0.05,0,85,85,85.0,15
0.05,1,-76,9,4.5,107
0.05,2,-37,-28,-9.333333333333334,138
0.05,3,42,14,3.5,58
0.05,4,76,90,18.0,25
0.05,5,90,180,30.0,10
0.05,6,-31,149,21.285714285714285,131
0.05,7,91,240,30.0,9
0.05,8,14,254,28.22222222222222,31
0.05,9,-57,197,19.7,90
0.05,10,-157,40,3.6363636363636362,122
0.05,11,3,43,3.5833333333333335,99
0.05,12,65,108,8.307692307692308,37
0.05,13,69,177,12.642857142857142,31
0.05,14,69,246,16.4,31
0.05,15,-185,61,3.8125,148
0.05,16,72,133,7.823529411764706,28
0.05,17,-21,112,6.222222222222222,121
0.05,18,45,157,8.263157894736842,55
0.05,19,9,166,8.3,23
0.05,20,62,228,10.857142857142858,39
0.05,21,-13,215,9.772727272727273,45
0.05,22,76,291,12.652173913043478,24
0.05,23,86,377,15.708333333333334,15
0.05,24,-25,352,14.08,127
0.05,25,78,430,16.53846153846154,23
0.05,26,-30,400,14.814814814814815,134
0.05,27,91,491,17.535714285714285,10
0.05,28,-42,449,15.482758620689655,75
0.05,29,88,537,17.9,12
0.05,30,63,600,19.35483870967742,37
0.05,31,89,689,21.53125,12
0.05,32,82,771,23.363636363636363,18
0.05,33,25,796,23.41176470588235,6
0.05,34,-128,668,19.085714285714285,162
0.05,35,83,751,20.86111111111111,17
0.05,36,92,843,22.783783783783782,8
0.05,37,-74,769,20.236842105263158,107
0.05,38,24,793,20.333333333333332,77
0.05,39,93,886,22.15,8
0.05,40,-107,779,19.0,210
0.05,41,93,872,20.761904761904763,7
0.05,42,-9,863,20.069767441860463,113
0.05,43,71,934,21.227272727272727,29
0.05,44,80,1014,22.533333333333335,21
0.05,45,92,1106,24.043478260869566,8
0.05,46,37,1143,24.319148936170212,64
0.05,47,80,1223,25.479166666666668,20
0.05,48,-96,1127,23.0,130
0.05,49,50,1177,23.54,50
0.05,50,25,1202,23.568627450980394,7
0.05,51,45,1247,23.98076923076923,55
0.05,52,74,1321,24.92452830188679,26
0.05,53,-34,1287,23.833333333333332,136
0.05,54,-146,1141,20.745454545454546,180
0.05,55,32,1173,20.946428571428573,69
0.05,56,73,1246,21.859649122807017,28
0.05,57,91,1337,23.051724137931036,9
0.05,58,95,1432,24.271186440677965,6
0.05,59,92,1524,25.4,9
0.05,60,77,1601,26.24590163934426,23
0.05,61,92,1693,27.306451612903224,9
0.05,62,-170,1523,24.174603174603174,65
0.05,63,-49,1474,23.03125,149
0.05,64,24,1498,23.046153846153846,78
0.05,65,2,1500,22.727272727272727,98
0.05,66,32,1532,22.865671641791046,68
0.05,67,7,1539,22.63235294117647,24
0.05,68,91,1630,23.6231884057971,9
0.05,69,77,1707,24.385714285714286,24
0.05,70,-35,1672,23.549295774647888,68
0.05,71,93,1765,24.51388888888889,8
0.05,72,-122,1643,22.506849315068493,169
0.05,73,35,1678,22.675675675675677,78
0.05,74,-246,1432,19.093333333333334,281
0.05,75,89,1521,20.013157894736842,11
0.05,76,40,1561,20.272727272727273,62
0.05,77,44,1605,20.576923076923077,57
0.05,78,78,1683,21.303797468354432,22
0.05,79,79,1762,22.025,22
0.05,80,22,1784,22.02469135802469,79
0.05,81,75,1859,22.670731707317074,25
0.05,82,91,1950,23.49397590361446,9
0.05,83,50,2000,23.80952380952381,50
0.05,84,-27,1973,23.211764705882352,127
0.05,85,82,2055,23.8953488372093,18
0.05,86,37,2092,24.04597701149425,63
0.05,87,94,2186,24.84090909090909,7
0.05,88,76,2262,25.415730337078653,25
0.05,89,9,2271,25.233333333333334,91
0.05,90,-63,2208,24.263736263736263,163
0.05,91,89,2297,24.967391304347824,12
0.05,92,-2,2295,24.677419354838708,104
0.05,93,65,2360,25.106382978723403,35
0.05,94,40,2400,25.263157894736842,61
0.05,95,72,2472,25.75,28
0.05,96,33,2505,25.824742268041238,68
0.05,97,68,2573,26.255102040816325,32
0.05,98,86,2659,26.858585858585858,24
0.05,99,32,2691,26.91,69
0.05,100,89,2780,27.524752475247524,12
0.05,101,71,2851,27.95098039215686,30
0.05,102,50,2901,28.16504854368932,51
0.05,103,86,2987,28.721153846153847,15
0.05,104,57,3044,28.99047619047619,46
0.05,105,72,3116,29.39622641509434,29
0.05,106,95,3211,30.009345794392523,6
0.05,107,64,3275,30.324074074074073,37
0.05,108,78,3353,30.761467889908257,22
0.05,109,-392,2961,26.918181818181818,363
0.05,110,-3,2958,26.64864864864865,103
0.05,111,25,2983,26.633928571428573,76
0.05,112,71,3054,27.02654867256637,29
0.05,113,80,3134,27.49122807017544,20
0.05,114,55,3189,27.730434782608697,45
0.05,115,-36,3153,27.18103448275862,68
0.05,116,23,3176,27.145299145299145,80
0.05,117,89,3265,27.66949152542373,11
0.05,118,-8,3257,27.369747899159663,110
0.05,119,86,3343,27.858333333333334,15
0.05,120,-16,3327,27.49586776859504,118
0.05,121,-16,3311,27.139344262295083,47
0.05,122,-8,3303,26.853658536585368,41
0.05,123,91,3394,27.370967741935484,9
0.05,124,92,3486,27.888,8
0.05,125,78,3564,28.285714285714285,23
0.05,126,36,3600,28.346456692913385,64
0.05,127,91,3691,28.8359375,10
0.05,128,75,3766,29.1937984496124,26
0.05,129,62,3828,29.446153846153845,44
0.05,130,6,3834,29.267175572519083,97
0.05,131,90,3924,29.727272727272727,11
0.05,132,25,3949,29.69172932330827,76
0.05,133,24,3973,29.649253731343283,76
0.05,134,85,4058,30.05925925925926,15
0.05,135,-17,4041,29.71323529411765,119
0.05,136,72,4113,30.021897810218977,29
0.05,137,83,4196,30.405797101449274,18
0.05,138,95,4291,30.8705035971223,6
0.05,139,72,4363,31.164285714285715,29
0.05,140,89,4452,31.574468085106382,11
0.05,141,95,4547,32.021126760563384,6
0.05,142,85,4632,32.39160839160839,16
0.05,143,29,4661,32.36805555555556,72
0.05,144,78,4739,32.682758620689654,22
0.05,145,80,4819,33.00684931506849,20
0.05,146,42,4861,33.06802721088435,59
0.05,147,94,4955,33.479729729729726,6
0.05,148,83,5038,33.81208053691275,18
0.05,149,-52,4986,33.24,177
0.05,150,10,4996,33.086092715231786,93
0.05,151,4,5000,32.89473684210526,28
0.05,152,95,5095,33.30065359477124,6
0.05,153,92,5187,33.68181818181818,8
0.05,154,44,5231,33.748387096774195,56
0.05,155,-64,5167,33.12179487179487,165
0.05,156,-126,5041,32.10828025477707,230
0.05,157,-10,5031,31.841772151898734,42
0.05,158,72,5103,32.094339622641506,28
0.05,159,66,5169,32.30625,34
0.05,160,-19,5150,31.987577639751553,121
0.05,161,-74,5076,31.333333333333332,176
0.05,162,-55,5021,30.803680981595093,156
0.05,163,92,5113,31.176829268292682,8
0.05,164,2,5115,31.0,102
0.05,165,92,5207,31.367469879518072,9
0.05,166,-18,5189,31.07185628742515,167
0.05,167,13,5202,30.964285714285715,87
0.05,168,24,5226,30.923076923076923,77
0.05,169,-88,5138,30.223529411764705,188
0.05,170,91,5229,30.57894736842105,9
0.05,171,90,5319,30.924418604651162,10
0.05,172,71,5390,31.15606936416185,30
0.05,173,-337,5053,29.04022988505747,231
0.05,174,90,5143,29.388571428571428,10
0.05,175,92,5235,29.744318181818183,8
0.05,176,22,5257,29.70056497175141,9
0.05,177,-23,5234,29.40449438202247,127
0.05,178,-84,5150,28.77094972067039,186
0.05,179,85,5235,29.083333333333332,15
0.05,180,-79,5156,28.486187845303867,112
0.05,181,-12,5144,28.263736263736263,115
0.05,182,20,5164,28.218579234972676,80
0.05,183,11,5175,28.125,89
0.05,184,85,5260,28.43243243243243,15
0.05,185,-91,5169,27.79032258064516,53
0.05,186,-13,5156,27.572192513368982,113
0.05,187,3,5159,27.44148936170213,100
0.05,188,-27,5132,27.15343915343915,59
0.05,189,51,5183,27.278947368421054,49
0.05,190,-31,5152,26.973821989528794,135
0.05,191,71,5223,27.203125,30
0.05,192,54,5277,27.3419689119171,47
0.05,193,-29,5248,27.051546391752577,132
0.05,194,-40,5208,26.70769230769231,141
0.05,195,-15,5193,26.494897959183675,116
0.05,196,17,5210,26.446700507614214,85
0.05,197,-194,5016,25.333333333333332,296
0.05,198,-5,5011,25.180904522613066,36
0.05,199,15,5026,25.13,85
0.05,200,79,5105,25.398009950248756,22
0.05,201,-45,5060,25.04950495049505,146
0.05,202,46,5106,25.15270935960591,55
0.05,203,49,5155,25.269607843137255,51
0.05,204,87,5242,25.570731707317073,14
0.05,205,-21,5221,25.344660194174757,122
0.05,206,-57,5164,24.946859903381643,157
0.05,207,57,5221,25.10096153846154,44
0.05,208,75,5296,25.339712918660286,26
0.05,209,79,5375,25.595238095238095,22
0.05,210,-113,5262,24.938388625592417,148
0.05,211,-40,5222,24.632075471698112,71
0.05,212,91,5313,24.943661971830984,9
0.05,213,93,5406,25.261682242990656,7
0.05,214,90,5496,25.56279069767442,10
0.05,215,83,5579,25.828703703703702,18
0.05,216,34,5613,25.86635944700461,67
0.05,217,-289,5324,24.422018348623855,255
0.05,218,73,5397,24.643835616438356,28
0.05,219,-26,5371,24.413636363636364,58
0.05,220,90,5461,24.710407239819006,11
0.05,221,88,5549,24.995495495495497,13
0.05,222,29,5578,25.013452914798208,71
0.05,223,32,5610,25.044642857142858,71
0.05,224,90,5700,25.333333333333332,10
0.05,225,94,5794,25.63716814159292,6
0.05,226,59,5853,25.784140969162994,41
0.05,227,31,5884,25.80701754385965,71
0.05,228,84,5968,26.061135371179038,16
0.05,229,-26,5942,25.83478260869565,129
0.05,230,82,6024,26.07792207792208,19
0.05,231,78,6102,26.301724137931036,22
0.05,232,-45,6057,25.99570815450644,147
0.05,233,82,6139,26.235042735042736,18
0.05,234,-87,6052,25.7531914893617,190
0.05,235,-97,5955,25.233050847457626,199
0.05,236,28,5983,25.244725738396625,72
0.05,237,2,5985,25.147058823529413,100
0.05,238,51,6036,25.255230125523013,50
0.05,239,-116,5920,24.666666666666668,217
0.05,240,58,5978,24.804979253112034,42
0.05,241,58,6036,24.94214876033058,43
0.05,242,-141,5895,24.25925925925926,175
0.05,243,59,5954,24.401639344262296,47
0.05,244,44,5998,24.481632653061226,56
0.05,245,87,6085,24.735772357723576,13
0.05,246,52,6137,24.846153846153847,48
0.05,247,-102,6035,24.33467741935484,133
0.05,248,-12,6023,24.188755020080322,114
0.05,249,1,6024,24.096,101
0.05,250,-80,5944,23.681274900398407,182
0.05,251,73,6017,23.876984126984127,62
0.05,252,-91,5926,23.42292490118577,125
0.05,253,-188,5738,22.590551181102363,222
0.05,254,-42,5696,22.337254901960783,145
0.05,255,84,5780,22.578125,17
0.05,256,66,5846,22.747081712062258,35
0.05,257,-103,5743,22.25968992248062,206
0.05,258,91,5834,22.525096525096526,10
0.05,259,-54,5780,22.23076923076923,89
0.05,260,87,5867,22.478927203065133,14
0.05,261,30,5897,22.50763358778626,71
0.05,262,2,5899,22.429657794676807,99
0.05,263,-19,5880,22.272727272727273,120
0.05,264,-211,5669,21.39245283018868,244
0.05,265,-49,5620,21.127819548872182,149
0.05,266,33,5653,21.172284644194757,67
0.05,267,48,5701,21.27238805970149,54
0.05,268,-49,5652,21.01115241635688,154
0.05,269,60,5712,21.155555555555555,41
0.05,270,52,5764,21.269372693726936,48
0.05,271,46,5810,21.360294117647058,54
0.05,272,83,5893,21.586080586080588,17
0.05,273,64,5957,21.740875912408757,37
0.05,274,-21,5936,21.585454545454546,123
0.05,275,-13,5923,21.46014492753623,114
0.05,276,66,5989,21.620938628158846,35
0.05,277,-9,5980,21.510791366906474,110
0.05,278,73,6053,21.695340501792113,28
0.05,279,93,6146,21.95,8
0.05,280,79,6225,22.153024911032027,21
0.05,281,33,6258,22.19148936170213,68
0.05,282,25,6283,22.20141342756184,78
0.05,283,-32,6251,22.010563380281692,63
0.05,284,85,6336,22.231578947368423,16
0.05,285,58,6394,22.356643356643357,43
0.05,286,-5,6389,22.261324041811847,108
0.05,287,-17,6372,22.125,117
0.05,288,-39,6333,21.913494809688583,140
0.05,289,-60,6273,21.631034482758622,94
0.05,290,92,6365,21.872852233676976,9
0.05,291,2,6367,21.804794520547944,30
0.05,292,86,6453,22.023890784982935,14
0.05,293,39,6492,22.081632653061224,62
0.05,294,83,6575,22.28813559322034,18
0.05,295,6,6581,22.23310810810811,94
0.05,296,-70,6511,21.922558922558924,207
0.05,297,21,6532,21.91946308724832,10
0.05,298,62,6594,22.05351170568562,41
0.05,299,63,6657,22.19,37
0.05,300,6,6663,22.13621262458472,94
0.05,301,-157,6506,21.543046357615893,122
0.05,302,84,6590,21.74917491749175,18
0.05,303,6,6596,21.69736842105263,95
0.05,304,38,6634,21.750819672131147,62
0.05,305,-135,6499,21.23856209150327,168
0.05,306,34,6533,21.28013029315961,68
0.05,307,88,6621,21.496753246753247,13
0.05,308,76,6697,21.673139158576053,25
0.05,309,50,6747,21.76451612903226,51
0.05,310,48,6795,21.84887459807074,53
0.05,311,1,6796,21.78205128205128,104
0.05,312,33,6829,21.817891373801917,67
0.05,313,82,6911,22.00955414012739,19
0.05,314,-52,6859,21.774603174603175,153
0.05,315,85,6944,21.974683544303797,15
0.05,316,86,7030,22.176656151419557,15
0.05,317,16,7046,22.157232704402517,84
0.05,318,63,7109,22.28526645768025,37
0.05,319,45,7154,22.35625,65
0.05,320,30,7184,22.38006230529595,71
0.05,321,-26,7158,22.229813664596275,59
0.05,322,86,7244,22.427244582043343,15
0.05,323,-46,7198,22.21604938271605,146
0.05,324,-128,7070,21.753846153846155,162
0.05,325,67,7137,21.892638036809817,34
0.05,326,34,7171,21.92966360856269,66
0.05,327,-100,7071,21.557926829268293,202
0.05,328,-96,6975,21.200607902735563,131
0.05,329,55,7030,21.303030303030305,47
0.05,330,76,7106,21.468277945619334,25
0.05,331,47,7153,21.545180722891565,55
0.05,332,13,7166,21.51951951951952,89
0.05,333,15,7181,21.5,85
0.05,334,78,7259,21.66865671641791,23
0.05,335,83,7342,21.851190476190474,17
0.05,336,20,7362,21.845697329376854,80
0.05,337,-179,7183,21.25147928994083,143
0.05,338,22,7205,21.253687315634217,78
0.05,339,24,7229,21.261764705882353,77
0.05,340,89,7318,21.46041055718475,12
0.05,341,3,7321,21.406432748538013,29
0.05,342,10,7331,21.373177842565596,91
0.05,343,88,7419,21.566860465116278,12
0.05,344,72,7491,21.713043478260868,29
0.05,345,52,7543,21.80057803468208,49
0.05,346,94,7637,22.00864553314121,7
0.05,347,62,7699,22.123563218390803,38
0.05,348,91,7790,22.320916905444125,14
0.05,349,85,7875,22.5,15
0.05,350,-39,7836,22.324786324786324,140
0.05,351,95,7931,22.53125,6
0.05,352,68,7999,22.660056657223794,32
0.05,353,-28,7971,22.516949152542374,128
0.05,354,50,8021,22.5943661971831,50
0.05,355,91,8112,22.786516853932586,10
0.05,356,70,8182,22.9187675070028,30
0.05,357,22,8204,22.916201117318437,78
0.05,358,69,8273,23.044568245125348,31
0.05,359,61,8334,23.15,39
0.05,360,5,8339,23.099722991689752,26
0.05,361,40,8379,23.146408839779006,61
0.05,362,78,8457,23.297520661157026,22
0.05,363,20,8477,23.28846153846154,82
0.05,364,34,8511,23.317808219178083,67
0.05,365,88,8599,23.494535519125684,13
0.05,366,62,8661,23.599455040871934,39
0.05,367,84,8745,23.76358695652174,17
0.05,368,74,8819,23.899728997289973,26
0.05,369,56,8875,23.986486486486488,44
0.05,370,25,8900,23.98921832884097,75
0.05,371,91,8991,24.169354838709676,10
0.05,372,81,9072,24.32171581769437,20
0.05,373,92,9164,24.502673796791445,10
0.05,374,93,9257,24.685333333333332,7
0.05,375,86,9343,24.84840425531915,15
0.05,376,82,9425,25.0,19
0.05,377,61,9486,25.095238095238095,39
0.05,378,68,9554,25.20844327176781,33
0.05,379,44,9598,25.257894736842104,57
0.05,380,88,9686,25.42257217847769,13
0.05,381,24,9710,25.418848167539267,77
0.05,382,95,9805,25.60052219321149,6
0.05,383,49,9854,25.661458333333332,51
0.05,384,-7,9847,25.576623376623377,38
0.05,385,-21,9826,25.4559585492228,54
0.05,386,73,9899,25.578811369509044,28
0.05,387,42,9941,25.621134020618555,58
0.05,388,83,10024,25.768637532133678,17
0.05,389,26,10050,25.76923076923077,75
0.05,390,18,10068,25.74936061381074,83
0.05,391,5,10073,25.696428571428573,26
0.05,392,43,10116,25.740458015267176,57
0.05,393,78,10194,25.873096446700508,23
0.05,394,-214,9980,25.265822784810126,181
0.05,395,78,10058,25.3989898989899,22
0.05,396,-28,10030,25.26448362720403,130
0.05,397,53,10083,25.334170854271356,48
0.05,398,2,10085,25.275689223057643,98
0.05,399,-100,9985,24.9625,132
0.05,400,3,9988,24.90773067331671,28
0.05,401,92,10080,25.074626865671643,8
0.05,402,68,10148,25.181141439205955,33
0.05,403,54,10202,25.252475247524753,51
0.05,404,84,10286,25.39753086419753,17
0.05,405,-43,10243,25.22906403940887,143
0.05,406,95,10338,25.4004914004914,6
0.05,407,-38,10300,25.245098039215687,71
0.05,408,65,10365,25.34229828850856,35
0.05,409,-16,10349,25.241463414634147,117
0.05,410,36,10385,25.2676399026764,64
0.05,411,-49,10336,25.0873786407767,151
0.05,412,66,10402,25.1864406779661,34
0.05,413,86,10488,25.333333333333332,14
0.05,414,25,10513,25.332530120481927,6
0.05,415,46,10559,25.38221153846154,54
0.05,416,13,10572,25.35251798561151,89
0.05,417,-206,10366,24.79904306220096,243
0.05,418,11,10377,24.766109785202865,90
0.05,419,13,10390,24.738095238095237,88
0.05,420,78,10468,24.8646080760095,22
0.05,421,39,10507,24.898104265402843,62
0.05,422,76,10583,25.01891252955083,25
0.05,423,-2,10581,24.955188679245282,33
0.05,424,-9,10572,24.87529411764706,109
0.05,425,77,10649,24.997652582159624,23
0.05,426,36,10685,25.02341920374707,66
0.05,427,72,10757,25.13317757009346,29
0.05,428,-49,10708,24.96037296037296,150
0.05,429,54,10762,25.027906976744188,46
0.05,430,89,10851,25.17633410672854,12
0.05,431,-169,10682,24.72685185185185,221
0.05,432,-156,10526,24.3094688221709,261
0.05,433,20,10546,24.29953917050691,81
0.05,434,89,10635,24.448275862068964,11
0.05,435,-145,10490,24.059633027522935,179
0.05,436,27,10517,24.066361556064074,74
0.05,437,37,10554,24.095890410958905,68
0.05,438,60,10614,24.17767653758542,41
0.05,439,58,10672,24.254545454545454,44
0.05,440,12,10684,24.226757369614514,89
0.05,441,27,10711,24.233031674208146,75
0.05,442,46,10757,24.28216704288939,55
0.05,443,-101,10656,24.0,206
0.05,444,55,10711,24.069662921348314,46
0.05,445,84,10795,24.204035874439462,17
0.05,446,86,10881,24.34228187919463,14
0.05,447,18,10899,24.328125,83
0.05,448,-45,10854,24.173719376391983,147
0.05,449,65,10919,24.264444444444443,35
0.05,450,68,10987,24.361419068736144,32
0.05,451,-8,10979,24.289823008849556,109
0.05,452,-19,10960,24.194260485651213,123
0.05,453,-68,10892,23.991189427312776,102
0.05,454,44,10936,24.035164835164835,58
0.05,455,86,11022,24.17105263157895,14
0.05,456,20,11042,24.161925601750546,80
0.05,457,83,11125,24.290393013100438,17
0.05,458,-23,11102,24.18736383442266,126
0.05,459,86,11188,24.321739130434782,14
0.05,460,89,11277,24.462039045553144,12
0.05,461,38,11315,24.49134199134199,63
0.05,462,79,11394,24.609071274298056,21
0.05,463,74,11468,24.71551724137931,27
0.05,464,-10,11458,24.640860215053763,110
0.05,465,-46,11412,24.489270386266096,78
0.05,466,60,11472,24.565310492505354,41
0.05,467,67,11539,24.655982905982906,34
0.05,468,86,11625,24.78678038379531,15
0.05,469,-173,11452,24.365957446808512,206
0.05,470,92,11544,24.50955414012739,8
0.05,471,41,11585,24.54449152542373,59
0.05,472,46,11631,24.58985200845666,55
0.05,473,93,11724,24.734177215189874,7
0.05,474,90,11814,24.87157894736842,10
0.05,475,-126,11688,24.554621848739497,159
0.05,476,31,11719,24.568134171907758,69
0.05,477,-100,11619,24.307531380753137,201
0.05,478,-57,11562,24.137787056367433,159
0.05,479,8,11570,24.104166666666668,93
0.05,480,83,11653,24.226611226611226,17
0.05,481,62,11715,24.304979253112034,39
0.05,482,75,11790,24.40993788819876,25
0.05,483,92,11882,24.549586776859503,9
0.05,484,90,11972,24.684536082474228,11
0.05,485,28,12000,24.691358024691358,75
0.05,486,89,12089,24.82340862422998,12
0.05,487,-8,12081,24.756147540983605,111
0.05,488,76,12157,24.860940695296524,24
0.05,489,59,12216,24.930612244897958,41
0.05,490,-104,12112,24.668024439918533,207
0.05,491,-178,11934,24.25609756097561,212
0.05,492,72,12006,24.352941176470587,28
0.05,493,86,12092,24.477732793522268,15
0.05,494,51,12143,24.53131313131313,51
0.05,495,30,12173,24.54233870967742,74
0.05,496,54,12227,24.601609657947687,47
0.05,497,78,12305,24.70883534136546,22
0.05,498,43,12348,24.74549098196393,64
0.05,499,76,12424,24.848,24
0.05,500,20,12444,24.838323353293415,83
0.05,501,88,12532,24.96414342629482,12
0.05,502,-124,12408,24.667992047713717,226
0.05,503,77,12485,24.771825396825395,24
0.05,504,90,12575,24.900990099009903,11
0.05,505,88,12663,25.025691699604742,12
0.05,506,80,12743,25.13412228796844,21
0.05,507,-11,12732,25.062992125984252,112
0.05,508,-56,12676,24.903732809430256,87
0.05,509,12,12688,24.87843137254902,19
0.05,510,77,12765,24.980430528375734,23
0.05,511,46,12811,25.021484375,55
0.05,512,44,12855,25.058479532163744,57
0.05,513,84,12939,25.173151750972764,17
0.05,514,60,12999,25.240776699029126,40
0.05,515,63,13062,25.313953488372093,38
0.05,516,68,13130,25.39651837524178,32
0.05,517,75,13205,25.49227799227799,25
0.05,518,29,13234,25.4990366088632,72
0.05,519,-77,13157,25.301923076923078,177
0.05,520,81,13238,25.408829174664106,19
0.05,521,-18,13220,25.325670498084293,61
0.05,522,-11,13209,25.25621414913958,111
0.05,523,-17,13192,25.17557251908397,119
0.05,524,-17,13175,25.095238095238095,119
0.05,525,-333,12842,24.41444866920152,473
0.05,526,17,12859,24.400379506641364,15
0.05,527,-52,12807,24.255681818181817,153
0.05,528,-56,12751,24.10396975425331,88
0.05,529,35,12786,24.12452830188679,77
0.05,530,25,12811,24.12617702448211,76
0.05,531,61,12872,24.195488721804512,42
0.05,532,-43,12829,24.069418386491556,76
0.05,533,84,12913,24.181647940074907,17
0.05,534,83,12996,24.29158878504673,18
0.05,535,47,13043,24.333955223880597,54
0.05,536,74,13117,24.426443202979517,27
0.05,537,91,13208,24.550185873605948,10
0.05,538,93,13301,24.67717996289425,8
0.05,539,74,13375,24.76851851851852,26
0.05,540,95,13470,24.89833641404806,6
0.05,541,44,13514,24.933579335793358,57
0.05,542,31,13545,24.944751381215468,70
0.05,543,75,13620,25.03676470588235,25
0.05,544,42,13662,25.06788990825688,58
0.05,545,44,13706,25.102564102564102,57
0.05,546,21,13727,25.09506398537477,10
0.05,547,51,13778,25.142335766423358,50
0.05,548,57,13835,25.200364298724953,43
0.05,549,-96,13739,24.98,200
0.05,550,11,13750,24.954627949183305,102
0.05,551,12,13762,24.931159420289855,90
0.05,552,-14,13748,24.860759493670887,46
0.05,553,78,13826,24.95667870036101,23
0.05,554,-108,13718,24.717117117117116,214
0.05,555,24,13742,24.715827338129497,7
0.05,556,59,13801,24.77737881508079,41
0.05,557,-39,13762,24.663082437275985,140
0.05,558,-42,13720,24.543828264758496,143
0.05,559,58,13778,24.603571428571428,42
0.05,560,33,13811,24.618538324420676,67
0.05,561,82,13893,24.72064056939502,18
0.05,562,71,13964,24.80284191829485,30
0.05,563,11,13975,24.77836879432624,89
0.05,564,-6,13969,24.723893805309736,106
0.05,565,87,14056,24.833922261484098,13
0.05,566,-31,14025,24.735449735449734,64
0.05,567,93,14118,24.8556338028169,8
0.05,568,36,14154,24.875219683655537,64
0.05,569,-13,14141,24.808771929824562,47
0.05,570,86,14227,24.915936952714535,14
0.05,571,-65,14162,24.75874125874126,96
0.05,572,86,14248,24.865619546247817,14
0.05,573,-225,14023,24.430313588850176,260
0.05,574,-2,14021,24.384347826086955,103
0.05,575,-39,13982,24.274305555555557,142
0.05,576,47,14029,24.31369150779896,55
0.05,577,75,14104,24.401384083044984,25
0.05,578,78,14182,24.493955094991364,22
0.05,579,68,14250,24.56896551724138,32
0.05,580,41,14291,24.59724612736661,62
0.05,581,72,14363,24.6786941580756,28
0.05,582,85,14448,24.782161234991424,16
0.05,583,39,14487,24.806506849315067,62
0.05,584,-10,14477,24.747008547008548,122
0.05,585,17,14494,24.733788395904437,83
0.05,586,76,14570,24.821124361158432,24
0.05,587,30,14600,24.829931972789115,71
0.05,588,71,14671,24.908319185059423,29
0.05,589,85,14756,25.010169491525424,16
0.05,590,55,14811,25.060913705583758,46
0.05,591,88,14899,25.16722972972973,12
0.05,592,67,14966,25.23777403035413,33
0.05,593,-195,14771,24.867003367003367,230
0.05,594,62,14833,24.929411764705883,39
0.05,595,67,14900,25.0,34
0.05,596,67,14967,25.07035175879397,33
0.05,597,67,15034,25.140468227424748,35
0.05,598,80,15114,25.23205342237062,20
0.05,599,-174,14940,24.9,291
0.05,600,-77,14863,24.73044925124792,179
0.05,601,-136,14727,24.463455149501662,173
0.05,602,-112,14615,24.23714759535655,146
0.05,603,90,14705,24.346026490066226,11
0.05,604,59,14764,24.403305785123965,43
0.05,605,-20,14744,24.33003300330033,121
0.05,606,20,14764,24.322899505766063,12
0.05,607,84,14848,24.42105263157895,16
0.05,608,-58,14790,24.285714285714285,93
0.05,609,-54,14736,24.15737704918033,155
0.05,610,-32,14704,24.06546644844517,134
0.05,611,15,14719,24.05065359477124,86
0.05,612,92,14811,24.161500815660684,8
0.05,613,50,14861,24.20358306188925,50
0.05,614,-54,14807,24.076422764227644,157
0.05,615,-9,14798,24.022727272727273,41
0.05,616,81,14879,24.11507293354943,20
0.05,617,92,14971,24.22491909385113,9
0.05,618,5,14976,24.193861066235865,96
0.05,619,78,15054,24.280645161290323,22
0.05,620,92,15146,24.389694041867955,8
0.05,621,31,15177,24.40032154340836,69
0.05,622,87,15264,24.500802568218297,13
0.05,623,-24,15240,24.423076923076923,63
0.05,624,31,15271,24.4336,71
0.05,625,48,15319,24.471246006389777,53
0.05,626,82,15401,24.562998405103666,19
0.05,627,34,15435,24.578025477707005,70
0.05,628,78,15513,24.66295707472178,22
0.05,629,94,15607,24.773015873015872,6
0.05,630,89,15696,24.874801901743265,11
0.05,631,85,15781,24.96993670886076,16
0.05,632,80,15861,25.05687203791469,20
0.05,633,-59,15802,24.92429022082019,92
0.05,634,-196,15606,24.576377952755905,299
0.05,635,66,15672,24.641509433962263,35
0.05,636,27,15699,24.645211930926216,74
0.05,637,39,15738,24.66771159874608,63
0.05,638,-32,15706,24.579029733959313,134
0.05,639,-147,15559,24.3109375,111
0.05,640,28,15587,24.316692667706707,81
0.05,641,-114,15473,24.101246105919003,146
0.05,642,86,15559,24.19751166407465,14
0.05,643,87,15646,24.295031055900623,13
0.05,644,40,15686,24.31937984496124,62
0.05,645,14,15700,24.30340557275542,87
0.05,646,87,15787,24.40030911901082,13
0.05,647,-78,15709,24.242283950617285,178
0.05,648,61,15770,24.298921417565484,39
0.05,649,-9,15761,24.247692307692308,41
0.05,650,95,15856,24.356374807987713,6
0.05,651,9,15865,24.33282208588957,94
0.05,652,-33,15832,24.245022970903523,134
0.05,653,49,15881,24.282874617737004,61
0.05,654,38,15919,24.30381679389313,64
0.05,655,-107,15812,24.103658536585368,141
0.05,656,90,15902,24.203957382039572,11
0.05,657,-103,15799,24.01063829787234,135
0.05,658,57,15856,24.060698027314114,43
0.05,659,77,15933,24.14090909090909,24
0.05,660,80,16013,24.225416036308623,20
0.05,661,34,16047,24.240181268882175,66
0.05,662,79,16126,24.322775263951733,22
0.05,663,-113,16013,24.115963855421686,219
0.05,664,2,16015,24.082706766917294,99
0.05,665,58,16073,24.133633633633632,42
0.05,666,36,16109,24.151424287856074,64
0.05,667,-296,15813,23.672155688622755,264
0.05,668,-25,15788,23.599402092675636,126
0.05,669,86,15874,23.692537313432837,15
0.05,670,-179,15695,23.390461997019376,285
0.05,671,61,15756,23.446428571428573,39
0.05,672,68,15824,23.512630014858843,34
0.05,673,25,15849,23.514836795252226,78
0.05,674,20,15869,23.50962962962963,11
0.05,675,-21,15848,23.443786982248522,52
0.05,676,-26,15822,23.370753323485967,57
0.05,677,35,15857,23.387905604719766,70
0.05,678,12,15869,23.371134020618555,89
0.05,679,86,15955,23.46323529411765,14
0.05,680,90,16045,23.56093979441997,10
0.05,681,-1,16044,23.524926686217007,122
0.05,682,88,16132,23.619326500732065,12
0.05,683,-72,16060,23.47953216374269,173
0.05,684,-108,15952,23.287591240875912,214
0.05,685,65,16017,23.348396501457724,36
0.05,686,59,16076,23.400291120815137,42
0.05,687,78,16154,23.4796511627907,22
0.05,688,80,16234,23.56168359941945,21
0.05,689,-127,16107,23.343478260869563,227
0.05,690,-86,16021,23.185238784370476,121
0.05,691,46,16067,23.21820809248555,55
0.05,692,71,16138,23.28715728715729,30
0.05,693,56,16194,23.334293948126803,45
0.05,694,46,16240,23.366906474820144,68
0.05,695,65,16305,23.426724137931036,35
0.05,696,71,16376,23.494978479196558,29
0.05,697,92,16468,23.593123209169054,8
0.05,698,68,16536,23.65665236051502,33
0.05,699,30,16566,23.665714285714287,73
0.05,700,45,16611,23.696148359486447,55
0.05,701,22,16633,23.693732193732195,79
0.05,702,68,16701,23.756756756756758,33
0.05,703,90,16791,23.850852272727273,10
0.05,704,-122,16669,23.643971631205673,154
0.05,705,7,16676,23.620396600566572,93
0.05,706,40,16716,23.643564356435643,62
0.05,707,59,16775,23.693502824858758,41
0.05,708,-257,16518,23.297602256699577,290
0.05,709,-8,16510,23.253521126760564,109
0.05,710,93,16603,23.351617440225034,8
0.05,711,90,16693,23.445224719101123,11
0.05,712,87,16780,23.5343618513324,14
0.05,713,78,16858,23.610644257703083,23
0.05,714,56,16914,23.655944055944055,44
0.05,715,-80,16834,23.511173184357542,184
0.05,716,24,16858,23.511854951185494,8
0.05,717,-76,16782,23.37325905292479,183
0.05,718,-181,16601,23.089012517385257,214
0.05,719,-38,16563,23.004166666666666,163
0.05,720,93,16656,23.10124826629681,8
0.05,721,92,16748,23.196675900277008,8
0.05,722,-35,16713,23.116182572614107,67
0.05,723,76,16789,23.189226519337016,25
0.05,724,82,16871,23.270344827586207,21
0.05,725,-44,16827,23.177685950413224,78
0.05,726,93,16920,23.27372764786795,7
0.05,727,82,17002,23.354395604395606,19
0.05,728,32,17034,23.366255144032923,68
0.05,729,9,17043,23.346575342465755,92
0.05,730,-31,17012,23.27222982216142,134
0.05,731,40,17052,23.295081967213115,61
0.05,732,67,17119,23.354706684856755,33
0.05,733,74,17193,23.423705722070846,26
0.05,734,70,17263,23.487074829931974,39
0.05,735,-39,17224,23.402173913043477,139
0.05,736,-90,17134,23.2483039348711,193
0.05,737,-64,17070,23.130081300813007,165
0.05,738,28,17098,23.136671177266578,72
0.05,739,82,17180,23.216216216216218,18
0.05,740,4,17184,23.190283400809715,97
0.05,741,93,17277,23.28436657681941,8
0.05,742,88,17365,23.371467025572006,12
0.05,743,61,17426,23.422043010752688,39
0.05,744,-412,17014,22.83758389261745,560
0.05,745,91,17105,22.928954423592494,10
0.05,746,-91,17014,22.7764390896921,194
0.05,747,46,17060,22.807486631016044,54
0.05,748,39,17099,22.82910547396529,61
0.05,749,42,17141,22.854666666666667,59
0.05,750,95,17236,22.95073235685752,6
0.05,751,93,17329,23.043882978723403,8
0.05,752,70,17399,23.106241699867198,31
0.05,753,16,17415,23.09681697612732,86
0.05,754,52,17467,23.135099337748343,48
0.05,755,25,17492,23.137566137566136,75
0.05,756,-117,17375,22.952443857331573,220
0.05,757,34,17409,22.967018469656992,67
0.05,758,61,17470,23.017127799736496,39
0.05,759,-131,17339,22.814473684210526,164
0.05,760,84,17423,22.894875164257556,17
0.05,761,91,17514,22.984251968503937,9
0.05,762,38,17552,23.003931847968545,63
0.05,763,47,17599,23.035340314136125,54
0.05,764,13,17612,23.022222222222222,87
0.05,765,-106,17506,22.85378590078329,137
0.05,766,85,17591,22.934810951760106,16
0.05,767,-82,17509,22.798177083333332,183
0.05,768,36,17545,22.815344603381014,65
0.05,769,80,17625,22.88961038961039,21
0.05,770,4,17629,22.865110246433204,99
0.05,771,94,17723,22.957253886010363,7
0.05,772,-200,17523,22.66882276843467,304
0.05,773,70,17593,22.72997416020672,30
0.05,774,27,17620,22.73548387096774,74
0.05,775,70,17690,22.79639175257732,31
0.05,776,22,17712,22.795366795366796,78
0.05,777,73,17785,22.859897172236504,28
0.05,778,49,17834,22.893453145057766,53
0.05,779,-50,17784,22.8,150
0.05,780,-3,17781,22.76696542893726,103
0.05,781,66,17847,22.82225063938619,35
0.05,782,64,17911,22.874840357598977,37
0.05,783,75,17986,22.941326530612244,26
0.05,784,69,18055,23.0,31
0.05,785,77,18132,23.068702290076335,23
0.05,786,-35,18097,22.994917407878017,135
0.05,787,66,18163,23.049492385786802,35
0.05,788,38,18201,23.068441064638783,64
0.05,789,55,18256,23.10886075949367,47
0.05,790,-62,18194,23.00126422250316,158
0.05,791,-28,18166,22.93686868686869,130
0.05,792,-128,18038,22.74653215636822,231
0.05,793,29,18067,22.7544080604534,72
0.05,794,52,18119,22.79119496855346,48
0.05,795,47,18166,22.821608040201006,54
0.05,796,-127,18039,22.633626097867,162
0.05,797,26,18065,22.637844611528823,75
0.05,798,23,18088,22.638297872340427,78
0.05,799,12,18100,22.625,90
0.05,800,-63,18037,22.518102372034956,95
0.05,801,51,18088,22.55361596009975,50
0.05,802,62,18150,22.602739726027398,40
0.05,803,12,18162,22.58955223880597,90
0.05,804,91,18253,22.674534161490683,9
0.05,805,66,18319,22.72828784119107,34
0.05,806,37,18356,22.745972738537795,64
0.05,807,6,18362,22.725247524752476,26
0.05,808,-191,18171,22.4610630407911,226
0.05,809,65,18236,22.51358024691358,36
0.05,810,91,18327,22.5980271270037,9
0.05,811,73,18400,22.660098522167488,28
0.05,812,-35,18365,22.589175891758916,136
0.05,813,-124,18241,22.40909090909091,227
0.05,814,-9,18232,22.370552147239263,41
0.05,815,94,18326,22.458333333333332,6
0.05,816,-57,18269,22.36107711138311,161
0.05,817,-3,18266,22.330073349633253,103
0.05,818,81,18347,22.4017094017094,19
0.05,819,77,18424,22.46829268292683,23
0.05,820,62,18486,22.516443361753957,38
0.05,821,-69,18417,22.405109489051096,196
0.05,822,28,18445,22.41190765492102,72
0.05,823,41,18486,22.434466019417474,59
0.05,824,67,18553,22.48848484848485,50
0.05,825,84,18637,22.562953995157386,16
0.05,826,-174,18463,22.325272067714632,280
0.05,827,-94,18369,22.184782608695652,129
0.05,828,93,18462,22.270205066344992,7
0.05,829,84,18546,22.344578313253013,16
0.05,830,13,18559,22.333333333333332,87
0.05,831,-50,18509,22.24639423076923,82
0.05,832,-38,18471,22.17406962785114,140
0.05,833,50,18521,22.207434052757794,53
0.05,834,-644,17877,21.409580838323354,677
0.05,835,-51,17826,21.322966507177032,83
0.05,836,-137,17689,21.133811230585422,241
0.05,837,53,17742,21.171837708830548,47
0.05,838,-147,17595,20.97139451728248,183
0.05,839,60,17655,21.017857142857142,41
0.05,840,-11,17644,20.979785969084425,112
0.05,841,43,17687,21.005938242280283,57
0.05,842,4,17691,20.98576512455516,126
0.05,843,56,17747,21.027251184834125,58
0.05,844,2,17749,21.004733727810653,29
0.05,845,47,17796,21.0354609929078,53
0.05,846,-38,17758,20.965761511216055,142
0.05,847,33,17791,20.97995283018868,69
0.05,848,84,17875,21.054181389870436,16
0.05,849,-29,17846,20.99529411764706,61
0.05,850,67,17913,21.049353701527615,36
0.05,851,-53,17860,20.962441314553992,156
0.05,852,4,17864,20.94255568581477,97
0.05,853,88,17952,21.021077283372364,12
0.05,854,5,17957,21.00233918128655,96
0.05,855,75,18032,21.065420560747665,25
0.05,856,-40,17992,20.99416569428238,142
0.05,857,26,18018,21.0,76
0.05,858,-27,17991,20.944121071012805,127
0.05,859,60,18051,20.989534883720932,42
0.05,860,90,18141,21.069686411149824,11
0.05,861,8,18149,21.054524361948957,23
0.05,862,90,18239,21.13441483198146,11
0.05,863,-29,18210,21.07638888888889,129
0.05,864,82,18292,21.146820809248556,18
0.05,865,-54,18238,21.060046189376443,156
0.05,866,89,18327,21.13840830449827,12
0.05,867,61,18388,21.18433179723502,39
0.05,868,57,18445,21.22554660529344,45
0.05,869,-4,18441,21.19655172413793,111
0.05,870,91,18532,21.276693455797933,10
0.05,871,69,18601,21.331422018348626,32
0.05,872,66,18667,21.38258877434135,35
0.05,873,-97,18570,21.247139588100687,131
0.05,874,93,18663,21.329142857142855,8
0.05,875,-4,18659,21.300228310502284,105
0.05,876,-179,18480,21.07183580387685,211
0.05,877,77,18557,21.135535307517085,23
0.05,878,87,18644,21.21046643913538,13
0.05,879,69,18713,21.264772727272728,32
0.05,880,-55,18658,21.178206583427922,156
0.05,881,-24,18634,21.126984126984127,56
0.05,882,19,18653,21.124575311438278,81
0.05,883,5,18658,21.10633484162896,96
0.05,884,-8,18650,21.073446327683616,39
0.05,885,5,18655,21.05530474040632,97
0.05,886,61,18716,21.100338218714768,39
0.05,887,36,18752,21.117117117117118,65
0.05,888,74,18826,21.17660292463442,26
0.05,889,-93,18733,21.048314606741574,125
0.05,890,-167,18566,20.837261503928172,129
0.05,891,73,18639,20.8957399103139,29
0.05,892,90,18729,20.973124300111984,10
0.05,893,34,18763,20.987695749440714,67
0.05,894,76,18839,21.049162011173184,24
0.05,895,-122,18717,20.889508928571427,155
0.05,896,48,18765,20.91973244147157,52
0.05,897,74,18839,20.978841870824052,26
0.05,898,92,18931,21.057842046718577,8
0.05,899,94,19025,21.13888888888889,6
0.05,900,29,19054,21.147613762486127,73
0.05,901,80,19134,21.212860310421284,20
0.05,902,-137,18997,21.03765227021041,168
0.05,903,30,19027,21.047566371681416,71
0.05,904,15,19042,21.040883977900553,86
0.05,905,91,19133,21.118101545253865,9
0.05,906,-6,19127,21.088202866593164,107
0.05,907,9,19136,21.07488986784141,91
0.05,908,-132,19004,20.906490649064907,235
0.05,909,79,19083,20.97032967032967,21
0.05,910,69,19152,21.02305159165752,33
0.05,911,50,19202,21.05482456140351,50
0.05,912,48,19250,21.08433734939759,52
0.05,913,93,19343,21.163019693654267,8
0.05,914,93,19436,21.24153005464481,7
0.05,915,-44,19392,21.170305676855897,155
0.05,916,84,19476,21.238822246455832,18
0.05,917,21,19497,21.23856209150327,79
0.05,918,81,19578,21.30359085963003,20
0.05,919,-1,19577,21.279347826086955,32
0.05,920,66,19643,21.327904451682954,34
0.05,921,62,19705,21.372017353579174,39
0.05,922,93,19798,21.449620801733477,7
0.05,923,66,19864,21.4978354978355,34
0.05,924,-477,19387,20.95891891891892,519
0.05,925,69,19456,21.010799136069114,31
0.05,926,58,19514,21.050701186623517,44
0.05,927,-20,19494,21.00646551724138,122
0.05,928,80,19574,21.069967707212054,21
0.05,929,81,19655,21.134408602150536,19
0.05,930,-78,19577,21.027926960257787,181
0.05,931,95,19672,21.107296137339056,6
0.05,932,42,19714,21.129689174705252,61
0.05,933,-128,19586,20.970021413276232,162
0.05,934,46,19632,20.996791443850267,56
0.05,935,-115,19517,20.851495726495727,218
0.05,936,3,19520,20.832443970117396,51
0.05,937,44,19564,20.857142857142858,58
0.05,938,79,19643,20.91906283280085,22
0.05,939,82,19725,20.98404255319149,18
0.05,940,33,19758,20.99681190223167,69
0.05,941,79,19837,21.058386411889597,22
0.05,942,92,19929,21.133616118769883,9
0.05,943,72,20001,21.1875,28
0.05,944,43,20044,21.210582010582012,57
0.05,945,93,20137,21.28646934460888,8
0.05,946,-149,19988,21.106652587117214,184
0.05,947,93,20081,21.182489451476794,7
0.05,948,-15,20066,21.14436248682824,47
0.05,949,42,20108,21.166315789473686,60
0.05,950,-43,20065,21.098843322818087,145
0.05,951,74,20139,21.154411764705884,26
0.05,952,-36,20103,21.094438614900316,140
0.05,953,76,20179,21.151991614255767,24
0.05,954,-5,20174,21.12460732984293,107
0.05,955,52,20226,21.156903765690377,49
0.05,956,94,20320,21.233019853709507,6
0.05,957,-95,20225,21.11169102296451,202
0.05,958,61,20286,21.153284671532848,40
0.05,959,-74,20212,21.054166666666667,110
0.05,960,72,20284,21.107180020811654,29
0.05,961,2,20286,21.08731808731809,99
0.05,962,56,20342,21.12357217030114,45
0.05,963,-45,20297,21.054979253112034,91
0.05,964,-76,20221,20.95440414507772,108
0.05,965,84,20305,21.01966873706004,17
0.05,966,84,20389,21.084798345398138,17
0.05,967,54,20443,21.11880165289256,46
0.05,968,-28,20415,21.068111455108358,136
0.05,969,76,20491,21.12474226804124,24
0.05,970,89,20580,21.194644696189496,11
0.05,971,-4,20576,21.16872427983539,106
0.05,972,86,20662,21.23535457348407,14
0.05,973,68,20730,21.28336755646817,32
0.05,974,53,20783,21.315897435897437,49
0.05,975,75,20858,21.37090163934426,26
0.05,976,36,20894,21.385875127942683,65
0.05,977,87,20981,21.452965235173824,13
0.05,978,-10,20971,21.420837589376916,112
0.05,979,51,21022,21.451020408163266,49
0.05,980,53,21075,21.483180428134556,48
0.05,981,83,21158,21.545824847250508,17
0.05,982,77,21235,21.602238046795524,23
0.05,983,45,21280,21.6260162601626,56
0.05,984,65,21345,21.67005076142132,35
0.05,985,32,21377,21.68052738336714,70
0.05,986,38,21415,21.697061803444782,63
0.05,987,91,21506,21.767206477732792,9
0.05,988,-126,21380,21.61779575328615,159
0.05,989,55,21435,21.651515151515152,46
0.05,990,79,21514,21.709384460141273,21
0.05,991,16,21530,21.703629032258064,87
0.05,992,71,21601,21.75327291037261,30
0.05,993,-150,21451,21.580482897384307,253
0.05,994,-175,21276,21.382914572864323,277
0.05,995,-166,21110,21.194779116465863,202
0.05,996,14,21124,21.187562688064194,88
0.05,997,6,21130,21.172344689378757,94
0.05,998,49,21179,21.2002002002002,52
0.05,999,-77,21102,21.102,110
0.05,1000,-53,21049,21.027972027972027,85
0.05,1001,84,21133,21.090818363273453,17
0.05,1002,81,21214,21.150548354935193,20
0.05,1003,93,21307,21.22211155378486,7
0.05,1004,9,21316,21.20995024875622,95
0.05,1005,45,21361,21.233598409542743,56
0.05,1006,69,21430,21.28103277060576,32
0.05,1007,11,21441,21.270833333333332,93
0.05,1008,64,21505,21.313181367690785,36
0.05,1009,-81,21424,21.211881188118813,112
0.05,1010,14,21438,21.204747774480712,86
0.05,1011,78,21516,21.26086956521739,22
0.05,1012,14,21530,21.25370187561698,17
0.05,1013,-34,21496,21.19921104536489,66
0.05,1014,19,21515,21.19704433497537,81
0.05,1015,18,21533,21.193897637795274,83
0.05,1016,55,21588,21.227138643067846,46
0.05,1017,-40,21548,21.166994106090375,142
0.05,1018,18,21566,21.16388616290481,85
0.05,1019,-3,21563,21.140196078431373,104
0.05,1020,68,21631,21.186092066601372,33
0.05,1021,9,21640,21.174168297455967,99
0.05,1022,39,21679,21.191593352883675,63
0.05,1023,61,21740,21.23046875,39
0.05,1024,78,21818,21.285853658536585,23
0.05,1025,46,21864,21.309941520467838,55
0.05,1026,37,21901,21.325219084712757,65
0.05,1027,93,21994,21.394941634241246,7
0.05,1028,34,22028,21.407191448007776,66
0.05,1029,-263,21765,21.131067961165048,297
0.05,1030,45,21810,21.154219204655675,56
0.05,1031,63,21873,21.194767441860463,44
0.05,1032,92,21965,21.263310745401743,9
0.05,1033,71,22036,21.311411992263057,32
0.05,1034,78,22114,21.366183574879226,22
0.05,1035,-30,22084,21.316602316602317,133
0.05,1036,-21,22063,21.27579556412729,54
0.05,1037,85,22148,21.33718689788054,16
0.05,1038,75,22223,21.3888354186718,26
0.05,1039,84,22307,21.44903846153846,16
0.05,1040,91,22398,21.51585014409222,10
0.05,1041,73,22471,21.565259117082533,59
0.05,1042,-102,22369,21.446788111217643,135
0.05,1043,83,22452,21.50574712643678,18
0.05,1044,81,22533,21.56267942583732,19
0.05,1045,-5,22528,21.537284894837477,105
0.05,1046,-34,22494,21.484240687679083,137
0.05,1047,-43,22451,21.422709923664122,75
0.05,1048,-265,22186,21.149666348903718,370
0.05,1049,66,22252,21.19238095238095,35
0.05,1050,89,22341,21.256898192197905,11
0.05,1051,44,22385,21.27851711026616,58
0.05,1052,82,22467,21.336182336182336,19
0.05,1053,94,22561,21.405123339658445,6
0.05,1054,-65,22496,21.323222748815166,97
0.05,1055,-88,22408,21.21969696969697,121
0.05,1056,94,22502,21.288552507095552,6
0.05,1057,89,22591,21.352551984877127,11
0.05,1058,48,22639,21.377714825306892,54
0.05,1059,85,22724,21.437735849056605,15
0.05,1060,92,22816,21.504241281809612,9
0.05,1061,71,22887,21.550847457627118,30
0.05,1062,-56,22831,21.477892756349952,89
0.05,1063,33,22864,21.48872180451128,67
0.05,1064,19,22883,21.486384976525823,82
0.05,1065,4,22887,21.46998123827392,96
0.05,1066,43,22930,21.490159325210872,70
0.05,1067,-62,22868,21.411985018726593,167
0.05,1068,81,22949,21.467726847521046,20
0.05,1069,69,23018,21.512149532710282,31
0.05,1070,64,23082,21.551820728291318,37
0.05,1071,50,23132,21.578358208955223,51
0.05,1072,9,23141,21.56663560111836,91
0.05,1073,84,23225,21.624767225325886,17
0.05,1074,43,23268,21.644651162790698,58
0.05,1075,18,23286,21.641263940520446,85
0.05,1076,89,23375,21.70380687093779,12
0.05,1077,8,23383,21.69109461966605,94
0.05,1078,-32,23351,21.641334569045412,64
0.05,1079,-140,23211,21.491666666666667,176
0.05,1080,49,23260,21.517113783533766,53
0.05,1081,-78,23182,21.42513863216266,180
0.05,1082,33,23215,21.43582640812558,67
0.05,1083,79,23294,21.488929889298895,21
0.05,1084,79,23373,21.54193548387097,21
0.05,1085,92,23465,21.60681399631676,9
0.05,1086,62,23527,21.64397424103036,39
0.05,1087,-59,23468,21.56985294117647,162
0.05,1088,-13,23455,21.538108356290174,116
0.05,1089,90,23545,21.60091743119266,10
0.05,1090,31,23576,21.609532538955087,70
0.05,1091,73,23649,21.656593406593405,27
0.05,1092,70,23719,21.70082342177493,31
0.05,1093,93,23812,21.76599634369287,7
0.05,1094,75,23887,21.81461187214612,26
0.05,1095,71,23958,21.85948905109489,30
0.05,1096,53,24011,21.887876025524157,61
0.05,1097,-98,23913,21.778688524590162,203
0.05,1098,77,23990,21.828935395814376,24
0.05,1099,91,24081,21.89181818181818,9
0.05,1100,81,24162,21.94550408719346,19
0.05,1101,-29,24133,21.899274047186932,131
0.05,1102,-6,24127,21.873980054397098,133
0.05,1103,70,24197,21.917572463768117,30
0.05,1104,43,24240,21.936651583710407,68
0.05,1105,74,24314,21.98372513562387,27
0.05,1106,51,24365,22.009936766034325,49
0.05,1107,68,24433,22.0514440433213,32
0.05,1108,64,24497,22.0892696122633,36
0.05,1109,92,24589,22.152252252252254,9
0.05,1110,73,24662,22.198019801980198,27
0.05,1111,-252,24410,21.951438848920862,358
0.05,1112,11,24421,21.941599281221922,21
0.05,1113,77,24498,21.991023339317774,24
0.05,1114,-23,24475,21.95067264573991,123
0.05,1115,67,24542,21.991039426523297,36
0.05,1116,53,24595,22.01880035810206,48
0.05,1117,-134,24461,21.879248658318424,237
0.05,1118,83,24544,21.933869526362823,18
0.05,1119,85,24629,21.990178571428572,15
0.05,1120,-60,24569,21.917038358608384,94
0.05,1121,91,24660,21.97860962566845,9
0.05,1122,49,24709,22.0026714158504,51
0.05,1123,89,24798,22.062277580071175,12
0.05,1124,89,24887,22.121777777777776,12
0.05,1125,-20,24867,22.08436944937833,121
0.05,1126,-65,24802,22.00709849157054,167
0.05,1127,3,24805,21.990248226950353,99
0.05,1128,19,24824,21.98759964570416,14
0.05,1129,80,24904,22.038938053097347,21
0.05,1130,-133,24771,21.90185676392573,166
0.05,1131,-67,24704,21.823321554770317,167
0.05,1132,-70,24634,21.742277140335393,102
0.05,1133,80,24714,21.793650793650794,21
0.05,1134,6,24720,21.779735682819382,97
0.05,1135,92,24812,21.841549295774648,8
0.05,1136,-18,24794,21.80650835532102,51
0.05,1137,65,24859,21.844463971880494,36
0.05,1138,83,24942,21.898156277436346,18
0.05,1139,-16,24926,21.864912280701756,47
0.05,1140,-41,24885,21.809815950920246,147
0.05,1141,76,24961,21.857267950963223,24
0.05,1142,45,25006,21.877515310586176,55
0.05,1143,-5,25001,21.85402097902098,106
0.05,1144,86,25087,21.91004366812227,14
0.05,1145,87,25174,21.966841186736474,13
0.05,1146,7,25181,21.9537925021796,93
0.05,1147,84,25265,22.007839721254356,17
0.05,1148,50,25315,22.03220191470844,51
0.05,1149,0,25315,22.01304347826087,100
0.05,1150,-53,25262,21.94787141615986,85
0.05,1151,-61,25201,21.875868055555557,95
0.05,1152,-25,25176,21.835212489158717,58
0.05,1153,-23,25153,21.796360485268632,138
0.05,1154,18,25171,21.793073593073593,13
0.05,1155,79,25250,21.842560553633216,21
0.05,1156,-180,25070,21.66810717372515,282
0.05,1157,-24,25046,21.6286701208981,138
0.05,1158,35,25081,21.640207075064712,68
0.05,1159,-63,25018,21.567241379310346,163
0.05,1160,58,25076,21.598621877691645,51
0.05,1161,-16,25060,21.566265060240966,48
0.05,1162,6,25066,21.552880481513327,94
0.05,1163,-89,24977,21.45790378006873,191
0.05,1164,-15,24962,21.426609442060087,46
0.05,1165,71,25033,21.469125214408233,30
0.05,1166,87,25120,21.525278491859467,13
0.05,1167,79,25199,21.574486301369863,22
0.05,1168,64,25263,21.610778443113773,38
0.05,1169,50,25313,21.635042735042735,50
0.05,1170,40,25353,21.65072587532024,61
0.05,1171,89,25442,21.708191126279864,11
0.05,1172,62,25504,21.742540494458652,38
0.05,1173,-4,25500,21.720613287904598,105
0.05,1174,52,25552,21.746382978723403,50
0.05,1175,55,25607,21.77465986394558,46
0.05,1176,94,25701,21.836023789294817,7
0.05,1177,-172,25529,21.671477079796265,206
0.05,1178,21,25550,21.670907548770145,80
0.05,1179,39,25589,21.685593220338983,61
0.05,1180,70,25659,21.72650296359018,31
0.05,1181,94,25753,21.787648054145517,6
0.05,1182,85,25838,21.84108199492815,16
0.05,1183,49,25887,21.86402027027027,52
0.05,1184,91,25978,21.922362869198313,9
0.05,1185,83,26061,21.973861720067454,18
0.05,1186,24,26085,21.975568660488626,77
0.05,1187,91,26176,22.033670033670035,9
0.05,1188,59,26235,22.06476030277544,42
0.05,1189,77,26312,22.1109243697479,24
0.05,1190,87,26399,22.16540722082284,13
0.05,1191,80,26479,22.213926174496645,21
0.05,1192,62,26541,22.247275775356243,39
0.05,1193,78,26619,22.29396984924623,23
0.05,1194,64,26683,22.32887029288703,36
0.05,1195,58,26741,22.358695652173914,42
0.05,1196,40,26781,22.3734335839599,61
0.05,1197,39,26820,22.387312186978296,62
0.05,1198,70,26890,22.42702251876564,33
0.05,1199,-13,26877,22.3975,114
0.05,1200,69,26946,22.436303080766027,31
0.05,1201,-114,26832,22.32279534109817,145
0.05,1202,-2,26830,22.30257689110557,33
0.05,1203,21,26851,22.301495016611295,81
0.05,1204,73,26924,22.34356846473029,36
0.05,1205,27,26951,22.34742951907131,74
0.05,1206,48,26999,22.36868268434134,66
0.05,1207,90,27089,22.424668874172184,11
0.05,1208,71,27160,22.464846980976013,29
0.05,1209,67,27227,22.501652892561985,33
0.05,1210,92,27319,22.55904211395541,8
0.05,1211,89,27408,22.613861386138613,11
0.05,1212,-71,27337,22.536685902720528,175
0.05,1213,-3,27334,22.515650741350907,106
0.05,1214,77,27411,22.560493827160492,23
0.05,1215,88,27499,22.614309210526315,13
0.05,1216,24,27523,22.61544782251438,76
0.05,1217,23,27546,22.61576354679803,80
0.05,1218,74,27620,22.65791632485644,26
0.05,1219,8,27628,22.645901639344263,94
0.05,1220,47,27675,22.665847665847664,54
0.05,1221,56,27731,22.69312602291326,46
0.05,1222,68,27799,22.73017170891251,33
0.05,1223,-50,27749,22.670751633986928,84
0.05,1224,87,27836,22.72326530612245,13
0.05,1225,81,27917,22.770799347471453,20
0.05,1226,73,27990,22.811735941320293,28
0.05,1227,68,28058,22.848534201954397,32
0.05,1228,73,28131,22.8893409275834,28
0.05,1229,95,28226,22.947967479674798,6
0.05,1230,86,28312,22.99918765231519,14
0.05,1231,15,28327,22.992694805194805,85
0.05,1232,-13,28314,22.963503649635037,114
0.05,1233,43,28357,22.979740680713128,61
0.05,1234,78,28435,23.024291497975707,22
0.05,1235,-1,28434,23.00485436893204,38
0.05,1236,-164,28270,22.853678253839934,128
0.05,1237,85,28355,22.903877221324716,16
0.05,1238,6,28361,22.890234059725586,98
0.05,1239,21,28382,22.888709677419357,11
0.05,1240,79,28461,22.93392425463336,21
0.05,1241,92,28553,22.98953301127214,8
0.05,1242,-69,28484,22.91552695092518,185
0.05,1243,87,28571,22.967041800643088,14
0.05,1244,16,28587,22.96144578313253,87
0.05,1245,59,28646,22.990369181380416,42
0.05,1246,72,28718,23.029671210906177,29
0.05,1247,48,28766,23.049679487179485,52
0.05,1248,45,28811,23.067253803042433,55
0.05,1249,-97,28714,22.9712,60
0.05,1250,47,28761,22.99040767386091,54
0.05,1251,26,28787,22.992811501597444,77
0.05,1252,89,28876,23.045490822027134,11
0.05,1253,-38,28838,22.996810207336523,73
0.05,1254,-17,28821,22.964940239043823,49
0.05,1255,49,28870,22.985668789808916,51
0.05,1256,74,28944,23.026252983293556,26
0.05,1257,4,28948,23.01112877583466,96
0.05,1258,-161,28787,22.864972200158856,194
0.05,1259,90,28877,22.918253968253968,10
0.05,1260,-9,28868,22.892942109436955,41
0.05,1261,94,28962,22.949286846275754,7
0.05,1262,88,29050,23.00079176563737,12
0.05,1263,-14,29036,22.97151898734177,46
0.05,1264,87,29123,23.02213438735178,13
0.05,1265,-57,29066,22.958925750394943,157
0.05,1266,-92,28974,22.868192580899763,156
0.05,1267,72,29046,22.906940063091483,28
0.05,1268,-26,29020,22.868400315208827,126
0.05,1269,24,29044,22.869291338582677,76
0.05,1270,-125,28919,22.752950432730135,160
0.05,1271,82,29001,22.79952830188679,18
0.05,1272,94,29095,22.855459544383347,7
0.05,1273,61,29156,22.885400313971743,40
0.05,1274,78,29234,22.928627450980393,23
0.05,1275,84,29318,22.976489028213166,17
0.05,1276,-33,29285,22.93265465935787,135
0.05,1277,11,29296,22.923317683881063,91
0.05,1278,93,29389,22.97810789679437,8
0.05,1279,47,29436,22.996875,53
0.05,1280,91,29527,23.049960967993755,9
0.05,1281,94,29621,23.105304212168488,7
0.05,1282,94,29715,23.160561184723306,6
0.05,1283,84,29799,23.207943925233646,17
0.05,1284,-74,29725,23.132295719844358,198
0.05,1285,86,29811,23.18118195956454,15
0.05,1286,81,29892,23.226107226107224,21
0.05,1287,-32,29860,23.183229813664596,64
0.05,1288,-126,29734,23.067494181536073,158
0.05,1289,24,29758,23.068217054263567,8
0.05,1290,77,29835,23.109992254066615,23
0.05,1291,-138,29697,22.985294117647058,240
0.05,1292,-62,29635,22.91956689868523,167
0.05,1293,80,29715,22.963678516228747,20
0.05,1294,26,29741,22.966023166023167,76
0.05,1295,52,29793,22.988425925925927,48
0.05,1296,45,29838,23.005397070161912,55
0.05,1297,-131,29707,22.886748844375962,234
0.05,1298,-30,29677,22.846035411855272,62
0.05,1299,69,29746,22.88153846153846,31
0.05,1300,94,29840,22.93620292083013,7
0.05,1301,91,29931,22.98847926267281,10
0.05,1302,-49,29882,22.933231005372217,81
0.05,1303,18,29900,22.929447852760735,82
0.05,1304,-331,29569,22.65823754789272,183
0.05,1305,-125,29444,22.545176110260336,204
0.05,1306,-40,29404,22.497322111706197,73
0.05,1307,-73,29331,22.424311926605505,173
0.05,1308,-3,29328,22.40488922841864,35
0.05,1309,-64,29264,22.338931297709923,97
0.05,1310,47,29311,22.357742181540807,55
0.05,1311,59,29370,22.385670731707318,41
0.05,1312,15,29385,22.38004569687738,16
0.05,1313,-159,29226,22.24200913242009,193
0.05,1314,-137,29089,22.120912547528516,169
0.05,1315,-31,29058,22.080547112462007,134
0.05,1316,-100,28958,21.987851176917236,136
0.05,1317,80,29038,22.03186646433991,20
0.05,1318,1,29039,22.015921152388174,99
0.05,1319,87,29126,22.065151515151516,13
0.05,1320,5,29131,22.05223315669947,26
0.05,1321,19,29150,22.049924357034797,83
0.05,1322,63,29213,22.08087679516251,38
0.05,1323,51,29264,22.102719033232628,51
0.05,1324,90,29354,22.153962264150945,10
0.05,1325,53,29407,22.177224736048267,50
0.05,1326,-25,29382,22.141672946495856,126
0.05,1327,-56,29326,22.082831325301203,158
0.05,1328,80,29406,22.126410835214447,21
0.05,1329,84,29490,22.172932330827066,16
0.05,1330,29,29519,22.178061607813675,74
0.05,1331,71,29590,22.214714714714713,29
0.05,1332,55,29645,22.239309827456864,45
0.05,1333,39,29684,22.251874062968515,64
0.05,1334,-327,29357,21.990262172284645,221
0.05,1335,94,29451,22.044161676646706,6
0.05,1336,89,29540,22.094240837696336,12
0.05,1337,-29,29511,22.056053811659194,140
0.05,1338,72,29583,22.093353248693056,28
0.05,1339,-145,29438,21.96865671641791,246
0.05,1340,17,29455,21.964951528709918,84
0.05,1341,-220,29235,21.784649776453055,184
0.05,1342,72,29307,21.82204020848846,28
0.05,1343,64,29371,21.85342261904762,36
0.05,1344,88,29459,21.90260223048327,13
0.05,1345,-103,29356,21.809806835066865,77
0.05,1346,67,29423,21.843355605048256,33
0.05,1347,35,29458,21.85311572700297,65
0.05,1348,-19,29439,21.822831727205337,121
0.05,1349,91,29530,21.874074074074073,9
0.05,1350,-29,29501,21.83641746854182,60
0.05,1351,13,29514,21.829881656804734,88
0.05,1352,82,29596,21.874353288987436,20
0.05,1353,37,29633,21.885524372230428,63
0.05,1354,78,29711,21.926937269372694,23
0.05,1355,-2,29709,21.90929203539823,34
0.05,1356,84,29793,21.955047899778926,16
0.05,1357,39,29832,21.96759941089838,62
0.05,1358,30,29862,21.973509933774835,71
0.05,1359,74,29936,22.011764705882353,26
0.05,1360,-99,29837,21.922850844966938,201
0.05,1361,64,29901,21.95374449339207,37
0.05,1362,77,29978,21.99413059427733,34
0.05,1363,77,30055,22.034457478005866,24
0.05,1364,82,30137,22.078388278388278,18
0.05,1365,12,30149,22.071010248901903,88
0.05,1366,-45,30104,22.021945866861742,77
0.05,1367,63,30167,22.051900584795323,53
0.05,1368,88,30255,22.10007304601899,12
0.05,1369,80,30335,22.142335766423358,20
0.05,1370,-77,30258,22.070021881838073,40
0.05,1371,61,30319,22.098396501457724,40
0.05,1372,44,30363,22.114348142753094,57
0.05,1373,48,30411,22.133187772925766,53
0.05,1374,-304,30107,21.896,267
0.05,1375,-30,30077,21.85828488372093,132
0.05,1376,9,30086,21.848946986201888,93
0.05,1377,21,30107,21.84833091436865,81
0.05,1378,66,30173,21.88034807831762,34
0.05,1379,40,30213,21.893478260869564,63
0.05,1380,94,30307,21.94569152787835,7
0.05,1381,94,30401,21.99782923299566,6
0.05,1382,75,30476,22.036153289949386,26
0.05,1383,84,30560,22.08092485549133,17
0.05,1384,84,30644,22.125631768953067,16
0.05,1385,7,30651,22.114718614718615,95
0.05,1386,-49,30602,22.063446286950253,82
0.05,1387,82,30684,22.10662824207493,18
0.05,1388,83,30767,22.150467962562995,17
0.05,1389,94,30861,22.202158273381293,7
0.05,1390,-17,30844,22.173975557153128,118
0.05,1391,51,30895,22.194683908045977,51
0.05,1392,-43,30852,22.147882268485283,148
0.05,1393,12,30864,22.140602582496413,89
0.05,1394,91,30955,22.189964157706093,9
0.05,1395,85,31040,22.23495702005731,15
0.05,1396,93,31133,22.285612025769506,7
0.05,1397,-23,31110,22.253218884120173,56
0.05,1398,47,31157,22.270907791279484,54
0.05,1399,15,31172,22.265714285714285,86
0.05,1400,82,31254,22.30835117773019,18
0.05,1401,65,31319,22.33880171184023,35
0.05,1402,94,31413,22.389878831076267,7
0.05,1403,36,31449,22.39957264957265,64
0.05,1404,55,31504,22.422775800711744,45
0.05,1405,67,31571,22.45448079658606,47
0.05,1406,-63,31508,22.393745557924664,193
0.05,1407,11,31519,22.38565340909091,20
0.05,1408,76,31595,22.423704755145494,24
0.05,1409,-160,31435,22.29432624113475,201
0.05,1410,82,31517,22.336640680368532,18
0.05,1411,88,31605,22.38314447592068,12
0.05,1412,73,31678,22.418966737438076,28
0.05,1413,60,31738,22.445544554455445,49
0.05,1414,50,31788,22.465017667844524,50
0.05,1415,-6,31782,22.444915254237287,44
0.05,1416,58,31840,22.47000705716302,59
0.05,1417,-38,31802,22.427362482369535,69
0.05,1418,85,31887,22.471458773784356,16
0.05,1419,76,31963,22.509154929577466,24
0.05,1420,-25,31938,22.475721323011964,130
0.05,1421,78,32016,22.514767932489452,25
0.05,1422,14,32030,22.508784258608575,86
0.05,1423,83,32113,22.55126404494382,17
0.05,1424,95,32208,22.602105263157895,6
0.05,1425,89,32297,22.64866760168303,11
0.05,1426,59,32356,22.674141555711284,42
0.05,1427,69,32425,22.70658263305322,33
0.05,1428,33,32458,22.713785864240727,68
0.05,1429,71,32529,22.747552447552447,29
0.05,1430,44,32573,22.76240391334731,56
0.05,1431,4,32577,22.749301675977655,99
0.05,1432,-350,32227,22.489183531053733,319
0.05,1433,63,32290,22.517433751743376,38
0.05,1434,34,32324,22.525435540069687,66
0.05,1435,71,32395,22.559192200557103,29
0.05,1436,41,32436,22.572025052192068,59
0.05,1437,-255,32181,22.378998609179416,219
0.05,1438,95,32276,22.42946490618485,6
0.05,1439,-12,32264,22.405555555555555,44
0.05,1440,-14,32250,22.38029146426093,117
0.05,1441,11,32261,22.372399445214977,21
0.05,1442,89,32350,22.418572418572417,11
0.05,1443,-188,32162,22.27285318559557,223
0.05,1444,-9,32153,22.25121107266436,111
0.05,1445,50,32203,22.270401106500692,60
0.05,1446,89,32292,22.316516931582584,12
0.05,1447,73,32365,22.351519337016576,27
0.05,1448,73,32438,22.386473429951693,27
0.05,1449,57,32495,22.410344827586208,43
0.05,1450,61,32556,22.43694004135079,39
0.05,1451,94,32650,22.486225895316803,6
0.05,1452,-60,32590,22.429456297315898,162
0.05,1453,-28,32562,22.39477303988996,131
0.05,1454,93,32655,22.443298969072163,8
0.05,1455,71,32726,22.47664835164835,30
0.05,1456,-4,32722,22.45847632120796,105
0.05,1457,62,32784,22.48559670781893,38
0.05,1458,-32,32752,22.44825222755312,132
0.05,1459,6,32758,22.436986301369863,96
0.05,1460,22,32780,22.43668720054757,79
0.05,1461,83,32863,22.4781121751026,18
0.05,1462,68,32931,22.509227614490772,32
0.05,1463,37,32968,22.51912568306011,63
0.05,1464,-64,32904,22.460068259385665,167
0.05,1465,-106,32798,22.37244201909959,208
0.05,1466,90,32888,22.418541240627132,11
0.05,1467,72,32960,22.452316076294277,28
0.05,1468,67,33027,22.482641252552757,33
0.05,1469,29,33056,22.487074829931974,74
0.05,1470,-30,33026,22.45139360978926,132
0.05,1471,74,33100,22.48641304347826,27
0.05,1472,-8,33092,22.46571622539036,116
0.05,1473,-195,32897,22.318181818181817,295
0.05,1474,70,32967,22.35050847457627,31
0.05,1475,-28,32939,22.31639566395664,59
0.05,1476,89,33028,22.361543669600543,12
0.05,1477,-112,32916,22.27063599458728,215
0.05,1478,32,32948,22.277214334009464,69
0.05,1479,-37,32911,22.23716216216216,139
0.05,1480,62,32973,22.26401080351114,38
0.05,1481,-109,32864,22.17543859649123,142
0.05,1482,73,32937,22.209710047201618,28
0.05,1483,25,32962,22.211590296495956,76
0.05,1484,13,32975,22.205387205387204,88
0.05,1485,92,33067,22.25235531628533,8
0.05,1486,63,33130,22.279757901815735,46
0.05,1487,37,33167,22.289650537634408,63
0.05,1488,44,33211,22.30423102753526,57
0.05,1489,31,33242,22.31006711409396,70
0.05,1490,15,33257,22.305164319248828,17
0.05,1491,-112,33145,22.21514745308311,213
0.05,1492,85,33230,22.257200267916947,16
0.05,1493,73,33303,22.29116465863454,28
0.05,1494,-27,33276,22.25819397993311,132
0.05,1495,79,33355,22.296122994652407,21
0.05,1496,5,33360,22.284569138276552,95
0.05,1497,78,33438,22.321762349799734,23
0.05,1498,-9,33429,22.300867244829888,41
0.05,1499,52,33481,22.320666666666668,48
0.05,1500,52,33533,22.340439706862092,49
0.05,1501,66,33599,22.369507323568577,34
0.05,1502,10,33609,22.36127744510978,91
0.05,1503,3,33612,22.34840425531915,28
0.05,1504,57,33669,22.37142857142857,43
0.05,1505,-18,33651,22.344621513944222,118
0.05,1506,78,33729,22.381552753815527,23
0.05,1507,-47,33682,22.33554376657825,78
0.05,1508,93,33775,22.38237243207422,7
0.05,1509,-6,33769,22.363576158940397,108
0.05,1510,94,33863,22.41098610191926,6
0.05,1511,12,33875,22.40410052910053,88
0.05,1512,27,33902,22.40713813615334,75
0.05,1513,33,33935,22.414134742404226,68
0.05,1514,25,33960,22.415841584158414,76
0.05,1515,0,33960,22.401055408970976,31
0.05,1516,-71,33889,22.339485827290705,185
0.05,1517,50,33939,22.357707509881422,51
0.05,1518,81,34020,22.3963133640553,20
0.05,1519,9,34029,22.3875,93
0.05,1520,15,34044,22.382642998027613,86
0.05,1521,46,34090,22.398160315374508,55
0.05,1522,31,34121,22.40380827314511,79
0.05,1523,93,34214,22.4501312335958,8
0.05,1524,12,34226,22.44327868852459,89
0.05,1525,29,34255,22.447575360419396,78
0.05,1526,-54,34201,22.397511460379828,86
0.05,1527,-238,33963,22.227094240837697,204
0.05,1528,62,34025,22.25310660562459,38
0.05,1529,-45,33980,22.209150326797385,77
0.05,1530,48,34028,22.225996080992815,52
0.05,1531,84,34112,22.266318537859007,17
0.05,1532,95,34207,22.313763861709067,6
0.05,1533,76,34283,22.34876140808344,24
0.05,1534,78,34361,22.38501628664495,22
0.05,1535,-143,34218,22.27734375,188
0.05,1536,72,34290,22.309694209499025,29
0.05,1537,63,34353,22.336150845253577,38
0.05,1538,82,34435,22.37491877842755,19
0.05,1539,-144,34291,22.26688311688312,244
0.05,1540,57,34348,22.28942245295263,44
0.05,1541,78,34426,22.325551232166017,23
0.05,1542,52,34478,22.344782890473105,51
0.05,1543,50,34528,22.362694300518136,53
0.05,1544,-112,34416,22.275728155339806,144
0.05,1545,-33,34383,22.239974126778783,146
0.05,1546,-36,34347,22.202327084680025,68
0.05,1547,44,34391,22.21640826873385,56
0.05,1548,17,34408,22.213040671400904,85
0.05,1549,67,34475,22.241935483870968,40
0.05,1550,9,34484,22.23339780786589,120
0.05,1551,46,34530,22.248711340206185,54
0.05,1552,-179,34351,22.11912427559562,286
0.05,1553,72,34423,22.15122265122265,28
0.05,1554,-67,34356,22.09389067524116,168
0.05,1555,74,34430,22.127249357326477,26
0.05,1556,83,34513,22.166345536287732,17
0.05,1557,-43,34470,22.12451861360719,74
0.05,1558,-133,34337,22.025016035920462,166
0.05,1559,-55,34282,21.975641025641025,157
0.05,1560,5,34287,21.964766175528506,26
0.05,1561,-121,34166,21.87323943661972,153
0.05,1562,83,34249,21.91234804862444,18
0.05,1563,27,34276,21.915601023017903,76
0.05,1564,54,34330,21.936102236421725,46
0.05,1565,81,34411,21.973818646232438,19
0.05,1566,73,34484,22.006381620931716,28
0.05,1567,-85,34399,21.93813775510204,187
0.05,1568,-33,34366,21.903123008285533,133
0.05,1569,92,34458,21.947770700636944,8
0.05,1570,79,34537,21.98408656906429,21
0.05,1571,70,34607,22.014631043256998,31
0.05,1572,29,34636,22.019071837253655,72
0.05,1573,22,34658,22.019059720457435,78
0.05,1574,-20,34638,21.99238095238095,121
0.05,1575,-6,34632,21.9746192893401,38
0.05,1576,92,34724,22.019023462270134,8
0.05,1577,26,34750,22.021546261089988,75
0.05,1578,-5,34745,22.00443318556048,107
0.05,1579,84,34829,22.04367088607595,17
0.05,1580,39,34868,22.05439595192916,61
0.05,1581,74,34942,22.087231352718078,27
0.05,1582,84,35026,22.12634238787113,17
0.05,1583,71,35097,22.15719696969697,29
0.05,1584,81,35178,22.194321766561515,20
0.05,1585,-207,34971,22.04981084489281,244
0.05,1586,87,35058,22.090737240075615,13
0.05,1587,84,35142,22.129722921914357,17
0.05,1588,50,35192,22.147262429200754,51
0.05,1589,93,35285,22.19182389937107,7
0.05,1590,4,35289,22.1803896920176,97
0.05,1591,52,35341,22.199120603015075,48
0.05,1592,-40,35301,22.160075329566855,147
0.05,1593,9,35310,22.15181932245922,91
0.05,1594,-49,35261,22.10721003134796,83
0.05,1595,-172,35089,21.985588972431078,204
0.05,1596,68,35157,22.014402003757045,32
0.05,1597,80,35237,22.050688360450565,21
0.05,1598,76,35313,22.084427767354597,24
0.05,1599,94,35407,22.129375,7
0.05,1600,91,35498,22.172392254840723,10
0.05,1601,-38,35460,22.134831460674157,140
0.05,1602,74,35534,22.167186525265127,27
0.05,1603,-36,35498,22.130922693266832,139
0.05,1604,-25,35473,22.101557632398755,57
0.05,1605,88,35561,22.142590286425904,12
0.05,1606,-369,35192,21.899191039203483,475
0.05,1607,47,35239,21.914800995024876,54
0.05,1608,60,35299,21.938471100062152,41
0.05,1609,56,35355,21.959627329192546,45
0.05,1610,72,35427,21.990689013035382,28
0.05,1611,-12,35415,21.969602977667495,45
0.05,1612,-65,35350,21.915685058896464,97
0.05,1613,91,35441,21.958488228004956,10
0.05,1614,43,35484,21.971517027863776,58
0.05,1615,-64,35420,21.918316831683168,164
0.05,1616,87,35507,21.95856524427953,13
0.05,1617,76,35583,21.991965389369593,25
0.05,1618,77,35660,22.025941939468808,24
0.05,1619,39,35699,22.03641975308642,62
0.05,1620,77,35776,22.07032695866749,23
0.05,1621,89,35865,22.111590628853268,12
0.05,1622,69,35934,22.140480591497226,31
0.05,1623,78,36012,22.17487684729064,22
0.05,1624,85,36097,22.213538461538462,22
0.05,1625,-122,35975,22.124846248462486,157
0.05,1626,-31,35944,22.09219422249539,139
0.05,1627,-63,35881,22.03992628992629,96
0.05,1628,21,35902,22.03928790669122,81
0.05,1629,55,35957,22.059509202453988,45
0.05,1630,82,36039,22.096259963212752,18
0.05,1631,-25,36014,22.067401960784313,145
0.05,1632,25,36039,22.06919779546846,76
0.05,1633,85,36124,22.107711138310894,15
0.05,1634,59,36183,22.1302752293578,42
0.05,1635,89,36272,22.17114914425428,11
0.05,1636,-146,36126,22.068417837507635,113
0.05,1637,25,36151,22.07020757020757,75
0.05,1638,77,36228,22.10372178157413,24
0.05,1639,72,36300,22.134146341463413,28
0.05,1640,-54,36246,22.087751371115175,180
0.05,1641,8,36254,22.079171741778318,24
0.05,1642,64,36318,22.10468654899574,37
0.05,1643,67,36385,22.131995133819952,33
0.05,1644,9,36394,22.12401215805471,93
0.05,1645,-110,36284,22.043742405832322,212
0.05,1646,-8,36276,22.025500910746814,108
0.05,1647,82,36358,22.061893203883496,19
0.05,1648,-235,36123,21.90600363856883,269
0.05,1649,16,36139,21.902424242424242,87
0.05,1650,-22,36117,21.875832828588734,53
0.05,1651,93,36210,21.918886198547217,8
0.05,1652,44,36254,21.93224440411373,58
0.05,1653,55,36309,21.95223700120919,46
0.05,1654,15,36324,21.948036253776436,85
0.05,1655,89,36413,21.988526570048307,12
0.05,1656,28,36441,21.992154496077248,73
0.05,1657,76,36517,22.024728588661038,25
0.05,1658,94,36611,22.068113321277878,6
0.05,1659,-5,36606,22.051807228915663,37
0.05,1660,63,36669,22.076459963877184,38
0.05,1661,81,36750,22.111913357400724,19
0.05,1662,-56,36694,22.064942874323513,169
0.05,1663,-24,36670,22.037259615384617,57
0.05,1664,67,36737,22.064264264264263,33
0.05,1665,-7,36730,22.046818727490997,39
0.05,1666,-90,36640,21.979604079184163,195
0.05,1667,20,36660,21.97841726618705,81
0.05,1668,24,36684,21.9796285200719,76
0.05,1669,-19,36665,21.95508982035928,122
0.05,1670,-77,36588,21.895870736086177,182
0.05,1671,-105,36483,21.819976076555022,213
0.05,1672,86,36569,21.85833831440526,15
0.05,1673,68,36637,21.88590203106332,33
0.05,1674,26,36663,21.888358208955225,6
0.05,1675,71,36734,21.91766109785203,29
0.05,1676,66,36800,21.943947525342875,34
0.05,1677,86,36886,21.982121573301548,15
0.05,1678,43,36929,21.994639666468135,57
0.05,1679,-4,36925,21.979166666666668,106
0.05,1680,-48,36877,21.93753718024985,80
0.05,1681,35,36912,21.945303210463734,68
0.05,1682,88,37000,21.984551396316103,13
0.05,1683,-123,36877,21.898456057007127,223
0.05,1684,-113,36764,21.81839762611276,146
0.05,1685,79,36843,21.852313167259787,22
0.05,1686,58,36901,21.8737403675163,42
0.05,1687,-66,36835,21.821682464454977,167
0.05,1688,-119,36716,21.73830669034932,223
0.05,1689,-71,36645,21.683431952662723,103
0.05,1690,76,36721,21.715552927261975,26
0.05,1691,73,36794,21.745862884160758,27
0.05,1692,61,36855,21.7690490253987,39
0.05,1693,91,36946,21.8099173553719,10
0.05,1694,76,37022,21.841887905604718,25
0.05,1695,32,37054,21.847877358490567,70
0.05,1696,90,37144,21.888037713612256,11
0.05,1697,77,37221,21.920494699646643,23
0.05,1698,24,37245,21.921718658034138,78
0.05,1699,81,37326,21.956470588235295,19
0.05,1700,89,37415,21.995884773662553,11
0.05,1701,46,37461,22.009988249118685,55
0.05,1702,90,37551,22.04991192014093,10
0.05,1703,85,37636,22.086854460093896,16
0.05,1704,51,37687,22.103812316715544,49
0.05,1705,93,37780,22.145369284876907,8
0.05,1706,5,37785,22.135325131810195,95
0.05,1707,-34,37751,22.102459016393443,135
0.05,1708,-37,37714,22.06787595084845,140
0.05,1709,56,37770,22.087719298245613,46
0.05,1710,81,37851,22.122150789012274,20
0.05,1711,-25,37826,22.0946261682243,131
0.05,1712,7,37833,22.085814360770577,94
0.05,1713,29,37862,22.08984830805134,72
0.05,1714,71,37933,22.118367346938776,30
0.05,1715,-72,37861,22.063519813519815,105
0.05,1716,-67,37794,22.011648223645896,184
0.05,1717,-65,37729,21.961001164144353,198
0.05,1718,87,37816,21.998836532867948,14
0.05,1719,60,37876,22.02093023255814,41
0.05,1720,-84,37792,21.959325973271355,116
0.05,1721,65,37857,21.98432055749129,36
0.05,1722,80,37937,22.01799187463726,20
0.05,1723,-9,37928,22.0,141
0.05,1724,45,37973,22.013333333333332,56
0.05,1725,75,38048,22.044032444959445,26
0.05,1726,78,38126,22.076433121019107,23
0.05,1727,-126,38000,21.99074074074074,161
0.05,1728,88,38088,22.02891844997108,12
0.05,1729,25,38113,22.03063583815029,8
0.05,1730,95,38208,22.07279029462738,6
0.05,1731,46,38254,22.086605080831408,55
0.05,1732,-42,38212,22.049624927870745,143
0.05,1733,56,38268,22.069204152249135,45
0.05,1734,41,38309,22.080115273775217,59
0.05,1735,61,38370,22.102534562211982,41
0.05,1736,-39,38331,22.067357512953368,71
0.05,1737,77,38408,22.09896432681243,23
0.05,1738,21,38429,22.09833237492812,79
0.05,1739,-28,38401,22.069540229885057,130
0.05,1740,73,38474,22.09879379666858,27
0.05,1741,10,38484,22.091848450057405,91
0.05,1742,-103,38381,22.02008032128514,66
0.05,1743,94,38475,22.061353211009173,6
0.05,1744,29,38504,22.06532951289398,71
0.05,1745,91,38595,22.104810996563575,10
0.05,1746,-39,38556,22.06983400114482,71
0.05,1747,68,38624,22.096109839816933,32
0.05,1748,-163,38461,21.99028016009148,198
0.05,1749,73,38534,22.01942857142857,28
0.05,1750,32,38566,22.02512849800114,68
0.05,1751,37,38603,22.033675799086758,64
0.05,1752,88,38691,22.071306332002283,12
0.05,1753,12,38703,22.065564424173317,88
0.05,1754,66,38769,22.09059829059829,34
0.05,1755,-41,38728,22.054669703872438,73
0.05,1756,87,38815,22.09163346613546,14
0.05,1757,43,38858,22.103526734926053,58
0.05,1758,-90,38768,22.039795338260376,123
0.05,1759,-9,38759,22.022159090909092,41
0.05,1760,76,38835,22.05281090289608,25
0.05,1761,24,38859,22.053916004540294,78
0.05,1762,64,38923,22.07770845150312,37
0.05,1763,93,39016,22.117913832199548,8
0.05,1764,24,39040,22.11898016997167,78
0.05,1765,-127,38913,22.034541336353342,230
0.05,1766,44,38957,22.046972269383136,58
0.05,1767,-3,38954,22.032805429864254,34
0.05,1768,53,39007,22.05031091011871,48
0.05,1769,76,39083,22.080790960451978,25
0.05,1770,59,39142,22.10163749294184,42
0.05,1771,-19,39123,22.07844243792325,119
0.05,1772,1,39124,22.06655386350818,101
0.05,1773,51,39175,22.08286358511838,50
0.05,1774,-12,39163,22.063661971830985,115
0.05,1775,81,39244,22.096846846846848,19
0.05,1776,27,39271,22.099606077658976,75
0.05,1777,33,39304,22.105736782902138,68
0.05,1778,67,39371,22.1309724564362,38
0.05,1779,67,39438,22.156179775280897,33
0.05,1780,18,39456,22.153846153846153,84
0.05,1781,61,39517,22.17564534231201,39
0.05,1782,44,39561,22.187885586090857,57
0.05,1783,28,39589,22.191143497757846,72
0.05,1784,38,39627,22.2,63
0.05,1785,-228,39399,22.059910414333707,190
0.05,1786,-224,39175,21.922216004476777,192
0.05,1787,-108,39067,21.849552572706934,210
0.05,1788,35,39102,21.856903297931805,68
0.05,1789,-27,39075,21.829608938547487,59
0.05,1790,74,39149,21.858738135120046,27
0.05,1791,31,39180,21.863839285714285,69
0.05,1792,15,39195,21.860011154489683,91
0.05,1793,94,39289,21.900222965440356,7
0.05,1794,23,39312,21.9008356545961,79
0.05,1795,64,39376,21.924276169265035,36
0.05,1796,-43,39333,21.888146911519197,145
0.05,1797,-193,39140,21.768631813125694,159
0.05,1798,36,39176,21.776542523624236,66
0.05,1799,71,39247,21.80388888888889,30
0.05,1800,-236,39011,21.660744031093838,271
0.05,1801,63,39074,21.683684794672587,38
0.05,1802,90,39164,21.72157515252357,65
0.05,1803,53,39217,21.73891352549889,48
0.05,1804,88,39305,21.775623268698062,12
0.05,1805,-103,39202,21.706533776301217,205
0.05,1806,-83,39119,21.64858882125069,186
0.05,1807,69,39188,21.674778761061948,31
0.05,1808,-81,39107,21.618021006080706,114
0.05,1809,-44,39063,21.581767955801105,146
0.05,1810,16,39079,21.578685808945334,87
0.05,1811,36,39115,21.586644591611478,64
0.05,1812,93,39208,21.62603419746277,8
0.05,1813,92,39300,21.664829106945977,8
0.05,1814,82,39382,21.69807162534435,18
0.05,1815,77,39459,21.72852422907489,23
0.05,1816,25,39484,21.73032471106219,76
0.05,1817,-22,39462,21.706270627062707,125
0.05,1818,44,39506,21.71852666300165,57
0.05,1819,60,39566,21.73956043956044,41
0.05,1820,11,39577,21.733662822624932,21
0.05,1821,93,39670,21.77277716794731,7
0.05,1822,11,39681,21.766867800329127,93
0.05,1823,76,39757,21.796600877192983,25
0.05,1824,83,39840,21.83013698630137,18
0.05,1825,77,39917,21.860350492880613,24
0.05,1826,63,39980,21.882868089764642,37
0.05,1827,53,40033,21.89989059080963,48
0.05,1828,-156,39877,21.802624384909787,265
0.05,1829,-25,39852,21.777049180327868,57
0.05,1830,-34,39818,21.746586564718733,136
0.05,1831,47,39865,21.7603711790393,54
0.05,1832,73,39938,21.788325150027276,28
0.05,1833,29,39967,21.792257360959653,72
0.05,1834,57,40024,21.811444141689375,45
0.05,1835,94,40118,21.850762527233115,6
0.05,1836,87,40205,21.88622754491018,14
0.05,1837,95,40300,21.926006528835693,6
0.05,1838,41,40341,21.936378466557912,62
0.05,1839,-28,40313,21.909239130434784,77
0.05,1840,42,40355,21.920152091254753,58
0.05,1841,64,40419,21.94299674267101,37
0.05,1842,-28,40391,21.91589799240369,59
0.05,1843,65,40456,21.939262472885034,36
0.05,1844,70,40526,21.96531165311653,31
0.05,1845,57,40583,21.984290357529794,44
0.05,1846,79,40662,22.01515971846237,21
0.05,1847,89,40751,22.051406926406926,12
0.05,1848,17,40768,22.048674959437534,83
0.05,1849,-209,40559,21.923783783783783,309
0.05,1850,95,40654,21.963263101026474,6
0.05,1851,31,40685,21.968142548596113,70
0.05,1852,85,40770,22.00215866162979,16
0.05,1853,-32,40738,21.973031283710895,132
0.05,1854,-131,40607,21.890566037735848,233
0.05,1855,91,40698,21.927801724137932,9
0.05,1856,-6,40692,21.912762520193862,109
0.05,1857,-140,40552,21.82561894510226,173
0.05,1858,64,40616,21.848305540613232,36
0.05,1859,29,40645,21.852150537634408,71
0.05,1860,58,40703,21.871574422353575,43
0.05,1861,83,40786,21.904403866809883,18
0.05,1862,16,40802,21.901234567901234,16
0.05,1863,60,40862,21.92167381974249,42
0.05,1864,71,40933,21.94798927613941,30
0.05,1865,-50,40883,21.909431939978564,83
0.05,1866,65,40948,21.93251205141939,35
0.05,1867,-95,40853,21.869914346895076,197
0.05,1868,62,40915,21.89138576779026,40
0.05,1869,39,40954,21.90053475935829,62
0.05,1870,-10,40944,21.883484767504008,42
0.05,1871,91,41035,21.920405982905983,10
0.05,1872,39,41074,21.92952482648158,62
0.05,1873,12,41086,21.924226254002136,90
0.05,1874,91,41177,21.961066666666667,9
0.05,1875,-41,41136,21.927505330490405,144
0.05,1876,84,41220,21.96057538625466,17
0.05,1877,-56,41164,21.91906283280085,156
0.05,1878,-126,41038,21.840340606705695,160
0.05,1879,83,41121,21.87287234042553,18
0.05,1880,-68,41053,21.82509303561935,99
0.05,1881,92,41145,21.862380446333688,8
0.05,1882,89,41234,21.89803505045141,12
0.05,1883,81,41315,21.92940552016985,19
0.05,1884,38,41353,21.93793103448276,63
0.05,1885,93,41446,21.975609756097562,7
0.05,1886,4,41450,21.966083730789613,96
0.05,1887,28,41478,21.969279661016948,72
0.05,1888,66,41544,21.992588671254634,34
0.05,1889,24,41568,21.993650793650794,76
0.05,1890,92,41660,22.030671602326812,8
0.05,1891,6,41666,22.022198731501057,95
0.05,1892,65,41731,22.044902271526677,40
0.05,1893,-235,41496,21.909186906019006,200
0.05,1894,-137,41359,21.82532981530343,173
0.05,1895,80,41439,21.856012658227847,20
0.05,1896,41,41480,21.866104375329467,62
0.05,1897,-155,41325,21.77291886195996,119
0.05,1898,-153,41172,21.68088467614534,185
0.05,1899,58,41230,21.7,43
0.05,1900,17,41247,21.69752761704366,84
0.05,1901,90,41337,21.733438485804417,11
0.05,1902,5,41342,21.72464529689963,96
0.05,1903,-59,41283,21.682247899159663,91
0.05,1904,79,41362,21.712335958005248,23
0.05,1905,62,41424,21.733473242392446,38
0.05,1906,-67,41357,21.686942842160462,189
0.05,1907,95,41452,21.72536687631027,6
0.05,1908,-15,41437,21.706128863279204,47
0.05,1909,29,41466,21.709947643979056,73
0.05,1910,83,41549,21.742019884877028,17
0.05,1911,90,41639,21.777719665271967,11
0.05,1912,-28,41611,21.751698902247778,130
0.05,1913,-276,41335,21.596133751306166,315
0.05,1914,77,41412,21.625065274151435,23
0.05,1915,72,41484,21.65135699373695,28
0.05,1916,-46,41438,21.616066770996348,149
0.05,1917,-67,41371,21.569864442127216,101
0.05,1918,-42,41329,21.536737884314746,146
0.05,1919,85,41414,21.569791666666667,15
0.05,1920,75,41489,21.597605413846956,26
0.05,1921,78,41567,21.62695109261186,22
0.05,1922,-28,41539,21.60114404576183,131
0.05,1923,-31,41508,21.573804573804573,133
0.05,1924,84,41592,21.606233766233768,17
0.05,1925,76,41668,21.63447559709242,24
0.05,1926,25,41693,21.63622210690192,77
0.05,1927,88,41781,21.67064315352697,13
0.05,1928,88,41869,21.705028512182476,12
0.05,1929,-34,41835,21.67616580310881,135
0.05,1930,29,41864,21.67995857068876,73
0.05,1931,57,41921,21.69824016563147,43
0.05,1932,58,41979,21.717020175892394,44
0.05,1933,78,42057,21.74612202688728,23
0.05,1934,-37,42020,21.71576227390181,138
0.05,1935,45,42065,21.727789256198346,58
0.05,1936,40,42105,21.737222509034588,61
0.05,1937,64,42169,21.75902992776058,36
0.05,1938,30,42199,21.76328004125838,72
0.05,1939,72,42271,21.78917525773196,28
0.05,1940,11,42282,21.783616692426584,90
0.05,1941,8,42290,21.77651905252317,93
0.05,1942,89,42379,21.811116829644877,11
0.05,1943,-60,42319,21.769032921810698,161
0.05,1944,32,42351,21.774293059125963,68
0.05,1945,23,42374,21.77492291880781,80
0.05,1946,89,42463,21.80945043656908,12
0.05,1947,-121,42342,21.736139630390145,223
0.05,1948,85,42427,21.768599281682913,15
0.05,1949,26,42453,21.77076923076923,74
0.05,1950,-134,42319,21.690927729369555,99
0.05,1951,65,42384,21.71311475409836,35
0.05,1952,-30,42354,21.68663594470046,131
0.05,1953,4,42358,21.67758444216991,100
0.05,1954,74,42432,21.704347826086956,43
0.05,1955,-272,42160,21.554192229038854,379
0.05,1956,54,42214,21.57077158916709,46
0.05,1957,60,42274,21.590398365679263,40
0.05,1958,27,42301,21.59315977539561,85
0.05,1959,50,42351,21.60765306122449,51
0.05,1960,70,42421,21.6323304436512,31
0.05,1961,91,42512,21.667686034658512,10
0.05,1962,90,42602,21.70249617931737,10
0.05,1963,80,42682,21.732179226069245,21
0.05,1964,72,42754,21.757760814249362,29
0.05,1965,22,42776,21.75788402848423,93
0.05,1966,1,42777,21.747330960854093,102
0.05,1967,-96,42681,21.6875,202
0.05,1968,71,42752,21.712544438801423,29
0.05,1969,94,42846,21.749238578680202,6
0.05,1970,-63,42783,21.706240487062406,114
0.05,1971,-61,42722,21.664300202839758,93
0.05,1972,-152,42570,21.576279776989356,256
0.05,1973,92,42662,21.61195542046606,8
0.05,1974,-97,42565,21.551898734177215,199
0.05,1975,36,42601,21.55921052631579,65
0.05,1976,-29,42572,21.533636823469905,130
0.05,1977,77,42649,21.561678463094033,24
0.05,1978,55,42704,21.578575037897927,45
0.05,1979,55,42759,21.595454545454544,47
0.05,1980,71,42830,21.620393740535082,29
0.05,1981,10,42840,21.614530776992936,91
0.05,1982,75,42915,21.64145234493192,26
0.05,1983,64,42979,21.66280241935484,37
0.05,1984,91,43070,21.697732997481108,10
0.05,1985,-65,43005,21.654078549848943,97
0.05,1986,87,43092,21.686965274282837,14
0.05,1987,20,43112,21.686116700201207,11
0.05,1988,84,43196,21.71744595274007,18
0.05,1989,95,43291,21.75427135678392,6
0.05,1990,-223,43068,21.63134103465595,328
0.05,1991,-161,42907,21.539658634538153,195
0.05,1992,-49,42858,21.50426492724536,154
0.05,1993,19,42877,21.503009027081244,82
0.05,1994,90,42967,21.53734335839599,10
0.05,1995,86,43053,21.569639278557116,14
0.05,1996,94,43147,21.605908863294943,6
0.05,1997,65,43212,21.62762762762763,35
0.05,1998,-44,43168,21.59479739869935,75
0.05,1999,-45,43123,21.5615,145
0.05,2000,-42,43081,21.529735132433782,144
0.05,2001,74,43155,21.555944055944057,26
0.05,2002,93,43248,21.591612581128306,7
0.05,2003,93,43341,21.627245508982035,7
0.05,2004,69,43410,21.65087281795511,31
0.05,2005,66,43476,21.67298105682951,68
0.05,2006,69,43545,21.696562032884902,32
0.05,2007,74,43619,21.72260956175299,26
0.05,2008,92,43711,21.757590841214533,9
0.05,2009,94,43805,21.79353233830846,6
0.05,2010,-149,43656,21.708602685231227,287
0.05,2011,85,43741,21.740059642147116,15
0.05,2012,-3,43738,21.727769498261303,105
0.05,2013,7,43745,21.720456802383318,96
0.05,2014,52,43797,21.73548387096774,49
0.05,2015,-24,43773,21.71279761904762,126
0.05,2016,42,43815,21.722855726326227,58
0.05,2017,35,43850,21.729435084241825,66
0.05,2018,12,43862,21.724616146607232,92
0.05,2019,-46,43816,21.69108910891089,81
0.05,2020,-215,43601,21.57397328055418,295
0.05,2021,68,43669,21.596933728981206,32
0.05,2022,-44,43625,21.564508156203658,146
0.05,2023,50,43675,21.578557312252965,50
0.05,2024,89,43764,21.611851851851853,12
0.05,2025,72,43836,21.636722606120433,29
0.05,2026,-10,43826,21.62111494819931,56
0.05,2027,10,43836,21.615384615384617,21
0.05,2028,-175,43661,21.51848201084278,210
0.05,2029,18,43679,21.516748768472905,84
0.05,2030,-92,43587,21.460856720827177,200
0.05,2031,-49,43538,21.426181102362204,17
0.05,2032,39,43577,21.434825381210036,63
0.05,2033,36,43613,21.44198623402163,65
0.05,2034,91,43704,21.476167076167076,11
0.05,2035,92,43796,21.51080550098232,8
0.05,2036,89,43885,21.543937162493865,11
0.05,2037,76,43961,21.570657507360156,25
0.05,2038,71,44032,21.594899460519862,30
0.05,2039,-23,44009,21.573039215686276,130
0.05,2040,44,44053,21.584027437530622,57
0.05,2041,56,44109,21.600881488736533,44
0.05,2042,18,44127,21.599118942731277,84
0.05,2043,43,44170,21.60958904109589,58
0.05,2044,78,44248,21.63716381418093,22
0.05,2045,69,44317,21.660312805474096,32
0.05,2046,75,44392,21.68637029799707,26
0.05,2047,60,44452,21.705078125,40
0.05,2048,22,44474,21.70522205954124,10
0.05,2049,90,44564,21.738536585365853,11
0.05,2050,73,44637,21.76352998537299,28
0.05,2051,64,44701,21.78411306042885,37
0.05,2052,-1,44700,21.773015099853872,101
0.05,2053,-197,44503,21.666504381694256,377
0.05,2054,82,44585,21.695863746958636,20
0.05,2055,-30,44555,21.670719844357976,132
0.05,2056,90,44645,21.70393777345649,11
0.05,2057,68,44713,21.726433430515062,33
0.05,2058,20,44733,21.72559494900437,82
0.05,2059,31,44764,21.730097087378642,70
0.05,2060,14,44778,21.726346433770015,86
0.05,2061,27,44805,21.72890397672163,76
0.05,2062,43,44848,21.73921473582162,58
0.05,2063,72,44920,21.76356589147287,36
0.05,2064,94,45014,21.798547215496367,7
0.05,2065,-73,44941,21.752662149080347,199
0.05,2066,76,45017,21.77890662796323,25
0.05,2067,46,45063,21.790618955512574,54
0.05,2068,-66,44997,21.74818753020783,98
0.05,2069,64,45061,21.768599033816425,36
0.05,2070,68,45129,21.790922259777886,33
0.05,2071,60,45189,21.809362934362934,41
0.05,2072,88,45277,21.841292812349252,12
0.05,2073,26,45303,21.843297974927676,104
0.05,2074,5,45308,21.835180722891565,98
0.05,2075,15,45323,21.831888246628132,87
0.05,2076,61,45384,21.850746268656717,39
0.05,2077,95,45479,21.885948026948988,6
0.05,2078,0,45479,21.875420875420875,31
0.05,2079,62,45541,21.89471153846154,39
0.05,2080,83,45624,21.924074963959633,17
0.05,2081,-52,45572,21.888568683957732,89
0.05,2082,86,45658,21.919347095535286,14
0.05,2083,66,45724,21.940499040307103,34
0.05,2084,-119,45605,21.872901678657076,82
0.05,2085,-197,45408,21.767976989453498,305
0.05,2086,-68,45340,21.72496406324868,101
0.05,2087,-18,45322,21.705938697318008,51
0.05,2088,62,45384,21.72522738152226,39
0.05,2089,7,45391,21.71818181818182,96
0.05,2090,-178,45213,21.62266857962697,281
0.05,2091,53,45266,21.637667304015295,48
0.05,2092,-161,45105,21.550406115623506,196
0.05,2093,76,45181,21.576408787010507,25
0.05,2094,41,45222,21.585680190930788,61
0.05,2095,-162,45060,21.498091603053435,262
0.05,2096,-21,45039,21.477825464949927,52
0.05,2097,-172,44867,21.38560533841754,277
0.05,2098,9,44876,21.379704621248212,92
0.05,2099,-47,44829,21.347142857142856,78
0.05,2100,58,44887,21.364588291289863,43
0.05,2101,37,44924,21.372026641294006,63
0.05,2102,-83,44841,21.322396576319544,116
0.05,2103,-92,44749,21.268536121673005,195
0.05,2104,28,44777,21.271733966745842,73
0.05,2105,-69,44708,21.228869895536562,103
0.05,2106,-41,44667,21.19933554817276,143
0.05,2107,69,44736,21.22201138519924,31
0.05,2108,-9,44727,21.207681365576104,109
0.05,2109,39,44766,21.21611374407583,62
0.05,2110,-46,44720,21.18427285646613,78
0.05,2111,-43,44677,21.153882575757574,143
0.05,2112,74,44751,21.178892569805964,27
0.05,2113,83,44834,21.208136234626302,18
0.05,2114,42,44876,21.217966903073286,58
0.05,2115,-11,44865,21.20274102079395,44
0.05,2116,89,44954,21.23476617855456,12
0.05,2117,-13,44941,21.218602455146364,59
0.05,2118,36,44977,21.225578102878718,65
0.05,2119,90,45067,21.258018867924527,11
0.05,2120,-43,45024,21.22772277227723,146
0.05,2121,45,45069,21.238925541941565,55
0.05,2122,32,45101,21.24399434762129,69
0.05,2123,94,45195,21.278248587570623,6
0.05,2124,85,45280,21.308235294117647,16
0.05,2125,78,45358,21.334901222953903,54
0.05,2126,-19,45339,21.315937940761636,121
0.05,2127,84,45423,21.345394736842106,17
0.05,2128,52,45475,21.359793330201974,50
0.05,2129,-6,45469,21.346948356807513,107
0.05,2130,69,45538,21.36931018301267,31
0.05,2131,-262,45276,21.23639774859287,294
0.05,2132,15,45291,21.233473980309423,100
0.05,2133,83,45374,21.262417994376758,17
0.05,2134,33,45407,21.26791569086651,69
0.05,2135,18,45425,21.26638576779026,84
0.05,2136,-64,45361,21.226485727655593,96
0.05,2137,-51,45310,21.19270346117867,153
0.05,2138,78,45388,21.219261337073398,23
0.05,2139,29,45417,21.222897196261684,73
0.05,2140,-184,45233,21.12704343764596,289
0.05,2141,83,45316,21.15592903828198,18
0.05,2142,47,45363,21.167988800746617,54
0.05,2143,67,45430,21.18936567164179,34
0.05,2144,-15,45415,21.172494172494172,117
0.05,2145,38,45453,21.180335507921715,63
0.05,2146,71,45524,21.20353982300885,29
0.05,2147,84,45608,21.232774674115458,17
0.05,2148,4,45612,21.224755700325733,97
0.05,2149,41,45653,21.233953488372094,59
0.05,2150,44,45697,21.244537424453743,56
0.05,2151,51,45748,21.25836431226766,49
0.05,2152,33,45781,21.263817928471898,68
0.05,2153,76,45857,21.289229340761374,25
0.05,2154,-34,45823,21.26357308584687,67
0.05,2155,79,45902,21.290352504638218,21
0.05,2156,33,45935,21.295781177561427,68
0.05,2157,72,46007,21.319277108433734,29
0.05,2158,57,46064,21.335803612783696,44
0.05,2159,63,46127,21.35509259259259,39
0.05,2160,50,46177,21.368347987043034,50
0.05,2161,-36,46141,21.3418131359852,137
0.05,2162,9,46150,21.336107258437355,94
0.05,2163,-130,46020,21.266173752310536,164
0.05,2164,47,46067,21.278060046189378,54
0.05,2165,21,46088,21.277931671283472,80
0.05,2166,60,46148,21.295800646054452,42
0.05,2167,12,46160,21.29151291512915,91
0.05,2168,83,46243,21.319963116643613,17
0.05,2169,-22,46221,21.3,124
0.05,2170,68,46289,21.321510824504838,32
0.05,2171,81,46370,21.348987108655617,20
0.05,2172,50,46420,21.362172112287162,51
0.05,2173,63,46483,21.38132474701012,38
0.05,2174,75,46558,21.405977011494254,25
0.05,2175,17,46575,21.40395220588235,15
0.05,2176,-14,46561,21.38768948093707,115
0.05,2177,-55,46506,21.352617079889807,159
0.05,2178,70,46576,21.37494263423589,31
0.05,2179,-13,46563,21.359174311926605,114
0.05,2180,76,46639,21.384227418615314,25
0.05,2181,-36,46603,21.357928505957837,67
0.05,2182,68,46671,21.379294548786074,32
0.05,2183,73,46744,21.4029304029304,27
0.05,2184,4,46748,21.394965675057207,28
0.05,2185,55,46803,21.410338517840806,47
0.05,2186,-61,46742,21.37265660722451,162
0.05,2187,18,46760,21.37111517367459,84
0.05,2188,30,46790,21.37505710370032,70
0.05,2189,35,46825,21.381278538812786,71
0.05,2190,71,46896,21.403925148334093,29
0.05,2191,41,46937,21.41286496350365,59
0.05,2192,-5,46932,21.400820793433653,36
0.05,2193,52,46984,21.414767547857792,60
0.05,2194,35,47019,21.420956719817767,67
0.05,2195,-6,47013,21.40846994535519,109
0.05,2196,79,47092,21.43468365953573,22
0.05,2197,-53,47039,21.400818926296633,157
0.05,2198,-9,47030,21.38699408822192,112
0.05,2199,63,47093,21.40590909090909,43
0.05,2200,54,47147,21.42071785552022,47
0.05,2201,-151,46996,21.342415985467756,255
0.05,2202,68,47064,21.36359509759419,33
0.05,2203,90,47154,21.394736842105264,11
0.05,2204,-45,47109,21.364625850340136,77
0.05,2205,11,47120,21.359927470534906,20
0.05,2206,-31,47089,21.33620299048482,133
0.05,2207,72,47161,21.359148550724637,28
0.05,2208,49,47210,21.37166138524219,51
0.05,2209,67,47277,21.392307692307693,33
0.05,2210,83,47360,21.42017186793306,17
0.05,2211,42,47402,21.429475587703436,59
0.05,2212,90,47492,21.460460912788072,11
0.05,2213,28,47520,21.463414634146343,74
0.05,2214,-63,47457,21.42528216704289,95
0.05,2215,84,47541,21.45351985559567,17
0.05,2216,88,47629,21.483536310329274,13
0.05,2217,59,47688,21.50045085662759,44
0.05,2218,28,47716,21.503379900856242,72
0.05,2219,53,47769,21.517567567567568,48
0.05,2220,20,47789,21.516884286357495,82
0.05,2221,68,47857,21.537803780378038,33
0.05,2222,58,47915,21.55420602789024,42
0.05,2223,-35,47880,21.528776978417266,68
0.05,2224,-75,47805,21.485393258426967,108
0.05,2225,-2,47803,21.4748427672956,104
0.05,2226,-81,47722,21.42882801975752,182
0.05,2227,90,47812,21.45960502692998,11
0.05,2228,9,47821,21.454015253476896,40
0.05,2229,-3,47818,21.44304932735426,105
0.05,2230,24,47842,21.444195428059167,77
0.05,2231,87,47929,21.47356630824373,13
0.05,2232,-10,47919,21.459471562919838,111
0.05,2233,91,48010,21.49059982094897,9
0.05,2234,-12,47998,21.475615212527963,44
0.05,2235,34,48032,21.481216457960645,67
0.05,2236,57,48089,21.49709432275369,61
0.05,2237,48,48137,21.50893655049151,52
0.05,2238,22,48159,21.50915587315766,13
0.05,2239,21,48180,21.508928571428573,79
0.05,2240,-33,48147,21.484605087014724,134
0.05,2241,-71,48076,21.44335414808207,175
0.05,2242,90,48166,21.47391885867142,10
0.05,2243,80,48246,21.5,20
0.05,2244,86,48332,21.528730512249442,14
0.05,2245,12,48344,21.524487978628674,19
0.05,2246,7,48351,21.518024032042725,96
0.05,2247,-62,48289,21.480871886120998,94
0.05,2248,78,48367,21.50600266785238,23
0.05,2249,91,48458,21.53688888888889,10
0.05,2250,-398,48060,21.350510884051534,439
0.05,2251,79,48139,21.376110124333927,22
0.05,2252,63,48202,21.394584997780736,37
0.05,2253,35,48237,21.400621118012424,65
0.05,2254,45,48282,21.411086474501108,55
0.05,2255,-247,48035,21.292109929078013,281
0.05,2256,69,48104,21.313247673903412,33
0.05,2257,-10,48094,21.29937998228521,144
0.05,2258,77,48171,21.324037184594953,24
0.05,2259,78,48249,21.34911504424779,22
0.05,2260,67,48316,21.369305616983635,34
0.05,2261,60,48376,21.386383731211318,40
0.05,2262,83,48459,21.413610251878037,18
0.05,2263,48,48507,21.425353356890458,53
0.05,2264,17,48524,21.423399558498897,15
0.05,2265,12,48536,21.419240953221536,89
0.05,2266,79,48615,21.444640494044993,21
0.05,2267,82,48697,21.471340388007054,18
0.05,2268,34,48731,21.47686205376818,68
0.05,2269,88,48819,21.506167400881058,12
0.05,2270,34,48853,21.51166886833994,66
0.05,2271,92,48945,21.542693661971832,8
0.05,2272,-30,48915,21.520017597888252,132
0.05,2273,29,48944,21.52330694810906,72
0.05,2274,50,48994,21.535824175824175,51
0.05,2275,-104,48890,21.48066783831283,143
0.05,2276,-98,48792,21.428194993412383,133
0.05,2277,93,48885,21.459613696224757,7
0.05,2278,-102,48783,21.40544098288723,136
0.05,2279,-77,48706,21.362280701754386,185
0.05,2280,81,48787,21.38842612889084,20
0.05,2281,-43,48744,21.360210341805434,144
0.05,2282,-106,48638,21.30442400350416,212
0.05,2283,12,48650,21.300350262697023,91
0.05,2284,21,48671,21.300218818380745,79
0.05,2285,70,48741,21.321522309711288,30
0.05,2286,-219,48522,21.216440752076956,263
0.05,2287,67,48589,21.23645104895105,33
0.05,2288,-107,48482,21.180428134556575,140
0.05,2289,62,48544,21.19825327510917,38
0.05,2290,93,48637,21.229594063727628,7
0.05,2291,21,48658,21.229493891797556,82
0.05,2292,-90,48568,21.18098560837331,121
0.05,2293,-70,48498,21.141238012205754,104
0.05,2294,88,48586,21.17037037037037,13
0.05,2295,79,48665,21.195557491289197,32
0.05,2296,5,48670,21.188506747932085,96
0.05,2297,-6,48664,21.17667536988686,109
0.05,2298,50,48714,21.189212701174423,58
0.05,2299,91,48805,21.219565217391306,10
0.05,2300,73,48878,21.24206866579748,28
0.05,2301,18,48896,21.24066029539531,112
0.05,2302,67,48963,21.26052974381242,34
0.05,2303,75,49038,21.283854166666668,25
0.05,2304,-218,48820,21.18004338394794,181
0.05,2305,-17,48803,21.163486556808326,121
0.05,2306,-257,48546,21.042912873862157,291
0.05,2307,-55,48491,21.009965337954938,165
0.05,2308,-9,48482,20.996968384582072,113
0.05,2309,-185,48297,20.90779220779221,295
0.05,2310,20,48317,20.907399394201644,12
0.05,2311,-69,48248,20.868512110726645,174
0.05,2312,-57,48191,20.834846519671423,165
0.05,2313,17,48208,20.833189282627483,83
0.05,2314,-1,48207,20.82375809935205,102
0.05,2315,26,48233,20.825993091537132,76
0.05,2316,-35,48198,20.801899007337074,67
0.05,2317,-7,48191,20.78990509059534,109
0.05,2318,80,48271,20.815437688658903,20
0.05,2319,55,48326,20.830172413793104,46
0.05,2320,35,48361,20.83627746660922,67
0.05,2321,83,48444,20.863049095607234,18
0.05,2322,24,48468,20.864399483426602,95
0.05,2323,80,48548,20.889845094664373,20
0.05,2324,55,48603,20.90451612903226,45
0.05,2325,16,48619,20.902407566638004,85
0.05,2326,87,48706,20.93081220455522,14
0.05,2327,29,48735,20.934278350515463,71
0.05,2328,87,48822,20.96264491197939,13
0.05,2329,-74,48748,20.921888412017168,111
0.05,2330,95,48843,20.953667953667953,6
0.05,2331,85,48928,20.9811320754717,15
0.05,2332,-125,48803,20.91855979425632,91
0.05,2333,88,48891,20.947300771208226,12
0.05,2334,47,48938,20.95845824411135,53
0.05,2335,54,48992,20.972602739726028,46
0.05,2336,2,48994,20.96448438168592,30
0.05,2337,66,49060,20.983746792130027,34
0.05,2338,-43,49017,20.956391620350576,143
0.05,2339,91,49108,20.986324786324786,10
0.05,2340,-1,49107,20.976932934643315,103
0.05,2341,70,49177,20.997865072587533,30
0.05,2342,-118,49059,20.93854033290653,156
0.05,2343,51,49110,20.95136518771331,52
0.05,2344,18,49128,20.950106609808103,83
0.05,2345,56,49184,20.965046888320547,46
0.05,2346,19,49203,20.964209629314016,84
0.05,2347,83,49286,20.990630323679728,18
0.05,2348,78,49364,21.014899957428693,22
0.05,2349,53,49417,21.028510638297874,47
0.05,2350,57,49474,21.04381114419396,44
0.05,2351,83,49557,21.070153061224488,17
0.05,2352,-113,49444,21.013174670633234,144
0.05,2353,90,49534,21.04248088360238,10
0.05,2354,-170,49364,20.96135881104034,205
0.05,2355,-22,49342,20.943123938879456,122
0.05,2356,61,49403,20.96011879507849,40
0.05,2357,76,49479,20.983460559796438,25
0.05,2358,30,49509,20.987282746926663,73
0.05,2359,-174,49335,20.904661016949152,297
0.05,2360,68,49403,20.924608216857266,32
0.05,2361,39,49442,20.932260795935647,61
0.05,2362,66,49508,20.951333051206095,35
0.05,2363,-1,49507,20.942047377326563,102
0.05,2364,6,49513,20.935729386892177,94
0.05,2365,82,49595,20.96153846153846,18
0.05,2366,92,49687,20.991550485847064,9
0.05,2367,61,49748,21.008445945945947,39
0.05,2368,62,49810,21.025749261291683,38
0.05,2369,64,49874,21.043881856540086,37
0.05,2370,94,49968,21.0746520455504,7
0.05,2371,18,49986,21.07335581787521,85
0.05,2372,91,50077,21.102823430257057,9
0.05,2373,50,50127,21.114995787700085,50
0.05,2374,52,50179,21.128,49
0.05,2375,46,50225,21.138468013468014,55
0.05,2376,95,50320,21.16954143878839,6
0.05,2377,7,50327,21.163582842724978,97
0.05,2378,40,50367,21.171500630517023,62
0.05,2379,64,50431,21.189495798319328,36
0.05,2380,1,50432,21.181016379672407,103
0.05,2381,21,50453,21.18094038623006,79
0.05,2382,85,50538,21.207721359630717,16
0.05,2383,-44,50494,21.18036912751678,84
0.05,2384,57,50551,21.19538784067086,43
0.05,2385,-125,50426,21.13411567476949,89
0.05,2386,3,50429,21.126518642647675,99
0.05,2387,85,50514,21.15326633165829,15
0.05,2388,91,50605,21.182503139388867,10
0.05,2389,49,50654,21.194142259414225,52
0.05,2390,35,50689,21.199916352990382,68
0.05,2391,82,50771,21.225334448160535,18
0.05,2392,86,50857,21.252402841621397,14
0.05,2393,-63,50794,21.217209690893903,165
0.05,2394,-6,50788,21.205845511482256,126
0.05,2395,11,50799,21.20158597662771,90
0.05,2396,68,50867,21.221109720483938,32
0.05,2397,80,50947,21.245621351125937,20
0.05,2398,85,51032,21.272196748645268,16
0.05,2399,72,51104,21.293333333333333,29
0.05,2400,26,51130,21.295293627655145,74
0.05,2401,85,51215,21.3218151540383,15
0.05,2402,48,51263,21.33291718684977,52
0.05,2403,95,51358,21.363560732113143,6
0.05,2404,5,51363,21.356756756756756,26
0.05,2405,94,51457,21.386949293433084,6
0.05,2406,78,51535,21.410469464063148,22
0.05,2407,-55,51480,21.37873754152824,166
0.05,2408,90,51570,21.40722291407223,11
0.05,2409,-45,51525,21.37966804979253,79
0.05,2410,54,51579,21.39319784321858,46
0.05,2411,70,51649,21.41334991708126,30
0.05,2412,-37,51612,21.389142146705346,153
0.05,2413,23,51635,21.38980944490472,9
0.05,2414,57,51692,21.40455486542443,45
0.05,2415,82,51774,21.429635761589402,18
0.05,2416,13,51787,21.426148117501036,88
0.05,2417,65,51852,21.444168734491313,36
0.05,2418,85,51937,21.47044233154196,16
0.05,2419,68,52005,21.489669421487605,33
0.05,2420,-113,51892,21.43411813300289,145
0.05,2421,64,51956,21.451692815854667,36
0.05,2422,-30,51926,21.430458109781263,148
0.05,2423,40,51966,21.43811881188119,60
0.05,2424,85,52051,21.464329896907216,16
0.05,2425,-46,52005,21.436521022258862,78
0.05,2426,-62,51943,21.402142562834776,94
0.05,2427,41,51984,21.410214168039538,60
0.05,2428,61,52045,21.42651296829971,42
0.05,2429,60,52105,21.44238683127572,41
0.05,2430,79,52184,21.466063348416288,21
0.05,2431,28,52212,21.46875,72
0.05,2432,76,52288,21.491163173037403,25
0.05,2433,64,52352,21.50862777321282,36
0.05,2434,-140,52212,21.442299794661192,245
0.05,2435,48,52260,21.45320197044335,55
0.05,2436,58,52318,21.46819860484202,49
0.05,2437,80,52398,21.492206726825266,21
0.05,2438,-13,52385,21.478064780647806,126
0.05,2439,18,52403,21.476639344262296,13
0.05,2440,92,52495,21.505530520278576,9
0.05,2441,-23,52472,21.487305487305488,125
0.05,2442,26,52498,21.48915268112976,74
0.05,2443,52,52550,21.50163666121113,48
0.05,2444,-30,52520,21.480572597137016,133
0.05,2445,53,52573,21.49345870809485,47
0.05,2446,94,52667,21.523089497343687,7
0.05,2447,94,52761,21.55269607843137,6
0.05,2448,80,52841,21.576561861984484,20
0.05,2449,79,52920,21.6,22
0.05,2450,83,53003,21.625050999592002,18
0.05,2451,82,53085,21.649673735725937,18
0.05,2452,-28,53057,21.629433346922138,134
0.05,2453,59,53116,21.644661776691116,41
0.05,2454,-82,53034,21.60244399185336,182
0.05,2455,74,53108,21.623778501628664,27
0.05,2456,90,53198,21.65160765160765,11
0.05,2457,62,53260,21.668022782750203,38
0.05,2458,-76,53184,21.628304188694592,109
0.05,2459,-19,53165,21.61178861788618,52
0.05,2460,92,53257,21.640390085331166,9
0.05,2461,9,53266,21.635255889520714,92
0.05,2462,45,53311,21.644742184328056,56
0.05,2463,79,53390,21.66801948051948,21
0.05,2464,49,53439,21.679107505070995,53
0.05,2465,-18,53421,21.66301703163017,119
0.05,2466,89,53510,21.690312119983787,12
0.05,2467,91,53601,21.71839546191248,10
0.05,2468,24,53625,21.71931956257594,78
0.05,2469,-51,53574,21.689878542510122,86
0.05,2470,54,53628,21.702954269526508,47
0.05,2471,82,53710,21.727346278317153,19
0.05,2472,64,53774,21.74443995147594,37
0.05,2473,56,53830,21.758286176232822,45
0.05,2474,-165,53665,21.682828282828282,129
0.05,2475,84,53749,21.70799676898223,17
0.05,2476,72,53821,21.728300363342754,28
0.05,2477,-54,53767,21.69774011299435,154
0.05,2478,36,53803,21.70350947962888,66
0.05,2479,7,53810,21.697580645161292,97
0.05,2480,65,53875,21.71503426037888,35
0.05,2481,41,53916,21.722804190169217,59
0.05,2482,87,54003,21.749093838099075,14
0.05,2483,5,54008,21.74235104669887,96
0.05,2484,-148,53860,21.67404426559356,181
0.05,2485,66,53926,21.69187449718423,36
0.05,2486,58,53984,21.70647366304785,42
0.05,2487,85,54069,21.731913183279744,15
0.05,2488,27,54096,21.73402973081559,73
0.05,2489,-129,53967,21.673493975903614,163
0.05,2490,28,53995,21.67603372139703,72
0.05,2491,68,54063,21.6946227929374,33
0.05,2492,87,54150,21.7208182912154,14
0.05,2493,62,54212,21.736968724939857,39
0.05,2494,32,54244,21.741082164328656,69
0.05,2495,87,54331,21.767227564102566,13
0.05,2496,-121,54210,21.71005206247497,224
0.05,2497,86,54296,21.735788630904725,14
0.05,2498,-71,54225,21.698679471788715,171
0.05,2499,-133,54092,21.6368,98
0.05,2500,20,54112,21.636145541783286,81
0.05,2501,-84,54028,21.593924860111912,184
0.05,2502,83,54111,21.618457850579304,19
0.05,2503,70,54181,21.637779552715656,30
0.05,2504,80,54261,21.66107784431138,21
0.05,2505,74,54335,21.68196328810854,26
0.05,2506,-112,54223,21.6286398085361,146
0.05,2507,-33,54190,21.606858054226475,65
0.05,2508,94,54284,21.63571143882025,6
0.05,2509,-127,54157,21.57649402390438,158
0.05,2510,76,54233,21.598168060533652,24
0.05,2511,-170,54063,21.5218949044586,134
0.05,2512,80,54143,21.54516514126542,20
0.05,2513,46,54189,21.55489260143198,56
0.05,2514,82,54271,21.57892644135189,19
0.05,2515,4,54275,21.57193958664547,29
0.05,2516,18,54293,21.57052046086611,83
0.05,2517,95,54388,21.599682287529784,6
0.05,2518,-20,54368,21.58316792377928,52
0.05,2519,83,54451,21.60753968253968,18
0.05,2520,-96,54355,21.56088853629512,199
0.05,2521,83,54438,21.58524980174465,17
0.05,2522,88,54526,21.611573523583036,12
0.05,2523,-126,54400,21.55309033280507,161
0.05,2524,-68,54332,21.51762376237624,169
0.05,2525,-12,54320,21.504354711005544,120
0.05,2526,64,54384,21.521171349426197,37
0.05,2527,28,54412,21.52373417721519,74
0.05,2528,43,54455,21.53222617635429,57
0.05,2529,-21,54434,21.515415019762845,157
0.05,2530,81,54515,21.538917423943104,20
0.05,2531,50,54565,21.550157977883096,50
0.05,2532,70,54635,21.56928543229372,30
0.05,2533,-83,54552,21.528018942383582,117
0.05,2534,-97,54455,21.481262327416175,148
0.05,2535,-31,54424,21.460567823343847,64
0.05,2536,91,54515,21.487977926685062,10
0.05,2537,57,54572,21.501970055161543,44
0.05,2538,46,54618,21.5116187475384,55
0.05,2539,30,54648,21.51496062992126,70
0.05,2540,90,54738,21.541912632821724,10
0.05,2541,-64,54674,21.508261211644374,28
0.05,2542,76,54750,21.52968934329532,24
0.05,2543,3,54753,21.52240566037736,53
0.05,2544,87,54840,21.548133595284874,13
0.05,2545,-60,54780,21.516103692065986,163
0.05,2546,59,54839,21.5308205732234,52
0.05,2547,18,54857,21.52943485086342,86
0.05,2548,67,54924,21.54727344056493,34
0.05,2549,94,55018,21.575686274509803,6
0.05,2550,-34,54984,21.55390043120345,136
0.05,2551,92,55076,21.58150470219436,8
0.05,2552,83,55159,21.605562083822953,18
0.05,2553,8,55167,21.60023492560689,24
0.05,2554,84,55251,21.624657534246577,17
0.05,2555,87,55338,21.650234741784036,13
0.05,2556,74,55412,21.670707860774346,26
0.05,2557,91,55503,21.697810789679437,10
0.05,2558,-254,55249,21.59007424775303,294
0.05,2559,-76,55173,21.551953125,190
0.05,2560,72,55245,21.57165169855525,32
0.05,2561,4,55249,21.5647931303669,31
0.05,2562,-158,55091,21.494732735076084,197
0.05,2563,-113,54978,21.442277691107645,160
0.05,2564,70,55048,21.46120857699805,30
0.05,2565,62,55110,21.47700701480904,39
0.05,2566,70,55180,21.495909622126998,31
0.05,2567,-2,55178,21.48676012461059,103
0.05,2568,54,55232,21.49941611521993,46
0.05,2569,-215,55017,21.40739299610895,319
0.05,2570,9,55026,21.402567094515753,93
0.05,2571,44,55070,21.41135303265941,57
0.05,2572,-23,55047,21.39409249902837,125
0.05,2573,83,55130,21.418026418026418,18
0.05,2574,48,55178,21.428349514563106,53
0.05,2575,-13,55165,21.41498447204969,115
0.05,2576,70,55235,21.43383779588669,31
0.05,2577,-41,55194,21.409619860356866,149
0.05,2578,59,55253,21.42419542458317,41
0.05,2579,88,55341,21.45,12
0.05,2580,-22,55319,21.433165439752035,123
0.05,2581,-138,55181,21.37141750580945,170
0.05,2582,55,55236,21.384436701509873,56
0.05,2583,87,55323,21.40982972136223,13
0.05,2584,66,55389,21.427079303675047,35
0.05,2585,63,55452,21.443155452436194,38
0.05,2586,70,55522,21.4619250096637,31
0.05,2587,-7,55515,21.45092735703246,108
0.05,2588,-35,55480,21.429123213595982,139
0.05,2589,85,55565,21.453667953667953,16
0.05,2590,74,55639,21.473948282516403,26
0.05,2591,18,55657,21.472608024691358,83
0.05,2592,-116,55541,21.419591207096026,219
0.05,2593,-6,55535,21.409020817270626,39
0.05,2594,54,55589,21.421579961464353,48
0.05,2595,55,55644,21.434514637904467,46
0.05,2596,65,55709,21.45128994994224,36
0.05,2597,68,55777,21.469207082371053,33
0.05,2598,24,55801,21.47018083878415,76
0.05,2599,65,55866,21.486923076923077,36
0.05,2600,87,55953,21.5121107266436,14
0.05,2601,-275,55678,21.39815526518063,311
0.05,2602,81,55759,21.42105263157895,20
0.05,2603,41,55800,21.428571428571427,76
0.05,2604,79,55879,21.450671785028792,21
0.05,2605,9,55888,21.445894090560245,91
0.05,2606,53,55941,21.457997698504027,47
0.05,2607,82,56023,21.48121165644172,19
0.05,2608,-109,55914,21.431199693369106,74
0.05,2609,56,55970,21.444444444444443,44
0.05,2610,-93,55877,21.400612792033705,126
0.05,2611,77,55954,21.421898928024504,24
0.05,2612,90,56044,21.44814389590509,11
0.05,2613,82,56126,21.471308339709257,18
0.05,2614,55,56181,21.48413001912046,45
0.05,2615,31,56212,21.48776758409786,69
0.05,2616,-61,56151,21.4562476117692,163
0.05,2617,-23,56128,21.439266615737203,126
0.05,2618,-7,56121,21.42840778923253,108
0.05,2619,18,56139,21.427099236641222,14
0.05,2620,72,56211,21.446394505913773,29
0.05,2621,-18,56193,21.431350114416475,120
0.05,2622,39,56232,21.438048036599312,62
0.05,2623,-41,56191,21.414253048780488,73
0.05,2624,72,56263,21.43352380952381,29
0.05,2625,-82,56181,21.394135567402895,117
0.05,2626,89,56270,21.419870574800154,12
0.05,2627,86,56356,21.444444444444443,14
0.05,2628,15,56371,21.441993153290223,86
0.05,2629,-349,56022,21.301140684410647,386
0.05,2630,86,56108,21.325731660965413,15
0.05,2631,88,56196,21.351063829787233,12
0.05,2632,76,56272,21.371819217622484,25
0.05,2633,-42,56230,21.347760060744115,161
0.05,2634,-115,56115,21.296015180265655,147
0.05,2635,92,56207,21.322837632776935,9
0.05,2636,-81,56126,21.284034888130453,184
0.05,2637,20,56146,21.283548142532222,80
0.05,2638,79,56225,21.305418719211822,22
0.05,2639,47,56272,21.315151515151516,54
0.05,2640,21,56293,21.31503218477849,11
0.05,2641,-213,56080,21.226343679031036,319
0.05,2642,-75,56005,21.189935679152477,106
0.05,2643,73,56078,21.209531013615734,27
0.05,2644,53,56131,21.22155009451796,47
0.05,2645,64,56195,21.237717309145882,37
0.05,2646,62,56257,21.253116735927463,38
0.05,2647,69,56326,21.271148036253777,31
0.05,2648,60,56386,21.285768214420536,41
0.05,2649,74,56460,21.30566037735849,26
0.05,2650,87,56547,21.330441342889475,14
0.05,2651,73,56620,21.3499245852187,35
0.05,2652,-212,56408,21.26196758386732,248
0.05,2653,90,56498,21.287867370007536,10
0.05,2654,93,56591,21.31487758945386,7
0.05,2655,-47,56544,21.289156626506024,80
0.05,2656,12,56556,21.285660519382763,96
0.05,2657,84,56640,21.30925507900677,17
0.05,2658,-15,56625,21.295599849567505,117
0.05,2659,80,56705,21.31766917293233,21
0.05,2660,87,56792,21.342352499060503,14
0.05,2661,-6,56786,21.332081141998497,38
0.05,2662,-14,56772,21.318813368381523,117
0.05,2663,8,56780,21.313813813813812,93
0.05,2664,-193,56587,21.233395872420264,235
0.05,2665,-31,56556,21.213803450862716,134
0.05,2666,93,56649,21.240719910011247,8
0.05,2667,59,56708,21.25487256371814,42
0.05,2668,93,56801,21.281753465717497,7
0.05,2669,-56,56745,21.252808988764045,96
0.05,2670,-85,56660,21.21302882815425,48
0.05,2671,-2,56658,21.20434131736527,103
0.05,2672,48,56706,21.21436588103255,53
0.05,2673,-8,56698,21.20344053851907,109
0.05,2674,60,56758,21.217943925233644,40
0.05,2675,55,56813,21.230568011958148,46
0.05,2676,-84,56729,21.191258871871497,117
0.05,2677,16,56745,21.189320388349515,84
0.05,2678,-25,56720,21.172079134005227,58
0.05,2679,86,56806,21.196268656716416,15
0.05,2680,60,56866,21.210742260350614,49
0.05,2681,86,56952,21.23489932885906,14
0.05,2682,92,57044,21.261274692508387,9
0.05,2683,64,57108,21.27719821162444,36
0.05,2684,51,57159,21.288268156424582,50
0.05,2685,86,57245,21.31236038719285,14
0.05,2686,-9,57236,21.301079270561964,40
0.05,2687,67,57303,21.318080357142858,47
0.05,2688,59,57362,21.332093715135738,42
0.05,2689,7,57369,21.326765799256506,93
0.05,2690,82,57451,21.349312523225567,19
0.05,2691,-80,57371,21.311664190193166,112
0.05,2692,54,57425,21.323802450798365,47
0.05,2693,72,57497,21.342613214550855,29
0.05,2694,65,57562,21.358812615955472,36
0.05,2695,-35,57527,21.337908011869438,136
0.05,2696,4,57531,21.331479421579534,28
0.05,2697,-6,57525,21.321349147516678,108
0.05,2698,2,57527,21.31419044090404,98
0.05,2699,75,57602,21.334074074074074,26
0.05,2700,-222,57380,21.243983709737133,186
0.05,2701,84,57464,21.26720947446336,16
0.05,2702,63,57527,21.28264890862005,38
0.05,2703,84,57611,21.305843195266274,16
0.05,2704,-26,57585,21.288354898336415,129
0.05,2705,-3,57582,21.27937915742794,103
0.05,2706,63,57645,21.29479128186184,37
0.05,2707,71,57716,21.31314623338257,30
0.05,2708,89,57805,21.33813215208564,11
0.05,2709,30,57835,21.34132841328413,71
0.05,2710,53,57888,21.3530062707488,48
0.05,2711,76,57964,21.37315634218289,25
0.05,2712,66,58030,21.389605602653887,34
0.05,2713,-67,57963,21.357037582903462,99
0.05,2714,-166,57797,21.28802946593002,198
0.05,2715,59,57856,21.301914580265095,41
0.05,2716,32,57888,21.30585204269415,69
0.05,2717,-80,57808,21.268579838116263,114
0.05,2718,-115,57693,21.218462670099303,150
0.05,2719,-23,57670,21.202205882352942,124
0.05,2720,94,57764,21.228959941198088,6
0.05,2721,52,57816,21.240264511388684,49
0.05,2722,93,57909,21.266617701065,7
0.05,2723,8,57917,21.26174743024963,95
0.05,2724,46,57963,21.270825688073394,70
0.05,2725,60,58023,21.28503301540719,41
0.05,2726,94,58117,21.31169783645031,6
0.05,2727,76,58193,21.33174486803519,24
0.05,2728,-238,57955,21.23671674606083,201
0.05,2729,-1,57954,21.228571428571428,32
0.05,2730,36,57990,21.233980227023068,65
0.05,2731,71,58061,21.252196193265007,30
0.05,2732,68,58129,21.269301134284667,32
0.05,2733,10,58139,21.26517922457937,92
0.05,2734,55,58194,21.277513711151737,45
0.05,2735,91,58285,21.30299707602339,9
0.05,2736,82,58367,21.325173547679942,18
0.05,2737,-72,58295,21.29108838568298,180
0.05,2738,27,58322,21.29317269076305,82
0.05,2739,92,58414,21.31897810218978,9
0.05,2740,10,58424,21.314848595403138,90
0.05,2741,12,58436,21.311451495258936,20
0.05,2742,78,58514,21.332118118847976,33
0.05,2743,89,58603,21.35677842565598,12
0.05,2744,30,58633,21.35992714025501,72
0.05,2745,78,58711,21.38055353241078,29
0.05,2746,-79,58632,21.344011649071714,180
0.05,2747,52,58684,21.355167394468705,48
0.05,2748,94,58778,21.381593306656967,7
0.05,2749,66,58844,21.39781818181818,34
0.05,2750,39,58883,21.404216648491456,69
0.05,2751,-79,58804,21.367732558139537,183
0.05,2752,39,58843,21.374137304758445,61
0.05,2753,90,58933,21.399055918663763,11
0.05,2754,-211,58722,21.31470054446461,324
0.05,2755,83,58805,21.33708272859216,17
0.05,2756,80,58885,21.35836053681538,21
0.05,2757,39,58924,21.364757070340826,61
0.05,2758,16,58940,21.362812613265675,15
0.05,2759,31,58971,21.366304347826087,70
0.05,2760,91,59062,21.391524809851504,10
0.05,2761,45,59107,21.40007241129616,55
0.05,2762,94,59201,21.426348172276512,7
0.05,2763,92,59293,21.45188133140376,8
0.05,2764,87,59380,21.475587703435806,14
0.05,2765,-89,59291,21.435647143890094,192
0.05,2766,50,59341,21.44597036501626,51
0.05,2767,26,59367,21.447615606936417,76
0.05,2768,-93,59274,21.406283856988082,127
0.05,2769,80,59354,21.427436823104692,21
0.05,2770,15,59369,21.425117286178274,87
0.05,2771,71,59440,21.443001443001442,29
0.05,2772,46,59486,21.451857194374323,54
0.05,2773,85,59571,21.474765681326605,15
0.05,2774,-56,59515,21.446846846846846,176
0.05,2775,-84,59431,21.40886167146974,188
0.05,2776,54,59485,21.420597767374865,46
0.05,2777,89,59574,21.444924406047516,11
0.05,2778,-39,59535,21.42317380352645,70
0.05,2779,74,59609,21.44208633093525,27
0.05,2780,94,59703,21.468176914778855,7
0.05,2781,32,59735,21.47196261682243,68
0.05,2782,-67,59668,21.440172475745598,170
0.05,2783,92,59760,21.46551724137931,9
0.05,2784,-48,59712,21.440574506283664,151
0.05,2785,-254,59458,21.34170854271357,287
0.05,2786,89,59547,21.365984930032294,12
0.05,2787,86,59633,21.38916786226686,14
0.05,2788,10,59643,21.385084259591252,92
0.05,2789,29,59672,21.387813620071686,72
0.05,2790,50,59722,21.398065209602294,51
0.05,2791,58,59780,21.411174785100286,42
0.05,2792,31,59811,21.414607948442534,70
0.05,2793,-67,59744,21.382963493199714,99
0.05,2794,-20,59724,21.36815742397138,51
0.05,2795,-124,59600,21.316165951359086,161
0.05,2796,-226,59374,21.22774401144083,188
0.05,2797,-41,59333,21.205503931379557,97
0.05,2798,56,59389,21.21793497677742,44
0.05,2799,-4,59385,21.208928571428572,108
0.05,2800,82,59467,21.23063191717244,19
0.05,2801,52,59519,21.24161313347609,49
0.05,2802,53,59572,21.25294327506243,47
0.05,2803,72,59644,21.271041369472183,28
0.05,2804,43,59687,21.278787878787877,57
0.05,2805,-81,59606,21.24233784746971,114
0.05,2806,59,59665,21.255789098681866,41
0.05,2807,76,59741,21.275284900284902,25
0.05,2808,19,59760,21.27447490210039,84
0.05,2809,-33,59727,21.255160142348753,136
0.05,2810,54,59781,21.266808964781216,46
0.05,2811,81,59862,21.28805120910384,19
0.05,2812,-112,59750,21.240668325631,145
0.05,2813,80,59830,21.261549395877754,21
0.05,2814,-151,59679,21.200355239786855,267
0.05,2815,81,59760,21.22159090909091,20
0.05,2816,-10,59750,21.210507632232872,113
0.05,2817,81,59831,21.231724627395316,19
0.05,2818,48,59879,21.24122029088329,52
0.05,2819,46,59925,21.25,55
0.05,2820,-5,59920,21.240694789081886,38
0.05,2821,-12,59908,21.228915662650603,44
0.05,2822,71,59979,21.246546227417642,29
0.05,2823,75,60054,21.26558073654391,25
0.05,2824,-1,60053,21.257699115044247,101
0.05,2825,73,60126,21.276008492569,28
0.05,2826,-15,60111,21.26317651220375,61
0.05,2827,88,60199,21.286775106082036,12
0.05,2828,33,60232,21.29091551785083,69
0.05,2829,-165,60067,21.225088339222616,136
0.05,2830,71,60138,21.24267043447545,30
0.05,2831,77,60215,21.262358757062145,24
0.05,2832,44,60259,21.270384751147194,56
0.05,2833,-120,60139,21.220536344389554,165
0.05,2834,69,60208,21.237389770723105,32
0.05,2835,85,60293,21.2598730606488,16
0.05,2836,-26,60267,21.243214663376808,130
0.05,2837,35,60302,21.248062015503876,67
0.05,2838,15,60317,21.24586121873899,86
0.05,2839,87,60404,21.26901408450704,14
0.05,2840,79,60483,21.28933474128828,22
0.05,2841,-9,60474,21.278676988036594,115
0.05,2842,85,60559,21.301090397467465,16
0.05,2843,39,60598,21.307313642756682,62
0.05,2844,-6,60592,21.297715289982424,106
0.05,2845,-16,60576,21.28460997891778,60
0.05,2846,45,60621,21.292939936775554,56
0.05,2847,74,60695,21.31144662921348,26
0.05,2848,33,60728,21.315549315549315,68
0.05,2849,66,60794,21.331228070175438,35
0.05,2850,52,60846,21.3419852683269,50
0.05,2851,88,60934,21.365357643758767,13
0.05,2852,86,61020,21.38801261829653,14
0.05,2853,24,61044,21.388927820602664,76
0.05,2854,9,61053,21.384588441330997,92
0.05,2855,90,61143,21.40861344537815,10
0.05,2856,56,61199,21.420721036051802,44
0.05,2857,59,61258,21.433869839048285,42
0.05,2858,49,61307,21.4435117173837,57
0.05,2859,-193,61114,21.36853146853147,294
0.05,2860,-130,60984,21.31562390772457,273
0.05,2861,-143,60841,21.25821104122991,246
0.05,2862,-184,60657,21.186517638840378,216
0.05,2863,71,60728,21.20391061452514,38
0.05,2864,18,60746,21.202792321116927,82
0.05,2865,0,60746,21.19539427773901,101
0.05,2866,14,60760,21.192884548308335,88
0.05,2867,77,60837,21.21234309623431,23
0.05,2868,-16,60821,21.199372603694666,127
0.05,2869,-120,60701,21.150174216027875,223
0.05,2870,30,60731,21.153256704980844,72
0.05,2871,-65,60666,21.12325905292479,167
0.05,2872,75,60741,21.142011834319526,26
0.05,2873,80,60821,21.1624913013222,20
0.05,2874,71,60892,21.17982608695652,30
0.05,2875,-1,60891,21.1721140472879,102
0.05,2876,91,60982,21.19638512339242,9
0.05,2877,83,61065,21.217859624739404,17
0.05,2878,82,61147,21.238971865230983,19
0.05,2879,48,61195,21.24826388888889,53
0.05,2880,71,61266,21.265532801110727,35
0.05,2881,-214,61052,21.183900069396252,326
0.05,2882,27,61079,21.185917447103712,80
0.05,2883,59,61138,21.199029126213592,41
0.05,2884,84,61222,21.220797227036396,17
0.05,2885,80,61302,21.241164241164242,20
0.05,2886,93,61395,21.266020090058884,8
0.05,2887,-289,61106,21.15858725761773,324
0.05,2888,61,61167,21.1723779854621,40
0.05,2889,-97,61070,21.131487889273355,131
0.05,2890,81,61151,21.152196471809063,20
0.05,2891,12,61163,21.149031811894883,92
0.05,2892,-94,61069,21.109229173867956,125
0.05,2893,11,61080,21.10573600552868,89
0.05,2894,92,61172,21.13022452504318,9
0.05,2895,-219,60953,21.047306629834253,254
0.05,2896,74,61027,21.065585088022093,26
0.05,2897,82,61109,21.086611456176673,18
0.05,2898,24,61133,21.087616419454985,78
0.05,2899,89,61222,21.11103448275862,12
0.05,2900,93,61315,21.135815236125474,8
0.05,2901,90,61405,21.159545141281875,10
0.05,2902,-49,61356,21.135377196004132,151
0.05,2903,54,61410,21.14669421487603,47
0.05,2904,-82,61328,21.11118760757315,182
0.05,2905,-171,61157,21.045079146593256,272
0.05,2906,89,61246,21.068455452356382,11
0.05,2907,55,61301,21.08012379642366,46
0.05,2908,86,61387,21.102440701271913,15
0.05,2909,48,61435,21.111683848797252,55
0.05,2910,4,61439,21.105805565097903,28
0.05,2911,91,61530,21.129807692307693,9
0.05,2912,-4,61526,21.121180913147956,35
0.05,2913,27,61553,21.123198352779685,73
0.05,2914,22,61575,21.123499142367066,80
0.05,2915,7,61582,21.118655692729767,25
0.05,2916,-98,61484,21.077819677751116,131
0.05,2917,94,61578,21.102810143934203,7
0.05,2918,45,61623,21.110996916752313,55
0.05,2919,70,61693,21.127739726027396,30
0.05,2920,-54,61639,21.102019856213627,89
0.05,2921,39,61678,21.10814510609172,63
0.05,2922,49,61727,21.117687307560725,52
0.05,2923,55,61782,21.129274965800274,55
0.05,2924,-352,61430,21.0017094017094,404
0.05,2925,22,61452,21.00205058099795,79
0.05,2926,24,61476,21.00307482063546,76
0.05,2927,-58,61418,20.976092896174862,161
0.05,2928,62,61480,20.99009900990099,39
0.05,2929,94,61574,21.015017064846415,6
0.05,2930,-26,61548,20.998976458546572,57
0.05,2931,90,61638,21.0225102319236,11
0.05,2932,84,61722,21.04398227071258,16
0.05,2933,80,61802,21.064076346284935,20
0.05,2934,-50,61752,21.03986371379898,81
0.05,2935,75,61827,21.05824250681199,26
0.05,2936,90,61917,21.081716036772217,10
0.05,2937,72,61989,21.099046970728388,29
0.05,2938,62,62051,21.112963593058865,39
0.05,2939,-150,61901,21.054761904761904,268
0.05,2940,-23,61878,21.039782386943216,125
0.05,2941,60,61938,21.053025152957172,41
0.05,2942,61,61999,21.066598708800544,40
0.05,2943,62,62061,21.080502717391305,39
0.05,2944,75,62136,21.098811544991513,26
0.05,2945,-87,62049,21.062118126272914,119
0.05,2946,30,62079,21.065151001017984,70
0.05,2947,-210,61869,20.986770691994572,173
0.05,2948,57,61926,20.998982706002035,44
0.05,2949,8,61934,20.99457627118644,23
0.05,2950,-10,61924,20.98407319552694,110
0.05,2951,63,61987,20.99830623306233,37
0.05,2952,85,62072,21.019979681679647,16
0.05,2953,-256,61816,20.926201760324982,236
0.05,2954,10,61826,20.92250423011844,93
0.05,2955,48,61874,20.93166441136671,56
0.05,2956,-26,61848,20.91579303347988,126
0.05,2957,-85,61763,20.87998647734956,189
0.05,2958,84,61847,20.901318012842175,17
0.05,2959,10,61857,20.897635135135136,22
0.05,2960,74,61931,20.915569064505235,27
0.05,2961,68,61999,20.931465226198515,33
0.05,2962,-130,61869,20.88052649341883,166
0.05,2963,28,61897,20.882928475033737,73
0.05,2964,6,61903,20.877908937605397,96
0.05,2965,24,61927,20.878961564396494,77
0.05,2966,88,62015,20.901584091675094,12
0.05,2967,82,62097,20.922169811320753,19
0.05,2968,62,62159,20.936005389019872,39
0.05,2969,64,62223,20.95050505050505,36
0.05,2970,83,62306,20.97139010434197,17
0.05,2971,66,62372,20.986541049798117,34
0.05,2972,29,62401,20.989236461486716,73
0.05,2973,94,62495,21.013786146603902,6
0.05,2974,11,62506,21.010420168067228,91
0.05,2975,92,62598,21.034274193548388,9
0.05,2976,-67,62531,21.004702720859925,170
0.05,2977,76,62607,21.02316991269308,25
0.05,2978,68,62675,21.03893924135616,32
0.05,2979,83,62758,21.05973154362416,17
0.05,2980,34,62792,21.064072458906406,66
0.05,2981,11,62803,21.060697518443998,89
0.05,2982,53,62856,21.07140462621522,49
0.05,2983,21,62877,21.071380697050937,79
0.05,2984,38,62915,21.077051926298157,63
0.05,2985,-10,62905,21.06664434025452,111
0.05,2986,81,62986,21.08670907264814,19
0.05,2987,75,63061,21.10475234270415,26
0.05,2988,-75,62986,21.072599531615925,108
0.05,2989,-305,62681,20.963545150501673,270
0.05,2990,90,62771,20.986626546305583,10
0.05,2991,95,62866,21.011363636363637,6
0.05,2992,82,62948,21.031740728366188,18
0.05,2993,-126,62822,20.982631930527724,226
0.05,2994,78,62900,21.001669449081803,23
0.05,2995,-356,62544,20.875834445927904,253
0.05,2996,19,62563,20.87520854187521,82
0.05,2997,55,62618,20.886591060707136,45
0.05,2998,71,62689,20.90330110036679,29
0.05,2999,63,62752,20.917333333333332,44
0.05,3000,56,62808,20.929023658780405,45
0.05,3001,71,62879,20.94570286475683,29
0.05,3002,-86,62793,20.91008991008991,122
0.05,3003,86,62879,20.931757656458057,20
0.05,3004,-90,62789,20.894841930116474,122
0.05,3005,76,62865,20.91317365269461,26
0.05,3006,80,62945,20.932823412038577,22
0.05,3007,-97,62848,20.893617021276597,198
0.05,3008,84,62932,20.914589564639414,17
0.05,3009,-64,62868,20.886378737541527,179
0.05,3010,3,62871,20.88043839256061,29
0.05,3011,29,62900,20.883134130146082,72
0.05,3012,6,62906,20.878194490540988,96
0.05,3013,-29,62877,20.861645653616456,61
0.05,3014,66,62943,20.876616915422886,34
0.05,3015,73,63016,20.893899204244033,28
0.05,3016,57,63073,20.90586675505469,52
0.05,3017,-130,62943,20.855864811133202,94
0.05,3018,51,62994,20.865849619079164,50
0.05,3019,17,63011,20.86456953642384,84
0.05,3020,-170,62841,20.80139026812314,203
0.05,3021,1,62842,20.794837855724687,101
0.05,3022,94,62936,20.819053919947073,6
0.05,3023,22,62958,20.819444444444443,10
0.05,3024,71,63029,20.83603305785124,29
0.05,3025,-127,62902,20.7871777924653,160
0.05,3026,85,62987,20.80839114634952,15
0.05,3027,71,63058,20.824966974900924,29
0.05,3028,-71,62987,20.7946517002311,174
0.05,3029,46,63033,20.802970297029702,55
0.05,3030,81,63114,20.822830748927746,20
0.05,3031,68,63182,20.83839050131926,33
0.05,3032,54,63236,20.84932410154962,47
0.05,3033,63,63299,20.863216875411997,38
0.05,3034,-187,63112,20.79472817133443,293
0.05,3035,65,63177,20.809288537549406,35
0.05,3036,82,63259,20.82943694435298,18
0.05,3037,90,63349,20.852205398288348,11
0.05,3038,-8,63341,20.84271141822968,111
0.05,3039,-9,63332,20.832894736842107,110
0.05,3040,90,63422,20.855639592239395,11
0.05,3041,87,63509,20.877383300460224,14
0.05,3042,44,63553,20.884981925731186,57
0.05,3043,57,63610,20.896846254927727,43
0.05,3044,52,63662,20.907060755336616,49
0.05,3045,51,63713,20.91694024950755,49
0.05,3046,83,63796,20.93731539218904,18
0.05,3047,88,63884,20.959317585301836,12
0.05,3048,41,63925,20.965890455887177,61
0.05,3049,-76,63849,20.93409836065574,110
0.05,3050,58,63907,20.94624713208784,43
0.05,3051,45,63952,20.954128440366972,56
0.05,3052,89,64041,20.97641663937111,11
0.05,3053,-174,63867,20.912573673870334,206
0.05,3054,90,63957,20.93518821603928,10
0.05,3055,62,64019,20.94862565445026,40
0.05,3056,88,64107,20.970559371933266,12
0.05,3057,29,64136,20.973185088293,74
0.05,3058,67,64203,20.988231448185683,33
0.05,3059,41,64244,20.994771241830065,60
0.05,3060,69,64313,21.01045409996733,32
0.05,3061,83,64396,21.03069888961463,18
0.05,3062,85,64481,21.05158341495266,15
0.05,3063,-84,64397,21.017297650130548,184
0.05,3064,27,64424,21.019249592169658,74
0.05,3065,-44,64380,20.998043052837573,77
0.05,3066,48,64428,21.00684708183893,52
0.05,3067,7,64435,21.002281616688396,93
0.05,3068,-38,64397,20.983056370153143,70
0.05,3069,-38,64359,20.96384364820847,138
0.05,3070,95,64454,20.987951807228917,6
0.05,3071,32,64486,20.991536458333332,69
0.05,3072,58,64544,21.00357956394403,43
0.05,3073,91,64635,21.026350032530903,9
0.05,3074,71,64706,21.04260162601626,30
0.05,3075,-30,64676,21.0260078023407,144
0.05,3076,-49,64627,21.003249918752033,152
0.05,3077,18,64645,21.00227420402859,13
0.05,3078,10,64655,20.99870087690809,93
0.05,3079,-9,64646,20.98896103896104,111
0.05,3080,-103,64543,20.94871794871795,139
0.05,3081,-28,64515,20.932835820895523,130
0.05,3082,31,64546,20.936101200129745,69
0.05,3083,-59,64487,20.910181582360572,163
0.05,3084,88,64575,20.93192868719611,12
0.05,3085,-59,64516,20.90602721970188,161
0.05,3086,87,64603,20.927437641723355,13
0.05,3087,93,64696,20.95077720207254,13
0.05,3088,87,64783,20.972159274846227,13
0.05,3089,95,64878,20.99611650485437,6
0.05,3090,6,64884,20.991264962795213,25
0.05,3091,-73,64811,20.960866752910736,174
0.05,3092,35,64846,20.965405754930487,66
0.05,3093,81,64927,20.98480930833872,19
0.05,3094,-36,64891,20.966397415185785,69
0.05,3095,67,64958,20.9812661498708,34
0.05,3096,-118,64840,20.93639005489183,152
0.05,3097,89,64929,20.958360232408005,12
0.05,3098,-42,64887,20.93804453049371,79
0.05,3099,51,64938,20.947741935483872,49
0.05,3100,-16,64922,20.93582715253144,118
0.05,3101,-75,64847,20.904900064474532,179
0.05,3102,-11,64836,20.894618111504997,112
0.05,3103,82,64918,20.91430412371134,18
0.05,3104,26,64944,20.91594202898551,76
0.05,3105,47,64991,20.9243399871217,54
0.05,3106,78,65069,20.942710009655617,23
0.05,3107,43,65112,20.94980694980695,58
0.05,3108,-10,65102,20.93985204245738,112
0.05,3109,-45,65057,20.918649517684887,85
0.05,3110,92,65149,20.941497910639665,9
0.05,3111,86,65235,20.962403598971722,14
0.05,3112,31,65266,20.96562801156441,70
0.05,3113,-48,65218,20.943481053307643,148
0.05,3114,5,65223,20.93836276083467,96
0.05,3115,92,65315,20.96116816431322,9
0.05,3116,-215,65100,20.88546679499519,321
0.05,3117,43,65143,20.89255933290571,57
0.05,3118,73,65216,20.90926579031741,27
0.05,3119,66,65282,20.92371794871795,36
0.05,3120,82,65364,20.94328740788209,19
0.05,3121,55,65419,20.95419602818706,46
0.05,3122,-48,65371,20.93211655459494,81
0.05,3123,61,65432,20.9449423815621,39
0.05,3124,72,65504,20.96128,28
0.05,3125,-72,65432,20.931541906589892,174
0.05,3126,5,65437,20.926447073872723,96
0.05,3127,-159,65278,20.868925831202045,265
0.05,3128,-91,65187,20.833173537871524,124
0.05,3129,47,65234,20.841533546325877,63
0.05,3130,-59,65175,20.81603321622485,90
0.05,3131,-43,65132,20.79565772669221,74
0.05,3132,46,65178,20.803702521544846,54
0.05,3133,4,65182,20.798340778557755,125
0.05,3134,88,65270,20.819776714513555,13
0.05,3135,75,65345,20.837053571428573,25
0.05,3136,-9,65336,20.82754223780682,112
0.05,3137,49,65385,20.836520076481836,52
0.05,3138,84,65469,20.856642242752468,17
0.05,3139,52,65521,20.86656050955414,49
0.05,3140,66,65587,20.880929640241963,34
0.05,3141,-7,65580,20.872056015276893,38
0.05,3142,-20,65560,20.85905186127903,130
0.05,3143,53,65613,20.869274809160306,48
0.05,3144,18,65631,20.868362480127185,13
0.05,3145,84,65715,20.888429752066116,17
0.05,3146,46,65761,20.896409278678107,55
0.05,3147,80,65841,20.915184243964422,21
0.05,3148,94,65935,20.93839314067958,7
0.05,3149,18,65953,20.937460317460317,13
0.05,3150,62,66015,20.950491907331006,39
0.05,3151,81,66096,20.96954314720812,20
0.05,3152,91,66187,20.99175388518871,9
0.05,3153,58,66245,21.003487634749526,43
0.05,3154,51,66296,21.01299524564184,51
0.05,3155,9,66305,21.00918884664132,91
0.05,3156,85,66390,21.029458346531516,16
0.05,3157,-87,66303,20.995250158328055,120
0.05,3158,49,66352,21.004115226337447,66
0.05,3159,-17,66335,20.992088607594937,125
0.05,3160,-30,66305,20.97595697564062,62
0.05,3161,42,66347,20.98260594560405,58
0.05,3162,-179,66168,20.91938033512488,280
0.05,3163,80,66248,20.938053097345133,21
0.05,3164,90,66338,20.95987361769352,11
0.05,3165,70,66408,20.97536323436513,31
0.05,3166,37,66445,20.98042311335649,63
0.05,3167,76,66521,20.997790404040405,24
0.05,3168,29,66550,21.000315556958032,71
0.05,3169,90,66640,21.022082018927446,10
0.05,3170,-84,66556,20.988962472406183,124
0.05,3171,90,66646,21.010718789407314,11
0.05,3172,-162,66484,20.953041285849356,263
0.05,3173,53,66537,20.96313799621928,50
0.05,3174,57,66594,20.974488188976377,44
0.05,3175,38,66632,20.97984886649874,62
0.05,3176,57,66689,20.991186654076174,43
0.05,3177,91,66780,21.013215859030836,10
0.05,3178,-137,66643,20.963510537905,179
0.05,3179,90,66733,20.985220125786164,11
0.05,3180,67,66800,20.9996856334486,33
0.05,3181,13,66813,20.997171590194846,88
0.05,3182,76,66889,21.01445177505498,24
0.05,3183,-16,66873,21.002826633165828,119
0.05,3184,32,66905,21.006279434850864,70
0.05,3185,23,66928,21.00690521029504,78
0.05,3186,82,67010,21.026043300909947,19
0.05,3187,48,67058,21.034504391468005,53
0.05,3188,94,67152,21.05738476011289,6
0.05,3189,95,67247,21.080564263322884,6
0.05,3190,81,67328,21.099341899091193,20
0.05,3191,50,67378,21.108395989974937,51
0.05,3192,42,67420,21.114938928906984,59
0.05,3193,-101,67319,21.07670632435817,202
0.05,3194,70,67389,21.092018779342723,30
0.05,3195,70,67459,21.10732165206508,30
0.05,3196,-53,67406,21.084141382546136,86
0.05,3197,-9,67397,21.07473420888055,110
0.05,3198,73,67470,21.090965926852142,27
0.05,3199,65,67535,21.1046875,37
0.05,3200,47,67582,21.112777257107155,54
0.05,3201,41,67623,21.11898813241724,61
0.05,3202,-474,67149,20.96440836715579,451
0.05,3203,-48,67101,20.942883895131086,80
0.05,3204,76,67177,20.9600624024961,25
0.05,3205,54,67231,20.97036805988771,46
0.05,3206,-134,67097,20.922045525413157,236
0.05,3207,91,67188,20.943890274314214,10
0.05,3208,94,67282,20.966656279214707,6
0.05,3209,22,67304,20.966978193146417,9
0.05,3210,-46,67258,20.946122703207724,147
0.05,3211,57,67315,20.957347447073474,44
0.05,3212,47,67362,20.96545284780579,53
0.05,3213,-16,67346,20.953951462352208,119
0.05,3214,84,67430,20.973561430793158,17
0.05,3215,-11,67419,20.963619402985074,111
0.05,3216,-164,67255,20.906123717749455,130
0.05,3217,-24,67231,20.89216904909882,56
0.05,3218,81,67312,20.910841876359118,20
0.05,3219,79,67391,20.92888198757764,21
0.05,3220,-9,67382,20.91959018938218,126
0.05,3221,79,67461,20.93761638733706,21
0.05,3222,89,67550,20.95873409866584,11
0.05,3223,79,67629,20.976736972704714,22
0.05,3224,77,67706,20.994108527131782,23
0.05,3225,90,67796,21.015499070055796,11
0.05,3226,-21,67775,21.002479082739388,123
0.05,3227,90,67865,21.023853779429988,10
0.05,3228,-37,67828,21.00588417466708,70
0.05,3229,77,67905,21.023219814241486,24
0.05,3230,33,67938,21.026926648096566,69
0.05,3231,-25,67913,21.012685643564357,56
0.05,3232,74,67987,21.029075162387876,27
0.05,3233,92,68079,21.051020408163264,8
0.05,3234,91,68170,21.072642967542503,9
0.05,3235,53,68223,21.082509270704573,48
0.05,3236,-17,68206,21.07074451652765,118
0.05,3237,85,68291,21.090487955528104,16
0.05,3238,-10,68281,21.080889163322013,114
0.05,3239,29,68310,21.083333333333332,73
0.05,3240,-106,68204,21.044122184510954,207
0.05,3241,-84,68120,21.011721159777913,116
0.05,3242,-55,68065,20.98828245451742,156
0.05,3243,-195,67870,20.92170160295931,161
0.05,3244,-20,67850,20.90909090909091,120
0.05,3245,75,67925,20.925754775107826,26
0.05,3246,92,68017,20.94764397905759,8
0.05,3247,11,68028,20.944581280788178,111
0.05,3248,82,68110,20.963373345644815,19
0.05,3249,83,68193,20.98246153846154,18
0.05,3250,51,68244,20.99169486311904,59
0.05,3251,-181,68063,20.92958179581796,215
0.05,3252,82,68145,20.948355364279127,19
0.05,3253,42,68187,20.95482483097726,59
0.05,3254,-19,68168,20.942549923195084,50
0.05,3255,-110,68058,20.902334152334152,234
0.05,3256,53,68111,20.91218913110224,47
0.05,3257,20,68131,20.911909146715775,80
0.05,3258,85,68216,20.931574102485424,15
0.05,3259,-108,68108,20.8920245398773,140
0.05,3260,40,68148,20.897884084636615,60
0.05,3261,57,68205,20.908951563458,44
0.05,3262,-347,67858,20.796199816120136,244
0.05,3263,-6,67852,20.787990196078432,108
0.05,3264,-467,67385,20.638591117917304,571
0.05,3265,32,67417,20.64206981016534,68
0.05,3266,84,67501,20.66146311600857,16
0.05,3267,55,67556,20.671970624235005,45
0.05,3268,-7,67549,20.663505659223006,107
0.05,3269,65,67614,20.677064220183485,35
0.05,3270,10,67624,20.673800061143382,91
0.05,3271,61,67685,20.686124694376527,40
0.05,3272,-27,67658,20.671555148182097,129
0.05,3273,26,67684,20.673182651191205,80
0.05,3274,78,67762,20.690687022900764,23
0.05,3275,80,67842,20.708791208791208,20
0.05,3276,-165,67677,20.65212084223375,197
0.05,3277,48,67725,20.66046369737645,52
0.05,3278,-270,67455,20.57182067703568,306
0.05,3279,59,67514,20.583536585365852,41
0.05,3280,-47,67467,20.562938128619322,103
0.05,3281,61,67528,20.575258988421695,41
0.05,3282,38,67566,20.5805665549802,63
0.05,3283,21,67587,20.580694275274055,82
0.05,3284,7,67594,20.576560121765603,94
0.05,3285,70,67664,20.591600730371272,30
0.05,3286,85,67749,20.61119561910557,15
0.05,3287,3,67752,20.605839416058394,28
0.05,3288,26,67778,20.607479477044695,6
0.05,3289,79,67857,20.625227963525838,22
0.05,3290,90,67947,20.646308113035552,10
0.05,3291,-219,67728,20.573511543134874,324
0.05,3292,-35,67693,20.556635286972366,138
0.05,3293,-69,67624,20.52944748026715,33
0.05,3294,31,67655,20.532625189681337,71
0.05,3295,39,67694,20.538228155339805,62
0.05,3296,32,67726,20.54170457992114,68
0.05,3297,87,67813,20.561855670103093,14
0.05,3298,45,67858,20.5692634131555,55
0.05,3299,-56,67802,20.546060606060607,87
0.05,3300,-71,67731,20.51832777946077,176
0.05,3301,27,67758,20.52029073288916,73
0.05,3302,91,67849,20.541628822282775,10
0.05,3303,-226,67623,20.467009685230025,192
0.05,3304,-197,67426,20.401210287443266,229
0.05,3305,-33,67393,20.385057471264368,135
0.05,3306,42,67435,20.39159358935591,58
0.05,3307,69,67504,20.40628778718259,32
0.05,3308,90,67594,20.427319431852524,11
0.05,3309,54,67648,20.437462235649548,47
0.05,3310,66,67714,20.45122319540924,36
0.05,3311,-36,67678,20.434178743961354,138
0.05,3312,-205,67473,20.36613341382433,308
0.05,3313,10,67483,20.363005431502717,91
0.05,3314,47,67530,20.3710407239819,54
0.05,3315,-101,67429,20.334439083232812,203
0.05,3316,79,67508,20.3521254145312,22
0.05,3317,64,67572,20.365280289330922,36
0.05,3318,8,67580,20.361554685146128,99
0.05,3319,94,67674,20.383734939759037,7
0.05,3320,83,67757,20.40258958145137,17
0.05,3321,43,67800,20.409391932570742,57
0.05,3322,64,67864,20.42250978031899,37
0.05,3323,73,67937,20.438327316486163,28
0.05,3324,58,67995,20.449624060150377,44
0.05,3325,-55,67940,20.42693926638605,155
0.05,3326,29,67969,20.42951608055305,72
0.05,3327,63,68032,20.442307692307693,45
0.05,3328,47,68079,20.45028537098228,55
0.05,3329,16,68095,20.44894894894895,15
0.05,3330,-42,68053,20.43020114079856,74
0.05,3331,-87,67966,20.397959183673468,118
0.05,3332,42,68008,20.404440444044404,59
0.05,3333,49,68057,20.413017396520697,52
0.05,3334,92,68149,20.43448275862069,8
0.05,3335,88,68237,20.454736211031175,13
0.05,3336,-246,67991,20.374887623614026,209
0.05,3337,81,68072,20.39304973037747,32
0.05,3338,76,68148,20.409703504043126,25
0.05,3339,87,68235,20.429640718562876,14
0.05,3340,19,68254,20.429212810535766,83
0.05,3341,20,68274,20.429084380610412,82
0.05,3342,8,68282,20.42536643733174,94
0.05,3343,50,68332,20.43421052631579,51
0.05,3344,76,68408,20.450822122571,25
0.05,3345,60,68468,20.46264196054991,41
0.05,3346,63,68531,20.47535106065133,40
0.05,3347,-67,68464,20.449223416965353,100
0.05,3348,94,68558,20.471185428486116,7
0.05,3349,14,68572,20.469253731343283,88
0.05,3350,9,68581,20.465831095195465,91
0.05,3351,85,68666,20.48508353221957,16
0.05,3352,76,68742,20.50164032209961,25
0.05,3353,16,68758,20.500298151460942,88
0.05,3354,-92,68666,20.46676602086438,195
0.05,3355,25,68691,20.468116805721095,76
0.05,3356,58,68749,20.479296991361334,42
0.05,3357,-65,68684,20.453841572364503,167
0.05,3358,1,68685,20.448050014885382,31
0.05,3359,-73,68612,20.420238095238094,105
0.05,3360,-60,68552,20.39631062183874,93
0.05,3361,62,68614,20.40868530636526,38
0.05,3362,-49,68565,20.388046387154326,151
0.05,3363,72,68637,20.403388822829964,28
0.05,3364,-85,68552,20.372065378900444,189
0.05,3365,74,68626,20.387997623291742,26
0.05,3366,-165,68461,20.332937332937334,267
0.05,3367,-2,68459,20.326306413301662,102
0.05,3368,94,68553,20.348174532502227,7
0.05,3369,94,68647,20.370029673590505,7
0.05,3370,84,68731,20.388905369326608,16
0.05,3371,69,68800,20.40332147093713,31
0.05,3372,74,68874,20.41921138452416,54
0.05,3373,49,68923,20.427682276229994,51
0.05,3374,94,69017,20.44948148148148,7
0.05,3375,-144,68873,20.400770142180093,195
0.05,3376,28,68901,20.403020432336394,74
0.05,3377,64,68965,20.415926583777384,38
0.05,3378,87,69052,20.43563184374075,13
0.05,3379,-56,68996,20.41301775147929,88
0.05,3380,-20,68976,20.40106477373558,52
0.05,3381,82,69058,20.419278533412182,19
0.05,3382,10,69068,20.416198640260124,22
0.05,3383,70,69138,20.430851063829788,31
0.05,3384,85,69223,20.44992614475628,16
0.05,3385,63,69286,20.46249261665682,37
0.05,3386,-24,69262,20.449365219958665,55
0.05,3387,-137,69125,20.40289256198347,102
0.05,3388,-48,69077,20.382708763647095,80
0.05,3389,80,69157,20.40029498525074,21
0.05,3390,92,69249,20.42140961368328,8
0.05,3391,6,69255,20.417158018867923,95
0.05,3392,79,69334,20.43442381373416,21
0.05,3393,-43,69291,20.415733647613436,76
0.05,3394,74,69365,20.431516936671574,27
0.05,3395,87,69452,20.451118963486454,14
0.05,3396,-94,69358,20.417427141595525,136
0.05,3397,59,69417,20.428781636256623,41
0.05,3398,86,69503,20.44807296263607,14
0.05,3399,94,69597,20.46970588235294,7
0.05,3400,36,69633,20.474272272860922,65
0.05,3401,59,69692,20.48559670781893,42
0.05,3402,-60,69632,20.46194534234499,161
0.05,3403,33,69665,20.465628672150412,67
0.05,3404,60,69725,20.477239353891335,40
0.05,3405,-237,69488,20.401644157369347,207
0.05,3406,26,69514,20.403287349574406,74
0.05,3407,19,69533,20.40287558685446,81
0.05,3408,23,69556,20.403637430331475,79
0.05,3409,-19,69537,20.39208211143695,121
0.05,3410,32,69569,20.39548519495749,68
0.05,3411,93,69662,20.416764361078545,8
0.05,3412,68,69730,20.43070612364489,33
0.05,3413,92,69822,20.451669595782075,9
0.05,3414,59,69881,20.46295754026354,41
0.05,3415,-4,69877,20.4557962529274,107
0.05,3416,85,69962,20.47468539654668,15
0.05,3417,-60,69902,20.451141018139264,161
0.05,3418,67,69969,20.464755776542848,34
0.05,3419,52,70021,20.473976608187133,49
0.05,3420,51,70072,20.48289973691903,50
0.05,3421,-122,69950,20.44126241963764,157
0.05,3422,75,70025,20.457201285422144,26
0.05,3423,-5,70020,20.449766355140188,37
0.05,3424,65,70085,20.462773722627738,35
0.05,3425,7,70092,20.458844133099824,94
0.05,3426,57,70149,20.4695068573096,44
0.05,3427,22,70171,20.469953325554258,79
0.05,3428,-9,70162,20.461358996792068,109
0.05,3429,-17,70145,20.450437317784257,49
0.05,3430,75,70220,20.466336345088894,28
0.05,3431,-11,70209,20.457167832167833,42
0.05,3432,88,70297,20.47684241188465,13
0.05,3433,56,70353,20.487186953989518,44
0.05,3434,79,70432,20.504221251819505,21
0.05,3435,-9,70423,20.495634458672875,40
0.05,3436,86,70509,20.514693046261275,14
0.05,3437,29,70538,20.51716114019779,71
0.05,3438,50,70588,20.525734225065428,50
0.05,3439,-78,70510,20.497093023255815,180
0.05,3440,-28,70482,20.48299912816042,128
0.05,3441,-28,70454,20.46891342242882,61
0.05,3442,75,70529,20.484751670055186,26
0.05,3443,83,70612,20.502903600464577,18
0.05,3444,57,70669,20.513497822931786,44
0.05,3445,72,70741,20.52843876958793,29
0.05,3446,94,70835,20.54975340876124,7
0.05,3447,87,70922,20.569025522041763,13
0.05,3448,36,70958,20.573499565091332,65
0.05,3449,29,70987,20.57594202898551,72
0.05,3450,-235,70752,20.5018835120255,270
0.05,3451,90,70842,20.52201622247972,10
0.05,3452,-57,70785,20.499565595134666,93
0.05,3453,81,70866,20.517081644470178,19
0.05,3454,78,70944,20.533719247467438,22
0.05,3455,-278,70666,20.447337962962962,316
0.05,3456,73,70739,20.462539774370843,27
0.05,3457,60,70799,20.473973395026025,42
0.05,3458,75,70874,20.489736918184445,25
0.05,3459,93,70967,20.5106936416185,8
0.05,3460,95,71062,20.532216122507947,6
0.05,3461,81,71143,20.549682264586945,19
0.05,3462,-1,71142,20.54345942824141,103
0.05,3463,90,71232,20.5635103926097,11
0.05,3464,57,71289,20.574025974025975,44
0.05,3465,34,71323,20.57789959607617,66
0.05,3466,69,71392,20.591866166714738,31
0.05,3467,-8,71384,20.583621683967706,109
0.05,3468,-27,71357,20.569904871720958,128
0.05,3469,88,71445,20.589337175792508,13
0.05,3470,71,71516,20.60386055891674,30
0.05,3471,-38,71478,20.586981566820278,140
0.05,3472,65,71543,20.59976965159804,36
0.05,3473,24,71567,20.600748416810593,76
0.05,3474,52,71619,20.609784172661872,48
0.05,3475,-83,71536,20.579976985040275,183
0.05,3476,71,71607,20.594477998274375,29
0.05,3477,-36,71571,20.57820586543991,138
0.05,3478,23,71594,20.578901983328542,79
0.05,3479,65,71659,20.591666666666665,36
0.05,3480,82,71741,20.60930767020971,19
0.05,3481,26,71767,20.610855829982768,75
0.05,3482,42,71809,20.616996841803044,58
0.05,3483,72,71881,20.63174512055109,28
0.05,3484,-89,71792,20.600286944045912,206
0.05,3485,93,71885,20.621055651176132,7
0.05,3486,-143,71742,20.574132492113566,174
0.05,3487,-33,71709,20.558772935779817,67
0.05,3488,90,71799,20.578675838349096,10
0.05,3489,-27,71772,20.565042979942692,60
0.05,3490,-20,71752,20.55342308794042,120
0.05,3491,76,71828,20.56930126002291,25
0.05,3492,-380,71448,20.454623532779845,421
0.05,3493,58,71506,20.465369204350313,43
0.05,3494,-2,71504,20.458941344778253,106
0.05,3495,-6,71498,20.45137299771167,38
0.05,3496,-167,71331,20.397769516728623,201
0.05,3497,28,71359,20.399942824471125,73
0.05,3498,81,71440,20.417262074878536,19
0.05,3499,31,71471,20.420285714285715,70
0.05,3500,17,71488,20.419308768923166,83
0.05,3501,46,71534,20.426613363792118,54
0.05,3502,54,71588,20.436197544961463,47
0.05,3503,15,71603,20.43464611872146,87
0.05,3504,83,71686,20.45249643366619,18
0.05,3505,88,71774,20.471762692527097,13
0.05,3506,89,71863,20.491303108069577,12
0.05,3507,93,71956,20.511972633979475,7
0.05,3508,46,72002,20.51923624964377,56
0.05,3509,85,72087,20.537606837606837,16
0.05,3510,94,72181,20.558530333238394,7
0.05,3511,58,72239,20.569191343963553,43
0.05,3512,-55,72184,20.547680045545118,89
0.05,3513,-13,72171,20.538133181559477,45
0.05,3514,75,72246,20.55362731152205,25
0.05,3515,-48,72198,20.534129692832764,81
0.05,3516,32,72230,20.53738982087006,69
0.05,3517,86,72316,20.55599772598067,15
0.05,3518,48,72364,20.563796533105997,52
0.05,3519,21,72385,20.563920454545453,79
0.05,3520,93,72478,20.584493041749504,8
0.05,3521,68,72546,20.597955706984667,33
0.05,3522,88,72634,20.61708770933863,12
0.05,3523,31,72665,20.620034052213395,70
0.05,3524,29,72694,20.62241134751773,72
0.05,3525,75,72769,20.637833238797505,26
0.05,3526,54,72823,20.647292316416216,47
0.05,3527,31,72854,20.650226757369616,69
0.05,3528,20,72874,20.65004250495891,11
0.05,3529,-45,72829,20.631444759206797,147
0.05,3530,30,72859,20.634097989238175,71
0.05,3531,90,72949,20.65373725934315,11
0.05,3532,11,72960,20.651004811774694,92
0.05,3533,0,72960,20.64516129032258,104
0.05,3534,-34,72926,20.62970297029703,135
0.05,3535,-89,72837,20.598699095022624,203
0.05,3536,59,72896,20.609556121006502,42
0.05,3537,-58,72838,20.587337478801583,91
0.05,3538,37,72875,20.591975134218707,77
0.05,3539,93,72968,20.612429378531072,8
0.05,3540,-82,72886,20.583451002541654,115
0.05,3541,-56,72830,20.561829474872955,88
0.05,3542,70,72900,20.575783234546993,30
0.05,3543,66,72966,20.58860045146727,35
0.05,3544,-43,72923,20.570662905500704,77
0.05,3545,-43,72880,20.552735476593345,76
0.05,3546,-158,72722,20.502396391316605,190
0.05,3547,45,72767,20.509301014656145,55
0.05,3548,-4,72763,20.50239504085658,106
0.05,3549,22,72785,20.50281690140845,78
0.05,3550,85,72870,20.520980005632218,16
0.05,3551,72,72942,20.535472972972972,29
0.05,3552,-63,72879,20.51196172248804,168
0.05,3553,91,72970,20.531795160382668,10
0.05,3554,80,73050,20.548523206751057,21
0.05,3555,0,73050,20.542744656917886,31
0.05,3556,88,73138,20.5617093055946,13
0.05,3557,-25,73113,20.548903878583474,56
0.05,3558,54,73167,20.558302894071367,47
0.05,3559,8,73175,20.554775280898877,24
0.05,3560,88,73263,20.573715248525694,12
0.05,3561,2,73265,20.56850084222347,98
0.05,3562,43,73308,20.574796519786698,58
0.05,3563,28,73336,20.576879910213243,75
0.05,3564,89,73425,20.596072931276296,12
0.05,3565,-105,73320,20.560852495793608,138
0.05,3566,-105,73215,20.52565180824222,162
0.05,3567,-6,73209,20.518217488789237,106
0.05,3568,-233,72976,20.44718408517792,270
0.05,3569,-7,72969,20.439495798319328,108
0.05,3570,51,73020,20.448053766451974,50
0.05,3571,85,73105,20.466125419932812,15
0.05,3572,79,73184,20.48250769661349,22
0.05,3573,-14,73170,20.472859541130386,115
0.05,3574,15,73185,20.47132867132867,17
0.05,3575,30,73215,20.473993288590606,71
0.05,3576,45,73260,20.480849874196252,55
0.05,3577,67,73327,20.493851313583008,33
0.05,3578,-71,73256,20.468287231070132,120
0.05,3579,81,73337,20.48519553072626,19
0.05,3580,73,73410,20.49986037419715,28
0.05,3581,-10,73400,20.491345616973756,43
0.05,3582,-90,73310,20.4605079542283,193
0.05,3583,83,73393,20.477957589285715,18
0.05,3584,-69,73324,20.45299860529986,104
0.05,3585,31,73355,20.455939765755716,72
0.05,3586,-32,73323,20.441315862838024,142
0.05,3587,2,73325,20.43617614269788,98
0.05,3588,82,73407,20.453329618278072,18
0.05,3589,71,73478,20.467409470752088,29
0.05,3590,32,73510,20.470620996936788,69
0.05,3591,35,73545,20.47466592427617,81
0.05,3592,-189,73356,20.41636515446702,223
0.05,3593,85,73441,20.434335002782415,16
0.05,3594,49,73490,20.442280945757997,51
0.05,3595,-65,73425,20.418520578420466,168
0.05,3596,32,73457,20.42174033917153,69
0.05,3597,65,73522,20.434130072262366,36
0.05,3598,-106,73416,20.39899972214504,140
0.05,3599,-234,73182,20.328333333333333,268
0.05,3600,89,73271,20.347403499028047,12
0.05,3601,75,73346,20.36257634647418,25
0.05,3602,84,73430,20.380238689980573,16
0.05,3603,51,73481,20.38873473917869,49
0.05,3604,91,73572,20.408321775312068,10
0.05,3605,20,73592,20.408208541320022,80
0.05,3606,37,73629,20.412808428056557,65
0.05,3607,85,73714,20.43070953436807,15
0.05,3608,74,73788,20.445552784704905,27
0.05,3609,80,73868,20.462049861495846,21
0.05,3610,69,73937,20.475491553586263,31
0.05,3611,45,73982,20.482281284606866,55
0.05,3612,76,74058,20.49764738444506,26
0.05,3613,-65,73993,20.47399003873824,98
0.05,3614,-144,73849,20.428492392807744,180
0.05,3615,44,73893,20.435011061946902,57
0.05,3616,62,73955,20.446502626486037,39
0.05,3617,73,74028,20.461028192371476,27
0.05,3618,-73,73955,20.435203094777563,106
0.05,3619,76,74031,20.450552486187846,25
0.05,3620,25,74056,20.451808892571112,76
0.05,3621,75,74131,20.466869133075647,26
0.05,3622,65,74196,20.47916091636765,36
0.05,3623,-79,74117,20.45171081677704,180
0.05,3624,58,74175,20.46206896551724,43
0.05,3625,84,74259,20.479591836734695,16
0.05,3626,16,74275,20.47835676867935,85
0.05,3627,-7,74268,20.470782800441015,41
0.05,3628,-3,74265,20.464315238357674,103
0.05,3629,22,74287,20.46473829201102,79
0.05,3630,95,74382,20.485265767006336,6
0.05,3631,9,74391,20.482103524229075,91
0.05,3632,82,74473,20.4990366088632,18
0.05,3633,48,74521,20.506604292790314,52
0.05,3634,-26,74495,20.493810178817057,127
0.05,3635,83,74578,20.51100110011001,18
0.05,3636,84,74662,20.528457519934012,42
0.05,3637,-159,74503,20.479109400769655,279
0.05,3638,-197,74306,20.419345974168728,228
0.05,3639,-149,74157,20.372802197802198,253
0.05,3640,80,74237,20.389178797033782,21
0.05,3641,-106,74131,20.35447556287754,139
0.05,3642,85,74216,20.37222069722756,16
0.05,3643,-107,74109,20.337266739846324,139
0.05,3644,74,74183,20.3519890260631,26
0.05,3645,-155,74028,20.303894679100384,189
0.05,3646,43,74071,20.310117905127502,58
0.05,3647,93,74164,20.330043859649123,8
0.05,3648,90,74254,20.349136749794464,11
0.05,3649,-31,74223,20.335068493150686,63
0.05,3650,-14,74209,20.325664201588605,47
0.05,3651,86,74295,20.34364731653888,14
0.05,3652,75,74370,20.35860936216808,25
0.05,3653,-168,74202,20.307060755336618,245
0.05,3654,60,74262,20.317920656634747,41
0.05,3655,84,74346,20.335339168490155,16
0.05,3656,10,74356,20.332512988788626,91
0.05,3657,75,74431,20.347457627118644,25
0.05,3658,-53,74378,20.327411861164254,156
0.05,3659,91,74469,20.34672131147541,9
0.05,3660,-29,74440,20.333242283529092,132
0.05,3661,94,74534,20.353358820316767,7
0.05,3662,-16,74518,20.343434343434343,48
0.05,3663,86,74604,20.361353711790393,14
0.05,3664,-14,74590,20.351978171896317,115
0.05,3665,47,74637,20.35924713584288,54
0.05,3666,78,74715,20.3749659121898,23
0.05,3667,93,74808,20.394765539803707,8
0.05,3668,-31,74777,20.38075769964568,133
0.05,3669,17,74794,20.37983651226158,84
0.05,3670,90,74884,20.398801416507762,11
0.05,3671,83,74967,20.415849673202615,18
0.05,3672,71,75038,20.42962156275524,29
0.05,3673,8,75046,20.426238432226455,23
0.05,3674,94,75140,20.44625850340136,9
0.05,3675,88,75228,20.46463547334059,17
0.05,3676,74,75302,20.479194995920587,27
0.05,3677,-20,75282,20.468189233278956,59
0.05,3678,27,75309,20.469964664310954,74
0.05,3679,-116,75193,20.432880434782607,79
0.05,3680,13,75206,20.43086117902744,87
0.05,3681,81,75287,20.447311243889192,19
0.05,3682,86,75373,20.465109964702688,14
0.05,3683,-18,75355,20.454668838219327,120
0.05,3684,-75,75280,20.42876526458616,109
0.05,3685,66,75346,20.44112859468258,36
0.05,3686,71,75417,20.454841334418226,30
0.05,3687,54,75471,20.463937093275486,49
0.05,3688,-339,75132,20.36649498509081,447
0.05,3689,-14,75118,20.35718157181572,46
0.05,3690,8,75126,20.353833649417503,92
0.05,3691,21,75147,20.35400866738895,81
0.05,3692,-1,75146,20.3482263742215,103
0.05,3693,-373,74773,20.241743367623172,338
0.05,3694,65,74838,20.25385656292287,36
0.05,3695,91,74929,20.272997835497836,9
0.05,3696,-280,74649,20.19177711658101,245
0.05,3697,44,74693,20.19821525148729,58
0.05,3698,42,74735,20.20410921870776,58
0.05,3699,-35,74700,20.18918918918919,68
0.05,3700,20,74720,20.189138070791678,83
0.05,3701,-185,74535,20.133711507293356,291
0.05,3702,48,74583,20.14123683499865,53
0.05,3703,-118,74465,20.103941684665227,222
0.05,3704,89,74554,20.122537112010797,11
0.05,3705,4,74558,20.118186724230977,27
0.05,3706,-39,74519,20.10223900728352,73
0.05,3707,18,74537,20.101672060409925,82
0.05,3708,6,74543,20.09787004583446,108
0.05,3709,-59,74484,20.07654986522911,99
0.05,3710,45,74529,20.083265966046888,55
0.05,3711,27,74556,20.08512931034483,73
0.05,3712,42,74598,20.091031510907623,74
0.05,3713,-25,74573,20.078890683898763,113
0.05,3714,-105,74468,20.04522207267833,214
0.05,3715,9,74477,20.042249730893435,92
0.05,3716,83,74560,20.059187516814635,17
0.05,3717,88,74648,20.077461000537923,12
0.05,3718,41,74689,20.083086851304113,64
0.05,3719,94,74783,20.10295698924731,6
0.05,3720,53,74836,20.111797903789302,48
0.05,3721,71,74907,20.12547017732402,50
0.05,3722,62,74969,20.13671770077894,38
0.05,3723,22,74991,20.137218045112782,80
0.05,3724,21,75012,20.13744966442953,80
0.05,3725,41,75053,20.143048845947398,62
0.05,3726,84,75137,20.160182452374563,16
0.05,3727,95,75232,20.180257510729614,6
0.05,3728,58,75290,20.190399570930545,42
0.05,3729,37,75327,20.194906166219837,63
0.05,3730,-1,75326,20.189225408737602,103
0.05,3731,-67,75259,20.165862808145768,173
0.05,3732,61,75320,20.17680150013394,41
0.05,3733,-6,75314,20.169791108730585,107
0.05,3734,62,75376,20.180990629183402,39
0.05,3735,-26,75350,20.1686295503212,129
0.05,3736,26,75376,20.17018999197217,74
0.05,3737,15,75391,20.16880684858213,87
0.05,3738,88,75479,20.1869483819203,12
0.05,3739,87,75566,20.204812834224597,14
0.05,3740,-102,75464,20.172146484897088,141
0.05,3741,-17,75447,20.162212720470336,49
0.05,3742,-55,75392,20.14213197969543,157
0.05,3743,46,75438,20.14903846153846,55
0.05,3744,94,75532,20.168758344459278,6
0.05,3745,2,75534,20.163908168713295,101
0.05,3746,90,75624,20.182546036829464,11
0.05,3747,23,75647,20.183297758804695,79
0.05,3748,23,75670,20.1840490797546,8
0.05,3749,-211,75459,20.1224,177
0.05,3750,48,75507,20.129832044788056,53
0.05,3751,83,75590,20.146588486140725,18
0.05,3752,94,75684,20.16626698641087,7
0.05,3753,-36,75648,20.151305274374,138
0.05,3754,76,75724,20.16617842876165,25
0.05,3755,71,75795,20.179712460063897,30
0.05,3756,24,75819,20.18072930529678,76
0.05,3757,78,75897,20.19611495476317,22
0.05,3758,57,75954,20.205905826017556,44
0.05,3759,54,76008,20.214893617021275,46
0.05,3760,20,76028,20.214836479659667,81
0.05,3761,-88,75940,20.18607123870282,189
0.05,3762,-5,75935,20.179378155726813,108
0.05,3763,-3,75932,20.173219978746015,35
0.05,3764,70,76002,20.18645418326693,32
0.05,3765,62,76064,20.197557089750397,39
0.05,3766,-80,75984,20.170958322272366,113
0.05,3767,30,76014,20.173566878980893,70
0.05,3768,-29,75985,20.160520031838683,61
0.05,3769,80,76065,20.176392572944298,21
0.05,3770,76,76141,20.19119596923893,24
0.05,3771,61,76202,20.202014846235418,39
0.05,3772,80,76282,20.217863768884175,20
0.05,3773,89,76371,20.236089030206678,11
0.05,3774,68,76439,20.248741721854305,33
0.05,3775,85,76524,20.265889830508474,16
0.05,3776,-117,76407,20.229547259729944,149
0.05,3777,72,76479,20.243250397035467,29
0.05,3778,92,76571,20.26223868748346,8
0.05,3779,36,76607,20.266402116402116,66
0.05,3780,-48,76559,20.248346998148637,79
0.05,3781,-67,76492,20.22527763088313,169
0.05,3782,9,76501,20.222310335712397,94
0.05,3783,-38,76463,20.206923890063425,69
0.05,3784,79,76542,20.222457067371202,21
0.05,3785,-73,76469,20.19783412572636,174
0.05,3786,48,76517,20.20517560073937,53
0.05,3787,28,76545,20.207233368532208,73
0.05,3788,-55,76490,20.187384534177884,157
0.05,3789,45,76535,20.193931398416886,56
0.05,3790,-15,76520,20.18464785017146,116
0.05,3791,80,76600,20.20042194092827,21
0.05,3792,-124,76476,20.162404429211705,157
0.05,3793,-134,76342,20.121771217712176,169
0.05,3794,-133,76209,20.081422924901187,175
0.05,3795,26,76235,20.082982086406744,6
0.05,3796,76,76311,20.09770871740848,24
0.05,3797,-6,76305,20.09083728278041,38
0.05,3798,84,76389,20.107659910502765,16
0.05,3799,-57,76332,20.08736842105263,88
0.05,3800,28,76360,20.089450144698763,73
0.05,3801,-86,76274,20.06154655444503,137
0.05,3802,92,76366,20.080462792532213,8
0.05,3803,69,76435,20.093322818086225,32
0.05,3804,44,76479,20.099605781865964,58
0.05,3805,49,76528,20.10719915922228,53
0.05,3806,-19,76509,20.09692671394799,124
0.05,3807,86,76595,20.11423319327731,14
0.05,3808,49,76644,20.1218167498031,100
0.05,3809,41,76685,20.12729658792651,60
0.05,3810,86,76771,20.144581474678564,14
0.05,3811,40,76811,20.149790136411333,61
0.05,3812,-45,76766,20.13270390768424,148
0.05,3813,-76,76690,20.107498689040376,178
0.05,3814,88,76778,20.12529488859764,12
0.05,3815,62,76840,20.136268343815512,40
0.05,3816,88,76928,20.154047681425205,12
0.05,3817,62,76990,20.165007857517026,40
0.05,3818,0,76990,20.15972767740246,31
0.05,3819,49,77039,20.167277486910994,53
0.05,3820,82,77121,20.183459827270347,19
0.05,3821,48,77169,20.190737833594977,59
0.05,3822,-9,77160,20.183102275699714,110
0.05,3823,-81,77079,20.156642259414227,181
0.05,3824,94,77173,20.1759477124183,6
0.05,3825,-32,77141,20.16231050705698,134
0.05,3826,89,77230,20.18029788345963,12
0.05,3827,-28,77202,20.16771159874608,129
0.05,3828,36,77238,20.171846435100548,64
0.05,3829,-354,76884,20.074151436031332,390
0.05,3830,-64,76820,20.052205690420255,99
0.05,3831,-120,76700,20.015657620041754,260
0.05,3832,55,76755,20.024784763892512,45
0.05,3833,86,76841,20.041992696922275,14
0.05,3834,40,76881,20.047196870925685,60
0.05,3835,44,76925,20.053441084462982,57
0.05,3836,69,76994,20.066197550169402,32
0.05,3837,-96,76898,20.035956227201666,127
0.05,3838,88,76986,20.05365980724147,13
0.05,3839,-50,76936,20.035416666666666,137
0.05,3840,-8,76928,20.0281176776881,111
0.05,3841,46,76974,20.03487766788131,56
0.05,3842,10,76984,20.032266458495968,91
0.05,3843,64,77048,20.043704474505724,37
0.05,3844,52,77100,20.052015604681404,49
0.05,3845,76,77176,20.0665626625065,24
0.05,3846,5,77181,20.06264621783208,27
0.05,3847,-56,77125,20.04287941787942,159
0.05,3848,23,77148,20.04364770070148,9
0.05,3849,10,77158,20.04103896103896,21
0.05,3850,-132,77026,20.00155803687354,95
0.05,3851,-47,76979,19.984164070612668,149
0.05,3852,83,77062,20.00051907604464,17
0.05,3853,68,77130,20.01297353399066,32
0.05,3854,95,77225,20.03242542153048,6
0.05,3855,45,77270,20.03890041493776,55
0.05,3856,45,77315,20.045372050816695,56
0.05,3857,-160,77155,19.998703991705547,204
0.05,3858,25,77180,20.0,75
0.05,3859,94,77274,20.019170984455958,6
0.05,3860,25,77299,20.02046102046102,75
0.05,3861,68,77367,20.032884515794926,33
0.05,3862,74,77441,20.046854776080767,27
0.05,3863,-44,77397,20.03027950310559,77
0.05,3864,-79,77318,20.00465717981889,111
0.05,3865,-45,77273,19.98784273150543,147
0.05,3866,49,77322,19.99534522885958,53
0.05,3867,88,77410,20.0129265770424,12
0.05,3868,81,77491,20.028689583871802,19
0.05,3869,-202,77289,19.971317829457366,308
0.05,3870,-150,77139,19.927408938258846,189
0.05,3871,54,77193,19.93620867768595,48
0.05,3872,87,77280,19.953524399690163,13
0.05,3873,42,77322,19.959215281362933,60
0.05,3874,87,77409,19.97651612903226,13
0.05,3875,88,77497,19.99406604747162,12
0.05,3876,88,77585,20.01160691256126,12
0.05,3877,66,77651,20.02346570397112,35
0.05,3878,-53,77598,20.004640371229698,153
0.05,3879,8,77606,20.001546391752576,93
0.05,3880,-31,77575,19.988405050244783,64
0.05,3881,58,77633,19.99819680577022,42
0.05,3882,84,77717,20.01467937161988,17
0.05,3883,81,77798,20.03038105046344,19
0.05,3884,50,77848,20.038095238095238,51
0.05,3885,57,77905,20.047606793618115,44
0.05,3886,5,77910,20.04373552868536,105
0.05,3887,-262,77648,19.97119341563786,369
0.05,3888,30,77678,19.97377217793777,70
0.05,3889,88,77766,19.99125964010283,12
0.05,3890,-51,77715,19.97301464919044,82
0.05,3891,-6,77709,19.96634121274409,38
0.05,3892,76,77785,19.98073465193938,24
0.05,3893,11,77796,19.978428351309706,90
0.05,3894,82,77878,19.994351732991014,19
0.05,3895,17,77895,19.99358316221766,83
0.05,3896,-25,77870,19.98203746471645,58
0.05,3897,87,77957,19.99923037455105,14
0.05,3898,86,78043,20.016157989228006,15
0.05,3899,-51,77992,19.997948717948717,154
0.05,3900,-491,77501,19.866957190463985,569
0.05,3901,48,77549,19.874167093798054,52
0.05,3902,91,77640,19.8923904688701,10
0.05,3903,35,77675,19.89626024590164,68
0.05,3904,86,77761,19.913188220230474,15
0.05,3905,84,77845,19.929595494111624,17
0.05,3906,30,77875,19.932173022779626,70
0.05,3907,-30,77845,19.919396110542475,162
0.05,3908,57,77902,19.928882067024816,43
0.05,3909,-110,77792,19.895652173913042,210
0.05,3910,70,77862,19.90846330861672,31
0.05,3911,82,77944,19.924335378323107,18
0.05,3912,16,77960,19.923332481472016,84
0.05,3913,17,77977,19.922585590189065,84
0.05,3914,2,77979,19.918007662835247,101
0.05,3915,-258,77721,19.847037793667006,370
0.05,3916,21,77742,19.847332141945365,80
0.05,3917,73,77815,19.86089841755998,28
0.05,3918,-79,77736,19.835672365399336,182
0.05,3919,77,77813,19.850255102040816,24
0.05,3920,79,77892,19.865340474368782,21
0.05,3921,-366,77526,19.766955634880162,330
0.05,3922,91,77617,19.785113433596738,10
0.05,3923,-8,77609,19.77803261977574,110
0.05,3924,15,77624,19.776815286624203,85
0.05,3925,2,77626,19.772287315333674,30
0.05,3926,-87,77539,19.745098039215687,120
0.05,3927,79,77618,19.760183299389002,21
0.05,3928,-112,77506,19.726648002036143,146
0.05,3929,-98,77408,19.696692111959287,206
0.05,3930,67,77475,19.7087255151361,33
0.05,3931,67,77542,19.720752797558493,34
0.05,3932,32,77574,19.723874904652938,68
0.05,3933,64,77638,19.73512963904423,37
0.05,3934,70,77708,19.747903430749684,31
0.05,3935,74,77782,19.76168699186992,27
0.05,3936,-21,77761,19.751333502667006,54
0.05,3937,-124,77637,19.714829862874556,87
0.05,3938,87,77724,19.731911652703733,14
0.05,3939,-40,77684,19.716751269035534,141
0.05,3940,43,77727,19.72265922354732,57
0.05,3941,84,77811,19.73896499238965,17
0.05,3942,75,77886,19.752979964494042,25
0.05,3943,-34,77852,19.739350912778903,67
0.05,3944,15,77867,19.738149556400508,85
0.05,3945,74,77941,19.751900658895085,26
0.05,3946,86,78027,19.76868507727388,14
0.05,3947,-8,78019,19.76165146909828,109
0.05,3948,-32,77987,19.748543935173462,135
0.05,3949,44,78031,19.7546835443038,62
0.05,3950,11,78042,19.752467729688686,90
0.05,3951,7,78049,19.74924089068826,102
0.05,3952,-11,78038,19.741462180622314,111
0.05,3953,25,78063,19.74279210925645,6
0.05,3954,2,78065,19.738305941845766,101
0.05,3955,-83,77982,19.712335692618808,188
0.05,3956,-5,77977,19.706090472580236,37
0.05,3957,-19,77958,19.69631126831733,51
0.05,3958,-12,77946,19.688305127557463,115
0.05,3959,73,78019,19.701767676767677,28
0.05,3960,54,78073,19.71042665993436,48
0.05,3961,88,78161,19.72766279656739,12
0.05,3962,24,78185,19.728740852889224,9
0.05,3963,68,78253,19.740918264379413,32
0.05,3964,-99,78154,19.710970996216897,186
0.05,3965,93,78247,19.729450327786182,8
0.05,3966,-46,78201,19.71288127048147,79
0.05,3967,-34,78167,19.699344758064516,139
0.05,3968,-19,78148,19.689594356261022,50
0.05,3969,66,78214,19.701259445843828,35
0.05,3970,23,78237,19.7020901536137,94
0.05,3971,94,78331,19.72079556898288,6
0.05,3972,-46,78285,19.70425371255978,149
0.05,3973,73,78358,19.7176648213387,27
0.05,3974,83,78441,19.733584905660376,18
0.05,3975,75,78516,19.74748490945674,26
0.05,3976,-34,78482,19.733970329394015,67
0.05,3977,57,78539,19.74333836098542,43
0.05,3978,67,78606,19.755214878110078,34
0.05,3979,82,78688,19.770854271356782,18
0.05,3980,89,78777,19.788244159758854,12
0.05,3981,25,78802,19.789552988448015,76
0.05,3982,55,78857,19.798393170976652,46
0.05,3983,11,78868,19.796184738955823,21
0.05,3984,-54,78814,19.77766624843162,156
0.05,3985,39,78853,19.782488710486703,67
0.05,3986,53,78906,19.790820165537998,47
0.05,3987,-67,78839,19.769057171514543,168
0.05,3988,71,78910,19.781900225620458,29
0.05,3989,-44,78866,19.765914786967418,146
0.05,3990,91,78957,19.783763467802554,9
0.05,3991,-22,78935,19.773296593186373,54
0.05,3992,20,78955,19.77335336839469,83
0.05,3993,35,78990,19.777165748622934,65
0.05,3994,-36,78954,19.76320400500626,138
0.05,3995,-89,78865,19.735985985985987,121
0.05,3996,81,78946,19.751313485113837,20
0.05,3997,-343,78603,19.660580290145074,376
0.05,3998,74,78677,19.674168542135533,27
0.05,3999,38,78715,19.67875,64
0.05,4000,75,78790,19.692576855786054,25
0.05,4001,-31,78759,19.67991004497751,62
0.05,4002,71,78830,19.69273045216088,29
0.05,4003,59,78889,19.702547452547453,41
0.05,4004,47,78936,19.70936329588015,54
0.05,4005,48,78984,19.716425361957064,53
0.05,4006,-32,78952,19.703518842026455,133
0.05,4007,62,79014,19.714071856287426,38
0.05,4008,-4,79010,19.708156647543028,106
0.05,4009,68,79078,19.72019950124688,33
0.05,4010,83,79161,19.735976065819,17
0.05,4011,34,79195,19.739531405782653,66
0.05,4012,45,79240,19.745826065287815,57
0.05,4013,36,79276,19.74987543597409,66
0.05,4014,45,79321,19.756164383561643,55
0.05,4015,73,79394,19.769422310756973,29
0.05,4016,-27,79367,19.757779437391086,128
0.05,4017,95,79462,19.776505724240916,6
0.05,4018,-45,79417,19.760388156257775,146
0.05,4019,79,79496,19.775124378109453,21
0.05,4020,-27,79469,19.76349166873912,128
0.05,4021,75,79544,19.777225261064146,25
0.05,4022,79,79623,19.79194630872483,21
0.05,4023,70,79693,19.804423459244532,30
0.05,4024,48,79741,19.81142857142857,53
0.05,4025,95,79836,19.8301043219076,6
0.05,4026,93,79929,19.848274149490937,8
0.05,4027,-45,79884,19.832174776564052,77
0.05,4028,90,79974,19.84959046909903,10
0.05,4029,88,80062,19.866501240694788,13
0.05,4030,-106,79956,19.835276606301164,140
0.05,4031,92,80048,19.853174603174605,8
0.05,4032,-37,80011,19.839077609719812,140
0.05,4033,70,80081,19.851512146752604,33
0.05,4034,-76,80005,19.827757125154896,178
0.05,4035,-119,79886,19.793359762140735,151
0.05,4036,85,79971,19.809512013871686,15
0.05,4037,79,80050,19.82417038137692,22
0.05,4038,90,80140,19.84154493686556,11
0.05,4039,55,80195,19.850247524752476,63
0.05,4040,81,80276,19.865379856471172,20
0.05,4041,-30,80246,19.853043047996042,137
0.05,4042,-27,80219,19.841454365570122,142
0.05,4043,67,80286,19.85311572700297,33
0.05,4044,78,80364,19.867490729295426,23
0.05,4045,46,80410,19.873949579831933,54
0.05,4046,9,80419,19.871262663701508,34
0.05,4047,59,80478,19.88092885375494,42
0.05,4048,-161,80317,19.83625586564584,194
0.05,4049,83,80400,19.85185185185185,19
0.05,4050,72,80472,19.864724759318687,29
0.05,4051,77,80549,19.878825271470877,24
0.05,4052,-13,80536,19.870713052060204,115
0.05,4053,-11,80525,19.863098174642328,113
0.05,4054,36,80561,19.86707768187423,64
0.05,4055,20,80581,19.867110453648916,81
0.05,4056,75,80656,19.880700024648757,26
0.05,4057,81,80737,19.89576145884672,20
0.05,4058,13,80750,19.894062576989405,88
0.05,4059,-224,80526,19.83399014778325,330
0.05,4060,66,80592,19.84535828613642,35
0.05,4061,5,80597,19.84170359428853,26
0.05,4062,67,80664,19.853310361801626,33
0.05,4063,76,80740,19.867125984251967,25
0.05,4064,-23,80717,19.856580565805658,126
0.05,4065,75,80792,19.870142646335466,25
0.05,4066,68,80860,19.881976887140397,32
0.05,4067,70,80930,19.894296951819076,31
0.05,4068,39,80969,19.898992381420495,62
0.05,4069,89,81058,19.915970515970518,11
0.05,4070,42,81100,19.921395234586097,61
0.05,4071,82,81182,19.93664047151277,18
0.05,4072,87,81269,19.953105818806776,13
0.05,4073,-53,81216,19.93519882179676,154
0.05,4074,79,81295,19.94969325153374,22
0.05,4075,45,81340,19.9558390578999,56
0.05,4076,-79,81261,19.931567328918323,189
0.05,4077,78,81339,19.94580676802354,23
0.05,4078,-14,81325,19.937484677617064,116
0.05,4079,46,81371,19.94387254901961,54
0.05,4080,8,81379,19.940945846606223,92
0.05,4081,9,81388,19.93826555609995,22
0.05,4082,43,81431,19.943913788880725,57
0.05,4083,91,81522,19.961312438785505,10
0.05,4084,84,81606,19.976988984088127,18
0.05,4085,19,81625,19.976749877630933,81
0.05,4086,75,81700,19.99021287007585,27
0.05,4087,-3,81697,19.98458904109589,36
0.05,4088,78,81775,19.99877720714111,22
0.05,4089,27,81802,20.000488997555014,75
0.05,4090,77,81879,20.014421901735517,24
0.05,4091,-146,81733,19.973851417399803,251
0.05,4092,45,81778,19.9799657952602,57
0.05,4093,93,81871,19.99780166096727,8
0.05,4094,-51,81820,19.98046398046398,82
0.05,4095,83,81903,19.995849609375,18
0.05,4096,85,81988,20.011715889675372,15
0.05,4097,-37,81951,19.997803806734993,68
0.05,4098,-4,81947,19.991949255916076,112
0.05,4099,58,82005,20.00121951219512,42
0.05,4100,19,82024,20.000975371860523,83
0.05,4101,1,82025,19.99634324719649,30
0.05,4102,2,82027,19.991957104557642,30
0.05,4103,-57,81970,19.973196881091617,161
0.05,4104,95,82065,19.991473812423873,6
0.05,4105,51,82116,19.9990258158792,49
0.05,4106,49,82165,20.00608716824933,51
0.05,4107,3,82168,20.001947419668937,98
0.05,4108,41,82209,20.00705767826722,59
0.05,4109,-3,82206,20.0014598540146,104
0.05,4110,83,82289,20.016784237411823,17
0.05,4111,65,82354,20.02772373540856,36
0.05,4112,-4,82350,20.0218818380744,107
0.05,4113,49,82399,20.02892561983471,107
0.05,4114,47,82446,20.035479951397328,54
0.05,4115,59,82505,20.04494655004859,42
0.05,4116,56,82561,20.053679863978626,44
0.05,4117,-4,82557,20.047838756678,105
0.05,4118,77,82634,20.061665452779803,23
0.05,4119,-168,82466,20.01601941747573,269
0.05,4120,70,82536,20.028148507643778,31
0.05,4121,26,82562,20.02959728287239,75
0.05,4122,53,82615,20.037593984962406,48
0.05,4123,83,82698,20.052861299709022,17
0.05,4124,76,82774,20.066424242424244,24
0.05,4125,62,82836,20.076587493940863,38
0.05,4126,81,82917,20.091349648655196,20
0.05,4127,48,82965,20.098110465116278,54
0.05,4128,41,83006,20.103172681036572,61
0.05,4129,15,83021,20.101937046004842,85
0.05,4130,59,83080,20.111353183248607,42
0.05,4131,-6,83074,20.105033881897388,107
0.05,4132,-42,83032,20.09000725864989,74
0.05,4133,84,83116,20.105466860183842,17
0.05,4134,67,83183,20.116807738814995,34
0.05,4135,-33,83150,20.10396518375242,133
0.05,4136,87,83237,20.120135363790187,13
0.05,4137,18,83255,20.119623006283227,85
0.05,4138,-64,83191,20.09929934766852,107
0.05,4139,17,83208,20.098550724637683,83
0.05,4140,-12,83196,20.090799323834823,125
0.05,4141,37,83233,20.094881699662,63
0.05,4142,68,83301,20.106444605358437,32
0.05,4143,-45,83256,20.090733590733592,82
0.05,4144,77,83333,20.104463208685164,24
0.05,4145,25,83358,20.105643994211288,75
0.05,4146,67,83425,20.116952013503738,34
0.05,4147,66,83491,20.12801350048216,34
0.05,4148,91,83582,20.145095203663534,10
0.05,4149,16,83598,20.14409638554217,85
0.05,4150,86,83684,20.159961455071066,15
0.05,4151,4,83688,20.15606936416185,99
0.05,4152,-86,83602,20.13050806645798,188
0.05,4153,12,83614,20.128550794415023,90
0.05,4154,-211,83403,20.072924187725633,247
0.05,4155,25,83428,20.074109720885467,6
0.05,4156,56,83484,20.082751984604283,44
0.05,4157,90,83574,20.0995670995671,10
0.05,4158,38,83612,20.103871122866074,65
0.05,4159,93,83705,20.12139423076923,8
0.05,4160,48,83753,20.12809420812305,52
0.05,4161,-132,83621,20.091542527630946,234
0.05,4162,37,83658,20.095604131635838,65
0.05,4163,-127,83531,20.060278578290106,161
0.05,4164,17,83548,20.05954381752701,83
0.05,4165,50,83598,20.066730676908307,51
0.05,4166,-58,83540,20.047996160307175,92
0.05,4167,1,83541,20.043426103646834,111
0.05,4168,89,83630,20.05996641880547,11
0.05,4169,91,83721,20.076978417266186,10
0.05,4170,-239,83482,20.014864540877486,272
0.05,4171,74,83556,20.027804410354747,27
0.05,4172,5,83561,20.024203211119097,26
0.05,4173,32,83593,20.02707235265932,69
0.05,4174,-14,83579,20.01892215568862,136
0.05,4175,64,83643,20.029454022988507,36
0.05,4176,1,83644,20.02489825233421,100
0.05,4177,36,83680,20.028721876495933,83
0.05,4178,-11,83669,20.021296960995453,113
0.05,4179,-192,83477,19.970574162679426,296
0.05,4180,11,83488,19.968428605596745,21
0.05,4181,70,83558,19.980392156862745,30
0.05,4182,93,83651,19.997848434138177,8
0.05,4183,25,83676,19.99904397705545,75
0.05,4184,44,83720,20.004778972520906,58
0.05,4185,-115,83605,19.97252747252747,146
0.05,4186,42,83647,19.977788392643898,58
0.05,4187,-20,83627,19.968242597898758,126
0.05,4188,4,83631,19.964430651706852,28
0.05,4189,14,83645,19.963007159904535,87
0.05,4190,71,83716,19.97518492006681,30
0.05,4191,23,83739,19.97590648854962,78
0.05,4192,-9,83730,19.968995945623657,111
0.05,4193,32,83762,19.97186456843109,68
0.05,4194,-145,83617,19.93253873659118,257
0.05,4195,91,83708,19.949475691134413,10
0.05,4196,93,83801,19.966881105551586,7
0.05,4197,-2,83799,19.961648404001906,33
0.05,4198,82,83881,19.976422957847106,18
0.05,4199,73,83954,19.989047619047618,27
0.05,4200,11,83965,19.986907879076412,91
0.05,4201,-17,83948,19.97810566396954,118
0.05,4202,66,84014,19.98905543659291,35
0.05,4203,64,84078,19.99952426260704,37
0.05,4204,47,84125,20.005945303210463,54
0.05,4205,8,84133,20.00309082263433,92
0.05,4206,81,84214,20.017589731400047,20
0.05,4207,-8,84206,20.01093155893536,111
0.05,4208,63,84269,20.021145165122356,37
0.05,4209,2,84271,20.01686460807601,100
0.05,4210,-111,84160,19.985751602944667,213
0.05,4211,46,84206,19.991927825261158,55
0.05,4212,83,84289,20.006883455969618,17
0.05,4213,-24,84265,19.996440436639773,127
0.05,4214,-151,84114,19.955871886120995,183
0.05,4215,-24,84090,19.945445920303605,126
0.05,4216,-459,83631,19.83187099834005,426
0.05,4217,64,83695,19.84234234234234,36
0.05,4218,9,83704,19.83977245792842,92
0.05,4219,87,83791,19.85568720379147,13
0.05,4220,78,83869,19.869462212745795,23
0.05,4221,85,83954,19.88488867835149,15
0.05,4222,-111,83843,19.853895335069854,74
0.05,4223,-51,83792,19.83712121212121,84
0.05,4224,22,83814,19.837633136094674,10
0.05,4225,5,83819,19.834122101277803,102
0.05,4226,37,83856,19.83818310858765,64
0.05,4227,-28,83828,19.82686849574267,128
0.05,4228,-58,83770,19.808465358240717,90
0.05,4229,78,83848,19.822222222222223,22
0.05,4230,71,83919,19.834318128102105,41
0.05,4231,89,84008,19.850661625708884,11
0.05,4232,58,84066,19.859673990077958,42
0.05,4233,74,84140,19.872461029759094,65
0.05,4234,-65,84075,19.85242030696576,169
0.05,4235,78,84153,19.86614730878187,23
0.05,4236,25,84178,19.867358980410668,78
0.05,4237,-57,84121,19.849221330816423,159
0.05,4238,-60,84061,19.83038452465204,92
0.05,4239,89,84150,19.846698113207548,12
0.05,4240,77,84227,19.86017448714926,23
0.05,4241,88,84315,19.876237623762375,13
0.05,4242,89,84404,19.892528871081783,12
0.05,4243,54,84458,19.900565504241282,47
0.05,4244,-142,84316,19.862426383981155,106
0.05,4245,7,84323,19.859397079604335,94
0.05,4246,5,84328,19.855898281139627,36
0.05,4247,82,84410,19.870527306967986,19
0.05,4248,-116,84294,19.83855024711697,149
0.05,4249,-14,84280,19.83058823529412,115
0.05,4250,66,84346,19.84144907080687,34
0.05,4251,64,84410,19.85183443085607,37
0.05,4252,83,84493,19.866682341876324,18
0.05,4253,42,84535,19.871885284438175,58
0.05,4254,92,84627,19.888836662749707,9
0.05,4255,93,84720,19.906015037593985,7
0.05,4256,83,84803,19.92083626967348,18
0.05,4257,93,84896,19.937999060591828,7
0.05,4258,35,84931,19.94153557173045,66
0.05,4259,-332,84599,19.858920187793426,440
0.05,4260,90,84689,19.875381365876557,11
0.05,4261,27,84716,19.877053026748005,84
0.05,4262,-6,84710,19.870982875908986,106
0.05,4263,84,84794,19.886022514071296,17
0.05,4264,34,84828,19.889331770222743,69
0.05,4265,83,84911,19.904125644631975,17
0.05,4266,84,84995,19.919146941645185,16
0.05,4267,76,85071,19.93228678537957,24
0.05,4268,-209,84862,19.87866010775357,312
0.05,4269,14,84876,19.87728337236534,88
0.05,4270,-9,84867,19.870522125965817,40
0.05,4271,77,84944,19.883895131086142,24
0.05,4272,23,84967,19.88462438567751,79
0.05,4273,64,85031,19.894946186242397,37
0.05,4274,67,85098,19.9059649122807,33
0.05,4275,56,85154,19.91440598690365,45
0.05,4276,42,85196,19.919569791910217,65
0.05,4277,92,85288,19.93641888733053,9
0.05,4278,92,85380,19.95326010750175,9
0.05,4279,72,85452,19.965420560747663,30
0.05,4280,81,85533,19.97967764540995,19
0.05,4281,-50,85483,19.963334890238208,82
0.05,4282,-60,85423,19.944664954471165,93
0.05,4283,-191,85232,19.895424836601308,222
0.05,4284,3,85235,19.891481913652274,98
0.05,4285,51,85286,19.8987400839944,49
0.05,4286,-106,85180,19.86937252157686,211
0.05,4287,64,85244,19.879664179104477,36
0.05,4288,80,85324,19.893681510841688,21
0.05,4289,-46,85278,19.87832167832168,77
0.05,4290,79,85357,19.8920997436495,22
0.05,4291,-248,85109,19.82968313140727,293
0.05,4292,-68,85041,19.80922431865828,170
0.05,4293,80,85121,19.82324173265021,21
0.05,4294,77,85198,19.836554132712457,24
0.05,4295,21,85219,19.836824953445067,79
0.05,4296,8,85227,19.83407028159181,24
0.05,4297,-21,85206,19.824569567240577,121
0.05,4298,53,85259,19.83228657827402,66
0.05,4299,24,85283,19.83325581395349,78
0.05,4300,11,85294,19.831202046035806,91
0.05,4301,19,85313,19.831008833100885,81
0.05,4302,86,85399,19.846386242156633,14
0.05,4303,-59,85340,19.82806691449814,159
0.05,4304,71,85411,19.839953542392568,30
0.05,4305,21,85432,19.840222944728286,81
0.05,4306,40,85472,19.844903645228698,63
0.05,4307,-50,85422,19.828690807799443,83
0.05,4308,-16,85406,19.820375957298676,118
0.05,4309,77,85483,19.833642691415314,24
0.05,4310,84,85567,19.84852702389237,17
0.05,4311,56,85623,19.85691094619666,45
0.05,4312,-29,85594,19.84558312079759,60
0.05,4313,46,85640,19.851645804357904,55
0.05,4314,83,85723,19.86628041714948,17
0.05,4315,91,85814,19.882761816496757,10
0.05,4316,90,85904,19.89900393791985,11
0.05,4317,22,85926,19.899490504863362,79
0.05,4318,-82,85844,19.875897198425562,186
0.05,4319,-64,85780,19.85648148148148,96
0.05,4320,92,85872,19.873177505207128,8
0.05,4321,71,85943,19.885006941230913,29
0.05,4322,33,85976,19.888040712468193,69
0.05,4323,19,85995,19.887835337650323,81
0.05,4324,33,86028,19.890867052023122,68
0.05,4325,79,86107,19.90453074433657,21
0.05,4326,72,86179,19.916570372082273,28
0.05,4327,81,86260,19.930683918669132,20
0.05,4328,94,86354,19.947793947793947,7
0.05,4329,34,86388,19.951039260969978,66
0.05,4330,32,86420,19.953821288386052,70
0.05,4331,46,86466,19.95983379501385,54
0.05,4332,65,86531,19.97022847911378,36
0.05,4333,-288,86243,19.899169358560222,422
0.05,4334,54,86297,19.907035755478663,47
0.05,4335,-104,86193,19.878459409594097,205
0.05,4336,4,86197,19.874798247636615,99
0.05,4337,90,86287,19.890963577685568,11
0.05,4338,-71,86216,19.87001613274948,174
0.05,4339,-11,86205,19.862903225806452,122
0.05,4340,80,86285,19.876756507717115,20
0.05,4341,76,86361,19.88968217411331,24
0.05,4342,68,86429,19.900759843426204,33
0.05,4343,-135,86294,19.86510128913444,99
0.05,4344,77,86371,19.87825086306099,23
0.05,4345,72,86443,19.890243902439025,29
0.05,4346,-123,86320,19.85737290085116,154
0.05,4347,68,86388,19.868445262189514,32
0.05,4348,63,86451,19.87836284203265,37
0.05,4349,43,86494,19.88367816091954,72
0.05,4350,-55,86439,19.86646747874052,156
0.05,4351,-96,86343,19.83984375,201
0.05,4352,20,86363,19.839880542154837,80
0.05,4353,81,86444,19.853927423059258,20
0.05,4354,-79,86365,19.831228473019518,184
0.05,4355,78,86443,19.844582185491277,22
0.05,4356,70,86513,19.856093642414507,31
0.05,4357,-91,86422,19.830656264341442,127
0.05,4358,-46,86376,19.81555402615279,148
0.05,4359,30,86406,19.81788990825688,71
0.05,4360,79,86485,19.831460674157302,21
0.05,4361,-4,86481,19.825997248968363,105
0.05,4362,44,86525,19.831537932615174,57
0.05,4363,61,86586,19.84097158570119,40
0.05,4364,61,86647,19.8504009163803,40
0.05,4365,66,86713,19.860971140632156,35
0.05,4366,48,86761,19.86741470116785,52
0.05,4367,76,86837,19.88026556776557,24
0.05,4368,74,86911,19.89265278095674,27
0.05,4369,-109,86802,19.86315789473684,212
0.05,4370,53,86855,19.87073896133608,47
0.05,4371,78,86933,19.884034766697162,23
0.05,4372,52,86985,19.89137891607592,48
0.05,4373,-21,86964,19.882030178326474,123
0.05,4374,71,87035,19.893714285714285,30
0.05,4375,76,87111,19.906535648994517,24
0.05,4376,51,87162,19.91363947909527,49
0.05,4377,44,87206,19.91914116034719,56
0.05,4378,-44,87162,19.904544416533454,144
0.05,4379,74,87236,19.91689497716895,27
0.05,4380,-44,87192,19.90230540972381,147
0.05,4381,82,87274,19.916476494751254,19
0.05,4382,-128,87146,19.88272872461784,162
0.05,4383,57,87203,19.891195255474454,43
0.05,4384,-61,87142,19.872748004561004,166
0.05,4385,-4,87138,19.867305061559506,120
0.05,4386,-7,87131,19.861180761340325,108
0.05,4387,-10,87121,19.85437556973564,113
0.05,4388,46,87167,19.860332649806335,56
0.05,4389,76,87243,19.873120728929386,24
0.05,4390,94,87337,19.890002277385562,6
0.05,4391,-44,87293,19.875455373406194,76
0.05,4392,-396,86897,19.780787616662874,435
0.05,4393,19,86916,19.780609922621757,82
0.05,4394,91,87007,19.796814562002275,9
0.05,4395,53,87060,19.804367606915378,48
0.05,4396,89,87149,19.82010461678417,11
0.05,4397,80,87229,19.833788085493406,21
0.05,4398,40,87269,19.838372357353943,61
0.05,4399,45,87314,19.84409090909091,55
0.05,4400,50,87364,19.850942967507386,50
0.05,4401,39,87403,19.855293048614268,61
0.05,4402,37,87440,19.859186918010447,64
0.05,4403,-78,87362,19.8369663941871,109
0.05,4404,-15,87347,19.82905788876277,47
0.05,4405,87,87434,19.844303222877894,13
0.05,4406,75,87509,19.856818697526663,25
0.05,4407,10,87519,19.854582577132486,92
0.05,4408,22,87541,19.855069176684054,80
0.05,4409,-36,87505,19.842403628117914,68
0.05,4410,-46,87459,19.827476762638856,79
0.05,4411,76,87535,19.840208522212148,24
0.05,4412,57,87592,19.848629050532516,44
0.05,4413,81,87673,19.862483008608972,19
0.05,4414,-81,87592,19.839637599093997,113
0.05,4415,79,87671,19.853034420289855,22
0.05,4416,-64,87607,19.83405026035771,170
0.05,4417,11,87618,19.832050701674966,97
0.05,4418,72,87690,19.8438560760353,28
0.05,4419,80,87770,19.857466063348415,20
0.05,4420,-166,87604,19.8154263741235,267
0.05,4421,63,87667,19.82519222071461,37
0.05,4422,70,87737,19.83653628758761,31
0.05,4423,37,87774,19.840415913200722,63
0.05,4424,85,87859,19.855141242937854,16
0.05,4425,72,87931,19.866922729326706,29
0.05,4426,89,88020,19.88253896543935,11
0.05,4427,-48,87972,19.867208672086722,85
0.05,4428,41,88013,19.87198013095507,59
0.05,4429,-64,87949,19.853047404063204,95
0.05,4430,82,88031,19.867072895508915,19
0.05,4431,95,88126,19.884025270758123,6
0.05,4432,88,88214,19.899390931648995,13
0.05,4433,-30,88184,19.888137122237257,62
0.05,4434,-136,88048,19.852987598647125,171
0.05,4435,-29,88019,19.841974752028854,132
0.05,4436,-185,87834,19.795807978363758,289
0.05,4437,4,87838,19.792248760703018,27
0.05,4438,-200,87638,19.742734850191486,234
0.05,4439,90,87728,19.75855855855856,10
0.05,4440,3,87731,19.754784958342714,97
0.05,4441,7,87738,19.75191355245385,95
0.05,4442,54,87792,19.75962187711006,48
0.05,4443,-68,87724,19.739873987398738,169
0.05,4444,59,87783,19.74870641169854,42
0.05,4445,83,87866,19.76293297345929,17
0.05,4446,-129,87737,19.729480548684506,108
0.05,4447,70,87807,19.740782374100718,31
0.05,4448,88,87895,19.756124971903798,13
0.05,4449,75,87970,19.768539325842696,25
0.05,4450,-83,87887,19.74545046057066,115
0.05,4451,72,87959,19.757187780772686,30
0.05,4452,21,87980,19.757466876263194,79
0.05,4453,-269,87711,19.692635832959137,307
0.05,4454,93,87804,19.70909090909091,7
0.05,4455,-125,87679,19.6766157989228,226
0.05,4456,48,87727,19.68297060803231,53
0.05,4457,87,87814,19.698070883804398,14
0.05,4458,17,87831,19.697465799506617,84
0.05,4459,-114,87717,19.66748878923767,146
0.05,4460,80,87797,19.68101322573414,20
0.05,4461,86,87883,19.695876288659793,15
0.05,4462,-9,87874,19.689446560609454,110
0.05,4463,-46,87828,19.6747311827957,150
0.05,4464,-15,87813,19.666965285554312,116
0.05,4465,90,87903,19.68271383788625,10
0.05,4466,78,87981,19.69576897246474,23
0.05,4467,43,88024,19.700984780662488,57
0.05,4468,-7,88017,19.69501006936675,110
0.05,4469,-27,87990,19.684563758389263,58
0.05,4470,56,88046,19.69268619995527,51
0.05,4471,58,88104,19.701252236135957,43
0.05,4472,84,88188,19.715627095908786,16
0.05,4473,-9,88179,19.709208761734466,112
0.05,4474,-85,88094,19.68581005586592,186
0.05,4475,88,88182,19.701072386058982,13
0.05,4476,58,88240,19.709626982354255,42
0.05,4477,94,88334,19.72621706118803,7
0.05,4478,26,88360,19.727617771824068,76
0.05,4479,-93,88267,19.702455357142856,124
0.05,4480,53,88320,19.70988618611917,48
0.05,4481,89,88409,19.725345827755465,11
0.05,4482,25,88434,19.726522418023645,75
0.05,4483,90,88524,19.742194469223907,11
0.05,4484,-103,88421,19.714827201783724,205
0.05,4485,-54,88367,19.698395006687473,155
0.05,4486,80,88447,19.71183418765322,21
0.05,4487,-151,88296,19.67379679144385,258
0.05,4488,67,88363,19.684339496547114,34
0.05,4489,89,88452,19.69977728285078,12
0.05,4490,71,88523,19.711200178134046,30
0.05,4491,-260,88263,19.64893143365984,372
0.05,4492,59,88322,19.657689739594925,42
0.05,4493,-59,88263,19.64018691588785,160
0.05,4494,84,88347,19.654505005561735,16
0.05,4495,50,88397,19.661254448398576,50
0.05,4496,51,88448,19.668223259951077,49
0.05,4497,-53,88395,19.652067585593596,86
0.05,4498,67,88462,19.662591687041566,34
0.05,4499,90,88552,19.67822222222222,10
0.05,4500,68,88620,19.68895800933126,33
0.05,4501,-100,88520,19.662372278987117,202
0.05,4502,-43,88477,19.648456584499222,143
0.05,4503,71,88548,19.659857904085257,30
0.05,4504,-55,88493,19.64328523862375,86
0.05,4505,35,88528,19.646693297825124,71
0.05,4506,73,88601,19.658531173729752,27
0.05,4507,80,88681,19.671916592724045,20
0.05,4508,-137,88544,19.637170104235974,168
0.05,4509,13,88557,19.63569844789357,18
0.05,4510,-81,88476,19.613389492352027,181
0.05,4511,62,88538,19.62278368794326,39
0.05,4512,-35,88503,19.61068025703523,136
0.05,4513,88,88591,19.625830748781567,12
0.05,4514,-41,88550,19.612403100775193,144
0.05,4515,93,88643,19.628653675819308,7
0.05,4516,87,88730,19.643568740314368,13
0.05,4517,-149,88581,19.606241699867198,184
0.05,4518,-16,88565,19.598362469572916,118
0.05,4519,-50,88515,19.582964601769913,154
0.05,4520,94,88609,19.599424905994248,6
0.05,4521,95,88704,19.61609907120743,6
0.05,4522,-84,88620,19.59319036038028,119
0.05,4523,54,88674,19.60079575596817,46
0.05,4524,10,88684,19.59867403314917,92
0.05,4525,-67,88617,19.57954043305347,171
0.05,4526,90,88707,19.59509609012591,11
0.05,4527,19,88726,19.594964664310954,84
0.05,4528,67,88793,19.60543166261868,33
0.05,4529,19,88812,19.605298013245033,83
0.05,4530,51,88863,19.612226881483117,50
0.05,4531,48,88911,19.618490732568404,53
0.05,4532,15,88926,19.617471872931834,17
0.05,4533,64,88990,19.62726069695633,37
0.05,4534,12,89002,19.62557883131202,20
0.05,4535,26,89028,19.626984126984127,75
0.05,4536,80,89108,19.64029094115054,20
0.05,4537,62,89170,19.649625385632437,39
0.05,4538,32,89202,19.652346331791144,68
0.05,4539,-144,89058,19.616299559471365,176
0.05,4540,22,89080,19.616824487998237,81
0.05,4541,74,89154,19.62879788639366,26
0.05,4542,28,89182,19.63064054589478,75
0.05,4543,22,89204,19.631161971830984,83
0.05,4544,66,89270,19.641364136413642,36
0.05,4545,65,89335,19.651341838979324,36
0.05,4546,-143,89192,19.615570705959975,177
0.05,4547,-119,89073,19.58509234828496,82
0.05,4548,12,89085,19.583424928555726,89
0.05,4549,-69,89016,19.563956043956043,172
0.05,4550,54,89070,19.571522742254448,46
0.05,4551,39,89109,19.57579086115993,62
0.05,4552,75,89184,19.587963979793543,25
0.05,4553,-5,89179,19.582564778216952,112
0.05,4554,12,89191,19.580900109769484,89
0.05,4555,68,89259,19.591527655838455,33
0.05,4556,25,89284,19.592714505156902,76
0.05,4557,4,89288,19.589293549802544,98
0.05,4558,-50,89238,19.574029392410615,152
0.05,4559,-25,89213,19.56425438596491,57
0.05,4560,-42,89171,19.550756413067308,144
0.05,4561,53,89224,19.558088557650155,47
0.05,4562,42,89266,19.563006793776026,71
0.05,4563,90,89356,19.578439964943033,10
0.05,4564,81,89437,19.591894852135816,19
0.05,4565,61,89498,19.60096364432764,43
0.05,4566,76,89574,19.61331289686884,24
0.05,4567,92,89666,19.629159369527144,9
0.05,4568,93,89759,19.645217771941343,8
0.05,4569,88,89847,19.660175054704595,13
0.05,4570,-2,89845,19.65543644716692,34
0.05,4571,92,89937,19.671259842519685,8
0.05,4572,74,90011,19.683140170566368,27
0.05,4573,-74,89937,19.662658504591167,176
0.05,4574,7,89944,19.659890710382513,95
0.05,4575,82,90026,19.673513986013987,19
0.05,4576,63,90089,19.68298011798121,37
0.05,4577,90,90179,19.69833988641328,11
0.05,4578,80,90259,19.711509063114217,22
0.05,4579,-64,90195,19.693231441048034,97
0.05,4580,50,90245,19.699847194935604,51
0.05,4581,92,90337,19.715626364033174,8
0.05,4582,-67,90270,19.696705214924723,171
0.05,4583,75,90345,19.708769633507853,25
0.05,4584,92,90437,19.72453653217012,8
0.05,4585,43,90480,19.729611862189273,65
0.05,4586,84,90564,19.743623283191628,16
0.05,4587,94,90658,19.759808195292067,6
0.05,4588,90,90748,19.77511440400959,11
0.05,4589,62,90810,19.784313725490197,39
0.05,4590,49,90859,19.790677412328467,51
0.05,4591,27,90886,19.79224738675958,74
0.05,4592,-7,90879,19.786414108425866,108
0.05,4593,28,90907,19.788202002612103,108
0.05,4594,-105,90802,19.761044613710556,146
0.05,4595,33,90835,19.763925152306353,67
0.05,4596,52,90887,19.770937567979118,49
0.05,4597,61,90948,19.779904306220097,40
0.05,4598,78,91026,19.792563600782778,23
0.05,4599,62,91088,19.801739130434783,39
0.05,4600,38,91126,19.80569441425777,63
0.05,4601,-376,90750,19.71968709256845,343
0.05,4602,92,90842,19.735389963067565,9
0.05,4603,35,90877,19.7387054735013,66
0.05,4604,70,90947,19.749619978284475,31
0.05,4605,29,90976,19.751628310898827,71
0.05,4606,48,91024,19.75775993054048,53
0.05,4607,84,91108,19.77170138888889,16
0.05,4608,-46,91062,19.757431113039704,146
0.05,4609,-23,91039,19.748156182212583,126
0.05,4610,-38,91001,19.735632183908045,139
0.05,4611,8,91009,19.73308759757155,93
0.05,4612,-48,90961,19.718404508996315,152
0.05,4613,-16,90945,19.710663198959686,116
0.05,4614,17,90962,19.710075839653303,85
0.05,4615,-41,90921,19.696923743500868,143
0.05,4616,72,90993,19.708252111760885,28
0.05,4617,81,91074,19.7215244694673,19
0.05,4618,33,91107,19.724399220610522,68
0.05,4619,79,91186,19.737229437229438,22
0.05,4620,47,91233,19.74312919281541,55
0.05,4621,32,91265,19.74578104716573,70
0.05,4622,59,91324,19.754272117672507,43
0.05,4623,88,91412,19.769031141868513,13
0.05,4624,-68,91344,19.750054054054054,172
0.05,4625,6,91350,19.747081712062258,97
0.05,4626,69,91419,19.75772638858872,31
0.05,4627,-33,91386,19.746326707000865,136
0.05,4628,59,91445,19.754806653704904,66
0.05,4629,91,91536,19.770194384449244,9
0.05,4630,-58,91478,19.75340099330598,160
0.05,4631,32,91510,19.756044905008636,71
0.05,4632,69,91579,19.76667386142888,32
0.05,4633,58,91637,19.774924471299094,43
0.05,4634,76,91713,19.78705501618123,24
0.05,4635,75,91788,19.798964624676444,26
0.05,4636,93,91881,19.814750916540866,7
0.05,4637,29,91910,19.816731349719706,74
0.05,4638,-15,91895,19.80922612632033,47
0.05,4639,15,91910,19.808189655172413,85
0.05,4640,-20,91890,19.79961215255333,120
0.05,4641,13,91903,19.79814735028005,89
0.05,4642,47,91950,19.804006030583675,54
0.05,4643,1,91951,19.799956933677866,99
0.05,4644,67,92018,19.810118406889128,33
0.05,4645,58,92076,19.81833835557469,42
0.05,4646,79,92155,19.8310738110609,21
0.05,4647,95,92250,19.84724612736661,6
0.05,4648,-111,92139,19.81910088191009,74
0.05,4649,89,92228,19.833978494623654,12
0.05,4650,71,92299,19.8449795742851,30
0.05,4651,85,92384,19.858985382631126,16
0.05,4652,91,92475,19.874274661508704,10
0.05,4653,54,92529,19.881607219596045,46
0.05,4654,-20,92509,19.873039742212676,133
0.05,4655,41,92550,19.87757731958763,59
0.05,4656,88,92638,19.892205282370625,13
0.05,4657,-505,92133,19.779519106912836,581
0.05,4658,-70,92063,19.76024898046791,174
0.05,4659,66,92129,19.770171673819743,34
0.05,4660,87,92216,19.784595580347563,13
0.05,4661,-29,92187,19.774131274131275,60
0.05,4662,-107,92080,19.74694402745014,213
0.05,4663,82,92162,19.760291595197256,19
0.05,4664,42,92204,19.765058949624866,60
0.05,4665,94,92298,19.78096870981569,6
0.05,4666,-5,92293,19.775658881508463,36
0.05,4667,28,92321,19.777420736932307,73
0.05,4668,54,92375,19.784750481901906,47
0.05,4669,44,92419,19.789935760171307,57
0.05,4670,91,92510,19.8051809034468,10
0.05,4671,40,92550,19.809503424657535,64
0.05,4672,84,92634,19.823239888722448,16
0.05,4673,-129,92505,19.79139922978177,162
0.05,4674,-159,92346,19.753155080213904,265
0.05,4675,-111,92235,19.72519247219846,213
0.05,4676,-68,92167,19.706435749412016,169
0.05,4677,3,92170,19.70286447199658,99
0.05,4678,33,92203,19.70570634751015,75
0.05,4679,-76,92127,19.68525641025641,180
0.05,4680,67,92194,19.695364238410598,33
0.05,4681,87,92281,19.709739427595046,14
0.05,4682,75,92356,19.721546017510143,26
0.05,4683,29,92385,19.723526900085396,72
0.05,4684,-61,92324,19.706296691568838,163
0.05,4685,-16,92308,19.698676909944517,116
0.05,4686,54,92362,19.705995306165992,47
0.05,4687,-61,92301,19.68877986348123,165
0.05,4688,91,92392,19.703988057155044,10
0.05,4689,23,92415,19.704690831556505,9
0.05,4690,38,92453,19.708590918780644,64
0.05,4691,0,92453,19.704390451832907,31
0.05,4692,45,92498,19.709780524184957,56
0.05,4693,85,92583,19.723689816787388,15
0.05,4694,66,92649,19.733546325878596,34
0.05,4695,63,92712,19.7427597955707,38
0.05,4696,-105,92607,19.716201830955928,138
0.05,4697,71,92678,19.727117922520222,30
0.05,4698,16,92694,19.726324749946798,85
0.05,4699,93,92787,19.74191489361702,7
0.05,4700,25,92812,19.743033397149542,7
0.05,4701,-33,92779,19.731816248404932,67
0.05,4702,-57,92722,19.715500744205826,158
0.05,4703,1,92723,19.71152210884354,103
0.05,4704,12,92735,19.70988310308183,89
0.05,4705,-69,92666,19.691032724181895,186
0.05,4706,70,92736,19.70172084130019,31
0.05,4707,67,92803,19.71176720475786,33
0.05,4708,79,92882,19.724357613081335,22
0.05,4709,-177,92705,19.682590233545646,215
0.05,4710,94,92799,19.698365527488857,6
0.05,4711,94,92893,19.714134125636672,7
0.05,4712,0,92893,19.709951198811797,100
0.05,4713,21,92914,19.710224862112856,81
0.05,4714,-193,92721,19.66511134676564,226
0.05,4715,78,92799,19.677480916030536,22
0.05,4716,-55,92744,19.661649353402588,157
0.05,4717,17,92761,19.66108520559559,85
0.05,4718,80,92841,19.67387158296249,20
0.05,4719,86,92927,19.68792372881356,14
0.05,4720,-95,92832,19.663630586740098,199
0.05,4721,90,92922,19.678526048284624,11
0.05,4722,55,92977,19.68600465805632,45
0.05,4723,90,93067,19.700889077053343,11
0.05,4724,20,93087,19.70095238095238,81
0.05,4725,-25,93062,19.691493863732543,58
0.05,4726,57,93119,19.699386503067483,43
0.05,4727,94,93213,19.71510152284264,6
0.05,4728,41,93254,19.719602452949882,59
0.05,4729,92,93346,19.73488372093023,8
0.05,4730,32,93378,19.73747622067216,69
0.05,4731,87,93465,19.751690617075234,13
0.05,4732,-23,93442,19.7426579336573,124
0.05,4733,83,93525,19.75602027883397,18
0.05,4734,90,93615,19.770855332629356,11
0.05,4735,81,93696,19.783783783783782,20
0.05,4736,47,93743,19.78952923791429,53
0.05,4737,-18,93725,19.781553398058254,55
0.05,4738,69,93794,19.791939227685166,31
0.05,4739,75,93869,19.803586497890297,25
0.05,4740,18,93887,19.80320607466779,82
0.05,4741,14,93901,19.801982285955294,91
0.05,4742,57,93958,19.809825005270927,45
0.05,4743,42,94000,19.81450252951096,59
0.05,4744,69,94069,19.82486828240253,33
0.05,4745,85,94154,19.838600927096504,15
0.05,4746,25,94179,19.839688224141565,75
0.05,4747,62,94241,19.848567818028645,38
0.05,4748,-35,94206,19.83701831964624,136
0.05,4749,-33,94173,19.825894736842105,64
0.05,4750,59,94232,19.834140181014522,43
0.05,4751,76,94308,19.845959595959595,24
0.05,4752,60,94368,19.854407742478436,43
0.05,4753,72,94440,19.865376525031554,28
0.05,4754,-67,94373,19.847108307045215,169
0.05,4755,52,94425,19.853868797308664,50
0.05,4756,90,94515,19.868614673113306,11
0.05,4757,26,94541,19.869903320722994,74
0.05,4758,-187,94354,19.82643412481614,221
0.05,4759,63,94417,19.83550420168067,37
0.05,4760,75,94492,19.847090947279984,25
0.05,4761,79,94571,19.859512809743805,22
0.05,4762,75,94646,19.871089649380643,25
0.05,4763,12,94658,19.86943744752309,88
0.05,4764,26,94684,19.870724029380902,77
0.05,4765,59,94743,19.87893411665967,42
0.05,4766,18,94761,19.878539962240403,83
0.05,4767,72,94833,19.889471476510067,29
0.05,4768,70,94903,19.899979031243447,31
0.05,4769,-93,94810,19.87631027253669,125
0.05,4770,-92,94718,19.852861035422343,125
0.05,4771,26,94744,19.85414920368818,6
0.05,4772,86,94830,19.868007542426145,15
0.05,4773,79,94909,19.88039379974864,22
0.05,4774,82,94991,19.893403141361258,18
0.05,4775,19,95010,19.89321608040201,82
0.05,4776,68,95078,19.90328658153653,32
0.05,4777,70,95148,19.913771452490582,30
0.05,4778,-195,94953,19.868801004394225,236
0.05,4779,23,94976,19.869456066945606,9
0.05,4780,-162,94814,19.831416021752773,266
0.05,4781,-22,94792,19.82266833960686,125
0.05,4782,90,94882,19.837340581225174,10
0.05,4783,20,94902,19.837374581939798,81
0.05,4784,-42,94860,19.82445141065831,144
0.05,4785,36,94896,19.827831174258254,66
0.05,4786,91,94987,19.842698976394402,10
0.05,4787,45,95032,19.84795321637427,56
0.05,4788,-4,95028,19.842973480893715,36
0.05,4789,67,95095,19.852818371607516,35
0.05,4790,80,95175,19.865372573575453,20
0.05,4791,-207,94968,19.818030050083472,170
0.05,4792,84,95052,19.83142082203213,16
0.05,4793,76,95128,19.84313725490196,24
0.05,4794,70,95198,19.853597497393118,31
0.05,4795,73,95271,19.86467889908257,27
0.05,4796,60,95331,19.87304565353346,41
0.05,4797,-65,95266,19.855356398499374,97
0.05,4798,88,95354,19.86955615753282,12
0.05,4799,66,95420,19.879166666666666,34
0.05,4800,93,95513,19.89439700062487,7
0.05,4801,83,95596,19.907538525614328,18
0.05,4802,54,95650,19.914636685404954,47
0.05,4803,52,95702,19.921315570358036,49
0.05,4804,40,95742,19.925494276795007,62
0.05,4805,90,95832,19.94007490636704,10
0.05,4806,27,95859,19.941543582275848,73
0.05,4807,-12,95847,19.93490016638935,43
0.05,4808,37,95884,19.938448741942192,64
0.05,4809,78,95962,19.95051975051975,22
0.05,4810,-85,95877,19.928705050924965,189
0.05,4811,89,95966,19.94305901911887,12
0.05,4812,-135,95831,19.910866403490548,97
0.05,4813,73,95904,19.921894474449523,27
0.05,4814,94,95998,19.937279335410178,6
0.05,4815,-246,95752,19.88205980066445,352
0.05,4816,-17,95735,19.87440315549097,118
0.05,4817,-11,95724,19.86799501867995,44
0.05,4818,87,95811,19.881925710728368,13
0.05,4819,21,95832,19.882157676348548,79
0.05,4820,-58,95774,19.866002903961835,90
0.05,4821,89,95863,19.88034010783907,11
0.05,4822,95,95958,19.895915405349367,6
0.05,4823,82,96040,19.908789386401327,19
0.05,4824,73,96113,19.91979274611399,27
0.05,4825,25,96138,19.92084542063821,75
0.05,4826,73,96211,19.93184172363787,27
0.05,4827,94,96305,19.947183098591548,7
0.05,4828,-95,96210,19.923379581693933,127
0.05,4829,71,96281,19.933954451345755,29
0.05,4830,22,96303,19.934382115504036,78
0.05,4831,-14,96289,19.92735927152318,45
0.05,4832,70,96359,19.937719842747775,31
0.05,4833,83,96442,19.950765411667355,18
0.05,4834,65,96507,19.96008273009307,35
0.05,4835,92,96599,19.974979321753516,8
0.05,4836,-13,96586,19.968162083936324,116
0.05,4837,-53,96533,19.95307978503514,85
0.05,4838,26,96559,19.954329406902254,122
0.05,4839,45,96604,19.959504132231405,55
0.05,4840,85,96689,19.972939475315016,15
0.05,4841,54,96743,19.979966955803388,53
0.05,4842,79,96822,19.99215362378691,23
0.05,4843,58,96880,20.0,43
0.05,4844,-75,96805,19.980392156862745,109
0.05,4845,-98,96707,19.95604622368964,131
0.05,4846,-118,96589,19.927584072622242,152
0.05,4847,77,96666,19.939356435643564,23
0.05,4848,-83,96583,19.918127448958547,188
0.05,4849,88,96671,19.932164948453607,13
0.05,4850,84,96755,19.94537208822923,16
0.05,4851,86,96841,19.95898598516076,14
0.05,4852,23,96864,19.959612610756235,78
0.05,4853,19,96883,19.959414915533582,84
0.05,4854,11,96894,19.957569515962923,90
0.05,4855,6,96900,19.95469522240527,96
0.05,4856,-32,96868,19.94399835289273,64
0.05,4857,34,96902,19.946891724989708,68
0.05,4858,-40,96862,19.934554435068943,146
0.05,4859,54,96916,19.94156378600823,46
0.05,4860,82,96998,19.954330384694508,18
0.05,4861,-13,96985,19.947552447552447,46
0.05,4862,-104,96881,19.92206456919597,206
0.05,4863,85,96966,19.93544407894737,15
0.05,4864,43,97009,19.940184994861255,61
0.05,4865,72,97081,19.95088368269626,28
0.05,4866,-36,97045,19.93938771317033,139
0.05,4867,9,97054,19.937140509449467,94
0.05,4868,86,97140,19.95070856438694,14
0.05,4869,69,97209,19.960780287474332,32
0.05,4870,34,97243,19.963662492301374,66
0.05,4871,-129,97114,19.933087027914613,232
0.05,4872,-46,97068,19.91955674122717,149
0.05,4873,57,97125,19.927164546573657,43
0.05,4874,90,97215,19.94153846153846,11
0.05,4875,60,97275,19.949753896636587,40
0.05,4876,77,97352,19.961451712118105,24
0.05,4877,93,97445,19.976424764247643,8
0.05,4878,93,97538,19.99139167862267,8
0.05,4879,74,97612,20.00245901639344,59
0.05,4880,78,97690,20.014341323499284,22
0.05,4881,65,97755,20.02355591970504,36
0.05,4882,90,97845,20.037886545156667,11
0.05,4883,-98,97747,20.013718263718264,130
0.05,4884,9,97756,20.011463664278402,94
0.05,4885,72,97828,20.02210397052804,28
0.05,4886,-12,97816,20.015551463065275,112
0.05,4887,83,97899,20.028436988543373,17
0.05,4888,86,97985,20.041930865207608,14
0.05,4889,90,98075,20.056237218813905,11
0.05,4890,89,98164,20.070333265180945,11
0.05,4891,-122,98042,20.04129190515127,225
0.05,4892,62,98104,20.049867157163295,38
0.05,4893,-279,97825,19.988761749080506,381
0.05,4894,0,97825,19.984678243105208,32
0.05,4895,3,97828,19.981209150326798,99
0.05,4896,-16,97812,19.97386154788646,119
0.05,4897,-57,97755,19.95814618211515,157
0.05,4898,58,97813,19.965911410491938,42
0.05,4899,53,97866,19.97265306122449,48
0.05,4900,28,97894,19.974290961028363,101
0.05,4901,-349,97545,19.899020807833537,384
0.05,4902,64,97609,19.908015500713848,37
0.05,4903,15,97624,19.90701468189233,86
0.05,4904,55,97679,19.914169215086645,45
0.05,4905,58,97737,19.921932327761922,43
0.05,4906,-185,97552,19.880171184022824,216
0.05,4907,84,97636,19.89323553382233,16
0.05,4908,16,97652,19.89244245263801,87
0.05,4909,90,97742,19.90672097759674,10
0.05,4910,41,97783,19.911016086336794,59
0.05,4911,53,97836,19.917752442996743,48
0.05,4912,89,97925,19.931813555872175,14
0.05,4913,6,97931,19.92897842897843,25
0.05,4914,-159,97772,19.89257375381485,192
0.05,4915,52,97824,19.899104963384865,51
0.05,4916,58,97882,19.906853772625585,42
0.05,4917,62,97944,19.915412769418463,38
0.05,4918,51,97995,19.92173205936166,51
0.05,4919,-95,97900,19.898373983739837,130
0.05,4920,88,97988,19.912212964844542,12
0.05,4921,-50,97938,19.898008939455504,83
0.05,4922,7,97945,19.895388990452975,95
0.05,4923,31,97976,19.897644191714054,70
0.05,4924,75,98051,19.908832487309645,26
0.05,4925,60,98111,19.916971173365813,40
0.05,4926,-33,98078,19.906230972194034,134
0.05,4927,72,98150,19.916801948051948,28
0.05,4928,74,98224,19.927774396429296,27
0.05,4929,89,98313,19.94178498985801,11
0.05,4930,59,98372,19.949705941999593,42
0.05,4931,94,98466,19.964720194647203,7
0.05,4932,-30,98436,19.95459152645449,130
0.05,4933,-14,98422,19.94770976895014,46
0.05,4934,9,98431,19.94549138804458,91
0.05,4935,-64,98367,19.928484602917344,96
0.05,4936,67,98434,19.938019039902773,35
0.05,4937,7,98441,19.935398946942083,93
0.05,4938,-60,98381,19.919214415873657,91
0.05,4939,73,98454,19.92995951417004,28
0.05,4940,-25,98429,19.92086622141267,137
0.05,4941,-186,98243,19.879198704977743,299
0.05,4942,52,98295,19.885696945174995,48
0.05,4943,85,98380,19.898867313915858,16
0.05,4944,5,98385,19.895854398382205,95
0.05,4945,77,98462,19.90739991912657,24
0.05,4946,-19,98443,19.899535071760663,120
0.05,4947,58,98501,19.90723524656427,43
0.05,4948,4,98505,19.904021014346334,27
0.05,4949,-91,98414,19.88161616161616,192
0.05,4950,68,98482,19.89133508382145,33
0.05,4951,70,98552,19.901453957996768,31
0.05,4952,-89,98463,19.87946698970321,121
0.05,4953,61,98524,19.887767460637868,40
0.05,4954,83,98607,19.90050454086781,17
0.05,4955,-97,98510,19.876916868442294,129
0.05,4956,62,98572,19.885414565261247,40
0.05,4957,-111,98461,19.85901573215006,212
0.05,4958,68,98529,19.868723532970357,34
0.05,4959,89,98618,19.88266129032258,11
0.05,4960,93,98711,19.89739971779883,8
0.05,4961,84,98795,19.91031841999194,17
0.05,4962,88,98883,19.924037880314327,13
0.05,4963,75,98958,19.935132957292506,25
0.05,4964,-110,98848,19.90896273917422,149
0.05,4965,74,98922,19.91985501409585,26
0.05,4966,83,99005,19.93255486208979,18
0.05,4967,-10,98995,19.926529790660226,42
0.05,4968,82,99077,19.93902193600322,19
0.05,4969,1,99078,19.935211267605634,102
0.05,4970,88,99166,19.948903641118488,13
0.05,4971,-132,99034,19.918342719227674,179
0.05,4972,83,99117,19.93102754876332,17
0.05,4973,27,99144,19.93244873341375,75
0.05,4974,79,99223,19.9443216080402,22
0.05,4975,13,99236,19.942926045016076,94
0.05,4976,63,99299,19.951577255374723,37
0.05,4977,47,99346,19.95701084773001,54
0.05,4978,12,99358,19.955412733480618,88
0.05,4979,51,99409,19.96164658634538,49
0.05,4980,-21,99388,19.953423007428228,121
0.05,4981,94,99482,19.968285828984342,6
0.05,4982,91,99573,19.982540638169777,9
0.05,4983,-52,99521,19.968097913322634,85
0.05,4984,85,99606,19.981143430290874,15
0.05,4985,-49,99557,19.967308463698355,81
0.05,4986,22,99579,19.967716061760576,82
0.05,4987,50,99629,19.97373696872494,51
0.05,4988,-50,99579,19.959711365003006,152
0.05,4989,74,99653,19.970541082164328,27
0.05,4990,63,99716,19.979162492486477,46
0.05,4991,-205,99511,19.93409455128205,168
0.05,4992,55,99566,19.941117564590428,45
0.05,4993,94,99660,19.955947136563875,6
0.05,4994,-11,99649,19.94974974974975,42
0.05,4995,-54,99595,19.934947958366692,163
0.05,4996,26,99621,19.93616169701821,74
0.05,4997,81,99702,19.948379351740698,19
0.05,4998,84,99786,19.96119223844769,17
0.05,4999,32,99818,19.9636,83
0.05,5000,-29,99789,19.95380923815237,134
0.05,5001,-141,99648,19.921631347461016,175
0.05,5002,85,99733,19.934639216470117,16
0.05,5003,-187,99546,19.89328537170264,151
0.05,5004,92,99638,19.907692307692308,9
0.05,5005,16,99654,19.906911705952858,86
0.05,5006,88,99742,19.920511284202117,13
0.05,5007,4,99746,19.917332268370608,98
0.05,5008,-4,99742,19.912557396685965,36
0.05,5009,-39,99703,19.900798403193612,139
0.05,5010,80,99783,19.91279185791259,21
0.05,5011,89,99872,19.92657621707901,11
0.05,5012,-35,99837,19.915619389587075,135
0.05,5013,88,99925,19.92919824491424,13
0.05,5014,92,100017,19.94356929212363,9
0.05,5015,88,100105,19.95713716108453,12
0.05,5016,1,100106,19.953358580825196,101
0.05,5017,-101,100005,19.929254683140694,204
0.05,5018,26,100031,19.930464235903568,76
0.05,5019,-81,99950,19.910358565737052,114
0.05,5020,66,100016,19.919537940649274,35
0.05,5021,92,100108,19.93389088012744,8
0.05,5022,-48,100060,19.920366314951224,152
0.05,5023,89,100149,19.93411624203822,12
0.05,5024,93,100242,19.94865671641791,7
0.05,5025,57,100299,19.956028651014723,43
0.05,5026,-28,100271,19.946488959618062,129
0.05,5027,5,100276,19.94351630867144,96
0.05,5028,-75,100201,19.924637104792204,107
0.05,5029,-106,100095,19.899602385685885,142
0.05,5030,56,100151,19.906777976545417,45
0.05,5031,54,100205,19.913553259141494,47
0.05,5032,26,100231,19.91476256705742,76
0.05,5033,0,100231,19.910806515693285,37
0.05,5034,-13,100218,19.904270109235352,53
0.05,5035,-81,100137,19.884233518665607,113
0.05,5036,80,100217,19.896168354179075,20
0.05,5037,81,100298,19.90829694323144,19
0.05,5038,95,100393,19.923199047430046,6
0.05,5039,36,100429,19.926388888888887,64
0.05,5040,20,100449,19.92640349137076,80
0.05,5041,59,100508,19.934153113843713,42
0.05,5042,-112,100396,19.9079912750347,145
0.05,5043,-67,100329,19.890761300555116,99
0.05,5044,-170,100159,19.853121902874133,274
0.05,5045,83,100242,19.86563614744352,17
0.05,5046,82,100324,19.877947295423024,19
0.05,5047,84,100408,19.89064976228209,16
0.05,5048,-10,100398,19.88472964943553,111
0.05,5049,82,100480,19.897029702970297,19
0.05,5050,-426,100054,19.808750742427243,392
0.05,5051,47,100101,19.81413301662708,56
0.05,5052,80,100181,19.826043934296457,20
0.05,5053,59,100240,19.833795013850416,41
0.05,5054,-15,100225,19.826904055390703,116
0.05,5055,85,100310,19.83979430379747,15
0.05,5056,16,100326,19.83903500098873,85
0.05,5057,75,100401,19.84994068801898,26
0.05,5058,51,100452,19.85609804309152,50
0.05,5059,-70,100382,19.838339920948616,111
0.05,5060,66,100448,19.847460976091682,34
0.05,5061,81,100529,19.859541683129198,19
0.05,5062,-34,100495,19.848903811969187,67
0.05,5063,49,100544,19.85466034755134,51
0.05,5064,-46,100498,19.841658440276408,79
0.05,5065,-42,100456,19.829451243584682,142
0.05,5066,79,100535,19.841128873100455,23
0.05,5067,73,100608,19.851617995264405,28
0.05,5068,-107,100501,19.826593016374037,140
0.05,5069,26,100527,19.827810650887574,75
0.05,5070,86,100613,19.84085979096825,14
0.05,5071,68,100681,19.850354889589905,32
0.05,5072,-1,100680,19.846244825547014,32
0.05,5073,93,100773,19.860662199448168,7
0.05,5074,28,100801,19.862266009852217,73
0.05,5075,-28,100773,19.852836879432623,68
0.05,5076,92,100865,19.86704746897774,8
0.05,5077,-157,100708,19.832217408428516,190
0.05,5078,90,100798,19.846032683599134,30
0.05,5079,79,100877,19.857677165354332,39
0.05,5080,49,100926,19.86341271403267,52
0.05,5081,25,100951,19.864423455332545,77
0.05,5082,92,101043,19.87861499114696,8
0.05,5083,-162,100881,19.842840283241543,265
0.05,5084,65,100946,19.851720747295968,37
0.05,5085,17,100963,19.851160047188362,84
0.05,5086,91,101054,19.86514645173973,9
0.05,5087,-46,101008,19.852201257861637,147
0.05,5088,19,101027,19.852033798388682,103
0.05,5089,26,101053,19.853241650294695,75
0.05,5090,82,101135,19.86544883127087,18
0.05,5091,-276,100859,19.807344854674,320
0.05,5092,-64,100795,19.790889456116236,166
0.05,5093,55,100850,19.79780133490381,48
0.05,5094,-73,100777,19.779587831207067,178
0.05,5095,-115,100662,19.75313971742543,219
0.05,5096,74,100736,19.763782617225818,26
0.05,5097,69,100805,19.773440564927423,31
0.05,5098,19,100824,19.773288880172583,82
0.05,5099,-22,100802,19.765098039215687,53
0.05,5100,17,100819,19.76455596941776,84
0.05,5101,71,100890,19.774598196785576,29
0.05,5102,78,100968,19.786008230452676,23
0.05,5103,-28,100940,19.776645768025077,129
0.05,5104,8,100948,19.7743388834476,92
0.05,5105,57,101005,19.7816294555425,43
0.05,5106,-207,100798,19.73722341883689,241
0.05,5107,24,100822,19.738057948316367,8
0.05,5108,68,100890,19.747504403992952,32
0.05,5109,13,100903,19.746183953033267,89
0.05,5110,40,100943,19.750146742320485,63
0.05,5111,47,100990,19.75547730829421,53
0.05,5112,8,100998,19.753178173283786,95
0.05,5113,90,101088,19.766914352757137,10
0.05,5114,-75,101013,19.748387096774195,175
0.05,5115,80,101093,19.76016419077404,20
0.05,5116,85,101178,19.772913816689467,16
0.05,5117,79,101257,19.784486127393514,22
0.05,5118,-10,101247,19.778667708536823,112
0.05,5119,90,101337,19.7923828125,11
0.05,5120,53,101390,19.798867408709235,47
0.05,5121,16,101406,19.798125732135883,15
0.05,5122,67,101473,19.807339449541285,34
0.05,5123,-7,101466,19.802107728337237,40
0.05,5124,6,101472,19.79941463414634,95
0.05,5125,89,101561,19.8129145532579,12
0.05,5126,70,101631,19.82270333528379,31
0.05,5127,-37,101594,19.811622464898598,68
0.05,5128,69,101663,19.821212712029634,31
0.05,5129,-77,101586,19.80233918128655,182
0.05,5130,83,101669,19.8146560124732,17
0.05,5131,89,101758,19.828137178487918,11
0.05,5132,-65,101693,19.811611143580752,99
0.05,5133,35,101728,19.814569536423843,73
0.05,5134,45,101773,19.819474196689388,56
0.05,5135,65,101838,19.828271028037385,35
0.05,5136,-143,101695,19.796573875803,177
0.05,5137,74,101769,19.807123394316854,27
0.05,5138,59,101828,19.814749951352404,42
0.05,5139,69,101897,19.82431906614786,32
0.05,5140,95,101992,19.838941840108927,6
0.05,5141,44,102036,19.843640606767796,58
0.05,5142,84,102120,19.85611510791367,17
0.05,5143,33,102153,19.85867029548989,69
0.05,5144,80,102233,19.87035957240039,20
0.05,5145,-32,102201,19.86027982899339,64
0.05,5146,54,102255,19.866912764717313,48
0.05,5147,44,102299,19.87160062160062,56
0.05,5148,84,102383,19.884055156341038,17
0.05,5149,44,102427,19.88873786407767,64
0.05,5150,1,102428,19.88507086002718,102
0.05,5151,-8,102420,19.87965838509317,115
0.05,5152,38,102458,19.883174849602174,63
0.05,5153,82,102540,19.89522700814901,19
0.05,5154,-44,102496,19.882832201745877,87
0.05,5155,90,102586,19.89643134212568,10
0.05,5156,93,102679,19.910606942020554,8
0.05,5157,54,102733,19.91721597518418,48
0.05,5158,73,102806,19.927505330490405,28
0.05,5159,-51,102755,19.91375968992248,168
0.05,5160,-54,102701,19.899438093392753,86
0.05,5161,80,102781,19.91108097636575,20
0.05,5162,64,102845,19.919620375750533,37
0.05,5163,66,102911,19.928543764523624,52
0.05,5164,14,102925,19.927395934172313,18
0.05,5165,47,102972,19.932636469221833,54
0.05,5166,19,102991,19.93245597058254,83
0.05,5167,-6,102985,19.927438080495357,37
0.05,5168,80,103065,19.93905977945444,20
0.05,5169,89,103154,19.952417794970987,12
0.05,5170,43,103197,19.95687487913363,58
0.05,5171,70,103267,19.966550657385923,30
0.05,5172,50,103317,19.972356466267158,52
0.05,5173,-105,103212,19.948202551217626,69
0.05,5174,-11,103201,19.942222222222224,112
0.05,5175,79,103280,19.953632148377125,21
0.05,5176,-60,103220,19.938188139849334,162
0.05,5177,29,103249,19.93993820007725,72
0.05,5178,64,103313,19.948445645877584,37
0.05,5179,-13,103300,19.942084942084943,116
0.05,5180,85,103385,19.954641961011387,15
0.05,5181,88,103473,19.967773060594364,13
0.05,5182,40,103513,19.97163804746286,62
0.05,5183,-32,103481,19.961612654320987,135
0.05,5184,-75,103406,19.943297974927678,177
0.05,5185,69,103475,19.952757423833397,31
0.05,5186,72,103547,19.962791594370543,29
0.05,5187,86,103633,19.975520431765613,14
0.05,5188,84,103717,19.987858932356907,17
0.05,5189,44,103761,19.992485549132947,56
0.05,5190,23,103784,19.99306492005394,78
0.05,5191,88,103872,20.006163328197225,13
0.05,5192,92,103964,20.02002695936838,8
0.05,5193,71,104035,20.029842125529456,29
0.05,5194,-5,104030,20.02502406159769,37
0.05,5195,87,104117,20.03791377983064,14
0.05,5196,94,104211,20.052145468539543,7
0.05,5197,85,104296,20.06464024624856,15
0.05,5198,65,104361,20.0732833237161,35
0.05,5199,49,104410,20.078846153846154,52
0.05,5200,62,104472,20.08690636416074,38
0.05,5201,89,104561,20.100153787005,12
0.05,5202,94,104655,20.114357101672113,6
0.05,5203,71,104726,20.12413528055342,29
0.05,5204,92,104818,20.13794428434198,8
0.05,5205,85,104903,20.15040338071456,15
0.05,5206,55,104958,20.15709621663146,46
0.05,5207,-13,104945,20.15072964669739,44
0.05,5208,-39,104906,20.139374160107508,143
0.05,5209,11,104917,20.137619961612284,90
0.05,5210,79,104996,20.148915755133373,21
0.05,5211,58,105054,20.15617805065234,44
0.05,5212,-15,105039,20.149434107040094,117
0.05,5213,41,105080,20.15343306482547,60
0.05,5214,90,105170,20.166826462128476,10
0.05,5215,-14,105156,20.16027607361963,115
0.05,5216,56,105212,20.16714586927353,44
0.05,5217,88,105300,20.180145649674206,13
0.05,5218,-165,105135,20.144663728683657,198
0.05,5219,-64,105071,20.128544061302684,166
0.05,5220,84,105155,20.14077762880674,16
0.05,5221,-2,105153,20.136537725009575,33
0.05,5222,-27,105126,20.12751292360712,129
0.05,5223,-8,105118,20.122128637059724,109
0.05,5224,50,105168,20.127846889952153,50
0.05,5225,38,105206,20.131266743207043,63
0.05,5226,85,105291,20.1436770614119,15
0.05,5227,24,105315,20.14441469013007,8
0.05,5228,58,105373,20.151654235991586,48
0.05,5229,-184,105189,20.112619502868068,215
0.05,5230,56,105245,20.119480022940163,44
0.05,5231,-17,105228,20.112385321100916,125
0.05,5232,67,105295,20.121345308618384,34
0.05,5233,70,105365,20.130875047764615,31
0.05,5234,33,105398,20.133333333333333,68
0.05,5235,41,105439,20.13731856378915,60
0.05,5236,50,105489,20.14302081344281,51
0.05,5237,-41,105448,20.131347842688047,145
0.05,5238,57,105505,20.13838518801298,43
0.05,5239,-6,105499,20.133396946564886,109
0.05,5240,56,105555,20.14024041213509,45
0.05,5241,86,105641,20.152804273178177,14
0.05,5242,50,105691,20.158497043677283,51
0.05,5243,-42,105649,20.146643783371474,75
0.05,5244,62,105711,20.154623450905625,39
0.05,5245,64,105775,20.16298131910027,37
0.05,5246,26,105801,20.164093767867353,6
0.05,5247,76,105877,20.174733231707318,25
0.05,5248,9,105886,20.172604305582016,91
0.05,5249,-32,105854,20.162666666666667,134
0.05,5250,68,105922,20.171776804418204,32
0.05,5251,79,106001,20.182977913175932,21
0.05,5252,95,106096,20.197220635827147,6
0.05,5253,-10,106086,20.19147316330415,112
0.05,5254,-24,106062,20.183063748810657,127
0.05,5255,-27,106035,20.174086757990867,58
0.05,5256,-1,106034,20.17005896899372,102
0.05,5257,55,106089,20.176683149486497,45
0.05,5258,83,106172,20.188629016923368,17
0.05,5259,70,106242,20.19809885931559,32
0.05,5260,-187,106055,20.158715073180005,290
0.05,5261,-86,105969,20.13854047890536,191
0.05,5262,74,106043,20.1487744632339,26
0.05,5263,-56,105987,20.1343085106383,159
0.05,5264,-28,105959,20.125166191832857,128
0.05,5265,-19,105940,20.11773642233194,50
0.05,5266,72,106012,20.127586861591038,28
0.05,5267,3,106015,20.12433561123766,98
0.05,5268,-65,105950,20.108179920288478,165
0.05,5269,70,106020,20.11764705882353,31
0.05,5270,92,106112,20.131284386264465,9
0.05,5271,-174,105938,20.094461305007588,278
0.05,5272,-71,105867,20.077185662810543,171
0.05,5273,65,105932,20.085703450891163,36
0.05,5274,82,106014,20.09744075829384,18
0.05,5275,-9,106005,20.091925701288854,41
0.05,5276,-10,105995,20.08622323289748,111
0.05,5277,50,106045,20.091890867752937,50
0.05,5278,93,106138,20.10570183746922,8
0.05,5279,50,106188,20.111363636363638,51
0.05,5280,50,106238,20.117023291043363,51
0.05,5281,-71,106167,20.099772813328286,174
0.05,5282,1,106168,20.096157486276738,101
0.05,5283,83,106251,20.108062074186222,18
0.05,5284,-6,106245,20.103122043519395,106
0.05,5285,71,106316,20.11275066212637,30
0.05,5286,28,106344,20.11424248155854,74
0.05,5287,53,106397,20.120461422087747,48
0.05,5288,92,106489,20.134051805634336,8
0.05,5289,88,106577,20.146880907372402,13
0.05,5290,88,106665,20.159705159705158,12
0.05,5291,67,106732,20.168556311413454,34
0.05,5292,-95,106637,20.146797657283205,195
0.05,5293,70,106707,20.15621458254628,30
0.05,5294,64,106771,20.164494806421153,38
0.05,5295,-40,106731,20.153134441087612,71
0.05,5296,-22,106709,20.145176515008494,125
0.05,5297,8,106717,20.142884107210268,23
0.05,5298,88,106805,20.155689752783545,12
0.05,5299,83,106888,20.16754716981132,17
0.05,5300,29,106917,20.169213355970573,72
0.05,5301,15,106932,20.168238400603546,16
0.05,5302,-59,106873,20.153309447482556,162
0.05,5303,29,106902,20.15497737556561,72
0.05,5304,-31,106871,20.145334590009426,131
0.05,5305,25,106896,20.14624952883528,6
0.05,5306,15,106911,20.14527981910684,16
0.05,5307,-358,106553,20.074039186134137,394
0.05,5308,-60,106493,20.058956488980975,165
0.05,5309,79,106572,20.07005649717514,21
0.05,5310,45,106617,20.07475051779326,55
0.05,5311,58,106675,20.081890060240966,43
0.05,5312,85,106760,20.094108789760963,23
0.05,5313,51,106811,20.099924727135868,49
0.05,5314,28,106839,20.101411100658513,74
0.05,5315,76,106915,20.111926260346124,25
0.05,5316,83,106998,20.12375399661463,17
0.05,5317,87,107085,20.136329447160588,14
0.05,5318,45,107130,20.141003948110548,55
0.05,5319,57,107187,20.147932330827068,44
0.05,5320,45,107232,20.15260289419282,57
0.05,5321,89,107321,20.16553927095077,11
0.05,5322,66,107387,20.174149915461207,34
0.05,5323,63,107450,20.182193839218634,40
0.05,5324,-55,107395,20.168075117370893,87
0.05,5325,58,107453,20.175178370259108,43
0.05,5326,39,107492,20.178712220762154,62
0.05,5327,45,107537,20.18337087087087,58
0.05,5328,-46,107491,20.170951398010885,148
0.05,5329,88,107579,20.183677298311444,12
0.05,5330,73,107652,20.193584693303322,27
0.05,5331,23,107675,20.19411102775694,94
0.05,5332,26,107701,20.19519969998125,75
0.05,5333,-65,107636,20.17922759655043,97
0.05,5334,2,107638,20.17582005623243,101
0.05,5335,-102,107536,20.152923538230883,211
0.05,5336,30,107566,20.154768596589843,70
0.05,5337,60,107626,20.162233046084676,42
0.05,5338,4,107630,20.15920584379097,126
0.05,5339,95,107725,20.173220973782772,6
0.05,5340,18,107743,20.172814079760343,14
0.05,5341,63,107806,20.180831149382254,38
0.05,5342,-29,107777,20.17162642710088,131
0.05,5343,-10,107767,20.165980538922156,110
0.05,5344,-20,107747,20.158465855940133,120
0.05,5345,87,107834,20.170968948746726,14
0.05,5346,76,107910,20.181410136525155,25
0.05,5347,-147,107763,20.150149588631265,111
0.05,5348,82,107845,20.16171246962049,58
0.05,5349,-25,107820,20.153271028037384,56
0.05,5350,76,107896,20.163707718183517,24
0.05,5351,56,107952,20.170403587443946,44
0.05,5352,76,108028,20.180833177657387,25
0.05,5353,-115,107913,20.155584609637653,220
0.05,5354,90,108003,20.16862745098039,10
0.05,5355,82,108085,20.180171769977594,18
0.05,5356,19,108104,20.17995146537241,82
0.05,5357,76,108180,20.19036954087346,25
0.05,5358,15,108195,20.18940100765068,16
0.05,5359,91,108286,20.202611940298507,10
0.05,5360,77,108363,20.213206491326247,23
0.05,5361,80,108443,20.224356583364415,21
0.05,5362,33,108476,20.22673876561626,67
0.05,5363,-69,108407,20.210104399701716,101
0.05,5364,76,108483,20.220503261882573,25
0.05,5365,63,108546,20.228475587029443,38
0.05,5366,-90,108456,20.207937395192847,123
0.05,5367,-50,108406,20.194858420268258,156
0.05,5368,86,108492,20.207114918979325,15
0.05,5369,87,108579,20.219553072625697,13
0.05,5370,29,108608,20.22118786073357,72
0.05,5371,84,108692,20.23306031273269,17
0.05,5372,30,108722,20.234878094174576,72
0.05,5373,-30,108692,20.225530331224412,62
0.05,5374,21,108713,20.22567441860465,79
0.05,5375,68,108781,20.234561011904763,32
0.05,5376,86,108867,20.24679189138925,15
0.05,5377,86,108953,20.259018222387503,15
0.05,5378,54,109007,20.26529094627254,47
0.05,5379,6,109013,20.26263940520446,27
0.05,5380,-59,108954,20.247909310537075,90
0.05,5381,94,109048,20.261612783351914,7
0.05,5382,42,109090,20.2656511239086,60
0.05,5383,21,109111,20.26578751857355,79
0.05,5384,54,109165,20.27205199628598,48
0.05,5385,85,109250,20.284069810620124,15
0.05,5386,75,109325,20.294226842398366,25
0.05,5387,82,109407,20.30567928730512,18
0.05,5388,76,109483,20.316014102802004,24
0.05,5389,77,109560,20.3265306122449,23
0.05,5390,-69,109491,20.309961046188093,102
0.05,5391,-3,109488,20.305637982195847,105
0.05,5392,65,109553,20.31392545892824,36
0.05,5393,75,109628,20.32406377456433,25
0.05,5394,91,109719,20.3371640407785,9
0.05,5395,-133,109586,20.308747220163085,166
0.05,5396,30,109616,20.31054289420048,70
0.05,5397,-47,109569,20.298073360503892,156
0.05,5398,-250,109319,20.248008890535285,229
0.05,5399,95,109414,20.26185185185185,6
0.05,5400,94,109508,20.275504536197,7
0.05,5401,-5,109503,20.270825620140688,106
0.05,5402,-137,109366,20.241717564316122,182
0.05,5403,84,109450,20.253515914137676,17
0.05,5404,-112,109338,20.22904717853839,214
0.05,5405,85,109423,20.241028486866444,16
0.05,5406,41,109464,20.244867764009616,60
0.05,5407,88,109552,20.257396449704142,12
0.05,5408,47,109599,20.262340543538546,61
0.05,5409,89,109688,20.275046210720888,12
0.05,5410,87,109775,20.287377564221032,14
0.05,5411,84,109859,20.299150036954916,17
0.05,5412,38,109897,20.30242009975984,63
0.05,5413,-60,109837,20.287587735500555,165
0.05,5414,86,109923,20.29972299168975,14
0.05,5415,92,110015,20.312961595273265,9
0.05,5416,-176,109839,20.27672143252723,279
0.05,5417,66,109905,20.28516057585825,34
0.05,5418,-18,109887,20.278095589592176,53
0.05,5419,-107,109780,20.25461254612546,141
0.05,5420,49,109829,20.25991514480723,52
0.05,5421,-152,109677,20.228144596090004,186
0.05,5422,78,109755,20.238797713442743,22
0.05,5423,30,109785,20.240597345132745,70
0.05,5424,-67,109718,20.224516129032256,170
0.05,5425,92,109810,20.237744194618504,9
0.05,5426,-121,109689,20.211719181868435,279
0.05,5427,12,109701,20.210206337509213,89
0.05,5428,64,109765,20.218272241665133,36
0.05,5429,23,109788,20.218784530386742,78
0.05,5430,91,109879,20.23181734487203,9
0.05,5431,73,109952,20.241531664212076,29
0.05,5432,-38,109914,20.230811706239646,140
0.05,5433,86,110000,20.242914979757085,15
0.05,5434,86,110086,20.255013799448022,14
0.05,5435,16,110102,20.254231052244297,15
0.05,5436,7,110109,20.251793268346514,96
0.05,5437,-5,110104,20.24714968738507,106
0.05,5438,-197,109907,20.207207207207208,230
0.05,5439,83,109990,20.21875,18
0.05,5440,78,110068,20.229369601176256,23
0.05,5441,9,110077,20.227306137449467,93
0.05,5442,-54,110023,20.21366893257395,86
0.05,5443,-460,109563,20.12545922116091,566
0.05,5444,66,109629,20.133884297520662,34
0.05,5445,91,109720,20.14689680499449,10
0.05,5446,87,109807,20.159170185423168,14
0.05,5447,32,109839,20.1613436123348,70
0.05,5448,-20,109819,20.15397320609286,51
0.05,5449,42,109861,20.157981651376147,67
0.05,5450,-53,109808,20.144560631076867,159
0.05,5451,71,109879,20.15388848129127,29
0.05,5452,95,109974,20.16761415734458,6
0.05,5453,44,110018,20.17198386505317,58
0.05,5454,17,110035,20.17140238313474,85
0.05,5455,6,110041,20.168804985337243,95
0.05,5456,-109,109932,20.145134689389774,141
0.05,5457,80,110012,20.15610113594723,21
0.05,5458,47,110059,20.161018501557063,54
0.05,5459,56,110115,20.167582417582416,45
0.05,5460,20,110135,20.1675517304523,81
0.05,5461,28,110163,20.16898571951666,73
0.05,5462,-171,109992,20.13399231191653,275
0.05,5463,-10,109982,20.128477306002928,42
0.05,5464,83,110065,20.139981701738336,18
0.05,5465,-16,110049,20.13336992316136,119
0.05,5466,-21,110028,20.125845985000915,52
0.05,5467,61,110089,20.13332114118508,39
0.05,5468,-63,110026,20.118120314499908,97
0.05,5469,61,110087,20.125594149908594,54
0.05,5470,78,110165,20.13617254615244,23
0.05,5471,93,110258,20.149488304093566,7
0.05,5472,-133,110125,20.121505572811987,166
0.05,5473,-240,109885,20.073986116185605,372
0.05,5474,65,109950,20.08219178082192,36
0.05,5475,-9,109941,20.076880934989042,110
0.05,5476,-100,109841,20.05495709329925,134
0.05,5477,66,109907,20.063344286235854,35
0.05,5478,-10,109897,20.05785727322504,110
0.05,5479,41,109938,20.061678832116787,60
0.05,5480,67,110005,20.070242656449555,34
0.05,5481,77,110082,20.080627508208682,23
0.05,5482,-128,109954,20.053620280868138,161
0.05,5483,59,110013,20.060722100656456,42
0.05,5484,19,110032,20.06052871467639,82
0.05,5485,-6,110026,20.055778344877872,38
0.05,5486,-116,109910,20.03098232185165,218
0.05,5487,93,110003,20.04427842565598,7
0.05,5488,53,110056,20.050282382947714,47
0.05,5489,8,110064,20.04808743169399,94
0.05,5490,23,110087,20.048625022764522,79
0.05,5491,11,110098,20.046977421704298,90
0.05,5492,94,110192,20.060440560713637,7
0.05,5493,16,110208,20.059701492537314,85
0.05,5494,-116,110092,20.034940855323022,242
0.05,5495,-19,110073,20.027838427947597,52
0.05,5496,-18,110055,20.02092050209205,49
0.05,5497,31,110086,20.022917424518006,69
0.05,5498,63,110149,20.030732860520093,37
0.05,5499,88,110237,20.04309090909091,12
0.05,5500,-116,110121,20.018360298127615,218
0.05,5501,92,110213,20.031443111595785,8
0.05,5502,57,110270,20.038161003089225,43
0.05,5503,90,110360,20.050872093023255,11
0.05,5504,58,110418,20.05776566757493,43
0.05,5505,66,110484,20.066109698510715,35
0.05,5506,75,110559,20.07608498274923,26
0.05,5507,90,110649,20.088779956427015,10
0.05,5508,-42,110607,20.07750952986023,74
0.05,5509,-138,110469,20.048820326678765,104
0.05,5510,32,110501,20.050988931228453,69
0.05,5511,-36,110465,20.040820029027575,67
0.05,5512,76,110541,20.05097043352077,25
0.05,5513,80,110621,20.06184258251723,20
0.05,5514,39,110660,20.065276518585677,63
0.05,5515,91,110751,20.0781363306744,10
0.05,5516,41,110792,20.081928584375568,60
0.05,5517,69,110861,20.090793765857196,32
0.05,5518,49,110910,20.096031889835114,51
0.05,5519,9,110919,20.094021739130437,93
0.05,5520,35,110954,20.096721608404273,66
0.05,5521,-36,110918,20.086562839550886,138
0.05,5522,42,110960,20.09053050878146,60
0.05,5523,39,110999,20.093953656770456,62
0.05,5524,-46,110953,20.081990950226245,149
0.05,5525,93,111046,20.09518639160333,7
0.05,5526,78,111124,20.10566310837706,22
0.05,5527,-34,111090,20.09587554269175,135
0.05,5528,2,111092,20.092602640622175,101
0.05,5529,46,111138,20.097287522603978,54
0.05,5530,75,111213,20.10721388537335,26
0.05,5531,-70,111143,20.090925524222705,114
0.05,5532,58,111201,20.097776974516538,42
0.05,5533,70,111271,20.106794362125044,31
0.05,5534,25,111296,20.107678410117433,75
0.05,5535,-73,111223,20.090859826589597,105
0.05,5536,60,111283,20.098067545602312,55
0.05,5537,92,111375,20.111050920910074,8
0.05,5538,89,111464,20.123487994222785,11
0.05,5539,45,111509,20.12797833935018,55
0.05,5540,95,111604,20.1414907056488,6
0.05,5541,-59,111545,20.1272103933598,168
0.05,5542,92,111637,20.140176799567023,9
0.05,5543,77,111714,20.1504329004329,24
0.05,5544,67,111781,20.15888187556357,34
0.05,5545,78,111859,20.1693112152903,22
0.05,5546,-7,111852,20.164413196322336,108
0.05,5547,-63,111789,20.14942321557318,165
0.05,5548,89,111878,20.16183096053343,12
0.05,5549,-75,111803,20.144684684684684,111
0.05,5550,49,111852,20.149882903981265,52
0.05,5551,85,111937,20.16156340057637,16
0.05,5552,53,111990,20.167477039438143,48
0.05,5553,89,112079,20.179870363701838,11
0.05,5554,84,112163,20.19135913591359,17
0.05,5555,-92,112071,20.171166306695465,204
0.05,5556,69,112140,20.179953212164836,31
0.05,5557,31,112171,20.181899964015834,71
0.05,5558,57,112228,20.188523115668286,46
0.05,5559,83,112311,20.199820143884892,18
0.05,5560,42,112353,20.20374033447222,73
0.05,5561,-23,112330,20.195972671700826,125
0.05,5562,0,112330,20.192342261369763,31
0.05,5563,84,112414,20.203810208483105,16
0.05,5564,89,112503,20.216172506738545,11
0.05,5565,27,112530,20.217391304347824,76
0.05,5566,49,112579,20.22256152326208,52
0.05,5567,27,112606,20.223778735632184,74
0.05,5568,94,112700,20.237026396121387,6
0.05,5569,18,112718,20.236624775583483,83
0.05,5570,4,112722,20.23371028540657,29
0.05,5571,-9,112713,20.22846374730797,112
0.05,5572,82,112795,20.239547819845683,19
0.05,5573,-47,112748,20.227484750627916,152
0.05,5574,59,112807,20.234439461883408,41
0.05,5575,82,112889,20.24551649928264,18
0.05,5576,89,112978,20.25784471938318,11
0.05,5577,8,112986,20.2556471853711,117
0.05,5578,-11,112975,20.25004481089801,114
0.05,5579,-13,112962,20.244086021505375,113
0.05,5580,75,113037,20.2538971510482,26
0.05,5581,-102,112935,20.231995700465784,136
0.05,5582,67,113002,20.240372559555794,33
0.05,5583,89,113091,20.25268624641834,11
0.05,5584,31,113122,20.254610564010743,70
0.05,5585,-78,113044,20.23702112423917,183
0.05,5586,52,113096,20.242706282441382,60
0.05,5587,-38,113058,20.23228346456693,139
0.05,5588,82,113140,20.243335122562176,19
0.05,5589,-11,113129,20.237745974955278,121
0.05,5590,-21,113108,20.230370237882312,52
0.05,5591,85,113193,20.24195278969957,16
0.05,5592,17,113210,20.241373145002683,84
0.05,5593,-177,113033,20.20611369324276,141
0.05,5594,-3,113030,20.201966041108133,35
0.05,5595,44,113074,20.206218727662616,57
0.05,5596,78,113152,20.216544577452208,23
0.05,5597,-98,113054,20.195426938192213,212
0.05,5598,-107,112947,20.172709412395072,139
0.05,5599,54,113001,20.17875,47
0.05,5600,-20,112981,20.17157650419568,120
0.05,5601,-10,112971,20.166190646197787,113
0.05,5602,86,113057,20.17794038907728,15
0.05,5603,89,113146,20.190221270521057,11
0.05,5604,15,113161,20.1892952720785,85
0.05,5605,16,113177,20.188547984302534,84
0.05,5606,55,113232,20.194756554307116,45
0.05,5607,15,113247,20.1938302425107,17
0.05,5608,-3,113244,20.18969513282225,106
0.05,5609,-7,113237,20.184848484848484,108
0.05,5610,82,113319,20.195865264658707,18
0.05,5611,81,113400,20.206699928724163,19
0.05,5612,-114,113286,20.18278995189738,219
0.05,5613,92,113378,20.195582472390452,8
0.05,5614,-148,113230,20.165627782724844,112
0.05,5615,76,113306,20.1755698005698,30
0.05,5616,72,113378,20.18479615453089,29
0.05,5617,-97,113281,20.163937344250623,73
0.05,5618,68,113349,20.172450613988254,33
0.05,5619,69,113418,20.181138790035586,31
0.05,5620,-74,113344,20.164383561643834,175
0.05,5621,-112,113232,20.14087513340448,148
0.05,5622,80,113312,20.15152054063667,21
0.05,5623,-51,113261,20.138869132290186,82
0.05,5624,-62,113199,20.124266666666667,93
0.05,5625,90,113289,20.13668681123356,10
0.05,5626,-185,113104,20.100231028967478,220
0.05,5627,-427,112677,20.020788912579956,321
0.05,5628,79,112756,20.031266654823238,22
0.05,5629,73,112829,20.040674955595026,28
0.05,5630,91,112920,20.05327650506127,10
0.05,5631,93,113013,20.066228693181817,7
0.05,5632,92,113105,20.078998757322918,8
0.05,5633,72,113177,20.088214412495564,29
0.05,5634,88,113265,20.100266193433896,13
0.05,5635,-221,113044,20.057487579843862,185
0.05,5636,66,113110,20.06563775057655,35
0.05,5637,54,113164,20.07165661582121,46
0.05,5638,77,113241,20.081752083702785,23
0.05,5639,94,113335,20.09485815602837,6
0.05,5640,85,113420,20.106364119836908,15
0.05,5641,81,113501,20.117157036511877,19
0.05,5642,94,113595,20.130249867091973,7
0.05,5643,5,113600,20.12756909992913,96
0.05,5644,-134,113466,20.10026572187777,98
0.05,5645,34,113500,20.10272759475735,67
0.05,5646,57,113557,20.109261554807862,45
0.05,5647,77,113634,20.119334277620396,24
0.05,5648,-55,113579,20.106036466631263,155
0.05,5649,14,113593,20.10495575221239,87
0.05,5650,6,113599,20.102459741638647,97
0.05,5651,73,113672,20.11181882519462,28
0.05,5652,86,113758,20.123474261454096,15
0.05,5653,-28,113730,20.11496285815352,133
0.05,5654,18,113748,20.114588859416447,83
0.05,5655,85,113833,20.12606082036775,16
0.05,5656,17,113850,20.125508219904543,83
0.05,5657,89,113939,20.13768115942029,12
0.05,5658,81,114020,20.148436119455734,19
0.05,5659,-43,113977,20.137279151943464,75
0.05,5660,65,114042,20.145204027556968,35
0.05,5661,16,114058,20.144471918050158,87
0.05,5662,92,114150,20.15716051562776,8
0.05,5663,20,114170,20.15713276836158,82
0.05,5664,84,114254,20.168402471315094,16
0.05,5665,62,114316,20.17578538651606,38
0.05,5666,-81,114235,20.157931886359627,187
0.05,5667,5,114240,20.155257586450247,27
0.05,5668,-43,114197,20.144117128241312,143
0.05,5669,-58,114139,20.130335097001765,89
0.05,5670,92,114231,20.14300828777993,9
0.05,5671,82,114313,20.15391396332863,19
0.05,5672,18,114331,20.153534285210647,13
0.05,5673,14,114345,20.152449770884736,88
0.05,5674,70,114415,20.16123348017621,30
0.05,5675,80,114495,20.171775898520085,20
0.05,5676,-32,114463,20.162585872820152,135
0.05,5677,50,114513,20.167840789010214,51
0.05,5678,-27,114486,20.159535129424196,60
0.05,5679,-117,114369,20.13538732394366,81
0.05,5680,70,114439,20.1441647597254,30
0.05,5681,94,114533,20.157162970784935,6
0.05,5682,-26,114507,20.14904099947211,128
0.05,5683,-30,114477,20.14021815622801,132
0.05,5684,40,114517,20.14371152154793,62
0.05,5685,-46,114471,20.132078790010553,146
0.05,5686,80,114551,20.14260594337964,21
0.05,5687,7,114558,20.140295358649787,94
0.05,5688,23,114581,20.14079803128845,78
0.05,5689,-33,114548,20.13145869947276,138
0.05,5690,84,114632,20.142681426814267,17
0.05,5691,-157,114475,20.111560084328882,259
0.05,5692,-38,114437,20.101352538204814,140
0.05,5693,72,114509,20.110467158412362,28
0.05,5694,53,114562,20.11624231782265,48
0.05,5695,-220,114342,20.074087078651687,257
0.05,5696,-65,114277,20.059153940670527,166
0.05,5697,80,114357,20.06967356967357,21
0.05,5698,72,114429,20.078785751886297,28
0.05,5699,44,114473,20.08298245614035,57
0.05,5700,22,114495,20.083318716014734,81
0.05,5701,-47,114448,20.07155384075763,149
0.05,5702,86,114534,20.083114150447134,15
0.05,5703,11,114545,20.081521739130434,93
0.05,5704,-302,114243,20.0250657318142,339
0.05,5705,62,114305,20.03242201191728,38
0.05,5706,-20,114285,20.025407394427894,124
0.05,5707,41,114326,20.02908199018921,59
0.05,5708,73,114399,20.03836048344719,28
0.05,5709,-160,114239,20.006830122591943,260
0.05,5710,-2,114237,20.002976711609175,105
0.05,5711,88,114325,20.014880952380953,13
0.05,5712,-55,114270,20.001750393838613,86
0.05,5713,43,114313,20.00577528876444,57
0.05,5714,-18,114295,19.99912510936133,118
0.05,5715,91,114386,20.011546536039187,9
0.05,5716,77,114463,20.021514780479272,23
0.05,5717,41,114504,20.025183630640083,60
0.05,5718,39,114543,20.028501486273825,61
0.05,5719,40,114583,20.031993006993005,60
0.05,5720,58,114641,20.038629610208005,43
0.05,5721,83,114724,20.049632995456133,18
0.05,5722,-45,114679,20.038266643368864,150
0.05,5723,-9,114670,20.03319357092942,110
0.05,5724,30,114700,20.034934497816593,70
0.05,5725,16,114716,20.034229828850854,92
0.05,5726,75,114791,20.04382748384844,25
0.05,5727,91,114882,20.056215083798882,10
0.05,5728,69,114951,20.064758247512653,33
0.05,5729,78,115029,20.074869109947645,22
0.05,5730,94,115123,20.08776827778747,6
0.05,5731,-99,115024,20.06699232379623,203
0.05,5732,-12,115012,20.061398918541776,44
0.05,5733,88,115100,20.07324729682595,12
0.05,5734,88,115188,20.08509154315606,13
0.05,5735,65,115253,20.09292189679219,36
0.05,5736,41,115294,20.096566149555517,60
0.05,5737,-185,115109,20.06082258626699,218
0.05,5738,90,115199,20.07300923505837,10
0.05,5739,90,115289,20.08519163763066,10
0.05,5740,61,115350,20.092318411426582,39
0.05,5741,76,115426,20.102055033089517,25
0.05,5742,72,115498,20.11109176388647,29
0.05,5743,79,115577,20.12134401114206,21
0.05,5744,68,115645,20.129677980852914,32
0.05,5745,87,115732,20.141315697876784,13
0.05,5746,68,115800,20.149643292152426,32
0.05,5747,72,115872,20.15866388308977,28
0.05,5748,91,115963,20.170986258479736,10
0.05,5749,16,115979,20.17026086956522,85
0.05,5750,76,116055,20.17996870109546,25
0.05,5751,-316,115739,20.12152294853964,441
0.05,5752,-10,115729,20.116287154528074,41
0.05,5753,74,115803,20.12565172054223,27
0.05,5754,-64,115739,20.111033883579495,97
0.05,5755,49,115788,20.11605281445448,52
0.05,5756,-9,115779,20.110995310057323,109
0.05,5757,69,115848,20.11948593261549,33
0.05,5758,11,115859,20.117902413613475,91
0.05,5759,78,115937,20.12795138888889,23
0.05,5760,-145,115792,20.099288318000347,176
0.05,5761,-52,115740,20.086775425199583,84
0.05,5762,57,115797,20.093180635085893,44
0.05,5763,90,115887,20.10530881332408,10
0.05,5764,62,115949,20.112575888985255,39
0.05,5765,85,116034,20.12382934443288,15
0.05,5766,38,116072,20.126929079243975,67
0.05,5767,-42,116030,20.11615811373093,145
0.05,5768,92,116122,20.128618478072458,8
0.05,5769,45,116167,20.132928942807627,59
0.05,5770,-22,116145,20.12562814070352,74
0.05,5771,86,116231,20.137040887040886,15
0.05,5772,50,116281,20.142213753680927,51
0.05,5773,87,116368,20.153792864565293,14
0.05,5774,13,116381,20.152554112554114,87
0.05,5775,68,116449,20.160837950138504,33
0.05,5776,85,116534,20.17206162368011,15
0.05,5777,-192,116342,20.13534094842506,263
0.05,5778,92,116434,20.147776431908635,12
0.05,5779,-10,116424,20.142560553633217,112
0.05,5780,49,116473,20.147552326587096,53
0.05,5781,53,116526,20.153234175025943,50
0.05,5782,-9,116517,20.148192979422443,110
0.05,5783,85,116602,20.159405255878283,16
0.05,5784,-56,116546,20.146240276577355,88
0.05,5785,94,116640,20.159004493605256,7
0.05,5786,-51,116589,20.146708138932087,83
0.05,5787,83,116672,20.157567380787835,17
0.05,5788,21,116693,20.157712903783036,10
0.05,5789,48,116741,20.162521588946458,53
0.05,5790,65,116806,20.170264203073735,36
0.05,5791,-275,116531,20.119302486187845,307
0.05,5792,-9,116522,20.114275850163992,110
0.05,5793,-198,116324,20.076630997583706,162
0.05,5794,91,116415,20.088869715271787,10
0.05,5795,73,116488,20.09799861973775,28
0.05,5796,6,116494,20.095566672416766,95
0.05,5797,60,116554,20.10244912038634,64
0.05,5798,34,116588,20.104845663045353,67
0.05,5799,41,116629,20.10844827586207,59
0.05,5800,75,116704,20.117910705050853,26
0.05,5801,88,116792,20.12961047914512,13
0.05,5802,-211,116581,20.089781147682235,244
0.05,5803,12,116593,20.088387319090284,89
0.05,5804,66,116659,20.096296296296295,35
0.05,5805,37,116696,20.0992077161557,63
0.05,5806,49,116745,20.104184604787324,51
0.05,5807,31,116776,20.106060606060606,70
0.05,5808,46,116822,20.110518161473575,54
0.05,5809,65,116887,20.118244406196215,43
0.05,5810,77,116964,20.128033040784718,23
0.05,5811,-50,116914,20.115966964900206,83
0.05,5812,-261,116653,20.06760708756236,296
0.05,5813,-21,116632,20.060543515651876,121
0.05,5814,-9,116623,20.05554600171969,40
0.05,5815,57,116680,20.061898211829437,44
0.05,5816,18,116698,20.06154375107444,129
0.05,5817,83,116781,20.072361636301135,18
0.05,5818,59,116840,20.07905138339921,42
0.05,5819,78,116918,20.08900343642612,22
0.05,5820,44,116962,20.093111149287065,56
0.05,5821,-345,116617,20.030401923737546,390
0.05,5822,19,116636,20.03022496994676,81
0.05,5823,24,116660,20.030906593406595,78
0.05,5824,23,116683,20.031416309012876,9
0.05,5825,54,116737,20.037246824579473,47
0.05,5826,-66,116671,20.022481551398663,98
0.05,5827,92,116763,20.034831846259436,8
0.05,5828,94,116857,20.047521015611597,6
0.05,5829,-29,116828,20.03910806174957,131
0.05,5830,-50,116778,20.027096552906876,83
0.05,5831,23,116801,20.027606310013716,78
0.05,5832,52,116853,20.033087605006,67
0.05,5833,25,116878,20.033938978402468,7
0.05,5834,56,116934,20.040102827763498,44
0.05,5835,-35,116899,20.03067169294037,135
0.05,5836,-71,116828,20.015076237793387,173
0.05,5837,14,116842,20.014045906132235,86
0.05,5838,93,116935,20.02654564137695,7
0.05,5839,75,117010,20.035958904109588,26
0.05,5840,37,117047,20.038863208354734,64
0.05,5841,-7,117040,20.0342348510784,108
0.05,5842,-2,117038,20.030463802841005,33
0.05,5843,91,117129,20.042607802874745,9
0.05,5844,84,117213,20.0535500427716,16
0.05,5845,-83,117130,20.035921997947316,115
0.05,5846,57,117187,20.04224388575338,43
0.05,5847,0,117187,20.038816689466483,101
0.05,5848,66,117253,20.046674645238504,34
0.05,5849,41,117294,20.05025641025641,59
0.05,5850,-114,117180,20.027345752862757,217
0.05,5851,40,117220,20.03075871496924,60
0.05,5852,54,117274,20.036562446608578,46
0.05,5853,61,117335,20.04355995900239,39
0.05,5854,95,117430,20.056362083689155,6
0.05,5855,26,117456,20.057377049180328,75
0.05,5856,91,117547,20.069489499743895,10
0.05,5857,-56,117491,20.056503926254695,156
0.05,5858,23,117514,20.057006315070833,78
0.05,5859,-119,117395,20.033276450511945,223
0.05,5860,76,117471,20.042825456406757,27
0.05,5861,73,117544,20.051859433640395,27
0.05,5862,93,117637,20.06430155210643,7
0.05,5863,88,117725,20.07588676671214,13
0.05,5864,94,117819,20.08849104859335,6
0.05,5865,48,117867,20.09324923286737,54
0.05,5866,39,117906,20.09647179137549,63
0.05,5867,39,117945,20.099693251533743,63
0.05,5868,-345,117600,20.037485091156928,314
0.05,5869,-48,117552,20.02589437819421,182
0.05,5870,89,117641,20.037642650315107,12
0.05,5871,40,117681,20.041042234332426,60
0.05,5872,82,117763,20.051592031329815,18
0.05,5873,6,117769,20.049199863806606,26
0.05,5874,66,117835,20.057021276595744,34
0.05,5875,59,117894,20.06364874063989,41
0.05,5876,-58,117836,20.050365832907946,90
0.05,5877,70,117906,20.058863559033686,31
0.05,5878,56,117962,20.06497703691104,47
0.05,5879,55,118017,20.070918367346938,45
0.05,5880,0,118017,20.06750552627104,103
0.05,5881,80,118097,20.0776946616797,21
0.05,5882,24,118121,20.07836138024817,8
0.05,5883,-88,118033,20.059993201903467,195
0.05,5884,-68,117965,20.04502973661852,184
0.05,5885,87,118052,20.056405028882093,13
0.05,5886,41,118093,20.059962629522676,59
0.05,5887,69,118162,20.06827445652174,31
0.05,5888,33,118195,20.070470368483612,68
0.05,5889,36,118231,20.073174872665536,64
0.05,5890,-123,118108,20.048888134442368,155
0.05,5891,75,118183,20.058214528173796,25
0.05,5892,67,118250,20.066180213813,34
0.05,5893,89,118339,20.07787580590431,12
0.05,5894,88,118427,20.089397794741306,12
0.05,5895,49,118476,20.094301221166894,53
0.05,5896,67,118543,20.102255384093606,45
0.05,5897,-67,118476,20.087487283825027,175
0.05,5898,-7,118469,20.08289540600102,108
0.05,5899,68,118537,20.091016949152543,33
0.05,5900,62,118599,20.098118962887646,39
0.05,5901,43,118642,20.10199932226364,57
0.05,5902,36,118678,20.10469252922243,66
0.05,5903,-289,118389,20.052337398373982,404
0.05,5904,14,118403,20.051312447078747,87
0.05,5905,80,118483,20.061462919065356,21
0.05,5906,-100,118383,20.041137633316403,211
0.05,5907,30,118413,20.042823290453622,71
0.05,5908,17,118430,20.04230834320528,83
0.05,5909,64,118494,20.0497461928934,37
0.05,5910,61,118555,20.056673997631535,40
0.05,5911,90,118645,20.068504736129906,11
0.05,5912,-165,118480,20.037206155927617,197
0.05,5913,-53,118427,20.024856273249917,84
0.05,5914,68,118495,20.032967032967033,33
0.05,5915,-100,118395,20.01267748478702,134
0.05,5916,79,118474,20.02264661145851,22
0.05,5917,86,118560,20.033795201081446,14
0.05,5918,-1,118559,20.030241594864,102
0.05,5919,-25,118534,20.022635135135136,57
0.05,5920,-94,118440,20.003377807802735,212
0.05,5921,-238,118202,19.95981087470449,275
0.05,5922,82,118284,19.97028532838089,18
0.05,5923,-117,118167,19.947164078325457,153
0.05,5924,72,118239,19.955949367088607,28
0.05,5925,25,118264,19.95680053999325,76
0.05,5926,30,118294,19.95849502277712,70
0.05,5927,40,118334,19.96187584345479,61
0.05,5928,64,118398,19.969303423848878,36
0.05,5929,85,118483,19.98026981450253,16
0.05,5930,58,118541,19.98668015511718,43
0.05,5931,30,118571,19.988368172623062,71
0.05,5932,89,118660,20.0,11
0.05,5933,85,118745,20.010953825412876,16
0.05,5934,27,118772,20.01213142375737,74
0.05,5935,-7,118765,20.007580862533693,108
0.05,5936,89,118854,20.019201616978272,12
0.05,5937,92,118946,20.031323678006064,8
0.05,5938,-26,118920,20.02357299208621,128
0.05,5939,72,118992,20.032323232323233,28
0.05,5940,-239,118753,19.98872243730012,320
0.05,5941,-165,118588,19.95759003702457,197
0.05,5942,48,118636,19.962308598351,52
0.05,5943,69,118705,19.970558546433377,34
0.05,5944,-110,118595,19.94869638351556,212
0.05,5945,21,118616,19.94887319206189,82
0.05,5946,67,118683,19.956784933579957,34
0.05,5947,-167,118516,19.92535305985205,130
0.05,5948,-157,118359,19.895612708018156,191
0.05,5949,36,118395,19.89831932773109,67
0.05,5950,53,118448,19.90388170055453,48
0.05,5951,76,118524,19.913306451612904,24
0.05,5952,11,118535,19.911809171846127,37
0.05,5953,95,118630,19.92442055760833,6
0.05,5954,-6,118624,19.920067170445005,37
0.05,5955,-211,118413,19.881296171927467,242
0.05,5956,44,118457,19.885344972301493,57
0.05,5957,75,118532,19.894595501846258,25
0.05,5958,79,118611,19.904514180231583,22
0.05,5959,85,118696,19.915436241610738,16
0.05,5960,84,118780,19.92618688139574,17
0.05,5961,-50,118730,19.914458235491445,152
0.05,5962,44,118774,19.918497400637264,57
0.05,5963,86,118860,19.929577464788732,15
0.05,5964,-34,118826,19.92053646269908,134
0.05,5965,-38,118788,19.910828025477706,138
0.05,5966,35,118823,19.91335679570974,67
0.05,5967,82,118905,19.923760053619304,19
0.05,5968,46,118951,19.928128664767968,56
0.05,5969,-77,118874,19.911892797319933,111
0.05,5970,62,118936,19.918941550829008,39
0.05,5971,89,119025,19.93050904219692,11
0.05,5972,-16,119009,19.924493554327807,117
0.05,5973,51,119060,19.929695346501507,50
0.05,5974,-161,118899,19.899414225941424,192
0.05,5975,-57,118842,19.886546184738958,95
0.05,5976,92,118934,19.898611343483353,9
0.05,5977,82,119016,19.908999665439946,18
0.05,5978,65,119081,19.916541227630038,37
0.05,5979,56,119137,19.922575250836122,44
0.05,5980,91,119228,19.934459120548404,9
0.05,5981,48,119276,19.939150785690405,53
0.05,5982,27,119303,19.940330937656693,87
0.05,5983,74,119377,19.949364973262032,27
0.05,5984,88,119465,19.960735171261486,12
0.05,5985,53,119518,19.96625459405279,47
0.05,5986,30,119548,19.967930516118255,72
0.05,5987,12,119560,19.966599866399466,90
0.05,5988,63,119623,19.9737852730005,38
0.05,5989,62,119685,19.980801335559267,38
0.05,5990,70,119755,19.98915039225505,31
0.05,5991,80,119835,19.999165554072096,21
0.05,5992,10,119845,19.997497079926582,93
0.05,5993,95,119940,20.01001001001001,6
0.05,5994,31,119971,20.011843202668892,69
0.05,5995,34,120005,20.01417611741161,66
0.05,5996,77,120082,20.023678505919627,24
0.05,5997,84,120166,20.034344781593866,16
0.05,5998,59,120225,20.040840140023338,41
0.05,5999,88,120313,20.05216666666667,13
0.05,6000,41,120354,20.055657390434927,59
0.05,6001,76,120430,20.06497834055315,36
0.05,6002,94,120524,20.07729468599034,7
0.05,6003,69,120593,20.085443037974684,32
0.05,6004,70,120663,20.09375520399667,31
0.05,6005,12,120675,20.092407592407593,89
0.05,6006,66,120741,20.100049941734643,34
0.05,6007,-161,120580,20.069906790945407,264
0.05,6008,80,120660,20.079880179730406,20
0.05,6009,60,120720,20.086522462562396,40
0.05,6010,71,120791,20.094992513724836,29
0.05,6011,82,120873,20.105289421157686,19
0.05,6012,7,120880,20.103109928488276,25
0.05,6013,-6,120874,20.098769537745262,106
0.05,6014,-12,120862,20.093433083956775,113
0.05,6015,6,120868,20.091090425531913,25
0.05,6016,67,120935,20.0988864882832,33
0.05,6017,43,120978,20.10269192422732,58
0.05,6018,26,121004,20.103671706263498,76
0.05,6019,93,121097,20.11578073089701,8
0.05,6020,-4,121093,20.111775452582627,108
0.05,6021,61,121154,20.118565260710728,39
0.05,6022,-105,121049,20.097791798107256,207
0.05,6023,-75,120974,20.082005312084995,106
0.05,6024,91,121065,20.093775933609958,9
0.05,6025,33,121098,20.09591769000996,89
0.05,6026,82,121180,20.106188816990212,19
0.05,6027,-255,120925,20.060550763105507,218
0.05,6028,64,120989,20.067838779233703,38
0.05,6029,-66,120923,20.05356550580431,105
0.05,6030,-46,120877,20.042613165312552,150
0.05,6031,-41,120836,20.032493368700266,82
0.05,6032,95,120931,20.044919608818166,6
0.05,6033,64,120995,20.052204176334108,36
0.05,6034,62,121057,20.059154929577463,38
0.05,6035,-70,120987,20.044234592445328,102
0.05,6036,40,121027,20.047540168958093,62
0.05,6037,59,121086,20.05399138787678,41
0.05,6038,86,121172,20.064911409173703,14
0.05,6039,69,121241,20.073013245033113,31
0.05,6040,-6,121235,20.06869723555703,107
0.05,6041,29,121264,20.07017543859649,72
0.05,6042,-138,121126,20.044017871917923,172
0.05,6043,78,121204,20.053606882859032,23
0.05,6044,93,121297,20.065674110835403,7
0.05,6045,29,121326,20.067151835924577,71
0.05,6046,42,121368,20.07077889862742,59
0.05,6047,-50,121318,20.05919312169312,151
0.05,6048,72,121390,20.067779798313772,28
0.05,6049,79,121469,20.077520661157024,25
0.05,6050,88,121557,20.08874566187407,13
0.05,6051,50,121607,20.09368803701256,60
0.05,6052,-82,121525,20.076821410870643,114
0.05,6053,-3,121522,20.073009580442683,103
0.05,6054,49,121571,20.07778695293146,60
0.05,6055,66,121637,20.085369881109642,34
0.05,6056,90,121727,20.096912663034505,10
0.05,6057,80,121807,20.10680092439749,21
0.05,6058,71,121878,20.115200528139958,29
0.05,6059,84,121962,20.125742574257426,16
0.05,6060,91,122053,20.137436066655667,10
0.05,6061,91,122144,20.14912570108875,10
0.05,6062,2,122146,20.14613227775029,98
0.05,6063,-155,121991,20.117249340369394,260
0.05,6064,48,122039,20.12184666117065,62
0.05,6065,49,122088,20.126607319485657,51
0.05,6066,-27,122061,20.11883962419647,127
0.05,6067,33,122094,20.120962425840474,67
0.05,6068,89,122183,20.1323117482287,11
0.05,6069,-159,122024,20.102800658978584,193
0.05,6070,82,122106,20.112996211497283,37
0.05,6071,32,122138,20.114953886693016,72
0.05,6072,-93,122045,20.096328009221143,196
0.05,6073,65,122110,20.103720777082646,36
0.05,6074,91,122201,20.115390946502057,9
0.05,6075,-65,122136,20.101382488479263,97
0.05,6076,-8,122128,20.096758268882674,108
0.05,6077,71,122199,20.105133267522213,29
0.05,6078,-80,122119,20.088665898996545,183
0.05,6079,7,122126,20.086513157894736,94
0.05,6080,87,122213,20.0975168557803,14
0.05,6081,-12,122201,20.092239394935877,115
0.05,6082,39,122240,20.0953476902844,64
0.05,6083,72,122312,20.10387902695595,28
0.05,6084,17,122329,20.103368940016434,84
0.05,6085,52,122381,20.108609924416694,50
0.05,6086,-243,122138,20.065385247248233,206
0.05,6087,35,122173,20.067838370565045,65
0.05,6088,76,122249,20.077024141895222,25
0.05,6089,90,122339,20.088505747126437,10
0.05,6090,88,122427,20.099655229026432,13
0.05,6091,-10,122417,20.094714379514116,112
0.05,6092,41,122458,20.09814541276875,60
0.05,6093,31,122489,20.099934361667213,70
0.05,6094,84,122573,20.110418375717803,16
0.05,6095,71,122644,20.118766404199476,29
0.05,6096,-135,122509,20.0933245858619,166
0.05,6097,78,122587,20.102820596917024,23
0.05,6098,84,122671,20.113297261846203,16
0.05,6099,55,122726,20.119016393442624,46
0.05,6100,-1,122725,20.115554827077528,103
0.05,6101,70,122795,20.12372992461488,30
0.05,6102,75,122870,20.13272161232181,25
0.05,6103,-18,122852,20.126474442988204,50
0.05,6104,73,122925,20.135135135135137,27
0.05,6105,86,123011,20.145922043891254,14
0.05,6106,86,123097,20.156705420009825,14
0.05,6107,57,123154,20.162737393582187,45
0.05,6108,82,123236,20.172859715174333,18
0.05,6109,58,123294,20.179050736497544,43
0.05,6110,90,123384,20.19047619047619,11
0.05,6111,87,123471,20.201407068062828,14
0.05,6112,-16,123455,20.19548503189923,118
0.05,6113,94,123549,20.20755642787046,7
0.05,6114,-30,123519,20.199345870809484,61
0.05,6115,50,123569,20.204218443427077,67
0.05,6116,-285,123284,20.154324015040054,321
0.05,6117,52,123336,20.159529257927428,49
0.05,6118,82,123418,20.169635561366235,19
0.05,6119,-15,123403,20.163888888888888,115
0.05,6120,46,123449,20.168109785982683,55
0.05,6121,93,123542,20.18000653381248,7
0.05,6122,79,123621,20.189612934835864,23
0.05,6123,59,123680,20.195950359242325,43
0.05,6124,94,123774,20.208,7
0.05,6125,-60,123714,20.1949069539667,93
0.05,6126,-26,123688,20.18736739023992,127
0.05,6127,-37,123651,20.178035248041777,138
0.05,6128,83,123734,20.18828520150106,17
0.05,6129,-50,123684,20.1768352365416,168
0.05,6130,93,123777,20.188713097374002,8
0.05,6131,23,123800,20.189171559034573,81
0.05,6132,-79,123721,20.172998532528943,188
0.05,6133,-59,123662,20.160091294424518,165
0.05,6134,65,123727,20.167400162999186,35
0.05,6135,64,123791,20.17454367666232,37
0.05,6136,84,123875,20.184943783607626,16
0.05,6137,46,123921,20.1891495601173,55
0.05,6138,-20,123901,20.182603029809414,123
0.05,6139,62,123963,20.189413680781758,40
0.05,6140,16,123979,20.18873147695815,85
0.05,6141,-154,123825,20.160371214588082,188
0.05,6142,93,123918,20.172228552824354,8
0.05,6143,-192,123726,20.1376953125,155
0.05,6144,-16,123710,20.131814483319772,116
0.05,6145,71,123781,20.14009111617312,29
0.05,6146,-90,123691,20.122173417927446,124
0.05,6147,16,123707,20.121502927781393,84
0.05,6148,-193,123514,20.08684338916897,296
0.05,6149,70,123584,20.094959349593495,30
0.05,6150,54,123638,20.100471468053975,47
0.05,6151,27,123665,20.101592977893368,74
0.05,6152,87,123752,20.1124654640013,14
0.05,6153,-17,123735,20.106434839129022,120
0.05,6154,69,123804,20.114378554021123,32
0.05,6155,92,123896,20.126055880441847,8
0.05,6156,80,123976,20.135780412538573,20
0.05,6157,23,123999,20.136245534264372,79
0.05,6158,-182,123817,20.10342588082481,146
0.05,6159,94,123911,20.115422077922076,6
0.05,6160,3,123914,20.112644051290374,97
0.05,6161,-42,123872,20.102564102564102,74
0.05,6162,12,123884,20.1012493915301,90
0.05,6163,37,123921,20.103990914990266,64
0.05,6164,81,124002,20.113868613138685,20
0.05,6165,70,124072,20.121959130716835,30
0.05,6166,84,124156,20.132317172044754,16
0.05,6167,90,124246,20.143644617380026,10
0.05,6168,83,124329,20.153833684551792,18
0.05,6169,74,124403,20.16256077795786,26
0.05,6170,-16,124387,20.156700696807647,47
0.05,6171,2,124389,20.153758911211924,29
0.05,6172,80,124469,20.163453750202496,20
0.05,6173,-56,124413,20.1511175898931,159
0.05,6174,-26,124387,20.143643724696357,127
0.05,6175,58,124445,20.149773316062177,44
0.05,6176,61,124506,20.156386595434675,51
0.05,6177,-213,124293,20.118646811265783,246
0.05,6178,77,124370,20.127852403301507,23
0.05,6179,-79,124291,20.111812297734627,203
0.05,6180,53,124344,20.117133149975732,48
0.05,6181,59,124403,20.12342284050469,48
0.05,6182,15,124418,20.122594209930455,86
0.05,6183,-44,124374,20.11222509702458,146
0.05,6184,50,124424,20.11705739692805,51
0.05,6185,-202,124222,20.08115098609764,237
0.05,6186,92,124314,20.092775173751413,8
0.05,6187,76,124390,20.101809954751133,60
0.05,6188,93,124483,20.1135886249798,7
0.05,6189,-107,124376,20.093053311793216,139
0.05,6190,-25,124351,20.085769665643678,125
0.05,6191,75,124426,20.094638242894057,26
0.05,6192,54,124480,20.10011303084127,47
0.05,6193,-12,124468,20.09493057797869,113
0.05,6194,7,124475,20.09281678773204,93
0.05,6195,32,124507,20.09473854099419,72
0.05,6196,30,124537,20.09633693722769,70
0.05,6197,88,124625,20.10729267505647,13
0.05,6198,60,124685,20.11372802064849,40
0.05,6199,79,124764,20.123225806451615,21
0.05,6200,73,124837,20.131752943073696,30
0.05,6201,89,124926,20.142857142857142,11
0.05,6202,88,125014,20.153796550056423,12
0.05,6203,-176,124838,20.122179239200516,282
0.05,6204,90,124928,20.133440773569703,10
0.05,6205,69,124997,20.141314856590398,32
0.05,6206,-19,124978,20.135008860963428,121
0.05,6207,14,124992,20.1340206185567,101
0.05,6208,-11,124981,20.129006281204703,114
0.05,6209,76,125057,20.138003220611917,24
0.05,6210,39,125096,20.141040090162615,61
0.05,6211,3,125099,20.138280746941405,97
0.05,6212,58,125157,20.144374698213422,42
0.05,6213,65,125222,20.15159317669778,36
0.05,6214,-34,125188,20.142880128720837,135
0.05,6215,79,125267,20.152348777348777,22
0.05,6216,32,125299,20.154254463567636,69
0.05,6217,-75,125224,20.1389514313284,39
0.05,6218,79,125303,20.14841614407461,21
0.05,6219,-41,125262,20.138585209003214,72
0.05,6220,77,125339,20.147725446069764,24
0.05,6221,-10,125329,20.142880102860815,43
0.05,6222,49,125378,20.147517274626384,53
0.05,6223,18,125396,20.147172236503856,82
0.05,6224,51,125447,20.152128514056226,49
0.05,6225,42,125489,20.15563764857051,61
0.05,6226,78,125567,20.16492693110647,22
0.05,6227,81,125648,20.174694926140013,19
0.05,6228,-71,125577,20.16005779418847,177
0.05,6229,41,125618,20.163402889245585,60
0.05,6230,-72,125546,20.148611779810626,175
0.05,6231,51,125597,20.153562259306803,49
0.05,6232,86,125683,20.164126423872933,15
0.05,6233,35,125718,20.1665062560154,67
0.05,6234,86,125804,20.177064955894146,15
0.05,6235,-141,125663,20.1512187299551,177
0.05,6236,14,125677,20.150232483565816,86
0.05,6237,76,125753,20.15918563642193,26
0.05,6238,-140,125613,20.13351498637602,175
0.05,6239,-11,125602,20.12852564102564,43
0.05,6240,94,125696,20.140362121454896,6
0.05,6241,93,125789,20.152034604293494,7
0.05,6242,-96,125693,20.13342944097389,196
0.05,6243,27,125720,20.134529147982065,75
0.05,6244,53,125773,20.139791833466774,48
0.05,6245,34,125807,20.14201088696766,67
0.05,6246,-13,125794,20.136705618696976,114
0.05,6247,-187,125607,20.103553137003843,235
0.05,6248,79,125686,20.11297807649224,21
0.05,6249,73,125759,20.12144,27
0.05,6250,-80,125679,20.10542313229883,182
0.05,6251,0,125679,20.102207293666027,100
0.05,6252,-21,125658,20.095634095634097,62
0.05,6253,13,125671,20.094499520307004,88
0.05,6254,24,125695,20.095123900879297,8
0.05,6255,-63,125632,20.081841432225065,27
0.05,6256,62,125694,20.088540834265622,39
0.05,6257,80,125774,20.098114413550654,21
0.05,6258,48,125822,20.102572295893914,52
0.05,6259,69,125891,20.11038338658147,32
0.05,6260,68,125959,20.118032263216737,33
0.05,6261,87,126046,20.128712871287128,14
0.05,6262,21,126067,20.12885198786524,82
0.05,6263,64,126131,20.135855683269476,36
0.05,6264,57,126188,20.14173982442139,44
0.05,6265,95,126283,20.153686562400257,6
0.05,6266,38,126321,20.156534226902824,64
0.05,6267,90,126411,20.167677089980856,10
0.05,6268,86,126497,20.178178337852927,14
0.05,6269,91,126588,20.189473684210526,10
0.05,6270,72,126660,20.197735608355924,29
0.05,6271,93,126753,20.2093431122449,7
0.05,6272,-100,126653,20.19018013709549,132
0.05,6273,-38,126615,20.18090532355754,70
0.05,6274,-205,126410,20.145019920318724,307
0.05,6275,-164,126246,20.115678776290633,127
0.05,6276,19,126265,20.115501035526524,82
0.05,6277,-68,126197,20.101465434851864,169
0.05,6278,-175,126022,20.0703933747412,139
0.05,6279,-114,125908,20.04904458598726,240
0.05,6280,56,125964,20.054768348989015,45
0.05,6281,90,126054,20.06590257879656,10
0.05,6282,-3,126051,20.06223141811237,35
0.05,6283,76,126127,20.07113303628262,24
0.05,6284,88,126215,20.081941129673826,13
0.05,6285,-82,126133,20.065701559020045,185
0.05,6286,60,126193,20.072053443613807,56
0.05,6287,89,126282,20.083015267175572,11
0.05,6288,3,126285,20.080298934647796,100
0.05,6289,22,126307,20.08060413354531,78
0.05,6290,-9,126298,20.075981560960102,111
0.05,6291,26,126324,20.076923076923077,74
0.05,6292,70,126394,20.08485618941681,30
0.05,6293,67,126461,20.09231013663807,33
0.05,6294,80,126541,20.101826846703734,20
0.05,6295,38,126579,20.10466963151207,63
0.05,6296,62,126641,20.11132285215182,39
0.05,6297,74,126715,20.119879326770402,26
0.05,6298,93,126808,20.131449436418478,7
0.05,6299,69,126877,20.13920634920635,32
0.05,6300,-44,126833,20.129027138549436,147
0.05,6301,36,126869,20.131545541098063,64
0.05,6302,66,126935,20.13882278280184,34
0.05,6303,-8,126927,20.13435913705584,113
0.05,6304,-34,126893,20.125773195876288,136
0.05,6305,94,126987,20.137488106565176,7
0.05,6306,65,127052,20.144601236721105,35
0.05,6307,-179,126873,20.11303107165504,281
0.05,6308,-91,126782,20.095419242352197,198
0.05,6309,93,126875,20.106973058637085,7
0.05,6310,93,126968,20.118523213436855,8
0.05,6311,-2,126966,20.115019011406844,103
0.05,6312,-117,126849,20.093299540630444,159
0.05,6313,-34,126815,20.084732340829902,67
0.05,6314,47,126862,20.08899445764054,53
0.05,6315,39,126901,20.091988600379988,62
0.05,6316,72,126973,20.100205793889504,29
0.05,6317,-210,126763,20.06378600823045,248
0.05,6318,89,126852,20.07469536319038,12
0.05,6319,-84,126768,20.058227848101264,117
0.05,6320,-46,126722,20.047777250435058,148
0.05,6321,38,126760,20.050616893388167,64
0.05,6322,80,126840,20.06009805472086,20
0.05,6323,87,126927,20.07068311195446,14
0.05,6324,90,127017,20.081739130434784,11
0.05,6325,85,127102,20.092001264622194,16
0.05,6326,87,127189,20.102576260470997,14
0.05,6327,64,127253,20.109513274336283,36
0.05,6328,94,127347,20.121188181387264,7
0.05,6329,85,127432,20.131437598736177,16
0.05,6330,83,127515,20.141367872374033,18
0.05,6331,95,127610,20.153190145293745,6
0.05,6332,74,127684,20.16169272066951,26
0.05,6333,45,127729,20.16561414587938,57
0.05,6334,35,127764,20.167955801104974,65
0.05,6335,68,127832,20.175505050505052,33
0.05,6336,14,127846,20.174530534953448,87
0.05,6337,85,127931,20.184758598927107,15
0.05,6338,-3,127928,20.18110112005048,103
0.05,6339,6,127934,20.178864353312303,113
0.05,6340,58,127992,20.18482889134206,45
0.05,6341,46,128038,20.18889940081993,56
0.05,6342,-251,127787,20.146145357086553,215
0.05,6343,72,127859,20.154319041614123,31
0.05,6344,56,127915,20.159968479117417,45
0.05,6345,47,127962,20.164197919949576,54
0.05,6346,74,128036,20.17268000630219,26
0.05,6347,79,128115,20.181947069943288,21
0.05,6348,88,128203,20.192628760434715,13
0.05,6349,-169,128034,20.162834645669292,201
0.05,6350,70,128104,20.17068178239647,30
0.05,6351,80,128184,20.180100755667507,21
0.05,6352,87,128271,20.190618605383282,13
0.05,6353,95,128366,20.202392193893612,6
0.05,6354,76,128442,20.21117230527144,25
0.05,6355,-20,128422,20.204845814977972,52
0.05,6356,-19,128403,20.198678621991505,124
0.05,6357,51,128454,20.20352312047814,49
0.05,6358,11,128465,20.20207579808146,90
0.05,6359,-184,128281,20.16996855345912,218
0.05,6360,78,128359,20.17905989624273,22
0.05,6361,-40,128319,20.169600754479724,140
0.05,6362,70,128389,20.177432028917178,30
0.05,6363,54,128443,20.18274670018856,48
0.05,6364,-10,128433,20.178004713275726,113
0.05,6365,21,128454,20.17813383600377,79
0.05,6366,77,128531,20.187058269200566,24
0.05,6367,73,128604,20.19535175879397,27
0.05,6368,22,128626,20.195635107552206,9
0.05,6369,-28,128598,20.18806907378336,130
0.05,6370,54,128652,20.193376236069692,47
0.05,6371,76,128728,20.202134337727557,24
0.05,6372,94,128822,20.213714106386316,6
0.05,6373,-76,128746,20.198619391277063,108
0.05,6374,94,128840,20.210196078431373,6
0.05,6375,63,128903,20.216907151819324,38
0.05,6376,-17,128886,20.211071036537557,119
0.05,6377,54,128940,20.21636876763876,49
0.05,6378,27,128967,20.217432199404296,74
0.05,6379,-11,128956,20.212539184952977,111
0.05,6380,63,129019,20.219244632502743,38
0.05,6381,-107,128912,20.19931056095268,140
0.05,6382,36,128948,20.201785994046688,65
0.05,6383,88,129036,20.212406015037594,13
0.05,6384,20,129056,20.2123727486296,81
0.05,6385,-31,129025,20.204353272784214,63
0.05,6386,64,129089,20.21121027086269,36
0.05,6387,51,129140,20.216030056355667,49
0.05,6388,93,129233,20.227422131789012,8
0.05,6389,37,129270,20.230046948356808,65
0.05,6390,91,129361,20.241120325457675,10
0.05,6391,14,129375,20.240143929912392,87
0.05,6392,62,129437,20.2466760519318,38
0.05,6393,74,129511,20.25508289020957,27
0.05,6394,-84,129427,20.238780297107116,188
0.05,6395,93,129520,20.250156347717322,7
0.05,6396,-69,129451,20.23620447084571,101
0.05,6397,0,129451,20.23304157549234,31
0.05,6398,89,129540,20.243788091889357,12
0.05,6399,92,129632,20.255,8
0.05,6400,-84,129548,20.238712701140447,187
0.05,6401,64,129612,20.24554826616682,37
0.05,6402,-28,129584,20.238013431204124,130
0.05,6403,30,129614,20.23953778888195,70
0.05,6404,-20,129594,20.233255269320843,51
0.05,6405,3,129597,20.230565095223227,98
0.05,6406,78,129675,20.239581707507412,23
0.05,6407,67,129742,20.246878901373282,34
0.05,6408,-22,129720,20.24028709627087,54
0.05,6409,-49,129671,20.229485179407177,81
0.05,6410,46,129717,20.233504913430043,55
0.05,6411,34,129751,20.23565190268247,67
0.05,6412,5,129756,20.23327615780446,99
0.05,6413,-56,129700,20.22139070782663,158
0.05,6414,-144,129556,20.195791114575215,179
0.05,6415,38,129594,20.19856608478803,62
0.05,6416,89,129683,20.209287829203678,12
0.05,6417,81,129764,20.218759738236212,19
0.05,6418,89,129853,20.229474996105314,11
0.05,6419,4,129857,20.22694704049844,99
0.05,6420,81,129938,20.236411773866998,19
0.05,6421,66,130004,20.24353783867954,35
0.05,6422,-101,129903,20.2246613731901,148
0.05,6423,86,129989,20.234900373599004,14
0.05,6424,84,130073,20.244824902723735,17
0.05,6425,26,130099,20.24572051042639,88
0.05,6426,74,130173,20.254084331725533,27
0.05,6427,75,130248,20.262601120099564,27
0.05,6428,73,130321,20.270804168610983,27
0.05,6429,-91,130230,20.253499222395025,138
0.05,6430,-40,130190,20.244129995335097,140
0.05,6431,90,130280,20.25497512437811,11
0.05,6432,40,130320,20.258044458262088,60
0.05,6433,64,130384,20.264843021448556,37
0.05,6434,86,130470,20.275058275058274,15
0.05,6435,76,130546,20.283716594157863,25
0.05,6436,-30,130516,20.27590492465434,134
0.05,6437,-56,130460,20.264057160608886,158
0.05,6438,53,130513,20.269141170989283,48
0.05,6439,6,130519,20.266925465838508,97
0.05,6440,32,130551,20.26874708896134,69
0.05,6441,86,130637,20.278950636448307,23
0.05,6442,-18,130619,20.273009467639298,126
0.05,6443,84,130703,20.282898820608317,35
0.05,6444,47,130750,20.287044220325836,54
0.05,6445,93,130843,20.298324542351846,7
0.05,6446,46,130889,20.30231115247402,56
0.05,6447,85,130974,20.312344913151364,15
0.05,6448,81,131055,20.321755310900915,20
0.05,6449,-23,131032,20.315038759689923,135
0.05,6450,-382,130650,20.252674004030382,492
0.05,6451,94,130744,20.264104153750775,7
0.05,6452,-38,130706,20.25507515884085,142
0.05,6453,75,130781,20.26355748373102,25
0.05,6454,63,130844,20.270178156467853,37
0.05,6455,62,130906,20.276641883519208,38
0.05,6456,95,131001,20.288214341025245,6
0.05,6457,62,131063,20.294673273459274,39
0.05,6458,73,131136,20.302833255921968,28
0.05,6459,56,131192,20.308359133126935,44
0.05,6460,9,131201,20.306608884073672,92
0.05,6461,76,131277,20.315227483751162,25
0.05,6462,-155,131122,20.288101500851,262
0.05,6463,-71,131051,20.27397896039604,174
0.05,6464,-14,131037,20.268677494199537,45
0.05,6465,11,131048,20.267244045777915,21
0.05,6466,88,131136,20.27771764342044,13
0.05,6467,64,131200,20.28447742733457,36
0.05,6468,40,131240,20.287525119802133,61
0.05,6469,27,131267,20.28856259659969,74
0.05,6470,-119,131148,20.26703755215577,222
0.05,6471,57,131205,20.27271322620519,44
0.05,6472,62,131267,20.2791595859725,38
0.05,6473,-92,131175,20.261816496756257,125
0.05,6474,-74,131101,20.247258687258686,177
0.05,6475,-205,130896,20.212476837554046,310
0.05,6476,60,130956,20.21861973135711,40
0.05,6477,-107,130849,20.19898116702686,208
0.05,6478,92,130941,20.210063281370584,8
0.05,6479,81,131022,20.219444444444445,20
0.05,6480,83,131105,20.229131306897084,17
0.05,6481,-1,131104,20.225856217216908,103
0.05,6482,94,131198,20.23723584760142,7
0.05,6483,72,131270,20.245219000616903,30
0.05,6484,2,131272,20.242405551272167,100
0.05,6485,13,131285,20.241288930003083,87
0.05,6486,79,131364,20.250346847541238,24
0.05,6487,-39,131325,20.24121454993835,168
0.05,6488,54,131379,20.246417013407303,48
0.05,6489,60,131439,20.252542372881354,43
0.05,6490,74,131513,20.260822677553534,26
0.05,6491,53,131566,20.265865680837955,47
0.05,6492,-6,131560,20.261820421992915,125
0.05,6493,91,131651,20.27271327379119,10
0.05,6494,62,131713,20.27913779830639,39
0.05,6495,67,131780,20.286330049261085,33
0.05,6496,-40,131740,20.277050946590734,72
0.05,6497,-175,131565,20.246999076638964,281
0.05,6498,-2,131563,20.243575934759193,102
0.05,6499,12,131575,20.24230769230769,20
0.05,6500,-114,131461,20.22165820642978,78
0.05,6501,72,131533,20.229621654875423,29
0.05,6502,54,131587,20.234814700907272,46
0.05,6503,82,131669,20.24431119311193,19
0.05,6504,-3,131666,20.240737893927747,35
0.05,6505,43,131709,20.244236089763294,57
0.05,6506,61,131770,20.25049946211772,40
0.05,6507,-33,131737,20.242317148125384,75
0.05,6508,-19,131718,20.23628821631587,52
0.05,6509,82,131800,20.2457757296467,18
0.05,6510,-136,131664,20.221778528643835,171
0.05,6511,12,131676,20.220515970515972,93
0.05,6512,41,131717,20.223706433287273,65
0.05,6513,-126,131591,20.20125882714154,229
0.05,6514,-24,131567,20.19447429009977,57
0.05,6515,43,131610,20.197974217311234,57
0.05,6516,0,131610,20.194874942458185,31
0.05,6517,80,131690,20.20405032218472,21
0.05,6518,-19,131671,20.198036508666974,121
0.05,6519,84,131755,20.20782208588957,16
0.05,6520,-43,131712,20.198129121300415,77
0.05,6521,44,131756,20.201778595522846,59
0.05,6522,-111,131645,20.181664878123563,145
0.05,6523,-306,131339,20.13166768853464,412
0.05,6524,16,131355,20.131034482758622,16
0.05,6525,-20,131335,20.12488507508428,140
0.05,6526,92,131427,20.135897043051937,9
0.05,6527,33,131460,20.137867647058822,69
0.05,6528,-85,131375,20.121764435595036,187
0.05,6529,59,131434,20.12771822358346,41
0.05,6530,-5,131429,20.12387077017302,38
0.05,6531,72,131501,20.13181261481935,28
0.05,6532,58,131559,20.13760906168682,43
0.05,6533,-69,131490,20.123966942148762,175
0.05,6534,12,131502,20.122723794950268,90
0.05,6535,61,131563,20.128977968176255,39
0.05,6536,62,131625,20.13538320330427,39
0.05,6537,-51,131574,20.12450290608749,84
0.05,6538,51,131625,20.129224652087476,50
0.05,6539,-99,131526,20.111009174311928,201
0.05,6540,-28,131498,20.103653875554198,129
0.05,6541,3,131501,20.101039437480893,97
0.05,6542,46,131547,20.104997707473636,54
0.05,6543,32,131579,20.10681540342298,68
0.05,6544,90,131669,20.117494270435447,11
0.05,6545,52,131721,20.122364802933088,48
0.05,6546,-20,131701,20.116236444172905,121
0.05,6547,60,131761,20.12232742822236,41
0.05,6548,54,131815,20.12750038173767,46
0.05,6549,68,131883,20.134809160305345,61
0.05,6550,95,131978,20.14623721569226,6
0.05,6551,69,132047,20.15369352869353,33
0.05,6552,-34,132013,20.145429574240804,134
0.05,6553,-38,131975,20.13655782728105,72
0.05,6554,66,132041,20.143554538520213,35
0.05,6555,66,132107,20.150549115314217,35
0.05,6556,-326,131781,20.097758121091964,362
0.05,6557,-103,131678,20.078987496187864,138
0.05,6558,93,131771,20.090105198963258,8
0.05,6559,89,131860,20.100609756097562,12
0.05,6560,41,131901,20.10379515317787,59
0.05,6561,12,131913,20.10256019506248,89
0.05,6562,76,131989,20.111077251257047,24
0.05,6563,73,132062,20.119134673979282,28
0.05,6564,81,132143,20.12840822543793,19
0.05,6565,64,132207,20.135089856838256,37
0.05,6566,79,132286,20.144053601340033,21
0.05,6567,16,132302,20.143422655298416,85
0.05,6568,72,132374,20.151316790987973,29
0.05,6569,-83,132291,20.135616438356163,185
0.05,6570,-3,132288,20.13209557145031,107
0.05,6571,-106,132182,20.112903225806452,229
0.05,6572,76,132258,20.121405750798722,25
0.05,6573,60,132318,20.127471858837847,40
0.05,6574,63,132381,20.13399239543726,37
0.05,6575,-438,131943,20.064324817518248,490
0.05,6576,-20,131923,20.058233237038163,121
0.05,6577,82,132005,20.067649741562786,18
0.05,6578,48,132053,20.0718954248366,52
0.05,6579,93,132146,20.082978723404256,7
0.05,6580,65,132211,20.08980398115788,36
0.05,6581,68,132279,20.09708295350957,32
0.05,6582,43,132322,20.100562053774876,57
0.05,6583,65,132387,20.107381530984203,36
0.05,6584,-75,132312,20.092938496583145,177
0.05,6585,36,132348,20.09535378074704,64
0.05,6586,-68,132280,20.081979656899954,100
0.05,6587,58,132338,20.087735276259867,49
0.05,6588,62,132400,20.09409622097435,53
0.05,6589,72,132472,20.10197268588771,28
0.05,6590,-130,132342,20.079198907601274,162
0.05,6591,19,132361,20.079035194174757,82
0.05,6592,-101,132260,20.060670408008495,213
0.05,6593,60,132320,20.066727327873824,42
0.05,6594,70,132390,20.074298711144806,31
0.05,6595,23,132413,20.074742268041238,8
0.05,6596,92,132505,20.085644990147035,8
0.05,6597,-101,132404,20.067293119127008,133
0.05,6598,94,132498,20.078496741930596,7
0.05,6599,-147,132351,20.05318181818182,199
0.05,6600,69,132420,20.060596879260718,31
0.05,6601,-49,132371,20.05013632232657,82
0.05,6602,91,132462,20.060881417537484,9
0.05,6603,86,132548,20.070866141732285,14
0.05,6604,57,132605,20.076457229371687,45
0.05,6605,66,132671,20.08340902210112,35
0.05,6606,91,132762,20.0941425760557,9
0.05,6607,-275,132487,20.049485472154963,315
0.05,6608,-101,132386,20.03116961718868,203
0.05,6609,62,132448,20.0375189107413,38
0.05,6610,63,132511,20.044017546513388,37
0.05,6611,84,132595,20.05369026013309,18
0.05,6612,75,132670,20.061999092696205,26
0.05,6613,11,132681,20.060628968853948,20
0.05,6614,85,132766,20.070445956160242,16
0.05,6615,-3,132763,20.066958887545344,109
0.05,6616,-128,132635,20.044582136920056,91
0.05,6617,-131,132504,20.02175883952856,93
0.05,6618,80,132584,20.03082036561414,21
0.05,6619,-17,132567,20.02522658610272,49
0.05,6620,74,132641,20.03337864370941,26
0.05,6621,-48,132593,20.02310480217457,150
0.05,6622,-8,132585,20.018873622225577,39
0.05,6623,-34,132551,20.010718599033815,138
0.05,6624,67,132618,20.017811320754717,34
0.05,6625,26,132644,20.01871415635376,74
0.05,6626,65,132709,20.025501735325186,36
0.05,6627,93,132802,20.036511768255885,7
0.05,6628,20,132822,20.036506260371098,82
0.05,6629,56,132878,20.041930618401206,45
0.05,6630,44,132922,20.04554365857337,56
0.05,6631,86,133008,20.05548854041013,14
0.05,6632,-10,132998,20.050957334539426,42
0.05,6633,91,133089,20.06165209526681,10
0.05,6634,77,133166,20.07023360964582,23
0.05,6635,-34,133132,20.06208559373116,136
0.05,6636,52,133184,20.0668976947416,48
0.05,6637,14,133198,20.065983730039168,18
0.05,6638,45,133243,20.069739418587137,56
0.05,6639,74,133317,20.07786144578313,26
0.05,6640,6,133323,20.075741605179942,95
0.05,6641,-87,133236,20.059620596205963,193
0.05,6642,-60,133176,20.04756886948668,92
0.05,6643,9,133185,20.045906080674293,22
0.05,6644,64,133249,20.05252069224981,37
0.05,6645,14,133263,20.051609990972015,18
0.05,6646,86,133349,20.061531517978036,14
0.05,6647,-227,133122,20.02436823104693,331
0.05,6648,-38,133084,20.015641449842082,138
0.05,6649,-11,133073,20.010977443609022,113
0.05,6650,59,133132,20.016839572996542,41
0.05,6651,5,133137,20.01458208057727,98
0.05,6652,19,133156,20.014429580640314,82
0.05,6653,-85,133071,19.998647430117224,118
0.05,6654,21,133092,19.998797896318557,80
0.05,6655,-1,133091,19.995643028846153,33
0.05,6656,60,133151,20.001652395974162,41
0.05,6657,42,133193,20.00495644337639,59
0.05,6658,7,133200,20.003003453972067,94
0.05,6659,40,133240,20.006006006006007,62
0.05,6660,66,133306,20.01291097432818,35
0.05,6661,-32,133274,20.00510357250075,64
0.05,6662,79,133353,20.013957676722196,22
0.05,6663,89,133442,20.024309723889555,11
0.05,6664,-10,133432,20.01980495123781,42
0.05,6665,-184,133248,19.98919891989199,290
0.05,6666,84,133332,19.998800059997,16
0.05,6667,-14,133318,19.99370125974805,115
0.05,6668,-36,133282,19.98530514319988,70
0.05,6669,74,133356,19.993403298350824,27
0.05,6670,94,133450,20.004497076900016,6
0.05,6671,-51,133399,19.993854916067146,153
0.05,6672,-27,133372,19.986812528098305,138
0.05,6673,55,133427,19.99205873539107,46
0.05,6674,70,133497,19.999550561797754,31
0.05,6675,87,133584,20.009586578789694,14
0.05,6676,-389,133195,19.948330088363036,515
0.05,6677,-19,133176,19.942497753818508,50
0.05,6678,64,133240,19.949094175774817,37
0.05,6679,36,133276,19.951497005988024,65
0.05,6680,68,133344,19.958688819039065,32
0.05,6681,-2,133342,19.955402574079617,34
0.05,6682,23,133365,19.95585814753853,77
0.05,6683,39,133404,19.95870736086176,61
0.05,6684,84,133488,19.968287210172026,17
0.05,6685,-128,133360,19.9461561471732,160
0.05,6686,60,133420,19.952145954837746,41
0.05,6687,-39,133381,19.94333133971292,71
0.05,6688,21,133402,19.94348931080879,82
0.05,6689,71,133473,19.951121076233182,29
0.05,6690,95,133568,19.96233746824092,6
0.05,6691,-38,133530,19.95367603108189,139
0.05,6692,77,133607,19.962199312714777,24
0.05,6693,93,133700,19.973110247983268,7
0.05,6694,7,133707,19.971172516803584,95
0.05,6695,-47,133660,19.961170848267624,188
0.05,6696,49,133709,19.965506943407497,52
0.05,6697,81,133790,19.9746192893401,19
0.05,6698,49,133839,19.978952082400358,52
0.05,6699,16,133855,19.978358208955225,85
0.05,6700,48,133903,19.982539919415014,53
0.05,6701,77,133980,19.991047448522828,23
0.05,6702,-155,133825,19.964941071162166,118
0.05,6703,43,133868,19.968377088305488,57
0.05,6704,76,133944,19.976733780760625,24
0.05,6705,83,134027,19.986131822248733,18
0.05,6706,28,134055,19.987326673624572,74
0.05,6707,-85,133970,19.971675611210493,119
0.05,6708,87,134057,19.98166641824415,14
0.05,6709,73,134130,19.98956780923994,28
0.05,6710,-62,134068,19.97735061838772,165
0.05,6711,74,134142,19.985399284862932,34
0.05,6712,91,134233,19.995977953225086,10
0.05,6713,-298,133935,19.948614834673815,403
0.05,6714,53,133988,19.95353685778109,48
0.05,6715,-17,133971,19.948034544371648,118
0.05,6716,-5,133966,19.944320381122527,36
0.05,6717,44,134010,19.94790116105984,56
0.05,6718,90,134100,19.958327132013693,11
0.05,6719,95,134195,19.969494047619047,6
0.05,6720,76,134271,19.97783067995834,25
0.05,6721,-43,134228,19.968461767331153,144
0.05,6722,2,134230,19.965789082254947,30
0.05,6723,72,134302,19.97352766210589,28
0.05,6724,60,134362,19.979479553903346,41
0.05,6725,-39,134323,19.970710674992567,144
0.05,6726,50,134373,19.975174669243348,50
0.05,6727,15,134388,19.974435196195007,88
0.05,6728,49,134437,19.978748699658198,52
0.05,6729,43,134480,19.98216939078752,58
0.05,6730,53,134533,19.98707472886644,48
0.05,6731,92,134625,19.99777183600713,8
0.05,6732,-5,134620,19.99405911183722,37
0.05,6733,55,134675,19.9992574992575,45
0.05,6734,74,134749,20.007275426874536,27
0.05,6735,94,134843,20.018260095011875,7
0.05,6736,85,134928,20.027905595962594,16
0.05,6737,74,135002,20.03591570198872,26
0.05,6738,68,135070,20.04303309096305,33
0.05,6739,93,135163,20.05385756676558,7
0.05,6740,94,135257,20.06482717697671,7
0.05,6741,-39,135218,20.056066449124888,144
0.05,6742,-92,135126,20.03944831677295,194
0.05,6743,76,135202,20.047746144721234,25
0.05,6744,84,135286,20.05722757598221,16
0.05,6745,3,135289,20.054699080936853,97
0.05,6746,81,135370,20.063732029049948,19
0.05,6747,12,135382,20.062537048014228,91
0.05,6748,23,135405,20.062972292191436,9
0.05,6749,-20,135385,20.057037037037038,122
0.05,6750,76,135461,20.065323655754703,24
0.05,6751,-137,135324,20.042061611374407,172
0.05,6752,72,135396,20.049755664149266,29
0.05,6753,76,135472,20.058039680189516,24
0.05,6754,73,135545,20.065877128053295,28
0.05,6755,-3,135542,20.062462995855537,34
0.05,6756,83,135625,20.071777416013024,18
0.05,6757,46,135671,20.07561408700799,56
0.05,6758,64,135735,20.082112738570796,38
0.05,6759,-33,135702,20.074260355029587,66
0.05,6760,21,135723,20.074397278509096,79
0.05,6761,-164,135559,20.047175391895887,199
0.05,6762,93,135652,20.05796244270294,7
0.05,6763,42,135694,20.0612063867534,58
0.05,6764,90,135784,20.071544715447153,10
0.05,6765,71,135855,20.079071829736918,30
0.05,6766,2,135857,20.076400177331166,30
0.05,6767,50,135907,20.080821513002363,51
0.05,6768,28,135935,20.081991431526074,73
0.05,6769,-80,135855,20.067208271787297,112
0.05,6770,-139,135716,20.043715846994534,172
0.05,6771,85,135801,20.05330773774365,15
0.05,6772,-34,135767,20.045327033810718,139
0.05,6773,-298,135469,19.998376144080307,264
0.05,6774,45,135514,20.002066420664207,55
0.05,6775,86,135600,20.011806375442738,15
0.05,6776,-144,135456,19.987605135015492,270
0.05,6777,78,135534,19.996164060194747,22
0.05,6778,93,135627,20.00693317598466,8
0.05,6779,-1,135626,20.003834808259587,102
0.05,6780,-25,135601,19.997198053384455,128
0.05,6781,74,135675,20.005160719551753,26
0.05,6782,91,135766,20.015627303553,10
0.05,6783,59,135825,20.021373820754718,41
0.05,6784,68,135893,20.028445099484156,35
0.05,6785,-50,135843,20.01812555260831,82
0.05,6786,65,135908,20.02475320465596,35
0.05,6787,19,135927,20.024602239245727,12
0.05,6788,-90,135837,20.008395934600088,144
0.05,6789,10,135847,20.006921944035348,90
0.05,6790,-12,135835,20.002208805772344,114
0.05,6791,61,135896,20.00824499411072,39
0.05,6792,-95,135801,19.991314588547034,128
0.05,6793,-7,135794,19.9873417721519,109
0.05,6794,-255,135539,19.946872700515083,323
0.05,6795,-116,135423,19.926868746321365,218
0.05,6796,74,135497,19.934824187141388,27
0.05,6797,0,135497,19.931891732862606,102
0.05,6798,83,135580,19.94116781879688,17
0.05,6799,-130,135450,19.919117647058822,231
0.05,6800,-175,135275,19.89045728569328,219
0.05,6801,95,135370,19.901499558953248,6
0.05,6802,54,135424,19.906511833014847,47
0.05,6803,78,135502,19.915049970605526,23
0.05,6804,-32,135470,19.907421013960324,64
0.05,6805,-155,135315,19.881722009991183,198
0.05,6806,-179,135136,19.852504774496843,226
0.05,6807,58,135194,19.85810810810811,62
0.05,6808,41,135235,19.861213100308415,59
0.05,6809,-43,135192,19.851982378854625,146
0.05,6810,22,135214,19.852297753633827,9
0.05,6811,-164,135050,19.825308279506753,197
0.05,6812,32,135082,19.827095259063555,69
0.05,6813,49,135131,19.831376577634284,51
0.05,6814,-100,135031,19.813793103448276,132
0.05,6815,95,135126,19.824823943661972,6
0.05,6816,30,135156,19.826316561537332,71
0.05,6817,28,135184,19.82751540041068,73
0.05,6818,69,135253,19.834726499486727,32
0.05,6819,-32,135221,19.827126099706746,63
0.05,6820,-213,135008,19.792992229878315,319
0.05,6821,71,135079,19.80049838756963,29
0.05,6822,89,135168,19.810640480726953,11
0.05,6823,-43,135125,19.80143610785463,75
0.05,6824,-45,135080,19.791941391941393,150
0.05,6825,72,135152,19.799589803691767,29
0.05,6826,69,135221,19.80679654313754,32
0.05,6827,-61,135160,19.794961921499706,161
0.05,6828,3,135163,19.792502562600674,98
0.05,6829,-54,135109,19.781698389458274,87
0.05,6830,85,135194,19.791245791245792,15
0.05,6831,76,135270,19.79947306791569,24
0.05,6832,81,135351,19.808429679496562,20
0.05,6833,86,135437,19.818115305823824,14
0.05,6834,65,135502,19.82472567666423,35
0.05,6835,-40,135462,19.81597425394968,143
0.05,6836,72,135534,19.823606845107502,30
0.05,6837,-12,135522,19.818952910207663,113
0.05,6838,-9,135513,19.814738996929375,114
0.05,6839,86,135599,19.824415204678363,14
0.05,6840,37,135636,19.826925888028065,64
0.05,6841,-56,135580,19.81584332066647,87
0.05,6842,29,135609,19.81718544498027,72
0.05,6843,78,135687,19.825686732904735,23
0.05,6844,-27,135660,19.818845872899928,60
0.05,6845,31,135691,19.820479111890155,70
0.05,6846,-52,135639,19.809989776544473,164
0.05,6847,-84,135555,19.794830607476637,123
0.05,6848,93,135648,19.805519053876477,8
0.05,6849,79,135727,19.814160583941607,22
0.05,6850,68,135795,19.821193986279376,33
0.05,6851,79,135874,19.829830706363104,21
0.05,6852,88,135962,19.839778199328762,12
0.05,6853,65,136027,19.84636708491392,37
0.05,6854,88,136115,19.856309263311452,13
0.05,6855,90,136205,19.866540256709452,11
0.05,6856,49,136254,19.870788974770306,52
0.05,6857,58,136312,19.876348789734617,43
0.05,6858,14,136326,19.875492054235313,17
0.05,6859,-28,136298,19.868513119533528,129
0.05,6860,8,136306,19.866783267745227,93
0.05,6861,41,136347,19.86986301369863,60
0.05,6862,90,136437,19.880081596969255,10
0.05,6863,10,136447,19.87864219114219,92
0.05,6864,-48,136399,19.868754552075746,149
0.05,6865,40,136439,19.8716865715118,60
0.05,6866,-20,136419,19.86588029707296,51
0.05,6867,94,136513,19.8766744321491,6
0.05,6868,36,136549,19.879021691658174,65
0.05,6869,-146,136403,19.854876273653566,110
0.05,6870,-94,136309,19.83830592344637,126
0.05,6871,70,136379,19.845605355064027,30
0.05,6872,58,136437,19.851156700130947,42
0.05,6873,-145,136292,19.82717486179808,110
0.05,6874,22,136314,19.82749090909091,80
0.05,6875,80,136394,19.836242001163466,21
0.05,6876,14,136408,19.83539334011924,88
0.05,6877,65,136473,19.84195987205583,35
0.05,6878,86,136559,19.85157726413723,15
0.05,6879,-54,136505,19.840843023255815,187
0.05,6880,-38,136467,19.8324371457637,71
0.05,6881,15,136482,19.831734960767218,86
0.05,6882,0,136482,19.82885369751562,136
0.05,6883,-121,136361,19.808396281231843,153
0.05,6884,56,136417,19.81365286855483,44
0.05,6885,40,136457,19.81658437409236,60
0.05,6886,6,136463,19.81457819079425,94
0.05,6887,-25,136438,19.80807200929152,128
0.05,6888,36,136474,19.810422412541733,65
0.05,6889,66,136540,19.817126269956457,34
0.05,6890,-344,136196,19.764330285880135,378
0.05,6891,88,136284,19.77423099245502,12
0.05,6892,-65,136219,19.761932395183518,166
0.05,6893,-180,136039,19.732956193791704,212
0.05,6894,85,136124,19.742422044960115,15
0.05,6895,-47,136077,19.732743619489558,149
0.05,6896,94,136171,19.743511671741338,6
0.05,6897,-173,135998,19.715569730356624,209
0.05,6898,-171,135827,19.687925786345847,203
0.05,6899,70,135897,19.695217391304347,30
0.05,6900,24,135921,19.695841182437327,76
0.05,6901,-40,135881,19.6871921182266,155
0.05,6902,-60,135821,19.675648268868606,161
0.05,6903,73,135894,19.68337195828505,27
0.05,6904,84,135978,19.692686459087618,16
0.05,6905,-15,135963,19.6876629018245,117
0.05,6906,17,135980,19.687273780222963,14
0.05,6907,-13,135967,19.68254198031268,115
0.05,6908,-68,135899,19.66985091909104,171
0.05,6909,15,135914,19.66917510853835,85
0.05,6910,90,136004,19.67935175806685,11
0.05,6911,-244,135760,19.641203703703702,211
0.05,6912,-48,135712,19.631419065528714,156
0.05,6913,9,135721,19.629881400057855,91
0.05,6914,57,135778,19.6352856109906,44
0.05,6915,94,135872,19.64603817235396,7
0.05,6916,53,135925,19.650860199508458,48
0.05,6917,81,136006,19.65972824515756,20
0.05,6918,-37,135969,19.651539239774532,141
0.05,6919,-11,135958,19.647109826589595,112
0.05,6920,80,136038,19.65583008235804,20
0.05,6921,-4,136034,19.65241259751517,36
0.05,6922,-20,136014,19.64668496316626,52
0.05,6923,-82,135932,19.632004621606008,116
0.05,6924,59,135991,19.637689530685922,42
0.05,6925,-65,135926,19.62546924631822,168
0.05,6926,88,136014,19.635339974014727,13
0.05,6927,40,136054,19.638279445727484,61
0.05,6928,48,136102,19.64237263674412,53
0.05,6929,31,136133,19.644011544011544,71
0.05,6930,84,136217,19.653296782571058,17
0.05,6931,-21,136196,19.64743219849971,53
0.05,6932,-9,136187,19.643300158661475,110
0.05,6933,74,136261,19.651139313527544,26
0.05,6934,45,136306,19.654794520547945,56
0.05,6935,61,136367,19.660755478662054,39
0.05,6936,1,136368,19.658065446158282,101
0.05,6937,58,136426,19.66359181320265,43
0.05,6938,23,136449,19.66407263294423,79
0.05,6939,72,136521,19.671613832853026,28
0.05,6940,73,136594,19.679296931277914,27
0.05,6941,-92,136502,19.663209449726303,194
0.05,6942,-33,136469,19.65562436986893,64
0.05,6943,44,136513,19.659130184331797,56
0.05,6944,-23,136490,19.652987760979123,125
0.05,6945,-15,136475,19.64799884825799,117
0.05,6946,43,136518,19.651360299409816,57
0.05,6947,19,136537,19.65126655152562,14
0.05,6948,35,136572,19.653475320189955,65
0.05,6949,87,136659,19.6631654676259,13
0.05,6950,63,136722,19.669400086318515,37
0.05,6951,30,136752,19.670886075949365,70
0.05,6952,74,136826,19.67869984179491,27
0.05,6953,60,136886,19.684498130572333,41
0.05,6954,71,136957,19.691876347951116,29
0.05,6955,64,137021,19.698246118458883,37
0.05,6956,93,137114,19.708782521201666,7
0.05,6957,93,137207,19.719315895372233,7
0.05,6958,89,137296,19.72927144704699,11
0.05,6959,70,137366,19.736494252873563,32
0.05,6960,91,137457,19.74673179140928,10
0.05,6961,93,137550,19.75725366274059,7
0.05,6962,70,137620,19.764469337929054,30
0.05,6963,21,137641,19.764646754738656,10
0.05,6964,44,137685,19.768126346015794,56
0.05,6965,-2,137683,19.76500143554407,36
0.05,6966,-192,137491,19.734605999712933,304
0.05,6967,-29,137462,19.72761194029851,131
0.05,6968,-43,137419,19.718610991533936,149
0.05,6969,92,137511,19.728981348637017,9
0.05,6970,-42,137469,19.720126237268683,146
0.05,6971,61,137530,19.726047045324155,40
0.05,6972,23,137553,19.726516563889287,79
0.05,6973,90,137643,19.736593059936908,11
0.05,6974,-3,137640,19.733333333333334,105
0.05,6975,88,137728,19.743119266055047,13
0.05,6976,74,137802,19.750895800487317,27
0.05,6977,25,137827,19.75164803668673,76
0.05,6978,61,137888,19.757558389454076,39
0.05,6979,74,137962,19.765329512893985,27
0.05,6980,83,138045,19.774387623549636,17
0.05,6981,67,138112,19.781151532512173,33
0.05,6982,81,138193,19.789918373192037,19
0.05,6983,91,138284,19.800114547537227,10
0.05,6984,-56,138228,19.789262705798137,158
0.05,6985,-6,138222,19.78557114228457,106
0.05,6986,-82,138140,19.77100329182768,184
0.05,6987,89,138229,19.780910131654263,11
0.05,6988,-11,138218,19.776505937902417,113
0.05,6989,-146,138072,19.752789699570815,254
0.05,6990,35,138107,19.75497067658418,66
0.05,6991,-28,138079,19.748140732265448,131
0.05,6992,-100,137979,19.73101673101673,135
0.05,6993,57,138036,19.73634543894767,43
0.05,6994,53,138089,19.74110078627591,48
0.05,6995,27,138116,19.742138364779873,75
0.05,6996,-77,138039,19.728312133771617,178
0.05,6997,94,138133,19.738925407259217,6
0.05,6998,71,138204,19.74624946420917,30
0.05,6999,59,138263,19.751857142857144,45
0.05,7000,87,138350,19.761462648193117,13
0.05,7001,52,138402,19.76606683804627,49
0.05,7002,-65,138337,19.753962587462517,171
0.05,7003,45,138382,19.757567104511708,55
0.05,7004,74,138456,19.765310492505353,26
0.05,7005,-128,138328,19.74421924065087,180
0.05,7006,45,138373,19.747823604966463,56
0.05,7007,80,138453,19.75642123287671,20
0.05,7008,-26,138427,19.749892994721073,126
0.05,7009,41,138468,19.75292439372325,59
0.05,7010,49,138517,19.75709599201255,52
0.05,7011,63,138580,19.763262977752426,38
0.05,7012,-74,138506,19.7498930557536,105
0.05,7013,93,138599,19.76033646991731,8
0.05,7014,48,138647,19.764362081254454,52
0.05,7015,59,138706,19.769954389965793,42
0.05,7016,16,138722,19.769417129827563,15
0.05,7017,70,138792,19.776574522656027,31
0.05,7018,42,138834,19.77974070380396,59
0.05,7019,-55,138779,19.76908831908832,89
0.05,7020,-124,138655,19.74861130893035,228
0.05,7021,-50,138605,19.738678439191112,151
0.05,7022,44,138649,19.742132991599032,57
0.05,7023,-7,138642,19.738325740318906,39
0.05,7024,52,138694,19.742918149466192,49
0.05,7025,64,138758,19.749217193282096,36
0.05,7026,13,138771,19.748256724064323,107
0.05,7027,54,138825,19.753130335799657,47
0.05,7028,-9,138816,19.749039692701665,110
0.05,7029,79,138895,19.7574679943101,22
0.05,7030,-4,138891,19.754089034276774,104
0.05,7031,-19,138872,19.748577929465302,120
0.05,7032,93,138965,19.758993317218824,8
0.05,7033,22,138987,19.759311913562694,78
0.05,7034,-1,138986,19.75636105188344,106
0.05,7035,-13,138973,19.751705514496873,44
0.05,7036,23,138996,19.752167116669035,80
0.05,7037,68,139064,19.759022449559534,33
0.05,7038,-63,139001,19.74726523653928,168
0.05,7039,7,139008,19.745454545454546,93
0.05,7040,87,139095,19.755006391137623,14
0.05,7041,-6,139089,19.75134904856575,109
0.05,7042,-104,138985,19.733778219508732,204
0.05,7043,65,139050,19.74020442930153,35
0.05,7044,32,139082,19.74194464158978,68
0.05,7045,93,139175,19.752341754186773,7
0.05,7046,-73,139102,19.73917979281964,198
0.05,7047,-22,139080,19.733257661748013,54
0.05,7048,64,139144,19.739537523052917,36
0.05,7049,-442,138702,19.67404255319149,481
0.05,7050,65,138767,19.680470855197843,35
0.05,7051,87,138854,19.690017016449236,15
0.05,7052,-51,138803,19.679994328654473,82
0.05,7053,-206,138597,19.648001134108306,241
0.05,7054,19,138616,19.647909284195606,12
0.05,7055,80,138696,19.656462585034014,21
0.05,7056,-44,138652,19.64744225591611,145
0.05,7057,0,138652,19.644658543496742,101
0.05,7058,-244,138408,19.607309817254567,279
0.05,7059,67,138475,19.614022662889518,33
0.05,7060,57,138532,19.619317377142046,57
0.05,7061,83,138615,19.628292268479186,18
0.05,7062,-2,138613,19.625230072207277,104
0.05,7063,86,138699,19.634626274065685,14
0.05,7064,-94,138605,19.61854210898797,194
0.05,7065,74,138679,19.626238324370224,26
0.05,7066,91,138770,19.63633790858922,10
0.05,7067,90,138860,19.646293152235426,11
0.05,7068,49,138909,19.6504456075824,52
0.05,7069,46,138955,19.654172560113153,56
0.05,7070,2,138957,19.65167585914298,32
0.05,7071,-32,138925,19.6443721719457,163
0.05,7072,91,139016,19.654460624911636,9
0.05,7073,85,139101,19.66369804919423,16
0.05,7074,-38,139063,19.65554770318021,70
0.05,7075,-4,139059,19.652204635387225,105
0.05,7076,-161,138898,19.62667797089162,195
0.05,7077,78,138976,19.634925120090422,23
0.05,7078,86,139062,19.644300042378866,15
0.05,7079,-56,139006,19.63361581920904,162
0.05,7080,-43,138963,19.624770512639458,74
0.05,7081,87,139050,19.634284100536572,14
0.05,7082,-5,139045,19.63080615558379,105
0.05,7083,85,139130,19.640033879164314,17
0.05,7084,38,139168,19.642625264643613,62
0.05,7085,-17,139151,19.637454134913916,49
0.05,7086,-8,139143,19.633554395371807,110
0.05,7087,35,139178,19.635722347629798,65
0.05,7088,76,139254,19.643673296656793,25
0.05,7089,66,139320,19.65021156558533,34
0.05,7090,-92,139228,19.63446622479199,124
0.05,7091,65,139293,19.640862944162436,35
0.05,7092,82,139375,19.64965458903144,19
0.05,7093,73,139448,19.657175077530308,28
0.05,7094,-98,139350,19.64059196617336,129
0.05,7095,85,139435,19.649802705749718,15
0.05,7096,77,139512,19.657883612794137,23
0.05,7097,-171,139341,19.631022823330515,202
0.05,7098,-160,139181,19.605719115368363,125
0.05,7099,69,139250,19.612676056338028,32
0.05,7100,78,139328,19.620898465004927,22
0.05,7101,86,139414,19.630245001408053,14
0.05,7102,41,139455,19.633253554835985,59
0.05,7103,63,139518,19.63935810810811,37
0.05,7104,24,139542,19.63997185080929,76
0.05,7105,14,139556,19.639178159302,86
0.05,7106,40,139596,19.642043056141834,103
0.05,7107,35,139631,19.64420371412493,66
0.05,7108,77,139708,19.65227176818118,23
0.05,7109,78,139786,19.660478199718707,22
0.05,7110,-4,139782,19.657150892982703,105
0.05,7111,24,139806,19.657761529808774,7
0.05,7112,51,139857,19.662167861661747,50
0.05,7113,67,139924,19.668822041045825,34
0.05,7114,-143,139781,19.645959241040057,175
0.05,7115,-45,139736,19.636874648679033,77
0.05,7116,54,139790,19.641702964732332,47
0.05,7117,16,139806,19.641191345883676,84
0.05,7118,-217,139589,19.60795055485321,319
0.05,7119,-61,139528,19.596629213483148,167
0.05,7120,52,139580,19.601179609605392,48
0.05,7121,75,139655,19.608958157820837,26
0.05,7122,-31,139624,19.601853151761897,133
0.05,7123,-185,139439,19.573133071308252,149
0.05,7124,-123,139316,19.553122807017544,158
0.05,7125,-154,139162,19.528767892225652,186
0.05,7126,6,139168,19.526869650624388,94
0.05,7127,76,139244,19.5347923681257,25
0.05,7128,62,139306,19.540749053163136,40
0.05,7129,10,139316,19.539410939691443,103
0.05,7130,23,139339,19.539896227738044,78
0.05,7131,21,139360,19.540100953449244,81
0.05,7132,80,139440,19.548577036310107,20
0.05,7133,59,139499,19.554107092795064,51
0.05,7134,-194,139305,19.524176594253678,226
0.05,7135,10,139315,19.522841928251122,92
0.05,7136,-38,139277,19.514782121339497,141
0.05,7137,-37,139240,19.506864667974224,137
0.05,7138,93,139333,19.51715926600364,8
0.05,7139,88,139421,19.52675070028011,13
0.05,7140,-354,139067,19.47444335527237,334
0.05,7141,92,139159,19.484598151778215,8
0.05,7142,-10,139149,19.48047039059219,111
0.05,7143,14,139163,19.479703247480405,88
0.05,7144,52,139215,19.484254723582925,49
0.05,7145,64,139279,19.49048418695774,37
0.05,7146,26,139305,19.491394990905274,6
0.05,7147,83,139388,19.500279798545048,18
0.05,7148,-81,139307,19.48622184920968,115
0.05,7149,70,139377,19.493286713286714,30
0.05,7150,83,139460,19.50216752901692,24
0.05,7151,64,139524,19.508389261744966,37
0.05,7152,-75,139449,19.4951768488746,108
0.05,7153,12,139461,19.49412915851272,23
0.05,7154,-38,139423,19.486093640810623,144
0.05,7155,47,139470,19.48993851313583,53
0.05,7156,29,139499,19.491267290764288,72
0.05,7157,42,139541,19.494411846884606,66
0.05,7158,85,139626,19.503561949993017,16
0.05,7159,-61,139565,19.49231843575419,164
0.05,7160,-11,139554,19.488060326770004,112
0.05,7161,84,139638,19.497067858140184,17
0.05,7162,-14,139624,19.492391456093817,116
0.05,7163,94,139718,19.50279173646008,7
0.05,7164,-92,139626,19.487229588276342,123
0.05,7165,6,139632,19.485347474183644,94
0.05,7166,50,139682,19.4896051346449,101
0.05,7167,10,139692,19.48828125,93
0.05,7168,-42,139650,19.479704282326683,74
0.05,7169,-151,139499,19.45592747559275,195
0.05,7170,64,139563,19.462139171663644,37
0.05,7171,84,139647,19.471137757947574,16
0.05,7172,78,139725,19.479297365119198,23
0.05,7173,57,139782,19.48452746027321,44
0.05,7174,73,139855,19.49198606271777,27
0.05,7175,8,139863,19.490384615384617,94
0.05,7176,89,139952,19.50006966699178,11
0.05,7177,-128,139824,19.479520757871274,162
0.05,7178,-37,139787,19.471653433625853,138
0.05,7179,26,139813,19.472562674094707,75
0.05,7180,45,139858,19.476117532377106,55
0.05,7181,46,139904,19.479810637705373,55
0.05,7182,60,139964,19.485451761102603,40
0.05,7183,-32,139932,19.478285077951004,63
0.05,7184,-31,139901,19.47125956854558,145
0.05,7185,25,139926,19.472028945171168,75
0.05,7186,-108,139818,19.45429247251983,140
0.05,7187,-65,139753,19.442543127434615,166
0.05,7188,9,139762,19.441090555014604,94
0.05,7189,83,139845,19.449930458970794,18
0.05,7190,-85,139760,19.435405367820888,119
0.05,7191,44,139804,19.438820912124584,56
0.05,7192,-57,139747,19.42819407757542,160
0.05,7193,95,139842,19.438698915763137,6
0.05,7194,94,139936,19.449061848505906,6
0.05,7195,-55,139881,19.438715953307394,88
0.05,7196,4,139885,19.43657079338613,134
0.05,7197,61,139946,19.44234509585996,42
0.05,7198,1,139947,19.43978330323656,30
0.05,7199,-104,139843,19.42263888888889,206
0.05,7200,39,139882,19.42535758922372,62
0.05,7201,79,139961,19.43362954734796,22
0.05,7202,37,139998,19.43606830487297,64
0.05,7203,24,140022,19.43670183231538,76
0.05,7204,-22,140000,19.43095072866065,125
0.05,7205,-23,139977,19.425062447960034,123
0.05,7206,18,139995,19.42486471486055,14
0.05,7207,67,140062,19.431465038845726,33
0.05,7208,89,140151,19.441115272575946,11
0.05,7209,49,140200,19.445214979195562,52
0.05,7210,-109,140091,19.427402579392595,159
0.05,7211,32,140123,19.429145867997782,68
0.05,7212,62,140185,19.43504783030639,39
0.05,7213,91,140276,19.44496811754921,9
0.05,7214,10,140286,19.443659043659043,22
0.05,7215,12,140298,19.44262749445676,19
0.05,7216,88,140386,19.452126922543993,12
0.05,7217,-83,140303,19.437932945414243,187
0.05,7218,-58,140245,19.42720598420834,161
0.05,7219,81,140326,19.43573407202216,19
0.05,7220,70,140396,19.442736463093755,46
0.05,7221,46,140442,19.446413735807255,54
0.05,7222,78,140520,19.454520282431123,22
0.05,7223,-120,140400,19.435215946843854,233
0.05,7224,87,140487,19.444567474048444,14
0.05,7225,87,140574,19.453916412953223,13
0.05,7226,22,140596,19.45426871454269,78
0.05,7227,89,140685,19.463890426120642,11
0.05,7228,46,140731,19.467561211785863,55
0.05,7229,-100,140631,19.45103734439834,205
0.05,7230,71,140702,19.45816622873738,29
0.05,7231,48,140750,19.462112831858406,53
0.05,7232,80,140830,19.47048251071478,21
0.05,7233,66,140896,19.476914570085707,34
0.05,7234,-1,140895,19.474084312370422,101
0.05,7235,-64,140831,19.462548369264788,97
0.05,7236,78,140909,19.470637004283542,22
0.05,7237,29,140938,19.471953578336556,73
0.05,7238,14,140952,19.471197679237463,90
0.05,7239,13,140965,19.470303867403317,88
0.05,7240,85,141050,19.47935368043088,16
0.05,7241,56,141106,19.484396575531623,45
0.05,7242,62,141168,19.490266464172304,39
0.05,7243,85,141253,19.49930977360574,16
0.05,7244,25,141278,19.50006901311249,76
0.05,7245,57,141335,19.505244272702182,44
0.05,7246,93,141428,19.51538567683179,8
0.05,7247,81,141509,19.523868653421633,21
0.05,7248,92,141601,19.533866740240033,9
0.05,7249,-49,141552,19.52441379310345,81
0.05,7250,90,141642,19.534133223003725,10
0.05,7251,22,141664,19.534473248758964,78
0.05,7252,-203,141461,19.503791534537434,237
0.05,7253,-30,141431,19.496967190515576,154
0.05,7254,90,141521,19.506685044796694,11
0.05,7255,89,141610,19.516262403528113,12
0.05,7256,93,141703,19.526388314730603,7
0.05,7257,12,141715,19.525351336456325,89
0.05,7258,79,141794,19.53354456536713,21
0.05,7259,-95,141699,19.51776859504132,129
0.05,7260,39,141738,19.520451728412066,78
0.05,7261,17,141755,19.520104654365188,83
0.05,7262,43,141798,19.52333746385791,57
0.05,7263,12,141810,19.522301762114537,88
0.05,7264,-9,141801,19.51837577426015,115
0.05,7265,84,141885,19.527250206440957,17
0.05,7266,-120,141765,19.508050089445437,154
0.05,7267,76,141841,19.515822784810126,25
0.05,7268,-1,141840,19.513000412711516,103
0.05,7269,17,141857,19.512654745529574,98
0.05,7270,60,141917,19.51822307798102,40
0.05,7271,-75,141842,19.505225522552255,106
0.05,7272,58,141900,19.510518355561665,42
0.05,7273,11,141911,19.509348364036292,20
0.05,7274,74,141985,19.51683848797251,27
0.05,7275,87,142072,19.526113249037934,13
0.05,7276,-189,141883,19.497457743575648,294
0.05,7277,-64,141819,19.48598516075845,98
0.05,7278,19,141838,19.48591839538398,13
0.05,7279,-23,141815,19.480082417582416,140
0.05,7280,62,141877,19.485922263425355,38
0.05,7281,81,141958,19.49436967865971,19
0.05,7282,90,142048,19.504050528628312,10
0.05,7283,27,142075,19.5050796265788,75
0.05,7284,-20,142055,19.499656829100893,122
0.05,7285,87,142142,19.508921218775733,13
0.05,7286,76,142218,19.516673528200904,25
0.05,7287,-144,142074,19.49423710208562,176
0.05,7288,-106,141968,19.477020167375496,208
0.05,7289,75,142043,19.484636488340193,26
0.05,7290,32,142075,19.486353037992046,69
0.05,7291,91,142166,19.496160175534833,10
0.05,7292,-24,142142,19.49019607843137,124
0.05,7293,55,142197,19.49506443652317,45
0.05,7294,-63,142134,19.483755997258395,96
0.05,7295,75,142209,19.49136513157895,40
0.05,7296,67,142276,19.497875839386047,34
0.05,7297,19,142295,19.497807618525623,83
0.05,7298,-45,142250,19.488971091930402,146
0.05,7299,20,142270,19.48904109589041,99
0.05,7300,-148,142122,19.4661005341734,180
0.05,7301,14,142136,19.46535195836757,87
0.05,7302,-21,142115,19.459811036560318,122
0.05,7303,64,142179,19.46590909090909,37
0.05,7304,-3,142176,19.46283367556468,105
0.05,7305,-25,142151,19.456747878456063,56
0.05,7306,-50,142101,19.44724237032982,82
0.05,7307,89,142190,19.456759715380404,12
0.05,7308,94,142284,19.4669585442605,7
0.05,7309,79,142363,19.475102599179205,21
0.05,7310,80,142443,19.48338120640131,21
0.05,7311,91,142534,19.49316192560175,9
0.05,7312,50,142584,19.49733351565705,52
0.05,7313,66,142650,19.50369155045119,34
0.05,7314,-119,142531,19.48475734791524,154
0.05,7315,33,142564,19.486604702022962,70
0.05,7316,17,142581,19.486264862648625,15
0.05,7317,73,142654,19.49357748018584,27
0.05,7318,3,142657,19.491323951359476,28
0.05,7319,88,142745,19.50068306010929,12
0.05,7320,31,142776,19.502253790465783,70
0.05,7321,-114,142662,19.484020759355367,146
0.05,7322,87,142749,19.493240475215075,14
0.05,7323,47,142796,19.496996176952486,57
0.05,7324,77,142873,19.504846416382254,37
0.05,7325,58,142931,19.51010101010101,43
0.05,7326,-23,142908,19.504299167462808,126
0.05,7327,76,142984,19.512008733624455,25
0.05,7328,77,143061,19.51985264019648,23
0.05,7329,88,143149,19.529195088676673,12
0.05,7330,77,143226,19.537034510980767,23
0.05,7331,63,143289,19.542962356792145,38
0.05,7332,-13,143276,19.53852447838538,114
0.05,7333,-11,143265,19.534360512680664,116
0.05,7334,92,143357,19.544239945466938,9
0.05,7335,88,143445,19.553571428571427,13
0.05,7336,-49,143396,19.544227886056973,152
0.05,7337,45,143441,19.54769692014173,56
0.05,7338,63,143504,19.55361765908162,38
0.05,7339,-7,143497,19.55,110
0.05,7340,40,143537,19.552785724015802,63
0.05,7341,69,143606,19.559520566603105,32
0.05,7342,-208,143398,19.52853057333515,244
0.05,7343,44,143442,19.53186274509804,56
0.05,7344,87,143529,19.541048332198773,13
0.05,7345,71,143600,19.54805336237408,29
0.05,7346,19,143619,19.54797876684361,81
0.05,7347,18,143637,19.54776810016331,85
0.05,7348,82,143719,19.556266158661042,43
0.05,7349,5,143724,19.554285714285715,106
0.05,7350,93,143817,19.56427696911985,7
0.05,7351,-25,143792,19.5582154515778,129
0.05,7352,80,143872,19.566435468516254,20
0.05,7353,24,143896,19.567038346478107,77
0.05,7354,37,143933,19.56940856560163,64
0.05,7355,75,144008,19.57694399129962,26
0.05,7356,34,144042,19.5789044447465,70
0.05,7357,34,144076,19.58086436531666,67
0.05,7358,90,144166,19.590433482810166,11
0.05,7359,-153,144013,19.566983695652173,188
0.05,7360,-25,143988,19.560929221573154,129
0.05,7361,35,144023,19.56302635153491,65
0.05,7362,76,144099,19.570691294309384,24
0.05,7363,1,144100,19.568169473112437,101
0.05,7364,4,144104,19.566055668703328,97
0.05,7365,12,144116,19.565028509367362,88
0.05,7366,79,144195,19.57309623998914,21
0.05,7367,-28,144167,19.566639522258416,60
0.05,7368,75,144242,19.574162030126203,25
0.05,7369,76,144318,19.581818181818182,24
0.05,7370,70,144388,19.588658255324923,31
0.05,7371,40,144428,19.59142702116115,60
0.05,7372,82,144510,19.599891495998914,18
0.05,7373,-61,144449,19.588961215080012,162
0.05,7374,-5,144444,19.58562711864407,36
0.05,7375,-64,144380,19.574295010845987,98
0.05,7376,59,144439,19.579639419818353,41
0.05,7377,26,144465,19.58050962320412,74
0.05,7378,77,144542,19.58829109635452,23
0.05,7379,-82,144460,19.574525745257453,182
0.05,7380,-7,144453,19.570925348868716,107
0.05,7381,7,144460,19.569222432945,93
0.05,7382,5,144465,19.567249085737505,95
0.05,7383,88,144553,19.576516793066087,12
0.05,7384,13,144566,19.575626269465133,90
0.05,7385,32,144598,19.577308421337666,69
0.05,7386,89,144687,19.58670637606606,11
0.05,7387,-124,144563,19.56727125067677,97
0.05,7388,28,144591,19.568412505075113,75
0.05,7389,-56,144535,19.558186738836266,156
0.05,7390,39,144574,19.560817210120415,63
0.05,7391,43,144617,19.563988095238095,57
0.05,7392,58,144675,19.569187068848912,43
0.05,7393,71,144746,19.576142818501488,29
0.05,7394,59,144805,19.581473968897903,41
0.05,7395,70,144875,19.58829096809086,31
0.05,7396,20,144895,19.58834662701095,11
0.05,7397,88,144983,19.597593944309274,12
0.05,7398,55,145038,19.6023786998243,46
0.05,7399,80,145118,19.61054054054054,21
0.05,7400,8,145126,19.608971760572896,95
0.05,7401,91,145217,19.61861659011078,10
0.05,7402,-22,145195,19.61299473186546,122
0.05,7403,61,145256,19.61858454889249,40
0.05,7404,49,145305,19.62255232950709,58
0.05,7405,49,145354,19.62651903861734,51
0.05,7406,51,145405,19.630754691508034,49
0.05,7407,63,145468,19.636609071274297,38
0.05,7408,71,145539,19.643541638547713,29
0.05,7409,77,145616,19.651282051282053,23
0.05,7410,-3,145613,19.64822561057887,104
0.05,7411,87,145700,19.657312466270913,14
0.05,7412,-46,145654,19.6484554161608,148
0.05,7413,81,145735,19.656730509846238,20
0.05,7414,-73,145662,19.64423465947404,174
0.05,7415,-8,145654,19.640507011866234,110
0.05,7416,13,145667,19.639611702844817,93
0.05,7417,1,145668,19.63709894850364,99
0.05,7418,35,145703,19.639169699420407,66
0.05,7419,73,145776,19.646361185983828,29
0.05,7420,78,145854,19.654224498046087,23
0.05,7421,71,145925,19.66114254917812,29
0.05,7422,62,145987,19.666846288562574,38
0.05,7423,74,146061,19.674164870689655,27
0.05,7424,-264,145797,19.635959595959594,302
0.05,7425,8,145805,19.63439267438729,23
0.05,7426,66,145871,19.640635519052108,34
0.05,7427,22,145893,19.640953150242325,79
0.05,7428,75,145968,19.648404899717324,25
0.05,7429,78,146046,19.656258411843876,23
0.05,7430,91,146137,19.665859238325933,10
0.05,7431,53,146190,19.670344456404735,48
0.05,7432,62,146252,19.676039284272836,38
0.05,7433,19,146271,19.67594834543987,84
0.05,7434,66,146337,19.682178883658374,35
0.05,7435,21,146358,19.68235610543303,80
0.05,7436,10,146368,19.681054188516875,22
0.05,7437,94,146462,19.691045980102178,6
0.05,7438,81,146543,19.699287538647667,19
0.05,7439,57,146600,19.704301075268816,43
0.05,7440,48,146648,19.708103749496036,55
0.05,7441,84,146732,19.716742811072294,17
0.05,7442,55,146787,19.72148327287384,48
0.05,7443,44,146831,19.724744760881247,56
0.05,7444,19,146850,19.72464741437206,102
0.05,7445,45,146895,19.728041901692183,57
0.05,7446,75,146970,19.73546394521284,25
0.05,7447,73,147043,19.742615467239528,27
0.05,7448,76,147119,19.750167807759432,25
0.05,7449,60,147179,19.75557046979866,43
0.05,7450,61,147240,19.7611058918266,40
0.05,7451,86,147326,19.769994632313473,14
0.05,7452,69,147395,19.77660002683483,31
0.05,7453,55,147450,19.781325462838744,45
0.05,7454,60,147510,19.78672032193159,41
0.05,7455,47,147557,19.79037017167382,53
0.05,7456,-122,147435,19.771355773099103,87
0.05,7457,-1,147434,19.76857066237597,102
0.05,7458,19,147453,19.768467623005765,83
0.05,7459,-19,147434,19.763270777479892,120
0.05,7460,72,147506,19.77027208149042,29
0.05,7461,-70,147436,19.75824175824176,171
0.05,7462,50,147486,19.762293983652686,53
0.05,7463,69,147555,19.768890675241156,32
0.05,7464,26,147581,19.76972538513061,76
0.05,7465,28,147609,19.7708277524779,74
0.05,7466,80,147689,19.778893799383955,21
0.05,7467,42,147731,19.781869309051956,59
0.05,7468,85,147816,19.790601151425893,66
0.05,7469,69,147885,19.79718875502008,31
0.05,7470,95,147980,19.807254718243875,6
0.05,7471,86,148066,19.816113490364025,14
0.05,7472,87,148153,19.82510370667737,13
0.05,7473,91,148244,19.834626705913834,10
0.05,7474,47,148291,19.838260869565218,54
0.05,7475,74,148365,19.84550561797753,26
0.05,7476,87,148452,19.85448709375418,13
0.05,7477,-32,148420,19.847552821610055,134
0.05,7478,23,148443,19.84797432811873,80
0.05,7479,-8,148435,19.844251336898395,60
0.05,7480,55,148490,19.848950675043444,45
0.05,7481,63,148553,19.85471798984229,38
0.05,7482,33,148586,19.856474675932112,68
0.05,7483,8,148594,19.854890432923572,94
0.05,7484,91,148685,19.864395457581832,9
0.05,7485,36,148721,19.866550895004007,66
0.05,7486,55,148776,19.87124348871377,48
0.05,7487,86,148862,19.880074786324787,14
0.05,7488,21,148883,19.88022432901589,80
0.05,7489,46,148929,19.883711615487318,55
0.05,7490,80,149009,19.89173675076759,21
0.05,7491,91,149100,19.901227976508274,9
0.05,7492,-65,149035,19.889897237421593,166
0.05,7493,85,149120,19.898585535094742,15
0.05,7494,91,149211,19.90807204803202,9
0.05,7495,-78,149133,19.89501067235859,183
0.05,7496,93,149226,19.904761904761905,8
0.05,7497,-31,149195,19.89797279274473,131
0.05,7498,70,149265,19.904653953860514,30
0.05,7499,66,149331,19.9108,34
0.05,7500,77,149408,19.918410878549526,24
0.05,7501,-170,149238,19.8930951746201,136
0.05,7502,91,149329,19.902572304411567,9
0.05,7503,-151,149178,19.879797441364605,185
0.05,7504,68,149246,19.88620919387075,34
0.05,7505,75,149321,19.8935518252065,26
0.05,7506,95,149416,19.903556680431596,6
0.05,7507,43,149459,19.906632924880128,58
0.05,7508,60,149519,19.91197229990678,40
0.05,7509,-149,149370,19.88948069241012,252
0.05,7510,-98,149272,19.873785115164427,130
0.05,7511,-5,149267,19.870473908413206,107
0.05,7512,19,149286,19.870358046053507,82
0.05,7513,95,149381,19.8803566675539,6
0.05,7514,-39,149342,19.87252162341983,71
0.05,7515,76,149418,19.879989356040447,24
0.05,7516,76,149494,19.887455101769323,24
0.05,7517,41,149535,19.890263367917,59
0.05,7518,-353,149182,19.84067030190185,274
0.05,7519,82,149264,19.848936170212767,18
0.05,7520,87,149351,19.85786464565882,14
0.05,7521,67,149418,19.864131879819197,33
0.05,7522,60,149478,19.869466967964907,40
0.05,7523,-33,149445,19.86244019138756,64
0.05,7524,-2,149443,19.85953488372093,103
0.05,7525,-138,149305,19.838559659845867,171
0.05,7526,-142,149163,19.817058589079313,250
0.05,7527,81,149244,19.82518597236982,19
0.05,7528,78,149322,19.832912737415327,22
0.05,7529,-45,149277,19.824302788844623,147
0.05,7530,72,149349,19.83123091222945,29
0.05,7531,-33,149316,19.82421667551779,134
0.05,7532,-153,149163,19.80127439267224,187
0.05,7533,-7,149156,19.797717016193257,39
0.05,7534,77,149233,19.805308560053085,23
0.05,7535,8,149241,19.803742038216562,94
0.05,7536,87,149328,19.812657556056788,13
0.05,7537,51,149379,19.81679490581056,49
0.05,7538,76,149455,19.824247247645577,24
0.05,7539,-136,149319,19.803580901856765,100
0.05,7540,-136,149183,19.782920037130353,244
0.05,7541,81,149264,19.79103686024927,19
0.05,7542,-16,149248,19.786291926289273,121
0.05,7543,-21,149227,19.7808854718982,127
0.05,7544,92,149319,19.79045725646123,8
0.05,7545,83,149402,19.79883381924198,17
0.05,7546,87,149489,19.807738174108916,14
0.05,7547,47,149536,19.81134075251722,54
0.05,7548,58,149594,19.816399523115646,42
0.05,7549,82,149676,19.824635761589406,19
0.05,7550,-9,149667,19.82081843464442,111
0.05,7551,59,149726,19.826006355932204,41
0.05,7552,-135,149591,19.80550774526678,240
0.05,7553,48,149639,19.809240137675403,52
0.05,7554,57,149696,19.81416280608868,44
0.05,7555,5,149701,19.812202223398625,97
0.05,7556,71,149772,19.818975784041285,29
0.05,7557,94,149866,19.8287906853665,7
0.05,7558,31,149897,19.830268554041538,85
0.05,7559,87,149984,19.83915343915344,13
0.05,7560,-140,149844,19.818013490279064,243
0.05,7561,74,149918,19.82517852419995,26
0.05,7562,9,149927,19.823747190268413,96
0.05,7563,-1,149926,19.820994182971972,102
0.05,7564,76,150002,19.828420356906808,60
0.05,7565,87,150089,19.837298440391223,13
0.05,7566,36,150125,19.83943438615039,67
0.05,7567,93,150218,19.849101479915433,8
0.05,7568,88,150306,19.858105430043597,13
0.05,7569,87,150393,19.866974900924703,14
0.05,7570,55,150448,19.871615374455157,47
0.05,7571,-59,150389,19.86119915478077,91
0.05,7572,18,150407,19.86095338703288,83
0.05,7573,-46,150361,19.85225772379192,146
0.05,7574,62,150423,19.857821782178217,39
0.05,7575,16,150439,19.857312565997887,84
0.05,7576,34,150473,19.85917909462848,66
0.05,7577,36,150509,19.861309052520454,65
0.05,7578,82,150591,19.869507850639927,18
0.05,7579,76,150667,19.876912928759893,25
0.05,7580,-89,150578,19.862551114628676,131
0.05,7581,33,150611,19.864283830123977,68
0.05,7582,-34,150577,19.85718053540815,136
0.05,7583,92,150669,19.866693037974684,9
0.05,7584,90,150759,19.875939353988134,10
0.05,7585,41,150800,19.87872396519905,59
0.05,7586,79,150879,19.88651640964808,22
0.05,7587,-28,150851,19.880205587770163,129
0.05,7588,69,150920,19.88667808670444,32
0.05,7589,-2,150918,19.883794466403163,104
0.05,7590,-67,150851,19.872348834145697,99
0.05,7591,-23,150828,19.866701791359326,126
0.05,7592,-62,150766,19.85591992624786,94
0.05,7593,34,150800,19.857782459836713,67
0.05,7594,-341,150459,19.81026991441738,307
0.05,7595,70,150529,19.81687730384413,31
0.05,7596,-133,150396,19.796761879689353,166
0.05,7597,-64,150332,19.785733087654645,104
0.05,7598,39,150371,19.78826161337018,61
0.05,7599,71,150442,19.795,31
0.05,7600,45,150487,19.798316011051178,64
0.05,7601,27,150514,19.79926335174954,74
0.05,7602,49,150563,19.803104037879784,51
0.05,7603,-70,150493,19.791294055760126,170
0.05,7604,90,150583,19.800525969756738,10
0.05,7605,81,150664,19.808572179858007,20
0.05,7606,73,150737,19.815564611542,28
0.05,7607,94,150831,19.82531545741325,7
0.05,7608,9,150840,19.823892758575372,93
0.05,7609,66,150906,19.829960578186597,35
0.05,7610,-53,150853,19.820391538562607,155
0.05,7611,12,150865,19.819364161849713,89
0.05,7612,61,150926,19.82477341389728,43
0.05,7613,67,150993,19.83096926713948,34
0.05,7614,-54,150939,19.821273801707157,181
0.05,7615,75,151014,19.828518907563026,26
0.05,7616,-118,150896,19.81042405146383,223
0.05,7617,-43,150853,19.802179049619323,145
0.05,7618,-14,150839,19.797742485890538,45
0.05,7619,93,150932,19.80734908136483,8
0.05,7620,90,151022,19.816559506626426,11
0.05,7621,59,151081,19.82170034111782,42
0.05,7622,76,151157,19.829069919979013,24
0.05,7623,-9,151148,19.825288562434416,109
0.05,7624,94,151242,19.835016393442622,6
0.05,7625,-89,151153,19.82074482035143,193
0.05,7626,50,151203,19.824701717582272,51
0.05,7627,54,151257,19.829181961195594,47
0.05,7628,-102,151155,19.813212740857256,205
0.05,7629,10,151165,19.81192660550459,91
0.05,7630,70,151235,19.81850347267724,30
0.05,7631,62,151297,19.82403039832285,38
0.05,7632,-17,151280,19.819206078868074,56
0.05,7633,80,151360,19.827089337175792,21
0.05,7634,-121,151239,19.808644400785855,152
0.05,7635,87,151326,19.817443687794658,14
0.05,7636,57,151383,19.822312426345423,43
0.05,7637,53,151436,19.82665619272061,47
0.05,7638,57,151493,19.831522450582536,43
0.05,7639,-11,151482,19.827486910994764,43
0.05,7640,66,151548,19.833529642716922,34
0.05,7641,18,151566,19.833289714734363,83
0.05,7642,30,151596,19.834619913646474,71
0.05,7643,-22,151574,19.82914704343276,124
0.05,7644,-102,151472,19.813211249182473,203
0.05,7645,-17,151455,19.80839654721423,119
0.05,7646,39,151494,19.81090623774029,61
0.05,7647,84,151578,19.819299163179917,17
0.05,7648,-13,151565,19.815008497842854,117
0.05,7649,58,151623,19.82,43
0.05,7650,-41,151582,19.812050712325185,75
0.05,7651,12,151594,19.81102979613173,20
0.05,7652,-69,151525,19.79942506206716,205
0.05,7653,-5,151520,19.796185001306508,38
0.05,7654,64,151584,19.801959503592425,37
0.05,7655,29,151613,19.80316091954023,73
0.05,7656,-99,151514,19.787645291889774,132
0.05,7657,33,151547,19.789370592844083,67
0.05,7658,70,151617,19.795926361143753,30
0.05,7659,74,151691,19.803002610966058,27
0.05,7660,-76,151615,19.790497324109126,178
0.05,7661,67,151682,19.796658835813105,34
0.05,7662,87,151769,19.80542868328331,13
0.05,7663,24,151793,19.80597599164927,78
0.05,7664,68,151861,19.812263535551207,33
0.05,7665,-45,151816,19.803809026871903,145
0.05,7666,56,151872,19.808530063910265,45
0.05,7667,-32,151840,19.801773604590505,133
0.05,7668,83,151923,19.810014343460686,17
0.05,7669,64,151987,19.815775749674057,36
0.05,7670,16,152003,19.81527832094903,85
0.05,7671,65,152068,19.82116788321168,35
0.05,7672,93,152161,19.83070506972501,7
0.05,7673,63,152224,19.836330466510294,38
0.05,7674,78,152302,19.843908794788273,22
0.05,7675,-78,152224,19.83116206357478,111
0.05,7676,-85,152139,19.817506838608832,189
0.05,7677,83,152222,19.82573586871581,17
0.05,7678,83,152305,19.833962755567132,17
0.05,7679,34,152339,19.835807291666665,70
0.05,7680,-19,152320,19.83075120427028,119
0.05,7681,69,152389,19.837151783389743,32
0.05,7682,71,152460,19.8438110113237,30
0.05,7683,88,152548,19.852680895366998,12
0.05,7684,64,152612,19.858425504229018,37
0.05,7685,85,152697,19.86690085870414,16
0.05,7686,-117,152580,19.849095876154546,248
0.05,7687,93,152673,19.858610822060353,7
0.05,7688,-347,152326,19.810898686435166,313
0.05,7689,52,152378,19.81508452535761,48
0.05,7690,80,152458,19.822909894682095,21
0.05,7691,51,152509,19.82696307852314,50
0.05,7692,90,152599,19.836084752372287,10
0.05,7693,92,152691,19.845463997920458,9
0.05,7694,19,152710,19.84535412605588,83
0.05,7695,-173,152537,19.820296257796258,207
0.05,7696,-68,152469,19.808886579186694,102
0.05,7697,25,152494,19.809560924915562,7
0.05,7698,-100,152394,19.79399922067801,132
0.05,7699,74,152468,19.801038961038962,27
0.05,7700,86,152554,19.809635112323075,14
0.05,7701,88,152642,19.818488704232667,12
0.05,7702,-48,152594,19.809684538491496,148
0.05,7703,85,152679,19.818146417445483,16
0.05,7704,45,152724,19.821414665801427,55
0.05,7705,81,152805,19.829353750324422,19
0.05,7706,12,152817,19.8283378746594,89
0.05,7707,52,152869,19.83251167618059,48
0.05,7708,86,152955,19.84109482423142,14
0.05,7709,-122,152833,19.822697795071335,159
0.05,7710,-1,152832,19.819997406302683,105
0.05,7711,80,152912,19.827800829875518,20
0.05,7712,-93,152819,19.813172565798002,128
0.05,7713,84,152903,19.821493388644022,16
0.05,7714,65,152968,19.82734931950745,36
0.05,7715,94,153062,19.836962156557803,7
0.05,7716,90,153152,19.846054166126734,10
0.05,7717,-71,153081,19.834283493132936,105
0.05,7718,-51,153030,19.82510687912942,152
0.05,7719,62,153092,19.83056994818653,39
0.05,7720,31,153123,19.83201657816345,72
0.05,7721,-129,152994,19.812742812742812,233
0.05,7722,62,153056,19.818205360611163,38
0.05,7723,-20,153036,19.813050233039874,123
0.05,7724,-19,153017,19.808025889967638,122
0.05,7725,45,153062,19.811286564845975,57
0.05,7726,19,153081,19.811181571114275,82
0.05,7727,93,153174,19.820652173913043,8
0.05,7728,44,153218,19.823780566696858,57
0.05,7729,58,153276,19.828719275549805,42
0.05,7730,82,153358,19.836761091708706,19
0.05,7731,24,153382,19.837299534402483,78
0.05,7732,-21,153361,19.832018621492306,121
0.05,7733,75,153436,19.839151797258857,26
0.05,7734,-120,153316,19.821073044602457,156
0.05,7735,67,153383,19.827171664943123,35
0.05,7736,-44,153339,19.818922062815044,145
0.05,7737,-152,153187,19.796717498061515,186
0.05,7738,2,153189,19.794417883447473,99
0.05,7739,85,153274,19.802842377260983,16
0.05,7740,-591,152683,19.723937475778325,583
0.05,7741,95,152778,19.733660552828727,6
0.05,7742,47,152825,19.737181970812347,54
0.05,7743,81,152906,19.74509297520661,19
0.05,7744,85,152991,19.753518398967074,16
0.05,7745,57,153048,19.758326878388846,63
0.05,7746,15,153063,19.75771266296631,88
0.05,7747,91,153154,19.76690758905524,10
0.05,7748,-12,153142,19.762808104271517,113
0.05,7749,27,153169,19.76374193548387,74
0.05,7750,75,153244,19.770868275061282,25
0.05,7751,37,153281,19.773090815273477,63
0.05,7752,82,153363,19.781116986972783,18
0.05,7753,0,153363,19.77856590147021,101
0.05,7754,72,153435,19.785299806576404,28
0.05,7755,81,153516,19.793192367199588,20
0.05,7756,85,153601,19.80159855614284,16
0.05,7757,69,153670,19.807940190770818,31
0.05,7758,79,153749,19.815569016625854,22
0.05,7759,69,153818,19.821907216494846,32
0.05,7760,82,153900,19.8299188248937,18
0.05,7761,35,153935,19.831873228549345,69
0.05,7762,88,154023,19.840654386190906,12
0.05,7763,69,154092,19.846986089644513,31
0.05,7764,87,154179,19.855634256278172,14
0.05,7765,-52,154127,19.846381663662118,83
0.05,7766,73,154200,19.85322518346852,27
0.05,7767,52,154252,19.857363542739442,49
0.05,7768,89,154341,19.86626335435706,11
0.05,7769,-17,154324,19.861518661518662,51
0.05,7770,78,154402,19.869000128683567,22
0.05,7771,-133,154269,19.84933093154915,234
0.05,7772,78,154347,19.856812041682748,23
0.05,7773,75,154422,19.86390532544379,26
0.05,7774,77,154499,19.871254019292603,23
0.05,7775,87,154586,19.87988683127572,19
0.05,7776,68,154654,19.886074321717885,32
0.05,7777,49,154703,19.889817433787606,51
0.05,7778,54,154757,19.894202339632344,53
0.05,7779,-51,154706,19.88508997429306,82
0.05,7780,76,154782,19.892301760699137,25
0.05,7781,88,154870,19.90105371369828,13
0.05,7782,74,154944,19.908004625465757,26
0.05,7783,62,155006,19.913412127440903,38
0.05,7784,95,155101,19.92305716120745,6
0.05,7785,46,155147,19.926406370408426,56
0.05,7786,-72,155075,19.91460125850777,173
0.05,7787,-103,154972,19.898818695428865,137
0.05,7788,-1,154971,19.896135575812043,103
0.05,7789,71,155042,19.902695763799745,29
0.05,7790,57,155099,19.90745732255166,45
0.05,7791,63,155162,19.912987679671456,38
0.05,7792,-32,155130,19.906326190170667,64
0.05,7793,19,155149,19.90620990505517,82
0.05,7794,-17,155132,19.90147530468249,121
0.05,7795,59,155191,19.906490507952796,41
0.05,7796,87,155278,19.91509554957035,14
0.05,7797,-144,155134,19.89407540394973,109
0.05,7798,75,155209,19.90114117194512,26
0.05,7799,-11,155198,19.897179487179486,113
0.05,7800,80,155278,19.90488398923215,20
0.05,7801,7,155285,19.90322994104076,25
0.05,7802,80,155365,19.910931692938615,20
0.05,7803,-39,155326,19.903382880574064,143
0.05,7804,-180,155146,19.87777065983344,216
0.05,7805,40,155186,19.880348449910326,61
0.05,7806,86,155272,19.888817727680287,14
0.05,7807,-29,155243,19.882556352459016,131
0.05,7808,-23,155220,19.87706492508644,55
0.05,7809,94,155314,19.886555697823304,7
0.05,7810,82,155396,19.894507745487132,19
0.05,7811,42,155438,19.897337429595495,60
0.05,7812,73,155511,19.904134135415333,27
0.05,7813,79,155590,19.911696954184798,22
0.05,7814,75,155665,19.91874600127959,26
0.05,7815,89,155754,19.92758444216991,12
0.05,7816,-18,155736,19.9227325060765,120
0.05,7817,88,155824,19.9314402660527,12
0.05,7818,10,155834,19.930170098478065,22
0.05,7819,91,155925,19.93925831202046,21
0.05,7820,93,156018,19.948599923283467,7
0.05,7821,38,156056,19.95090769624137,63
0.05,7822,-27,156029,19.944906046273807,127
0.05,7823,80,156109,19.952581799591,21
0.05,7824,91,156200,19.961661341853034,10
0.05,7825,11,156211,19.960516227958088,89
0.05,7826,43,156254,19.963459818576723,60
0.05,7827,59,156313,19.968446601941746,41
0.05,7828,72,156385,19.975092604419466,28
0.05,7829,76,156461,19.982247765006385,25
0.05,7830,-5,156456,19.979057591623036,106
0.05,7831,40,156496,19.98161389172625,61
0.05,7832,91,156587,19.990680454487425,9
0.05,7833,84,156671,19.998851161603266,16
0.05,7834,54,156725,20.00319081046586,47
0.05,7835,-7,156718,19.99974476773864,109
0.05,7836,2,156720,19.997448003062395,99
0.05,7837,-59,156661,19.987369226843583,93
0.05,7838,-93,156568,19.972955734149764,125
0.05,7839,72,156640,19.979591836734695,29
0.05,7840,6,156646,19.977808952939675,26
0.05,7841,49,156695,19.981509818923744,53
0.05,7842,17,156712,19.98112966976922,83
0.05,7843,-157,156555,19.95856705762366,191
0.05,7844,-16,156539,19.95398342893563,118
0.05,7845,57,156596,19.958705072648485,44
0.05,7846,90,156686,19.967630941761183,11
0.05,7847,32,156718,19.969164118246688,68
0.05,7848,52,156770,19.973244999362976,49
0.05,7849,-7,156763,19.96980891719745,43
0.05,7850,52,156815,19.973888676601707,49
0.05,7851,48,156863,19.977457972491084,52
0.05,7852,19,156882,19.977333503119826,82
0.05,7853,-52,156830,19.968169085816143,85
0.05,7854,-2,156828,19.965372374283895,34
0.05,7855,-106,156722,19.949338085539715,208
0.05,7856,65,156787,19.95507191039837,36
0.05,7857,68,156855,19.961186052430644,33
0.05,7858,59,156914,19.966153454637993,42
0.05,7859,95,157009,19.975699745547075,6
0.05,7860,-65,156944,19.96488996310902,102
0.05,7861,-334,156610,19.91986771813788,300
0.05,7862,72,156682,19.926491161134425,29
0.05,7863,-298,156384,19.886063072227874,334
0.05,7864,-33,156351,19.879338842975205,139
0.05,7865,32,156383,19.88087973557081,68
0.05,7866,75,156458,19.88788610652091,27
0.05,7867,28,156486,19.888917132689375,72
0.05,7868,-572,155914,19.813699326470964,540
0.05,7869,-50,155864,19.804828462515882,154
0.05,7870,95,155959,19.814381908270867,6
0.05,7871,-22,155937,19.80907012195122,122
0.05,7872,-59,155878,19.79906007875016,161
0.05,7873,56,155934,19.803657607315216,45
0.05,7874,9,155943,19.802285714285713,92
0.05,7875,61,156004,19.80751650584053,40
0.05,7876,42,156046,19.81033388345817,61
0.05,7877,91,156137,19.819370398578318,9
0.05,7878,95,156232,19.82891229851504,6
0.05,7879,-173,156059,19.80444162436548,276
0.05,7880,59,156118,19.80941504885167,41
0.05,7881,47,156165,19.81286475513829,53
0.05,7882,16,156181,19.812381073195485,15
0.05,7883,64,156245,19.81798579401319,36
0.05,7884,71,156316,19.824476854787573,29
0.05,7885,-1,156315,19.821836165356327,104
0.05,7886,29,156344,19.822999873209078,71
0.05,7887,-82,156262,19.810091277890468,185
0.05,7888,-76,156186,19.797946507795665,111
0.05,7889,51,156237,19.80190114068441,50
0.05,7890,40,156277,19.804460778101635,60
0.05,7891,-32,156245,19.797896604156108,137
0.05,7892,86,156331,19.80628404915748,14
0.05,7893,36,156367,19.8083354446415,67
0.05,7894,69,156436,19.814566181127297,31
0.05,7895,-67,156369,19.803571428571427,98
0.05,7896,87,156456,19.812080536912752,13
0.05,7897,-17,156439,19.807419599898708,118
0.05,7898,-8,156431,19.80389922775035,108
0.05,7899,78,156509,19.81126582278481,22
0.05,7900,23,156532,19.81166940893558,78
0.05,7901,40,156572,19.81422424702607,63
0.05,7902,35,156607,19.81614576743009,66
0.05,7903,93,156700,19.825404858299596,8
0.05,7904,24,156724,19.82593295382669,78
0.05,7905,92,156816,19.835061978244372,9
0.05,7906,-159,156657,19.812444669280385,192
0.05,7907,31,156688,19.813859382903388,70
0.05,7908,-137,156551,19.79403211531167,249
0.05,7909,84,156635,19.802149178255373,17
0.05,7910,54,156689,19.80647200101125,47
0.05,7911,-22,156667,19.801188068756318,122
0.05,7912,-22,156645,19.795905472008087,55
0.05,7913,70,156715,19.80224917867071,31
0.05,7914,-93,156622,19.78799747315224,125
0.05,7915,-40,156582,19.78044466902476,73
0.05,7916,73,156655,19.787166856132373,27
0.05,7917,28,156683,19.78820409194241,72
0.05,7918,55,156738,19.792650587195354,46
0.05,7919,22,156760,19.792929292929294,81
0.05,7920,63,156823,19.798384042418885,38
0.05,7921,47,156870,19.801817722797274,54
0.05,7922,8,156878,19.80032815852581,23
0.05,7923,-10,156868,19.796567390206967,115
0.05,7924,66,156934,19.802397476340694,34
0.05,7925,-50,156884,19.793590714105477,82
0.05,7926,63,156947,19.7990412514192,39
0.05,7927,91,157038,19.808022199798184,9
0.05,7928,52,157090,19.812082229789382,50
0.05,7929,-23,157067,19.806683480453973,55
0.05,7930,67,157134,19.812633967973774,34
0.05,7931,70,157204,19.81896116994453,31
0.05,7932,88,157292,19.827555779654606,12
0.05,7933,74,157366,19.834383665238214,27
0.05,7934,76,157442,19.841461877756775,26
0.05,7935,-8,157434,19.83795362903226,110
0.05,7936,19,157453,19.83784805342069,81
0.05,7937,86,157539,19.84618291761149,15
0.05,7938,-15,157524,19.84179367678549,117
0.05,7939,91,157615,19.8507556675063,10
0.05,7940,-80,157535,19.8381815892205,183
0.05,7941,93,157628,19.84739360362629,8
0.05,7942,44,157672,19.85043434470603,59
0.05,7943,79,157751,19.857880161127895,22
0.05,7944,13,157764,19.857016991818753,88
0.05,7945,64,157828,19.86257236345331,36
0.05,7946,-9,157819,19.858940480684534,41
0.05,7947,32,157851,19.860468042274785,70
0.05,7948,61,157912,19.86564347716694,40
0.05,7949,-29,157883,19.859496855345913,60
0.05,7950,80,157963,19.86706074707584,20
0.05,7951,76,158039,19.87411971830986,24
0.05,7952,95,158134,19.88356594995599,12
0.05,7953,95,158229,19.893009806386722,6
0.05,7954,23,158252,19.893400377121306,79
0.05,7955,9,158261,19.892031171442937,91
0.05,7956,57,158318,19.896694734196306,43
0.05,7957,63,158381,19.902111083186732,37
0.05,7958,-122,158259,19.88428194496796,158
0.05,7959,36,158295,19.886306532663315,64
0.05,7960,93,158388,19.8954905162668,8
0.05,7961,23,158411,19.895880432052248,8
0.05,7962,-22,158389,19.890619113399474,54
0.05,7963,77,158466,19.89779005524862,24
0.05,7964,-97,158369,19.883113622096673,200
0.05,7965,93,158462,19.89229224202862,8
0.05,7966,76,158538,19.899334755867955,24
0.05,7967,-188,158350,19.87324297188755,221
0.05,7968,77,158427,19.880411594930354,24
0.05,7969,93,158520,19.889585947302383,7
0.05,7970,42,158562,19.892359804290553,60
0.05,7971,92,158654,19.901404917210236,8
0.05,7972,49,158703,19.90505455913709,51
0.05,7973,-89,158614,19.89139704038124,193
0.05,7974,91,158705,19.900313479623826,10
0.05,7975,86,158791,19.90860080240722,14
0.05,7976,93,158884,19.917763570264512,8
0.05,7977,83,158967,19.92567059413387,18
0.05,7978,92,159059,19.934703596941972,9
0.05,7979,92,159151,19.9437343358396,9
0.05,7980,18,159169,19.94349079062774,85
0.05,7981,94,159263,19.952768729641694,6
0.05,7982,65,159328,19.958411624702492,37
0.05,7983,92,159420,19.967434869739478,8
0.05,7984,-309,159111,19.926236693800877,275
0.05,7985,89,159200,19.93488605058853,13
0.05,7986,93,159293,19.944034055339927,8
0.05,7987,-49,159244,19.935403104656984,150
0.05,7988,92,159336,19.944423582425834,9
0.05,7989,-106,159230,19.92866082603254,210
0.05,7990,-11,159219,19.924790389187837,112
0.05,7991,-77,159142,19.91266266266266,183
0.05,7992,-114,159028,19.895908920305267,222
0.05,7993,92,159120,19.904928696522393,8
0.05,7994,58,159178,19.909693558474046,43
0.05,7995,-88,159090,19.896198099049524,190
0.05,7996,18,159108,19.895960985369513,82
0.05,7997,77,159185,19.9031007751938,24
0.05,7998,-373,158812,19.853981747718464,412
0.05,7999,-89,158723,19.840375,194
0.05,8000,73,158796,19.847019122609673,28
0.05,8001,61,158857,19.852161959510124,39
0.05,8002,42,158899,19.854929401474447,58
0.05,8003,14,158913,19.854197901049474,18
0.05,8004,-40,158873,19.84672079950031,142
0.05,8005,60,158933,19.85173619785161,41
0.05,8006,95,159028,19.861121518671162,6
0.05,8007,-313,158715,19.819555444555444,346
0.05,8008,74,158789,19.826320389561744,26
0.05,8009,76,158865,19.833333333333332,24
0.05,8010,-127,158738,19.815004368992636,163
0.05,8011,22,158760,19.81527708437344,79
0.05,8012,90,158850,19.824035941594907,10
0.05,8013,-178,158672,19.799351135512854,213
0.05,8014,44,158716,19.802370555208984,57
0.05,8015,-80,158636,19.789920159680637,183
0.05,8016,39,158675,19.792316327803416,63
0.05,8017,31,158706,19.79371414317785,70
0.05,8018,64,158770,19.799226836263873,36
0.05,8019,63,158833,19.804613466334164,40
0.05,8020,69,158902,19.810746789677097,31
0.05,8021,76,158978,19.81775118424333,25
0.05,8022,34,159012,19.81951888321077,67
0.05,8023,93,159105,19.828639082751746,7
0.05,8024,39,159144,19.831028037383177,61
0.05,8025,66,159210,19.836780463493646,35
0.05,8026,82,159292,19.84452472903949,20
0.05,8027,-73,159219,19.832959641255606,175
0.05,8028,66,159285,19.838709677419356,35
0.05,8029,83,159368,19.846575342465755,17
0.05,8030,50,159418,19.850329971360978,51
0.05,8031,91,159509,19.859188247011954,30
0.05,8032,62,159571,19.864434208888337,38
0.05,8033,15,159586,19.863828727906398,88
0.05,8034,62,159648,19.869072806471685,38
0.05,8035,87,159735,19.877426580388253,14
0.05,8036,45,159780,19.880552444942143,55
0.05,8037,80,159860,19.888031848718587,20
0.05,8038,53,159913,19.892150765020524,48
0.05,8039,89,160002,19.900746268656718,11
0.05,8040,83,160085,19.908593458525058,17
0.05,8041,72,160157,19.915070877891072,29
0.05,8042,34,160191,19.916822081312944,66
0.05,8043,92,160283,19.92578319244157,8
0.05,8044,85,160368,19.933871970167807,15
0.05,8045,-55,160313,19.924558786974895,158
0.05,8046,-31,160282,19.918230396421027,134
0.05,8047,-6,160276,19.91500994035785,108
0.05,8048,13,160289,19.914150826189587,88
0.05,8049,3,160292,19.912049689440995,99
0.05,8050,-153,160139,19.890572599677057,186
0.05,8051,89,160228,19.899155489319423,12
0.05,8052,27,160255,19.900037253197567,73
0.05,8053,90,160345,19.908740998261734,10
0.05,8054,34,160379,19.910490378646802,67
0.05,8055,-58,160321,19.90081926514399,161
0.05,8056,-67,160254,19.89003351123247,169
0.05,8057,57,160311,19.89463886820551,43
0.05,8058,-2,160309,19.891922074699096,102
0.05,8059,7,160316,19.89032258064516,94
0.05,8060,31,160347,19.891700781540752,69
0.05,8061,60,160407,19.896675762838004,40
0.05,8062,-90,160317,19.88304601265038,193
0.05,8063,79,160396,19.890376984126984,22
0.05,8064,-144,160252,19.8700557966522,179
0.05,8065,89,160341,19.878626332754774,12
0.05,8066,69,160410,19.884715507623653,32
0.05,8067,56,160466,19.889191869112544,44
0.05,8068,54,160520,19.893419258892056,47
0.05,8069,35,160555,19.89529120198265,66
0.05,8070,-121,160434,19.877834221286086,223
0.05,8071,87,160521,19.886149653121905,14
0.05,8072,84,160605,19.894091415830545,16
0.05,8073,19,160624,19.893980678721825,83
0.05,8074,44,160668,19.896965944272445,57
0.05,8075,88,160756,19.90539871223378,14
0.05,8076,-15,160741,19.901077132598736,117
0.05,8077,71,160812,19.90740282248081,30
0.05,8078,8,160820,19.90592895160292,94
0.05,8079,-106,160714,19.890346534653464,140
0.05,8080,-88,160626,19.876995421358743,119
0.05,8081,83,160709,19.88480574115318,17
0.05,8082,-44,160665,19.876902140294444,173
0.05,8083,-19,160646,19.872093023255815,51
0.05,8084,93,160739,19.881137909709338,8
0.05,8085,58,160797,19.885852090032156,42
0.05,8086,-13,160784,19.881785581797946,44
0.05,8087,73,160857,19.888353115727003,28
0.05,8088,55,160912,19.892693781678823,46
0.05,8089,78,160990,19.899876390605687,22
0.05,8090,23,161013,19.900259547645533,77
0.05,8091,54,161067,19.904473554127534,47
0.05,8092,85,161152,19.91251698999135,15
0.05,8093,71,161223,19.91882876204596,29
0.05,8094,-15,161208,19.914515132798023,46
0.05,8095,-42,161166,19.906867588932805,74
0.05,8096,8,161174,19.905397060639743,92
0.05,8097,77,161251,19.912447517905655,23
0.05,8098,14,161265,19.91171749598716,86
0.05,8099,68,161333,19.917654320987655,33
0.05,8100,17,161350,19.917294161214667,14
0.05,8101,13,161363,19.9164403850901,90
0.05,8102,-46,161317,19.90830556583981,151
0.05,8103,-223,161094,19.87833168805528,330
0.05,8104,52,161146,19.882294879703885,49
0.05,8105,-98,161048,19.867752282260053,200
0.05,8106,75,161123,19.874552855556924,26
0.05,8107,-72,161051,19.86322150962013,174
0.05,8108,11,161062,19.862128499198423,109
0.05,8109,80,161142,19.869543773119606,23
0.05,8110,93,161235,19.878559980273703,8
0.05,8111,54,161289,19.88276627218935,48
0.05,8112,92,161381,19.891655367928017,9
0.05,8113,94,161475,19.90078876016761,6
0.05,8114,91,161566,19.909550215650032,9
0.05,8115,69,161635,19.915598817151306,32
0.05,8116,84,161719,19.923493901687817,16
0.05,8117,-132,161587,19.904779502340478,97
0.05,8118,86,161673,19.91292031038305,14
0.05,8119,51,161724,19.916748768472907,49
0.05,8120,93,161817,19.925748060583672,7
0.05,8121,-25,161792,19.920216695395222,60
0.05,8122,-96,161696,19.90594607903484,130
0.05,8123,13,161709,19.905096011816838,89
0.05,8124,43,161752,19.90793846153846,59
0.05,8125,93,161845,19.91693330051686,7
0.05,8126,-255,161590,19.883105697059186,289
0.05,8127,1,161591,19.88078248031496,102
0.05,8128,67,161658,19.886578914995695,33
0.05,8129,89,161747,19.89507995079951,12
0.05,8130,86,161833,19.903209937277087,15
0.05,8131,79,161912,19.910477127397932,21
0.05,8132,-33,161879,19.90397147424075,135
0.05,8133,-16,161863,19.899557413326775,117
0.05,8134,-117,161746,19.882728948985864,219
0.05,8135,-100,161646,19.867994100294986,131
0.05,8136,52,161698,19.871942976526977,48
0.05,8137,-195,161503,19.84553944458098,266
0.05,8138,67,161570,19.8513330876029,34
0.05,8139,95,161665,19.860565110565112,6
0.05,8140,50,161715,19.86426728903083,50
0.05,8141,-2,161713,19.861581920903955,105
0.05,8142,87,161800,19.869826845143066,14
0.05,8143,-15,161785,19.86554518664047,48
0.05,8144,13,161798,19.864702271332106,90
0.05,8145,47,161845,19.868033390621164,53
0.05,8146,-74,161771,19.856511599361728,187
0.05,8147,88,161859,19.864874815905743,13
0.05,8148,89,161948,19.87335869431832,12
0.05,8149,-53,161895,19.86441717791411,153
0.05,8150,63,161958,19.86970923813029,37
0.05,8151,92,162050,19.87855740922473,8
0.05,8152,-86,161964,19.86557095547651,194
0.05,8153,45,162009,19.868653421633553,57
0.05,8154,82,162091,19.876272225628448,18
0.05,8155,42,162133,19.878984796468856,61
0.05,8156,-85,162048,19.86612725266642,186
0.05,8157,-12,162036,19.86222113263055,112
0.05,8158,83,162119,19.869959553866895,17
0.05,8159,-40,162079,19.86262254901961,141
0.05,8160,51,162130,19.866437936527387,49
0.05,8161,40,162170,19.868904680225434,61
0.05,8162,13,162183,19.86806321205439,90
0.05,8163,69,162252,19.87408133268006,31
0.05,8164,70,162322,19.880220453153704,30
0.05,8165,89,162411,19.88868479059515,11
0.05,8166,-56,162355,19.879392677849882,158
0.05,8167,51,162406,19.883202742409402,50
0.05,8168,50,162456,19.88688946015424,52
0.05,8169,38,162494,19.8891064871481,92
0.05,8170,-102,162392,19.874189205727575,206
0.05,8171,-18,162374,19.869554576603036,121
0.05,8172,56,162430,19.873975284473264,45
0.05,8173,82,162512,19.881575727917788,18
0.05,8174,-6,162506,19.87840978593272,38
0.05,8175,95,162601,19.887597847358123,6
0.05,8176,69,162670,19.89360401125107,31
0.05,8177,-272,162398,19.857911469797017,306
0.05,8178,70,162468,19.86404205893141,31
0.05,8179,47,162515,19.867359413202934,53
0.05,8180,-201,162314,19.840361813959174,241
0.05,8181,74,162388,19.84698117819604,27
0.05,8182,-13,162375,19.84296712697055,44
0.05,8183,82,162457,19.850562072336267,18
0.05,8184,68,162525,19.8564447159438,33
0.05,8185,92,162617,19.86525775714635,8
0.05,8186,2,162619,19.863075607670698,100
0.05,8187,-67,162552,19.85246702491451,193
0.05,8188,2,162554,19.850286970326046,101
0.05,8189,90,162644,19.85885225885226,10
0.05,8190,91,162735,19.86753754120376,9
0.05,8191,24,162759,19.8680419921875,76
0.05,8192,58,162817,19.87269620407665,42
0.05,8193,-2,162815,19.870026848913838,104
0.05,8194,-36,162779,19.86320927394753,70
0.05,8195,86,162865,19.871278672523182,15
0.05,8196,-49,162816,19.862876662193486,80
0.05,8197,-186,162630,19.837765308611857,152
0.05,8198,14,162644,19.837053299182827,89
0.05,8199,-28,162616,19.831219512195123,60
0.05,8200,-45,162571,19.823314229971956,148
0.05,8201,-15,162556,19.819068519873202,118
0.05,8202,79,162635,19.826283067170547,21
0.05,8203,59,162694,19.831058020477816,41
0.05,8204,92,162786,19.83985374771481,9
0.05,8205,69,162855,19.845844504021446,31
0.05,8206,52,162907,19.84976239795297,49
0.05,8207,62,162969,19.854897660818715,38
0.05,8208,80,163049,19.862224387866974,21
0.05,8209,10,163059,19.861023142509136,92
0.05,8210,70,163129,19.867129460479845,32
0.05,8211,92,163221,19.87591329761325,8
0.05,8212,68,163289,19.881772799220748,34
0.05,8213,61,163350,19.886778670562453,39
0.05,8214,-108,163242,19.87121119902617,143
0.05,8215,83,163325,19.878894839337878,18
0.05,8216,19,163344,19.87878787878788,82
0.05,8217,65,163409,19.88427841323923,35
0.05,8218,-137,163272,19.865190412458936,170
0.05,8219,20,163292,19.86520681265207,80
0.05,8220,55,163347,19.86948059846734,45
0.05,8221,33,163380,19.8710775966918,67
0.05,8222,36,163416,19.873039036847867,64
0.05,8223,70,163486,19.879134241245136,31
0.05,8224,-59,163427,19.86954407294833,160
0.05,8225,-31,163396,19.863360077802092,141
0.05,8226,57,163453,19.867874073173695,44
0.05,8227,-334,163119,19.824866310160427,443
0.05,8228,-42,163077,19.817353262850894,74
0.05,8229,95,163172,19.82648845686513,6
0.05,8230,-49,163123,19.81812659458146,83
0.05,8231,-42,163081,19.810617103984452,143
0.05,8232,46,163127,19.813798129478926,66
0.05,8233,90,163217,19.822322079183873,10
0.05,8234,85,163302,19.83023679417122,15
0.05,8235,78,163380,19.83729966002914,23
0.05,8236,91,163471,19.845939055481363,10
0.05,8237,-11,163460,19.842194707453267,118
0.05,8238,87,163547,19.850345915766475,14
0.05,8239,-11,163536,19.846601941747572,115
0.05,8240,-127,163409,19.82878291469482,228
0.05,8241,71,163480,19.8349915069158,29
0.05,8242,-13,163467,19.8310081281087,116
0.05,8243,46,163513,19.83418243571082,57
0.05,8244,30,163543,19.835415403274713,71
0.05,8245,78,163621,19.842469075915595,23
0.05,8246,18,163639,19.842245665090335,82
0.05,8247,92,163731,19.850994180407373,8
0.05,8248,17,163748,19.850648563462236,15
0.05,8249,29,163777,19.851757575757574,71
0.05,8250,56,163833,19.856138649860622,45
0.05,8251,80,163913,19.863427047988367,21
0.05,8252,14,163927,19.86271658790743,120
0.05,8253,32,163959,19.864187060818995,70
0.05,8254,82,164041,19.871714112658996,19
0.05,8255,91,164132,19.88032945736434,9
0.05,8256,84,164216,19.888094949739614,16
0.05,8257,82,164298,19.895616372002905,18
0.05,8258,60,164358,19.900472212132218,42
0.05,8259,-37,164321,19.89358353510896,139
0.05,8260,-6,164315,19.890449098172134,108
0.05,8261,-64,164251,19.880295328007747,166
0.05,8262,22,164273,19.88055185767881,82
0.05,8263,62,164335,19.885648596321396,38
0.05,8264,54,164389,19.889776164549303,47
0.05,8265,-34,164355,19.88325671425115,137
0.05,8266,82,164437,19.890770533446233,18
0.05,8267,33,164470,19.892356071601355,68
0.05,8268,63,164533,19.897569234490266,38
0.05,8269,59,164592,19.90229746070133,41
0.05,8270,42,164634,19.904969169387016,58
0.05,8271,62,164696,19.910058027079305,39
0.05,8272,85,164781,19.917925782666504,15
0.05,8273,73,164854,19.924341310128113,28
0.05,8274,48,164902,19.92773413897281,53
0.05,8275,48,164950,19.931126147897537,54
0.05,8276,93,165043,19.939954089646008,7
0.05,8277,40,165083,19.94237738584199,62
0.05,8278,-42,165041,19.93489551878246,145
0.05,8279,-42,164999,19.927415458937197,78
0.05,8280,92,165091,19.936118826228718,8
0.05,8281,47,165138,19.939386621588987,53
0.05,8282,94,165232,19.948327900519136,7
0.05,8283,-149,165083,19.927933365523902,183
0.05,8284,31,165114,19.92926976463488,72
0.05,8285,60,165174,19.934105720492397,41
0.05,8286,-31,165143,19.927959454567393,135
0.05,8287,37,165180,19.930019305019304,71
0.05,8288,50,165230,19.93364700205091,50
0.05,8289,-119,165111,19.91688781664656,240
0.05,8290,88,165199,19.92509950548788,13
0.05,8291,77,165276,19.931982633863964,24
0.05,8292,75,165351,19.938622935005426,25
0.05,8293,23,165374,19.93899204244032,79
0.05,8294,-70,165304,19.928149487643157,173
0.05,8295,-42,165262,19.920684667309548,78
0.05,8296,53,165315,19.92467156803664,48
0.05,8297,78,165393,19.93167028199566,23
0.05,8298,8,165401,19.930232558139537,93
0.05,8299,84,165485,19.937951807228917,16
0.05,8300,-16,165469,19.93362245512589,134
0.05,8301,80,165549,19.940857624668755,20
0.05,8302,-25,165524,19.935445019872336,127
0.05,8303,5,165529,19.933646435452793,101
0.05,8304,61,165590,19.93859121011439,42
0.05,8305,-185,165405,19.913917649891644,285
0.05,8306,33,165438,19.91549295774648,68
0.05,8307,89,165527,19.923808377467502,11
0.05,8308,83,165610,19.93139968708629,21
0.05,8309,-105,165505,19.916365824308063,138
0.05,8310,59,165564,19.921068463482133,42
0.05,8311,95,165659,19.9301010587103,6
0.05,8312,-53,165606,19.921328040418622,157
0.05,8313,54,165660,19.925426990618234,47
0.05,8314,78,165738,19.932411304870715,22
0.05,8315,53,165791,19.936387686387686,48
0.05,8316,85,165876,19.944210652879644,16
0.05,8317,82,165958,19.95167107477759,19
0.05,8318,-109,165849,19.93617021276596,143
0.05,8319,-16,165833,19.931850961538462,120
0.05,8320,74,165907,19.938348756159115,27
0.05,8321,-58,165849,19.92898341744773,162
0.05,8322,67,165916,19.934638952300855,33
0.05,8323,84,166000,19.942335415665546,16
0.05,8324,-25,165975,19.936936936936938,125
0.05,8325,-122,165853,19.91988950276243,229
0.05,8326,21,165874,19.920019214603098,79
0.05,8327,-17,165857,19.915585975024015,49
0.05,8328,2,165859,19.91343498619282,98
0.05,8329,75,165934,19.920048019207684,26
0.05,8330,-45,165889,19.912255431520826,78
0.05,8331,-97,165792,19.898223715794526,129
0.05,8332,69,165861,19.904116164646585,32
0.05,8333,44,165905,19.907007439404847,56
0.05,8334,46,165951,19.91013797240552,55
0.05,8335,50,166001,19.913747600767753,50
0.05,8336,14,166015,19.913038263164207,17
0.05,8337,-25,165990,19.907651715039577,57
0.05,8338,-125,165865,19.89027461326298,170
0.05,8339,-29,165836,19.88441247002398,131
0.05,8340,94,165930,19.89329816568757,7
0.05,8341,82,166012,19.900743227043876,18
0.05,8342,-11,166001,19.897039434256264,134
0.05,8343,54,166055,19.901126558005753,46
0.05,8344,2,166057,19.898981426003594,100
0.05,8345,83,166140,19.906542056074766,18
0.05,8346,76,166216,19.913262249910147,25
0.05,8347,78,166294,19.920220412074748,23
0.05,8348,44,166338,19.923104563420768,56
0.05,8349,92,166430,19.931736526946107,8
0.05,8350,-192,166238,19.906358519937733,229
0.05,8351,-38,166200,19.899425287356323,138
0.05,8352,66,166266,19.904944331377948,35
0.05,8353,19,166285,19.904836006703377,84
0.05,8354,2,166287,19.902692998204667,29
0.05,8355,59,166346,19.90737194830062,42
0.05,8356,79,166425,19.914442981931316,22
0.05,8357,-3,166422,19.91170136396267,103
0.05,8358,26,166448,19.912429716473262,79
0.05,8359,54,166502,19.91650717703349,46
0.05,8360,86,166588,19.924410955627316,15
0.05,8361,-87,166501,19.911624013393926,121
0.05,8362,-52,166449,19.903025230180557,85
0.05,8363,-123,166326,19.88593974175036,228
0.05,8364,89,166415,19.894202032277345,11
0.05,8365,-297,166118,19.85632321300502,263
0.05,8366,93,166211,19.865065136847136,8
0.05,8367,-48,166163,19.856955066921607,80
0.05,8368,-32,166131,19.850758752539132,132
0.05,8369,94,166225,19.859617682198326,6
0.05,8370,29,166254,19.86070959264126,73
0.05,8371,-108,166146,19.84543717152413,143
0.05,8372,92,166238,19.854054699629764,9
0.05,8373,-32,166206,19.847862431335084,133
0.05,8374,36,166242,19.84979104477612,66
0.05,8375,57,166299,19.854226361031518,43
0.05,8376,89,166388,19.862480601647366,12
0.05,8377,-22,166366,19.85748388636906,123
0.05,8378,48,166414,19.860842582647095,54
0.05,8379,88,166502,19.868973747016707,13
0.05,8380,17,166519,19.868631428230522,83
0.05,8381,61,166580,19.87353853495586,40
0.05,8382,-153,166427,19.8529166169629,254
0.05,8383,93,166520,19.861641221374047,8
0.05,8384,-127,166393,19.84412641621944,160
0.05,8385,43,166436,19.84688766992607,57
0.05,8386,37,166473,19.848932872302374,63
0.05,8387,15,166488,19.8483547925608,85
0.05,8388,-17,166471,19.84396233162475,118
0.05,8389,67,166538,19.84958283671037,34
0.05,8390,-103,166435,19.834942199976165,136
0.05,8391,68,166503,19.84068160152526,45
0.05,8392,84,166587,19.848325985940665,17
0.05,8393,79,166666,19.855372885394328,22
0.05,8394,63,166729,19.8605122096486,37
0.05,8395,24,166753,19.861005240590757,78
0.05,8396,-63,166690,19.851137310944384,95
0.05,8397,42,166732,19.853774708263874,59
0.05,8398,-41,166691,19.84652934873199,143
0.05,8399,68,166759,19.852261904761903,32
0.05,8400,44,166803,19.85513629329842,57
0.05,8401,-279,166524,19.81956676981671,244
0.05,8402,78,166602,19.826490539093182,23
0.05,8403,-5,166597,19.823536411232745,105
0.05,8404,-73,166524,19.81249256395003,173
0.05,8405,-71,166453,19.801689269569355,174
0.05,8406,28,166481,19.802664446294756,73
0.05,8407,55,166536,19.80685061845861,47
0.05,8408,33,166569,19.808419550481627,67
0.05,8409,70,166639,19.81438763376932,31
0.05,8410,84,166723,19.822018784924502,16
0.05,8411,82,166805,19.829410366143605,18
0.05,8412,80,166885,19.836562462855106,21
0.05,8413,-3,166882,19.83384834799144,105
0.05,8414,-101,166781,19.8194890077243,135
0.05,8415,18,166799,19.81927281368821,84
0.05,8416,71,166870,19.825353451348462,29
0.05,8417,41,166911,19.827868852459016,60
0.05,8418,52,166963,19.83169022449222,49
0.05,8419,-197,166766,19.805938242280284,232
0.05,8420,-18,166748,19.801448759054743,49
0.05,8421,71,166819,19.8075279031109,29
0.05,8422,69,166888,19.813368158613322,32
0.05,8423,-49,166839,19.80519943019943,80
0.05,8424,71,166910,19.81127596439169,31
0.05,8425,56,166966,19.815570852124377,44
0.05,8426,-1,166965,19.81310074759701,33
0.05,8427,73,167038,19.81941148552444,27
0.05,8428,-47,166991,19.811484161822282,152
0.05,8429,-110,166881,19.79608540925267,211
0.05,8430,-29,166852,19.790297710829083,61
0.05,8431,-54,166798,19.781546489563567,165
0.05,8432,-29,166769,19.775761887821652,132
0.05,8433,37,166806,19.777804126156035,64
0.05,8434,-98,166708,19.763841138114998,203
0.05,8435,80,166788,19.770981507823613,21
0.05,8436,90,166878,19.77930544032239,10
0.05,8437,37,166915,19.781346290590186,63
0.05,8438,16,166931,19.78089821068847,84
0.05,8439,-209,166722,19.75379146919431,245
0.05,8440,64,166786,19.759033289894564,36
0.05,8441,-9,166777,19.755626628760957,140
0.05,8442,-30,166747,19.749733507047257,63
0.05,8443,86,166833,19.757579346281382,14
0.05,8444,56,166889,19.76187092954411,45
0.05,8445,85,166974,19.76959507459152,15
0.05,8446,33,167007,19.77116135906239,68
0.05,8447,77,167084,19.777935606060606,24
0.05,8448,88,167172,19.786010178719376,12
0.05,8449,70,167242,19.791952662721894,30
0.05,8450,83,167325,19.799432019879305,18
0.05,8451,72,167397,19.805608140085187,29
0.05,8452,91,167488,19.81403052170827,10
0.05,8453,65,167553,19.819375443577005,38
0.05,8454,38,167591,19.821525724423417,62
0.05,8455,-22,167569,19.816579943235574,124
0.05,8456,72,167641,19.82275038429703,29
0.05,8457,-145,167496,19.80326318278553,189
0.05,8458,-17,167479,19.798912400993025,50
0.05,8459,78,167557,19.80579196217494,22
0.05,8460,-174,167383,19.782886183666232,207
0.05,8461,79,167462,19.789884188135193,21
0.05,8462,49,167511,19.793335696561503,51
0.05,8463,35,167546,19.795132325141775,65
0.05,8464,64,167610,19.800354400472536,36
0.05,8465,-362,167248,19.75525631939523,260
0.05,8466,-194,167054,19.730010629502775,157
0.05,8467,41,167095,19.732522437411433,59
0.05,8468,3,167098,19.73054669972842,100
0.05,8469,74,167172,19.736953955135775,28
0.05,8470,87,167259,19.744894345413766,13
0.05,8471,90,167349,19.753186968838527,11
0.05,8472,90,167439,19.76147763484008,10
0.05,8473,70,167509,19.767406183620487,30
0.05,8474,24,167533,19.767905604719765,77
0.05,8475,-16,167517,19.763685700802267,119
0.05,8476,49,167566,19.76713459950454,53
0.05,8477,80,167646,19.774239207360228,21
0.05,8478,89,167735,19.78240358532846,12
0.05,8479,86,167821,19.790212264150945,15
0.05,8480,95,167916,19.799080297134772,6
0.05,8481,60,167976,19.803819853808065,40
0.05,8482,-12,167964,19.800070729694685,43
0.05,8483,-143,167821,19.78088165959453,245
0.05,8484,-131,167690,19.763111373011196,163
0.05,8485,-23,167667,19.75807211878388,55
0.05,8486,-348,167319,19.71474019088017,383
0.05,8487,-118,167201,19.698515551366636,151
0.05,8488,52,167253,19.70232065025327,48
0.05,8489,94,167347,19.711071849234393,7
0.05,8490,-146,167201,19.69155576492757,179
0.05,8491,-69,167132,19.68111163447951,174
0.05,8492,67,167199,19.686683150830095,33
0.05,8493,90,167289,19.694961149046385,10
0.05,8494,53,167342,19.698881695114775,48
0.05,8495,57,167399,19.703272128060263,43
0.05,8496,32,167431,19.7047193126986,69
0.05,8497,46,167477,19.70781360320075,56
0.05,8498,18,167495,19.70761266031298,82
0.05,8499,85,167580,19.71529411764706,15
0.05,8500,-75,167505,19.70415245265263,178
0.05,8501,-14,167491,19.70018819101388,120
0.05,8502,-133,167358,19.68222980124662,233
0.05,8503,-131,167227,19.664510818438384,233
0.05,8504,76,167303,19.671134626690183,24
0.05,8505,80,167383,19.678227133787914,20
0.05,8506,62,167445,19.683202068884448,39
0.05,8507,57,167502,19.687588152327223,43
0.05,8508,-65,167437,19.677635444823128,167
0.05,8509,-7,167430,19.674500587544067,39
0.05,8510,-2,167428,19.671953941957465,33
0.05,8511,66,167494,19.677396616541355,34
0.05,8512,-70,167424,19.666862445671327,102
0.05,8513,55,167479,19.671012450082216,46
0.05,8514,65,167544,19.676335877862595,36
0.05,8515,75,167619,19.682832315641146,26
0.05,8516,5,167624,19.68110837149231,102
0.05,8517,49,167673,19.684550363935195,56
0.05,8518,65,167738,19.689869703016786,35
0.05,8519,-46,167692,19.682159624413146,77
0.05,8520,74,167766,19.688534209599812,27
0.05,8521,88,167854,19.696550105609013,13
0.05,8522,-49,167805,19.688489968321015,82
0.05,8523,-29,167776,19.682778038479587,131
0.05,8524,-123,167653,19.666041055718477,237
0.05,8525,26,167679,19.666783954961296,77
0.05,8526,65,167744,19.67210038700598,36
0.05,8527,88,167832,19.680112570356474,13
0.05,8528,86,167918,19.687888380818386,15
0.05,8529,94,168012,19.69660023446659,7
0.05,8530,10,168022,19.695463603329035,90
0.05,8531,17,168039,19.695147679324894,108
0.05,8532,28,168067,19.696120942224304,73
0.05,8533,67,168134,19.701663932505273,33
0.05,8534,24,168158,19.702167545401288,76
0.05,8535,-100,168058,19.688144329896907,204
0.05,8536,94,168152,19.696849010190935,6
0.05,8537,-9,168143,19.693487936284843,111
0.05,8538,52,168195,19.697271343248623,49
0.05,8539,0,168195,19.69496487119438,107
0.05,8540,-269,167926,19.6611637981501,375
0.05,8541,57,167983,19.66553500351206,43
0.05,8542,-19,167964,19.661009013227204,119
0.05,8543,-21,167943,19.65625,122
0.05,8544,-103,167840,19.6418958455237,135
0.05,8545,-15,167825,19.637842265387317,117
0.05,8546,65,167890,19.643149643149645,36
0.05,8547,21,167911,19.643308376228358,79
0.05,8548,-73,167838,19.63247163410925,109
0.05,8549,42,167880,19.635087719298244,59
0.05,8550,-56,167824,19.62624254473161,157
0.05,8551,-53,167771,19.617750233863426,154
0.05,8552,33,167804,19.61931486028294,68
0.05,8553,18,167822,19.619125555295767,83
0.05,8554,40,167862,19.621507890122736,61
0.05,8555,-38,167824,19.614773258532026,139
0.05,8556,93,167917,19.62334930466285,8
0.05,8557,44,167961,19.626197709745266,56
0.05,8558,20,167981,19.626241383339174,81
0.05,8559,88,168069,19.634228971962617,12
0.05,8560,35,168104,19.63602382899194,68
0.05,8561,91,168195,19.64435879467414,10
0.05,8562,77,168272,19.651056872591383,24
0.05,8563,28,168300,19.652031760859412,73
0.05,8564,87,168387,19.659894921190894,14
0.05,8565,60,168447,19.664604249357925,41
0.05,8566,91,168538,19.672931014357417,10
0.05,8567,91,168629,19.6812558356676,9
0.05,8568,85,168714,19.688878515579415,15
0.05,8569,91,168805,19.697199533255542,9
0.05,8570,67,168872,19.702718469256798,41
0.05,8571,-77,168795,19.691437237517498,189
0.05,8572,74,168869,19.697772075119563,26
0.05,8573,82,168951,19.705038488453464,19
0.05,8574,-106,168845,19.690379008746355,137
0.05,8575,11,168856,19.68936567164179,89
0.05,8576,-10,168846,19.68590416229451,112
0.05,8577,56,168902,19.690137561203077,44
0.05,8578,43,168945,19.692854645063527,58
0.05,8579,82,169027,19.70011655011655,18
0.05,8580,-166,168861,19.67847570213262,129
0.05,8581,72,168933,19.68457236075507,28
0.05,8582,11,168944,19.683560526622394,91
0.05,8583,-85,168859,19.67136533084809,117
0.05,8584,95,168954,19.68013977868375,6
0.05,8585,30,168984,19.68134171907757,70
0.05,8586,55,169039,19.685454757191103,48
0.05,8587,-142,168897,19.666627852817886,175
0.05,8588,84,168981,19.67411805798114,16
0.05,8589,10,168991,19.672991850989522,22
0.05,8590,46,169037,19.676056338028168,55
0.05,8591,-386,168651,19.628840782122904,285
0.05,8592,45,168696,19.631793320144304,56
0.05,8593,-46,168650,19.6241563881778,148
0.05,8594,73,168723,19.630366492146596,28
0.05,8595,-92,168631,19.61738017682643,192
0.05,8596,59,168690,19.621961149238107,42
0.05,8597,-32,168658,19.615957199348685,133
0.05,8598,94,168752,19.624607512501452,7
0.05,8599,-6,168746,19.621627906976745,107
0.05,8600,-25,168721,19.61643994884316,125
0.05,8601,64,168785,19.62159962799349,37
0.05,8602,-14,168771,19.61769150296408,117
0.05,8603,87,168858,19.6255230125523,19
0.05,8604,57,168915,19.62986635676932,43
0.05,8605,45,168960,19.632814315593773,57
0.05,8606,69,169029,19.638550017427676,32
0.05,8607,91,169120,19.646840148698885,9
0.05,8608,-69,169051,19.63654315251481,170
0.05,8609,54,169105,19.64053426248548,47
0.05,8610,54,169159,19.644524445476716,48
0.05,8611,67,169226,19.650023223409196,33
0.05,8612,43,169269,19.652734238941136,57
0.05,8613,95,169364,19.661481309496168,6
0.05,8614,-193,169171,19.636796285548463,228
0.05,8615,93,169264,19.645311049210772,7
0.05,8616,-34,169230,19.639085528606245,135
0.05,8617,62,169292,19.644000928289625,39
0.05,8618,94,169386,19.652627915071353,6
0.05,8619,83,169469,19.659976798143852,19
0.05,8620,26,169495,19.660712214360284,74
0.05,8621,75,169570,19.667130596149384,26
0.05,8622,50,169620,19.670648266264642,51
0.05,8623,-44,169576,19.663265306122447,86
0.05,8624,76,169652,19.669797101449277,24
0.05,8625,-45,169607,19.66230002318572,148
0.05,8626,89,169696,19.670337313086822,11
0.05,8627,-78,169618,19.65901715345387,112
0.05,8628,47,169665,19.66218565303048,54
0.05,8629,94,169759,19.670799536500578,6
0.05,8630,79,169838,19.67767350249102,21
0.05,8631,93,169931,19.686167747914737,8
0.05,8632,-126,169805,19.66929225066605,184
0.05,8633,-36,169769,19.66284456798703,138
0.05,8634,38,169807,19.66496815286624,64
0.05,8635,14,169821,19.66431218156554,86
0.05,8636,66,169887,19.669676971170546,34
0.05,8637,92,169979,19.67805047464691,8
0.05,8638,92,170071,19.686422039587914,9
0.05,8639,90,170161,19.694560185185185,11
0.05,8640,-29,170132,19.688924892952205,63
0.05,8641,76,170208,19.69544087016894,24
0.05,8642,92,170300,19.70380654865209,9
0.05,8643,63,170363,19.708815363257752,37
0.05,8644,41,170404,19.71127819548872,61
0.05,8645,59,170463,19.715822345593338,42
0.05,8646,-42,170421,19.70868509309587,75
0.05,8647,84,170505,19.716119333950047,16
0.05,8648,-5,170500,19.71326164874552,37
0.05,8649,58,170558,19.717687861271678,42
0.05,8650,17,170575,19.7173737140215,85
0.05,8651,42,170617,19.719949144706426,59
0.05,8652,86,170703,19.727608921761238,14
0.05,8653,67,170770,19.733071412063786,33
0.05,8654,79,170849,19.739919121894857,21
0.05,8655,-16,170833,19.735790203327173,116
0.05,8656,58,170891,19.74021023449232,43
0.05,8657,60,170951,19.744860244860245,40
0.05,8658,70,171021,19.750664048966392,31
0.05,8659,77,171098,19.75727482678984,24
0.05,8660,86,171184,19.764923219027825,14
0.05,8661,33,171217,19.76645116601247,68
0.05,8662,-31,171186,19.760591019277385,63
0.05,8663,92,171278,19.76892890120037,8
0.05,8664,94,171372,19.77749567224466,6
0.05,8665,71,171443,19.783406415878144,29
0.05,8666,85,171528,19.79093111803392,15
0.05,8667,28,171556,19.79187817258883,72
0.05,8668,57,171613,19.796170261852577,43
0.05,8669,78,171691,19.802883506343715,23
0.05,8670,-169,171522,19.781109445277362,132
0.05,8671,33,171555,19.782633763837637,67
0.05,8672,-8,171547,19.77943041623429,109
0.05,8673,68,171615,19.78498962416417,32
0.05,8674,58,171673,19.789394812680115,43
0.05,8675,22,171695,19.78964960811434,79
0.05,8676,-189,171506,19.765587184510775,224
0.05,8677,-15,171491,19.76158100944918,46
0.05,8678,-31,171460,19.755732227215116,65
0.05,8679,-264,171196,19.723041474654377,301
0.05,8680,-32,171164,19.71708328533579,133
0.05,8681,64,171228,19.72218382861092,37
0.05,8682,69,171297,19.727859034895772,32
0.05,8683,23,171320,19.728235836020268,78
0.05,8684,-11,171309,19.724697754749567,113
0.05,8685,51,171360,19.728298411236473,49
0.05,8686,-26,171334,19.72303441924715,60
0.05,8687,92,171426,19.73135359116022,9
0.05,8688,79,171505,19.73817470364829,21
0.05,8689,-6,171499,19.735212888377447,107
0.05,8690,-71,171428,19.724772753423082,185
0.05,8691,6,171434,19.723193741371375,96
0.05,8692,84,171518,19.730587829287934,17
0.05,8693,84,171602,19.737980216241088,16
0.05,8694,-24,171578,19.732949971247844,128
0.05,8695,92,171670,19.741260349586017,9
0.05,8696,67,171737,19.74669426238933,34
0.05,8697,24,171761,19.74718326051966,7
0.05,8698,23,171784,19.747557190481665,9
0.05,8699,55,171839,19.7516091954023,45
0.05,8700,36,171875,19.75347661188369,73
0.05,8701,73,171948,19.75959549528844,28
0.05,8702,-37,171911,19.753073652763415,141
0.05,8703,51,171962,19.756663602941178,50
0.05,8704,91,172053,19.764847788627225,9
0.05,8705,-12,172041,19.76119917298415,113
0.05,8706,63,172104,19.766165154473413,37
0.05,8707,-279,171825,19.731855764813965,318
0.05,8708,87,171912,19.739579745091284,13
0.05,8709,81,171993,19.746613088404132,20
0.05,8710,71,172064,19.752496843071977,30
0.05,8711,70,172134,19.75826446280992,31
0.05,8712,-5,172129,19.755422931252152,105
0.05,8713,-208,171921,19.72928620610512,243
0.05,8714,86,172007,19.73689041881813,14
0.05,8715,-126,171881,19.720169802661772,89
0.05,8716,-49,171832,19.71228633704256,154
0.05,8717,-33,171799,19.706239963294333,134
0.05,8718,-47,171752,19.698589287762356,148
0.05,8719,65,171817,19.703784403669726,36
0.05,8720,13,171830,19.70301570920766,87
0.05,8721,95,171925,19.711648704425592,9
0.05,8722,59,171984,19.716152699759256,42
0.05,8723,-65,171919,19.70644199908299,99
0.05,8724,28,171947,19.707392550143265,75
0.05,8725,87,172034,19.715104286041715,13
0.05,8726,-208,171826,19.689011114930675,173
0.05,8727,62,171888,19.69385884509624,39
0.05,8728,89,171977,19.70179860235995,11
0.05,8729,32,172009,19.703207331042382,69
0.05,8730,0,172009,19.70095063566602,100
0.05,8731,83,172092,19.708199725148877,18
0.05,8732,81,172173,19.715218138096873,20
0.05,8733,88,172261,19.723036409434393,12
0.05,8734,-24,172237,19.718030910131656,125
0.05,8735,-133,172104,19.70054945054945,250
0.05,8736,68,172172,19.70607760100721,33
0.05,8737,78,172250,19.71274891279469,22
0.05,8738,42,172292,19.71529923332189,59
0.05,8739,71,172363,19.72116704805492,29
0.05,8740,-16,172347,19.717080425580598,48
0.05,8741,-70,172277,19.706817661862274,175
0.05,8742,94,172371,19.715315109230243,6
0.05,8743,81,172452,19.722323879231475,20
0.05,8744,94,172546,19.730817610062893,7
0.05,8745,-56,172490,19.722158701120513,158
0.05,8746,58,172548,19.726534811935522,42
0.05,8747,-57,172491,19.717764060356654,107
0.05,8748,77,172568,19.724311349868557,24
0.05,8749,58,172626,19.728685714285714,43
0.05,8750,-16,172610,19.724602902525426,116
0.05,8751,-12,172598,19.720978062157222,44
0.05,8752,53,172651,19.72478007540272,49
0.05,8753,77,172728,19.731322823851954,24
0.05,8754,15,172743,19.7307824100514,16
0.05,8755,68,172811,19.73629511192325,32
0.05,8756,-49,172762,19.72844581477675,83
0.05,8757,10,172772,19.727335007992693,94
0.05,8758,73,172845,19.733417056741636,27
0.05,8759,74,172919,19.739611872146117,27
0.05,8760,-47,172872,19.731994064604496,147
0.05,8761,-107,172765,19.717530244236475,71
0.05,8762,81,172846,19.72452356498916,20
0.05,8763,52,172898,19.728206298493838,53
0.05,8764,39,172937,19.730405019965772,63
0.05,8765,-10,172927,19.727013461099702,111
0.05,8766,-3,172924,19.724421124672066,106
0.05,8767,-242,172682,19.69457116788321,276
0.05,8768,64,172746,19.69962367430722,37
0.05,8769,47,172793,19.70273660205245,53
0.05,8770,50,172843,19.706190856230762,50
0.05,8771,82,172925,19.713292293661652,45
0.05,8772,74,172999,19.719480223412745,27
0.05,8773,-20,172979,19.714953271028037,121
0.05,8774,76,173055,19.721367521367522,24
0.05,8775,82,173137,19.728463992707383,18
0.05,8776,-32,173105,19.722570354335193,68
0.05,8777,-50,173055,19.714627477785374,83
0.05,8778,-101,172954,19.700877093062992,209
0.05,8779,91,173045,19.70899772209567,9
0.05,8780,-45,173000,19.701628516114337,163
0.05,8781,-49,172951,19.69380551127306,152
0.05,8782,38,172989,19.695889787088696,62
0.05,8783,91,173080,19.704007285974498,9
0.05,8784,-154,172926,19.684234490608993,258
0.05,8785,14,172940,19.683587525608925,88
0.05,8786,21,172961,19.683737339251167,11
0.05,8787,91,173052,19.691852526172053,10
0.05,8788,84,173136,19.69916941631585,16
0.05,8789,79,173215,19.705915813424348,22
0.05,8790,-51,173164,19.69787282447958,156
0.05,8791,89,173253,19.705755232029116,11
0.05,8792,-81,173172,19.694302285909245,113
0.05,8793,80,173252,19.70115988173755,20
0.05,8794,-139,173113,19.683115406480955,173
0.05,8795,65,173178,19.688267394270124,36
0.05,8796,-8,173170,19.685119927247925,110
0.05,8797,-39,173131,19.67844964764719,140
0.05,8798,79,173210,19.68519149903398,21
0.05,8799,25,173235,19.685795454545456,76
0.05,8800,71,173306,19.69162595159641,30
0.05,8801,81,173387,19.698591229266075,20
0.05,8802,21,173408,19.69873906622742,81
0.05,8803,-11,173397,19.695252158109952,42
0.05,8804,52,173449,19.69892106757524,49
0.05,8805,-69,173380,19.688848512377923,103
0.05,8806,83,173463,19.69603724310208,17
0.05,8807,-220,173243,19.668823796548594,254
0.05,8808,10,173253,19.66772618912476,91
0.05,8809,92,173345,19.67593643586833,9
0.05,8810,79,173424,19.68266939053456,21
0.05,8811,46,173470,19.685655923740352,55
0.05,8812,94,173564,19.694088278679224,7
0.05,8813,10,173574,19.692988427501703,92
0.05,8814,10,173584,19.691888825865004,90
0.05,8815,61,173645,19.69657441016334,39
0.05,8816,85,173730,19.703980945899968,16
0.05,8817,-16,173714,19.699931957359947,48
0.05,8818,66,173780,19.70518199342329,35
0.05,8819,73,173853,19.711224489795917,48
0.05,8820,84,173937,19.718512640290218,16
0.05,8821,89,174026,19.72636590342326,12
0.05,8822,-186,173840,19.703048849597643,220
0.05,8823,54,173894,19.70693563009973,46
0.05,8824,81,173975,19.71388101983003,33
0.05,8825,20,173995,19.713913437570813,84
0.05,8826,-177,173818,19.691627959669198,141
0.05,8827,75,173893,19.69789306751246,26
0.05,8828,-5,173888,19.69509570732812,36
0.05,8829,-73,173815,19.684597961494905,175
0.05,8830,-88,173727,19.67240403125354,191
0.05,8831,65,173792,19.67753623188406,35
0.05,8832,90,173882,19.685497565945884,10
0.05,8833,-39,173843,19.67885442608105,162
0.05,8834,-122,173721,19.66281833616299,179
0.05,8835,94,173815,19.671231326392032,7
0.05,8836,-56,173759,19.6626683263551,89
0.05,8837,91,173850,19.670739986422266,9
0.05,8838,-53,173797,19.662518384432627,153
0.05,8839,3,173800,19.660633484162897,100
0.05,8840,-33,173767,19.654677072729328,135
0.05,8841,77,173844,19.661162632888487,23
0.05,8842,42,173886,19.663688793395906,58
0.05,8843,47,173933,19.66677973767526,54
0.05,8844,73,174006,19.6728094968909,28
0.05,8845,0,174006,19.67058557540131,105
0.05,8846,84,174090,19.677856900644286,17
0.05,8847,-7,174083,19.6748417721519,39
0.05,8848,-103,173980,19.660978641654424,206
0.05,8849,80,174060,19.667796610169493,21
0.05,8850,83,174143,19.674951982826798,17
0.05,8851,26,174169,19.675666516041574,78
0.05,8852,39,174208,19.677849316615838,61
0.05,8853,67,174275,19.68319403659363,33
0.05,8854,80,174355,19.690005646527386,20
0.05,8855,49,174404,19.693315266486,54
0.05,8856,81,174485,19.700237100598397,19
0.05,8857,48,174533,19.703431925942652,53
0.05,8858,-64,174469,19.693983519584602,97
0.05,8859,64,174533,19.698984198645597,37
0.05,8860,62,174595,19.703758040853177,41
0.05,8861,83,174678,19.71090047393365,17
0.05,8862,60,174738,19.715446237165747,41
0.05,8863,84,174822,19.72269855595668,16
0.05,8864,94,174916,19.731077270163563,7
0.05,8865,-48,174868,19.72343785247011,150
0.05,8866,16,174884,19.723017931656706,15
0.05,8867,76,174960,19.72936400541272,25
0.05,8868,-33,174927,19.723418649227646,65
0.05,8869,86,175013,19.73089064261556,14
0.05,8870,-44,174969,19.72370645924924,75
0.05,8871,84,175053,19.73095130748422,17
0.05,8872,44,175097,19.733686464555394,57
0.05,8873,35,175132,19.73540680640072,65
0.05,8874,-277,174855,19.701971830985915,243
0.05,8875,68,174923,19.707413249211356,33
0.05,8876,88,175011,19.715106454883408,13
0.05,8877,74,175085,19.721220995719758,26
0.05,8878,-124,174961,19.70503435071517,157
0.05,8879,60,175021,19.70957207207207,40
0.05,8880,-123,174898,19.69350298389821,224
0.05,8881,71,174969,19.699279441567214,29
0.05,8882,21,174990,19.699425869638635,80
0.05,8883,49,175039,19.70272399819901,53
0.05,8884,12,175051,19.70185706246483,88
0.05,8885,-37,175014,19.695476029709656,138
0.05,8886,41,175055,19.69787329807584,59
0.05,8887,-1,175054,19.695544554455445,102
0.05,8888,-126,174928,19.67915401057487,167
0.05,8889,38,174966,19.68121484814398,64
0.05,8890,89,175055,19.68901135980205,11
0.05,8891,42,175097,19.691520467836256,59
0.05,8892,92,175189,19.69965141122231,8
0.05,8893,-22,175167,19.69496289633461,126
0.05,8894,34,175201,19.696571107363688,68
0.05,8895,17,175218,19.69626798561151,98
0.05,8896,50,175268,19.699674047431717,52
0.05,8897,58,175326,19.70397842211733,42
0.05,8898,93,175419,19.712214855601754,8
0.05,8899,42,175461,19.714719101123595,59
0.05,8900,20,175481,19.714751151556005,81
0.05,8901,66,175547,19.719950572904967,34
0.05,8902,9,175556,19.718746489947208,92
0.05,8903,48,175604,19.721922731356695,52
0.05,8904,80,175684,19.728691746209993,21
0.05,8905,32,175716,19.73006961598922,68
0.05,8906,10,175726,19.72897720893679,91
0.05,8907,14,175740,19.72833408172429,87
0.05,8908,-91,175649,19.715905264339433,123
0.05,8909,68,175717,19.72132435465769,33
0.05,8910,91,175808,19.729323308270676,9
0.05,8911,-265,175543,19.69737432675045,159
0.05,8912,-182,175361,19.674744754852462,144
0.05,8913,-102,175259,19.661094906888042,135
0.05,8914,89,175348,19.668872686483454,20
0.05,8915,64,175412,19.673844773441004,37
0.05,8916,16,175428,19.673432768868455,85
0.05,8917,77,175505,19.679860955371158,23
0.05,8918,52,175557,19.683484695593677,49
0.05,8919,52,175609,19.687107623318386,50
0.05,8920,72,175681,19.692971639950677,28
0.05,8921,-67,175614,19.683254875588432,170
0.05,8922,9,175623,19.682057603944862,92
0.05,8923,86,175709,19.689489018377408,15
0.05,8924,-48,175661,19.68190476190476,148
0.05,8925,87,175748,19.689446560609454,14
0.05,8926,-24,175724,19.684552481236697,127
0.05,8927,67,175791,19.689852150537636,33
0.05,8928,33,175824,19.691342815544854,67
0.05,8929,-199,175625,19.666853303471445,234
0.05,8930,76,175701,19.673160900235136,25
0.05,8931,32,175733,19.674540976265114,68
0.05,8932,-63,175670,19.665286018135006,179
0.05,8933,24,175694,19.66577121110365,76
0.05,8934,4,175698,19.66401790710688,96
0.05,8935,2,175700,19.662041181736797,99
0.05,8936,94,175794,19.6703591809332,7
0.05,8937,80,175874,19.677108972924593,21
0.05,8938,73,175947,19.683074169370176,27
0.05,8939,23,175970,19.6834451901566,78
0.05,8940,84,176054,19.690638631025614,16
0.05,8941,-84,175970,19.679042719749496,136
0.05,8942,-154,175816,19.65962205076596,201
0.05,8943,9,175825,19.65843023255814,92
0.05,8944,31,175856,19.659698155394075,71
0.05,8945,47,175903,19.662754303599375,60
0.05,8946,19,175922,19.66268022800939,83
0.05,8947,-33,175889,19.656794814483682,133
0.05,8948,-8,175881,19.653704324505533,110
0.05,8949,60,175941,19.658212290502792,41
0.05,8950,72,176013,19.664059881577476,28
0.05,8951,39,176052,19.66621983914209,61
0.05,8952,59,176111,19.670613202278567,42
0.05,8953,88,176199,19.678244360062543,12
0.05,8954,84,176283,19.685427135678392,16
0.05,8955,90,176373,19.6932782492184,10
0.05,8956,80,176453,19.700011164452384,20
0.05,8957,53,176506,19.70372851082831,48
0.05,8958,32,176538,19.705101015738364,68
0.05,8959,-1,176537,19.70279017857143,106
0.05,8960,-24,176513,19.697913179332662,55
0.05,8961,-149,176364,19.67908948895336,249
0.05,8962,-9,176355,19.675889769050542,112
0.05,8963,95,176450,19.6842927264614,6
0.05,8964,83,176533,19.691355270496373,18
0.05,8965,-38,176495,19.684920811956278,139
0.05,8966,80,176575,19.691647150663545,21
0.05,8967,94,176669,19.69993309545049,7
0.05,8968,16,176685,19.699520570855167,84
0.05,8969,-96,176589,19.686622073578594,199
0.05,8970,59,176648,19.691004347341433,41
0.05,8971,89,176737,19.69872938029425,12
0.05,8972,44,176781,19.70143764627215,57
0.05,8973,0,176781,19.699242255404503,102
0.05,8974,79,176860,19.705849582172704,22
0.05,8975,-23,176837,19.701091800356505,126
0.05,8976,73,176910,19.70702907430099,27
0.05,8977,82,176992,19.713967476052574,19
0.05,8978,63,177055,19.71878828377325,38
0.05,8979,-163,176892,19.698440979955457,195
0.05,8980,-96,176796,19.685558401068924,209
0.05,8981,34,176830,19.68715208194166,66
0.05,8982,80,176910,19.693866191695424,21
0.05,8983,82,176992,19.70080142475512,19
0.05,8984,77,177069,19.707178631051754,24
0.05,8985,-146,176923,19.68873803694636,259
0.05,8986,83,177006,19.695782797373983,17
0.05,8987,-77,176929,19.685024477080553,108
0.05,8988,50,176979,19.6883969295806,51
0.05,8989,88,177067,19.69599555061179,15
0.05,8990,21,177088,19.696140585029475,80
0.05,8991,-97,176991,19.683162811387902,200
0.05,8992,25,177016,19.683754030912933,75
0.05,8993,60,177076,19.68823660217923,40
0.05,8994,-233,176843,19.660144524735966,127
0.05,8995,90,176933,19.667963539350822,10
0.05,8996,90,177023,19.675780815827498,10
0.05,8997,65,177088,19.680817959546566,36
0.05,8998,92,177180,19.68885431714635,9
0.05,8999,-83,177097,19.677444444444443,115
0.05,9000,79,177176,19.68403510721031,22
0.05,9001,-1,177175,19.681737391690735,104
0.05,9002,62,177237,19.686437854048652,39
0.05,9003,-158,177079,19.66670368725011,264
0.05,9004,76,177155,19.672959466962798,24
0.05,9005,44,177199,19.675660670664,57
0.05,9006,-54,177145,19.667480848229154,158
0.05,9007,80,177225,19.674178507992895,20
0.05,9008,37,177262,19.676101676101677,63
0.05,9009,-167,177095,19.65538290788013,206
0.05,9010,-43,177052,19.648429697036956,148
0.05,9011,86,177138,19.655792276964046,14
0.05,9012,-156,176982,19.63630311771885,208
0.05,9013,-71,176911,19.62624805857555,105
0.05,9014,-11,176900,19.622850804215197,113
0.05,9015,-33,176867,19.617014196983142,89
0.05,9016,28,176895,19.61794388377509,72
0.05,9017,73,176968,19.623863384342425,27
0.05,9018,73,177041,19.62978157223639,28
0.05,9019,78,177119,19.636252771618626,23
0.05,9020,92,177211,19.644274470679527,9
0.05,9021,6,177217,19.64276213699845,25
0.05,9022,83,177300,19.649783885625624,17
0.05,9023,-57,177243,19.64128989361702,165
0.05,9024,-158,177085,19.621606648199446,189
0.05,9025,22,177107,19.621870152891645,9
0.05,9026,25,177132,19.622465935526755,78
0.05,9027,35,177167,19.624169251218433,67
0.05,9028,48,177215,19.627311994683797,52
0.05,9029,61,177276,19.63189368770764,39
0.05,9030,28,177304,19.632820285682648,74
0.05,9031,-33,177271,19.62699291408326,134
0.05,9032,17,177288,19.62670209232813,99
0.05,9033,-210,177078,19.601284038078372,311
0.05,9034,63,177141,19.606087437742115,38
0.05,9035,-31,177110,19.60048694112439,63
0.05,9036,79,177189,19.607059864999446,22
0.05,9037,11,177200,19.60610754591724,91
0.05,9038,55,177255,19.61002323265848,46
0.05,9039,72,177327,19.615818584070798,29
0.05,9040,83,177410,19.622829333038382,17
0.05,9041,20,177430,19.62287104622871,81
0.05,9042,53,177483,19.62656198164326,47
0.05,9043,67,177550,19.631800088456437,33
0.05,9044,-134,177416,19.614814814814814,238
0.05,9045,-19,177397,19.61054609772275,122
0.05,9046,-4,177393,19.607936332485906,104
0.05,9047,13,177406,19.607206012378427,94
0.05,9048,69,177475,19.61266438280473,31
0.05,9049,62,177537,19.61734806629834,40
0.05,9050,50,177587,19.620704894486796,50
0.05,9051,-6,177581,19.617874502872294,107
0.05,9052,66,177647,19.622997901248205,36
0.05,9053,73,177720,19.628893306825713,27
0.05,9054,74,177794,19.63489784649365,27
0.05,9055,85,177879,19.642115724381625,16
0.05,9056,27,177906,19.642928121894666,74
0.05,9057,9,177915,19.64175314638993,92
0.05,9058,-143,177772,19.62379953637267,177
0.05,9059,80,177852,19.63046357615894,20
0.05,9060,31,177883,19.631718353382627,69
0.05,9061,74,177957,19.637717943058927,28
0.05,9062,92,178049,19.645702306079663,8
0.05,9063,90,178139,19.65346425419241,10
0.05,9064,-20,178119,19.649089906232764,121
0.05,9065,85,178204,19.656298257224798,15
0.05,9066,84,178288,19.663394728134996,17
0.05,9067,83,178371,19.67037935597706,17
0.05,9068,65,178436,19.675377660160986,35
0.05,9069,-73,178363,19.6651598676957,181
0.05,9070,87,178450,19.672582956675118,14
0.05,9071,78,178528,19.679012345679013,23
0.05,9072,0,178528,19.676843381461477,102
0.05,9073,76,178604,19.68305047388142,25
0.05,9074,32,178636,19.684407713498622,68
0.05,9075,66,178702,19.68951079770824,34
0.05,9076,-170,178532,19.66861297785612,204
0.05,9077,92,178624,19.676580744657414,9
0.05,9078,31,178655,19.677827954620554,85
0.05,9079,-13,178642,19.67422907488987,114
0.05,9080,-73,178569,19.66402378592666,174
0.05,9081,35,178604,19.665712398150188,66
0.05,9082,59,178663,19.6700429373555,42
0.05,9083,16,178679,19.669638925583442,15
0.05,9084,80,178759,19.676279581728124,20
0.05,9085,48,178807,19.67939687431213,52
0.05,9086,79,178886,19.68592494772752,23
0.05,9087,22,178908,19.686179577464788,79
0.05,9088,90,178998,19.693915722301682,10
0.05,9089,-264,178734,19.662706270627062,378
0.05,9090,44,178778,19.66538334616654,56
0.05,9091,91,178869,19.6732292124945,27
0.05,9092,76,178945,19.679423732541515,25
0.05,9093,33,178978,19.68088849791071,68
0.05,9094,-94,178884,19.668389224848816,126
0.05,9095,92,178976,19.676341248900616,8
0.05,9096,52,179028,19.679894470704628,49
0.05,9097,21,179049,19.680039569136074,82
0.05,9098,72,179121,19.68578964721398,28
0.05,9099,-18,179103,19.681648351648352,118
0.05,9100,-66,179037,19.67223382045929,99
0.05,9101,35,179072,19.673917820259284,67
0.05,9102,81,179153,19.68065472921015,20
0.05,9103,91,179244,19.688488576449913,10
0.05,9104,77,179321,19.694783086216365,23
0.05,9105,89,179410,19.702394025916977,11
0.05,9106,80,179490,19.709015043373228,20
0.05,9107,42,179532,19.711462450592887,59
0.05,9108,83,179615,19.71841036337688,17
0.05,9109,79,179694,19.72491767288694,33
0.05,9110,-86,179608,19.713313576994842,186
0.05,9111,36,179644,19.715100965759436,66
0.05,9112,-401,179243,19.668934489191265,506
0.05,9113,-30,179213,19.663484748738206,62
0.05,9114,47,179260,19.66648381788261,53
0.05,9115,78,179338,19.672882843352347,22
0.05,9116,64,179402,19.67774487221674,36
0.05,9117,80,179482,19.68436060539592,20
0.05,9118,1,179483,19.68231165697993,100
0.05,9119,-7,179476,19.67938596491228,112
0.05,9120,65,179541,19.684354785659465,36
0.05,9121,94,179635,19.692501644376232,6
0.05,9122,85,179720,19.69966019949578,15
0.05,9123,5,179725,19.698049101271373,95
0.05,9124,14,179739,19.697424657534246,87
0.05,9125,71,179810,19.70304624150778,30
0.05,9126,83,179893,19.709981373945435,18
0.05,9127,87,179980,19.71735319894829,14
0.05,9128,82,180062,19.724175703801073,18
0.05,9129,72,180134,19.729901423877326,28
0.05,9130,27,180161,19.730697623480452,99
0.05,9131,-338,179823,19.691524310118265,388
0.05,9132,15,179838,19.691010620825576,86
0.05,9133,94,179932,19.69914604773374,6
0.05,9134,-95,179837,19.686590038314176,197
0.05,9135,-150,179687,19.668016637478107,263
0.05,9136,-140,179547,19.650541753310716,174
0.05,9137,94,179641,19.658678047712847,7
0.05,9138,-88,179553,19.646897910055806,192
0.05,9139,-10,179543,19.643654266958425,42
0.05,9140,74,179617,19.649600700142216,26
0.05,9141,73,179690,19.65543644716692,27
0.05,9142,90,179780,19.663130263589633,11
0.05,9143,76,179856,19.669291338582678,25
0.05,9144,-51,179805,19.66156369600875,153
0.05,9145,-162,179643,19.6417012901815,124
0.05,9146,47,179690,19.64469224882475,53
0.05,9147,-113,179577,19.630192391779623,77
0.05,9148,35,179612,19.6318723357744,68
0.05,9149,18,179630,19.63169398907104,82
0.05,9150,-138,179492,19.61446836411321,241
0.05,9151,32,179524,19.615821678321677,68
0.05,9152,64,179588,19.620670818310938,37
0.05,9153,87,179675,19.628031461656107,14
0.05,9154,-33,179642,19.622282905516112,65
0.05,9155,45,179687,19.625054608999562,56
0.05,9156,63,179750,19.629791416402753,37
0.05,9157,76,179826,19.63594671325617,24
0.05,9158,17,179843,19.635658914728683,83
0.05,9159,-73,179770,19.625545851528383,176
0.05,9160,81,179851,19.632245388058074,20
0.05,9161,8,179859,19.630975769482646,92
0.05,9162,80,179939,19.637564116555712,21
0.05,9163,-73,179866,19.627455259711915,108
0.05,9164,-46,179820,19.620294599018003,149
0.05,9165,94,179914,19.628409338861008,7
0.05,9166,-36,179878,19.622341005781607,138
0.05,9167,51,179929,19.62576352530541,50
0.05,9168,62,179991,19.630384992910894,39
0.05,9169,64,180055,19.635223555070883,37
0.05,9170,90,180145,19.64289608548686,10
0.05,9171,85,180230,19.650021805494983,16
0.05,9172,13,180243,19.64929684944947,87
0.05,9173,66,180309,19.65434924787443,34
0.05,9174,80,180389,19.660926430517712,21
0.05,9175,88,180477,19.668374019180472,19
0.05,9176,-66,180411,19.659038901601832,170
0.05,9177,6,180417,19.65755066463282,113
0.05,9178,-4,180413,19.654973308639285,105
0.05,9179,94,180507,19.663071895424835,7
0.05,9180,-68,180439,19.653523581309226,171
0.05,9181,3,180442,19.651709867131345,98
0.05,9182,88,180530,19.659152782315147,14
0.05,9183,-88,180442,19.64743031358885,189
0.05,9184,-17,180425,19.643440391943386,118
0.05,9185,54,180479,19.647180492053124,46
0.05,9186,32,180511,19.648525089800806,69
0.05,9187,56,180567,19.65248149760557,45
0.05,9188,81,180648,19.659157688540645,19
0.05,9189,31,180679,19.66039173014146,72
0.05,9190,91,180770,19.668153628549668,10
0.05,9191,88,180858,19.675587467362924,12
0.05,9192,-63,180795,19.666594147721092,95
0.05,9193,-11,180784,19.66325864694366,43
0.05,9194,83,180867,19.670146818923328,18
0.05,9195,22,180889,19.67040017398869,78
0.05,9196,75,180964,19.676416222681308,26
0.05,9197,82,181046,19.68319199826049,19
0.05,9198,6,181052,19.681704533101424,25
0.05,9199,28,181080,19.682608695652174,72
0.05,9200,76,181156,19.688729485925442,25
0.05,9201,93,181249,19.69669637035427,7
0.05,9202,82,181331,19.703466261001847,19
0.05,9203,87,181418,19.71077792264233,13
0.05,9204,92,181510,19.718631178707223,8
0.05,9205,-10,181500,19.715402998044752,118
0.05,9206,82,181582,19.7221679157163,19
0.05,9207,-115,181467,19.707536924413553,150
0.05,9208,-70,181397,19.69779563470518,172
0.05,9209,45,181442,19.70054288816504,55
0.05,9210,-124,181318,19.684941917272827,159
0.05,9211,52,181370,19.688449848024316,49
0.05,9212,95,181465,19.69662433517855,6
0.05,9213,-17,181448,19.692641632298677,117
0.05,9214,92,181540,19.700488334237654,9
0.05,9215,-137,181403,19.683485243055557,172
0.05,9216,55,181458,19.68731691439731,46
0.05,9217,74,181532,19.693208939032328,26
0.05,9218,-191,181341,19.670354702245362,230
0.05,9219,13,181354,19.669631236442516,87
0.05,9220,-26,181328,19.664678451361024,58
0.05,9221,-17,181311,19.660702667534157,117
0.05,9222,56,181367,19.66464274097365,45
0.05,9223,-42,181325,19.657957502168255,74
0.05,9224,67,181392,19.66308943089431,33
0.05,9225,-112,181280,19.648818556254064,147
0.05,9226,23,181303,19.64918174921426,9
0.05,9227,-71,181232,19.63935847420893,103
0.05,9228,45,181277,19.642106403727382,55
0.05,9229,70,181347,19.647562296858073,30
0.05,9230,-2,181345,19.64521720290326,103
0.05,9231,73,181418,19.650996533795492,28
0.05,9232,17,181435,19.650709411892127,83
0.05,9233,81,181516,19.657353259692442,19
0.05,9234,94,181610,19.6654033567948,7
0.05,9235,87,181697,19.67269380684279,13
0.05,9236,49,181746,19.675868788567715,52
0.05,9237,14,181760,19.675254384065816,87
0.05,9238,-33,181727,19.66955298192445,90
0.05,9239,-4,181723,19.66699134199134,109
0.05,9240,-117,181606,19.652202142625256,224
0.05,9241,-138,181468,19.63514390824497,239
0.05,9242,64,181532,19.639943741209564,36
0.05,9243,-141,181391,19.62256598874946,256
0.05,9244,-4,181387,19.620010816657654,104
0.05,9245,17,181404,19.61972744970798,85
0.05,9246,80,181484,19.62625716448578,20
0.05,9247,-38,181446,19.620025951557093,144
0.05,9248,71,181517,19.62558114390745,29
0.05,9249,79,181596,19.632,22
0.05,9250,62,181658,19.636579829207655,39
0.05,9251,72,181730,19.64223951578037,29
0.05,9252,70,181800,19.647681832919055,30
0.05,9253,92,181892,19.655500324184136,9
0.05,9254,41,181933,19.657806591031875,59
0.05,9255,-150,181783,19.63947709593777,182
0.05,9256,22,181805,19.63973209463109,81
0.05,9257,40,181845,19.641931302657163,77
0.05,9258,-17,181828,19.637973863268172,117
0.05,9259,91,181919,19.645680345572355,10
0.05,9260,69,181988,19.651009610193285,32
0.05,9261,31,182019,19.652234938458218,71
0.05,9262,53,182072,19.65583504264277,52
0.05,9263,53,182125,19.659434369602764,50
0.05,9264,-179,181946,19.637992444684297,213
0.05,9265,58,182004,19.642132527519966,45
0.05,9266,-14,181990,19.63850221215064,124
0.05,9267,81,182071,19.645123003884333,19
0.05,9268,90,182161,19.65271334556047,11
0.05,9269,81,182242,19.65933117583603,19
0.05,9270,-21,182221,19.654945529069142,122
0.05,9271,-30,182191,19.649590163934427,62
0.05,9272,68,182259,19.654804270462634,32
0.05,9273,84,182343,19.661742505930558,16
0.05,9274,74,182417,19.667601078167117,27
0.05,9275,-7,182410,19.664726175075465,109
0.05,9276,92,182502,19.67252344507923,9
0.05,9277,-160,182342,19.653158008191422,192
0.05,9278,-103,182239,19.63993964866904,203
0.05,9279,43,182282,19.642456896551725,58
0.05,9280,69,182351,19.647775024243078,31
0.05,9281,-70,182281,19.638116785175608,191
0.05,9282,-9,182272,19.635031778519874,40
0.05,9283,92,182364,19.642826367944853,18
0.05,9284,-47,182317,19.63564889606893,149
0.05,9285,-188,182129,19.613288821882403,294
0.05,9286,64,182193,19.618068267470658,37
0.05,9287,13,182206,19.617355727820843,88
0.05,9288,22,182228,19.617612229518787,80
0.05,9289,-22,182206,19.61313240043057,122
0.05,9290,12,182218,19.612312991066624,19
0.05,9291,-29,182189,19.607081360309945,130
0.05,9292,83,182272,19.613902937695038,17
0.05,9293,-1,182271,19.611684958037443,104
0.05,9294,-240,182031,19.58375470683163,274
0.05,9295,86,182117,19.590899311531842,14
0.05,9296,17,182134,19.590620630310852,85
0.05,9297,-9,182125,19.587545708754572,112
0.05,9298,-54,182071,19.57963221851812,160
0.05,9299,-3,182068,19.57720430107527,105
0.05,9300,79,182147,19.58359316202559,21
0.05,9301,42,182189,19.586003010105355,60
0.05,9302,-11,182178,19.582715253144148,114
0.05,9303,60,182238,19.587059329320724,40
0.05,9304,94,182332,19.595056421278883,7
0.05,9305,26,182358,19.595744680851062,76
0.05,9306,83,182441,19.602557214999464,18
0.05,9307,-10,182431,19.599376880103137,113
0.05,9308,84,182515,19.606294983349446,16
0.05,9309,56,182571,19.610204081632652,47
0.05,9310,64,182635,19.614971539039846,37
0.05,9311,-20,182615,19.61071735395189,123
0.05,9312,-32,182583,19.6051755610437,63
0.05,9313,91,182674,19.612840884689714,10
0.05,9314,83,182757,19.61964573268921,18
0.05,9315,30,182787,19.62075998282525,72
0.05,9316,-134,182653,19.604271761296555,96
0.05,9317,-19,182634,19.600128783000645,121
0.05,9318,81,182715,19.606717458954822,20
0.05,9319,83,182798,19.61351931330472,18
0.05,9320,-28,182770,19.608411114687264,59
0.05,9321,59,182829,19.61263677322463,42
0.05,9322,-2,182827,19.610318566984876,104
0.05,9323,60,182887,19.614650364650366,51
0.05,9324,67,182954,19.619731903485256,34
0.05,9325,-22,182932,19.615269140038603,125
0.05,9326,77,183009,19.621421678996462,24
0.05,9327,-19,182990,19.61728130360206,120
0.05,9328,-22,182968,19.61282023796763,54
0.05,9329,-1,182967,19.610610932475883,102
0.05,9330,90,183057,19.61815453863466,11
0.05,9331,93,183150,19.626018002571797,7
0.05,9332,22,183172,19.626272366870246,79
0.05,9333,-68,183104,19.61688450824941,100
0.05,9334,66,183170,19.62185324049277,34
0.05,9335,93,183263,19.62971293916024,7
0.05,9336,17,183280,19.62943129484845,83
0.05,9337,38,183318,19.631398586421074,62
0.05,9338,23,183341,19.631759289003107,77
0.05,9339,28,183369,19.632655246252675,73
0.05,9340,-137,183232,19.615886950005354,238
0.05,9341,81,183313,19.62245771783344,19
0.05,9342,93,183406,19.630311463127477,8
0.05,9343,69,183475,19.635595034246574,32
0.05,9344,-57,183418,19.627394328517923,158
0.05,9345,56,183474,19.631286111705542,45
0.05,9346,77,183551,19.63742377233337,23
0.05,9347,4,183555,19.635750962772786,98
0.05,9348,91,183646,19.643384319178523,9
0.05,9349,85,183731,19.6503743315508,15
0.05,9350,75,183806,19.656293444551384,26
0.05,9351,78,183884,19.662532078699744,23
0.05,9352,70,183954,19.66791403827649,31
0.05,9353,15,183969,19.667415009621553,21
0.05,9354,9,183978,19.66627471940139,92
0.05,9355,33,184011,19.66769987174006,68
0.05,9356,72,184083,19.67329272202629,29
0.05,9357,-31,184052,19.667877751656338,131
0.05,9358,69,184121,19.673148840688107,32
0.05,9359,74,184195,19.67895299145299,27
0.05,9360,90,184285,19.68646512124773,10
0.05,9361,59,184344,19.690664387951294,41
0.05,9362,78,184422,19.69689202178789,23
0.05,9363,-9,184413,19.6938274241777,111
0.05,9364,66,184479,19.698772023491724,34
0.05,9365,32,184511,19.70008541533205,70
0.05,9366,84,184595,19.70694993060745,16
0.05,9367,81,184676,19.713492741246796,20
0.05,9368,-19,184657,19.70936065748746,51
0.05,9369,72,184729,19.714941302027746,28
0.05,9370,0,184729,19.712837477323657,100
0.05,9371,94,184823,19.720763977806232,6
0.05,9372,94,184917,19.728688786941213,7
0.05,9373,17,184934,19.728397695754214,83
0.05,9374,95,185029,19.736426666666667,6
0.05,9375,52,185081,19.73986774744027,49
0.05,9376,-40,185041,19.73349685400448,142
0.05,9377,62,185103,19.738003838771593,38
0.05,9378,69,185172,19.74325621068344,31
0.05,9379,8,185180,19.742004264392325,23
0.05,9380,57,185237,19.74597590875173,45
0.05,9381,-96,185141,19.733638882967384,128
0.05,9382,37,185178,19.735479057870617,64
0.05,9383,68,185246,19.74062233589088,32
0.05,9384,-13,185233,19.737133724027704,45
0.05,9385,48,185281,19.74014489665459,55
0.05,9386,-53,185228,19.732395866624053,154
0.05,9387,35,185263,19.73402215594376,65
0.05,9388,72,185335,19.739588880604963,28
0.05,9389,8,185343,19.738338658146965,93
0.05,9390,-12,185331,19.734959003301032,44
0.05,9391,-141,185190,19.717844974446336,174
0.05,9392,56,185246,19.721707654636432,48
0.05,9393,-13,185233,19.718224398552266,45
0.05,9394,-28,185205,19.713145290047898,128
0.05,9395,77,185282,19.719242230736484,24
0.05,9396,-62,185220,19.71054591891029,169
0.05,9397,85,185305,19.717493083634817,16
0.05,9398,56,185361,19.72135333546122,44
0.05,9399,25,185386,19.721914893617022,78
0.05,9400,88,185474,19.729177747048187,12
0.05,9401,-21,185453,19.72484577749415,124
0.05,9402,13,185466,19.7241305966181,88
0.05,9403,58,185524,19.728200765631644,43
0.05,9404,72,185596,19.733758639021797,29
0.05,9405,80,185676,19.740165851584095,21
0.05,9406,6,185682,19.73870521951738,94
0.05,9407,-152,185530,19.72045068027211,252
0.05,9408,31,185561,19.721649484536083,72
0.05,9409,75,185636,19.72752391073326,25
0.05,9410,79,185715,19.7338221230475,21
0.05,9411,93,185808,19.741606459838504,7
0.05,9412,-37,185771,19.735578455327737,139
0.05,9413,5,185776,19.73401317187168,97
0.05,9414,-16,185760,19.730217737652683,117
0.05,9415,43,185803,19.73268903993203,58
0.05,9416,27,185830,19.733460762450886,73
0.05,9417,-85,185745,19.722340199617754,193
0.05,9418,85,185830,19.729270623208407,15
0.05,9419,65,185895,19.734076433121018,36
0.05,9420,76,185971,19.74004882708842,24
0.05,9421,-180,185791,19.71884950116748,215
0.05,9422,48,185839,19.7218507906187,52
0.05,9423,94,185933,19.72973259762309,6
0.05,9424,37,185970,19.7315649867374,63
0.05,9425,-9,185961,19.72851686823679,42
0.05,9426,-46,185915,19.72154449984088,78
0.05,9427,-73,185842,19.711709800593976,173
0.05,9428,17,185859,19.71142220808145,15
0.05,9429,88,185947,19.7186638388123,12
0.05,9430,84,186031,19.725479800657407,17
0.05,9431,30,186061,19.726569126378287,71
0.05,9432,15,186076,19.726068058942012,86
0.05,9433,31,186107,19.727263090947638,81
0.05,9434,45,186152,19.729941706412294,55
0.05,9435,-12,186140,19.726579058923274,114
0.05,9436,46,186186,19.72936314506729,55
0.05,9437,38,186224,19.731299004026276,73
0.05,9438,49,186273,19.734399830490517,51
0.05,9439,14,186287,19.733792372881357,87
0.05,9440,86,186373,19.74081135472937,14
0.05,9441,-164,186209,19.721351408599872,198
0.05,9442,11,186220,19.72042783013873,98
0.05,9443,70,186290,19.72575180008471,41
0.05,9444,44,186334,19.728321863419797,58
0.05,9445,70,186404,19.733643870421343,31
0.05,9446,11,186415,19.732719381814334,89
0.05,9447,70,186485,19.738039796782388,31
0.05,9448,81,186566,19.744523229971424,19
0.05,9449,5,186571,19.742962962962963,96
0.05,9450,13,186584,19.74224949740768,88
0.05,9451,27,186611,19.743017350825223,76
0.05,9452,7,186618,19.741669311329737,95
0.05,9453,55,186673,19.745398773006134,45
0.05,9454,60,186733,19.749656266525648,42
0.05,9455,84,186817,19.75645093062606,17
0.05,9456,41,186858,19.758697261287935,59
0.05,9457,57,186915,19.762634806513006,43
0.05,9458,90,187005,19.770060260069776,10
0.05,9459,88,187093,19.777272727272727,13
0.05,9460,55,187148,19.78099566642004,46
0.05,9461,48,187196,19.783978017332487,53
0.05,9462,90,187286,19.791398076719855,10
0.05,9463,89,187375,19.798710904480135,12
0.05,9464,-206,187169,19.774854727945062,308
0.05,9465,48,187217,19.777836467356856,53
0.05,9466,-40,187177,19.771522129502483,143
0.05,9467,90,187267,19.778939585973806,10
0.05,9468,89,187356,19.786249867990286,11
0.05,9469,30,187386,19.787328405491024,72
0.05,9470,42,187428,19.789673740893253,59
0.05,9471,0,187428,19.78758445945946,32
0.05,9472,70,187498,19.792885041697456,31
0.05,9473,-11,187487,19.789634789951446,43
0.05,9474,-51,187436,19.7821635883905,85
0.05,9475,45,187481,19.784824820599408,57
0.05,9476,91,187572,19.792339347894902,9
0.05,9477,-65,187507,19.783393120911583,167
0.05,9478,88,187595,19.7905897246545,12
0.05,9479,-59,187536,19.782278481012657,160
0.05,9480,62,187598,19.786731357451746,39
0.05,9481,29,187627,19.7877030162413,73
0.05,9482,-27,187600,19.782769165875777,127
0.05,9483,86,187686,19.789751159848166,15
0.05,9484,56,187742,19.793568792830786,45
0.05,9485,-36,187706,19.787687117857896,68
0.05,9486,90,187796,19.795088015178667,11
0.05,9487,51,187847,19.79837689713322,49
0.05,9488,90,187937,19.805775108019812,11
0.05,9489,25,187962,19.80632244467861,76
0.05,9490,54,188016,19.80992519228743,47
0.05,9491,84,188100,19.81668773704172,17
0.05,9492,49,188149,19.819761929843043,51
0.05,9493,74,188223,19.825468717084476,27
0.05,9494,1,188224,19.823486045286995,99
0.05,9495,-14,188210,19.819924178601518,117
0.05,9496,-55,188155,19.812045909234495,155
0.05,9497,84,188239,19.818803958728154,17
0.05,9498,83,188322,19.825455311085378,17
0.05,9499,54,188376,19.829052631578946,46
0.05,9500,-84,188292,19.818124407957058,48
0.05,9501,79,188371,19.82435276783835,22
0.05,9502,-3,188368,19.821950962853837,103
0.05,9503,-11,188357,19.818707912457914,43
0.05,9504,40,188397,19.82083114150447,61
0.05,9505,92,188489,19.82842415316642,8
0.05,9506,80,188569,19.83475333964447,20
0.05,9507,84,188653,19.841501893142617,16
0.05,9508,45,188698,19.844147649595122,56
0.05,9509,-134,188564,19.827970557308095,190
0.05,9510,88,188652,19.835138260960992,12
0.05,9511,-17,188635,19.831265769554246,48
0.05,9512,73,188708,19.836854830232312,27
0.05,9513,85,188793,19.84370401513559,16
0.05,9514,59,188852,19.847819232790332,41
0.05,9515,35,188887,19.849411517444306,66
0.05,9516,-12,188875,19.846064936429546,112
0.05,9517,-168,188707,19.826329060727044,130
0.05,9518,69,188776,19.831494904926988,31
0.05,9519,-64,188712,19.82268907563025,169
0.05,9520,57,188769,19.82659384518433,44
0.05,9521,26,188795,19.827242176013442,6
0.05,9522,91,188886,19.834715950855824,10
0.05,9523,-58,188828,19.826543469130616,165
0.05,9524,86,188914,19.833490813648293,14
0.05,9525,93,189007,19.841171530547975,7
0.05,9526,45,189052,19.843812322871837,58
0.05,9527,67,189119,19.848761544920237,34
0.05,9528,77,189196,19.85475915625984,24
0.05,9529,72,189268,19.860230849947534,28
0.05,9530,47,189315,19.86307837582625,55
0.05,9531,80,189395,19.869387326898867,21
0.05,9532,24,189419,19.86982062309871,78
0.05,9533,-109,189310,19.856303754982168,210
0.05,9534,69,189379,19.861457787100157,37
0.05,9535,32,189411,19.862730704697988,68
0.05,9536,1,189412,19.86075285729265,101
0.05,9537,-5,189407,19.85814636192074,105
0.05,9538,92,189499,19.865709193835833,9
0.05,9539,70,189569,19.870964360587003,30
0.05,9540,39,189608,19.872969290430774,62
0.05,9541,54,189662,19.876545797526724,50
0.05,9542,-48,189614,19.869433092318978,152
0.05,9543,-60,189554,19.86106454316848,165
0.05,9544,-44,189510,19.854374017810372,154
0.05,9545,28,189538,19.855227320343598,75
0.05,9546,53,189591,19.85869906776998,47
0.05,9547,-15,189576,19.855048177628824,117
0.05,9548,57,189633,19.858938108702482,43
0.05,9549,-67,189566,19.84984293193717,100
0.05,9550,-3,189563,19.847450528740445,105
0.05,9551,28,189591,19.848304020100503,73
0.05,9552,-45,189546,19.841515754213336,147
0.05,9553,62,189608,19.84592840694997,39
0.05,9554,-18,189590,19.84196755625327,132
0.05,9555,-16,189574,19.83821682712432,48
0.05,9556,82,189656,19.84472114680339,19
0.05,9557,-70,189586,19.835321196903116,175
0.05,9558,85,189671,19.84213829898525,16
0.05,9559,82,189753,19.848640167364017,19
0.05,9560,26,189779,19.84928354774605,75
0.05,9561,93,189872,19.856933695879523,8
0.05,9562,-202,189670,19.833734183833524,235
0.05,9563,-11,189659,19.830510246758678,112
0.05,9564,91,189750,19.8379508625196,10
0.05,9565,43,189793,19.840372151369433,58
0.05,9566,-13,189780,19.836939479460646,44
0.05,9567,76,189856,19.842809364548494,25
0.05,9568,-162,189694,19.823806040338592,197
0.05,9569,69,189763,19.82894461859979,31
0.05,9570,45,189808,19.831574548114094,58
0.05,9571,84,189892,19.83827831174258,17
0.05,9572,56,189948,19.842055781886557,45
0.05,9573,66,190014,19.84687695842908,34
0.05,9574,22,190036,19.84710182767624,78
0.05,9575,81,190117,19.853487886382624,19
0.05,9576,-65,190052,19.844627753993944,97
0.05,9577,88,190140,19.85174357903529,13
0.05,9578,-109,190031,19.83829209729617,143
0.05,9579,49,190080,19.84133611691023,51
0.05,9580,9,190089,19.840204571547854,94
0.05,9581,-112,189977,19.82644541849301,145
0.05,9582,-36,189941,19.820619847646874,138
0.05,9583,-21,189920,19.81636060100167,124
0.05,9584,84,190004,19.823056859676576,16
0.05,9585,91,190095,19.830481952847904,9
0.05,9586,94,190189,19.838218420778137,7
0.05,9587,83,190272,19.844806007509387,17
0.05,9588,86,190358,19.851705078736053,15
0.05,9589,-125,190233,19.83660062565172,158
0.05,9590,-397,189836,19.79313940152226,364
0.05,9591,89,189925,19.80035446205171,12
0.05,9592,-67,189858,19.79130616074221,169
0.05,9593,93,189951,19.798936835522202,7
0.05,9594,52,190003,19.802292860865034,48
0.05,9595,92,190095,19.809816590245937,10
0.05,9596,74,190169,19.815463165572574,26
0.05,9597,61,190230,19.819754115440716,39
0.05,9598,91,190321,19.827169496822584,9
0.05,9599,34,190355,19.828645833333333,67
0.05,9600,22,190377,19.82887199250078,79
0.05,9601,72,190449,19.834305353051448,28
0.05,9602,18,190467,19.83411433926898,82
0.05,9603,-13,190454,19.830695543523532,114
0.05,9604,93,190547,19.838313378448724,7
0.05,9605,15,190562,19.837809702269414,86
0.05,9606,39,190601,19.83980430935776,64
0.05,9607,-32,190569,19.83440882597835,132
0.05,9608,-170,190399,19.81465292954522,272
0.05,9609,20,190419,19.814672216441206,81
0.05,9610,54,190473,19.81822911247529,46
0.05,9611,-117,190356,19.803995006242197,224
0.05,9612,88,190444,19.811089150109225,13
0.05,9613,-122,190322,19.79633867276888,224
0.05,9614,57,190379,19.800208008320332,44
0.05,9615,48,190427,19.803140599001665,53
0.05,9616,58,190485,19.80711240511594,43
0.05,9617,77,190562,19.813058847993346,24
0.05,9618,92,190654,19.82056346813598,8
0.05,9619,49,190703,19.823596673596672,52
0.05,9620,93,190796,19.831202577694626,7
0.05,9621,74,190870,19.83683225940553,26
0.05,9622,79,190949,19.84298035955523,22
0.05,9623,86,191035,19.849854530340814,14
0.05,9624,-69,190966,19.840623376623377,100
0.05,9625,90,191056,19.8479119052566,10
0.05,9626,-23,191033,19.843461098992417,125
0.05,9627,86,191119,19.850332363938513,15
0.05,9628,-6,191113,19.84764773081317,108
0.05,9629,1,191114,19.845690550363447,100
0.05,9630,49,191163,19.848717682483645,51
0.05,9631,85,191248,19.85548172757475,16
0.05,9632,71,191319,19.860791030831518,29
0.05,9633,37,191356,19.862570064355406,65
0.05,9634,-20,191336,19.85843279709393,121
0.05,9635,56,191392,19.862183478621834,45
0.05,9636,-55,191337,19.85441527446301,156
0.05,9637,62,191399,19.858788130317492,38
0.05,9638,63,191462,19.863263824048136,37
0.05,9639,80,191542,19.869502074688796,21
0.05,9640,85,191627,19.876257649621408,15
0.05,9641,-134,191493,19.860298693217175,166
0.05,9642,66,191559,19.86508348024474,34
0.05,9643,18,191577,19.86489008710079,83
0.05,9644,13,191590,19.864178330741318,18
0.05,9645,-66,191524,19.855276798673025,98
0.05,9646,24,191548,19.855706437234375,76
0.05,9647,93,191641,19.863287728026535,7
0.05,9648,40,191681,19.865374650222822,60
0.05,9649,93,191774,19.87295336787565,7
0.05,9650,-47,191727,19.866024246192104,79
0.05,9651,-265,191462,19.836510567757976,370
0.05,9652,74,191536,19.842121620221693,27
0.05,9653,-84,191452,19.831365237207375,186
0.05,9654,-16,191436,19.827654065251163,117
0.05,9655,91,191527,19.835024855012428,10
0.05,9656,71,191598,19.84032308170239,30
0.05,9657,-59,191539,19.832159867467386,162
0.05,9658,90,191629,19.839424371052903,11
0.05,9659,-103,191526,19.82670807453416,135
0.05,9660,-80,191446,19.816375116447574,184
0.05,9661,90,191536,19.82363899813703,11
0.05,9662,73,191609,19.82914208837835,27
0.05,9663,-13,191596,19.825745033112582,116
0.05,9664,85,191681,19.83248836006208,16
0.05,9665,15,191696,19.831988412994,88
0.05,9666,45,191741,19.83459191062377,55
0.05,9667,84,191825,19.841228796028133,17
0.05,9668,79,191904,19.84734719205709,21
0.05,9669,23,191927,19.847673216132367,78
0.05,9670,88,192015,19.854720297797538,12
0.05,9671,40,192055,19.856803143093465,60
0.05,9672,95,192150,19.864571487646025,6
0.05,9673,45,192195,19.86716973330577,56
0.05,9674,48,192243,19.870077519379844,53
0.05,9675,23,192266,19.870400992145516,78
0.05,9676,-3,192263,19.868037614963313,105
0.05,9677,24,192287,19.86846455879314,78
0.05,9678,84,192371,19.875090401901023,16
0.05,9679,93,192464,19.882644628099175,7
0.05,9680,18,192482,19.882450160107428,85
0.05,9681,54,192536,19.885973972319768,47
0.05,9682,59,192595,19.890013425591242,41
0.05,9683,94,192689,19.897666253614208,6
0.05,9684,28,192717,19.898502839442436,73
0.05,9685,51,192768,19.901713813751808,49
0.05,9686,72,192840,19.907091978940848,29
0.05,9687,27,192867,19.90782411230388,73
0.05,9688,45,192912,19.910413871400557,57
0.05,9689,-57,192855,19.902476780185758,161
0.05,9690,-68,192787,19.89340625322464,175
0.05,9691,-124,192663,19.87855963681387,176
0.05,9692,64,192727,19.883111523780048,36
0.05,9693,-6,192721,19.880441510212503,108
0.05,9694,-189,192532,19.858896338318722,224
0.05,9695,60,192592,19.863036303630363,41
0.05,9696,87,192679,19.869959781375684,13
0.05,9697,69,192748,19.875025778511034,32
0.05,9698,73,192821,19.88050314465409,28
0.05,9699,50,192871,19.883608247422682,51
0.05,9700,16,192887,19.88320791670962,86
0.05,9701,77,192964,19.889095031952174,23
0.05,9702,77,193041,19.894980933731837,23
0.05,9703,84,193125,19.90158697444353,17
0.05,9704,22,193147,19.901803194229778,79
0.05,9705,20,193167,19.901813311353802,83
0.05,9706,43,193210,19.904192850520243,57
0.05,9707,-120,193090,19.88978162340338,238
0.05,9708,-61,193029,19.881450200844576,164
0.05,9709,47,193076,19.884243048403707,55
0.05,9710,34,193110,19.885696632684585,66
0.05,9711,-108,193002,19.872528830313016,142
0.05,9712,38,193040,19.874395140533306,62
0.05,9713,-300,192740,19.841465925468395,268
0.05,9714,-132,192608,19.82583633556356,166
0.05,9715,79,192687,19.831926718814326,21
0.05,9716,-175,192512,19.81187609344448,212
0.05,9717,86,192598,19.818686972628115,14
0.05,9718,31,192629,19.81983743183455,69
0.05,9719,73,192702,19.825308641975308,28
0.05,9720,37,192739,19.827075403765043,65
0.05,9721,-8,192731,19.824213124871427,110
0.05,9722,75,192806,19.82988789468271,25
0.05,9723,-171,192635,19.81026326614562,276
0.05,9724,57,192692,19.814087403598972,44
0.05,9725,93,192785,19.82161217355542,8
0.05,9726,-7,192778,19.818854734244887,108
0.05,9727,83,192861,19.82534950657895,18
0.05,9728,69,192930,19.83040394696269,32
0.05,9729,71,193001,19.835662898252828,30
0.05,9730,72,193073,19.841023533038744,28
0.05,9731,-39,193034,19.834977394163584,71
0.05,9732,57,193091,19.838795849172918,44
0.05,9733,65,193156,19.843435381138278,36
0.05,9734,-61,193095,19.83513097072419,99
0.05,9735,94,193189,19.842748562037798,7
0.05,9736,-27,193162,19.837937763171407,127
0.05,9737,84,193246,19.844526596837134,17
0.05,9738,69,193315,19.849573878221584,34
0.05,9739,-73,193242,19.840041067761806,176
0.05,9740,-99,193143,19.827841084077612,202
0.05,9741,75,193218,19.833504413878053,25
0.05,9742,-32,193186,19.828184337473058,64
0.05,9743,16,193202,19.82779146141215,84
0.05,9744,1,193203,19.825859415084658,99
0.05,9745,82,193285,19.83223886722758,19
0.05,9746,40,193325,19.834307992202728,62
0.05,9747,84,193409,19.840890439064424,16
0.05,9748,36,193445,19.84254795363627,64
0.05,9749,-23,193422,19.838153846153848,54
0.05,9750,-60,193362,19.829966157317198,166
0.05,9751,15,193377,19.829470877768664,86
0.05,9752,56,193433,19.833179534502204,44
0.05,9753,18,193451,19.832991593192535,83
0.05,9754,-10,193441,19.829933367503845,115
0.05,9755,23,193464,19.830258302583026,83
0.05,9756,53,193517,19.833657886645486,48
0.05,9757,-159,193358,19.81533101045296,124
0.05,9758,91,193449,19.822625268982478,10
0.05,9759,63,193512,19.82704918032787,37
0.05,9760,-23,193489,19.822661612539697,124
0.05,9761,44,193533,19.825138291333744,56
0.05,9762,71,193604,19.830380006145653,29
0.05,9763,17,193621,19.83009012699713,84
0.05,9764,15,193636,19.829595494111622,85
0.05,9765,79,193715,19.835654310874464,21
0.05,9766,-35,193680,19.830039930377804,137
0.05,9767,39,193719,19.832002457002456,62
0.05,9768,22,193741,19.83222438325315,78
0.05,9769,92,193833,19.839611054247698,8
0.05,9770,21,193854,19.839729812711084,81
0.05,9771,42,193896,19.841997544003274,59
0.05,9772,92,193988,19.849380947508443,8
0.05,9773,12,194000,19.848577859627582,90
0.05,9774,5,194005,19.847058823529412,95
0.05,9775,-2,194003,19.844824058919805,34
0.05,9776,7,194010,19.843510279226756,95
0.05,9777,75,194085,19.84915115565555,26
0.05,9778,61,194146,19.853359239186013,40
0.05,9779,-29,194117,19.84836400817996,61
0.05,9780,-43,194074,19.84193845210101,143
0.05,9781,80,194154,19.84808832549581,20
0.05,9782,5,194159,19.84657058162118,27
0.05,9783,-38,194121,19.840658217497957,142
0.05,9784,71,194192,19.84588656106285,30
0.05,9785,94,194286,19.85346413243409,6
0.05,9786,15,194301,19.852968223153162,17
0.05,9787,-236,194065,19.826828769922354,271
0.05,9788,-162,193903,19.808254162835837,265
0.05,9789,89,193992,19.81532175689479,12
0.05,9790,29,194021,19.81625983045654,74
0.05,9791,30,194051,19.817299836601308,83
0.05,9792,55,194106,19.820892474216276,45
0.05,9793,-5,194101,19.81835817847662,108
0.05,9794,85,194186,19.825012761613067,15
0.05,9795,-203,193983,19.80226623111474,238
0.05,9796,5,193988,19.800755333265286,26
0.05,9797,68,194056,19.805674627474996,33
0.05,9798,66,194122,19.810388815185224,35
0.05,9799,-54,194068,19.802857142857142,157
0.05,9800,-56,194012,19.7951229466381,157
0.05,9801,-141,193871,19.778718628851255,244
0.05,9802,92,193963,19.786085892073856,13
0.05,9803,-19,193944,19.782129742962056,51
0.05,9804,59,194003,19.786129525752166,41
0.05,9805,47,194050,19.788904752192536,53
0.05,9806,56,194106,19.792597124502905,44
0.05,9807,87,194193,19.79944942903752,14
0.05,9808,95,194288,19.807115913956572,6
0.05,9809,-71,194217,19.797859327217125,172
0.05,9810,94,194311,19.805422484965856,7
0.05,9811,83,194394,19.81186302486751,17
0.05,9812,69,194463,19.8168755732192,32
0.05,9813,74,194537,19.822396576319544,27
0.05,9814,-40,194497,19.816301579215487,73
0.05,9815,80,194577,19.822432762836186,21
0.05,9816,87,194664,19.82927574615463,13
0.05,9817,-261,194403,19.800672234671012,366
0.05,9818,48,194451,19.803544149098688,52
0.05,9819,66,194517,19.808248472505092,35
0.05,9820,16,194533,19.807860706649016,90
0.05,9821,-114,194419,19.79423742618611,78
0.05,9822,62,194481,19.79853405273338,46
0.05,9823,90,194571,19.80567996742671,10
0.05,9824,86,194657,19.81241730279898,14
0.05,9825,59,194716,19.81640545491553,41
0.05,9826,-146,194570,19.79953190190292,181
0.05,9827,47,194617,19.80229955229955,54
0.05,9828,94,194711,19.809848407772918,6
0.05,9829,85,194796,19.81648016276704,15
0.05,9830,-38,194758,19.810599125216154,140
0.05,9831,59,194817,19.814585028478437,41
0.05,9832,-67,194750,19.80575612732635,98
0.05,9833,6,194756,19.804352247305268,25
0.05,9834,57,194813,19.80813421453991,43
0.05,9835,84,194897,19.81466043106954,17
0.05,9836,43,194940,19.81701738334858,58
0.05,9837,85,195025,19.823643016873348,16
0.05,9838,-50,194975,19.816546396991566,83
0.05,9839,25,195000,19.817073170731707,78
0.05,9840,74,195074,19.822579006198556,26
0.05,9841,87,195161,19.829404592562486,13
0.05,9842,80,195241,19.835517626739815,21
0.05,9843,75,195316,19.8411214953271,25
0.05,9844,-50,195266,19.834027425088877,81
0.05,9845,88,195354,19.840950639853748,13
0.05,9846,-15,195339,19.83741240987103,117
0.05,9847,79,195418,19.843419983753048,21
0.05,9848,71,195489,19.84861407249467,30
0.05,9849,69,195558,19.853604060913707,32
0.05,9850,71,195629,19.858796061313573,30
0.05,9851,51,195680,19.86195696305319,49
0.05,9852,-96,195584,19.850197909266214,214
0.05,9853,-214,195370,19.826466409579865,323
0.05,9854,-27,195343,19.821714865550483,128
0.05,9855,64,195407,19.82619724025974,37
0.05,9856,72,195479,19.831490311453788,28
0.05,9857,4,195483,19.829884357881923,98
0.05,9858,47,195530,19.83264022720357,54
0.05,9859,77,195607,19.838438133874238,23
0.05,9860,2,195609,19.83662914511713,30
0.05,9861,-12,195597,19.833400932873655,43
0.05,9862,-5,195592,19.830883098448748,36
0.05,9863,91,195683,19.838098134630982,10
0.05,9864,23,195706,19.83841865179929,79
0.05,9865,68,195774,19.843300222988038,33
0.05,9866,80,195854,19.849396979831763,21
0.05,9867,-22,195832,19.845156059991893,53
0.05,9868,71,195903,19.850339446752457,30
0.05,9869,15,195918,19.84984802431611,16
0.05,9870,41,195959,19.85199067976902,60
0.05,9871,70,196029,19.857070502431117,30
0.05,9872,87,196116,19.863871163780008,13
0.05,9873,74,196190,19.869353858618595,26
0.05,9874,58,196248,19.873215189873417,43
0.05,9875,70,196318,19.87829080599433,30
0.05,9876,58,196376,19.882150450541662,43
0.05,9877,-306,196070,19.849159748937033,341
0.05,9878,53,196123,19.8525154367851,48
0.05,9879,73,196196,19.857894736842105,28
0.05,9880,26,196222,19.858516344499545,81
0.05,9881,37,196259,19.86025096134386,65
0.05,9882,7,196266,19.858949711626025,25
0.05,9883,0,196266,19.856940509915013,101
0.05,9884,87,196353,19.863732928679816,14
0.05,9885,59,196412,19.867691685211412,42
0.05,9886,90,196502,19.874785071305755,10
0.05,9887,12,196514,19.87398867313916,90
0.05,9888,85,196599,19.880574375568813,16
0.05,9889,59,196658,19.8845298281092,42
0.05,9890,90,196748,19.891618643211,11
0.05,9891,88,196836,19.898503841488072,12
0.05,9892,-132,196704,19.88314970180936,236
0.05,9893,34,196738,19.88457651101678,67
0.05,9894,69,196807,19.88954017180394,31
0.05,9895,93,196900,19.896928051738076,7
0.05,9896,-26,196874,19.892290593109024,129
0.05,9897,81,196955,19.89846433622954,19
0.05,9898,7,196962,19.897161329427213,25
0.05,9899,87,197049,19.903939393939392,13
0.05,9900,67,197116,19.90869609130391,43
0.05,9901,84,197200,19.915168652797416,17
0.05,9902,20,197220,19.91517721902454,81
0.05,9903,68,197288,19.920032310177707,34
0.05,9904,85,197373,19.92660272589601,15
0.05,9905,88,197461,19.93347466182112,12
0.05,9906,66,197527,19.938124558393056,34
0.05,9907,-146,197381,19.921376665320953,180
0.05,9908,66,197447,19.926026844282976,35
0.05,9909,-58,197389,19.918163471241172,91
0.05,9910,19,197408,19.918070830390477,82
0.05,9911,64,197472,19.922518159806295,37
0.05,9912,81,197553,19.928679511752243,20
0.05,9913,57,197610,19.932418801694574,43
0.05,9914,7,197617,19.931114473020674,94
0.05,9915,64,197681,19.93555869302138,36
0.05,9916,-6,197675,19.932943430472925,107
0.05,9917,39,197714,19.93486590038314,61
0.05,9918,-98,197616,19.922976106462347,130
0.05,9919,88,197704,19.92983870967742,12
0.05,9920,65,197769,19.934381614756578,36
0.05,9921,-55,197714,19.926829268292682,157
0.05,9922,90,197804,19.933890960395043,11
0.05,9923,-97,197707,19.92210802095929,200
0.05,9924,94,197801,19.9295717884131,7
0.05,9925,32,197833,19.93078782994157,70
0.05,9926,21,197854,19.93089553742319,11
0.05,9927,-87,197767,19.92012489927478,190
0.05,9928,-217,197550,19.896263470641554,333
0.05,9929,68,197618,19.90110775427996,33
0.05,9930,63,197681,19.90544758835968,37
0.05,9931,-44,197637,19.899013290374548,148
0.05,9932,93,197730,19.90637269707037,7
0.05,9933,63,197793,19.910710690557682,37
0.05,9934,13,197806,19.910015098137897,90
0.05,9935,4,197810,19.90841384863124,60
0.05,9936,90,197900,19.915467444902887,11
0.05,9937,-90,197810,19.90440732541759,191
0.05,9938,40,197850,19.90642921823121,61
0.05,9939,59,197909,19.91036217303823,42
0.05,9940,29,197938,19.911276531536064,73
0.05,9941,60,197998,19.91530879098773,41
0.05,9942,-5,197993,19.91280297696872,55
0.05,9943,27,198020,19.91351568785197,76
0.05,9944,92,198112,19.920764203117145,9
0.05,9945,49,198161,19.923687914739595,52
0.05,9946,8,198169,19.922489192721425,93
0.05,9947,42,198211,19.92470848411741,59
0.05,9948,-125,198086,19.91014172278621,227
0.05,9949,73,198159,19.915477386934672,27
0.05,9950,82,198241,19.921716410411015,19
0.05,9951,70,198311,19.92674839228296,30
0.05,9952,-136,198175,19.911082085803276,100
0.05,9953,61,198236,19.915209965842877,40
0.05,9954,89,198325,19.92214967353089,11
0.05,9955,19,198344,19.922057051024506,22
0.05,9956,76,198420,19.927689062970774,24
0.05,9957,29,198449,19.928600120506125,71
0.05,9958,-99,198350,19.916658299026007,132
0.05,9959,20,198370,19.916666666666668,11
0.05,9960,54,198424,19.92008834454372,47
0.05,9961,93,198517,19.927424212005622,8
0.05,9962,81,198598,19.93355415035632,20
0.05,9963,54,198652,19.936973103171418,46
0.05,9964,43,198695,19.939287506271953,58
0.05,9965,51,198746,19.942404174192255,49
0.05,9966,55,198801,19.945921541085582,45
0.05,9967,41,198842,19.948033707865168,61
0.05,9968,83,198925,19.954358511385294,18
0.05,9969,65,198990,19.95887662988967,36
0.05,9970,53,199043,19.962190352020862,48
0.05,9971,71,199114,19.967308463698355,29
0.05,9972,72,199186,19.972525819713226,28
0.05,9973,0,199186,19.970523360737918,103
0.05,9974,61,199247,19.974636591478696,40
0.05,9975,24,199271,19.975040096230956,76
0.05,9976,46,199317,19.97764859176105,73
0.05,9977,93,199410,19.984966927239928,8
0.05,9978,82,199492,19.99118148111033,18
0.05,9979,70,199562,19.99619238476954,33
0.05,9980,74,199636,20.001603045786997,26
0.05,9981,87,199723,20.008314966940492,14
0.05,9982,-171,199552,19.98918160873485,209
0.05,9983,89,199641,19.99609375,12
0.05,9984,-36,199605,19.99048572859289,138
0.05,9985,70,199675,19.995493691167635,30
0.05,9986,53,199728,19.99879843796936,47
0.05,9987,63,199791,20.003103724469362,37
0.05,9988,-219,199572,19.979177094804285,255
0.05,9989,92,199664,19.986386386386386,9
0.05,9990,6,199670,19.984986487839056,96
0.05,9991,82,199752,19.99119295436349,18
0.05,9992,24,199776,19.991594115881117,76
0.05,9993,-102,199674,19.97938763257955,133
0.05,9994,23,199697,19.97968984492246,9
0.05,9995,-40,199657,19.973689475790316,73
0.05,9996,-164,199493,19.95528658597579,196
0.05,9997,76,199569,19.96089217843569,24
0.05,9998,38,199607,19.962696269626964,62
0.05,9999,85,199692,19.9692,15
