0.05,0,-262,-262,-262.0,207
0.05,1,19,-243,-121.5,73
0.05,2,-76,-319,-106.33333333333333,148
0.05,3,84,-235,-58.75,55
0.05,4,-59,-294,-58.8,118
0.05,5,95,-199,-33.166666666666664,6
0.05,6,65,-134,-19.142857142857142,158
0.05,7,23,-111,-13.875,24
0.05,8,95,-16,-1.7777777777777777,6
0.05,9,95,79,7.9,6
0.05,10,70,149,13.545454545454545,55
0.05,11,94,243,20.25,7
0.05,12,0,243,18.692307692307693,168
0.05,13,78,321,22.928571428571427,108
0.05,14,94,415,27.666666666666668,7
0.05,15,95,510,31.875,6
0.05,16,94,604,35.529411764705884,12
0.05,17,90,694,38.55555555555556,40
0.05,18,92,786,41.36842105263158,9
0.05,19,94,880,44.0,7
0.05,20,94,974,46.38095238095238,7
0.05,21,94,1068,48.54545454545455,7
0.05,22,91,1159,50.391304347826086,10
0.05,23,88,1247,51.958333333333336,53
0.05,24,94,1341,53.64,7
0.05,25,83,1424,54.76923076923077,109
0.05,26,94,1518,56.22222222222222,7
0.05,27,94,1612,57.57142857142857,7
0.05,28,92,1704,58.758620689655174,9
0.05,29,94,1798,59.93333333333333,7
0.05,30,24,1822,58.774193548387096,36
0.05,31,91,1913,59.78125,35
0.05,32,93,2006,60.78787878787879,8
0.05,33,93,2099,61.73529411764706,8
0.05,34,94,2193,62.65714285714286,7
0.05,35,94,2287,63.52777777777778,7
0.05,36,94,2381,64.35135135135135,7
0.05,37,91,2472,65.05263157894737,20
0.05,38,92,2564,65.74358974358974,18
0.05,39,95,2659,66.475,6
0.05,40,92,2751,67.09756097560975,9
0.05,41,94,2845,67.73809523809524,23
0.05,42,90,2935,68.25581395348837,12
0.05,43,89,3024,68.72727272727273,12
0.05,44,89,3113,69.17777777777778,12
0.05,45,94,3207,69.71739130434783,8
0.05,46,94,3301,70.23404255319149,7
0.05,47,94,3395,70.72916666666667,7
0.05,48,95,3490,71.22448979591837,6
0.05,49,87,3577,71.54,18
0.05,50,27,3604,70.66666666666667,6
0.05,51,95,3699,71.13461538461539,6
0.05,52,95,3794,71.58490566037736,6
0.05,53,88,3882,71.88888888888889,18
0.05,54,93,3975,72.27272727272727,8
0.05,55,94,4069,72.66071428571429,7
0.05,56,93,4162,73.01754385964912,8
0.05,57,83,4245,73.1896551724138,23
0.05,58,92,4337,73.50847457627118,9
0.05,59,91,4428,73.8,11
0.05,60,91,4519,74.08196721311475,11
0.05,61,95,4614,74.41935483870968,6
0.05,62,94,4708,74.73015873015873,7
0.05,63,95,4803,75.046875,6
0.05,64,94,4897,75.33846153846154,7
0.05,65,94,4991,75.62121212121212,8
0.05,66,92,5083,75.86567164179104,9
0.05,67,94,5177,76.13235294117646,7
0.05,68,93,5270,76.3768115942029,8
0.05,69,91,5361,76.58571428571429,11
0.05,70,94,5455,76.83098591549296,7
0.05,71,93,5548,77.05555555555556,10
0.05,72,94,5642,77.28767123287672,7
0.05,73,94,5736,77.51351351351352,8
0.05,74,94,5830,77.73333333333333,7
0.05,75,94,5924,77.94736842105263,7
0.05,76,92,6016,78.12987012987013,9
0.05,77,95,6111,78.34615384615384,6
0.05,78,94,6205,78.54430379746836,8
0.05,79,93,6298,78.725,8
0.05,80,93,6391,78.90123456790124,9
0.05,81,92,6483,79.0609756097561,9
0.05,82,93,6576,79.2289156626506,8
0.05,83,94,6670,79.4047619047619,7
0.05,84,92,6762,79.55294117647058,9
0.05,85,94,6856,79.72093023255815,7
0.05,86,92,6948,79.86206896551724,9
0.05,87,91,7039,79.98863636363636,10
0.05,88,93,7132,80.13483146067416,8
0.05,89,93,7225,80.27777777777777,8
0.05,90,94,7319,80.42857142857143,7
0.05,91,94,7413,80.57608695652173,8
0.05,92,94,7507,80.72043010752688,8
0.05,93,25,7532,80.12765957446808,9
0.05,94,93,7625,80.26315789473684,9
0.05,95,91,7716,80.375,11
0.05,96,95,7811,80.52577319587628,6
0.05,97,89,7900,80.61224489795919,12
0.05,98,90,7990,80.70707070707071,11
0.05,99,90,8080,80.8,12
0.05,100,92,8172,80.91089108910892,9
0.05,101,94,8266,81.03921568627452,7
0.05,102,88,8354,81.10679611650485,14
0.05,103,94,8448,81.23076923076923,8
0.05,104,94,8542,81.35238095238095,7
0.05,105,95,8637,81.48113207547169,6
0.05,106,91,8728,81.57009345794393,10
0.05,107,92,8820,81.66666666666667,10
0.05,108,94,8914,81.77981651376147,7
0.05,109,95,9009,81.9,6
0.05,110,93,9102,82.0,10
0.05,111,82,9184,82.0,25
0.05,112,94,9278,82.10619469026548,8
0.05,113,93,9371,82.20175438596492,9
0.05,114,94,9465,82.30434782608695,7
0.05,115,23,9488,81.79310344827586,9
0.05,116,94,9582,81.8974358974359,8
0.05,117,94,9676,82.0,7
0.05,118,94,9770,82.10084033613445,8
0.05,119,94,9864,82.2,8
0.05,120,94,9958,82.29752066115702,7
0.05,121,91,10049,82.3688524590164,11
0.05,122,95,10144,82.47154471544715,6
0.05,123,94,10238,82.56451612903226,8
0.05,124,95,10333,82.664,6
0.05,125,95,10428,82.76190476190476,6
0.05,126,95,10523,82.85826771653544,6
0.05,127,93,10616,82.9375,8
0.05,128,95,10711,83.03100775193798,6
0.05,129,93,10804,83.1076923076923,11
0.05,130,92,10896,83.17557251908397,9
0.05,131,94,10990,83.25757575757575,7
0.05,132,93,11083,83.33082706766918,10
0.05,133,94,11177,83.41044776119404,7
0.05,134,90,11267,83.45925925925926,11
0.05,135,91,11358,83.51470588235294,10
0.05,136,95,11453,83.5985401459854,6
0.05,137,93,11546,83.66666666666667,10
0.05,138,92,11638,83.72661870503597,9
0.05,139,90,11728,83.77142857142857,11
0.05,140,93,11821,83.83687943262412,9
0.05,141,92,11913,83.8943661971831,11
0.05,142,92,12005,83.95104895104895,9
0.05,143,91,12096,84.0,12
0.05,144,93,12189,84.06206896551724,8
0.05,145,92,12281,84.11643835616438,9
0.05,146,93,12374,84.17687074829932,10
0.05,147,92,12466,84.22972972972973,9
0.05,148,89,12555,84.26174496644295,16
0.05,149,90,12645,84.3,11
0.05,150,94,12739,84.36423841059603,7
0.05,151,94,12833,84.42763157894737,7
0.05,152,93,12926,84.48366013071896,8
0.05,153,94,13020,84.54545454545455,7
0.05,154,94,13114,84.60645161290323,7
0.05,155,92,13206,84.65384615384616,10
0.05,156,90,13296,84.68789808917198,11
0.05,157,94,13390,84.74683544303798,7
0.05,158,94,13484,84.80503144654088,8
0.05,159,93,13577,84.85625,8
0.05,160,94,13671,84.91304347826087,7
0.05,161,93,13764,84.96296296296296,9
0.05,162,94,13858,85.01840490797547,7
0.05,163,93,13951,85.0670731707317,9
0.05,164,94,14045,85.12121212121212,9
0.05,165,95,14140,85.18072289156626,6
0.05,166,94,14234,85.23353293413173,7
0.05,167,85,14319,85.23214285714286,18
0.05,168,94,14413,85.28402366863905,7
0.05,169,91,14504,85.31764705882352,11
0.05,170,94,14598,85.36842105263158,7
0.05,171,94,14692,85.4186046511628,7
0.05,172,92,14784,85.45664739884393,9
0.05,173,94,14878,85.50574712643679,8
0.05,174,95,14973,85.56,6
0.05,175,94,15067,85.60795454545455,7
0.05,176,92,15159,85.64406779661017,9
0.05,177,93,15252,85.68539325842697,8
0.05,178,92,15344,85.72067039106145,10
0.05,179,94,15438,85.76666666666667,8
0.05,180,95,15533,85.81767955801105,6
0.05,181,91,15624,85.84615384615384,10
0.05,182,94,15718,85.89071038251366,7
0.05,183,92,15810,85.92391304347827,10
0.05,184,95,15905,85.97297297297297,6
0.05,185,95,16000,86.02150537634408,6
0.05,186,94,16094,86.06417112299465,8
0.05,187,94,16188,86.1063829787234,7
0.05,188,90,16278,86.12698412698413,11
0.05,189,91,16369,86.15263157894736,10
0.05,190,95,16464,86.19895287958116,6
0.05,191,94,16558,86.23958333333333,7
0.05,192,95,16653,86.28497409326425,6
0.05,193,93,16746,86.31958762886597,10
0.05,194,94,16840,86.35897435897436,7
0.05,195,94,16934,86.39795918367346,8
0.05,196,88,17022,86.40609137055837,14
0.05,197,93,17115,86.43939393939394,8
0.05,198,90,17205,86.4572864321608,11
0.05,199,90,17295,86.475,11
0.05,200,92,17387,86.50248756218906,11
0.05,201,94,17481,86.53960396039604,8
0.05,202,94,17575,86.57635467980296,7
0.05,203,94,17669,86.61274509803921,7
0.05,204,94,17763,86.64878048780488,7
0.05,205,92,17855,86.6747572815534,9
0.05,206,91,17946,86.69565217391305,10
0.05,207,94,18040,86.73076923076923,7
0.05,208,94,18134,86.76555023923444,8
0.05,209,91,18225,86.78571428571429,11
0.05,210,94,18319,86.81990521327015,7
0.05,211,94,18413,86.85377358490567,7
0.05,212,93,18506,86.88262910798122,8
0.05,213,94,18600,86.91588785046729,7
0.05,214,89,18689,86.92558139534884,13
0.05,215,94,18783,86.95833333333333,7
0.05,216,93,18876,86.98617511520737,9
0.05,217,94,18970,87.01834862385321,7
0.05,218,90,19060,87.03196347031964,11
0.05,219,92,19152,87.05454545454545,9
0.05,220,94,19246,87.08597285067873,7
0.05,221,94,19340,87.11711711711712,8
0.05,222,93,19433,87.14349775784753,8
0.05,223,92,19525,87.16517857142857,9
0.05,224,95,19620,87.2,6
0.05,225,91,19711,87.21681415929204,12
0.05,226,95,19806,87.2511013215859,6
0.05,227,94,19900,87.28070175438596,8
0.05,228,89,19989,87.2882096069869,13
0.05,229,94,20083,87.31739130434782,8
0.05,230,92,20175,87.33766233766234,10
0.05,231,92,20267,87.35775862068965,9
0.05,232,93,20360,87.38197424892704,9
0.05,233,89,20449,87.38888888888889,14
0.05,234,94,20543,87.41702127659575,8
0.05,235,93,20636,87.44067796610169,8
0.05,236,94,20730,87.46835443037975,8
0.05,237,92,20822,87.4873949579832,9
0.05,238,94,20916,87.51464435146444,7
0.05,239,94,21010,87.54166666666667,7
0.05,240,94,21104,87.56846473029046,7
0.05,241,23,21127,87.30165289256199,11
0.05,242,93,21220,87.32510288065843,8
0.05,243,94,21314,87.35245901639344,7
0.05,244,95,21409,87.38367346938776,6
0.05,245,93,21502,87.40650406504065,8
0.05,246,93,21595,87.42914979757084,8
0.05,247,96,21691,87.46370967741936,6
0.05,248,93,21784,87.4859437751004,9
0.05,249,95,21879,87.516,6
0.05,250,94,21973,87.54183266932272,7
0.05,251,94,22067,87.56746031746032,7
0.05,252,90,22157,87.57707509881423,11
0.05,253,93,22250,87.5984251968504,9
0.05,254,92,22342,87.6156862745098,9
0.05,255,94,22436,87.640625,7
0.05,256,95,22531,87.6692607003891,6
0.05,257,94,22625,87.6937984496124,7
0.05,258,25,22650,87.45173745173746,8
0.05,259,91,22741,87.46538461538462,10
0.05,260,94,22835,87.4904214559387,8
0.05,261,95,22930,87.51908396946565,6
0.05,262,88,23018,87.52091254752851,13
0.05,263,93,23111,87.54166666666667,8
0.05,264,92,23203,87.55849056603773,9
0.05,265,94,23297,87.5827067669173,7
0.05,266,93,23390,87.60299625468164,9
0.05,267,94,23484,87.6268656716418,8
0.05,268,88,23572,87.62825278810409,13
0.05,269,94,23666,87.65185185185184,7
0.05,270,94,23760,87.67527675276753,7
0.05,271,94,23854,87.69852941176471,9
0.05,272,94,23948,87.72161172161172,8
0.05,273,93,24041,87.74087591240875,10
0.05,274,94,24135,87.76363636363637,7
0.05,275,96,24231,87.79347826086956,6
0.05,276,91,24322,87.80505415162455,13
0.05,277,93,24415,87.82374100719424,10
0.05,278,93,24508,87.84229390681004,8
0.05,279,90,24598,87.85,12
0.05,280,94,24692,87.87188612099644,7
0.05,281,94,24786,87.8936170212766,8
0.05,282,95,24881,87.91872791519435,6
0.05,283,93,24974,87.93661971830986,9
0.05,284,93,25067,87.95438596491228,9
0.05,285,91,25158,87.96503496503496,10
0.05,286,94,25252,87.98606271777004,7
0.05,287,93,25345,88.00347222222223,8
0.05,288,94,25439,88.0242214532872,8
0.05,289,93,25532,88.04137931034482,8
0.05,290,95,25627,88.06529209621993,6
0.05,291,94,25721,88.08561643835617,7
0.05,292,94,25815,88.10580204778157,7
0.05,293,94,25909,88.12585034013605,7
0.05,294,91,26000,88.13559322033899,11
0.05,295,94,26094,88.1554054054054,7
0.05,296,84,26178,88.14141414141415,17
0.05,297,89,26267,88.14429530201342,12
0.05,298,93,26360,88.16053511705685,8
0.05,299,94,26454,88.18,7
0.05,300,94,26548,88.19933554817275,7
0.05,301,94,26642,88.21854304635761,7
0.05,302,94,26736,88.23762376237623,7
0.05,303,95,26831,88.25986842105263,6
0.05,304,94,26925,88.27868852459017,7
0.05,305,93,27018,88.29411764705883,10
0.05,306,94,27112,88.31270358306189,8
0.05,307,94,27206,88.33116883116882,7
0.05,308,95,27301,88.35275080906149,6
0.05,309,92,27393,88.36451612903225,11
0.05,310,89,27482,88.36655948553054,12
0.05,311,94,27576,88.38461538461539,7
0.05,312,95,27671,88.40575079872204,6
0.05,313,92,27763,88.4171974522293,10
0.05,314,89,27852,88.41904761904762,12
0.05,315,92,27944,88.43037974683544,9
0.05,316,93,28037,88.44479495268139,8
0.05,317,94,28131,88.4622641509434,7
0.05,318,90,28221,88.46708463949844,13
0.05,319,93,28314,88.48125,9
0.05,320,95,28409,88.50155763239876,6
0.05,321,90,28499,88.50621118012423,11
0.05,322,90,28589,88.51083591331269,11
0.05,323,93,28682,88.5246913580247,10
0.05,324,94,28776,88.54153846153847,7
0.05,325,95,28871,88.56134969325153,6
0.05,326,94,28965,88.57798165137615,7
0.05,327,93,29058,88.59146341463415,8
0.05,328,87,29145,88.58662613981762,15
0.05,329,94,29239,88.60303030303031,8
0.05,330,94,29333,88.61933534743203,7
0.05,331,95,29428,88.63855421686748,6
0.05,332,92,29520,88.64864864864865,10
0.05,333,95,29615,88.66766467065868,6
0.05,334,93,29708,88.68059701492537,8
0.05,335,94,29802,88.69642857142857,8
0.05,336,94,29896,88.71216617210682,7
0.05,337,93,29989,88.72485207100591,8
0.05,338,91,30080,88.73156342182891,10
0.05,339,94,30174,88.74705882352941,7
0.05,340,91,30265,88.75366568914956,10
0.05,341,95,30360,88.7719298245614,6
0.05,342,92,30452,88.78134110787173,9
0.05,343,93,30545,88.7936046511628,8
0.05,344,94,30639,88.80869565217391,7
0.05,345,95,30734,88.82658959537572,6
0.05,346,94,30828,88.8414985590778,7
0.05,347,93,30921,88.85344827586206,9
0.05,348,94,31015,88.86819484240688,7
0.05,349,95,31110,88.88571428571429,6
0.05,350,94,31204,88.9002849002849,7
0.05,351,93,31297,88.91193181818181,9
0.05,352,94,31391,88.92634560906515,7
0.05,353,94,31485,88.94067796610169,7
0.05,354,92,31577,88.9492957746479,9
0.05,355,94,31671,88.96348314606742,8
0.05,356,93,31764,88.97478991596638,8
0.05,357,94,31858,88.98882681564245,7
0.05,358,92,31950,88.99721448467966,9
0.05,359,92,32042,89.00555555555556,10
0.05,360,93,32135,89.01662049861496,9
0.05,361,95,32230,89.03314917127072,6
0.05,362,95,32325,89.0495867768595,6
0.05,363,96,32421,89.06868131868131,6
0.05,364,94,32515,89.08219178082192,7
0.05,365,96,32611,89.10109289617486,6
0.05,366,94,32705,89.11444141689373,7
0.05,367,92,32797,89.12228260869566,9
0.05,368,93,32890,89.13279132791328,8
0.05,369,95,32985,89.14864864864865,6
0.05,370,93,33078,89.15902964959568,8
0.05,371,93,33171,89.16935483870968,9
0.05,372,92,33263,89.17694369973191,9
0.05,373,92,33355,89.18449197860963,9
0.05,374,90,33445,89.18666666666667,11
0.05,375,93,33538,89.19680851063829,10
0.05,376,93,33631,89.20689655172414,8
0.05,377,94,33725,89.21957671957672,7
0.05,378,94,33819,89.23218997361478,8
0.05,379,92,33911,89.23947368421052,10
0.05,380,88,33999,89.23622047244095,14
0.05,381,95,34094,89.25130890052355,6
0.05,382,94,34188,89.26370757180156,7
0.05,383,92,34280,89.27083333333333,11
0.05,384,94,34374,89.28311688311689,7
0.05,385,91,34465,89.28756476683938,12
0.05,386,94,34559,89.29974160206719,7
0.05,387,95,34654,89.31443298969072,6
0.05,388,94,34748,89.32647814910025,7
0.05,389,92,34840,89.33333333333333,9
0.05,390,95,34935,89.34782608695652,6
0.05,391,87,35022,89.34183673469387,14
0.05,392,94,35116,89.35368956743002,7
0.05,393,95,35211,89.36802030456853,6
0.05,394,94,35305,89.37974683544304,7
0.05,395,89,35394,89.37878787878788,13
0.05,396,95,35489,89.39294710327457,6
0.05,397,94,35583,89.40452261306532,8
0.05,398,95,35678,89.41854636591479,6
0.05,399,91,35769,89.4225,10
0.05,400,94,35863,89.43391521197007,7
0.05,401,94,35957,89.44527363184079,8
0.05,402,94,36051,89.45657568238214,8
0.05,403,91,36142,89.46039603960396,10
0.05,404,90,36232,89.46172839506173,12
0.05,405,91,36323,89.46551724137932,10
0.05,406,89,36412,89.46437346437347,12
0.05,407,95,36507,89.4779411764706,6
0.05,408,94,36601,89.48899755501222,8
0.05,409,94,36695,89.5,8
0.05,410,92,36787,89.50608272506082,10
0.05,411,94,36881,89.51699029126213,7
0.05,412,95,36976,89.53026634382567,6
0.05,413,94,37070,89.54106280193237,8
0.05,414,94,37164,89.55180722891566,7
0.05,415,94,37258,89.5625,7
0.05,416,92,37350,89.56834532374101,10
0.05,417,91,37441,89.57177033492823,10
0.05,418,94,37535,89.58233890214797,7
0.05,419,93,37628,89.5904761904762,8
0.05,420,94,37722,89.60095011876484,8
0.05,421,94,37816,89.61137440758294,7
0.05,422,94,37910,89.62174940898345,7
0.05,423,92,38002,89.62735849056604,10
0.05,424,93,38095,89.63529411764706,8
0.05,425,94,38189,89.64553990610328,7
0.05,426,95,38284,89.65807962529274,6
0.05,427,92,38376,89.66355140186916,9
0.05,428,86,38462,89.65501165501165,15
0.05,429,94,38556,89.66511627906976,7
0.05,430,93,38649,89.67285382830626,8
0.05,431,94,38743,89.68287037037037,7
0.05,432,93,38836,89.6905311778291,9
0.05,433,92,38928,89.6958525345622,9
0.05,434,95,39023,89.7080459770115,6
0.05,435,94,39117,89.71788990825688,7
0.05,436,95,39212,89.7299771167048,6
0.05,437,93,39305,89.73744292237443,8
0.05,438,95,39400,89.749430523918,6
0.05,439,94,39494,89.75909090909092,7
0.05,440,93,39587,89.76643990929705,8
0.05,441,95,39682,89.77828054298642,6
0.05,442,94,39776,89.78781038374717,7
0.05,443,94,39870,89.79729729729729,7
0.05,444,94,39964,89.8067415730337,8
0.05,445,91,40055,89.80941704035874,10
0.05,446,92,40147,89.81431767337807,11
0.05,447,92,40239,89.81919642857143,10
0.05,448,92,40331,89.82405345211582,9
0.05,449,92,40423,89.82888888888888,9
0.05,450,90,40513,89.82926829268293,12
0.05,451,93,40606,89.83628318584071,8
0.05,452,93,40699,89.84326710816777,8
0.05,453,95,40794,89.8546255506608,6
0.05,454,94,40888,89.86373626373626,7
0.05,455,92,40980,89.86842105263158,10
0.05,456,90,41070,89.86870897155362,11
0.05,457,95,41165,89.87991266375546,6
0.05,458,94,41259,89.88888888888889,8
0.05,459,94,41353,89.89782608695653,8
0.05,460,92,41445,89.90238611713666,11
0.05,461,94,41539,89.91125541125541,8
0.05,462,94,41633,89.92008639308855,7
0.05,463,94,41727,89.92887931034483,7
0.05,464,93,41820,89.93548387096774,8
0.05,465,93,41913,89.94206008583691,8
0.05,466,93,42006,89.94860813704497,9
0.05,467,92,42098,89.95299145299145,9
0.05,468,93,42191,89.9594882729211,10
0.05,469,93,42284,89.96595744680852,8
0.05,470,95,42379,89.97664543524417,6
0.05,471,94,42473,89.98516949152543,8
0.05,472,91,42564,89.98731501057082,10
0.05,473,94,42658,89.9957805907173,8
0.05,474,93,42751,90.0021052631579,9
0.05,475,94,42845,90.01050420168067,7
0.05,476,92,42937,90.01467505241091,9
0.05,477,92,43029,90.01882845188284,9
0.05,478,94,43123,90.02713987473904,7
0.05,479,94,43217,90.03541666666666,8
0.05,480,91,43308,90.03742203742203,10
0.05,481,94,43402,90.04564315352697,7
0.05,482,95,43497,90.05590062111801,6
0.05,483,94,43591,90.06404958677686,8
0.05,484,94,43685,90.0721649484536,8
0.05,485,93,43778,90.07818930041152,9
0.05,486,94,43872,90.08624229979466,8
0.05,487,94,43966,90.09426229508196,7
0.05,488,95,44061,90.1042944785276,6
0.05,489,94,44155,90.11224489795919,7
0.05,490,94,44249,90.12016293279022,7
0.05,491,95,44344,90.130081300813,6
0.05,492,90,44434,90.12981744421907,11
0.05,493,93,44527,90.13562753036437,8
0.05,494,94,44621,90.14343434343435,7
0.05,495,94,44715,90.15120967741936,9
0.05,496,93,44808,90.1569416498994,8
0.05,497,93,44901,90.16265060240964,9
0.05,498,94,44995,90.17034068136273,7
0.05,499,95,45090,90.18,6
0.05,500,92,45182,90.18363273453093,10
0.05,501,94,45276,90.19123505976096,8
0.05,502,93,45369,90.19681908548708,9
0.05,503,91,45460,90.1984126984127,10
0.05,504,93,45553,90.2039603960396,9
0.05,505,88,45641,90.199604743083,14
0.05,506,94,45735,90.20710059171597,7
0.05,507,95,45830,90.21653543307086,6
0.05,508,92,45922,90.22003929273085,9
0.05,509,94,46016,90.22745098039216,7
0.05,510,92,46108,90.23091976516633,9
0.05,511,92,46200,90.234375,9
0.05,512,93,46293,90.23976608187135,10
0.05,513,94,46387,90.24708171206225,7
0.05,514,89,46476,90.24466019417476,12
0.05,515,95,46571,90.25387596899225,6
0.05,516,94,46665,90.26112185686654,7
0.05,517,92,46757,90.26447876447877,9
0.05,518,89,46846,90.26204238921002,13
0.05,519,92,46938,90.26538461538462,9
0.05,520,94,47032,90.2725527831094,8
0.05,521,95,47127,90.2816091954023,6
0.05,522,94,47221,90.2887189292543,7
0.05,523,91,47312,90.29007633587786,10
0.05,524,95,47407,90.29904761904761,6
0.05,525,94,47501,90.30608365019012,8
0.05,526,93,47594,90.3111954459203,8
0.05,527,95,47689,90.32007575757575,6
0.05,528,91,47780,90.32136105860114,11
0.05,529,94,47874,90.32830188679246,8
0.05,530,94,47968,90.3352165725047,7
0.05,531,95,48063,90.34398496240601,6
0.05,532,95,48158,90.35272045028142,6
0.05,533,92,48250,90.35580524344569,10
0.05,534,95,48345,90.3644859813084,6
0.05,535,94,48439,90.37126865671642,7
0.05,536,92,48531,90.37430167597765,9
0.05,537,94,48625,90.38104089219331,7
0.05,538,95,48720,90.3896103896104,6
0.05,539,94,48814,90.3962962962963,7
0.05,540,93,48907,90.4011090573013,8
0.05,541,94,49001,90.40774907749078,7
0.05,542,94,49095,90.41436464088397,7
0.05,543,92,49187,90.41727941176471,9
0.05,544,92,49279,90.42018348623853,10
0.05,545,90,49369,90.41941391941391,11
0.05,546,89,49458,90.41681901279708,12
0.05,547,92,49550,90.41970802919708,9
0.05,548,92,49642,90.42258652094718,10
0.05,549,95,49737,90.4309090909091,6
0.05,550,95,49832,90.43920145190563,6
0.05,551,94,49926,90.44565217391305,7
0.05,552,85,50011,90.43580470162749,17
0.05,553,94,50105,90.44223826714801,7
0.05,554,94,50199,90.44864864864864,8
0.05,555,92,50291,90.45143884892086,11
0.05,556,94,50385,90.45780969479354,7
0.05,557,94,50479,90.46415770609319,7
0.05,558,94,50573,90.47048300536673,8
0.05,559,94,50667,90.47678571428571,8
0.05,560,95,50762,90.48484848484848,6
0.05,561,92,50854,90.48754448398577,10
0.05,562,94,50948,90.49378330373001,7
0.05,563,89,51037,90.49113475177305,12
0.05,564,94,51131,90.49734513274336,7
0.05,565,94,51225,90.50353356890459,7
0.05,566,93,51318,90.5079365079365,8
0.05,567,93,51411,90.51232394366197,9
0.05,568,94,51505,90.51845342706503,7
0.05,569,94,51599,90.52456140350877,7
0.05,570,93,51692,90.52889667250437,9
0.05,571,92,51784,90.53146853146853,9
0.05,572,94,51878,90.53752181500873,7
0.05,573,94,51972,90.54355400696865,8
0.05,574,92,52064,90.54608695652173,9
0.05,575,94,52158,90.55208333333333,7
0.05,576,94,52252,90.5580589254766,7
0.05,577,95,52347,90.56574394463668,6
0.05,578,93,52440,90.56994818652849,8
0.05,579,95,52535,90.57758620689656,6
0.05,580,94,52629,90.58347676419966,8
0.05,581,94,52723,90.58934707903781,7
0.05,582,95,52818,90.59691252144083,6
0.05,583,94,52912,90.6027397260274,7
0.05,584,95,53007,90.61025641025641,6
0.05,585,94,53101,90.6160409556314,7
0.05,586,91,53192,90.61669505962521,12
0.05,587,93,53285,90.62074829931973,8
0.05,588,93,53378,90.62478777589133,9
0.05,589,94,53472,90.63050847457627,7
0.05,590,94,53566,90.63620981387479,7
0.05,591,92,53658,90.63851351351352,10
0.05,592,92,53750,90.64080944350759,9
0.05,593,94,53844,90.64646464646465,7
0.05,594,86,53930,90.63865546218487,15
0.05,595,93,54023,90.64261744966443,8
0.05,596,94,54117,90.64824120603015,7
0.05,597,92,54209,90.65050167224081,10
0.05,598,95,54304,90.65776293823038,6
0.05,599,93,54397,90.66166666666666,8
0.05,600,92,54489,90.66389351081531,9
0.05,601,95,54584,90.67109634551495,6
0.05,602,92,54676,90.67330016583747,9
0.05,603,93,54769,90.6771523178808,8
0.05,604,95,54864,90.68429752066116,6
0.05,605,95,54959,90.6914191419142,6
0.05,606,94,55053,90.69686985172982,8
0.05,607,91,55144,90.69736842105263,10
0.05,608,95,55239,90.70443349753694,6
0.05,609,93,55332,90.70819672131148,8
0.05,610,94,55426,90.71358428805237,8
0.05,611,93,55519,90.7173202614379,8
0.05,612,94,55613,90.7226753670473,7
0.05,613,94,55707,90.72801302931596,7
0.05,614,94,55801,90.73333333333333,8
0.05,615,94,55895,90.73863636363636,7
0.05,616,94,55989,90.74392220421394,7
0.05,617,93,56082,90.74757281553399,9
0.05,618,94,56176,90.75282714054927,7
0.05,619,94,56270,90.75806451612904,7
0.05,620,93,56363,90.76167471819646,9
0.05,621,94,56457,90.76688102893891,7
0.05,622,94,56551,90.77207062600321,7
0.05,623,92,56643,90.77403846153847,9
0.05,624,93,56736,90.7776,9
0.05,625,94,56830,90.78274760383387,7
0.05,626,95,56925,90.78947368421052,6
0.05,627,94,57019,90.79458598726114,8
0.05,628,92,57111,90.79650238473768,9
0.05,629,94,57205,90.8015873015873,7
0.05,630,95,57300,90.8082408874802,6
0.05,631,94,57394,90.8132911392405,7
0.05,632,14,57408,90.69194312796209,18
0.05,633,90,57498,90.69085173501577,11
0.05,634,92,57590,90.69291338582677,10
0.05,635,93,57683,90.69654088050315,8
0.05,636,95,57778,90.7032967032967,6
0.05,637,94,57872,90.70846394984326,7
0.05,638,93,57965,90.71205007824726,8
0.05,639,95,58060,90.71875,6
0.05,640,94,58154,90.72386895475819,8
0.05,641,93,58247,90.72741433021807,8
0.05,642,93,58340,90.73094867807154,8
0.05,643,93,58433,90.73447204968944,8
0.05,644,94,58527,90.73953488372094,7
0.05,645,93,58620,90.74303405572755,8
0.05,646,95,58715,90.74961360123648,6
0.05,647,94,58809,90.75462962962963,9
0.05,648,94,58903,90.75963020030817,8
0.05,649,94,58997,90.76461538461538,8
0.05,650,95,59092,90.77112135176651,6
0.05,651,92,59184,90.77300613496932,9
0.05,652,94,59278,90.77794793261869,7
0.05,653,95,59373,90.78440366972477,7
0.05,654,94,59467,90.78931297709924,7
0.05,655,95,59562,90.79573170731707,6
0.05,656,91,59653,90.79604261796042,10
0.05,657,93,59746,90.79939209726444,9
0.05,658,95,59841,90.80576631259484,6
0.05,659,95,59936,90.81212121212121,6
0.05,660,94,60030,90.81694402420575,7
0.05,661,92,60122,90.81873111782477,9
0.05,662,93,60215,90.82202111613876,8
0.05,663,94,60309,90.82680722891567,7
0.05,664,91,60400,90.82706766917293,10
0.05,665,94,60494,90.83183183183183,7
0.05,666,93,60587,90.83508245877061,8
0.05,667,95,60682,90.84131736526946,6
0.05,668,94,60776,90.84603886397609,8
0.05,669,94,60870,90.85074626865672,7
0.05,670,94,60964,90.85543964232488,8
0.05,671,94,61058,90.86011904761905,7
0.05,672,95,61153,90.86627043090638,6
0.05,673,95,61248,90.87240356083086,6
0.05,674,92,61340,90.87407407407407,9
0.05,675,93,61433,90.87721893491124,8
0.05,676,94,61527,90.88183161004432,7
0.05,677,94,61621,90.88643067846607,7
0.05,678,94,61715,90.89101620029454,7
0.05,679,94,61809,90.89558823529411,8
0.05,680,94,61903,90.90014684287812,7
0.05,681,95,61998,90.90615835777126,6
0.05,682,91,62089,90.90629575402636,10
0.05,683,93,62182,90.9093567251462,8
0.05,684,93,62275,90.91240875912409,8
0.05,685,94,62369,90.91690962099125,7
0.05,686,90,62459,90.9155749636099,13
0.05,687,94,62553,90.92005813953489,7
0.05,688,93,62646,90.92307692307692,8
0.05,689,93,62739,90.92608695652174,8
0.05,690,90,62829,90.9247467438495,11
0.05,691,95,62924,90.9306358381503,6
0.05,692,95,63019,90.93650793650794,6
0.05,693,94,63113,90.94092219020173,7
0.05,694,93,63206,90.94388489208633,8
0.05,695,95,63301,90.94971264367815,6
0.05,696,89,63390,90.94691535150646,13
0.05,697,92,63482,90.9484240687679,9
0.05,698,94,63576,90.95278969957081,7
0.05,699,94,63670,90.95714285714286,7
0.05,700,95,63765,90.96291012838802,6
0.05,701,94,63859,90.96723646723646,7
0.05,702,94,63953,90.97155049786629,8
0.05,703,95,64048,90.97727272727273,6
0.05,704,92,64140,90.97872340425532,9
0.05,705,91,64231,90.97875354107649,12
0.05,706,94,64325,90.98302687411598,7
0.05,707,94,64419,90.98728813559322,7
0.05,708,94,64513,90.99153737658675,7
0.05,709,94,64607,90.99577464788733,7
0.05,710,95,64702,91.0014064697609,6
0.05,711,94,64796,91.00561797752809,8
0.05,712,92,64888,91.0070126227209,9
0.05,713,94,64982,91.01120448179272,7
0.05,714,94,65076,91.01538461538462,8
0.05,715,91,65167,91.01536312849161,11
0.05,716,92,65259,91.01673640167364,11
0.05,717,95,65354,91.02228412256268,6
0.05,718,94,65448,91.02642559109874,8
0.05,719,92,65540,91.02777777777777,9
0.05,720,91,65631,91.02773925104022,11
0.05,721,93,65724,91.03047091412742,8
0.05,722,95,65819,91.0359612724758,6
0.05,723,94,65913,91.04005524861878,7
0.05,724,94,66007,91.04413793103448,7
0.05,725,95,66102,91.0495867768595,6
0.05,726,94,66196,91.05364511691884,8
0.05,727,96,66292,91.06043956043956,6
0.05,728,92,66384,91.06172839506173,10
0.05,729,90,66474,91.06027397260274,11
0.05,730,92,66566,91.06155950752394,10
0.05,731,95,66661,91.06693989071039,6
0.05,732,93,66754,91.06957708049113,8
0.05,733,89,66843,91.066757493188,12
0.05,734,92,66935,91.06802721088435,9
0.05,735,91,67026,91.0679347826087,10
0.05,736,94,67120,91.0719131614654,7
0.05,737,91,67211,91.07181571815718,10
0.05,738,94,67305,91.07577807848443,8
0.05,739,93,67398,91.07837837837837,9
0.05,740,93,67491,91.08097165991903,8
0.05,741,94,67585,91.08490566037736,8
0.05,742,92,67677,91.08613728129205,9
0.05,743,90,67767,91.08467741935483,11
0.05,744,94,67861,91.08859060402685,7
0.05,745,93,67954,91.0911528150134,9
0.05,746,94,68048,91.095046854083,8
0.05,747,93,68141,91.0975935828877,8
0.05,748,94,68235,91.10146862483312,10
0.05,749,92,68327,91.10266666666666,9
0.05,750,92,68419,91.10386151797603,9
0.05,751,91,68510,91.10372340425532,10
0.05,752,94,68604,91.10756972111554,8
0.05,753,94,68698,91.11140583554376,7
0.05,754,92,68790,91.11258278145695,9
0.05,755,95,68885,91.11772486772487,6
0.05,756,94,68979,91.12153236459709,8
0.05,757,94,69073,91.12532981530343,7
0.05,758,92,69165,91.12648221343873,9
0.05,759,93,69258,91.12894736842105,9
0.05,760,93,69351,91.13140604467806,10
0.05,761,94,69445,91.13517060367454,7
0.05,762,93,69538,91.13761467889908,9
0.05,763,92,69630,91.13874345549738,9
0.05,764,94,69724,91.14248366013072,8
0.05,765,94,69818,91.1462140992167,7
0.05,766,95,69913,91.15123859191655,6
0.05,767,94,70007,91.15494791666667,7
0.05,768,93,70100,91.15734720416125,8
0.05,769,90,70190,91.15584415584415,11
0.05,770,91,70281,91.1556420233463,10
0.05,771,93,70374,91.15803108808291,10
0.05,772,94,70468,91.16170763260025,7
0.05,773,95,70563,91.16666666666667,6
0.05,774,94,70657,91.17032258064516,7
0.05,775,90,70747,91.16881443298969,12
0.05,776,94,70841,91.17245817245818,7
0.05,777,92,70933,91.17352185089975,9
0.05,778,95,71028,91.17843388960205,6
0.05,779,93,71121,91.18076923076923,8
0.05,780,90,71211,91.17925736235595,11
0.05,781,94,71305,91.18286445012788,7
0.05,782,94,71399,91.18646232439336,7
0.05,783,94,71493,91.19005102040816,7
0.05,784,94,71587,91.19363057324841,8
0.05,785,93,71680,91.19592875318067,9
0.05,786,95,71775,91.20076238881829,6
0.05,787,92,71867,91.2017766497462,10
0.05,788,94,71961,91.20532319391636,8
0.05,789,90,72051,91.20379746835442,12
0.05,790,94,72145,91.20733249051833,7
0.05,791,94,72239,91.21085858585859,8
0.05,792,94,72333,91.21437578814628,8
0.05,793,92,72425,91.21536523929471,9
0.05,794,19,72444,91.1245283018868,14
0.05,795,94,72538,91.12814070351759,7
0.05,796,94,72632,91.13174404015056,7
0.05,797,94,72726,91.13533834586467,7
0.05,798,94,72820,91.13892365456822,7
0.05,799,94,72914,91.1425,9
0.05,800,94,73008,91.14606741573034,7
0.05,801,95,73103,91.15087281795512,6
0.05,802,94,73197,91.15442092154422,7
0.05,803,92,73289,91.15547263681592,9
0.05,804,92,73381,91.15652173913044,9
0.05,805,93,73474,91.15880893300248,8
0.05,806,94,73568,91.16232961586121,7
0.05,807,95,73663,91.16707920792079,6
0.05,808,92,73755,91.16810877626699,9
0.05,809,92,73847,91.16913580246914,9
0.05,810,95,73942,91.17385943279902,6
0.05,811,94,74036,91.17733990147784,7
0.05,812,94,74130,91.18081180811808,7
0.05,813,94,74224,91.18427518427518,7
0.05,814,94,74318,91.1877300613497,7
0.05,815,88,74406,91.18382352941177,14
0.05,816,92,74498,91.18482252141983,9
0.05,817,93,74591,91.18704156479218,8
0.05,818,92,74683,91.1880341880342,11
0.05,819,92,74775,91.1890243902439,9
0.05,820,92,74867,91.19001218026797,10
0.05,821,94,74961,91.19343065693431,7
0.05,822,94,75055,91.19684082624545,7
0.05,823,94,75149,91.2002427184466,7
0.05,824,94,75243,91.20363636363636,8
0.05,825,94,75337,91.20702179176756,7
0.05,826,94,75431,91.21039903264813,7
0.05,827,94,75525,91.21376811594203,7
0.05,828,93,75618,91.21592279855247,8
0.05,829,93,75711,91.21807228915662,8
0.05,830,93,75804,91.2202166064982,8
0.05,831,95,75899,91.22475961538461,6
0.05,832,95,75994,91.22929171668667,6
0.05,833,95,76089,91.23381294964028,6
0.05,834,92,76181,91.23473053892215,10
0.05,835,93,76274,91.23684210526316,8
0.05,836,93,76367,91.2389486260454,10
0.05,837,94,76461,91.24224343675418,8
0.05,838,92,76553,91.24314660309892,9
0.05,839,93,76646,91.2452380952381,8
0.05,840,95,76741,91.24970273483947,6
0.05,841,94,76835,91.25296912114014,7
0.05,842,94,76929,91.25622775800711,7
0.05,843,94,77023,91.25947867298578,7
0.05,844,92,77115,91.2603550295858,9
0.05,845,94,77209,91.26359338061465,7
0.05,846,95,77304,91.26800472255017,6
0.05,847,92,77396,91.26886792452831,9
0.05,848,92,77488,91.26972909305064,9
0.05,849,94,77582,91.27294117647058,8
0.05,850,93,77675,91.27497062279672,8
0.05,851,94,77769,91.27816901408451,7
0.05,852,95,77864,91.28253223915593,7
0.05,853,93,77957,91.28454332552693,8
0.05,854,94,78051,91.28771929824562,7
0.05,855,94,78145,91.29088785046729,7
0.05,856,95,78240,91.29521586931155,6
0.05,857,94,78334,91.2983682983683,8
0.05,858,93,78427,91.30034924330617,8
0.05,859,91,78518,91.3,10
0.05,860,94,78612,91.30313588850174,7
0.05,861,93,78705,91.30510440835266,8
0.05,862,94,78799,91.3082271147161,8
0.05,863,92,78891,91.30902777777777,10
0.05,864,94,78985,91.3121387283237,8
0.05,865,95,79080,91.31639722863741,6
0.05,866,89,79169,91.31372549019608,13
0.05,867,94,79263,91.3168202764977,7
0.05,868,95,79358,91.32105868814729,8
0.05,869,95,79453,91.32528735632184,6
0.05,870,95,79548,91.32950631458094,8
0.05,871,95,79643,91.33371559633028,6
0.05,872,93,79736,91.3356242840779,8
0.05,873,94,79830,91.33867276887872,7
0.05,874,95,79925,91.34285714285714,6
0.05,875,94,80019,91.3458904109589,7
0.05,876,92,80111,91.34663625997719,10
0.05,877,94,80205,91.34965831435079,7
0.05,878,95,80300,91.35381114903299,6
0.05,879,94,80394,91.35681818181818,7
0.05,880,94,80488,91.35981838819524,7
0.05,881,92,80580,91.36054421768708,9
0.05,882,94,80674,91.36353340883352,8
0.05,883,96,80770,91.36877828054298,6
0.05,884,92,80862,91.36949152542373,11
0.05,885,94,80956,91.372460496614,7
0.05,886,95,81051,91.37655016910935,6
0.05,887,93,81144,91.37837837837837,8
0.05,888,92,81236,91.37907761529809,9
0.05,889,93,81329,91.3808988764045,9
0.05,890,87,81416,91.37598204264872,14
0.05,891,92,81508,91.37668161434978,10
0.05,892,94,81602,91.37961926091825,7
0.05,893,92,81694,91.38031319910515,9
0.05,894,95,81789,91.38435754189945,6
0.05,895,94,81883,91.38727678571429,8
0.05,896,94,81977,91.3901895206243,7
0.05,897,92,82069,91.39086859688196,10
0.05,898,93,82162,91.39265850945495,8
0.05,899,92,82254,91.39333333333333,9
0.05,900,94,82348,91.39622641509433,7
0.05,901,94,82442,91.39911308203992,7
0.05,902,91,82533,91.39867109634551,11
0.05,903,93,82626,91.40044247787611,8
0.05,904,94,82720,91.40331491712708,7
0.05,905,88,82808,91.39955849889624,13
0.05,906,90,82898,91.39801543550165,13
0.05,907,94,82992,91.40088105726872,8
0.05,908,94,83086,91.4037403740374,8
0.05,909,92,83178,91.4043956043956,10
0.05,910,93,83271,91.40614709110868,8
0.05,911,92,83363,91.40679824561404,9
0.05,912,94,83457,91.40963855421687,7
0.05,913,94,83551,91.4124726477024,7
0.05,914,95,83646,91.41639344262295,6
0.05,915,94,83740,91.41921397379913,7
0.05,916,94,83834,91.42202835332607,8
0.05,917,94,83928,91.42483660130719,7
0.05,918,94,84022,91.42763873775843,7
0.05,919,92,84114,91.42826086956522,10
0.05,920,94,84208,91.43105320304018,7
0.05,921,94,84302,91.43383947939263,7
0.05,922,94,84396,91.43661971830986,7
0.05,923,93,84489,91.43831168831169,8
0.05,924,93,84582,91.44,8
0.05,925,94,84676,91.44276457883369,7
0.05,926,93,84769,91.44444444444444,9
0.05,927,94,84863,91.44719827586206,7
0.05,928,91,84954,91.44671689989235,11
0.05,929,94,85048,91.4494623655914,8
0.05,930,94,85142,91.45220193340494,7
0.05,931,93,85235,91.45386266094421,8
0.05,932,94,85329,91.45659163987138,8
0.05,933,92,85421,91.45717344753747,10
0.05,934,93,85514,91.45882352941176,8
0.05,935,93,85607,91.46047008547009,8
0.05,936,92,85699,91.46104589114194,9
0.05,937,91,85790,91.46055437100213,10
0.05,938,95,85885,91.4643237486688,6
0.05,939,93,85978,91.46595744680852,8
0.05,940,93,86071,91.46758767268862,9
0.05,941,92,86163,91.46815286624204,9
0.05,942,95,86258,91.47189819724284,6
0.05,943,90,86348,91.47033898305085,11
0.05,944,88,86436,91.46666666666667,13
0.05,945,94,86530,91.4693446088795,7
0.05,946,92,86622,91.46990496304119,9
0.05,947,92,86714,91.4704641350211,10
0.05,948,92,86806,91.47102212855637,10
0.05,949,91,86897,91.47052631578947,10
0.05,950,91,86988,91.47003154574132,11
0.05,951,92,87080,91.47058823529412,9
0.05,952,93,87173,91.47219307450158,8
0.05,953,92,87265,91.47274633123689,9
0.05,954,93,87358,91.47434554973822,8
0.05,955,94,87452,91.47698744769875,7
0.05,956,93,87545,91.478578892372,8
0.05,957,95,87640,91.48225469728601,6
0.05,958,94,87734,91.48488008342024,7
0.05,959,94,87828,91.4875,8
0.05,960,92,87920,91.48803329864724,9
0.05,961,94,88014,91.49064449064448,7
0.05,962,94,88108,91.4932502596054,8
0.05,963,91,88199,91.49273858921161,12
0.05,964,95,88294,91.49637305699481,6
0.05,965,93,88387,91.49792960662526,8
0.05,966,94,88481,91.5005170630817,7
0.05,967,94,88575,91.50309917355372,8
0.05,968,95,88670,91.50670794633643,6
0.05,969,94,88764,91.50927835051546,8
0.05,970,95,88859,91.51287332646756,6
0.05,971,93,88952,91.51440329218107,9
0.05,972,93,89045,91.51593011305242,8
0.05,973,95,89140,91.51950718685832,6
0.05,974,92,89232,91.52,9
0.05,975,92,89324,91.52049180327869,10
0.05,976,91,89415,91.51995905834187,10
0.05,977,94,89509,91.52249488752557,7
0.05,978,94,89603,91.5250255362615,7
0.05,979,94,89697,91.52755102040817,7
0.05,980,93,89790,91.52905198776759,8
0.05,981,96,89886,91.53360488798371,6
0.05,982,91,89977,91.53306205493388,10
0.05,983,95,90072,91.53658536585365,6
0.05,984,94,90166,91.53908629441625,8
0.05,985,92,90258,91.5395537525355,11
0.05,986,94,90352,91.5420466058764,7
0.05,987,94,90446,91.54453441295547,7
0.05,988,92,90538,91.54499494438826,9
0.05,989,94,90632,91.54747474747475,7
0.05,990,95,90727,91.55095862764884,6
0.05,991,94,90821,91.55342741935483,7
0.05,992,95,90916,91.55689828801611,6
0.05,993,92,91008,91.55734406438631,9
0.05,994,93,91101,91.55879396984925,8
0.05,995,93,91194,91.56024096385542,8
0.05,996,88,91282,91.55667001003009,15
0.05,997,94,91376,91.55911823647294,7
0.05,998,91,91467,91.55855855855856,10
0.05,999,93,91560,91.56,8
0.05,1000,91,91651,91.55944055944056,10
0.05,1001,94,91745,91.56187624750498,7
0.05,1002,96,91841,91.56630109670986,6
0.05,1003,94,91935,91.5687250996016,7
0.05,1004,95,92030,91.57213930348259,6
0.05,1005,91,92121,91.57157057654075,11
0.05,1006,94,92215,91.57398212512413,8
0.05,1007,92,92307,91.57440476190476,9
0.05,1008,89,92396,91.57185332011893,13
0.05,1009,90,92486,91.57029702970297,11
0.05,1010,93,92579,91.57171117705242,8
0.05,1011,94,92673,91.57411067193677,8
0.05,1012,92,92765,91.57453109575518,9
0.05,1013,92,92857,91.5749506903353,9
0.05,1014,95,92952,91.57832512315271,6
0.05,1015,91,93043,91.57775590551181,10
0.05,1016,94,93137,91.58013765978367,7
0.05,1017,91,93228,91.57956777996071,10
0.05,1018,94,93322,91.58194308145241,7
0.05,1019,92,93414,91.58235294117647,10
0.05,1020,92,93506,91.58276199804114,9
0.05,1021,92,93598,91.58317025440313,9
0.05,1022,95,93693,91.58651026392963,6
0.05,1023,92,93785,91.5869140625,9
0.05,1024,94,93879,91.58926829268293,7
0.05,1025,94,93973,91.5916179337232,7
0.05,1026,94,94067,91.59396299902629,7
0.05,1027,89,94156,91.59143968871595,12
0.05,1028,95,94251,91.59475218658892,6
0.05,1029,93,94344,91.59611650485436,8
0.05,1030,95,94439,91.59941804073715,6
0.05,1031,95,94534,91.60271317829458,6
0.05,1032,92,94626,91.60309777347531,9
0.05,1033,93,94719,91.60444874274661,8
0.05,1034,94,94813,91.60676328502416,7
0.05,1035,92,94905,91.60714285714286,9
0.05,1036,90,94995,91.60559305689489,12
0.05,1037,94,95089,91.60789980732177,7
0.05,1038,94,95183,91.6102021174206,8
0.05,1039,91,95274,91.60961538461538,10
0.05,1040,94,95368,91.611911623439,8
0.05,1041,92,95460,91.61228406909788,9
0.05,1042,94,95554,91.61457334611697,7
0.05,1043,94,95648,91.61685823754789,9
0.05,1044,94,95742,91.61913875598086,7
0.05,1045,94,95836,91.62141491395793,7
0.05,1046,95,95931,91.62464183381088,6
0.05,1047,93,96024,91.62595419847328,8
0.05,1048,91,96115,91.62535748331744,10
0.05,1049,95,96210,91.62857142857143,6
0.05,1050,94,96304,91.63082778306375,7
0.05,1051,93,96397,91.63212927756653,9
0.05,1052,93,96490,91.63342830009496,8
0.05,1053,91,96581,91.63282732447819,11
0.05,1054,94,96675,91.63507109004739,8
0.05,1055,94,96769,91.63731060606061,7
0.05,1056,94,96863,91.639545884579,7
0.05,1057,94,96957,91.64177693761815,7
0.05,1058,92,97049,91.64211520302172,9
0.05,1059,93,97142,91.64339622641509,9
0.05,1060,93,97235,91.64467483506127,8
0.05,1061,94,97329,91.64689265536722,8
0.05,1062,93,97422,91.64816556914393,8
0.05,1063,94,97516,91.65037593984962,7
0.05,1064,90,97606,91.64882629107981,11
0.05,1065,95,97701,91.65196998123827,6
0.05,1066,92,97793,91.65229615745079,10
0.05,1067,92,97885,91.65262172284645,10
0.05,1068,95,97980,91.65575304022451,6
0.05,1069,95,98075,91.6588785046729,6
0.05,1070,93,98168,91.66013071895425,9
0.05,1071,20,98188,91.59328358208955,13
0.05,1072,94,98282,91.5955265610438,9
0.05,1073,93,98375,91.59683426443203,9
0.05,1074,95,98470,91.6,7
0.05,1075,95,98565,91.60315985130111,6
0.05,1076,92,98657,91.60352831940575,10
0.05,1077,93,98750,91.6048237476809,9
0.05,1078,94,98844,91.60704355885079,7
0.05,1079,93,98937,91.60833333333333,9
0.05,1080,94,99031,91.61054579093432,7
0.05,1081,94,99125,91.61275415896488,8
0.05,1082,90,99215,91.61126500461681,11
0.05,1083,92,99307,91.61162361623616,11
0.05,1084,91,99398,91.6110599078341,11
0.05,1085,93,99491,91.61233885819522,8
0.05,1086,94,99585,91.61453541858326,7
0.05,1087,91,99676,91.61397058823529,11
0.05,1088,91,99767,91.61340679522498,11
0.05,1089,92,99859,91.6137614678899,10
0.05,1090,89,99948,91.61136571952338,13
0.05,1091,94,100042,91.61355311355311,7
0.05,1092,95,100137,91.61665141811528,6
0.05,1093,92,100229,91.61700182815356,9
0.05,1094,95,100324,91.62009132420091,6
0.05,1095,91,100415,91.61952554744525,11
0.05,1096,93,100508,91.6207839562443,9
0.05,1097,92,100600,91.62112932604735,9
0.05,1098,93,100693,91.62238398544132,8
0.05,1099,94,100787,91.62454545454545,7
0.05,1100,94,100881,91.6267029972752,7
0.05,1101,90,100971,91.62522686025409,11
0.05,1102,94,101065,91.62737987307344,7
0.05,1103,93,101158,91.6286231884058,8
0.05,1104,92,101250,91.6289592760181,10
0.05,1105,94,101344,91.63110307414105,7
0.05,1106,92,101436,91.63143631436314,9
0.05,1107,91,101527,91.63086642599278,10
0.05,1108,92,101619,91.6311992786294,9
0.05,1109,94,101713,91.63333333333334,8
0.05,1110,92,101805,91.63366336633663,10
0.05,1111,94,101899,91.63579136690647,8
0.05,1112,93,101992,91.63701707097934,8
0.05,1113,93,102085,91.63824057450628,8
0.05,1114,95,102180,91.64125560538116,6
0.05,1115,95,102275,91.64426523297492,6
0.05,1116,94,102369,91.64637421665175,8
0.05,1117,90,102459,91.64490161001788,11
0.05,1118,92,102551,91.64521894548704,9
0.05,1119,92,102643,91.64553571428571,10
0.05,1120,94,102737,91.64763603925067,7
0.05,1121,93,102830,91.64884135472371,8
0.05,1122,94,102924,91.65093499554764,7
0.05,1123,92,103016,91.65124555160142,9
0.05,1124,92,103108,91.65155555555556,9
0.05,1125,94,103202,91.65364120781527,7
0.05,1126,92,103294,91.65394853593611,9
0.05,1127,95,103389,91.65691489361703,6
0.05,1128,92,103481,91.65721877767936,10
0.05,1129,94,103575,91.65929203539822,7
0.05,1130,95,103670,91.66224580017683,6
0.05,1131,94,103764,91.66431095406361,8
0.05,1132,94,103858,91.66637246248897,8
0.05,1133,94,103952,91.668430335097,7
0.05,1134,95,104047,91.67136563876652,6
0.05,1135,94,104141,91.67341549295774,7
0.05,1136,94,104235,91.6754617414248,7
0.05,1137,94,104329,91.6775043936731,7
0.05,1138,92,104421,91.67778753292362,9
0.05,1139,92,104513,91.67807017543859,9
0.05,1140,92,104605,91.6783523225241,9
0.05,1141,92,104697,91.67863397548162,9
0.05,1142,94,104791,91.68066491688539,8
0.05,1143,95,104886,91.68356643356644,6
0.05,1144,95,104981,91.68646288209607,6
0.05,1145,88,105069,91.68324607329843,14
0.05,1146,87,105156,91.67916303400175,16
0.05,1147,88,105244,91.67595818815332,13
0.05,1148,94,105338,91.67798085291558,7
0.05,1149,89,105427,91.67565217391305,12
0.05,1150,93,105520,91.67680278019114,9
0.05,1151,92,105612,91.67708333333333,10
0.05,1152,91,105703,91.6764960971379,10
0.05,1153,94,105797,91.67850953206239,7
0.05,1154,93,105890,91.67965367965368,8
0.05,1155,93,105983,91.68079584775087,9
0.05,1156,93,106076,91.68193604148661,8
0.05,1157,94,106170,91.6839378238342,7
0.05,1158,93,106263,91.68507333908542,9
0.05,1159,91,106354,91.68448275862069,10
0.05,1160,91,106445,91.68389319552111,10
0.05,1161,92,106537,91.684165232358,10
0.05,1162,94,106631,91.68615649183147,7
0.05,1163,94,106725,91.6881443298969,7
0.05,1164,92,106817,91.68841201716738,9
0.05,1165,94,106911,91.69039451114922,8
0.05,1166,94,107005,91.6923736075407,7
0.05,1167,94,107099,91.6943493150685,7
0.05,1168,92,107191,91.69461077844312,9
0.05,1169,95,107286,91.6974358974359,6
0.05,1170,94,107380,91.69940222032452,8
0.05,1171,94,107474,91.70136518771331,8
0.05,1172,96,107570,91.70502983802217,6
0.05,1173,94,107664,91.70698466780239,7
0.05,1174,92,107756,91.7072340425532,9
0.05,1175,93,107849,91.70833333333333,8
0.05,1176,95,107944,91.71112999150382,6
0.05,1177,94,108038,91.71307300509338,7
0.05,1178,93,108131,91.71416454622562,8
0.05,1179,93,108224,91.71525423728814,9
0.05,1180,94,108318,91.71718882303134,8
0.05,1181,94,108412,91.7191201353638,7
0.05,1182,94,108506,91.72104818258664,7
0.05,1183,94,108600,91.72297297297297,7
0.05,1184,94,108694,91.72489451476794,8
0.05,1185,95,108789,91.72765598650928,6
0.05,1186,94,108883,91.72957034540859,7
0.05,1187,94,108977,91.73148148148148,8
0.05,1188,94,109071,91.73338940285954,7
0.05,1189,91,109162,91.7327731092437,10
0.05,1190,92,109254,91.73299748110831,11
0.05,1191,92,109346,91.73322147651007,9
0.05,1192,94,109440,91.73512154233026,7
0.05,1193,94,109534,91.73701842546063,7
0.05,1194,92,109626,91.73723849372385,9
0.05,1195,95,109721,91.73996655518394,6
0.05,1196,93,109814,91.74101921470343,9
0.05,1197,94,109908,91.74290484140234,7
0.05,1198,92,110000,91.74311926605505,9
0.05,1199,94,110094,91.745,7
0.05,1200,94,110188,91.74687760199834,7
0.05,1201,93,110281,91.74792013311148,8
0.05,1202,94,110375,91.74979218620116,7
0.05,1203,91,110466,91.74916943521595,11
0.05,1204,93,110559,91.75020746887967,9
0.05,1205,91,110650,91.74958540630182,11
0.05,1206,88,110738,91.74647887323944,14
0.05,1207,95,110833,91.74917218543047,6
0.05,1208,92,110925,91.74937965260546,9
0.05,1209,93,111018,91.7504132231405,8
0.05,1210,95,111113,91.75309661436829,6
0.05,1211,94,111207,91.7549504950495,7
0.05,1212,94,111301,91.75680131904369,8
0.05,1213,94,111395,91.75864909390445,7
0.05,1214,94,111489,91.76049382716049,8
0.05,1215,90,111579,91.75904605263158,11
0.05,1216,93,111672,91.76006573541495,9
0.05,1217,90,111762,91.75862068965517,11
0.05,1218,94,111856,91.76045939294504,7
0.05,1219,95,111951,91.76311475409837,6
0.05,1220,94,112045,91.76494676494677,7
0.05,1221,90,112135,91.76350245499182,12
0.05,1222,94,112229,91.7653311529027,7
0.05,1223,88,112317,91.76225490196079,14
0.05,1224,95,112412,91.76489795918367,6
0.05,1225,94,112506,91.76672104404568,7
0.05,1226,96,112602,91.77017114914426,6
0.05,1227,91,112693,91.76954397394137,10
0.05,1228,92,112785,91.76973148901546,9
0.05,1229,89,112874,91.76747967479675,12
0.05,1230,94,112968,91.76929325751422,7
0.05,1231,90,113058,91.76785714285714,11
0.05,1232,92,113150,91.76804541768045,9
0.05,1233,92,113242,91.76823338735818,9
0.05,1234,95,113337,91.77085020242914,6
0.05,1235,92,113429,91.7710355987055,9
0.05,1236,93,113522,91.77202910266774,8
0.05,1237,94,113616,91.77382875605817,7
0.05,1238,92,113708,91.77401129943503,9
0.05,1239,94,113802,91.77580645161291,7
0.05,1240,90,113892,91.7743755036261,12
0.05,1241,93,113985,91.77536231884058,8
0.05,1242,93,114078,91.77634754625905,8
0.05,1243,93,114171,91.77733118971061,9
0.05,1244,94,114265,91.77911646586345,7
0.05,1245,94,114359,91.78089887640449,8
0.05,1246,92,114451,91.78107457898957,9
0.05,1247,94,114545,91.78285256410257,7
0.05,1248,89,114634,91.78062449959968,12
0.05,1249,94,114728,91.7824,7
0.05,1250,93,114821,91.7833733013589,9
0.05,1251,92,114913,91.78354632587859,9
0.05,1252,94,115007,91.78531524341581,7
0.05,1253,95,115102,91.78787878787878,6
0.05,1254,94,115196,91.78964143426295,7
0.05,1255,94,115290,91.79140127388536,7
0.05,1256,95,115385,91.793953858393,6
0.05,1257,94,115479,91.79570747217807,7
0.05,1258,95,115574,91.79825258141382,8
0.05,1259,94,115668,91.8,7
0.05,1260,93,115761,91.8009516256939,8
0.05,1261,90,115851,91.79952456418384,11
0.05,1262,94,115945,91.8012668250198,7
0.05,1263,93,116038,91.80221518987342,8
0.05,1264,95,116133,91.80474308300396,6
0.05,1265,95,116228,91.80726698262244,6
0.05,1266,91,116319,91.80662983425414,12
0.05,1267,94,116413,91.8083596214511,8
0.05,1268,88,116501,91.8053585500394,13
0.05,1269,94,116595,91.80708661417323,7
0.05,1270,91,116686,91.80645161290323,10
0.05,1271,94,116780,91.80817610062893,7
0.05,1272,94,116874,91.80989787902593,7
0.05,1273,92,116966,91.81004709576138,9
0.05,1274,95,117061,91.81254901960784,6
0.05,1275,95,117156,91.81504702194357,6
0.05,1276,94,117250,91.8167580266249,8
0.05,1277,94,117344,91.81846635367762,7
0.05,1278,88,117432,91.81548084440969,15
0.05,1279,94,117526,91.8171875,7
0.05,1280,93,117619,91.81811085089774,8
0.05,1281,94,117713,91.8198127925117,7
0.05,1282,94,117807,91.82151208106002,7
0.05,1283,93,117900,91.82242990654206,8
0.05,1284,95,117995,91.8249027237354,6
0.05,1285,95,118090,91.82737169517885,6
0.05,1286,91,118181,91.82672882672883,10
0.05,1287,90,118271,91.82531055900621,11
0.05,1288,89,118360,91.82311869666408,12
0.05,1289,93,118453,91.82403100775194,8
0.05,1290,92,118545,91.82416731216111,10
0.05,1291,95,118640,91.82662538699691,6
0.05,1292,94,118734,91.82830626450117,8
0.05,1293,91,118825,91.82766615146832,11
0.05,1294,94,118919,91.82934362934363,7
0.05,1295,94,119013,91.83101851851852,8
0.05,1296,94,119107,91.83269082498073,8
0.05,1297,95,119202,91.8351309707242,6
0.05,1298,88,119290,91.83217859892225,14
0.05,1299,94,119384,91.83384615384615,8
0.05,1300,92,119476,91.83397386625673,9
0.05,1301,94,119570,91.83563748079877,7
0.05,1302,95,119665,91.83806600153493,6
0.05,1303,94,119759,91.83972392638037,8
0.05,1304,93,119852,91.84061302681992,9
0.05,1305,94,119946,91.84226646248086,8
0.05,1306,92,120038,91.84238714613619,9
0.05,1307,94,120132,91.8440366972477,7
0.05,1308,94,120226,91.84568372803668,7
0.05,1309,94,120320,91.8473282442748,9
0.05,1310,93,120413,91.84820747520976,8
0.05,1311,95,120508,91.85060975609755,6
0.05,1312,92,120600,91.85072353389185,10
0.05,1313,95,120695,91.85312024353121,6
0.05,1314,91,120786,91.85247148288974,11
0.05,1315,92,120878,91.85258358662614,10
0.05,1316,94,120972,91.85421412300683,8
0.05,1317,93,121065,91.85508345978755,8
0.05,1318,91,121156,91.85443517816528,12
0.05,1319,93,121249,91.85530303030303,8
0.05,1320,94,121343,91.8569265707797,8
0.05,1321,90,121433,91.85552193645991,12
0.05,1322,94,121527,91.85714285714286,7
0.05,1323,94,121621,91.85876132930514,8
0.05,1324,94,121715,91.86037735849057,9
0.05,1325,94,121809,91.86199095022624,7
0.05,1326,94,121903,91.86360211002261,8
0.05,1327,92,121995,91.8637048192771,10
0.05,1328,93,122088,91.86455981941309,8
0.05,1329,94,122182,91.86616541353384,7
0.05,1330,94,122276,91.86776859504133,7
0.05,1331,95,122371,91.87012012012012,6
0.05,1332,94,122465,91.87171792948237,7
0.05,1333,92,122557,91.87181409295353,10
0.05,1334,94,122651,91.87340823970037,8
0.05,1335,93,122744,91.87425149700599,8
0.05,1336,92,122836,91.87434554973822,10
0.05,1337,94,122930,91.87593423019432,8
0.05,1338,91,123021,91.87528005974607,10
0.05,1339,94,123115,91.8768656716418,8
0.05,1340,94,123209,91.87844891871738,8
0.05,1341,93,123302,91.87928464977645,8
0.05,1342,95,123397,91.88160833953835,6
0.05,1343,95,123492,91.88392857142857,6
0.05,1344,94,123586,91.88550185873606,7
0.05,1345,95,123681,91.88781575037147,6
0.05,1346,95,123776,91.89012620638456,6
0.05,1347,92,123868,91.89020771513353,10
0.05,1348,94,123962,91.89177168272795,7
0.05,1349,91,124053,91.89111111111112,10
0.05,1350,92,124145,91.89119170984456,10
0.05,1351,18,124163,91.83653846153847,15
0.05,1352,90,124253,91.83518107908351,12
0.05,1353,95,124348,91.83751846381094,6
0.05,1354,92,124440,91.83763837638377,9
0.05,1355,95,124535,91.83997050147492,6
0.05,1356,94,124629,91.8415622697126,7
0.05,1357,94,124723,91.84315169366715,8
0.05,1358,93,124816,91.8440029433407,8
0.05,1359,90,124906,91.84264705882353,11
0.05,1360,92,124998,91.84276267450404,10
0.05,1361,92,125090,91.84287812041116,9
0.05,1362,93,125183,91.8437270726339,8
0.05,1363,91,125274,91.84310850439883,10
0.05,1364,94,125368,91.84468864468865,7
0.05,1365,92,125460,91.84480234260614,12
0.05,1366,94,125554,91.8463789319678,7
0.05,1367,94,125648,91.84795321637426,8
0.05,1368,89,125737,91.84587289992696,12
0.05,1369,92,125829,91.84598540145986,9
0.05,1370,92,125921,91.84609773887674,9
0.05,1371,93,126014,91.84693877551021,8
0.05,1372,94,126108,91.84850691915514,7
0.05,1373,95,126203,91.85080058224163,6
0.05,1374,90,126293,91.84945454545455,12
0.05,1375,94,126387,91.85101744186046,7
0.05,1376,94,126481,91.85257806826434,7
0.05,1377,90,126571,91.85123367198838,12
0.05,1378,94,126665,91.8527918781726,8
0.05,1379,94,126759,91.85434782608695,8
0.05,1380,92,126851,91.85445329471398,9
0.05,1381,95,126946,91.85672937771346,6
0.05,1382,94,127040,91.8582791033984,7
0.05,1383,95,127135,91.86054913294798,6
0.05,1384,95,127230,91.86281588447653,6
0.05,1385,94,127324,91.86435786435787,7
0.05,1386,94,127418,91.86589762076424,7
0.05,1387,96,127514,91.86887608069165,6
0.05,1388,96,127610,91.87185025197984,6
0.05,1389,94,127704,91.87338129496403,7
0.05,1390,94,127798,91.87491013659238,7
0.05,1391,94,127892,91.8764367816092,9
0.05,1392,95,127987,91.87867910983489,6
0.05,1393,94,128081,91.88020086083213,8
0.05,1394,26,128107,91.83297491039427,6
0.05,1395,93,128200,91.83381088825215,9
0.05,1396,94,128294,91.8353614889048,7
0.05,1397,94,128388,91.83690987124463,8
0.05,1398,95,128483,91.83917083631165,6
0.05,1399,94,128577,91.84071428571428,7
0.05,1400,88,128665,91.83797287651677,13
0.05,1401,91,128756,91.83737517831669,11
0.05,1402,92,128848,91.83749109052032,9
0.05,1403,93,128941,91.83831908831908,9
0.05,1404,95,129036,91.8405693950178,6
0.05,1405,91,129127,91.83997155049786,10
0.05,1406,95,129222,91.84221748400853,6
0.05,1407,94,129316,91.84375,7
0.05,1408,94,129410,91.84528034066714,7
0.05,1409,94,129504,91.8468085106383,7
0.05,1410,92,129596,91.84691708008505,9
0.05,1411,91,129687,91.84631728045326,10
0.05,1412,94,129781,91.84784147204529,7
0.05,1413,93,129874,91.84865629420085,8
0.05,1414,94,129968,91.85017667844522,7
0.05,1415,95,130063,91.8524011299435,6
0.05,1416,94,130157,91.85391672547635,8
0.05,1417,94,130251,91.85543018335684,7
0.05,1418,92,130343,91.85553206483439,9
0.05,1419,93,130436,91.85633802816902,8
0.05,1420,94,130530,91.85784658691063,8
0.05,1421,93,130623,91.85864978902954,8
0.05,1422,94,130717,91.86015460295151,7
0.05,1423,89,130806,91.85814606741573,12
0.05,1424,94,130900,91.85964912280701,8
0.05,1425,92,130992,91.85974754558205,10
0.05,1426,90,131082,91.85844428871759,11
0.05,1427,94,131176,91.85994397759103,7
0.05,1428,92,131268,91.86004198740378,9
0.05,1429,93,131361,91.86083916083916,8
0.05,1430,92,131453,91.86093640810621,9
0.05,1431,94,131547,91.86243016759776,7
0.05,1432,94,131641,91.8639218422889,9
0.05,1433,94,131735,91.86541143654114,7
0.05,1434,92,131827,91.86550522648083,9
0.05,1435,92,131919,91.86559888579387,10
0.05,1436,93,132012,91.86638830897704,8
0.05,1437,94,132106,91.86787204450626,7
0.05,1438,92,132198,91.8679638637943,9
0.05,1439,93,132291,91.86875,8
0.05,1440,92,132383,91.86884108258154,10
0.05,1441,92,132475,91.86893203883496,9
0.05,1442,91,132566,91.86832986832987,12
0.05,1443,95,132661,91.87049861495845,6
0.05,1444,94,132755,91.8719723183391,7
0.05,1445,95,132850,91.87413554633471,6
0.05,1446,93,132943,91.87491361437456,10
0.05,1447,94,133037,91.8763812154696,8
0.05,1448,93,133130,91.87715665976536,8
0.05,1449,94,133224,91.87862068965518,7
0.05,1450,94,133318,91.88008270158511,7
0.05,1451,94,133412,91.88154269972452,7
0.05,1452,94,133506,91.88300068823125,8
0.05,1453,86,133592,91.87895460797799,16
0.05,1454,93,133685,91.87972508591065,8
0.05,1455,92,133777,91.8798076923077,9
0.05,1456,94,133871,91.88126286890872,7
0.05,1457,93,133964,91.88203017832647,9
0.05,1458,94,134058,91.88348183687457,8
0.05,1459,93,134151,91.88424657534246,8
0.05,1460,95,134246,91.88637919233402,6
0.05,1461,92,134338,91.88645690834473,9
0.05,1462,92,134430,91.88653451811346,9
0.05,1463,91,134521,91.88592896174863,10
0.05,1464,95,134616,91.88805460750854,6
0.05,1465,94,134710,91.88949522510232,7
0.05,1466,94,134804,91.89093387866394,7
0.05,1467,93,134897,91.891689373297,8
0.05,1468,94,134991,91.89312457454051,7
0.05,1469,94,135085,91.89455782312925,7
0.05,1470,93,135178,91.89530931339225,8
0.05,1471,94,135272,91.89673913043478,7
0.05,1472,93,135365,91.89748811948405,9
0.05,1473,95,135460,91.89959294436906,6
0.05,1474,93,135553,91.90033898305084,8
0.05,1475,91,135644,91.89972899728997,10
0.05,1476,94,135738,91.9011509817197,7
0.05,1477,92,135830,91.90121786197564,9
0.05,1478,93,135923,91.90196078431373,9
0.05,1479,95,136018,91.90405405405406,6
0.05,1480,88,136106,91.90141796083728,13
0.05,1481,91,136197,91.90080971659918,10
0.05,1482,92,136289,91.90087660148347,10
0.05,1483,96,136385,91.90363881401618,6
0.05,1484,93,136478,91.9043771043771,9
0.05,1485,94,136572,91.90578734858681,7
0.05,1486,86,136658,91.90181573638198,16
0.05,1487,92,136750,91.90188172043011,9
0.05,1488,92,136842,91.90194761584956,12
0.05,1489,94,136936,91.90335570469799,7
0.05,1490,93,137029,91.90409121395037,8
0.05,1491,94,137123,91.90549597855228,8
0.05,1492,92,137215,91.90555927662425,9
0.05,1493,93,137308,91.90629183400267,9
0.05,1494,94,137402,91.9076923076923,9
0.05,1495,94,137496,91.9090909090909,7
0.05,1496,91,137587,91.90848363393454,10
0.05,1497,90,137677,91.90720961281708,12
0.05,1498,94,137771,91.90860573715811,7
0.05,1499,93,137864,91.90933333333334,8
0.05,1500,94,137958,91.91072618254498,7
0.05,1501,93,138051,91.91145139813582,8
0.05,1502,86,138137,91.90751829673985,16
0.05,1503,95,138232,91.90957446808511,6
0.05,1504,91,138323,91.90897009966777,10
0.05,1505,90,138413,91.90770252324037,11
0.05,1506,95,138508,91.90975447909754,6
0.05,1507,94,138602,91.91114058355437,8
0.05,1508,90,138692,91.90987408880054,11
0.05,1509,93,138785,91.91059602649007,9
0.05,1510,94,138879,91.9119788219722,7
0.05,1511,91,138970,91.91137566137566,11
0.05,1512,94,139064,91.91275611368143,7
0.05,1513,91,139155,91.91215323645972,10
0.05,1514,92,139247,91.9122112211221,9
0.05,1515,93,139340,91.91292875989446,8
0.05,1516,90,139430,91.9116677653263,11
0.05,1517,93,139523,91.91238471673255,8
0.05,1518,95,139618,91.91441737985517,6
0.05,1519,92,139710,91.91447368421052,9
0.05,1520,93,139803,91.91518737672584,8
0.05,1521,94,139897,91.91655716162944,7
0.05,1522,92,139989,91.91661195009848,10
0.05,1523,95,140084,91.91863517060368,6
0.05,1524,92,140176,91.91868852459017,9
0.05,1525,93,140269,91.91939711664482,8
0.05,1526,94,140363,91.920759659463,10
0.05,1527,94,140457,91.92212041884817,7
0.05,1528,92,140549,91.92217135382603,9
0.05,1529,94,140643,91.9235294117647,7
0.05,1530,94,140737,91.92488569562377,7
0.05,1531,95,140832,91.92689295039165,6
0.05,1532,91,140923,91.9262883235486,11
0.05,1533,92,141015,91.92633637548892,9
0.05,1534,94,141109,91.92768729641693,7
0.05,1535,88,141197,91.92513020833333,14
0.05,1536,94,141291,91.92648015614834,7
0.05,1537,95,141386,91.92847854356307,6
0.05,1538,92,141478,91.92852501624431,11
0.05,1539,93,141571,91.92922077922078,8
0.05,1540,94,141665,91.93056456846203,7
0.05,1541,93,141758,91.93125810635539,8
0.05,1542,21,141779,91.88528839922229,11
0.05,1543,94,141873,91.88665803108809,7
0.05,1544,90,141963,91.88543689320389,11
0.05,1545,94,142057,91.88680465717982,7
0.05,1546,94,142151,91.88817065287654,8
0.05,1547,94,142245,91.88953488372093,8
0.05,1548,93,142338,91.89025177533892,8
0.05,1549,94,142432,91.8916129032258,8
0.05,1550,92,142524,91.8916827852998,9
0.05,1551,94,142618,91.89304123711341,7
0.05,1552,95,142713,91.89504185447521,7
0.05,1553,93,142806,91.89575289575289,8
0.05,1554,93,142899,91.89646302250804,10
0.05,1555,94,142993,91.8978149100257,7
0.05,1556,93,143086,91.8985228002569,9
0.05,1557,94,143180,91.89987163029525,8
0.05,1558,94,143274,91.9012187299551,9
0.05,1559,93,143367,91.90192307692308,8
0.05,1560,92,143459,91.90198590647022,10
0.05,1561,92,143551,91.90204865556979,10
0.05,1562,94,143645,91.90339091490723,8
0.05,1563,95,143740,91.90537084398977,6
0.05,1564,95,143835,91.90734824281151,6
0.05,1565,94,143929,91.90868454661558,7
0.05,1566,90,144019,91.9074664964901,12
0.05,1567,94,144113,91.90880102040816,9
0.05,1568,95,144208,91.91077119184193,6
0.05,1569,94,144302,91.91210191082803,7
0.05,1570,94,144396,91.91343093570974,8
0.05,1571,91,144487,91.91284987277353,10
0.05,1572,95,144582,91.914812460267,6
0.05,1573,92,144674,91.9148665819568,9
0.05,1574,95,144769,91.9168253968254,6
0.05,1575,93,144862,91.91751269035532,8
0.05,1576,94,144956,91.91883322764743,7
0.05,1577,92,145048,91.91888466413181,9
0.05,1578,94,145142,91.92020265991134,7
0.05,1579,91,145233,91.91962025316455,10
0.05,1580,94,145327,91.92093611638204,9
0.05,1581,90,145417,91.9197218710493,11
0.05,1582,96,145513,91.92229943145925,6
0.05,1583,95,145608,91.92424242424242,6
0.05,1584,93,145701,91.92492113564668,8
0.05,1585,89,145790,91.92307692307692,12
0.05,1586,96,145886,91.92564587271582,6
0.05,1587,94,145980,91.92695214105794,7
0.05,1588,94,146074,91.92825676526117,7
0.05,1589,96,146170,91.93081761006289,6
0.05,1590,92,146262,91.93086109365179,10
0.05,1591,95,146357,91.93278894472361,6
0.05,1592,93,146450,91.93345888261142,9
0.05,1593,95,146545,91.93538268506902,6
0.05,1594,94,146639,91.93667711598746,7
0.05,1595,92,146731,91.93671679197995,9
0.05,1596,93,146824,91.93738259236068,8
0.05,1597,94,146918,91.9386733416771,7
0.05,1598,94,147012,91.93996247654785,8
0.05,1599,94,147106,91.94125,7
0.05,1600,94,147200,91.94253591505309,7
0.05,1601,96,147296,91.94506866416978,6
0.05,1602,94,147390,91.94635059263881,7
0.05,1603,95,147485,91.94825436408978,6
0.05,1604,94,147579,91.94953271028038,8
0.05,1605,93,147672,91.95018679950186,8
0.05,1606,95,147767,91.95208462974486,6
0.05,1607,93,147860,91.95273631840796,11
0.05,1608,92,147952,91.95276569297701,9
0.05,1609,94,148046,91.95403726708075,8
0.05,1610,92,148138,91.95406579764122,9
0.05,1611,91,148229,91.95347394540943,10
0.05,1612,95,148324,91.95536267823931,7
0.05,1613,94,148418,91.95662949194548,7
0.05,1614,95,148513,91.95851393188855,6
0.05,1615,92,148605,91.95853960396039,10
0.05,1616,94,148699,91.95980210265924,7
0.05,1617,92,148791,91.95982694684795,10
0.05,1618,94,148885,91.9610870907968,7
0.05,1619,94,148979,91.96234567901234,7
0.05,1620,96,149075,91.96483652066625,6
0.05,1621,95,149170,91.96670776818742,6
0.05,1622,94,149264,91.96796056685152,7
0.05,1623,95,149359,91.96982758620689,6
0.05,1624,96,149455,91.9723076923077,6
0.05,1625,94,149549,91.97355473554735,7
0.05,1626,27,149576,91.93362015980333,6
0.05,1627,96,149672,91.93611793611794,6
0.05,1628,95,149767,91.93799877225291,6
0.05,1629,94,149861,91.93926380368099,9
0.05,1630,95,149956,91.94114040465972,6
0.05,1631,94,150050,91.94240196078431,7
0.05,1632,92,150142,91.94243723208818,9
0.05,1633,92,150234,91.94247246022032,9
0.05,1634,95,150329,91.94434250764526,6
0.05,1635,95,150424,91.94621026894866,6
0.05,1636,94,150518,91.94746487477092,7
0.05,1637,96,150614,91.94993894993895,6
0.05,1638,94,150708,91.95118974984747,7
0.05,1639,95,150803,91.9530487804878,6
0.05,1640,94,150897,91.95429616087752,8
0.05,1641,25,150922,91.91352009744215,7
0.05,1642,92,151014,91.91357273280585,10
0.05,1643,95,151109,91.9154501216545,6
0.05,1644,94,151203,91.91671732522796,7
0.05,1645,94,151297,91.9179829890644,7
0.05,1646,95,151392,91.91985428051002,8
0.05,1647,93,151485,91.92050970873787,8
0.05,1648,96,151581,91.92298362644027,6
0.05,1649,93,151674,91.92363636363636,8
0.05,1650,94,151768,91.92489400363417,7
0.05,1651,94,151862,91.92615012106538,7
0.05,1652,92,151954,91.92619479733817,9
0.05,1653,92,152046,91.92623941958888,9
0.05,1654,93,152139,91.92688821752266,8
0.05,1655,95,152234,91.92874396135265,6
0.05,1656,94,152328,91.92999396499698,8
0.05,1657,95,152423,91.93184559710494,6
0.05,1658,94,152517,91.93309222423146,7
0.05,1659,92,152609,91.93313253012049,9
0.05,1660,93,152702,91.93377483443709,8
0.05,1661,94,152796,91.93501805054152,7
0.05,1662,94,152890,91.93625977149729,7
0.05,1663,94,152984,91.9375,7
0.05,1664,94,153078,91.93873873873873,7
0.05,1665,94,153172,91.93997599039616,7
0.05,1666,88,153260,91.9376124775045,13
0.05,1667,93,153353,91.93824940047962,9
0.05,1668,95,153448,91.94008388256441,6
0.05,1669,94,153542,91.94131736526946,7
0.05,1670,95,153637,91.94314781567924,7
0.05,1671,93,153730,91.94377990430623,8
0.05,1672,94,153824,91.94500896592947,7
0.05,1673,94,153918,91.94623655913979,7
0.05,1674,93,154011,91.94686567164179,8
0.05,1675,96,154107,91.94928400954655,6
0.05,1676,96,154203,91.95169946332737,6
0.05,1677,96,154299,91.95411203814065,6
0.05,1678,92,154391,91.95413936867183,9
0.05,1679,95,154486,91.95595238095238,6
0.05,1680,96,154582,91.95835812016657,6
0.05,1681,94,154676,91.95957193816885,7
0.05,1682,96,154772,91.96197266785502,6
0.05,1683,19,154791,91.9186460807601,13
0.05,1684,96,154887,91.92106824925816,6
0.05,1685,89,154976,91.91933570581257,12
0.05,1686,94,155070,91.92056905749851,7
0.05,1687,93,155163,91.92120853080569,8
0.05,1688,94,155257,91.92243931320309,7
0.05,1689,95,155352,91.92426035502959,7
0.05,1690,94,155446,91.92548787699586,8
0.05,1691,95,155541,91.927304964539,6
0.05,1692,96,155637,91.92971057294743,6
0.05,1693,94,155731,91.93093270365998,8
0.05,1694,94,155825,91.93215339233038,7
0.05,1695,96,155921,91.93455188679245,6
0.05,1696,96,156017,91.93694755450795,6
0.05,1697,94,156111,91.93816254416961,7
0.05,1698,90,156201,91.93702177751618,11
0.05,1699,94,156295,91.93823529411765,8
0.05,1700,95,156390,91.94003527336861,6
0.05,1701,95,156485,91.94183313748532,6
0.05,1702,96,156581,91.94421608925425,6
0.05,1703,94,156675,91.94542253521126,7
0.05,1704,95,156770,91.94721407624634,8
0.05,1705,93,156863,91.94783118405627,8
0.05,1706,94,156957,91.94903339191565,8
0.05,1707,95,157052,91.95081967213115,6
0.05,1708,93,157145,91.95143358689292,8
0.05,1709,94,157239,91.95263157894736,7
0.05,1710,94,157333,91.95382817066043,8
0.05,1711,93,157426,91.95443925233644,8
0.05,1712,93,157519,91.95504962054875,8
0.05,1713,94,157613,91.95624270711785,7
0.05,1714,94,157707,91.95743440233237,7
0.05,1715,93,157800,91.95804195804196,8
0.05,1716,91,157891,91.95748398369248,10
0.05,1717,95,157986,91.9592549476135,6
0.05,1718,96,158082,91.96160558464223,6
0.05,1719,95,158177,91.96337209302325,6
0.05,1720,92,158269,91.96339337594422,10
0.05,1721,27,158296,91.92566782810685,6
0.05,1722,94,158390,91.92687173534533,7
0.05,1723,93,158483,91.92749419953596,8
0.05,1724,94,158577,91.92869565217391,7
0.05,1725,96,158673,91.93105446118193,6
0.05,1726,88,158761,91.92877822814128,13
0.05,1727,94,158855,91.92997685185185,7
0.05,1728,94,158949,91.93117408906883,7
0.05,1729,95,159044,91.93294797687861,6
0.05,1730,19,159063,91.89081455805892,13
0.05,1731,91,159154,91.89030023094688,10
0.05,1732,95,159249,91.89209463358338,6
0.05,1733,95,159344,91.89388696655132,6
0.05,1734,94,159438,91.89510086455331,7
0.05,1735,95,159533,91.89688940092167,6
0.05,1736,89,159622,91.89522164651699,12
0.05,1737,95,159717,91.8970080552359,6
0.05,1738,95,159812,91.89879240943071,6
0.05,1739,91,159903,91.89827586206897,11
0.05,1740,89,159992,91.89661114302125,12
0.05,1741,94,160086,91.89781859931114,7
0.05,1742,96,160182,91.90017211703959,6
0.05,1743,96,160278,91.90252293577981,6
0.05,1744,94,160372,91.90372492836676,7
0.05,1745,95,160467,91.90549828178695,6
0.05,1746,94,160561,91.90669719519175,7
0.05,1747,94,160655,91.90789473684211,8
0.05,1748,95,160750,91.90966266437965,6
0.05,1749,95,160845,91.91142857142857,7
0.05,1750,95,160940,91.9131924614506,7
0.05,1751,94,161034,91.91438356164383,7
0.05,1752,93,161127,91.91500285225328,8
0.05,1753,94,161221,91.91619156214367,7
0.05,1754,94,161315,91.91737891737891,7
0.05,1755,94,161409,91.91856492027335,7
0.05,1756,92,161501,91.91861126920888,9
0.05,1757,93,161594,91.91922639362912,8
0.05,1758,96,161690,91.92154633314384,6
0.05,1759,27,161717,91.8846590909091,6
0.05,1760,94,161811,91.88586030664395,7
0.05,1761,25,161836,91.84790011350738,8
0.05,1762,95,161931,91.84968803176403,7
0.05,1763,95,162026,91.8514739229025,6
0.05,1764,92,162118,91.85155807365439,9
0.05,1765,92,162210,91.85164212910533,10
0.05,1766,96,162306,91.85398981324279,6
0.05,1767,94,162400,91.8552036199095,7
0.05,1768,95,162495,91.85698134539288,6
0.05,1769,94,162589,91.85819209039548,7
0.05,1770,95,162684,91.85996612083568,6
0.05,1771,96,162780,91.86230248306998,6
0.05,1772,94,162874,91.863508178229,7
0.05,1773,94,162968,91.86471251409245,7
0.05,1774,94,163062,91.86591549295774,7
0.05,1775,94,163156,91.86711711711712,7
0.05,1776,94,163250,91.86831738885762,8
0.05,1777,93,163343,91.8689538807649,8
0.05,1778,92,163435,91.8690275435638,9
0.05,1779,89,163524,91.86741573033707,13
0.05,1780,94,163618,91.86861313868613,7
0.05,1781,96,163714,91.87093153759821,6
0.05,1782,96,163810,91.87324733595065,6
0.05,1783,91,163901,91.87275784753363,10
0.05,1784,96,163997,91.87507002801121,6
0.05,1785,94,164091,91.87625979843224,7
0.05,1786,94,164185,91.87744823726916,7
0.05,1787,94,164279,91.87863534675616,7
0.05,1788,93,164372,91.87926215762997,8
0.05,1789,96,164468,91.88156424581005,6
0.05,1790,92,164560,91.88163037409268,9
0.05,1791,95,164655,91.88337053571429,6
0.05,1792,94,164749,91.8845510317903,7
0.05,1793,93,164842,91.88517279821627,8
0.05,1794,93,164935,91.8857938718663,8
0.05,1795,95,165030,91.88752783964365,6
0.05,1796,96,165126,91.889816360601,6
0.05,1797,87,165213,91.88709677419355,14
0.05,1798,93,165306,91.88771539744302,8
0.05,1799,94,165400,91.88888888888889,7
0.05,1800,91,165491,91.88839533592449,10
0.05,1801,93,165584,91.88901220865705,8
0.05,1802,93,165677,91.88962839711591,8
0.05,1803,95,165772,91.89135254988913,6
0.05,1804,96,165868,91.89362880886426,6
0.05,1805,95,165963,91.8953488372093,7
0.05,1806,95,166058,91.89706696181517,6
0.05,1807,24,166082,91.85951327433628,9
0.05,1808,96,166178,91.86180210060807,6
0.05,1809,95,166273,91.86353591160221,6
0.05,1810,94,166367,91.86471562672557,7
0.05,1811,90,166457,91.86368653421634,11
0.05,1812,94,166551,91.86486486486487,8
0.05,1813,95,166646,91.86659316427784,7
0.05,1814,95,166741,91.86831955922865,6
0.05,1815,95,166836,91.87004405286343,6
0.05,1816,90,166926,91.86901485965878,11
0.05,1817,93,167019,91.86963696369637,8
0.05,1818,94,167113,91.87080813633865,7
0.05,1819,91,167204,91.87032967032967,10
0.05,1820,94,167298,91.87149917627677,7
0.05,1821,93,167391,91.87211855104282,8
0.05,1822,96,167487,91.87438288535381,6
0.05,1823,95,167582,91.87609649122807,6
0.05,1824,95,167677,91.87780821917808,6
0.05,1825,94,167771,91.8789704271632,7
0.05,1826,94,167865,91.88013136288998,7
0.05,1827,94,167959,91.88129102844638,7
0.05,1828,92,168051,91.88135593220339,9
0.05,1829,90,168141,91.88032786885246,12
0.05,1830,96,168237,91.88257782632441,6
0.05,1831,94,168331,91.88373362445415,7
0.05,1832,96,168427,91.885979268958,6
0.05,1833,91,168518,91.8854961832061,10
0.05,1834,94,168612,91.8866485013624,8
0.05,1835,96,168708,91.88888888888889,6
0.05,1836,94,168802,91.89003810560696,8
0.05,1837,92,168894,91.89009793253537,9
0.05,1838,94,168988,91.89124524197933,7
0.05,1839,95,169083,91.89293478260869,6
0.05,1840,95,169178,91.89462248777838,6
0.05,1841,94,169272,91.8957654723127,7
0.05,1842,94,169366,91.89690721649484,8
0.05,1843,92,169458,91.89696312364426,9
0.05,1844,94,169552,91.89810298102981,7
0.05,1845,94,169646,91.89924160346696,7
0.05,1846,95,169741,91.90092041147807,6
0.05,1847,92,169833,91.90097402597402,9
0.05,1848,92,169925,91.90102758247701,9
0.05,1849,94,170019,91.90216216216216,7
0.05,1850,94,170113,91.90329551593733,7
0.05,1851,95,170208,91.9049676025918,7
0.05,1852,94,170302,91.90609821910415,7
0.05,1853,96,170398,91.90830636461705,6
0.05,1854,95,170493,91.9099730458221,6
0.05,1855,94,170587,91.91109913793103,7
0.05,1856,94,170681,91.91222401723209,7
0.05,1857,94,170775,91.91334768568353,7
0.05,1858,94,170869,91.91447014523938,7
0.05,1859,94,170963,91.91559139784947,7
0.05,1860,23,170986,91.87855991402472,9
0.05,1861,91,171077,91.8780880773362,10
0.05,1862,91,171168,91.87761674718196,10
0.05,1863,95,171263,91.87929184549357,6
0.05,1864,94,171357,91.88042895442359,7
0.05,1865,95,171452,91.88210075026795,6
0.05,1866,94,171546,91.88323513658275,7
0.05,1867,94,171640,91.88436830835117,7
0.05,1868,93,171733,91.88496522204387,8
0.05,1869,95,171828,91.88663101604278,6
0.05,1870,94,171922,91.88776055585248,7
0.05,1871,92,172014,91.88782051282051,9
0.05,1872,90,172104,91.88681260010678,11
0.05,1873,92,172196,91.88687299893276,9
0.05,1874,94,172290,91.888,7
0.05,1875,92,172382,91.88805970149254,9
0.05,1876,94,172476,91.88918486947256,7
0.05,1877,92,172568,91.88924387646432,9
0.05,1878,94,172662,91.89036721660457,7
0.05,1879,89,172751,91.88882978723404,12
0.05,1880,93,172844,91.88942052099947,8
0.05,1881,94,172938,91.89054197662061,7
0.05,1882,95,173033,91.89219330855019,6
0.05,1883,94,173127,91.89331210191082,7
0.05,1884,94,173221,91.89442970822282,7
0.05,1885,94,173315,91.89554612937434,7
0.05,1886,94,173409,91.8966613672496,7
0.05,1887,92,173501,91.89671610169492,9
0.05,1888,92,173593,91.89677077818952,10
0.05,1889,26,173619,91.86190476190477,7
0.05,1890,90,173709,91.86092014806981,12
0.05,1891,93,173802,91.8615221987315,9
0.05,1892,93,173895,91.8621236133122,8
0.05,1893,94,173989,91.86325237592398,7
0.05,1894,94,174083,91.86437994722955,7
0.05,1895,88,174171,91.8623417721519,13
0.05,1896,96,174267,91.8645229309436,6
0.05,1897,95,174362,91.86617492096944,8
0.05,1898,95,174457,91.86782517114271,6
0.05,1899,92,174549,91.8678947368421,9
0.05,1900,91,174640,91.86743819042609,12
0.05,1901,94,174734,91.86855941114617,8
0.05,1902,91,174825,91.86810299527062,10
0.05,1903,94,174919,91.86922268907563,7
0.05,1904,93,175012,91.86981627296588,8
0.05,1905,93,175105,91.8704092339979,8
0.05,1906,92,175197,91.87047718930258,9
0.05,1907,24,175221,91.83490566037736,9
0.05,1908,91,175312,91.83446830801466,10
0.05,1909,95,175407,91.83612565445026,7
0.05,1910,92,175499,91.83621140763998,10
0.05,1911,94,175593,91.8373430962343,7
0.05,1912,95,175688,91.83899634082593,6
0.05,1913,25,175713,91.80407523510972,7
0.05,1914,95,175808,91.80574412532637,6
0.05,1915,94,175902,91.80688935281837,7
0.05,1916,95,175997,91.80855503390714,6
0.05,1917,92,176089,91.80865484880083,9
0.05,1918,94,176183,91.8097967691506,8
0.05,1919,94,176277,91.8109375,7
0.05,1920,93,176370,91.81155648099949,8
0.05,1921,96,176466,91.81373569198752,6
0.05,1922,94,176560,91.81487259490379,7
0.05,1923,93,176653,91.81548856548856,8
0.05,1924,95,176748,91.81714285714285,6
0.05,1925,96,176844,91.81931464174455,6
0.05,1926,94,176938,91.82044628956928,8
0.05,1927,94,177032,91.82157676348548,8
0.05,1928,92,177124,91.82166925868326,9
0.05,1929,96,177220,91.8238341968912,6
0.05,1930,94,177314,91.82496116002072,7
0.05,1931,94,177408,91.82608695652173,7
0.05,1932,96,177504,91.82824624935334,6
0.05,1933,94,177598,91.82936918304033,8
0.05,1934,94,177692,91.83049095607235,7
0.05,1935,94,177786,91.83161157024793,7
0.05,1936,94,177880,91.8327310273619,7
0.05,1937,94,177974,91.83384932920536,7
0.05,1938,94,178068,91.83496647756576,8
0.05,1939,94,178162,91.8360824742268,7
0.05,1940,95,178257,91.83771251931994,6
0.05,1941,92,178349,91.83779608650876,9
0.05,1942,93,178442,91.83839423571796,8
0.05,1943,94,178536,91.8395061728395,7
0.05,1944,93,178629,91.8401028277635,8
0.05,1945,92,178721,91.84018499486126,9
0.05,1946,96,178817,91.84232152028763,6
0.05,1947,92,178909,91.84240246406571,9
0.05,1948,96,179005,91.84453565931247,6
0.05,1949,93,179098,91.8451282051282,8
0.05,1950,94,179192,91.84623270117888,7
0.05,1951,95,179287,91.84784836065573,6
0.05,1952,95,179382,91.84946236559139,6
0.05,1953,94,179476,91.85056294779939,7
0.05,1954,96,179572,91.85268542199489,6
0.05,1955,90,179662,91.8517382413088,11
0.05,1956,94,179756,91.85283597342871,7
0.05,1957,90,179846,91.85188968335035,11
0.05,1958,95,179941,91.8534966819806,6
0.05,1959,94,180035,91.8545918367347,7
0.05,1960,93,180128,91.85517593064763,8
0.05,1961,92,180220,91.855249745158,9
0.05,1962,94,180314,91.85634233316352,7
0.05,1963,93,180407,91.85692464358452,8
0.05,1964,93,180500,91.85750636132316,8
0.05,1965,95,180595,91.85910478128179,6
0.05,1966,93,180688,91.85968479918658,8
0.05,1967,94,180782,91.86077235772358,7
0.05,1968,93,180875,91.86135093956322,8
0.05,1969,94,180969,91.86243654822336,8
0.05,1970,94,181063,91.86352105530187,7
0.05,1971,94,181157,91.86460446247465,9
0.05,1972,95,181252,91.86619361378611,6
0.05,1973,94,181346,91.86727456940223,7
0.05,1974,95,181441,91.86886075949367,7
0.05,1975,94,181535,91.86993927125506,8
0.05,1976,95,181630,91.8715225088518,6
0.05,1977,95,181725,91.87310414560162,6
0.05,1978,94,181819,91.87417887822133,7
0.05,1979,94,181913,91.87525252525252,7
0.05,1980,92,182005,91.87531549722362,9
0.05,1981,96,182101,91.8773965691221,6
0.05,1982,94,182195,91.87846696923853,7
0.05,1983,94,182289,91.87953629032258,7
0.05,1984,94,182383,91.88060453400504,7
0.05,1985,87,182470,91.87814702920443,14
0.05,1986,92,182562,91.87820835430297,9
0.05,1987,94,182656,91.87927565392354,7
0.05,1988,96,182752,91.88134741075918,6
0.05,1989,95,182847,91.88291457286432,6
0.05,1990,95,182942,91.88448016072326,7
0.05,1991,21,182963,91.84889558232932,13
0.05,1992,94,183057,91.84997491219268,7
0.05,1993,95,183152,91.85155466399198,6
0.05,1994,94,183246,91.85263157894737,7
0.05,1995,94,183340,91.85370741482966,7
0.05,1996,93,183433,91.8542814221332,8
0.05,1997,96,183529,91.85635635635636,6
0.05,1998,89,183618,91.85492746373187,12
0.05,1999,94,183712,91.856,7
0.05,2000,95,183807,91.8575712143928,7
0.05,2001,93,183900,91.85814185814186,10
0.05,2002,93,183993,91.85871193210184,8
0.05,2003,93,184086,91.85928143712574,8
0.05,2004,94,184180,91.86034912718205,7
0.05,2005,95,184275,91.86191425722832,6
0.05,2006,95,184370,91.86347782760339,6
0.05,2007,95,184465,91.86503984063745,7
0.05,2008,92,184557,91.86510701841712,9
0.05,2009,25,184582,91.8318407960199,10
0.05,2010,95,184677,91.83341621084038,6
0.05,2011,96,184773,91.8354870775348,6
0.05,2012,92,184865,91.83556880278192,10
0.05,2013,96,184961,91.83763654419066,6
0.05,2014,94,185055,91.83870967741936,8
0.05,2015,93,185148,91.83928571428571,8
0.05,2016,93,185241,91.83986117997026,8
0.05,2017,95,185336,91.8414271555996,6
0.05,2018,92,185428,91.84150569588905,10
0.05,2019,94,185522,91.84257425742574,7
0.05,2020,94,185616,91.8436417615042,7
0.05,2021,94,185710,91.84470820969338,7
0.05,2022,92,185802,91.84478497281266,9
0.05,2023,94,185896,91.84584980237155,7
0.05,2024,94,185990,91.84691358024692,7
0.05,2025,94,186084,91.84797630799605,7
0.05,2026,95,186179,91.84953132708436,6
0.05,2027,92,186271,91.84960552268245,9
0.05,2028,94,186365,91.85066535239034,9
0.05,2029,89,186454,91.84926108374384,12
0.05,2030,89,186543,91.84785819793206,12
0.05,2031,94,186637,91.84891732283465,7
0.05,2032,96,186733,91.85095917363502,6
0.05,2033,93,186826,91.85152409046215,8
0.05,2034,96,186922,91.85356265356265,6
0.05,2035,96,187018,91.85559921414539,6
0.05,2036,92,187110,91.85567010309278,9
0.05,2037,92,187202,91.85574092247302,9
0.05,2038,96,187298,91.85777341834232,6
0.05,2039,95,187393,91.8593137254902,6
0.05,2040,92,187485,91.859382655561,9
0.05,2041,94,187579,91.86043095004896,7
0.05,2042,94,187673,91.86147821830642,7
0.05,2043,95,187768,91.86301369863014,6
0.05,2044,94,187862,91.8640586797066,8
0.05,2045,91,187953,91.86363636363636,10
0.05,2046,92,188045,91.86370297997068,9
0.05,2047,90,188135,91.86279296875,11
0.05,2048,96,188231,91.8648121034651,6
0.05,2049,94,188325,91.86585365853658,7
0.05,2050,90,188415,91.86494392979034,12
0.05,2051,94,188509,91.8659844054581,7
0.05,2052,96,188605,91.86799805163176,6
0.05,2053,90,188695,91.86708860759494,12
0.05,2054,94,188789,91.86812652068126,7
0.05,2055,92,188881,91.8681906614786,9
0.05,2056,92,188973,91.86825473991249,9
0.05,2057,94,189067,91.86929057337221,7
0.05,2058,94,189161,91.87032540067995,8
0.05,2059,93,189254,91.87087378640777,8
0.05,2060,88,189342,91.86899563318778,13
0.05,2061,89,189431,91.86760426770127,12
0.05,2062,91,189522,91.86718371303927,10
0.05,2063,93,189615,91.86773255813954,8
0.05,2064,96,189711,91.86973365617433,6
0.05,2065,27,189738,91.83833494675702,6
0.05,2066,96,189834,91.84034833091437,6
0.05,2067,89,189923,91.8389748549323,12
0.05,2068,94,190017,91.84001933301111,7
0.05,2069,94,190111,91.84106280193237,7
0.05,2070,95,190206,91.84258812168035,6
0.05,2071,96,190302,91.8445945945946,6
0.05,2072,94,190396,91.84563434635794,7
0.05,2073,94,190490,91.8466730954677,7
0.05,2074,92,190582,91.8467469879518,9
0.05,2075,95,190677,91.84826589595376,6
0.05,2076,94,190771,91.84930187770823,7
0.05,2077,96,190867,91.85129932627527,6
0.05,2078,94,190961,91.85233285233285,7
0.05,2079,95,191056,91.85384615384615,6
0.05,2080,93,191149,91.8543969245555,8
0.05,2081,94,191243,91.85542747358309,7
0.05,2082,94,191337,91.8564570331253,8
0.05,2083,95,191432,91.85796545105566,6
0.05,2084,96,191528,91.8599520383693,6
0.05,2085,94,191622,91.86097794822626,7
0.05,2086,94,191716,91.8620028749401,7
0.05,2087,94,191810,91.86302681992338,7
0.05,2088,94,191904,91.86404978458593,7
0.05,2089,96,192000,91.86602870813397,6
0.05,2090,95,192095,91.8675274988044,6
0.05,2091,94,192189,91.86854684512429,7
0.05,2092,95,192284,91.87004300047778,6
0.05,2093,93,192377,91.87058261700095,8
0.05,2094,89,192466,91.86921241050119,12
0.05,2095,96,192562,91.87118320610686,6
0.05,2096,96,192658,91.87315212207916,6
0.05,2097,93,192751,91.87368922783604,8
0.05,2098,95,192846,91.8751786565031,6
0.05,2099,92,192938,91.87523809523809,9
0.05,2100,93,193031,91.87577344121847,8
0.05,2101,92,193123,91.87583254043768,9
0.05,2102,91,193214,91.8754160722777,11
0.05,2103,95,193309,91.87690114068441,6
0.05,2104,96,193405,91.87885985748218,6
0.05,2105,96,193501,91.88081671415004,7
0.05,2106,94,193595,91.88182249644044,7
0.05,2107,95,193690,91.88330170777989,7
0.05,2108,94,193784,91.88430535798958,7
0.05,2109,96,193880,91.88625592417061,6
0.05,2110,93,193973,91.88678351492185,8
0.05,2111,96,194069,91.88873106060606,6
0.05,2112,90,194159,91.88783719829627,12
0.05,2113,96,194255,91.88978240302744,6
0.05,2114,95,194350,91.89125295508275,6
0.05,2115,95,194445,91.89272211720227,7
0.05,2116,96,194541,91.89466225791215,6
0.05,2117,91,194632,91.89423984891407,10
0.05,2118,95,194727,91.8957055214724,6
0.05,2119,90,194817,91.89481132075471,13
0.05,2120,94,194911,91.89580386610089,7
0.05,2121,94,195005,91.89679547596607,7
0.05,2122,93,195098,91.89731512011305,8
0.05,2123,94,195192,91.89830508474576,7
0.05,2124,90,195282,91.89741176470588,12
0.05,2125,96,195378,91.89934148635936,6
0.05,2126,93,195471,91.89985895627645,8
0.05,2127,96,195567,91.90178571428571,6
0.05,2128,92,195659,91.90183184593705,9
0.05,2129,94,195753,91.90281690140846,8
0.05,2130,92,195845,91.90286250586578,9
0.05,2131,94,195939,91.90384615384616,7
0.05,2132,95,196034,91.90529770276606,6
0.05,2133,94,196128,91.90627928772258,7
0.05,2134,94,196222,91.9072599531616,7
0.05,2135,91,196313,91.90683520599251,10
0.05,2136,94,196407,91.90781469349555,7
0.05,2137,95,196502,91.90926099158092,6
0.05,2138,93,196595,91.90977092099112,8
0.05,2139,95,196690,91.91121495327103,6
0.05,2140,96,196786,91.91312470808033,6
0.05,2141,94,196880,91.9140989729225,7
0.05,2142,96,196976,91.91600559962669,6
0.05,2143,94,197070,91.9169776119403,7
0.05,2144,94,197164,91.91794871794872,7
0.05,2145,95,197259,91.91938490214352,6
0.05,2146,91,197350,91.91895668374477,10
0.05,2147,96,197446,91.92085661080074,6
0.05,2148,93,197539,91.92135877152164,8
0.05,2149,94,197633,91.92232558139536,7
0.05,2150,92,197725,91.92236169223617,10
0.05,2151,91,197816,91.92193308550186,10
0.05,2152,92,197908,91.92196934509987,9
0.05,2153,95,198003,91.92339832869081,6
0.05,2154,96,198099,91.92529002320185,6
0.05,2155,94,198193,91.92625231910947,7
0.05,2156,93,198286,91.92675011590171,8
0.05,2157,92,198378,91.92678405931417,10
0.05,2158,96,198474,91.92867068087078,6
0.05,2159,92,198566,91.9287037037037,9
0.05,2160,94,198660,91.92966219342897,7
0.05,2161,93,198753,91.93015726179463,8
0.05,2162,93,198846,91.93065187239945,8
0.05,2163,96,198942,91.93253234750462,6
0.05,2164,96,199038,91.93441108545035,6
0.05,2165,94,199132,91.9353647276085,7
0.05,2166,96,199228,91.93724042455007,6
0.05,2167,93,199321,91.93773062730628,9
0.05,2168,94,199415,91.93868142000922,7
0.05,2169,94,199509,91.93963133640553,7
0.05,2170,95,199604,91.9410409949332,6
0.05,2171,95,199699,91.94244935543279,6
0.05,2172,88,199787,91.94063506672802,13
0.05,2173,94,199881,91.94158233670653,7
0.05,2174,92,199973,91.9416091954023,9
0.05,2175,95,200068,91.94301470588235,6
0.05,2176,94,200162,91.9439595774001,7
0.05,2177,93,200255,91.94444444444444,8
0.05,2178,95,200350,91.9458467186783,6
0.05,2179,93,200443,91.94633027522936,8
0.05,2180,94,200537,91.94727189362678,7
0.05,2181,94,200631,91.94821264894593,8
0.05,2182,92,200723,91.94823637196518,9
0.05,2183,96,200819,91.95009157509158,6
0.05,2184,93,200912,91.95057208237986,8
0.05,2185,94,201006,91.95150960658738,7
0.05,2186,93,201099,91.9519890260631,8
0.05,2187,93,201192,91.95246800731262,10
0.05,2188,95,201287,91.95386021014161,6
0.05,2189,91,201378,91.95342465753424,10
0.05,2190,96,201474,91.95527156549521,6
0.05,2191,94,201568,91.95620437956204,7
0.05,2192,93,201661,91.95668034655722,8
0.05,2193,25,201686,91.92616226071102,8
0.05,2194,92,201778,91.92619589977221,9
0.05,2195,95,201873,91.9275956284153,7
0.05,2196,95,201968,91.92899408284023,6
0.05,2197,94,202062,91.92993630573248,7
0.05,2198,95,202157,91.93133242382902,6
0.05,2199,95,202252,91.93272727272728,6
0.05,2200,93,202345,91.9332121762835,8
0.05,2201,90,202435,91.93233424159855,11
0.05,2202,93,202528,91.9328188833409,8
0.05,2203,90,202618,91.93194192377496,11
0.05,2204,94,202712,91.9328798185941,7
0.05,2205,96,202808,91.93472348141432,6
0.05,2206,94,202902,91.9356592659719,7
0.05,2207,95,202997,91.93704710144928,6
0.05,2208,96,203093,91.93888637392486,6
0.05,2209,94,203187,91.93981900452489,8
0.05,2210,95,203282,91.94120307553143,6
0.05,2211,96,203378,91.94303797468355,6
0.05,2212,95,203473,91.94441934026209,6
0.05,2213,95,203568,91.94579945799458,6
0.05,2214,92,203660,91.94582392776523,9
0.05,2215,27,203687,91.91651624548736,6
0.05,2216,94,203781,91.91745602165088,7
0.05,2217,93,203874,91.91794409377817,8
0.05,2218,94,203968,91.91888237945021,7
0.05,2219,94,204062,91.91981981981982,7
0.05,2220,95,204157,91.92120666366502,7
0.05,2221,94,204251,91.92214221422142,7
0.05,2222,96,204347,91.92397660818713,6
0.05,2223,95,204442,91.92535971223022,6
0.05,2224,94,204536,91.92629213483146,7
0.05,2225,96,204632,91.92812219227314,6
0.05,2226,94,204726,91.92905253704535,7
0.05,2227,96,204822,91.93087971274686,6
0.05,2228,94,204916,91.93180798564379,7
0.05,2229,95,205011,91.93318385650224,7
0.05,2230,92,205103,91.9332138054684,9
0.05,2231,93,205196,91.9336917562724,8
0.05,2232,93,205289,91.93416927899686,8
0.05,2233,94,205383,91.93509400179052,7
0.05,2234,94,205477,91.93601789709172,7
0.05,2235,93,205570,91.93649373881932,8
0.05,2236,93,205663,91.93696915511846,8
0.05,2237,95,205758,91.93833780160858,6
0.05,2238,95,205853,91.93970522554712,6
0.05,2239,95,205948,91.94107142857143,8
0.05,2240,94,206042,91.94199018295404,8
0.05,2241,95,206137,91.94335414808207,6
0.05,2242,93,206230,91.94382523406152,8
0.05,2243,95,206325,91.9451871657754,6
0.05,2244,94,206419,91.94610244988864,7
0.05,2245,92,206511,91.94612644701692,9
0.05,2246,95,206606,91.94748553627058,7
0.05,2247,93,206699,91.94795373665481,8
0.05,2248,95,206794,91.94931080480214,6
0.05,2249,94,206888,91.95022222222222,7
0.05,2250,94,206982,91.95113282985339,7
0.05,2251,91,207073,91.95071047957371,10
0.05,2252,96,207169,91.95250776742121,6
0.05,2253,94,207263,91.95341614906832,8
0.05,2254,93,207356,91.95388026607539,10
0.05,2255,95,207451,91.95523049645391,6
0.05,2256,96,207547,91.95702259636685,6
0.05,2257,94,207641,91.95792736935341,7
0.05,2258,94,207735,91.95883134130146,7
0.05,2259,92,207827,91.95884955752213,9
0.05,2260,96,207923,91.96063688633348,6
0.05,2261,95,208018,91.96198054818744,6
0.05,2262,96,208114,91.9637649138312,6
0.05,2263,95,208209,91.96510600706713,6
0.05,2264,90,208299,91.96423841059602,11
0.05,2265,93,208392,91.96469549867608,8
0.05,2266,90,208482,91.96382884869872,11
0.05,2267,92,208574,91.96384479717813,9
0.05,2268,89,208663,91.96253856324373,12
0.05,2269,90,208753,91.96167400881058,11
0.05,2270,95,208848,91.96301188903567,7
0.05,2271,94,208942,91.96390845070422,7
0.05,2272,95,209037,91.96524417069952,6
0.05,2273,84,209121,91.96174142480211,17
0.05,2274,94,209215,91.96263736263737,8
0.05,2275,95,209310,91.9639718804921,6
0.05,2276,94,209404,91.96486605182257,7
0.05,2277,94,209498,91.9657594381036,7
0.05,2278,94,209592,91.96665204036859,7
0.05,2279,93,209685,91.96710526315789,8
0.05,2280,93,209778,91.96755808855765,8
0.05,2281,94,209872,91.96844872918493,7
0.05,2282,94,209966,91.96933858957512,7
0.05,2283,96,210062,91.97110332749563,6
0.05,2284,94,210156,91.97199124726477,7
0.05,2285,94,210250,91.97287839020123,7
0.05,2286,94,210344,91.973764757324,7
0.05,2287,92,210436,91.97377622377623,9
0.05,2288,95,210531,91.97509829619922,6
0.05,2289,94,210625,91.97598253275109,7
0.05,2290,96,210721,91.97773897861195,6
0.05,2291,85,210806,91.97469458987784,16
0.05,2292,92,210898,91.9747056258177,9
0.05,2293,92,210990,91.97471665213601,9
0.05,2294,90,211080,91.97385620915033,12
0.05,2295,96,211176,91.97560975609755,6
0.05,2296,94,211270,91.97649107531564,7
0.05,2297,94,211364,91.97737162750218,8
0.05,2298,94,211458,91.97825141365811,7
0.05,2299,96,211554,91.98,6
0.05,2300,94,211648,91.98087787918297,8
0.05,2301,96,211744,91.98262380538662,6
0.05,2302,95,211839,91.98393399913157,6
0.05,2303,94,211933,91.98480902777777,7
0.05,2304,92,212025,91.98481561822126,9
0.05,2305,93,212118,91.98525585429314,8
0.05,2306,94,212212,91.98612917208496,8
0.05,2307,95,212307,91.98743500866551,7
0.05,2308,92,212399,91.98744045041143,9
0.05,2309,95,212494,91.9887445887446,6
0.05,2310,92,212586,91.9887494591086,9
0.05,2311,95,212681,91.99005190311419,7
0.05,2312,94,212775,91.99092088197146,7
0.05,2313,93,212868,91.99135695764909,8
0.05,2314,94,212962,91.99222462203024,8
0.05,2315,94,213056,91.99309153713298,7
0.05,2316,95,213151,91.9943892965041,6
0.05,2317,93,213244,91.99482312338223,8
0.05,2318,94,213338,91.995687796464,7
0.05,2319,95,213433,91.99698275862069,6
0.05,2320,94,213527,91.9978457561396,7
0.05,2321,94,213621,91.99870801033592,7
0.05,2322,94,213715,91.99956952216961,7
0.05,2323,90,213805,91.9987091222031,11
0.05,2324,94,213899,91.99956989247312,7
0.05,2325,90,213989,91.99871023215822,12
0.05,2326,92,214081,91.99871078642029,9
0.05,2327,94,214175,91.99957044673539,7
0.05,2328,94,214269,92.00042936882782,7
0.05,2329,93,214362,92.00085836909871,8
0.05,2330,94,214456,92.001716001716,7
0.05,2331,95,214551,92.00300171526587,6
0.05,2332,95,214646,92.00428632661809,7
0.05,2333,94,214740,92.0051413881748,7
0.05,2334,95,214835,92.00642398286938,7
0.05,2335,94,214929,92.00727739726027,7
0.05,2336,93,215022,92.00770218228499,8
0.05,2337,93,215115,92.00812660393498,8
0.05,2338,95,215210,92.00940572894399,6
0.05,2339,89,215299,92.00811965811965,12
0.05,2340,93,215392,92.00854335753951,8
0.05,2341,94,215486,92.00939368061486,7
0.05,2342,94,215580,92.01024327784891,7
0.05,2343,95,215675,92.01151877133105,7
0.05,2344,94,215769,92.01236673773987,7
0.05,2345,95,215864,92.01364023870418,6
0.05,2346,91,215955,92.01320835108649,10
0.05,2347,92,216047,92.01320272572401,11
0.05,2348,94,216141,92.01404853128992,8
0.05,2349,94,216235,92.01489361702127,7
0.05,2350,93,216328,92.01531263292216,8
0.05,2351,94,216422,92.01615646258503,8
0.05,2352,93,216515,92.01657458563535,8
0.05,2353,95,216610,92.017841971113,6
0.05,2354,92,216702,92.01783439490445,10
0.05,2355,94,216796,92.01867572156198,8
0.05,2356,91,216887,92.0182435299109,12
0.05,2357,93,216980,92.0186598812553,10
0.05,2358,92,217072,92.01865197117422,9
0.05,2359,95,217167,92.01991525423729,6
0.05,2360,95,217262,92.02117746717492,6
0.05,2361,95,217357,92.02243861134632,6
0.05,2362,95,217452,92.02369868810834,6
0.05,2363,81,217533,92.01903553299492,21
0.05,2364,94,217627,92.01987315010571,7
0.05,2365,94,217721,92.02071005917159,7
0.05,2366,94,217815,92.02154626108998,7
0.05,2367,94,217909,92.02238175675676,7
0.05,2368,96,218005,92.02406078514142,6
0.05,2369,93,218098,92.02447257383966,9
0.05,2370,95,218193,92.0257275411219,6
0.05,2371,94,218287,92.02655986509275,7
0.05,2372,94,218381,92.02739148756848,7
0.05,2373,94,218475,92.02822240943556,8
0.05,2374,95,218570,92.02947368421053,6
0.05,2375,91,218661,92.0290404040404,10
0.05,2376,96,218757,92.03071098022718,6
0.05,2377,96,218853,92.03238015138773,6
0.05,2378,93,218946,92.0327868852459,8
0.05,2379,93,219039,92.03319327731093,8
0.05,2380,94,219133,92.0340193196136,7
0.05,2381,96,219229,92.03568429890848,6
0.05,2382,93,219322,92.0360889634914,8
0.05,2383,94,219416,92.03691275167785,8
0.05,2384,91,219507,92.03647798742138,10
0.05,2385,93,219600,92.03688181056161,8
0.05,2386,94,219694,92.03770423125262,7
0.05,2387,94,219788,92.03852596314908,7
0.05,2388,92,219880,92.03850983675179,10
0.05,2389,96,219976,92.04016736401674,6
0.05,2390,95,220071,92.04140526976161,6
0.05,2391,91,220162,92.04096989966555,10
0.05,2392,94,220256,92.04178854993732,7
0.05,2393,94,220350,92.04260651629073,7
0.05,2394,96,220446,92.04425887265135,6
0.05,2395,91,220537,92.04382303839733,10
0.05,2396,91,220628,92.04338756779308,10
0.05,2397,94,220722,92.0442035029191,7
0.05,2398,92,220814,92.04418507711546,9
0.05,2399,93,220907,92.04458333333334,8
0.05,2400,95,221002,92.04581424406497,7
0.05,2401,95,221097,92.04704412989176,6
0.05,2402,94,221191,92.04785684560966,7
0.05,2403,93,221284,92.04825291181365,8
0.05,2404,96,221380,92.04989604989605,6
0.05,2405,95,221475,92.05112219451371,6
0.05,2406,94,221569,92.0519318653926,7
0.05,2407,96,221665,92.05357142857143,6
0.05,2408,94,221759,92.05437941054379,7
0.05,2409,94,221853,92.0551867219917,7
0.05,2410,27,221880,92.02820406470344,6
0.05,2411,92,221972,92.02819237147595,9
0.05,2412,90,222062,92.02735184417737,11
0.05,2413,94,222156,92.02816901408451,8
0.05,2414,94,222250,92.02898550724638,7
0.05,2415,96,222346,92.03062913907284,6
0.05,2416,91,222437,92.03020273065783,10
0.05,2417,95,222532,92.03143093465674,6
0.05,2418,95,222627,92.0326581231914,6
0.05,2419,93,222720,92.03305785123968,8
0.05,2420,94,222814,92.0338703015283,7
0.05,2421,94,222908,92.03468208092485,7
0.05,2422,93,223001,92.03508047874536,8
0.05,2423,93,223094,92.03547854785478,8
0.05,2424,94,223188,92.03628865979381,7
0.05,2425,91,223279,92.0358615004122,10
0.05,2426,93,223372,92.03625875566543,8
0.05,2427,94,223466,92.03706754530478,7
0.05,2428,90,223556,92.03622890078222,11
0.05,2429,96,223652,92.03786008230453,6
0.05,2430,94,223746,92.0386672151378,8
0.05,2431,94,223840,92.03947368421052,7
0.05,2432,92,223932,92.03945745992601,10
0.05,2433,95,224027,92.04067378800329,6
0.05,2434,96,224123,92.04229979466119,6
0.05,2435,94,224217,92.04310344827586,7
0.05,2436,94,224311,92.04390644234715,7
0.05,2437,91,224402,92.04347826086956,10
0.05,2438,96,224498,92.04510045100452,6
0.05,2439,91,224589,92.04467213114754,10
0.05,2440,94,224683,92.04547316673495,7
0.05,2441,94,224777,92.04627354627354,7
0.05,2442,93,224870,92.04666393778142,8
0.05,2443,96,224966,92.04828150572831,6
0.05,2444,96,225062,92.04989775051125,6
0.05,2445,93,225155,92.05028618152085,8
0.05,2446,95,225250,92.05149162239476,6
0.05,2447,95,225345,92.05269607843137,6
0.05,2448,94,225439,92.0534912209065,8
0.05,2449,96,225535,92.05510204081632,6
0.05,2450,94,225629,92.05589555283558,7
0.05,2451,93,225722,92.0562805872757,8
0.05,2452,95,225817,92.05748063595597,7
0.05,2453,94,225911,92.05827220863895,7
0.05,2454,96,226007,92.05987780040734,6
0.05,2455,94,226101,92.060667752443,7
0.05,2456,92,226193,92.06064306064306,9
0.05,2457,94,226287,92.06143205858422,8
0.05,2458,96,226383,92.06303375355836,6
0.05,2459,92,226475,92.0630081300813,9
0.05,2460,95,226570,92.06420154408777,6
0.05,2461,93,226663,92.06458164094232,8
0.05,2462,92,226755,92.06455542021925,9
0.05,2463,95,226850,92.06574675324676,7
0.05,2464,92,226942,92.06572008113591,9
0.05,2465,93,227035,92.06609894566098,10
0.05,2466,93,227128,92.06647750304013,8
0.05,2467,94,227222,92.06726094003241,7
0.05,2468,93,227315,92.06763872012961,8
0.05,2469,94,227409,92.06842105263158,7
0.05,2470,92,227501,92.06839336301093,9
0.05,2471,94,227595,92.06917475728156,7
0.05,2472,95,227690,92.0703598867772,6
0.05,2473,95,227785,92.07154405820533,6
0.05,2474,95,227880,92.07272727272728,6
0.05,2475,95,227975,92.07390953150242,6
0.05,2476,94,228069,92.07468712151797,7
0.05,2477,94,228163,92.07546408393866,7
0.05,2478,93,228256,92.07583703106091,8
0.05,2479,94,228350,92.07661290322581,7
0.05,2480,94,228444,92.07738814993954,7
0.05,2481,96,228540,92.07896857373086,6
0.05,2482,92,228632,92.07893677003625,10
0.05,2483,96,228728,92.0805152979066,6
0.05,2484,92,228820,92.0804828973843,9
0.05,2485,94,228914,92.08125502815768,7
0.05,2486,95,229009,92.08242862887012,6
0.05,2487,94,229103,92.08319935691318,8
0.05,2488,93,229196,92.08356769787063,9
0.05,2489,95,229291,92.0847389558233,6
0.05,2490,94,229385,92.08550782818145,7
0.05,2491,91,229476,92.08507223113965,10
0.05,2492,96,229572,92.08664259927798,6
0.05,2493,92,229664,92.08660785886127,9
0.05,2494,91,229755,92.08617234468937,10
0.05,2495,91,229846,92.08573717948718,10
0.05,2496,91,229937,92.0853023628354,10
0.05,2497,90,230027,92.08446757405925,11
0.05,2498,96,230123,92.0860344137655,6
0.05,2499,93,230216,92.0864,8
0.05,2500,87,230303,92.0843662534986,14
0.05,2501,94,230397,92.08513189448442,7
0.05,2502,92,230489,92.08509788254095,10
0.05,2503,95,230584,92.08626198083067,7
0.05,2504,93,230677,92.08662674650698,8
0.05,2505,94,230771,92.08739026336792,7
0.05,2506,94,230865,92.08815317112087,7
0.05,2507,92,230957,92.08811802232854,10
0.05,2508,95,231052,92.08927859705062,6
0.05,2509,27,231079,92.06334661354582,6
0.05,2510,96,231175,92.06491437674234,6
0.05,2511,94,231269,92.0656847133758,7
0.05,2512,95,231364,92.06685236768803,7
0.05,2513,94,231458,92.06762132060462,7
0.05,2514,94,231552,92.06838966202783,7
0.05,2515,95,231647,92.06955484896662,7
0.05,2516,95,231742,92.07071911005166,8
0.05,2517,94,231836,92.07148530579825,9
0.05,2518,95,231931,92.07264787614133,7
0.05,2519,91,232022,92.07222222222222,10
0.05,2520,94,232116,92.07298690995637,7
0.05,2521,96,232212,92.07454401268835,6
0.05,2522,96,232308,92.07609988109394,6
0.05,2523,88,232396,92.07448494453249,14
0.05,2524,93,232489,92.07485148514851,8
0.05,2525,94,232583,92.07561361836896,7
0.05,2526,94,232677,92.0763751483973,7
0.05,2527,91,232768,92.07594936708861,10
0.05,2528,94,232862,92.07671016211941,7
0.05,2529,93,232955,92.07707509881423,8
0.05,2530,92,233047,92.07704464638483,9
0.05,2531,85,233132,92.07424960505529,16
0.05,2532,96,233228,92.0757994472957,6
0.05,2533,96,233324,92.07734806629834,6
0.05,2534,95,233419,92.07850098619329,8
0.05,2535,95,233514,92.07965299684543,6
0.05,2536,94,233608,92.08040993299173,7
0.05,2537,94,233702,92.08116627265564,7
0.05,2538,94,233796,92.08192201654195,7
0.05,2539,94,233890,92.08267716535433,7
0.05,2540,94,233984,92.08343171979536,7
0.05,2541,95,234079,92.08457907159716,6
0.05,2542,93,234172,92.08493904836807,9
0.05,2543,95,234267,92.08608490566037,6
0.05,2544,95,234362,92.08722986247544,6
0.05,2545,93,234455,92.08758837391987,8
0.05,2546,91,234546,92.08716136631331,10
0.05,2547,94,234640,92.08791208791209,7
0.05,2548,92,234732,92.08787759905846,9
0.05,2549,91,234823,92.08745098039216,10
0.05,2550,96,234919,92.0889847118777,6
0.05,2551,92,235011,92.08894984326018,9
0.05,2552,91,235102,92.0885233059146,10
0.05,2553,94,235196,92.08927173061863,7
0.05,2554,93,235289,92.08962818003914,9
0.05,2555,94,235383,92.09037558685446,7
0.05,2556,27,235410,92.06491982792335,6
0.05,2557,89,235499,92.06372165754496,12
0.05,2558,92,235591,92.06369675654553,9
0.05,2559,96,235687,92.065234375,6
0.05,2560,95,235782,92.06638032018742,6
0.05,2561,94,235876,92.06713505074161,8
0.05,2562,95,235971,92.06827936012485,7
0.05,2563,93,236064,92.06864274570982,8
0.05,2564,94,236158,92.06939571150097,9
0.05,2565,91,236249,92.06897895557287,11
0.05,2566,95,236344,92.0701207635372,6
0.05,2567,92,236436,92.07009345794393,9
0.05,2568,94,236530,92.0708446866485,7
0.05,2569,94,236624,92.0715953307393,7
0.05,2570,93,236717,92.07195643718397,8
0.05,2571,94,236811,92.07270606531881,7
0.05,2572,95,236906,92.07384376214536,6
0.05,2573,92,236998,92.07381507381507,9
0.05,2574,94,237092,92.07456310679612,7
0.05,2575,96,237188,92.07608695652173,6
0.05,2576,96,237284,92.07760962359333,6
0.05,2577,94,237378,92.07835531419705,7
0.05,2578,95,237473,92.07948817371074,6
0.05,2579,93,237566,92.07984496124031,8
0.05,2580,94,237660,92.08058891902364,8
0.05,2581,94,237754,92.08133230054221,8
0.05,2582,94,237848,92.08207510646535,7
0.05,2583,96,237944,92.08359133126935,6
0.05,2584,92,238036,92.08355899419729,9
0.05,2585,94,238130,92.08430007733952,7
0.05,2586,94,238224,92.08504058755315,7
0.05,2587,94,238318,92.08578052550232,8
0.05,2588,92,238410,92.08574739281576,9
0.05,2589,27,238437,92.06061776061776,6
0.05,2590,94,238531,92.06136626785025,9
0.05,2591,94,238625,92.06211419753086,7
0.05,2592,93,238718,92.06247589664481,8
0.05,2593,92,238810,92.06245181187356,9
0.05,2594,96,238906,92.06396917148362,6
0.05,2595,96,239002,92.06548536209553,6
0.05,2596,92,239094,92.06546014632268,9
0.05,2597,93,239187,92.06581986143188,8
0.05,2598,94,239281,92.0665640631012,8
0.05,2599,96,239377,92.06807692307693,6
0.05,2600,88,239465,92.06651287966167,15
0.05,2601,92,239557,92.06648731744812,9
0.05,2602,92,239649,92.06646177487515,9
0.05,2603,94,239743,92.06720430107526,7
0.05,2604,94,239837,92.06794625719769,7
0.05,2605,96,239933,92.06945510360705,6
0.05,2606,27,239960,92.04449558879939,6
0.05,2607,94,240054,92.045245398773,7
0.05,2608,94,240148,92.04599463395937,7
0.05,2609,92,240240,92.04597701149426,9
0.05,2610,91,240331,92.0455764075067,10
0.05,2611,95,240426,92.04670750382849,6
0.05,2612,95,240521,92.0478377344049,6
0.05,2613,94,240615,92.048584544759,7
0.05,2614,95,240710,92.04971319311663,6
0.05,2615,95,240805,92.05084097859327,6
0.05,2616,92,240897,92.05082155139473,9
0.05,2617,95,240992,92.05194805194805,6
0.05,2618,94,241086,92.05269186712486,7
0.05,2619,94,241180,92.05343511450381,8
0.05,2620,94,241274,92.05417779473484,7
0.05,2621,95,241369,92.05530129672006,6
0.05,2622,27,241396,92.03049942813573,6
0.05,2623,95,241491,92.03163109756098,6
0.05,2624,94,241585,92.03238095238095,7
0.05,2625,94,241679,92.03313023610053,7
0.05,2626,92,241771,92.03311762466691,9
0.05,2627,93,241864,92.03348554033485,8
0.05,2628,95,241959,92.03461392164321,6
0.05,2629,96,242055,92.0361216730038,6
0.05,2630,92,242147,92.03610794374762,10
0.05,2631,94,242241,92.03685410334346,7
0.05,2632,92,242333,92.03684010634258,10
0.05,2633,96,242429,92.03834472285497,6
0.05,2634,94,242523,92.03908918406073,8
0.05,2635,94,242617,92.03983308042488,7
0.05,2636,89,242706,92.0386803185438,12
0.05,2637,95,242801,92.03980288097043,7
0.05,2638,96,242897,92.04130352406214,6
0.05,2639,94,242991,92.04204545454546,7
0.05,2640,94,243085,92.04278682317305,7
0.05,2641,95,243180,92.0439061317184,6
0.05,2642,93,243273,92.04426787741203,8
0.05,2643,95,243368,92.04538577912254,7
0.05,2644,95,243463,92.04650283553875,6
0.05,2645,95,243558,92.04761904761905,7
0.05,2646,95,243653,92.04873441632036,6
0.05,2647,94,243747,92.04947129909365,7
0.05,2648,95,243842,92.05058512646282,7
0.05,2649,94,243936,92.05132075471698,7
0.05,2650,95,244031,92.05243304413429,6
0.05,2651,92,244123,92.0524132730015,9
0.05,2652,93,244216,92.05277044854881,8
0.05,2653,91,244307,92.05237377543331,10
0.05,2654,95,244402,92.05348399246704,6
0.05,2655,95,244497,92.05459337349397,7
0.05,2656,94,244591,92.05532555513737,7
0.05,2657,94,244685,92.05605718585403,7
0.05,2658,96,244781,92.05754042873261,6
0.05,2659,95,244876,92.05864661654135,6
0.05,2660,95,244971,92.05975197294251,6
0.05,2661,96,245067,92.06123215627348,6
0.05,2662,92,245159,92.06120916259857,10
0.05,2663,24,245183,92.03566066066067,8
0.05,2664,95,245278,92.03677298311445,6
0.05,2665,95,245373,92.03788447111778,6
0.05,2666,94,245467,92.03862017247845,7
0.05,2667,92,245559,92.03860569715143,11
0.05,2668,95,245654,92.03971524915698,7
0.05,2669,92,245746,92.03970037453183,9
0.05,2670,94,245840,92.0404342942718,7
0.05,2671,95,245935,92.04154191616766,6
0.05,2672,94,246029,92.04227459783016,8
0.05,2673,95,246124,92.04338070306656,6
0.05,2674,89,246213,92.0422429906542,12
0.05,2675,94,246307,92.04297458893872,7
0.05,2676,94,246401,92.04370564064251,7
0.05,2677,94,246495,92.04443614637789,7
0.05,2678,92,246587,92.04441955953715,9
0.05,2679,94,246681,92.04514925373134,7
0.05,2680,93,246774,92.04550540842969,8
0.05,2681,94,246868,92.04623415361671,7
0.05,2682,94,246962,92.04696235557212,7
0.05,2683,94,247056,92.04769001490313,7
0.05,2684,92,247148,92.04767225325885,9
0.05,2685,94,247242,92.04839910647803,7
0.05,2686,94,247336,92.04912541868255,7
0.05,2687,92,247428,92.04910714285714,9
0.05,2688,95,247523,92.0502045370026,6
0.05,2689,90,247613,92.04944237918215,11
0.05,2690,94,247707,92.05016722408027,7
0.05,2691,95,247802,92.05126300148588,7
0.05,2692,94,247896,92.0519866320089,7
0.05,2693,92,247988,92.05196733481812,9
0.05,2694,89,248077,92.05083487940631,12
0.05,2695,94,248171,92.05155786350149,7
0.05,2696,95,248266,92.05265109380794,6
0.05,2697,93,248359,92.05300222386953,8
0.05,2698,93,248452,92.05335309373842,8
0.05,2699,96,248548,92.05481481481482,6
0.05,2700,93,248641,92.05516475379488,8
0.05,2701,95,248736,92.05625462620281,6
0.05,2702,94,248830,92.05697373288938,8
0.05,2703,94,248924,92.0576923076923,7
0.05,2704,92,249016,92.05767097966728,9
0.05,2705,94,249110,92.05838876570584,8
0.05,2706,94,249204,92.05910602142593,7
0.05,2707,94,249298,92.05982274741507,7
0.05,2708,93,249391,92.06016980435585,8
0.05,2709,93,249484,92.06051660516606,8
0.05,2710,94,249578,92.06123201770565,7
0.05,2711,95,249673,92.0623156342183,7
0.05,2712,95,249768,92.06339845189827,7
0.05,2713,93,249861,92.06374355195284,8
0.05,2714,90,249951,92.06298342541436,11
0.05,2715,95,250046,92.0640648011782,6
0.05,2716,95,250141,92.06514538093485,6
0.05,2717,96,250237,92.06659308314937,6
0.05,2718,93,250330,92.06693637366679,8
0.05,2719,94,250424,92.06764705882352,7
0.05,2720,92,250516,92.06762219772142,9
0.05,2721,95,250611,92.0686994856723,6
0.05,2722,96,250707,92.07014322438486,6
0.05,2723,95,250802,92.0712187958884,7
0.05,2724,94,250896,92.07192660550459,7
0.05,2725,94,250990,92.07263389581804,8
0.05,2726,90,251080,92.07187385405207,11
0.05,2727,93,251173,92.07221407624634,8
0.05,2728,91,251264,92.07182117991938,10
0.05,2729,96,251360,92.07326007326007,6
0.05,2730,95,251455,92.07433174661296,6
0.05,2731,95,251550,92.07540263543191,6
0.05,2732,94,251644,92.07610684229785,7
0.05,2733,91,251735,92.07571324067301,10
0.05,2734,96,251831,92.07714808043876,6
0.05,2735,91,251922,92.07675438596492,10
0.05,2736,95,252017,92.07782243332116,6
0.05,2737,94,252111,92.07852447041637,7
0.05,2738,96,252207,92.07995618838993,6
0.05,2739,94,252301,92.08065693430657,7
0.05,2740,96,252397,92.08208682962423,6
0.05,2741,94,252491,92.08278628738147,7
0.05,2742,27,252518,92.05905942398833,6
0.05,2743,94,252612,92.0597667638484,7
0.05,2744,90,252702,92.05901639344262,12
0.05,2745,94,252796,92.05972323379461,7
0.05,2746,96,252892,92.06115762650164,6
0.05,2747,90,252982,92.06040756914119,11
0.05,2748,93,253075,92.06074936340488,8
0.05,2749,94,253169,92.06145454545455,7
0.05,2750,94,253263,92.06215921483097,7
0.05,2751,94,253357,92.06286337209302,7
0.05,2752,94,253451,92.06356701779876,8
0.05,2753,94,253545,92.06427015250544,7
0.05,2754,94,253639,92.06497277676951,8
0.05,2755,95,253734,92.06603773584905,6
0.05,2756,95,253829,92.0671019223794,7
0.05,2757,94,253923,92.06780275562001,7
0.05,2758,96,254019,92.0692279811526,6
0.05,2759,92,254111,92.06920289855073,9
0.05,2760,92,254203,92.06917783411808,9
0.05,2761,95,254298,92.07023895727734,7
0.05,2762,23,254321,92.04524068041984,9
0.05,2763,96,254417,92.04667149059334,6
0.05,2764,95,254512,92.04773960216998,6
0.05,2765,91,254603,92.04736080983369,11
0.05,2766,95,254698,92.04842790025297,6
0.05,2767,94,254792,92.04913294797687,7
0.05,2768,95,254887,92.05019862766342,6
0.05,2769,90,254977,92.0494584837545,11
0.05,2770,94,255071,92.05016239624685,7
0.05,2771,93,255164,92.05050505050505,8
0.05,2772,94,255258,92.05120807789397,7
0.05,2773,93,255351,92.05155010814708,8
0.05,2774,93,255444,92.0518918918919,9
0.05,2775,96,255540,92.05331412103746,6
0.05,2776,93,255633,92.05365502340655,8
0.05,2777,96,255729,92.05507559395248,6
0.05,2778,96,255825,92.05649514213746,6
0.05,2779,95,255920,92.05755395683454,6
0.05,2780,96,256016,92.05897159295218,6
0.05,2781,94,256110,92.05966930265996,7
0.05,2782,94,256204,92.0603665109594,8
0.05,2783,95,256299,92.06142241379311,6
0.05,2784,95,256394,92.06247755834829,7
0.05,2785,95,256489,92.0635319454415,6
0.05,2786,89,256578,92.06243272335846,12
0.05,2787,23,256601,92.03766140602582,9
0.05,2788,94,256695,92.03836500537827,7
0.05,2789,91,256786,92.03799283154122,10
0.05,2790,93,256879,92.03833751343605,8
0.05,2791,90,256969,92.03760744985674,11
0.05,2792,93,257062,92.03795202291442,8
0.05,2793,94,257156,92.0386542591267,8
0.05,2794,95,257251,92.0397137745975,6
0.05,2795,95,257346,92.04077253218884,8
0.05,2796,94,257440,92.041473006793,7
0.05,2797,94,257534,92.0421729807005,7
0.05,2798,95,257629,92.04322972490175,6
0.05,2799,90,257719,92.0425,12
0.05,2800,94,257813,92.04319885755088,7
0.05,2801,27,257840,92.01998572448251,6
0.05,2802,95,257935,92.02104887620406,6
0.05,2803,94,258029,92.02175463623395,7
0.05,2804,93,258122,92.02210338680926,8
0.05,2805,86,258208,92.01995723449751,16
0.05,2806,94,258302,92.02066262914143,7
0.05,2807,92,258394,92.02065527065527,9
0.05,2808,93,258487,92.02100391598434,8
0.05,2809,94,258581,92.02170818505338,7
0.05,2810,25,258606,91.99786552828175,8
0.05,2811,96,258702,91.99928876244665,6
0.05,2812,94,258796,92.0,7
0.05,2813,90,258886,91.99928926794598,11
0.05,2814,91,258977,91.99893428063943,11
0.05,2815,95,259072,92.0,6
0.05,2816,95,259167,92.0010649627263,6
0.05,2817,94,259261,92.00177430801988,7
0.05,2818,91,259352,92.00141894288755,10
0.05,2819,27,259379,91.97836879432624,6
0.05,2820,93,259472,91.97873094647288,8
0.05,2821,91,259563,91.97838412473423,10
0.05,2822,94,259657,91.97910024796316,7
0.05,2823,95,259752,91.98016997167139,7
0.05,2824,96,259848,91.98159292035398,6
0.05,2825,94,259942,91.98230714791224,7
0.05,2826,27,259969,91.95932083480722,6
0.05,2827,91,260060,91.95898161244696,10
0.05,2828,94,260154,91.95970307529163,7
0.05,2829,93,260247,91.96007067137809,8
0.05,2830,95,260342,91.96114447191805,7
0.05,2831,26,260368,91.93785310734464,8
0.05,2832,94,260462,91.93858100953054,7
0.05,2833,96,260558,91.94001411432605,6
0.05,2834,91,260649,91.93968253968254,10
0.05,2835,95,260744,91.9407616361072,6
0.05,2836,93,260837,91.94113500176242,8
0.05,2837,95,260932,91.94221282593375,7
0.05,2838,94,261026,91.94293765410356,7
0.05,2839,96,261122,91.9443661971831,6
0.05,2840,94,261216,91.94508975712777,7
0.05,2841,92,261308,91.945109078114,9
0.05,2842,95,261403,91.94618360886388,6
0.05,2843,93,261496,91.9465541490858,8
0.05,2844,94,261590,91.94727592267135,8
0.05,2845,94,261684,91.94799718903724,8
0.05,2846,27,261711,91.92518440463645,6
0.05,2847,96,261807,91.92661516853933,6
0.05,2848,94,261901,91.92734292734293,8
0.05,2849,93,261994,91.92771929824562,8
0.05,2850,96,262090,91.9291476674851,6
0.05,2851,92,262182,91.92917251051894,9
0.05,2852,94,262276,91.92989835261129,7
0.05,2853,93,262369,91.93027330063069,9
0.05,2854,94,262463,91.93099824868652,7
0.05,2855,90,262553,91.93032212885154,12
0.05,2856,95,262648,91.9313965698285,6
0.05,2857,92,262740,91.93142057382785,9
0.05,2858,94,262834,91.93214410633088,7
0.05,2859,96,262930,91.93356643356644,6
0.05,2860,23,262953,91.90947221251311,10
0.05,2861,96,263049,91.91090146750524,6
0.05,2862,93,263142,91.91128187216206,8
0.05,2863,95,263237,91.91236033519553,6
0.05,2864,92,263329,91.91239092495637,9
0.05,2865,95,263424,91.91346824842987,6
0.05,2866,95,263519,91.91454482036973,6
0.05,2867,94,263613,91.9152719665272,7
0.05,2868,96,263709,91.91669571279192,6
0.05,2869,95,263804,91.9177700348432,7
0.05,2870,96,263900,91.91919191919192,6
0.05,2871,94,263994,91.91991643454038,8
0.05,2872,96,264090,91.92133658197007,6
0.05,2873,92,264182,91.92136395267919,9
0.05,2874,95,264277,91.92243478260869,6
0.05,2875,94,264371,91.92315716272601,7
0.05,2876,27,264398,91.90059089329162,6
0.05,2877,93,264491,91.90097289784573,8
0.05,2878,92,264583,91.90100729419937,9
0.05,2879,96,264679,91.90243055555555,6
0.05,2880,94,264773,91.90315862547726,8
0.05,2881,94,264867,91.90388619014573,7
0.05,2882,94,264961,91.90461325008671,7
0.05,2883,95,265056,91.90568654646324,6
0.05,2884,95,265151,91.90675909878682,6
0.05,2885,92,265243,91.90679140679141,9
0.05,2886,92,265335,91.90682369241426,9
0.05,2887,94,265429,91.9075484764543,7
0.05,2888,94,265523,91.90827275874005,7
0.05,2889,93,265616,91.90865051903114,8
0.05,2890,96,265712,91.91006572120374,6
0.05,2891,94,265806,91.91078838174273,7
0.05,2892,94,265900,91.91151054268926,7
0.05,2893,95,265995,91.91257774706288,6
0.05,2894,93,266088,91.91295336787564,8
0.05,2895,92,266180,91.91298342541437,9
0.05,2896,94,266274,91.91370383154988,7
0.05,2897,94,266368,91.9144237405107,7
0.05,2898,94,266462,91.91514315281131,7
0.05,2899,27,266489,91.89275862068966,6
0.05,2900,96,266585,91.89417442261289,6
0.05,2901,94,266679,91.89490006891799,8
0.05,2902,93,266772,91.89528074405787,9
0.05,2903,95,266867,91.89634986225896,6
0.05,2904,96,266963,91.89776247848538,6
0.05,2905,95,267058,91.8988300068823,6
0.05,2906,94,267152,91.89955280357758,7
0.05,2907,94,267246,91.9002751031637,7
0.05,2908,94,267340,91.90099690615332,7
0.05,2909,96,267436,91.90240549828178,6
0.05,2910,92,267528,91.90243902439025,10
0.05,2911,93,267621,91.90281593406593,8
0.05,2912,95,267716,91.90387916237556,6
0.05,2913,96,267812,91.90528483184626,6
0.05,2914,91,267903,91.90497427101201,10
0.05,2915,94,267997,91.9056927297668,7
0.05,2916,94,268091,91.90641069592047,8
0.05,2917,96,268187,91.907813570939,6
0.05,2918,95,268282,91.90887290167866,6
0.05,2919,96,268378,91.91027397260274,6
0.05,2920,93,268471,91.91064703868538,8
0.05,2921,95,268566,91.91170431211499,6
0.05,2922,96,268662,91.91310297639411,6
0.05,2923,95,268757,91.9141586867305,6
0.05,2924,94,268851,91.9148717948718,7
0.05,2925,94,268945,91.91558441558442,8
0.05,2926,92,269037,91.9156132558934,9
0.05,2927,93,269130,91.91598360655738,9
0.05,2928,95,269225,91.91703653123933,6
0.05,2929,92,269317,91.91706484641638,9
0.05,2930,93,269410,91.91743432275673,8
0.05,2931,96,269506,91.91882673942702,6
0.05,2932,94,269600,91.91953631094442,7
0.05,2933,92,269692,91.91956373551466,11
0.05,2934,92,269784,91.91959114139694,9
0.05,2935,95,269879,91.92064032697547,6
0.05,2936,94,269973,91.92134831460675,7
0.05,2937,96,270069,91.92273655547991,6
0.05,2938,94,270163,91.92344334807758,7
0.05,2939,89,270252,91.92244897959183,12
0.05,2940,92,270344,91.9224753485209,9
0.05,2941,96,270440,91.92386131883073,6
0.05,2942,94,270534,91.92456676860347,7
0.05,2943,93,270627,91.92493206521739,8
0.05,2944,93,270720,91.92529711375212,8
0.05,2945,92,270812,91.92532247114733,9
0.05,2946,24,270836,91.90227349847302,8
0.05,2947,96,270932,91.90366350067842,6
0.05,2948,96,271028,91.9050525601899,6
0.05,2949,92,271120,91.90508474576271,9
0.05,2950,95,271215,91.90613351406303,6
0.05,2951,92,271307,91.90616531165311,9
0.05,2952,96,271403,91.90755164239756,6
0.05,2953,93,271496,91.90792146242383,8
0.05,2954,92,271588,91.90795262267343,9
0.05,2955,94,271682,91.9086603518268,7
0.05,2956,95,271777,91.90970578288807,6
0.05,2957,94,271871,91.9104124408384,7
0.05,2958,91,271962,91.91010476512335,10
0.05,2959,95,272057,91.91114864864865,6
0.05,2960,94,272151,91.91185410334346,7
0.05,2961,94,272245,91.91255908170156,7
0.05,2962,91,272336,91.91225109686128,10
0.05,2963,94,272430,91.91295546558705,7
0.05,2964,95,272525,91.91399662731872,6
0.05,2965,94,272619,91.91469993256912,7
0.05,2966,95,272714,91.91573980451635,7
0.05,2967,96,272810,91.91711590296497,6
0.05,2968,94,272904,91.91781744695183,7
0.05,2969,96,273000,91.91919191919192,6
0.05,2970,95,273095,91.92022887916526,6
0.05,2971,96,273191,91.92160161507402,6
0.05,2972,94,273285,91.92230070635722,7
0.05,2973,94,273379,91.92299932750504,8
0.05,2974,94,273473,91.9236974789916,7
0.05,2975,21,273494,91.89986559139786,11
0.05,2976,94,273588,91.90057104467584,7
0.05,2977,92,273680,91.90060443250503,9
0.05,2978,94,273774,91.90130916414904,7
0.05,2979,91,273865,91.9010067114094,10
0.05,2980,96,273961,91.90238175109023,6
0.05,2981,91,274052,91.90207914151576,10
0.05,2982,94,274146,91.90278243379149,7
0.05,2983,94,274240,91.90348525469169,7
0.05,2984,94,274334,91.90418760469012,7
0.05,2985,93,274427,91.9045545880777,8
0.05,2986,89,274516,91.90358218948778,12
0.05,2987,94,274610,91.90428380187416,7
0.05,2988,92,274702,91.90431582469053,9
0.05,2989,92,274794,91.90434782608696,9
0.05,2990,96,274890,91.90571715145437,6
0.05,2991,92,274982,91.9057486631016,9
0.05,2992,94,275076,91.90644837955229,7
0.05,2993,96,275172,91.90781563126252,6
0.05,2994,95,275267,91.90884808013355,6
0.05,2995,94,275361,91.90954606141523,7
0.05,2996,94,275455,91.91024357691025,7
0.05,2997,92,275547,91.91027351567712,10
0.05,2998,94,275641,91.91097032344115,7
0.05,2999,91,275732,91.91066666666667,10
0.05,3000,91,275823,91.91036321226258,10
0.05,3001,94,275917,91.91105929380413,7
0.05,3002,94,276011,91.91175491175491,7
0.05,3003,94,276105,91.91245006657789,7
0.05,3004,93,276198,91.91281198003328,8
0.05,3005,93,276291,91.91317365269461,8
0.05,3006,91,276382,91.91286997006983,11
0.05,3007,95,276477,91.91389627659575,7
0.05,3008,94,276571,91.91458956463941,7
0.05,3009,92,276663,91.91461794019934,9
0.05,3010,96,276759,91.91597475921621,6
0.05,3011,94,276853,91.91666666666667,7
0.05,3012,92,276945,91.91669432459342,10
0.05,3013,27,276972,91.89515593895156,6
0.05,3014,93,277065,91.8955223880597,8
0.05,3015,92,277157,91.89555702917772,9
0.05,3016,92,277249,91.89559164733178,9
0.05,3017,94,277343,91.89628893306826,7
0.05,3018,92,277435,91.89632328585624,9
0.05,3019,93,277528,91.89668874172186,8
0.05,3020,90,277618,91.89606090698445,11
0.05,3021,91,277709,91.89576439444076,10
0.05,3022,96,277805,91.89712206417467,6
0.05,3023,93,277898,91.89748677248677,8
0.05,3024,26,277924,91.87570247933884,7
0.05,3025,94,278018,91.87640449438203,7
0.05,3026,92,278110,91.87644532540469,9
0.05,3027,92,278202,91.87648612945839,9
0.05,3028,94,278296,91.87718719049191,7
0.05,3029,96,278392,91.87854785478548,6
0.05,3030,96,278488,91.87990762124711,6
0.05,3031,92,278580,91.87994722955145,9
0.05,3032,92,278672,91.87998681173755,10
0.05,3033,93,278765,91.88035596572182,8
0.05,3034,94,278859,91.8810543657331,7
0.05,3035,95,278954,91.88208168642952,6
0.05,3036,95,279049,91.8831083305894,6
0.05,3037,94,279143,91.88380513495721,7
0.05,3038,90,279233,91.88318525830866,11
0.05,3039,94,279327,91.88388157894737,7
0.05,3040,96,279423,91.88523512002631,6
0.05,3041,94,279517,91.88593030900724,7
0.05,3042,94,279611,91.88662504107788,7
0.05,3043,90,279701,91.88600525624179,11
0.05,3044,95,279796,91.88702791461412,7
0.05,3045,96,279892,91.88837820091923,6
0.05,3046,94,279986,91.88907121759107,7
0.05,3047,93,280079,91.88943569553805,8
0.05,3048,92,280171,91.88947195801902,9
0.05,3049,94,280265,91.89016393442623,7
0.05,3050,95,280360,91.89118321861685,6
0.05,3051,92,280452,91.89121887287025,10
0.05,3052,94,280546,91.89190959711759,7
0.05,3053,90,280636,91.89129011132941,11
0.05,3054,93,280729,91.89165302782324,8
0.05,3055,93,280822,91.89201570680628,8
0.05,3056,95,280917,91.89303238469087,7
0.05,3057,94,281011,91.89372138652715,7
0.05,3058,90,281101,91.89310232101994,14
0.05,3059,93,281194,91.89346405228758,8
0.05,3060,96,281290,91.89480561907874,6
0.05,3061,94,281384,91.89549314173743,7
0.05,3062,95,281479,91.89650669278485,7
0.05,3063,94,281573,91.89719321148826,7
0.05,3064,93,281666,91.89755301794453,8
0.05,3065,95,281761,91.89856490541422,6
0.05,3066,96,281857,91.89990218454516,6
0.05,3067,92,281949,91.89993481095176,10
0.05,3068,95,282044,91.900944933203,6
0.05,3069,94,282138,91.90162866449512,7
0.05,3070,93,282231,91.90198632367307,8
0.05,3071,94,282325,91.90266927083333,7
0.05,3072,93,282418,91.90302635860722,8
0.05,3073,90,282508,91.90240728692258,11
0.05,3074,93,282601,91.90276422764228,9
0.05,3075,90,282691,91.9021456436931,11
0.05,3076,92,282783,91.90217744556386,9
0.05,3077,94,282877,91.90285899935023,7
0.05,3078,94,282971,91.90354011042547,8
0.05,3079,93,283064,91.9038961038961,8
0.05,3080,95,283159,91.90490100616682,6
0.05,3081,96,283255,91.90622972096041,6
0.05,3082,95,283350,91.90723321440156,6
0.05,3083,95,283445,91.90823605706875,6
0.05,3084,96,283541,91.9095623987034,6
0.05,3085,92,283633,91.90959170447181,9
0.05,3086,95,283728,91.910592808552,7
0.05,3087,95,283823,91.91159326424871,6
0.05,3088,90,283913,91.91097442538039,11
0.05,3089,95,284008,91.91197411003236,6
0.05,3090,95,284103,91.91297314784859,7
0.05,3091,92,284195,91.91300129366105,9
0.05,3092,93,284288,91.91335273197542,9
0.05,3093,93,284381,91.9137039431157,8
0.05,3094,92,284473,91.91373182552503,11
0.05,3095,92,284565,91.91375968992249,9
0.05,3096,94,284659,91.91443332257023,7
0.05,3097,94,284753,91.9151065203357,7
0.05,3098,95,284848,91.91610196837689,6
0.05,3099,93,284941,91.91645161290323,8
0.05,3100,94,285035,91.91712350854563,7
0.05,3101,96,285131,91.91843971631205,6
0.05,3102,94,285225,91.91911053818885,7
0.05,3103,96,285321,91.92042525773196,6
0.05,3104,94,285415,91.92109500805152,7
0.05,3105,94,285509,91.92176432710882,7
0.05,3106,95,285604,91.92275506919859,6
0.05,3107,93,285697,91.92310167310167,8
0.05,3108,93,285790,91.92344805403667,8
0.05,3109,91,285881,91.92315112540193,10
0.05,3110,94,285975,91.923818707811,8
0.05,3111,94,286069,91.92448586118252,7
0.05,3112,94,286163,91.92515258592996,7
0.05,3113,94,286257,91.92581888246629,7
0.05,3114,92,286349,91.92584269662922,9
0.05,3115,95,286444,91.92682926829268,6
0.05,3116,88,286532,91.925569457812,13
0.05,3117,94,286626,91.92623476587556,7
0.05,3118,93,286719,91.92657903174094,8
0.05,3119,93,286812,91.92692307692307,8
0.05,3120,92,286904,91.92694649150913,10
0.05,3121,96,287000,91.92825112107623,6
0.05,3122,96,287096,91.92955491514569,6
0.05,3123,95,287191,91.93053777208706,6
0.05,3124,94,287285,91.9312,7
0.05,3125,96,287381,91.93250159948816,6
0.05,3126,96,287477,91.93380236648545,6
0.05,3127,95,287572,91.93478260869566,6
0.05,3128,93,287665,91.9351230425056,8
0.05,3129,92,287757,91.93514376996805,10
0.05,3130,95,287852,91.93612264452251,6
0.05,3131,95,287947,91.93710089399744,7
0.05,3132,95,288042,91.93807851899138,6
0.05,3133,96,288138,91.93937460114869,6
0.05,3134,94,288232,91.94003189792663,7
0.05,3135,95,288327,91.94100765306122,6
0.05,3136,92,288419,91.94102645839975,9
0.05,3137,96,288515,91.94231994901212,6
0.05,3138,94,288609,91.94297546989488,7
0.05,3139,91,288700,91.94267515923566,10
0.05,3140,94,288794,91.94333014963388,7
0.05,3141,92,288886,91.94334818586887,9
0.05,3142,95,288981,91.94432071269487,6
0.05,3143,95,289076,91.94529262086515,6
0.05,3144,93,289169,91.9456279809221,8
0.05,3145,94,289263,91.94628099173553,7
0.05,3146,94,289357,91.9469335875437,7
0.05,3147,91,289448,91.94663278271919,10
0.05,3148,94,289542,91.94728485233408,7
0.05,3149,91,289633,91.94698412698413,10
0.05,3150,95,289728,91.94795303078388,6
0.05,3151,96,289824,91.94923857868021,6
0.05,3152,90,289914,91.94862036156042,11
0.05,3153,96,290010,91.94990488268864,6
0.05,3154,88,290098,91.9486529318542,13
0.05,3155,96,290194,91.94993662864385,6
0.05,3156,92,290286,91.94995248653785,9
0.05,3157,95,290381,91.95091830272324,7
0.05,3158,94,290475,91.95156695156695,7
0.05,3159,94,290569,91.95221518987341,7
0.05,3160,95,290664,91.95317937361594,7
0.05,3161,92,290756,91.95319418089817,9
0.05,3162,92,290848,91.95320897881759,9
0.05,3163,94,290942,91.95385587863464,7
0.05,3164,93,291035,91.95418641390205,8
0.05,3165,93,291128,91.95451674036639,8
0.05,3166,92,291220,91.95453110198926,9
0.05,3167,92,291312,91.95454545454545,9
0.05,3168,85,291397,91.95235089933733,16
0.05,3169,86,291483,91.95047318611988,15
0.05,3170,93,291576,91.9508041627247,8
0.05,3171,94,291670,91.95145018915511,8
0.05,3172,27,291697,91.9309801449732,6
0.05,3173,94,291791,91.93163201008191,8
0.05,3174,92,291883,91.93165354330709,9
0.05,3175,27,291910,91.91120906801008,6
0.05,3176,26,291936,91.890462700661,8
0.05,3177,93,292029,91.89081183134047,8
0.05,3178,94,292123,91.89147530670022,7
0.05,3179,93,292216,91.89182389937108,8
0.05,3180,92,292308,91.89185790631876,9
0.05,3181,92,292400,91.89189189189189,9
0.05,3182,95,292495,91.89286836317939,6
0.05,3183,94,292589,91.89353015075378,7
0.05,3184,96,292685,91.89481946624804,6
0.05,3185,96,292781,91.89610797237916,6
0.05,3186,94,292875,91.89676812048948,7
0.05,3187,92,292967,91.89680050188205,9
0.05,3188,96,293063,91.8980871746629,6
0.05,3189,95,293158,91.89905956112852,7
0.05,3190,92,293250,91.89909119398308,9
0.05,3191,90,293340,91.8984962406015,11
0.05,3192,94,293434,91.89915440025055,7
0.05,3193,94,293528,91.89981214777708,7
0.05,3194,95,293623,91.90078247261346,6
0.05,3195,93,293716,91.90112640801001,8
0.05,3196,93,293809,91.90147012824524,8
0.05,3197,94,293903,91.9021263289556,7
0.05,3198,94,293997,91.90278211941232,7
0.05,3199,93,294090,91.903125,9
0.05,3200,94,294184,91.90378006872852,7
0.05,3201,96,294280,91.9050593379138,6
0.05,3202,94,294374,91.90571339369342,7
0.05,3203,95,294469,91.90667915106117,7
0.05,3204,95,294564,91.90764430577224,6
0.05,3205,92,294656,91.90767311291329,9
0.05,3206,95,294751,91.90863735578422,6
0.05,3207,96,294847,91.9099127182045,6
0.05,3208,94,294941,91.91056403864133,8
0.05,3209,89,295030,91.90965732087227,12
0.05,3210,94,295124,91.91030831516662,7
0.05,3211,96,295220,91.91158156911581,6
0.05,3212,91,295311,91.91129785247432,10
0.05,3213,94,295405,91.911947728687,7
0.05,3214,93,295498,91.91228615863142,8
0.05,3215,93,295591,91.91262437810946,8
0.05,3216,84,295675,91.91016474976686,17
0.05,3217,94,295769,91.91081417029211,7
0.05,3218,27,295796,91.89064926995961,6
0.05,3219,93,295889,91.89099378881987,8
0.05,3220,95,295984,91.89195901893822,7
0.05,3221,93,296077,91.89230291744258,8
0.05,3222,94,296171,91.89295687247906,7
0.05,3223,95,296266,91.8939205955335,7
0.05,3224,92,296358,91.89395348837209,9
0.05,3225,95,296453,91.8949163050217,6
0.05,3226,94,296547,91.89556863960334,7
0.05,3227,96,296643,91.89684014869889,6
0.05,3228,93,296736,91.89718179002787,8
0.05,3229,93,296829,91.89752321981425,9
0.05,3230,92,296921,91.89755493655215,9
0.05,3231,91,297012,91.89727722772277,10
0.05,3232,95,297107,91.89823693164244,7
0.05,3233,93,297200,91.89857761286332,8
0.05,3234,96,297296,91.89984544049459,6
0.05,3235,94,297390,91.90049443757725,7
0.05,3236,94,297484,91.90114303367315,8
0.05,3237,94,297578,91.9017912291538,7
0.05,3238,88,297666,91.90058660080271,13
0.05,3239,94,297760,91.90123456790124,9
0.05,3240,94,297854,91.90188213514348,7
0.05,3241,94,297948,91.90252930289944,8
0.05,3242,95,298043,91.90348442799876,6
0.05,3243,96,298139,91.90474722564736,6
0.05,3244,92,298231,91.90477657935286,10
0.05,3245,92,298323,91.90480591497227,9
0.05,3246,90,298413,91.90421927933477,11
0.05,3247,94,298507,91.9048645320197,7
0.05,3248,95,298602,91.90581717451524,6
0.05,3249,94,298696,91.90646153846154,7
0.05,3250,94,298790,91.90710550599816,7
0.05,3251,94,298884,91.90774907749078,7
0.05,3252,93,298977,91.90808484475869,8
0.05,3253,94,299071,91.90872771972957,8
0.05,3254,94,299165,91.90937019969277,7
0.05,3255,96,299261,91.91062653562653,6
0.05,3256,91,299352,91.91034694504145,11
0.05,3257,92,299444,91.91037446286064,9
0.05,3258,95,299539,91.91132249156183,7
0.05,3259,93,299632,91.9116564417178,9
0.05,3260,92,299724,91.9116835326587,9
0.05,3261,94,299818,91.91232372777438,7
0.05,3262,93,299911,91.91265706405149,8
0.05,3263,94,300005,91.91329656862744,7
0.05,3264,95,300100,91.91424196018377,7
0.05,3265,94,300194,91.91488058787507,7
0.05,3266,94,300288,91.91551882460973,7
0.05,3267,94,300382,91.91615667074663,7
0.05,3268,90,300472,91.9155705108596,11
0.05,3269,96,300568,91.91681957186545,6
0.05,3270,94,300662,91.91745643534088,7
0.05,3271,95,300757,91.91839853300733,8
0.05,3272,96,300853,91.91964558509014,6
0.05,3273,92,300945,91.91967012828344,11
0.05,3274,94,301039,91.92030534351144,7
0.05,3275,95,301134,91.92124542124542,6
0.05,3276,95,301229,91.9221849252365,7
0.05,3277,96,301325,91.92342892007322,6
0.05,3278,95,301420,91.92436718511742,6
0.05,3279,94,301514,91.925,7
0.05,3280,92,301606,91.92502285888449,9
0.05,3281,94,301700,91.92565508836076,7
0.05,3282,95,301795,91.92659153213525,6
0.05,3283,93,301888,91.92691839220463,8
0.05,3284,93,301981,91.92724505327244,8
0.05,3285,94,302075,91.92787583688374,7
0.05,3286,94,302169,91.92850623669,7
0.05,3287,94,302263,91.92913625304136,7
0.05,3288,90,302353,91.92854971115841,11
0.05,3289,94,302447,91.929179331307,7
0.05,3290,94,302541,91.92980856882407,8
0.05,3291,91,302632,91.92952612393681,10
0.05,3292,94,302726,91.9301548739751,7
0.05,3293,94,302820,91.93078324225866,7
0.05,3294,94,302914,91.93141122913505,7
0.05,3295,96,303010,91.93264563106796,6
0.05,3296,94,303104,91.93327267212618,8
0.05,3297,94,303198,91.93389933292904,7
0.05,3298,94,303292,91.93452561382237,7
0.05,3299,93,303385,91.93484848484849,8
0.05,3300,92,303477,91.93486822175099,9
0.05,3301,96,303573,91.93609933373713,6
0.05,3302,91,303664,91.93581592491674,10
0.05,3303,94,303758,91.9364406779661,7
0.05,3304,94,303852,91.93706505295008,8
0.05,3305,96,303948,91.9382940108893,6
0.05,3306,94,304042,91.93891744783792,7
0.05,3307,88,304130,91.93772672309552,14
0.05,3308,96,304226,91.9389543668782,6
0.05,3309,95,304321,91.93987915407855,6
0.05,3310,95,304416,91.94080338266384,6
0.05,3311,96,304512,91.94202898550725,6
0.05,3312,94,304606,91.94265016601268,7
0.05,3313,95,304701,91.94357272178637,6
0.05,3314,94,304795,91.94419306184012,7
0.05,3315,94,304889,91.94481302774427,7
0.05,3316,95,304984,91.94573409707567,6
0.05,3317,93,305077,91.9460518384569,8
0.05,3318,95,305172,91.9469719795119,7
0.05,3319,95,305267,91.94789156626506,6
0.05,3320,92,305359,91.94790725685034,9
0.05,3321,96,305455,91.94912703190849,6
0.05,3322,93,305548,91.94944327414987,8
0.05,3323,90,305638,91.9488567990373,11
0.05,3324,91,305729,91.94857142857143,11
0.05,3325,93,305822,91.94888755261576,8
0.05,3326,89,305911,91.94800120228435,12
0.05,3327,92,306003,91.94801682692308,9
0.05,3328,94,306097,91.94863322319014,7
0.05,3329,96,306193,91.94984984984985,6
0.05,3330,91,306284,91.9495646952867,10
0.05,3331,92,306376,91.94957983193277,9
0.05,3332,88,306464,91.94839483948395,13
0.05,3333,94,306558,91.9490101979604,7
0.05,3334,95,306653,91.94992503748126,6
0.05,3335,96,306749,91.95113908872902,6
0.05,3336,94,306843,91.95175307162121,7
0.05,3337,94,306937,91.95236668663871,7
0.05,3338,95,307032,91.95327942497754,6
0.05,3339,92,307124,91.95329341317365,10
0.05,3340,95,307219,91.95420532774618,6
0.05,3341,94,307313,91.95481747456613,7
0.05,3342,92,307405,91.95483099012863,9
0.05,3343,92,307497,91.95484449760765,9
0.05,3344,90,307587,91.9542600896861,11
0.05,3345,92,307679,91.95427375971309,9
0.05,3346,90,307769,91.95368987152673,11
0.05,3347,96,307865,91.95489844683394,6
0.05,3348,93,307958,91.95521051060018,8
0.05,3349,95,308053,91.95611940298508,6
0.05,3350,96,308149,91.95732617129215,6
0.05,3351,94,308243,91.95793556085918,7
0.05,3352,94,308337,91.95854458693707,7
0.05,3353,24,308361,91.93828264758497,8
0.05,3354,91,308452,91.93800298062592,10
0.05,3355,93,308545,91.93831942789035,8
0.05,3356,94,308639,91.93893357164134,7
0.05,3357,89,308728,91.93805836807624,12
0.05,3358,95,308823,91.93896993152724,7
0.05,3359,94,308917,91.93958333333333,8
0.05,3360,95,309012,91.94049390062482,6
0.05,3361,88,309100,91.93932183224271,13
0.05,3362,89,309189,91.93844781445138,12
0.05,3363,93,309282,91.93876337693223,8
0.05,3364,92,309374,91.93878157503714,9
0.05,3365,95,309469,91.93969102792632,8
0.05,3366,94,309563,91.94030294030294,7
0.05,3367,96,309659,91.94150831353919,6
0.05,3368,95,309754,91.94241614722469,6
0.05,3369,94,309848,91.94302670623145,7
0.05,3370,26,309874,91.92346484722634,8
0.05,3371,91,309965,91.92319098457888,10
0.05,3372,95,310060,91.92410317225023,7
0.05,3373,92,310152,91.92412566686426,9
0.05,3374,94,310246,91.92474074074075,7
0.05,3375,93,310339,91.92505924170617,9
0.05,3376,94,310433,91.92567367485934,7
0.05,3377,88,310521,91.92451154529307,13
0.05,3378,95,310616,91.92542172240307,6
0.05,3379,92,310708,91.92544378698224,11
0.05,3380,95,310803,91.92635314995563,8
0.05,3381,94,310897,91.92696629213484,7
0.05,3382,93,310990,91.92728347620455,8
0.05,3383,96,311086,91.92848699763593,6
0.05,3384,92,311178,91.92850812407681,9
0.05,3385,94,311272,91.92911990549321,7
0.05,3386,94,311366,91.92973132565692,7
0.05,3387,95,311461,91.9306375442739,7
0.05,3388,93,311554,91.93095308350546,8
0.05,3389,96,311650,91.93215339233038,6
0.05,3390,91,311741,91.93187850191684,10
0.05,3391,96,311837,91.93307783018868,6
0.05,3392,92,311929,91.9330975537872,9
0.05,3393,94,312023,91.93370654095463,7
0.05,3394,92,312115,91.93372606774669,9
0.05,3395,96,312211,91.9349234393404,6
0.05,3396,95,312306,91.93582572858405,6
0.05,3397,21,312327,91.91494997057093,11
0.05,3398,90,312417,91.9143865842895,12
0.05,3399,94,312511,91.915,7
0.05,3400,94,312605,91.91561305498382,7
0.05,3401,21,312626,91.89476778365668,11
0.05,3402,91,312717,91.89450484866295,10
0.05,3403,94,312811,91.89512338425382,8
0.05,3404,93,312904,91.89544787077827,8
0.05,3405,94,312998,91.89606576629477,7
0.05,3406,94,313092,91.89668329909011,7
0.05,3407,95,313187,91.89759389671362,6
0.05,3408,95,313282,91.8985039601056,6
0.05,3409,95,313377,91.89941348973608,6
0.05,3410,96,313473,91.90061565523307,6
0.05,3411,92,313565,91.90064478311841,9
0.05,3412,95,313660,91.90155288602402,6
0.05,3413,91,313751,91.90128881077915,12
0.05,3414,93,313844,91.90161054172768,8
0.05,3415,96,313940,91.90281030444964,6
0.05,3416,90,314030,91.9022534386889,11
0.05,3417,94,314124,91.90286717378584,7
0.05,3418,91,314215,91.90260310032173,10
0.05,3419,95,314310,91.90350877192982,6
0.05,3420,94,314404,91.9041216018708,7
0.05,3421,94,314498,91.90473407364115,8
0.05,3422,94,314592,91.90534618755477,7
0.05,3423,91,314683,91.90508177570094,10
0.05,3424,92,314775,91.9051094890511,10
0.05,3425,90,314865,91.9045534150613,11
0.05,3426,95,314960,91.90545666763933,6
0.05,3427,95,315055,91.90635939323221,7
0.05,3428,95,315150,91.90726159230097,7
0.05,3429,95,315245,91.90816326530613,7
0.05,3430,94,315339,91.90877295249199,7
0.05,3431,94,315433,91.90938228438229,7
0.05,3432,94,315527,91.9099912612875,7
0.05,3433,90,315617,91.90943506115318,11
0.05,3434,94,315711,91.91004366812227,7
0.05,3435,92,315803,91.91006984866124,9
0.05,3436,93,315896,91.91038696537679,8
0.05,3437,94,315990,91.91099476439791,7
0.05,3438,94,316084,91.91160220994475,7
0.05,3439,95,316179,91.9125,6
0.05,3440,94,316273,91.91310665504214,7
0.05,3441,92,316365,91.9131319000581,9
0.05,3442,94,316459,91.91373801916933,7
0.05,3443,92,316551,91.9137630662021,9
0.05,3444,94,316645,91.91436865021771,7
0.05,3445,95,316740,91.91526407428903,6
0.05,3446,94,316834,91.91586887148245,7
0.05,3447,94,316928,91.91647331786542,7
0.05,3448,94,317022,91.91707741374312,7
0.05,3449,93,317115,91.91739130434783,8
0.05,3450,92,317207,91.91741524195885,11
0.05,3451,95,317302,91.91830822711472,6
0.05,3452,94,317396,91.91891109180423,7
0.05,3453,94,317490,91.9195136074117,7
0.05,3454,92,317582,91.91953690303907,9
0.05,3455,94,317676,91.92013888888889,8
0.05,3456,91,317767,91.91987272201331,11
0.05,3457,91,317858,91.9196067090804,10
0.05,3458,94,317952,91.92020815264527,8
0.05,3459,90,318042,91.91965317919075,11
0.05,3460,94,318136,91.92025426177405,7
0.05,3461,94,318230,91.92085499711149,7
0.05,3462,94,318324,91.9214553855039,8
0.05,3463,94,318418,91.92205542725173,7
0.05,3464,92,318510,91.92207792207792,9
0.05,3465,93,318603,91.92238892094633,8
0.05,3466,93,318696,91.92269974040957,8
0.05,3467,95,318791,91.92358708189158,6
0.05,3468,92,318883,91.92360910925339,9
0.05,3469,94,318977,91.92420749279539,7
0.05,3470,92,319069,91.92422932872371,9
0.05,3471,92,319161,91.92425115207374,10
0.05,3472,25,319186,91.90498128419235,8
0.05,3473,94,319280,91.9055843408175,7
0.05,3474,96,319376,91.90676258992806,6
0.05,3475,94,319470,91.90736478711162,8
0.05,3476,94,319564,91.90796663790624,7
0.05,3477,92,319656,91.90799309948247,9
0.05,3478,90,319746,91.90744466800805,11
0.05,3479,93,319839,91.90775862068965,8
0.05,3480,92,319931,91.90778511921862,9
0.05,3481,96,320027,91.90896036760482,6
0.05,3482,93,320120,91.90927361469997,8
0.05,3483,91,320211,91.90901262916188,10
0.05,3484,94,320305,91.90961262553802,7
0.05,3485,93,320398,91.90992541594952,8
0.05,3486,92,320490,91.90995124749068,9
0.05,3487,93,320583,91.91026376146789,8
0.05,3488,94,320677,91.91086271137861,7
0.05,3489,94,320771,91.91146131805158,7
0.05,3490,94,320865,91.91205958178172,7
0.05,3491,90,320955,91.91151202749141,11
0.05,3492,94,321049,91.91210993415402,7
0.05,3493,95,321144,91.9129937034917,6
0.05,3494,94,321238,91.91359084406295,7
0.05,3495,95,321333,91.91447368421052,7
0.05,3496,92,321425,91.91449814126393,9
0.05,3497,94,321519,91.91509433962264,7
0.05,3498,93,321612,91.9154044012575,8
0.05,3499,94,321706,91.916,8
0.05,3500,96,321802,91.91716652385033,6
0.05,3501,94,321896,91.91776127926899,7
0.05,3502,90,321986,91.91721381672852,11
0.05,3503,94,322080,91.91780821917808,7
0.05,3504,91,322171,91.91754636233952,10
0.05,3505,92,322263,91.91756988020536,9
0.05,3506,91,322354,91.91730824066154,10
0.05,3507,92,322446,91.91733181299885,9
0.05,3508,94,322540,91.91792533485324,7
0.05,3509,95,322635,91.91880341880342,6
0.05,3510,95,322730,91.91968100256337,6
0.05,3511,94,322824,91.92027334851936,7
0.05,3512,94,322918,91.92086535724452,7
0.05,3513,94,323012,91.92145702902675,7
0.05,3514,94,323106,91.92204836415362,7
0.05,3515,95,323201,91.92292377701934,6
0.05,3516,94,323295,91.92351435882854,8
0.05,3517,94,323389,91.92410460488914,7
0.05,3518,95,323484,91.92497868712702,6
0.05,3519,94,323578,91.92556818181818,7
0.05,3520,93,323671,91.92587333143993,8
0.05,3521,90,323761,91.92532651902329,11
0.05,3522,94,323855,91.92591541300028,7
0.05,3523,94,323949,91.92650397275823,7
0.05,3524,27,323976,91.90808510638298,6
0.05,3525,95,324071,91.90896199659672,6
0.05,3526,95,324166,91.9098383895662,6
0.05,3527,93,324259,91.91014739229026,8
0.05,3528,94,324353,91.91073958628506,7
0.05,3529,93,324446,91.91104815864023,8
0.05,3530,94,324540,91.91163976210706,8
0.05,3531,24,324564,91.89241223103058,9
0.05,3532,93,324657,91.89272572884235,8
0.05,3533,95,324752,91.89360498019242,6
0.05,3534,93,324845,91.8939179632249,8
0.05,3535,94,324939,91.89451357466064,7
0.05,3536,90,325029,91.89397794741306,11
0.05,3537,94,325123,91.89457320520067,7
0.05,3538,94,325217,91.89516812658943,7
0.05,3539,96,325313,91.89632768361582,6
0.05,3540,93,325406,91.89663936741033,8
0.05,3541,91,325497,91.89638622247318,10
0.05,3542,94,325591,91.89697996048547,7
0.05,3543,21,325612,91.87697516930022,12
0.05,3544,94,325706,91.87757404795487,7
0.05,3545,92,325798,91.87760857304005,9
0.05,3546,27,325825,91.85931773329574,6
0.05,3547,94,325919,91.85992108229989,7
0.05,3548,94,326013,91.86052409129333,8
0.05,3549,94,326107,91.86112676056338,7
0.05,3550,93,326200,91.86144747958322,8
0.05,3551,95,326295,91.86233108108108,6
0.05,3552,94,326389,91.86293273290177,7
0.05,3553,94,326483,91.86353404614519,7
0.05,3554,94,326577,91.86413502109704,8
0.05,3555,92,326669,91.86417322834646,10
0.05,3556,93,326762,91.8644925499016,9
0.05,3557,95,326857,91.86537380550871,6
0.05,3558,94,326951,91.86597358808655,7
0.05,3559,91,327042,91.86573033707865,10
0.05,3560,92,327134,91.86576804268464,9
0.05,3561,92,327226,91.8658057271196,9
0.05,3562,94,327320,91.8664047151277,7
0.05,3563,91,327411,91.86616161616162,11
0.05,3564,92,327503,91.86619915848527,9
0.05,3565,95,327598,91.86707795849692,6
0.05,3566,95,327693,91.86795626576955,6
0.05,3567,94,327787,91.8685538116592,7
0.05,3568,96,327883,91.86971140375455,6
0.05,3569,94,327977,91.8703081232493,7
0.05,3570,93,328070,91.87062447493699,8
0.05,3571,93,328163,91.87094064949608,8
0.05,3572,92,328255,91.8709767702211,9
0.05,3573,94,328349,91.87157246782317,7
0.05,3574,94,328443,91.87216783216783,7
0.05,3575,91,328534,91.87192393736018,11
0.05,3576,90,328624,91.87140061504054,12
0.05,3577,95,328719,91.87227501397429,7
0.05,3578,94,328813,91.87286951662476,8
0.05,3579,96,328909,91.87402234636872,6
0.05,3580,94,329003,91.87461602904217,7
0.05,3581,91,329094,91.87437185929649,10
0.05,3582,96,329190,91.87552330449344,6
0.05,3583,94,329284,91.87611607142857,7
0.05,3584,91,329375,91.87587168758716,10
0.05,3585,92,329467,91.87590630228667,10
0.05,3586,96,329563,91.87705603568442,6
0.05,3587,93,329656,91.8773690078038,8
0.05,3588,94,329750,91.87796043466146,7
0.05,3589,93,329843,91.8782729805014,8
0.05,3590,91,329934,91.87802840434419,10
0.05,3591,96,330030,91.87917594654789,6
0.05,3592,95,330125,91.88004453103257,7
0.05,3593,92,330217,91.88007790762381,9
0.05,3594,94,330311,91.88066759388039,7
0.05,3595,93,330404,91.88097886540601,8
0.05,3596,96,330500,91.88212399221574,6
0.05,3597,94,330594,91.88271261812118,7
0.05,3598,95,330689,91.88357877188108,6
0.05,3599,94,330783,91.88416666666667,7
0.05,3600,90,330873,91.8836434323799,11
0.05,3601,92,330965,91.88367573570238,9
0.05,3602,96,331061,91.88481820704968,6
0.05,3603,96,331157,91.88596004439512,6
0.05,3604,94,331251,91.8865464632455,7
0.05,3605,93,331344,91.88685524126456,8
0.05,3606,24,331368,91.86803437759912,11
0.05,3607,95,331463,91.8689024390244,6
0.05,3608,92,331555,91.8689387642006,9
0.05,3609,96,331651,91.87008310249307,6
0.05,3610,90,331741,91.8695652173913,11
0.05,3611,95,331836,91.87043189368771,6
0.05,3612,96,331932,91.8715748685303,6
0.05,3613,94,332026,91.8721638074156,7
0.05,3614,94,332120,91.87275242047026,7
0.05,3615,90,332210,91.87223451327434,11
0.05,3616,94,332304,91.87282278131048,7
0.05,3617,94,332398,91.873410724157,7
0.05,3618,94,332492,91.87399834208345,7
0.05,3619,96,332588,91.87513812154697,6
0.05,3620,94,332682,91.87572493786247,7
0.05,3621,95,332777,91.87658752070679,6
0.05,3622,25,332802,91.85812862268838,7
0.05,3623,94,332896,91.85871964679912,7
0.05,3624,95,332991,91.85958620689655,8
0.05,3625,95,333086,91.86045228902371,6
0.05,3626,95,333181,91.86131789357596,6
0.05,3627,93,333274,91.86163175303197,8
0.05,3628,93,333367,91.86194543951501,8
0.05,3629,96,333463,91.86308539944903,6
0.05,3630,94,333557,91.86367391903057,7
0.05,3631,92,333649,91.8637114537445,9
0.05,3632,94,333743,91.86429947701625,7
0.05,3633,95,333838,91.8651623555311,6
0.05,3634,92,333930,91.86519944979368,11
0.05,3635,96,334026,91.86633663366337,6
0.05,3636,90,334116,91.86582348089084,11
0.05,3637,95,334211,91.86668499175371,7
0.05,3638,95,334306,91.86754602912889,6
0.05,3639,93,334399,91.86785714285715,8
0.05,3640,95,334494,91.8687173853337,6
0.05,3641,94,334588,91.86930258099945,7
0.05,3642,92,334680,91.8693384573154,9
0.05,3643,96,334776,91.87047200878156,6
0.05,3644,92,334868,91.87050754458161,9
0.05,3645,93,334961,91.87081733406472,8
0.05,3646,89,335050,91.8700301617768,12
0.05,3647,94,335144,91.87061403508773,7
0.05,3648,93,335237,91.87092354069608,9
0.05,3649,93,335330,91.87123287671233,9
0.05,3650,95,335425,91.87208983840044,6
0.05,3651,94,335519,91.87267250821468,8
0.05,3652,94,335613,91.87325485901998,7
0.05,3653,93,335706,91.8735632183908,8
0.05,3654,94,335800,91.87414500683994,8
0.05,3655,96,335896,91.87527352297593,6
0.05,3656,94,335990,91.8758545255674,7
0.05,3657,96,336086,91.87698195735375,6
0.05,3658,93,336179,91.87728887674228,8
0.05,3659,95,336274,91.87814207650273,6
0.05,3660,93,336367,91.8784485113357,8
0.05,3661,94,336461,91.8790278536319,7
0.05,3662,94,336555,91.87960687960688,7
0.05,3663,93,336648,91.87991266375546,8
0.05,3664,91,336739,91.87967257844475,10
0.05,3665,91,336830,91.87943262411348,10
0.05,3666,92,336922,91.87946550313607,9
0.05,3667,95,337017,91.88031624863686,7
0.05,3668,93,337110,91.88062142273098,8
0.05,3669,95,337205,91.88147138964578,6
0.05,3670,89,337294,91.88068646145464,12
0.05,3671,94,337388,91.88126361655773,7
0.05,3672,93,337481,91.88156820038115,8
0.05,3673,95,337576,91.88241698421339,6
0.05,3674,94,337670,91.8829931972789,8
0.05,3675,96,337766,91.8841131664853,6
0.05,3676,92,337858,91.88414468316563,9
0.05,3677,96,337954,91.8852637302882,6
0.05,3678,27,337981,91.86762707257407,6
0.05,3679,95,338076,91.86847826086957,6
0.05,3680,92,338168,91.86851399076338,9
0.05,3681,93,338261,91.86882129277566,8
0.05,3682,90,338351,91.86831387455878,11
0.05,3683,96,338447,91.86943539630836,6
0.05,3684,96,338543,91.87055630936229,6
0.05,3685,93,338636,91.87086272381985,8
0.05,3686,95,338731,91.87171141849743,8
0.05,3687,94,338825,91.8722885032538,8
0.05,3688,93,338918,91.8725941989699,8
0.05,3689,90,339008,91.8720867208672,11
0.05,3690,96,339104,91.8732050934706,6
0.05,3691,95,339199,91.87405200433369,7
0.05,3692,94,339293,91.8746276739778,8
0.05,3693,93,339386,91.87493232268544,9
0.05,3694,94,339480,91.87550744248985,7
0.05,3695,27,339507,91.85795454545455,6
0.05,3696,94,339601,91.85853394644306,7
0.05,3697,96,339697,91.85965386695511,6
0.05,3698,96,339793,91.86077318194107,6
0.05,3699,95,339888,91.86162162162162,6
0.05,3700,96,339984,91.86273980005404,6
0.05,3701,95,340079,91.86358725013507,6
0.05,3702,91,340170,91.86335403726709,10
0.05,3703,93,340263,91.86366090712743,9
0.05,3704,93,340356,91.86396761133604,8
0.05,3705,93,340449,91.86427415002699,8
0.05,3706,95,340544,91.86512004316158,6
0.05,3707,94,340638,91.86569579288026,7
0.05,3708,95,340733,91.86654084658937,7
0.05,3709,94,340827,91.86711590296495,7
0.05,3710,25,340852,91.84909727836163,8
0.05,3711,93,340945,91.8494073275862,8
0.05,3712,96,341041,91.8505251817937,6
0.05,3713,93,341134,91.85083467959073,8
0.05,3714,87,341221,91.84952893674293,14
0.05,3715,94,341315,91.85010764262648,7
0.05,3716,92,341407,91.85014796879204,9
0.05,3717,95,341502,91.85099515868747,6
0.05,3718,95,341597,91.85184189298198,6
0.05,3719,95,341692,91.85268817204302,6
0.05,3720,95,341787,91.85353399623757,6
0.05,3721,92,341879,91.85357334766255,10
0.05,3722,96,341975,91.85468708031158,6
0.05,3723,93,342068,91.85499462943072,8
0.05,3724,91,342159,91.85476510067114,10
0.05,3725,94,342253,91.85534084809447,7
0.05,3726,92,342345,91.85537966192648,9
0.05,3727,94,342439,91.85595493562232,8
0.05,3728,94,342533,91.85652990077769,7
0.05,3729,96,342629,91.85764075067024,6
0.05,3730,96,342725,91.85875100509247,6
0.05,3731,95,342820,91.85959271168274,7
0.05,3732,87,342907,91.85829091883204,14
0.05,3733,94,343001,91.8588644884842,7
0.05,3734,26,343027,91.84123159303883,7
0.05,3735,92,343119,91.84127408993577,9
0.05,3736,92,343211,91.84131656408884,9
0.05,3737,95,343306,91.84216158373462,6
0.05,3738,95,343401,91.84300615137737,7
0.05,3739,92,343493,91.84304812834225,9
0.05,3740,96,343589,91.84415931569099,6
0.05,3741,94,343683,91.84473543559594,7
0.05,3742,94,343777,91.84531124766231,7
0.05,3743,96,343873,91.84642094017094,6
0.05,3744,96,343969,91.8475300400534,6
0.05,3745,95,344064,91.84837159636946,6
0.05,3746,93,344157,91.84867894315452,8
0.05,3747,94,344251,91.84925293489862,7
0.05,3748,27,344278,91.83195518805015,6
0.05,3749,96,344374,91.83306666666667,6
0.05,3750,94,344468,91.8336443615036,7
0.05,3751,87,344555,91.83235607675905,14
0.05,3752,94,344649,91.83293365307753,8
0.05,3753,94,344743,91.83351092168354,7
0.05,3754,94,344837,91.8340878828229,8
0.05,3755,96,344933,91.83519701810437,6
0.05,3756,94,345027,91.83577322331648,7
0.05,3757,94,345121,91.83634912187334,7
0.05,3758,94,345215,91.83692471401969,7
0.05,3759,94,345309,91.8375,7
0.05,3760,96,345405,91.838606753523,6
0.05,3761,92,345497,91.83864965443912,9
0.05,3762,91,345588,91.83842678713792,10
0.05,3763,95,345683,91.83926673751328,7
0.05,3764,96,345779,91.84037184594953,6
0.05,3765,95,345874,91.84121083377589,6
0.05,3766,94,345968,91.84178391292807,7
0.05,3767,91,346059,91.84156050955414,10
0.05,3768,96,346155,91.84266383656143,6
0.05,3769,94,346249,91.84323607427056,7
0.05,3770,94,346343,91.84380800848581,7
0.05,3771,95,346438,91.84464475079534,7
0.05,3772,96,346534,91.84574609064406,6
0.05,3773,94,346628,91.84631690514044,7
0.05,3774,91,346719,91.84609271523179,10
0.05,3775,94,346813,91.84666313559322,7
0.05,3776,96,346909,91.8477627746889,6
0.05,3777,95,347004,91.84859714134463,7
0.05,3778,95,347099,91.84943106641968,6
0.05,3779,91,347190,91.84920634920636,10
0.05,3780,94,347284,91.84977519174821,7
0.05,3781,92,347376,91.84981491274458,9
0.05,3782,93,347469,91.85011895321173,8
0.05,3783,94,347563,91.85068710359408,7
0.05,3784,93,347656,91.85099075297227,8
0.05,3785,94,347750,91.85155837295298,7
0.05,3786,94,347844,91.85212569316081,7
0.05,3787,92,347936,91.85216473072862,10
0.05,3788,94,348030,91.85273159144893,7
0.05,3789,92,348122,91.85277044854881,9
0.05,3790,95,348217,91.85360063307834,6
0.05,3791,95,348312,91.85443037974683,6
0.05,3792,95,348407,91.8552596889006,6
0.05,3793,94,348501,91.85582498682129,7
0.05,3794,91,348592,91.85559947299078,10
0.05,3795,90,348682,91.85511064278188,11
0.05,3796,95,348777,91.85593889913089,6
0.05,3797,96,348873,91.85703001579779,6
0.05,3798,94,348967,91.8575941037115,7
0.05,3799,91,349058,91.85736842105263,11
0.05,3800,94,349152,91.8579321231255,7
0.05,3801,92,349244,91.85796948974225,10
0.05,3802,91,349335,91.85774388640547,10
0.05,3803,93,349428,91.85804416403785,8
0.05,3804,95,349523,91.85886990801576,6
0.05,3805,94,349617,91.85943247503941,7
0.05,3806,96,349713,91.86052009456264,6
0.05,3807,94,349807,91.8610819327731,7
0.05,3808,94,349901,91.86164347597794,7
0.05,3809,94,349995,91.86220472440945,7
0.05,3810,95,350090,91.86302807662031,6
0.05,3811,94,350184,91.86358866736622,7
0.05,3812,26,350210,91.84631523734592,7
0.05,3813,95,350305,91.84714210802308,7
0.05,3814,95,350400,91.84796854521625,6
0.05,3815,92,350492,91.84800838574424,9
0.05,3816,95,350587,91.8488341629552,6
0.05,3817,96,350683,91.84992142482976,6
0.05,3818,96,350779,91.8510081173082,6
0.05,3819,96,350875,91.8520942408377,6
0.05,3820,95,350970,91.85291808427114,6
0.05,3821,94,351064,91.85347985347985,8
0.05,3822,92,351156,91.85351817944023,9
0.05,3823,94,351250,91.85407949790795,7
0.05,3824,94,351344,91.85464052287581,7
0.05,3825,93,351437,91.85493988499739,8
0.05,3826,92,351529,91.85497778939117,9
0.05,3827,95,351624,91.85579937304075,7
0.05,3828,95,351719,91.85662052755289,7
0.05,3829,96,351815,91.85770234986946,6
0.05,3830,94,351909,91.858261550509,7
0.05,3831,95,352004,91.85908141962422,6
0.05,3832,90,352094,91.85859639968693,11
0.05,3833,95,352189,91.85941575378195,6
0.05,3834,92,352281,91.85945241199478,9
0.05,3835,93,352374,91.85974973931178,8
0.05,3836,94,352468,91.86030753192598,8
0.05,3837,94,352562,91.8608650338718,7
0.05,3838,94,352656,91.8614222453764,7
0.05,3839,96,352752,91.8625,6
0.05,3840,96,352848,91.86357719343921,6
0.05,3841,90,352938,91.86309213951067,11
0.05,3842,96,353034,91.86416861826697,6
0.05,3843,93,353127,91.86446409989594,8
0.05,3844,95,353222,91.86527958387516,6
0.05,3845,94,353316,91.86583463338533,7
0.05,3846,93,353409,91.86612945152066,8
0.05,3847,94,353503,91.86668399168398,7
0.05,3848,94,353597,91.86723824369966,7
0.05,3849,92,353689,91.86727272727273,9
0.05,3850,87,353776,91.86600882887562,16
0.05,3851,94,353870,91.86656282450674,7
0.05,3852,94,353964,91.86711653257203,7
0.05,3853,94,354058,91.86766995329528,8
0.05,3854,93,354151,91.86796368352789,8
0.05,3855,92,354243,91.8679979253112,9
0.05,3856,95,354338,91.86880995592429,8
0.05,3857,93,354431,91.86910316226025,8
0.05,3858,94,354525,91.86965535112724,7
0.05,3859,94,354619,91.87020725388601,7
0.05,3860,91,354710,91.86998186998187,12
0.05,3861,92,354802,91.87001553599171,9
0.05,3862,92,354894,91.87004918457157,9
0.05,3863,94,354988,91.87060041407868,7
0.05,3864,93,355081,91.87089262613195,8
0.05,3865,96,355177,91.87196068287636,6
0.05,3866,93,355270,91.87225239203516,8
0.05,3867,94,355364,91.8728024819028,7
0.05,3868,93,355457,91.8730938226932,8
0.05,3869,95,355552,91.87390180878553,6
0.05,3870,94,355646,91.87445104624128,8
0.05,3871,91,355737,91.87422520661157,10
0.05,3872,96,355833,91.87529047250193,6
0.05,3873,94,355927,91.8758389261745,7
0.05,3874,95,356022,91.87664516129033,8
0.05,3875,92,356114,91.8766769865841,9
0.05,3876,92,356206,91.8767087954604,9
0.05,3877,92,356298,91.87674058793192,9
0.05,3878,88,356386,91.87574117040474,13
0.05,3879,89,356475,91.875,12
0.05,3880,91,356566,91.87477454264365,10
0.05,3881,95,356661,91.87557959814528,6
0.05,3882,94,356755,91.87612670615503,7
0.05,3883,96,356851,91.87718846549949,6
0.05,3884,94,356945,91.87773487773488,8
0.05,3885,94,357039,91.87828100874935,8
0.05,3886,90,357129,91.87779778749679,11
0.05,3887,96,357225,91.87885802469135,6
0.05,3888,95,357320,91.87966058112626,6
0.05,3889,91,357411,91.87943444730077,10
0.05,3890,23,357434,91.86173220251864,9
0.05,3891,89,357523,91.86099691675231,13
0.05,3892,94,357617,91.861546365271,8
0.05,3893,95,357712,91.86235233692861,7
0.05,3894,95,357807,91.86315789473684,8
0.05,3895,94,357901,91.86370636550308,8
0.05,3896,96,357997,91.86476777007955,7
0.05,3897,94,358091,91.86531554643408,7
0.05,3898,94,358185,91.8658630418056,7
0.05,3899,93,358278,91.86615384615385,8
0.05,3900,94,358372,91.86670084593693,7
0.05,3901,94,358466,91.86724756535111,7
0.05,3902,90,358556,91.8667691519344,11
0.05,3903,92,358648,91.86680327868852,9
0.05,3904,93,358741,91.86709346991037,8
0.05,3905,92,358833,91.86712749615975,9
0.05,3906,92,358925,91.86716150499105,9
0.05,3907,90,359015,91.86668372569089,11
0.05,3908,92,359107,91.86671783064722,10
0.05,3909,94,359201,91.86726342710998,7
0.05,3910,25,359226,91.85016619790335,8
0.05,3911,95,359321,91.85097137014314,6
0.05,3912,92,359413,91.85100945566062,9
0.05,3913,94,359507,91.85155850792029,7
0.05,3914,21,359528,91.83346104725415,12
0.05,3915,86,359614,91.83197139938713,15
0.05,3916,94,359708,91.8325248914986,7
0.05,3917,94,359802,91.83307810107198,8
0.05,3918,95,359897,91.83388619545802,6
0.05,3919,94,359991,91.83443877551021,7
0.05,3920,95,360086,91.83524611068604,6
0.05,3921,94,360180,91.83579806221316,7
0.05,3922,94,360274,91.8363497323477,7
0.05,3923,92,360366,91.83639143730886,9
0.05,3924,95,360461,91.8371974522293,7
0.05,3925,96,360557,91.83825776872135,6
0.05,3926,93,360650,91.83855360325948,8
0.05,3927,94,360744,91.83910386965377,7
0.05,3928,94,360838,91.83965385594298,7
0.05,3929,94,360932,91.84020356234096,9
0.05,3930,93,361025,91.84049860086492,9
0.05,3931,94,361119,91.8410478128179,8
0.05,3932,94,361213,91.84159674548691,7
0.05,3933,95,361308,91.84239959328927,6
0.05,3934,93,361401,91.84269377382465,8
0.05,3935,94,361495,91.8432418699187,7
0.05,3936,93,361588,91.84353568707138,8
0.05,3937,92,361680,91.84357541899442,9
0.05,3938,94,361774,91.84412287382584,7
0.05,3939,92,361866,91.84416243654822,10
0.05,3940,95,361961,91.84496320730779,7
0.05,3941,96,362057,91.84601725012683,6
0.05,3942,93,362150,91.84630991630738,8
0.05,3943,95,362245,91.84710953346855,6
0.05,3944,96,362341,91.84816223067173,6
0.05,3945,93,362434,91.84845413076533,8
0.05,3946,91,362525,91.84823916898911,11
0.05,3947,96,362621,91.84929078014184,6
0.05,3948,93,362714,91.84958217270194,8
0.05,3949,94,362808,91.85012658227848,8
0.05,3950,91,362899,91.8499114148317,10
0.05,3951,93,362992,91.8502024291498,8
0.05,3952,90,363082,91.84973437895269,11
0.05,3953,94,363176,91.85027819929185,7
0.05,3954,94,363270,91.85082174462705,7
0.05,3955,96,363366,91.85187057633973,6
0.05,3956,94,363460,91.85241344452868,7
0.05,3957,94,363554,91.85295603840324,7
0.05,3958,89,363643,91.85223541298308,12
0.05,3959,94,363737,91.85277777777777,8
0.05,3960,94,363831,91.85331986872002,7
0.05,3961,92,363923,91.85335689045937,9
0.05,3962,94,364017,91.85389856169569,7
0.05,3963,94,364111,91.85443995963674,7
0.05,3964,94,364205,91.85498108448928,7
0.05,3965,95,364300,91.85577407967726,6
0.05,3966,94,364394,91.85631459541214,7
0.05,3967,94,364488,91.85685483870968,8
0.05,3968,94,364582,91.85739480977576,8
0.05,3969,94,364676,91.85793450881611,7
0.05,3970,94,364770,91.85847393603626,7
0.05,3971,94,364864,91.85901309164149,7
0.05,3972,95,364959,91.85980367480494,6
0.05,3973,95,365054,91.86059386009059,6
0.05,3974,92,365146,91.86062893081761,10
0.05,3975,93,365239,91.86091549295774,8
0.05,3976,94,365333,91.8614533568016,7
0.05,3977,94,365427,91.86199095022624,7
0.05,3978,94,365521,91.86252827343553,7
0.05,3979,95,365616,91.86331658291458,6
0.05,3980,96,365712,91.86435568952524,6
0.05,3981,91,365803,91.86413862380714,10
0.05,3982,96,365899,91.8651770022596,6
0.05,3983,94,365993,91.86571285140562,7
0.05,3984,96,366089,91.86675031367629,6
0.05,3985,94,366183,91.86728549924736,7
0.05,3986,96,366279,91.86832204665161,6
0.05,3987,92,366371,91.86835506519559,9
0.05,3988,94,366465,91.86888944597644,8
0.05,3989,94,366559,91.86942355889724,7
0.05,3990,95,366654,91.87020796792784,6
0.05,3991,95,366749,91.87099198396794,7
0.05,3992,94,366843,91.87152516904582,7
0.05,3993,91,366934,91.87130696044066,10
0.05,3994,86,367020,91.86983729662077,15
0.05,3995,92,367112,91.86986986986987,9
0.05,3996,95,367207,91.87065298974231,7
0.05,3997,92,367299,91.87068534267134,9
0.05,3998,93,367392,91.87096774193549,8
0.05,3999,94,367486,91.8715,7
0.05,4000,95,367581,91.87228192951763,6
0.05,4001,95,367676,91.87306346826587,6
0.05,4002,92,367768,91.87309517861604,9
0.05,4003,94,367862,91.87362637362638,7
0.05,4004,93,367955,91.87390761548065,8
0.05,4005,94,368049,91.87443834248627,8
0.05,4006,96,368145,91.87546793112054,6
0.05,4007,92,368237,91.875499001996,9
0.05,4008,95,368332,91.87627837365926,6
0.05,4009,95,368427,91.87705735660847,6
0.05,4010,94,368521,91.87758663674894,7
0.05,4011,94,368615,91.87811565304088,8
0.05,4012,91,368706,91.87789683528533,10
0.05,4013,96,368802,91.87892376681614,6
0.05,4014,91,368893,91.87870485678705,10
0.05,4015,95,368988,91.87948207171314,6
0.05,4016,94,369082,91.88000995767986,7
0.05,4017,95,369177,91.88078646092583,6
0.05,4018,92,369269,91.88081612341378,10
0.05,4019,96,369365,91.8818407960199,6
0.05,4020,96,369461,91.88286495896543,6
0.05,4021,94,369555,91.88339134758826,8
0.05,4022,95,369650,91.88416604523987,6
0.05,4023,93,369743,91.88444333996024,8
0.05,4024,93,369836,91.88472049689442,8
0.05,4025,94,369930,91.88524590163935,7
0.05,4026,94,370024,91.88577104544326,7
0.05,4027,92,370116,91.88579940417081,9
0.05,4028,95,370211,91.88657235045918,6
0.05,4029,26,370237,91.87022332506203,6
0.05,4030,95,370332,91.8709997519226,6
0.05,4031,94,370426,91.87152777777777,7
0.05,4032,94,370520,91.87205554178031,7
0.05,4033,94,370614,91.87258304412494,7
0.05,4034,91,370705,91.8723667905824,10
0.05,4035,96,370801,91.87338949454906,8
0.05,4036,90,370891,91.87292543968293,11
0.05,4037,93,370984,91.87320455671124,8
0.05,4038,95,371079,91.8739787076009,8
0.05,4039,94,371173,91.87450495049505,7
0.05,4040,94,371267,91.87503093293739,7
0.05,4041,92,371359,91.87506185056903,9
0.05,4042,88,371447,91.87410338857285,14
0.05,4043,24,371471,91.85731948565777,9
0.05,4044,94,371565,91.85784919653894,7
0.05,4045,93,371658,91.85813148788927,8
0.05,4046,92,371750,91.85816654311836,9
0.05,4047,93,371843,91.8584486166008,8
0.05,4048,25,371868,91.8419362805631,9
0.05,4049,93,371961,91.84222222222222,8
0.05,4050,94,372055,91.84275487533942,7
0.05,4051,95,372150,91.84353405725568,6
0.05,4052,94,372244,91.84406612385887,7
0.05,4053,96,372340,91.84509126788357,6
0.05,4054,94,372434,91.84562268803946,7
0.05,4055,94,372528,91.84615384615384,7
0.05,4056,94,372622,91.8466847424205,7
0.05,4057,95,372717,91.84746180384425,6
0.05,4058,94,372811,91.8479921162848,7
0.05,4059,94,372905,91.84852216748769,7
0.05,4060,96,373001,91.84954444718049,6
0.05,4061,94,373095,91.85007385524372,7
0.05,4062,93,373188,91.85035687915334,8
0.05,4063,93,373281,91.85063976377953,8
0.05,4064,95,373376,91.85141451414515,6
0.05,4065,94,373470,91.85194294146581,7
0.05,4066,95,373565,91.85271699041063,6
0.05,4067,92,373657,91.85275319567354,9
0.05,4068,94,373751,91.85328090439911,7
0.05,4069,94,373845,91.85380835380835,7
0.05,4070,93,373938,91.85408990420044,8
0.05,4071,94,374032,91.85461689587426,8
0.05,4072,96,374128,91.85563466732138,6
0.05,4073,90,374218,91.8551791850761,11
0.05,4074,96,374314,91.85619631901841,6
0.05,4075,93,374407,91.85647693817468,8
0.05,4076,94,374501,91.8570026980623,7
0.05,4077,92,374593,91.85703776360961,10
0.05,4078,27,374620,91.84113753370924,6
0.05,4079,95,374715,91.84191176470588,6
0.05,4080,91,374806,91.84170546434697,10
0.05,4081,93,374899,91.8419892209701,8
0.05,4082,92,374991,91.84202792064659,9
0.05,4083,95,375086,91.84280117531831,6
0.05,4084,93,375179,91.84308445532436,8
0.05,4085,93,375272,91.84336759667156,8
0.05,4086,93,375365,91.84365059946171,8
0.05,4087,94,375459,91.84417808219177,7
0.05,4088,94,375553,91.84470530692101,7
0.05,4089,18,375571,91.82665036674817,14
0.05,4090,94,375665,91.82718161818626,8
0.05,4091,93,375758,91.82746823069404,8
0.05,4092,93,375851,91.82775470315173,8
0.05,4093,96,375947,91.82877381533952,6
0.05,4094,90,376037,91.82832722832723,11
0.05,4095,94,376131,91.828857421875,7
0.05,4096,94,376225,91.8293873566024,7
0.05,4097,94,376319,91.82991703269887,7
0.05,4098,94,376413,91.83044645035375,7
0.05,4099,95,376508,91.83121951219512,6
0.05,4100,91,376599,91.8310168251646,10
0.05,4101,93,376692,91.83130180399804,8
0.05,4102,95,376787,91.83207409212771,6
0.05,4103,91,376878,91.83187134502924,10
0.05,4104,93,376971,91.83215590742996,8
0.05,4105,95,377066,91.832927423283,7
0.05,4106,96,377162,91.83394205015827,6
0.05,4107,88,377250,91.8330087633885,13
0.05,4108,91,377341,91.83280603553176,10
0.05,4109,90,377431,91.8323600973236,11
0.05,4110,96,377527,91.8333738749696,6
0.05,4111,95,377622,91.8341439688716,6
0.05,4112,94,377716,91.83467055677121,7
0.05,4113,96,377812,91.835683033544,6
0.05,4114,94,377906,91.83620899149453,7
0.05,4115,92,377998,91.83624878522838,9
0.05,4116,96,378094,91.83726014087928,6
0.05,4117,93,378187,91.83754249635746,9
0.05,4118,96,378283,91.83855304685603,6
0.05,4119,94,378377,91.8390776699029,7
0.05,4120,95,378472,91.83984469788886,6
0.05,4121,93,378565,91.84012615235322,8
0.05,4122,94,378659,91.84065001212709,7
0.05,4123,94,378753,91.84117361784675,7
0.05,4124,94,378847,91.84169696969697,7
0.05,4125,96,378943,91.84270479883665,6
0.05,4126,95,379038,91.84346983280834,7
0.05,4127,94,379132,91.84399224806202,7
0.05,4128,95,379227,91.84475659966094,7
0.05,4129,93,379320,91.84503631961259,8
0.05,4130,94,379414,91.84555797627694,7
0.05,4131,94,379508,91.8460793804453,7
0.05,4132,92,379600,91.84611662230824,9
0.05,4133,95,379695,91.84687953555878,6
0.05,4134,95,379790,91.84764207980653,7
0.05,4135,94,379884,91.84816247582205,7
0.05,4136,94,379978,91.84868262025623,7
0.05,4137,93,380071,91.84896085065249,9
0.05,4138,94,380165,91.84948055085769,7
0.05,4139,95,380260,91.85024154589372,6
0.05,4140,90,380350,91.84979473557112,11
0.05,4141,95,380445,91.85055528730082,6
0.05,4142,92,380537,91.85059135891866,9
0.05,4143,96,380633,91.85159266409266,6
0.05,4144,93,380726,91.8518697225573,8
0.05,4145,95,380821,91.8526290400386,6
0.05,4146,93,380914,91.85290571497468,8
0.05,4147,92,381006,91.8529411764706,9
0.05,4148,95,381101,91.85369968667149,7
0.05,4149,92,381193,91.85373493975904,9
0.05,4150,96,381289,91.85473379908456,6
0.05,4151,95,381384,91.85549132947978,7
0.05,4152,94,381478,91.8560077052733,7
0.05,4153,96,381574,91.85700529610014,6
0.05,4154,94,381668,91.8575210589651,8
0.05,4155,94,381762,91.85803657362848,7
0.05,4156,94,381856,91.85855184026943,7
0.05,4157,92,381948,91.85858585858585,9
0.05,4158,94,382042,91.85910074537148,7
0.05,4159,95,382137,91.85985576923076,7
0.05,4160,95,382232,91.86061043018505,6
0.05,4161,93,382325,91.86088419029313,8
0.05,4162,94,382419,91.86139803026663,8
0.05,4163,95,382514,91.86215177713737,6
0.05,4164,27,382541,91.84657863145259,6
0.05,4165,94,382635,91.84709553528565,7
0.05,4166,94,382729,91.84761219102472,7
0.05,4167,96,382825,91.8486084452975,6
0.05,4168,94,382919,91.84912449028543,7
0.05,4169,95,383014,91.84988009592327,6
0.05,4170,94,383108,91.85039558858787,7
0.05,4171,94,383202,91.8509108341323,7
0.05,4172,96,383298,91.85190510424155,6
0.05,4173,90,383388,91.85146142788692,11
0.05,4174,94,383482,91.85197604790419,7
0.05,4175,95,383577,91.85272988505747,6
0.05,4176,26,383603,91.8369643284654,7
0.05,4177,96,383699,91.83796074676879,6
0.05,4178,94,383793,91.83847810480977,7
0.05,4179,94,383887,91.838995215311,7
0.05,4180,27,383914,91.82348720401818,6
0.05,4181,93,384007,91.82376853180297,10
0.05,4182,94,384101,91.82428878795123,7
0.05,4183,92,384193,91.82433078393882,10
0.05,4184,94,384287,91.82485065710873,7
0.05,4185,95,384382,91.82560917343525,6
0.05,4186,94,384476,91.82612849295438,7
0.05,4187,93,384569,91.82640878701051,8
0.05,4188,92,384661,91.82645022678443,10
0.05,4189,26,384687,91.81073985680192,6
0.05,4190,91,384778,91.8105464089716,10
0.05,4191,91,384869,91.81035305343511,10
0.05,4192,90,384959,91.80992129740044,11
0.05,4193,95,385054,91.81068192656176,6
0.05,4194,94,385148,91.81120381406436,8
0.05,4195,94,385242,91.8117254528122,8
0.05,4196,95,385337,91.81248510841077,6
0.05,4197,92,385429,91.81252977608385,9
0.05,4198,27,385456,91.79709454632055,6
0.05,4199,93,385549,91.79738095238095,10
0.05,4200,92,385641,91.79742918352773,9
0.05,4201,89,385730,91.7967634459781,12
0.05,4202,93,385823,91.79704972638592,8
0.05,4203,94,385917,91.79757373929591,8
0.05,4204,94,386011,91.79809750297265,7
0.05,4205,93,386104,91.79838326200665,8
0.05,4206,93,386197,91.79866888519135,8
0.05,4207,92,386289,91.79871673003802,9
0.05,4208,93,386382,91.79900213827513,8
0.05,4209,94,386476,91.79952494061757,7
0.05,4210,94,386570,91.80004749465685,7
0.05,4211,95,386665,91.80080721747389,6
0.05,4212,94,386759,91.80132921908378,7
0.05,4213,93,386852,91.8016136687233,8
0.05,4214,95,386947,91.8023724792408,7
0.05,4215,96,387043,91.80336812144212,6
0.05,4216,95,387138,91.8041261560351,6
0.05,4217,91,387229,91.80393551446183,11
0.05,4218,91,387320,91.80374496326144,10
0.05,4219,94,387414,91.8042654028436,7
0.05,4220,95,387509,91.80502250651504,6
0.05,4221,94,387603,91.80554239696826,8
0.05,4222,91,387694,91.80535164574947,10
0.05,4223,92,387786,91.80539772727273,9
0.05,4224,94,387880,91.80591715976331,7
0.05,4225,95,387975,91.80667297681022,8
0.05,4226,94,388069,91.80719186184055,7
0.05,4227,94,388163,91.80771050141911,7
0.05,4228,94,388257,91.80822889572003,7
0.05,4229,91,388348,91.8080378250591,10
0.05,4230,92,388440,91.80808319546206,9
0.05,4231,94,388534,91.80860113421551,7
0.05,4232,95,388629,91.80935506732814,6
0.05,4233,95,388724,91.81010864430799,6
0.05,4234,95,388819,91.81086186540732,7
0.05,4235,94,388913,91.81137865911236,7
0.05,4236,94,389007,91.8118952088742,7
0.05,4237,96,389103,91.81288343558282,6
0.05,4238,92,389195,91.81292757725879,9
0.05,4239,94,389289,91.81344339622642,7
0.05,4240,96,389385,91.81443055883047,6
0.05,4241,94,389479,91.81494578029232,7
0.05,4242,94,389573,91.815460758897,7
0.05,4243,91,389664,91.81526861451461,11
0.05,4244,94,389758,91.81578327444052,7
0.05,4245,91,389849,91.81559114460669,10
0.05,4246,95,389944,91.81634094655051,6
0.05,4247,94,390038,91.8168549905838,7
0.05,4248,94,390132,91.81736879265709,7
0.05,4249,91,390223,91.81717647058824,10
0.05,4250,96,390319,91.81816043283933,6
0.05,4251,93,390412,91.81843838193791,10
0.05,4252,95,390507,91.81918645661885,6
0.05,4253,92,390599,91.81922896097791,10
0.05,4254,95,390694,91.81997649823737,6
0.05,4255,95,390789,91.82072368421052,7
0.05,4256,94,390883,91.82123561193329,7
0.05,4257,89,390972,91.82057303898544,12
0.05,4258,95,391067,91.82131955858182,6
0.05,4259,24,391091,91.80539906103286,10
0.05,4260,94,391185,91.80591410467026,7
0.05,4261,94,391279,91.80642890661662,7
0.05,4262,94,391373,91.80694346704199,7
0.05,4263,94,391467,91.80745778611632,7
0.05,4264,96,391563,91.8084407971864,6
0.05,4265,96,391659,91.80942334739802,6
0.05,4266,96,391755,91.81040543707523,6
0.05,4267,96,391851,91.81138706654171,6
0.05,4268,95,391946,91.81213398922465,6
0.05,4269,91,392037,91.81194379391101,10
0.05,4270,95,392132,91.81269023647857,6
0.05,4271,91,392223,91.8125,10
0.05,4272,91,392314,91.8123098525626,11
0.05,4273,96,392410,91.81328965839963,6
0.05,4274,93,392503,91.81356725146199,9
0.05,4275,91,392594,91.8133769878391,10
0.05,4276,93,392687,91.81365443067571,8
0.05,4277,94,392781,91.81416549789621,7
0.05,4278,94,392875,91.81467632624445,7
0.05,4279,93,392968,91.81495327102803,8
0.05,4280,94,393062,91.81546367671105,7
0.05,4281,94,393156,91.81597384399814,7
0.05,4282,94,393250,91.81648377305626,7
0.05,4283,95,393345,91.8172268907563,6
0.05,4284,92,393437,91.81726954492416,9
0.05,4285,92,393529,91.81731217918805,9
0.05,4286,87,393616,91.8161884767903,14
0.05,4287,94,393710,91.81669776119404,7
0.05,4288,89,393799,91.81604103520634,12
0.05,4289,94,393893,91.81655011655012,7
0.05,4290,94,393987,91.81705896061524,7
0.05,4291,27,394014,91.80195712954334,6
0.05,4292,94,394108,91.80246913580247,8
0.05,4293,94,394202,91.8029809035864,7
0.05,4294,94,394296,91.8034924330617,7
0.05,4295,94,394390,91.80400372439479,7
0.05,4296,96,394486,91.80498021875728,6
0.05,4297,94,394580,91.8054909260121,8
0.05,4298,91,394671,91.8053035589672,10
0.05,4299,94,394765,91.80581395348837,7
0.05,4300,95,394860,91.80655661474076,6
0.05,4301,93,394953,91.8068340306834,8
0.05,4302,92,395045,91.80687892168255,9
0.05,4303,96,395141,91.8078531598513,6
0.05,4304,95,395236,91.80859465737514,6
0.05,4305,93,395329,91.80887134231305,9
0.05,4306,96,395425,91.80984443928489,6
0.05,4307,93,395518,91.81012070566388,8
0.05,4308,92,395610,91.81016477140868,11
0.05,4309,95,395705,91.81090487238978,8
0.05,4310,92,395797,91.81094873579217,9
0.05,4311,90,395887,91.81052875695732,11
0.05,4312,96,395983,91.81150011592858,6
0.05,4313,95,396078,91.81223922114047,6
0.05,4314,92,396170,91.81228273464659,9
0.05,4315,95,396265,91.81302131603337,6
0.05,4316,95,396360,91.8137595552467,7
0.05,4317,93,396453,91.81403427512737,8
0.05,4318,92,396545,91.81407733271591,9
0.05,4319,94,396639,91.81458333333333,7
0.05,4320,94,396733,91.81508909974544,7
0.05,4321,95,396828,91.81582600647849,6
0.05,4322,96,396924,91.81679389312977,6
0.05,4323,26,396950,91.80157261794635,7
0.05,4324,94,397044,91.80208092485549,10
0.05,4325,93,397137,91.80235783633842,9
0.05,4326,96,397233,91.80332794083661,6
0.05,4327,94,397327,91.80383548983365,7
0.05,4328,94,397421,91.80434280434281,8
0.05,4329,92,397513,91.80438799076212,9
0.05,4330,91,397604,91.80420226275687,10
0.05,4331,90,397694,91.80378578024008,11
0.05,4332,94,397788,91.80429263789522,8
0.05,4333,93,397881,91.80456852791878,8
0.05,4334,94,397975,91.80507497116494,8
0.05,4335,90,398065,91.80465867158672,11
0.05,4336,96,398161,91.80562600876182,6
0.05,4337,96,398257,91.8065928999539,6
0.05,4338,93,398350,91.8068679419221,8
0.05,4339,94,398444,91.8073732718894,7
0.05,4340,95,398539,91.8081087307072,6
0.05,4341,96,398635,91.80907415937357,6
0.05,4342,90,398725,91.80865760994705,11
0.05,4343,94,398819,91.8091620626151,8
0.05,4344,93,398912,91.80943613348677,8
0.05,4345,93,399005,91.80971007823285,8
0.05,4346,21,399026,91.79342074994248,11
0.05,4347,95,399121,91.79415823367066,6
0.05,4348,23,399144,91.77833984824098,10
0.05,4349,96,399240,91.77931034482759,6
0.05,4350,96,399336,91.78028039531142,6
0.05,4351,94,399430,91.78079044117646,7
0.05,4352,93,399523,91.78107052607398,9
0.05,4353,96,399619,91.78203950390446,6
0.05,4354,92,399711,91.7820895522388,9
0.05,4355,96,399807,91.78305785123968,6
0.05,4356,94,399901,91.78356667431719,7
0.05,4357,91,399992,91.78338687471317,12
0.05,4358,95,400087,91.78412479926588,7
0.05,4359,94,400181,91.78463302752293,7
0.05,4360,93,400274,91.78491171749599,9
0.05,4361,94,400368,91.78541953232462,8
0.05,4362,95,400463,91.78615631446253,6
0.05,4363,96,400559,91.78712190650779,6
0.05,4364,93,400652,91.78739977090493,8
0.05,4365,92,400744,91.78744846541457,9
0.05,4366,94,400838,91.78795511792993,7
0.05,4367,91,400929,91.78777472527473,10
0.05,4368,93,401022,91.78805218585488,8
0.05,4369,95,401117,91.78878718535469,7
0.05,4370,92,401209,91.78883550674902,9
0.05,4371,95,401304,91.78956999085086,7
0.05,4372,93,401397,91.78984678710268,8
0.05,4373,92,401489,91.78989483310471,9
0.05,4374,96,401585,91.79085714285715,6
0.05,4375,94,401679,91.79136197440585,7
0.05,4376,93,401772,91.79163810829336,8
0.05,4377,96,401868,91.79259936043856,6
0.05,4378,96,401964,91.7935601735556,6
0.05,4379,94,402058,91.79406392694064,8
0.05,4380,94,402152,91.7945674503538,7
0.05,4381,95,402247,91.79529895025102,6
0.05,4382,96,402343,91.79625827059093,6
0.05,4383,94,402437,91.7967609489051,7
0.05,4384,95,402532,91.79749144811859,6
0.05,4385,94,402626,91.79799361605107,7
0.05,4386,88,402714,91.79712787782083,14
0.05,4387,93,402807,91.79740200546946,8
0.05,4388,94,402901,91.79790385053543,7
0.05,4389,94,402995,91.7984054669704,7
0.05,4390,92,403087,91.79845137781827,9
0.05,4391,92,403179,91.79849726775956,9
0.05,4392,96,403275,91.79945367630322,6
0.05,4393,92,403367,91.79949931725079,9
0.05,4394,94,403461,91.8,7
0.05,4395,93,403554,91.80027297543221,8
0.05,4396,94,403648,91.8007732544917,7
0.05,4397,90,403738,91.80036380172805,11
0.05,4398,95,403833,91.80109115708116,8
0.05,4399,94,403927,91.8015909090909,7
0.05,4400,92,404019,91.80163599182004,9
0.05,4401,94,404113,91.80213539300318,7
0.05,4402,93,404206,91.80240744946627,8
0.05,4403,94,404300,91.80290644868302,7
0.05,4404,92,404392,91.80295119182747,10
0.05,4405,94,404486,91.80344984112574,7
0.05,4406,94,404580,91.80394826412525,7
0.05,4407,87,404667,91.80285843920146,14
0.05,4408,92,404759,91.80290315264233,9
0.05,4409,95,404854,91.80362811791383,6
0.05,4410,93,404947,91.80389934255271,8
0.05,4411,94,405041,91.8043970988214,10
0.05,4412,94,405135,91.80489462950374,7
0.05,4413,95,405230,91.80561848663343,6
0.05,4414,95,405325,91.80634201585504,6
0.05,4415,95,405420,91.8070652173913,6
0.05,4416,94,405514,91.8075616934571,7
0.05,4417,95,405609,91.80828429153463,6
0.05,4418,92,405701,91.80832767594478,9
0.05,4419,95,405796,91.80904977375566,7
0.05,4420,96,405892,91.8099977380683,6
0.05,4421,94,405986,91.81049298959746,7
0.05,4422,95,406081,91.81121410807144,6
0.05,4423,95,406176,91.8119349005425,6
0.05,4424,91,406267,91.81175141242937,10
0.05,4425,93,406360,91.81201988251243,8
0.05,4426,96,406456,91.81296589112266,6
0.05,4427,96,406552,91.81391147244805,6
0.05,4428,93,406645,91.81417927297359,9
0.05,4429,95,406740,91.81489841986456,7
0.05,4430,95,406835,91.81561724215753,6
0.05,4431,94,406929,91.81611010830325,7
0.05,4432,92,407021,91.81615159034514,9
0.05,4433,94,407115,91.81664411366712,8
0.05,4434,91,407206,91.81645997745208,11
0.05,4435,96,407302,91.81740306582506,6
0.05,4436,94,407396,91.81789497408158,8
0.05,4437,95,407491,91.8186119873817,7
0.05,4438,93,407584,91.81887812570399,8
0.05,4439,94,407678,91.81936936936937,7
0.05,4440,94,407772,91.81986039180364,7
0.05,4441,95,407867,91.82057631697434,6
0.05,4442,95,407962,91.82129191987396,6
0.05,4443,94,408056,91.82178217821782,7
0.05,4444,94,408150,91.822272215973,7
0.05,4445,94,408244,91.82276203328836,7
0.05,4446,94,408338,91.82325163031257,8
0.05,4447,96,408434,91.82419064748201,6
0.05,4448,93,408527,91.82445493369296,8
0.05,4449,92,408619,91.82449438202246,9
0.05,4450,96,408715,91.82543248708156,6
0.05,4451,95,408810,91.82614555256065,7
0.05,4452,94,408904,91.82663373006962,8
0.05,4453,90,408994,91.82622361921868,11
0.05,4454,94,409088,91.8267115600449,7
0.05,4455,93,409181,91.8269748653501,8
0.05,4456,93,409274,91.82723805250168,8
0.05,4457,96,409370,91.82817406908927,6
0.05,4458,95,409465,91.82888540031396,7
0.05,4459,96,409561,91.82982062780269,6
0.05,4460,92,409653,91.82985877605918,9
0.05,4461,96,409749,91.8307933662035,6
0.05,4462,95,409844,91.83150347300023,6
0.05,4463,96,409940,91.83243727598567,6
0.05,4464,92,410032,91.83247480403135,9
0.05,4465,94,410126,91.83296014330497,7
0.05,4466,96,410222,91.83389299306022,6
0.05,4467,93,410315,91.8341539838854,8
0.05,4468,92,410407,91.83419109420451,9
0.05,4469,95,410502,91.83489932885907,7
0.05,4470,96,410598,91.83583091031089,6
0.05,4471,91,410689,91.83564400715564,10
0.05,4472,93,410782,91.83590431477755,9
0.05,4473,91,410873,91.8357174787662,10
0.05,4474,93,410966,91.83597765363129,9
0.05,4475,91,411057,91.83579088471849,10
0.05,4476,89,411146,91.83515747152111,12
0.05,4477,93,411239,91.83541759714159,8
0.05,4478,96,411335,91.83634739897299,6
0.05,4479,92,411427,91.83638392857142,9
0.05,4480,92,411519,91.83642044186566,9
0.05,4481,26,411545,91.82173136992414,7
0.05,4482,95,411640,91.82244033013608,8
0.05,4483,95,411735,91.82314897413023,6
0.05,4484,92,411827,91.8231884057971,9
0.05,4485,93,411920,91.82345073562193,9
0.05,4486,86,412006,91.82215288611545,15
0.05,4487,92,412098,91.82219251336899,9
0.05,4488,94,412192,91.82267765649365,8
0.05,4489,95,412287,91.82338530066815,6
0.05,4490,93,412380,91.82364729458918,8
0.05,4491,91,412471,91.82346393588602,10
0.05,4492,95,412566,91.82417093256176,6
0.05,4493,96,412662,91.82510013351134,6
0.05,4494,94,412756,91.82558398220245,7
0.05,4495,95,412851,91.82629003558719,7
0.05,4496,96,412947,91.8272181454303,6
0.05,4497,95,413042,91.82792352156514,7
0.05,4498,93,413135,91.82818404089798,8
0.05,4499,94,413229,91.82866666666666,7
0.05,4500,94,413323,91.82914907798268,7
0.05,4501,94,413417,91.8296312749889,8
0.05,4502,96,413513,91.83055740617367,6
0.05,4503,96,413609,91.83148312611013,6
0.05,4504,95,413704,91.83218645948945,6
0.05,4505,95,413799,91.83288948069242,6
0.05,4506,96,413895,91.83381406700688,6
0.05,4507,94,413989,91.83429458740018,8
0.05,4508,92,414081,91.83433133732535,9
0.05,4509,96,414177,91.83525498891352,6
0.05,4510,95,414272,91.83595655065396,6
0.05,4511,94,414366,91.83643617021276,7
0.05,4512,96,414462,91.8373587414137,6
0.05,4513,96,414558,91.83828090385468,6
0.05,4514,95,414653,91.8389811738649,6
0.05,4515,89,414742,91.83835252435784,12
0.05,4516,94,414836,91.83883108257693,7
0.05,4517,94,414930,91.83930942895087,7
0.05,4518,95,415025,91.84000885151582,6
0.05,4519,93,415118,91.84026548672567,8
0.05,4520,92,415210,91.84030081840301,9
0.05,4521,91,415301,91.84011499336577,11
0.05,4522,93,415394,91.84037143488835,8
0.05,4523,92,415486,91.84040671971707,9
0.05,4524,94,415580,91.84088397790055,8
0.05,4525,94,415674,91.84136102518781,7
0.05,4526,94,415768,91.84183786171857,7
0.05,4527,96,415864,91.84275618374558,6
0.05,4528,94,415958,91.84323250165599,7
0.05,4529,95,416053,91.8439293598234,6
0.05,4530,95,416148,91.84462591039505,6
0.05,4531,94,416242,91.8451015004413,7
0.05,4532,93,416335,91.84535627619678,8
0.05,4533,95,416430,91.84605205116894,8
0.05,4534,95,416525,91.84674751929438,6
0.05,4535,96,416621,91.84766313932981,6
0.05,4536,94,416715,91.84813753581662,7
0.05,4537,95,416810,91.84883208461878,7
0.05,4538,94,416904,91.84930601454064,7
0.05,4539,95,416999,91.85,6
0.05,4540,95,417094,91.85069367980621,6
0.05,4541,94,417188,91.851166886834,8
0.05,4542,95,417283,91.85186000440238,6
0.05,4543,90,417373,91.85145246478874,11
0.05,4544,94,417467,91.85192519251925,7
0.05,4545,95,417562,91.85261768587769,7
0.05,4546,90,417652,91.8522102485155,11
0.05,4547,94,417746,91.85268249780123,7
0.05,4548,95,417841,91.85337436799297,6
0.05,4549,93,417934,91.85362637362637,8
0.05,4550,94,418028,91.85409800043946,7
0.05,4551,94,418122,91.85456942003515,7
0.05,4552,94,418216,91.85504063254997,7
0.05,4553,94,418310,91.85551163812033,7
0.05,4554,92,418402,91.8555433589462,9
0.05,4555,94,418496,91.85601404741001,7
0.05,4556,96,418592,91.8569234145271,6
0.05,4557,93,418685,91.85717419921018,8
0.05,4558,96,418781,91.8580829129195,6
0.05,4559,94,418875,91.85855263157895,7
0.05,4560,94,418969,91.8590221442666,7
0.05,4561,95,419064,91.85971065322227,6
0.05,4562,96,419160,91.86061801446417,6
0.05,4563,96,419256,91.86152497808939,6
0.05,4564,25,419281,91.84687842278204,8
0.05,4565,94,419375,91.84734997809899,7
0.05,4566,96,419471,91.84825925114956,6
0.05,4567,91,419562,91.84807355516638,10
0.05,4568,94,419656,91.8485445392865,8
0.05,4569,95,419751,91.8492341356674,6
0.05,4570,95,419846,91.8499234303216,6
0.05,4571,95,419941,91.85061242344707,6
0.05,4572,95,420036,91.85130111524164,6
0.05,4573,94,420130,91.85177087888063,7
0.05,4574,93,420223,91.8520218579235,8
0.05,4575,94,420317,91.85249125874125,7
0.05,4576,92,420409,91.85252348700021,9
0.05,4577,94,420503,91.85299257317605,7
0.05,4578,91,420594,91.85280628958287,10
0.05,4579,93,420687,91.85305676855896,8
0.05,4580,93,420780,91.85330713817943,8
0.05,4581,95,420875,91.85399388913139,6
0.05,4582,95,420970,91.8546803403884,6
0.05,4583,94,421064,91.85514834205934,7
0.05,4584,93,421157,91.85539803707742,8
0.05,4585,27,421184,91.84125599651112,6
0.05,4586,92,421276,91.84129060388054,9
0.05,4587,24,421300,91.82650392327811,8
0.05,4588,95,421395,91.8271954674221,6
0.05,4589,94,421489,91.8276688453159,7
0.05,4590,94,421583,91.82814201698976,7
0.05,4591,92,421675,91.82817944250871,9
0.05,4592,92,421767,91.8282168517309,9
0.05,4593,94,421861,91.82868959512408,7
0.05,4594,92,421953,91.82872687704027,9
0.05,4595,94,422047,91.82919930374239,7
0.05,4596,94,422141,91.82967152490755,8
0.05,4597,91,422232,91.8294910830796,10
0.05,4598,95,422327,91.83018047401609,6
0.05,4599,94,422421,91.83065217391304,7
0.05,4600,93,422514,91.83090632471202,8
0.05,4601,93,422607,91.83116036505866,8
0.05,4602,93,422700,91.83141429502498,8
0.05,4603,93,422793,91.83166811468288,8
0.05,4604,93,422886,91.83192182410423,8
0.05,4605,93,422979,91.83217542336084,8
0.05,4606,94,423073,91.83264597351855,7
0.05,4607,92,423165,91.83268229166667,9
0.05,4608,94,423259,91.83315252766327,8
0.05,4609,94,423353,91.83362255965292,7
0.05,4610,94,423447,91.83409238776838,7
0.05,4611,94,423541,91.83456201214224,7
0.05,4612,88,423629,91.83373076089313,13
0.05,4613,94,423723,91.83420026007802,7
0.05,4614,94,423817,91.83466955579631,7
0.05,4615,95,423912,91.83535528596187,6
0.05,4616,95,424007,91.83604071908165,6
0.05,4617,96,424103,91.83694239930706,6
0.05,4618,94,424197,91.83741069495562,8
0.05,4619,93,424290,91.83766233766234,8
0.05,4620,94,424384,91.83813027483228,7
0.05,4621,95,424479,91.8388143660753,6
0.05,4622,94,424573,91.8392818516115,8
0.05,4623,94,424667,91.8397491349481,7
0.05,4624,94,424761,91.84021621621622,7
0.05,4625,92,424853,91.84025075659316,9
0.05,4626,87,424940,91.83920466825157,14
0.05,4627,92,425032,91.83923941227312,9
0.05,4628,93,425125,91.83949017066321,8
0.05,4629,95,425220,91.8401727861771,6
0.05,4630,94,425314,91.84063917080545,8
0.05,4631,95,425409,91.84132124352331,6
0.05,4632,92,425501,91.84135549320095,9
0.05,4633,93,425594,91.84160552438497,8
0.05,4634,93,425687,91.84185544768069,8
0.05,4635,96,425783,91.84275237273512,6
0.05,4636,94,425877,91.84321759758464,7
0.05,4637,96,425973,91.84411384217336,6
0.05,4638,86,426059,91.84285406337573,15
0.05,4639,94,426153,91.84331896551724,7
0.05,4640,94,426247,91.84378366731308,7
0.05,4641,93,426340,91.84403274450668,8
0.05,4642,93,426433,91.8442817144088,8
0.05,4643,96,426529,91.84517657192076,6
0.05,4644,93,426622,91.84542518837459,8
0.05,4645,93,426715,91.84567369780456,9
0.05,4646,94,426809,91.84613729287713,7
0.05,4647,96,426905,91.84703098106712,6
0.05,4648,93,426998,91.8472789847279,8
0.05,4649,95,427093,91.84795698924731,7
0.05,4650,95,427188,91.84863470221458,6
0.05,4651,91,427279,91.84845227858986,10
0.05,4652,95,427374,91.84912959381045,6
0.05,4653,93,427467,91.84937688010314,8
0.05,4654,93,427560,91.84962406015038,8
0.05,4655,96,427656,91.85051546391753,6
0.05,4656,92,427748,91.85054756280867,9
0.05,4657,96,427844,91.8514383855732,6
0.05,4658,94,427938,91.8518995492595,7
0.05,4659,94,428032,91.85236051502146,7
0.05,4660,90,428122,91.85196309804763,11
0.05,4661,91,428213,91.85178035178035,10
0.05,4662,94,428307,91.85224104653656,7
0.05,4663,94,428401,91.85270154373929,8
0.05,4664,95,428496,91.85337620578778,6
0.05,4665,96,428592,91.854264894985,6
0.05,4666,90,428682,91.85386758088708,11
0.05,4667,95,428777,91.85454155955442,6
0.05,4668,94,428871,91.85500107089312,7
0.05,4669,95,428966,91.85567451820128,6
0.05,4670,94,429060,91.85613359023763,7
0.05,4671,96,429156,91.85702054794521,6
0.05,4672,94,429250,91.85747913545902,7
0.05,4673,93,429343,91.85772357723577,8
0.05,4674,93,429436,91.8579679144385,8
0.05,4675,90,429526,91.85757057313944,11
0.05,4676,95,429621,91.85824246311738,6
0.05,4677,90,429711,91.85784523300556,11
0.05,4678,94,429805,91.8583030562086,7
0.05,4679,93,429898,91.858547008547,8
0.05,4680,94,429992,91.8590044862209,7
0.05,4681,90,430082,91.85860743272106,11
0.05,4682,94,430176,91.85906470211403,7
0.05,4683,95,430271,91.85973526900085,6
0.05,4684,95,430366,91.86040554962646,6
0.05,4685,92,430458,91.86043533930858,9
0.05,4686,94,430552,91.8608918284617,7
0.05,4687,91,430643,91.86070819112628,10
0.05,4688,93,430736,91.86095116229474,8
0.05,4689,93,430829,91.86119402985075,8
0.05,4690,92,430921,91.8612236196973,9
0.05,4691,92,431013,91.86125319693095,9
0.05,4692,94,431107,91.86170892819092,7
0.05,4693,89,431196,91.86109927567107,13
0.05,4694,27,431223,91.84728434504792,6
0.05,4695,93,431316,91.84752981260647,9
0.05,4696,94,431410,91.84798807749627,7
0.05,4697,96,431506,91.84887186036612,6
0.05,4698,92,431598,91.84890402213237,9
0.05,4699,94,431692,91.84936170212767,7
0.05,4700,94,431786,91.84981918740694,7
0.05,4701,93,431879,91.85006380263718,8
0.05,4702,93,431972,91.85030831384223,8
0.05,4703,93,432065,91.85055272108843,8
0.05,4704,96,432161,91.85143464399574,6
0.05,4705,94,432255,91.85189120271993,8
0.05,4706,95,432350,91.85256001699597,6
0.05,4707,95,432445,91.85322854715378,6
0.05,4708,96,432541,91.85410915268635,6
0.05,4709,89,432630,91.85350318471338,12
0.05,4710,95,432725,91.85417108894077,6
0.05,4711,94,432819,91.85462648556876,7
0.05,4712,92,432911,91.85465733078719,9
0.05,4713,92,433003,91.85468816291896,9
0.05,4714,93,433096,91.85493107104985,8
0.05,4715,92,433188,91.85496183206106,9
0.05,4716,94,433282,91.85541657833369,7
0.05,4717,94,433376,91.85587113183553,7
0.05,4718,95,433471,91.85653740199194,6
0.05,4719,96,433567,91.85741525423728,6
0.05,4720,93,433660,91.85765727600085,8
0.05,4721,93,433753,91.85789919525625,8
0.05,4722,94,433847,91.85835274190133,7
0.05,4723,95,433942,91.85901778154107,6
0.05,4724,94,434036,91.85947089947089,7
0.05,4725,95,434131,91.8601354210749,7
0.05,4726,92,434223,91.86016500951978,9
0.05,4727,94,434317,91.86061759729273,7
0.05,4728,27,434344,91.84690209346584,6
0.05,4729,94,434438,91.84735729386892,7
0.05,4730,92,434530,91.84738955823293,9
0.05,4731,95,434625,91.84805579036349,6
0.05,4732,92,434717,91.84808789351362,9
0.05,4733,96,434813,91.84896493451626,6
0.05,4734,94,434907,91.849419218585,8
0.05,4735,94,435001,91.8498733108108,7
0.05,4736,91,435092,91.84969389909226,10
0.05,4737,94,435186,91.85014774166315,7
0.05,4738,85,435271,91.84870225786031,16
0.05,4739,91,435362,91.84852320675105,10
0.05,4740,96,435458,91.84939886099978,6
0.05,4741,91,435549,91.84921973850696,10
0.05,4742,94,435643,91.84967320261438,7
0.05,4743,95,435738,91.85033726812816,7
0.05,4744,92,435830,91.85036880927292,9
0.05,4745,90,435920,91.84997892962495,11
0.05,4746,91,436011,91.84979987360438,10
0.05,4747,94,436105,91.85025273799495,7
0.05,4748,94,436199,91.85070541166561,7
0.05,4749,93,436292,91.85094736842105,8
0.05,4750,93,436385,91.85118922332141,9
0.05,4751,96,436481,91.85206228956228,6
0.05,4752,95,436576,91.85272459499264,7
0.05,4753,94,436670,91.85317627261254,7
0.05,4754,94,436764,91.85362776025237,7
0.05,4755,94,436858,91.85407905803196,7
0.05,4756,96,436954,91.85495059911709,6
0.05,4757,94,437048,91.85540142917192,7
0.05,4758,94,437142,91.85585206976255,7
0.05,4759,87,437229,91.85483193277311,14
0.05,4760,92,437321,91.85486242386054,9
0.05,4761,93,437414,91.85510289794205,8
0.05,4762,96,437510,91.85597312618098,6
0.05,4763,94,437604,91.85642317380352,7
0.05,4764,90,437694,91.85603357817419,11
0.05,4765,92,437786,91.85606378514477,9
0.05,4766,93,437879,91.85630375498216,8
0.05,4767,96,437975,91.85717281879195,6
0.05,4768,91,438066,91.85699308031033,10
0.05,4769,92,438158,91.85702306079665,9
0.05,4770,96,438254,91.85789142737372,6
0.05,4771,96,438350,91.85875943000838,6
0.05,4772,96,438446,91.8596270689294,6
0.05,4773,94,438540,91.8600754084625,8
0.05,4774,94,438634,91.86052356020943,7
0.05,4775,93,438727,91.8607621440536,8
0.05,4776,94,438821,91.86120996441281,7
0.05,4777,92,438913,91.86123901213897,9
0.05,4778,94,439007,91.86168654530236,7
0.05,4779,96,439103,91.86255230125523,6
0.05,4780,94,439197,91.86299937251621,7
0.05,4781,92,439289,91.86302802174822,9
0.05,4782,96,439385,91.86389295421284,6
0.05,4783,93,439478,91.86413043478261,8
0.05,4784,94,439572,91.86457680250784,7
0.05,4785,93,439665,91.86481404095278,8
0.05,4786,96,439761,91.86567787758513,6
0.05,4787,96,439857,91.86654135338345,6
0.05,4788,93,439950,91.86677803299227,9
0.05,4789,94,440044,91.86722338204594,7
0.05,4790,95,440139,91.86787726988102,6
0.05,4791,95,440234,91.86853088480801,6
0.05,4792,93,440327,91.86876695180472,8
0.05,4793,94,440421,91.86921151439299,7
0.05,4794,93,440514,91.86944734098019,8
0.05,4795,93,440607,91.86968306922435,9
0.05,4796,93,440700,91.869918699187,8
0.05,4797,95,440795,91.8705710712797,6
0.05,4798,95,440890,91.87122317149407,6
0.05,4799,93,440983,91.87145833333334,8
0.05,4800,94,441077,91.87190168714851,8
0.05,4801,95,441172,91.87255310287381,7
0.05,4802,96,441268,91.87341245055174,6
0.05,4803,94,441362,91.87385512073273,7
0.05,4804,95,441457,91.87450572320499,6
0.05,4805,92,441549,91.87453183520599,9
0.05,4806,91,441640,91.87434990638651,10
0.05,4807,94,441734,91.87479201331115,7
0.05,4808,96,441830,91.87564982324808,6
0.05,4809,95,441925,91.87629937629937,6
0.05,4810,93,442018,91.87653294533361,8
0.05,4811,91,442109,91.87635078969244,10
0.05,4812,92,442201,91.87637648036568,9
0.05,4813,92,442293,91.8764021603656,9
0.05,4814,90,442383,91.87601246105919,11
0.05,4815,93,442476,91.87624584717608,8
0.05,4816,96,442572,91.87710193066223,6
0.05,4817,91,442663,91.8769198837692,10
0.05,4818,94,442757,91.87736044822577,7
0.05,4819,94,442851,91.87780082987553,7
0.05,4820,94,442945,91.87824102883219,7
0.05,4821,95,443040,91.87888842803815,8
0.05,4822,94,443134,91.87932821895086,7
0.05,4823,92,443226,91.87935323383084,9
0.05,4824,95,443321,91.88,6
0.05,4825,94,443415,91.88043928719436,7
0.05,4826,95,443510,91.88108556038948,7
0.05,4827,95,443605,91.88173156586578,6
0.05,4828,94,443699,91.88217022157797,7
0.05,4829,95,443794,91.88281573498965,8
0.05,4830,92,443886,91.88283999172015,9
0.05,4831,95,443981,91.88348509933775,6
0.05,4832,96,444077,91.88433685081729,6
0.05,4833,94,444171,91.88477451386015,8
0.05,4834,95,444266,91.88541882109617,7
0.05,4835,95,444361,91.88606286186932,6
0.05,4836,95,444456,91.88670663634484,6
0.05,4837,92,444548,91.88673005374122,9
0.05,4838,90,444638,91.88634015292416,11
0.05,4839,89,444727,91.8857438016529,12
0.05,4840,89,444816,91.88514769675687,12
0.05,4841,94,444910,91.8855844692276,7
0.05,4842,90,445000,91.8851951269874,11
0.05,4843,91,445091,91.88501238645748,10
0.05,4844,94,445185,91.88544891640866,7
0.05,4845,94,445279,91.88588526619893,7
0.05,4846,92,445371,91.88590880957292,9
0.05,4847,91,445462,91.88572607260726,10
0.05,4848,94,445556,91.88616209527737,7
0.05,4849,93,445649,91.88639175257732,8
0.05,4850,95,445744,91.88703360131932,6
0.05,4851,27,445771,91.87366034624897,6
0.05,4852,95,445866,91.8743045538842,6
0.05,4853,96,445962,91.87515451174289,6
0.05,4854,93,446055,91.87538619979402,9
0.05,4855,95,446150,91.87602965403624,6
0.05,4856,94,446244,91.87646695491044,8
0.05,4857,95,446339,91.87710992177851,6
0.05,4858,15,446354,91.8612883309323,17
0.05,4859,95,446449,91.8619341563786,6
0.05,4860,94,446543,91.86237399711993,7
0.05,4861,91,446634,91.8621966269025,10
0.05,4862,96,446730,91.86304750154225,6
0.05,4863,94,446824,91.86348684210526,7
0.05,4864,92,446916,91.86351490236382,9
0.05,4865,94,447010,91.86395396629675,7
0.05,4866,94,447104,91.8643928498048,7
0.05,4867,93,447197,91.86462612982744,8
0.05,4868,94,447291,91.86506469500924,7
0.05,4869,94,447385,91.86550308008214,7
0.05,4870,82,447467,91.86347772531307,19
0.05,4871,95,447562,91.86412151067323,6
0.05,4872,94,447656,91.86455981941309,7
0.05,4873,96,447752,91.86540828887976,6
0.05,4874,94,447846,91.86584615384615,7
0.05,4875,94,447940,91.86628383921247,8
0.05,4876,92,448032,91.86631125692024,9
0.05,4877,90,448122,91.8659286592866,11
0.05,4878,93,448215,91.86616109858578,8
0.05,4879,95,448310,91.86680327868852,7
0.05,4880,95,448405,91.86744519565663,6
0.05,4881,95,448500,91.86808684965179,6
0.05,4882,95,448595,91.86872824083555,6
0.05,4883,93,448688,91.86895986895986,8
0.05,4884,90,448778,91.86857727737973,11
0.05,4885,94,448872,91.86901350798199,7
0.05,4886,94,448966,91.86944956005729,7
0.05,4887,94,449060,91.86988543371523,7
0.05,4888,96,449156,91.87073021067702,6
0.05,4889,95,449251,91.87137014314928,6
0.05,4890,93,449344,91.87160089961154,8
0.05,4891,94,449438,91.87203597710548,8
0.05,4892,93,449531,91.8722665031678,8
0.05,4893,94,449625,91.87270126685738,7
0.05,4894,94,449719,91.87313585291113,7
0.05,4895,95,449814,91.87377450980392,6
0.05,4896,94,449908,91.87420869920359,7
0.05,4897,95,450003,91.87484687627602,8
0.05,4898,95,450098,91.87548479281486,6
0.05,4899,94,450192,91.87591836734694,7
0.05,4900,93,450285,91.8761477249541,9
0.05,4901,92,450377,91.87617299061607,9
0.05,4902,94,450471,91.87660615949419,7
0.05,4903,96,450567,91.87744698205546,6
0.05,4904,95,450662,91.87808358817533,6
0.05,4905,94,450756,91.87851610273135,7
0.05,4906,93,450849,91.87874465049929,8
0.05,4907,95,450944,91.87938060309699,7
0.05,4908,93,451037,91.87960888164595,8
0.05,4909,94,451131,91.88004073319756,8
0.05,4910,94,451225,91.88047240887803,7
0.05,4911,94,451319,91.88090390879479,7
0.05,4912,94,451413,91.88133523305515,7
0.05,4913,94,451507,91.88176638176638,7
0.05,4914,94,451601,91.8821973550356,7
0.05,4915,95,451696,91.88283157038242,8
0.05,4916,95,451791,91.88346552776083,6
0.05,4917,94,451885,91.88389589263929,7
0.05,4918,94,451979,91.8843260825371,7
0.05,4919,92,452071,91.88434959349594,9
0.05,4920,92,452163,91.88437309489942,9
0.05,4921,94,452257,91.88480292563999,7
0.05,4922,94,452351,91.88523258175908,7
0.05,4923,95,452446,91.88586515028432,6
0.05,4924,93,452539,91.88609137055838,8
0.05,4925,94,452633,91.88652050345108,7
0.05,4926,94,452727,91.88694946214736,7
0.05,4927,95,452822,91.88758116883118,6
0.05,4928,95,452917,91.88821261919253,6
0.05,4929,94,453011,91.88864097363083,8
0.05,4930,89,453100,91.8880551612249,12
0.05,4931,92,453192,91.88807785888078,9
0.05,4932,94,453286,91.88850598013379,7
0.05,4933,94,453380,91.88893392784759,8
0.05,4934,92,453472,91.88895643363729,9
0.05,4935,95,453567,91.88958670988654,6
0.05,4936,95,453662,91.89021673080818,7
0.05,4937,92,453754,91.89023896314298,9
0.05,4938,96,453850,91.89107106701762,6
0.05,4939,93,453943,91.89129554655871,8
0.05,4940,92,454035,91.89131754705525,9
0.05,4941,96,454131,91.89214892755969,6
0.05,4942,95,454226,91.8927776653854,6
0.05,4943,93,454319,91.89300161812298,8
0.05,4944,95,454414,91.89362992922143,6
0.05,4945,95,454509,91.89425798625152,8
0.05,4946,92,454601,91.89427936122902,9
0.05,4947,96,454697,91.89510913500405,6
0.05,4948,94,454791,91.89553445140433,7
0.05,4949,27,454818,91.88242424242424,6
0.05,4950,25,454843,91.8689153706322,8
0.05,4951,94,454937,91.86934571890146,7
0.05,4952,94,455031,91.86977589339794,7
0.05,4953,94,455125,91.87020589422688,7
0.05,4954,94,455219,91.87063572149344,8
0.05,4955,92,455311,91.87066182405165,9
0.05,4956,92,455403,91.87068791607827,9
0.05,4957,22,455425,91.85659540137152,10
0.05,4958,93,455518,91.85682597297843,9
0.05,4959,94,455612,91.85725806451613,7
0.05,4960,96,455708,91.85809312638581,6
0.05,4961,96,455804,91.85892785167272,6
0.05,4962,95,455899,91.85956074954665,6
0.05,4963,94,455993,91.85999194198227,8
0.05,4964,96,456089,91.86082578046324,6
0.05,4965,94,456183,91.86125654450262,7
0.05,4966,93,456276,91.86148580632172,8
0.05,4967,95,456371,91.86211755233495,6
0.05,4968,94,456465,91.8625477963373,7
0.05,4969,94,456559,91.86297786720321,7
0.05,4970,95,456654,91.86360893180446,7
0.05,4971,94,456748,91.86403861625101,7
0.05,4972,94,456842,91.8644681278906,7
0.05,4973,91,456933,91.8642943305187,10
0.05,4974,92,457025,91.8643216080402,9
0.05,4975,92,457117,91.86434887459806,9
0.05,4976,95,457212,91.86497890295358,7
0.05,4977,96,457308,91.86580956207312,6
0.05,4978,95,457403,91.86643904398474,7
0.05,4979,94,457497,91.86686746987952,8
0.05,4980,93,457590,91.86709496085123,8
0.05,4981,94,457684,91.86752308309916,7
0.05,4982,92,457776,91.86754966887418,10
0.05,4983,94,457870,91.86797752808988,8
0.05,4984,94,457964,91.86840521564694,7
0.05,4985,88,458052,91.8676293622142,13
0.05,4986,94,458146,91.86805694806498,8
0.05,4987,94,458240,91.86848436246993,7
0.05,4988,94,458334,91.86891160553218,7
0.05,4989,94,458428,91.8693386773547,7
0.05,4990,96,458524,91.8701662993388,6
0.05,4991,94,458618,91.87059294871794,8
0.05,4992,90,458708,91.87021830562787,11
0.05,4993,94,458802,91.87064477372847,7
0.05,4994,94,458896,91.87107107107107,7
0.05,4995,94,458990,91.8714971977582,8
0.05,4996,93,459083,91.87172303382029,8
0.05,4997,95,459178,91.87234893957583,6
0.05,4998,94,459272,91.87277455491098,7
0.05,4999,94,459366,91.8732,7
0.05,5000,96,459462,91.874025194961,6
0.05,5001,92,459554,91.87405037984806,9
0.05,5002,95,459649,91.87467519488307,6
0.05,5003,93,459742,91.87490007993605,8
0.05,5004,95,459837,91.87552447552447,8
0.05,5005,96,459933,91.87634838194167,6
0.05,5006,94,460027,91.87677251847414,7
0.05,5007,27,460054,91.8638178913738,6
0.05,5008,94,460148,91.86424436015173,7
0.05,5009,95,460243,91.86487025948104,7
0.05,5010,93,460336,91.86509678706845,10
0.05,5011,94,460430,91.86552274541101,7
0.05,5012,94,460524,91.86594853381209,7
0.05,5013,96,460620,91.8667730355006,6
0.05,5014,94,460714,91.86719840478564,7
0.05,5015,24,460738,91.853668261563,10
0.05,5016,20,460758,91.83934622284234,12
0.05,5017,94,460852,91.83977680350738,7
0.05,5018,96,460948,91.84060569834628,6
0.05,5019,93,461041,91.84083665338646,8
0.05,5020,93,461134,91.841067516431,8
0.05,5021,94,461228,91.84149741138988,7
0.05,5022,95,461323,91.8421262193908,6
0.05,5023,94,461417,91.84255573248407,8
0.05,5024,94,461511,91.84298507462687,7
0.05,5025,19,461530,91.82849184241942,14
0.05,5026,95,461625,91.82912273721902,6
0.05,5027,24,461649,91.81563245823389,9
0.05,5028,95,461744,91.81626565917678,6
0.05,5029,94,461838,91.81669980119284,7
0.05,5030,95,461933,91.81733253826278,6
0.05,5031,90,462023,91.81697138314786,11
0.05,5032,92,462115,91.81700774885753,9
0.05,5033,95,462210,91.81764004767581,6
0.05,5034,94,462304,91.81807348560079,7
0.05,5035,93,462397,91.81830818109611,8
0.05,5036,94,462491,91.81874131427438,7
0.05,5037,93,462584,91.81897578404129,8
0.05,5038,96,462680,91.81980551696765,6
0.05,5039,95,462775,91.8204365079365,6
0.05,5040,94,462869,91.82086887522317,7
0.05,5041,96,462965,91.82169773899247,6
0.05,5042,92,463057,91.82173309537973,9
0.05,5043,94,463151,91.8221649484536,7
0.05,5044,94,463245,91.82259663032706,7
0.05,5045,94,463339,91.82302814110186,7
0.05,5046,96,463435,91.82385575589458,6
0.05,5047,91,463526,91.82369255150554,10
0.05,5048,95,463621,91.82432164785106,6
0.05,5049,94,463715,91.82475247524752,7
0.05,5050,94,463809,91.82518313205306,7
0.05,5051,96,463905,91.82600950118764,6
0.05,5052,94,463999,91.82643973876905,7
0.05,5053,95,464094,91.82706766917293,6
0.05,5054,93,464187,91.82729970326409,9
0.05,5055,94,464281,91.82772943037975,7
0.05,5056,96,464377,91.82855447894008,6
0.05,5057,95,464472,91.82918149466192,6
0.05,5058,94,464566,91.82961059497924,7
0.05,5059,94,464660,91.8300395256917,7
0.05,5060,92,464752,91.83007310808141,9
0.05,5061,94,464846,91.83050177795337,7
0.05,5062,95,464941,91.83112778984791,6
0.05,5063,94,465035,91.8315560821485,7
0.05,5064,92,465127,91.83158933859822,9
0.05,5065,93,465220,91.83181997631267,8
0.05,5066,93,465313,91.8320505229919,8
0.05,5067,94,465407,91.83247829518548,7
0.05,5068,96,465503,91.83330045373842,6
0.05,5069,94,465597,91.83372781065088,8
0.05,5070,93,465690,91.83395779925064,8
0.05,5071,93,465783,91.83418769716089,8
0.05,5072,95,465878,91.8348117484723,7
0.05,5073,95,465973,91.8354355538037,6
0.05,5074,92,466065,91.83546798029556,9
0.05,5075,92,466157,91.83550039401104,9
0.05,5076,94,466251,91.8359267283829,7
0.05,5077,94,466345,91.83635289484049,7
0.05,5078,96,466441,91.83717267178578,6
0.05,5079,90,466531,91.83681102362205,11
0.05,5080,94,466625,91.83723676441646,8
0.05,5081,91,466716,91.8370720188902,10
0.05,5082,96,466812,91.8378910092465,6
0.05,5083,88,466900,91.83713611329662,14
0.05,5084,90,466990,91.83677482792527,11
0.05,5085,95,467085,91.83739677546205,7
0.05,5086,94,467179,91.83782189895813,7
0.05,5087,92,467271,91.83785377358491,9
0.05,5088,92,467363,91.83788563568481,9
0.05,5089,94,467457,91.83831041257368,7
0.05,5090,94,467551,91.83873502258888,7
0.05,5091,96,467647,91.83955223880596,6
0.05,5092,95,467742,91.8401727861771,6
0.05,5093,94,467836,91.84059678052611,7
0.05,5094,94,467930,91.84102060843965,7
0.05,5095,93,468023,91.8412480376766,8
0.05,5096,92,468115,91.84127918383363,9
0.05,5097,95,468210,91.8418987838368,6
0.05,5098,95,468305,91.84251814081192,7
0.05,5099,94,468399,91.84294117647059,7
0.05,5100,96,468495,91.84375612624976,6
0.05,5101,94,468589,91.84417875343003,7
0.05,5102,95,468684,91.8447971781305,6
0.05,5103,95,468779,91.84541536050156,8
0.05,5104,93,468872,91.84564152791381,8
0.05,5105,94,468966,91.8460634547591,7
0.05,5106,26,468992,91.83317015860584,6
0.05,5107,94,469086,91.83359436178543,7
0.05,5108,94,469180,91.8340183989039,7
0.05,5109,91,469271,91.83385518590998,10
0.05,5110,93,469364,91.83408334963804,8
0.05,5111,96,469460,91.83489827856025,6
0.05,5112,94,469554,91.83532172892626,7
0.05,5113,91,469645,91.8351583887368,10
0.05,5114,95,469740,91.8357771260997,6
0.05,5115,94,469834,91.83620015637217,8
0.05,5116,95,469929,91.83681844830956,6
0.05,5117,94,470023,91.83724110980852,7
0.05,5118,92,470115,91.83727290486424,10
0.05,5119,94,470209,91.8376953125,7
0.05,5120,95,470304,91.83831282952548,6
0.05,5121,91,470395,91.83814916048419,11
0.05,5122,95,470490,91.83876634784306,6
0.05,5123,95,470585,91.83938329430133,6
0.05,5124,94,470679,91.83980487804878,7
0.05,5125,92,470771,91.8398361295357,9
0.05,5126,92,470863,91.83986736883168,10
0.05,5127,94,470957,91.84028861154447,7
0.05,5128,94,471051,91.84070968999805,7
0.05,5129,94,471145,91.8411306042885,7
0.05,5130,94,471239,91.8415513545118,7
0.05,5131,96,471335,91.84236165237724,6
0.05,5132,94,471429,91.84278199883109,7
0.05,5133,91,471520,91.84261784183872,10
0.05,5134,94,471614,91.84303797468354,7
0.05,5135,95,471709,91.84365264797508,6
0.05,5136,96,471805,91.844461748102,6
0.05,5137,93,471898,91.84468664850137,8
0.05,5138,93,471991,91.84491146137381,8
0.05,5139,92,472083,91.84494163424125,9
0.05,5140,94,472177,91.84536082474227,7
0.05,5141,96,472273,91.8461688059121,6
0.05,5142,94,472367,91.84658759478903,7
0.05,5143,94,472461,91.84700622083982,8
0.05,5144,94,472555,91.84742468415938,7
0.05,5145,93,472648,91.84764865915274,8
0.05,5146,96,472744,91.84845541091899,6
0.05,5147,92,472836,91.84848484848484,9
0.05,5148,94,472930,91.8489026995533,8
0.05,5149,91,473021,91.84873786407768,10
0.05,5150,88,473109,91.84799068142108,13
0.05,5151,93,473202,91.84821428571429,10
0.05,5152,96,473298,91.8490199883563,6
0.05,5153,94,473392,91.84943733022895,7
0.05,5154,94,473486,91.84985451018429,7
0.05,5155,91,473577,91.84968968192398,10
0.05,5156,90,473667,91.84933100639907,11
0.05,5157,95,473762,91.84994183792168,6
0.05,5158,92,473854,91.84997092459778,9
0.05,5159,96,473950,91.85077519379846,6
0.05,5160,94,474044,91.85119162952915,7
0.05,5161,95,474139,91.85180162727625,6
0.05,5162,94,474233,91.85221770288592,7
0.05,5163,91,474324,91.85205267234701,10
0.05,5164,93,474417,91.85227492739594,8
0.05,5165,93,474510,91.85249709639953,8
0.05,5166,94,474604,91.85291271530869,8
0.05,5167,93,474697,91.8531346749226,8
0.05,5168,94,474791,91.85355000967306,7
0.05,5169,94,474885,91.85396518375242,7
0.05,5170,93,474978,91.8541868110617,8
0.05,5171,96,475074,91.85498839907193,6
0.05,5172,88,475162,91.85424318577228,13
0.05,5173,94,475256,91.85465790490916,7
0.05,5174,90,475346,91.85429951690821,11
0.05,5175,96,475442,91.85510046367851,6
0.05,5176,94,475536,91.85551477689782,8
0.05,5177,96,475632,91.85631517960603,6
0.05,5178,96,475728,91.85711527321877,6
0.05,5179,94,475822,91.85752895752896,8
0.05,5180,96,475918,91.85832850801003,6
0.05,5181,94,476012,91.85874179853339,7
0.05,5182,92,476104,91.8587690526722,9
0.05,5183,96,476200,91.85956790123457,6
0.05,5184,94,476294,91.85998071359691,7
0.05,5185,95,476389,91.86058619359815,6
0.05,5186,94,476483,91.86099865047234,7
0.05,5187,87,476570,91.86006168080185,14
0.05,5188,94,476664,91.86047407978415,7
0.05,5189,25,476689,91.847591522158,8
0.05,5190,92,476781,91.84762088229628,9
0.05,5191,94,476875,91.84803543913713,7
0.05,5192,92,476967,91.84806470248411,10
0.05,5193,93,477060,91.84828648440508,10
0.05,5194,94,477154,91.84870067372474,7
0.05,5195,92,477246,91.84872979214781,9
0.05,5196,96,477342,91.84952857417741,6
0.05,5197,94,477436,91.84994228549442,7
0.05,5198,92,477528,91.84997114829775,9
0.05,5199,93,477621,91.85019230769231,8
0.05,5200,96,477717,91.85099019419343,6
0.05,5201,93,477810,91.85121107266436,8
0.05,5202,94,477904,91.85162406304056,8
0.05,5203,90,477994,91.85126825518832,11
0.05,5204,96,478090,91.85206532180595,7
0.05,5205,95,478185,91.85266999615828,6
0.05,5206,95,478280,91.8532744382562,6
0.05,5207,95,478375,91.85387864823349,6
0.05,5208,94,478469,91.8542906507967,7
0.05,5209,95,478564,91.85489443378118,6
0.05,5210,94,478658,91.85530608328536,7
0.05,5211,93,478751,91.85552570990023,8
0.05,5212,92,478843,91.85555342413198,9
0.05,5213,94,478937,91.85596471039509,7
0.05,5214,94,479031,91.85637583892617,7
0.05,5215,95,479126,91.85697852760737,7
0.05,5216,93,479219,91.85719762315507,8
0.05,5217,92,479311,91.85722499041779,9
0.05,5218,25,479336,91.8444146388197,7
0.05,5219,94,479430,91.84482758620689,7
0.05,5220,94,479524,91.84524037540702,7
0.05,5221,94,479618,91.84565300651091,7
0.05,5222,94,479712,91.84606547960942,7
0.05,5223,93,479805,91.84628637059724,8
0.05,5224,94,479899,91.8466985645933,7
0.05,5225,94,479993,91.84711060084194,7
0.05,5226,95,480088,91.84771379376315,6
0.05,5227,96,480184,91.84850803366488,6
0.05,5228,94,480278,91.84891948747371,8
0.05,5229,94,480372,91.84933078393881,7
0.05,5230,94,480466,91.84974192315045,7
0.05,5231,95,480561,91.85034403669725,6
0.05,5232,93,480654,91.8505637301739,8
0.05,5233,93,480747,91.85078333970195,8
0.05,5234,96,480843,91.85157593123209,6
0.05,5235,92,480935,91.85160427807487,9
0.05,5236,90,481025,91.85125071605881,11
0.05,5237,88,481113,91.85051546391753,13
0.05,5238,93,481206,91.85073487306738,8
0.05,5239,92,481298,91.85076335877862,10
0.05,5240,96,481394,91.85155504674681,6
0.05,5241,96,481490,91.85234643265929,6
0.05,5242,94,481584,91.8527560556933,7
0.05,5243,93,481677,91.85297482837528,8
0.05,5244,95,481772,91.85357483317445,6
0.05,5245,96,481868,91.85436523065192,6
0.05,5246,94,481962,91.85477415666095,7
0.05,5247,91,482053,91.8546112804878,11
0.05,5248,92,482145,91.85463897885312,9
0.05,5249,95,482240,91.8552380952381,6
0.05,5250,94,482334,91.85564654351552,7
0.05,5251,96,482430,91.85643564356435,6
0.05,5252,91,482521,91.85627260612983,10
0.05,5253,93,482614,91.85649029311001,8
0.05,5254,91,482705,91.85632730732635,10
0.05,5255,93,482798,91.85654490106545,8
0.05,5256,93,482891,91.85676241202206,8
0.05,5257,94,482985,91.8571700266261,7
0.05,5258,94,483079,91.85757748621411,7
0.05,5259,93,483172,91.85779467680608,8
0.05,5260,92,483264,91.85782170689983,9
0.05,5261,95,483359,91.85841885214747,7
0.05,5262,90,483449,91.85806574197225,11
0.05,5263,94,483543,91.8584726443769,7
0.05,5264,95,483638,91.85906932573599,7
0.05,5265,93,483731,91.8592859855678,8
0.05,5266,94,483825,91.8596924245301,7
0.05,5267,95,483920,91.86028853454822,6
0.05,5268,95,484015,91.8608844182957,6
0.05,5269,93,484108,91.86110056925996,8
0.05,5270,94,484202,91.86150635553027,7
0.05,5271,89,484291,91.86096358118361,12
0.05,5272,94,484385,91.86136923952209,7
0.05,5273,95,484480,91.86196435343193,7
0.05,5274,94,484574,91.86236966824644,8
0.05,5275,96,484670,91.86315390447308,6
0.05,5276,93,484763,91.86336933863937,8
0.05,5277,94,484857,91.86377415687761,7
0.05,5278,90,484947,91.86342110248152,11
0.05,5279,94,485041,91.86382575757575,7
0.05,5280,95,485136,91.86441961749668,6
0.05,5281,94,485230,91.86482393032942,7
0.05,5282,93,485323,91.86503880371001,8
0.05,5283,94,485417,91.86544284632853,7
0.05,5284,95,485512,91.86603595080416,7
0.05,5285,94,485606,91.86643965191071,7
0.05,5286,96,485702,91.8672214866654,6
0.05,5287,94,485796,91.8676248108926,7
0.05,5288,94,485890,91.86802798260541,7
0.05,5289,95,485985,91.86862003780719,6
0.05,5290,94,486079,91.86902286902287,8
0.05,5291,91,486170,91.86885865457295,10
0.05,5292,94,486264,91.86926128849424,7
0.05,5293,92,486356,91.86928598413299,9
0.05,5294,94,486450,91.86968838526913,7
0.05,5295,88,486538,91.86895770392749,13
0.05,5296,27,486565,91.85671134604493,6
0.05,5297,92,486657,91.85673839184598,9
0.05,5298,94,486751,91.85714285714286,7
0.05,5299,94,486845,91.85754716981133,7
0.05,5300,93,486938,91.85776268628561,8
0.05,5301,83,487021,91.85609204073934,18
0.05,5302,95,487116,91.85668489534226,6
0.05,5303,94,487210,91.85708898944193,7
0.05,5304,96,487306,91.8578699340245,6
0.05,5305,27,487333,91.84564643799472,6
0.05,5306,92,487425,91.8456755228943,9
0.05,5307,96,487521,91.8464581763376,6
0.05,5308,96,487617,91.84724053494067,6
0.05,5309,96,487713,91.84802259887006,6
0.05,5310,86,487799,91.84692148371305,15
0.05,5311,94,487893,91.84732680722891,10
0.05,5312,96,487989,91.8481084133258,6
0.05,5313,95,488084,91.84870154309371,6
0.05,5314,94,488178,91.84910630291627,7
0.05,5315,94,488272,91.84951091045899,7
0.05,5316,92,488364,91.84953921384239,11
0.05,5317,96,488460,91.85031966904852,6
0.05,5318,94,488554,91.85072382026696,7
0.05,5319,92,488646,91.85075187969925,9
0.05,5320,95,488741,91.85134373238112,6
0.05,5321,94,488835,91.85174746335964,7
0.05,5322,96,488931,91.85252677061807,7
0.05,5323,95,489026,91.85311795642374,6
0.05,5324,91,489117,91.85295774647888,10
0.05,5325,96,489213,91.85373638753286,6
0.05,5326,93,489306,91.85395156748639,8
0.05,5327,90,489396,91.8536036036036,11
0.05,5328,90,489486,91.85325577031338,11
0.05,5329,94,489580,91.85365853658537,7
0.05,5330,94,489674,91.8540611517539,7
0.05,5331,95,489769,91.8546511627907,8
0.05,5332,94,489863,91.85505344084005,8
0.05,5333,94,489957,91.855455568054,7
0.05,5334,96,490053,91.85623242736645,6
0.05,5335,93,490146,91.85644677661169,8
0.05,5336,93,490239,91.8566610455312,8
0.05,5337,96,490335,91.85743724241289,6
0.05,5338,95,490430,91.858025847537,6
0.05,5339,92,490522,91.85805243445692,9
0.05,5340,91,490613,91.85789178056544,10
0.05,5341,92,490705,91.85791838262823,9
0.05,5342,94,490799,91.8583192962755,7
0.05,5343,94,490893,91.85872005988024,7
0.05,5344,93,490986,91.85893358278766,8
0.05,5345,92,491078,91.85895997007108,9
0.05,5346,92,491170,91.85898634748457,9
0.05,5347,94,491264,91.85938668661181,7
0.05,5348,94,491358,91.8597868760516,8
0.05,5349,93,491451,91.86,8
0.05,5350,95,491546,91.86058680620445,6
0.05,5351,96,491642,91.86136023916293,6
0.05,5352,95,491737,91.8619465720157,6
0.05,5353,95,491832,91.86253268584237,6
0.05,5354,92,491924,91.862558356676,10
0.05,5355,96,492020,91.86333084391337,6
0.05,5356,93,492113,91.86354302781407,8
0.05,5357,96,492209,91.86431504292646,6
0.05,5358,93,492302,91.86452696398582,8
0.05,5359,95,492397,91.8651119402985,6
0.05,5360,94,492491,91.8655101660138,8
0.05,5361,96,492587,91.8662812383439,6
0.05,5362,91,492678,91.86611970911802,11
0.05,5363,94,492772,91.86651752423565,7
0.05,5364,95,492867,91.86710158434296,6
0.05,5365,91,492958,91.86693999254565,11
0.05,5366,92,493050,91.86696478479598,9
0.05,5367,90,493140,91.8666169895678,11
0.05,5368,94,493234,91.86701434159062,7
0.05,5369,94,493328,91.86741154562384,7
0.05,5370,94,493422,91.86780860175014,7
0.05,5371,95,493517,91.86839166046165,7
0.05,5372,94,493611,91.86878838637632,7
0.05,5373,96,493707,91.86955712690734,6
0.05,5374,96,493803,91.87032558139535,6
0.05,5375,94,493897,91.87072172619048,8
0.05,5376,94,493991,91.87111772363771,7
0.05,5377,93,494084,91.87132763108963,8
0.05,5378,91,494175,91.87116564417178,10
0.05,5379,92,494267,91.87118959107806,10
0.05,5380,94,494361,91.87158520721056,7
0.05,5381,95,494456,91.87216648086213,7
0.05,5382,94,494550,91.87256176853056,7
0.05,5383,94,494644,91.87295690936106,7
0.05,5384,94,494738,91.87335190343546,8
0.05,5385,96,494834,91.87411808392127,6
0.05,5386,95,494929,91.87469834787451,6
0.05,5387,27,494956,91.8626577579807,6
0.05,5388,92,495048,91.86268324364445,14
0.05,5389,94,495142,91.86307977736548,7
0.05,5390,94,495236,91.863476163977,7
0.05,5391,95,495331,91.86405786350149,8
0.05,5392,92,495423,91.86408307064714,9
0.05,5393,92,495515,91.86410826844642,10
0.05,5394,90,495605,91.86376274328082,11
0.05,5395,94,495699,91.86415863602669,8
0.05,5396,92,495791,91.86418380581804,9
0.05,5397,93,495884,91.86439422008151,9
0.05,5398,94,495978,91.86478977588442,7
0.05,5399,94,496072,91.86518518518518,7
0.05,5400,92,496164,91.8652101462692,9
0.05,5401,94,496258,91.86560533135875,7
0.05,5402,94,496352,91.86600037016473,7
0.05,5403,92,496444,91.8660251665433,9
0.05,5404,93,496537,91.86623496762257,8
0.05,5405,94,496631,91.86662967073622,7
0.05,5406,94,496725,91.86702422785278,7
0.05,5407,96,496821,91.86778846153847,6
0.05,5408,25,496846,91.85542614161582,8
0.05,5409,94,496940,91.85582255083179,7
0.05,5410,94,497034,91.856218813528,8
0.05,5411,93,497127,91.85643015521065,8
0.05,5412,94,497221,91.85682615924625,7
0.05,5413,94,497315,91.85722201699298,8
0.05,5414,95,497410,91.85780240073869,6
0.05,5415,92,497502,91.85782865583457,9
0.05,5416,96,497598,91.85859331733432,6
0.05,5417,94,497692,91.85898855666298,7
0.05,5418,94,497786,91.85938365011995,7
0.05,5419,96,497882,91.86014760147602,6
0.05,5420,91,497973,91.85998893193138,11
0.05,5421,94,498067,91.8603836222796,7
0.05,5422,91,498158,91.86022496773003,10
0.05,5423,95,498253,91.86080383480827,6
0.05,5424,94,498347,91.86119815668202,7
0.05,5425,94,498441,91.86159233321047,7
0.05,5426,91,498532,91.86143357287636,10
0.05,5427,91,498623,91.86127487103906,10
0.05,5428,95,498718,91.86185301160435,7
0.05,5429,95,498813,91.86243093922651,6
0.05,5430,94,498907,91.86282452587001,8
0.05,5431,94,499001,91.86321796759941,7
0.05,5432,94,499095,91.86361126449475,7
0.05,5433,93,499188,91.86382039013618,8
0.05,5434,94,499282,91.86421343146274,7
0.05,5435,96,499378,91.86497424576895,6
0.05,5436,96,499474,91.86573478020968,6
0.05,5437,92,499566,91.86575947039353,9
0.05,5438,92,499658,91.86578415149843,9
0.05,5439,95,499753,91.86636029411764,7
0.05,5440,96,499849,91.86712001470318,6
0.05,5441,93,499942,91.86732818816611,8
0.05,5442,92,500034,91.86735256292486,9
0.05,5443,93,500127,91.86756061719323,8
0.05,5444,91,500218,91.8674012855831,12
0.05,5445,92,500310,91.86742563349247,9
0.05,5446,94,500404,91.86781714705343,7
0.05,5447,95,500499,91.86839207048457,6
0.05,5448,96,500595,91.86915030280785,6
0.05,5449,96,500691,91.86990825688073,6
0.05,5450,95,500786,91.87048248027885,6
0.05,5451,95,500881,91.87105649303008,6
0.05,5452,95,500976,91.87163029525033,7
0.05,5453,94,501070,91.87202053538687,8
0.05,5454,95,501165,91.87259395050413,6
0.05,5455,95,501260,91.87316715542522,6
0.05,5456,96,501356,91.87392340113615,6
0.05,5457,96,501452,91.8746793697325,6
0.05,5458,91,501543,91.87451914270012,10
0.05,5459,88,501631,91.87380952380953,13
0.05,5460,94,501725,91.8741988646768,7
0.05,5461,95,501820,91.87477114610033,6
0.05,5462,92,501912,91.87479406919275,9
0.05,5463,94,502006,91.87518301610542,7
0.05,5464,94,502100,91.87557182067704,7
0.05,5465,89,502189,91.87504573728503,12
0.05,5466,94,502283,91.8754344247302,7
0.05,5467,93,502376,91.87564008778347,8
0.05,5468,96,502472,91.87639422197843,6
0.05,5469,95,502567,91.87696526508226,6
0.05,5470,93,502660,91.87717053555109,8
0.05,5471,92,502752,91.87719298245614,9
0.05,5472,90,502842,91.87684999086424,11
0.05,5473,94,502936,91.8772378516624,7
0.05,5474,92,503028,91.87726027397261,9
0.05,5475,94,503122,91.87764791818846,7
0.05,5476,94,503216,91.87803542085084,7
0.05,5477,24,503240,91.86564439576487,9
0.05,5478,94,503334,91.86603394780069,7
0.05,5479,93,503427,91.86624087591241,8
0.05,5480,92,503519,91.86626528005839,9
0.05,5481,92,503611,91.86628967530099,9
0.05,5482,91,503702,91.86613167973736,10
0.05,5483,95,503797,91.8667031363968,6
0.05,5484,95,503892,91.8672743846855,6
0.05,5485,92,503984,91.86729857819905,9
0.05,5486,93,504077,91.86750501184618,8
0.05,5487,93,504170,91.86771137026238,8
0.05,5488,95,504265,91.86828201858262,8
0.05,5489,95,504360,91.8688524590164,6
0.05,5490,95,504455,91.86942269167729,6
0.05,5491,96,504551,91.87017479970866,6
0.05,5492,91,504642,91.87001638448935,10
0.05,5493,95,504737,91.87058609392064,7
0.05,5494,94,504831,91.87097361237488,7
0.05,5495,93,504924,91.87117903930131,8
0.05,5496,88,505012,91.87047480443879,13
0.05,5497,93,505105,91.87068024736267,10
0.05,5498,95,505200,91.87124931805783,8
0.05,5499,91,505291,91.87109090909091,10
0.05,5500,89,505380,91.87056898745682,12
0.05,5501,95,505475,91.87113776808434,6
0.05,5502,94,505569,91.87152462293295,7
0.05,5503,95,505664,91.87209302325581,7
0.05,5504,90,505754,91.87175295186195,11
0.05,5505,93,505847,91.8719578641482,8
0.05,5506,27,505874,91.86017795532958,6
0.05,5507,92,505966,91.8602033405955,9
0.05,5508,95,506061,91.86077328008713,6
0.05,5509,94,506155,91.8611615245009,7
0.05,5510,94,506249,91.86154962801669,8
0.05,5511,96,506345,91.86230043541364,6
0.05,5512,95,506440,91.86286958099039,6
0.05,5513,27,506467,91.85110627493653,6
0.05,5514,93,506560,91.85131459655486,8
0.05,5515,94,506654,91.85170413343002,7
0.05,5516,95,506749,91.85227478702193,7
0.05,5517,94,506843,91.85266400869881,7
0.05,5518,94,506937,91.85305308932777,7
0.05,5519,95,507032,91.85362318840579,7
0.05,5520,91,507123,91.8534685745336,10
0.05,5521,94,507217,91.8538572980804,7
0.05,5522,90,507307,91.8535216367916,11
0.05,5523,96,507403,91.85427226647357,6
0.05,5524,95,507498,91.85484162895928,6
0.05,5525,91,507589,91.8546869344915,10
0.05,5526,93,507682,91.85489415596165,8
0.05,5527,91,507773,91.85473950795948,11
0.05,5528,93,507866,91.85494664496292,9
0.05,5529,95,507961,91.85551537070525,7
0.05,5530,94,508055,91.85590309166516,7
0.05,5531,96,508151,91.85665220535068,6
0.05,5532,91,508242,91.8564973793602,10
0.05,5533,96,508338,91.85724611492591,6
0.05,5534,94,508432,91.8576332429991,7
0.05,5535,96,508528,91.85838150289017,6
0.05,5536,90,508618,91.85804587321654,11
0.05,5537,94,508712,91.85843264716505,7
0.05,5538,95,508807,91.858999819462,6
0.05,5539,92,508899,91.85902527075812,9
0.05,5540,93,508992,91.85923118570655,8
0.05,5541,94,509086,91.85961746661854,7
0.05,5542,96,509182,91.86036442359733,6
0.05,5543,94,509276,91.86075036075036,7
0.05,5544,95,509371,91.86131650135258,6
0.05,5545,92,509463,91.86134150739271,10
0.05,5546,91,509554,91.86118622678926,10
0.05,5547,94,509648,91.86157173756308,7
0.05,5548,94,509742,91.86195710938908,8
0.05,5549,93,509835,91.86216216216216,8
0.05,5550,94,509929,91.8625472887768,7
0.05,5551,95,510024,91.86311239193084,6
0.05,5552,96,510120,91.86385737439223,6
0.05,5553,94,510214,91.86424198775657,7
0.05,5554,93,510307,91.86444644464447,8
0.05,5555,96,510403,91.86519078473722,6
0.05,5556,95,510498,91.86575490372503,6
0.05,5557,91,510589,91.86559913638,12
0.05,5558,94,510683,91.8659830904839,7
0.05,5559,96,510779,91.86672661870503,6
0.05,5560,95,510874,91.86729005574537,6
0.05,5561,95,510969,91.86785329018339,6
0.05,5562,94,511063,91.86823656300557,7
0.05,5563,94,511157,91.86861969805895,7
0.05,5564,93,511250,91.86882300089847,8
0.05,5565,92,511342,91.86884656845132,9
0.05,5566,95,511437,91.8694090174241,6
0.05,5567,95,511532,91.86997126436782,6
0.05,5568,95,511627,91.87053330939128,6
0.05,5569,92,511719,91.8705565529623,9
0.05,5570,95,511814,91.8711182911506,6
0.05,5571,90,511904,91.8707824838478,11
0.05,5572,92,511996,91.87080567019558,9
0.05,5573,95,512091,91.8713670613563,6
0.05,5574,88,512179,91.87067264573992,14
0.05,5575,91,512270,91.87051649928264,11
0.05,5576,96,512366,91.87125694818002,6
0.05,5577,94,512460,91.87163858013625,7
0.05,5578,94,512554,91.87202007528231,7
0.05,5579,95,512649,91.87258064516129,6
0.05,5580,86,512735,91.87152839992832,15
0.05,5581,96,512831,91.87226800429953,6
0.05,5582,94,512925,91.87264911337991,7
0.05,5583,94,513019,91.87303008595988,7
0.05,5584,95,513114,91.87358997314234,6
0.05,5585,91,513205,91.8734335839599,10
0.05,5586,96,513301,91.87417218543047,6
0.05,5587,95,513396,91.87473156764496,6
0.05,5588,92,513488,91.87475398103417,10
0.05,5589,95,513583,91.87531305903399,6
0.05,5590,95,513678,91.87587193704168,6
0.05,5591,92,513770,91.87589413447783,9
0.05,5592,94,513864,91.87627391382085,8
0.05,5593,95,513959,91.87683232034323,6
0.05,5594,95,514054,91.87739052725648,7
0.05,5595,92,514146,91.87741243745532,9
0.05,5596,92,514238,91.8774343398249,9
0.05,5597,95,514333,91.87799214005001,6
0.05,5598,96,514429,91.87872834434721,6
0.05,5599,93,514522,91.87892857142857,8
0.05,5600,92,514614,91.87895018746653,9
0.05,5601,92,514706,91.87897179578722,10
0.05,5602,96,514802,91.8797072996609,6
0.05,5603,94,514896,91.88008565310493,7
0.05,5604,92,514988,91.88010704727921,9
0.05,5605,95,515083,91.88066357474135,6
0.05,5606,95,515178,91.88121990369181,6
0.05,5607,95,515273,91.88177603423681,8
0.05,5608,94,515367,91.88215368158318,7
0.05,5609,96,515463,91.88288770053477,6
0.05,5610,88,515551,91.8821956870433,13
0.05,5611,95,515646,91.88275124732715,6
0.05,5612,94,515740,91.8831284518083,8
0.05,5613,95,515835,91.8836836480228,6
0.05,5614,94,515929,91.8840605520926,7
0.05,5615,94,516023,91.88443732193733,8
0.05,5616,95,516118,91.88499198860602,6
0.05,5617,96,516214,91.88572445710217,6
0.05,5618,95,516309,91.88627869727709,6
0.05,5619,93,516402,91.8864768683274,8
0.05,5620,94,516496,91.88685287315424,7
0.05,5621,94,516590,91.88722874421914,7
0.05,5622,87,516677,91.8863595945225,14
0.05,5623,93,516770,91.88655761024182,8
0.05,5624,93,516863,91.88675555555555,8
0.05,5625,95,516958,91.88730892285815,6
0.05,5626,94,517052,91.88768437888751,7
0.05,5627,94,517146,91.88805970149254,7
0.05,5628,94,517240,91.88843489074436,9
0.05,5629,94,517334,91.88880994671403,7
0.05,5630,96,517430,91.88954004617297,6
0.05,5631,92,517522,91.8895596590909,9
0.05,5632,94,517616,91.88993431563998,7
0.05,5633,95,517711,91.89048633297834,6
0.05,5634,93,517804,91.89068322981366,8
0.05,5635,94,517898,91.89105748757984,8
0.05,5636,92,517990,91.89107681390811,9
0.05,5637,96,518086,91.89180560482441,6
0.05,5638,95,518181,91.89235680085122,6
0.05,5639,93,518274,91.89255319148936,9
0.05,5640,88,518362,91.89186314483247,13
0.05,5641,91,518453,91.89170506912443,10
0.05,5642,92,518545,91.89172426014531,9
0.05,5643,91,518636,91.89156626506023,10
0.05,5644,92,518728,91.89158547387068,9
0.05,5645,95,518823,91.89213602550478,6
0.05,5646,94,518917,91.89250929697184,7
0.05,5647,94,519011,91.89288243626062,7
0.05,5648,96,519107,91.89360948840503,6
0.05,5649,93,519200,91.89380530973452,8
0.05,5650,93,519293,91.89400106175898,8
0.05,5651,95,519388,91.89455060155697,6
0.05,5652,94,519482,91.89492304970813,8
0.05,5653,95,519577,91.8954722320481,6
0.05,5654,94,519671,91.89584438549956,8
0.05,5655,92,519763,91.89586280056577,9
0.05,5656,95,519858,91.89641152554357,7
0.05,5657,94,519952,91.89678331565925,8
0.05,5658,94,520046,91.8971549743771,7
0.05,5659,92,520138,91.89717314487632,10
0.05,5660,96,520234,91.89789789789789,6
0.05,5661,96,520330,91.89862239491346,6
0.05,5662,95,520425,91.89917005120961,7
0.05,5663,93,520518,91.89936440677967,9
0.05,5664,96,520614,91.90008826125332,6
0.05,5665,92,520706,91.90010589481115,9
0.05,5666,94,520800,91.90047644256221,7
0.05,5667,95,520895,91.90102328863797,6
0.05,5668,96,520991,91.90174633974246,6
0.05,5669,90,521081,91.90141093474426,11
0.05,5670,94,521175,91.90178099100687,7
0.05,5671,94,521269,91.90215091678421,10
0.05,5672,94,521363,91.90252071214525,7
0.05,5673,94,521457,91.90289037715897,7
0.05,5674,96,521553,91.90361233480176,6
0.05,5675,94,521647,91.9039816772375,7
0.05,5676,94,521741,91.90435088955434,8
0.05,5677,91,521832,91.90419161676647,10
0.05,5678,95,521927,91.90473674942771,6
0.05,5679,96,522023,91.90545774647887,6
0.05,5680,94,522117,91.90582643900721,7
0.05,5681,27,522144,91.89440337909187,6
0.05,5682,94,522238,91.89477388703149,7
0.05,5683,95,522333,91.89532019704434,6
0.05,5684,93,522426,91.89551451187334,8
0.05,5685,95,522521,91.89606049947238,6
0.05,5686,96,522617,91.89678213469315,6
0.05,5687,95,522712,91.8973277074543,6
0.05,5688,95,522807,91.89787308841625,6
0.05,5689,94,522901,91.89824253075571,7
0.05,5690,88,522989,91.89755754700404,13
0.05,5691,96,523085,91.89827828531271,6
0.05,5692,95,523180,91.8988231161075,6
0.05,5693,94,523274,91.89919213206885,7
0.05,5694,95,523369,91.89973661106234,6
0.05,5695,92,523461,91.89975421348315,10
0.05,5696,92,523553,91.89977180972441,9
0.05,5697,93,523646,91.8999648999649,8
0.05,5698,96,523742,91.90068433058431,6
0.05,5699,94,523836,91.90105263157895,7
0.05,5700,94,523930,91.90142080336783,7
0.05,5701,95,524025,91.90196422307962,6
0.05,5702,92,524117,91.90198141329125,9
0.05,5703,92,524209,91.90199859747545,9
0.05,5704,86,524295,91.90096406660824,15
0.05,5705,95,524390,91.90150718541885,6
0.05,5706,95,524485,91.90205011389521,6
0.05,5707,95,524580,91.90259285213735,6
0.05,5708,92,524672,91.90260991417061,9
0.05,5709,94,524766,91.9029772329247,7
0.05,5710,93,524859,91.90316932236036,8
0.05,5711,94,524953,91.90353641456582,7
0.05,5712,93,525046,91.90372833887625,9
0.05,5713,94,525140,91.90409520476024,7
0.05,5714,96,525236,91.90481189851269,6
0.05,5715,94,525330,91.90517844646607,9
0.05,5716,94,525424,91.90554486618856,8
0.05,5717,94,525518,91.90591115774747,8
0.05,5718,95,525613,91.90645217695402,7
0.05,5719,91,525704,91.90629370629371,10
0.05,5720,93,525797,91.9064848802657,8
0.05,5721,90,525887,91.90615169521146,12
0.05,5722,94,525981,91.9065175607199,7
0.05,5723,94,526075,91.90688329839273,7
0.05,5724,96,526171,91.90759825327511,6
0.05,5725,96,526267,91.9083129584352,6
0.05,5726,94,526361,91.90867819102498,7
0.05,5727,94,526455,91.90904329608938,7
0.05,5728,95,526550,91.90958282422761,6
0.05,5729,95,526645,91.91012216404887,6
0.05,5730,93,526738,91.91031233641598,8
0.05,5731,93,526831,91.91050244242847,8
0.05,5732,95,526926,91.91104133961277,6
0.05,5733,91,527017,91.91088245552842,10
0.05,5734,92,527109,91.91089799476896,9
0.05,5735,91,527200,91.91073919107392,10
0.05,5736,94,527294,91.9111033641276,8
0.05,5737,94,527388,91.91146741024747,7
0.05,5738,94,527482,91.91183132949992,7
0.05,5739,94,527576,91.91219512195121,7
0.05,5740,90,527666,91.91186204493991,11
0.05,5741,95,527761,91.91239986067572,6
0.05,5742,94,527855,91.91276336409543,7
0.05,5743,94,527949,91.91312674094708,7
0.05,5744,94,528043,91.91348999129679,7
0.05,5745,92,528135,91.91350504698921,9
0.05,5746,96,528231,91.91421611275447,6
0.05,5747,94,528325,91.91457898399443,7
0.05,5748,92,528417,91.91459384240737,9
0.05,5749,94,528511,91.91495652173913,8
0.05,5750,92,528603,91.9149713093375,10
0.05,5751,92,528695,91.91498609179416,9
0.05,5752,92,528787,91.91500086911176,9
0.05,5753,96,528883,91.9157108098714,6
0.05,5754,94,528977,91.91607298001738,7
0.05,5755,91,529068,91.91591382904795,10
0.05,5756,94,529162,91.91627583811012,7
0.05,5757,92,529254,91.91629037860368,9
0.05,5758,95,529349,91.91682583781906,6
0.05,5759,89,529438,91.91631944444444,12
0.05,5760,92,529530,91.91633396979691,9
0.05,5761,94,529624,91.9166955918084,7
0.05,5762,90,529714,91.91636300537914,11
0.05,5763,93,529807,91.91655100624567,8
0.05,5764,96,529903,91.9172593235039,6
0.05,5765,27,529930,91.90600069372182,6
0.05,5766,96,530026,91.90671059476331,6
0.05,5767,90,530116,91.90638002773925,12
0.05,5768,93,530209,91.90656959611718,8
0.05,5769,94,530303,91.90693240901213,7
0.05,5770,95,530398,91.90746837636458,8
0.05,5771,92,530490,91.9074844074844,9
0.05,5772,94,530584,91.90784687337606,7
0.05,5773,96,530680,91.90855559404226,6
0.05,5774,92,530772,91.90857142857143,9
0.05,5775,96,530868,91.90927977839335,6
0.05,5776,91,530959,91.90912238185909,10
0.05,5777,94,531053,91.90948425060574,7
0.05,5778,94,531147,91.90984599411662,7
0.05,5779,94,531241,91.91020761245674,7
0.05,5780,94,531335,91.91056910569105,7
0.05,5781,92,531427,91.91058457281217,9
0.05,5782,95,531522,91.91111879647242,6
0.05,5783,92,531614,91.91113416320886,10
0.05,5784,93,531707,91.91132238547969,8
0.05,5785,94,531801,91.91168337366057,7
0.05,5786,93,531894,91.91187143597719,9
0.05,5787,94,531988,91.91223220456116,7
0.05,5788,94,532082,91.91259284850578,7
0.05,5789,95,532177,91.91312607944732,6
0.05,5790,93,532270,91.91331376273529,8
0.05,5791,93,532363,91.91350138121547,8
0.05,5792,94,532457,91.91386155705162,7
0.05,5793,96,532553,91.91456679323439,6
0.05,5794,94,532647,91.91492666091459,7
0.05,5795,96,532743,91.9156314699793,6
0.05,5796,94,532837,91.91599102984303,7
0.05,5797,96,532933,91.91669541221111,6
0.05,5798,94,533027,91.91705466459734,7
0.05,5799,95,533122,91.91758620689656,7
0.05,5800,94,533216,91.91794518186519,7
0.05,5801,96,533312,91.91864874181317,6
0.05,5802,90,533402,91.91831811132172,11
0.05,5803,93,533495,91.9185044796692,8
0.05,5804,96,533591,91.9192075796727,6
0.05,5805,94,533685,91.91956596624182,7
0.05,5806,95,533780,91.92009643533666,6
0.05,5807,96,533876,91.92079889807162,6
0.05,5808,94,533970,91.92115682561543,7
0.05,5809,90,534060,91.92082616179002,12
0.05,5810,27,534087,91.90965410428498,6
0.05,5811,94,534181,91.91001376462492,7
0.05,5812,95,534276,91.91054532943403,6
0.05,5813,94,534370,91.9109047127623,8
0.05,5814,90,534460,91.91057609630266,11
0.05,5815,94,534554,91.91093535075653,7
0.05,5816,89,534643,91.91043493209558,12
0.05,5817,94,534737,91.91079408731522,7
0.05,5818,95,534832,91.9113249699261,6
0.05,5819,94,534926,91.91168384879725,7
0.05,5820,92,535018,91.91169902078681,9
0.05,5821,93,535111,91.91188594984541,9
0.05,5822,92,535203,91.91190108191654,9
0.05,5823,94,535297,91.91225961538461,7
0.05,5824,94,535391,91.91261802575107,7
0.05,5825,94,535485,91.9129763130793,7
0.05,5826,94,535579,91.91333447743264,7
0.05,5827,90,535669,91.91300617707618,12
0.05,5828,95,535764,91.91353576942872,6
0.05,5829,94,535858,91.9138936535163,7
0.05,5830,86,535944,91.91287943748928,15
0.05,5831,94,536038,91.91323731138546,7
0.05,5832,95,536133,91.91376650094291,6
0.05,5833,95,536228,91.91429550908468,7
0.05,5834,94,536322,91.9146529562982,9
0.05,5835,95,536417,91.91518163125428,6
0.05,5836,95,536512,91.91571012506425,6
0.05,5837,91,536603,91.91555327166839,10
0.05,5838,94,536697,91.91591025860592,10
0.05,5839,94,536791,91.91626712328767,7
0.05,5840,95,536886,91.91679506933744,7
0.05,5841,96,536982,91.91749400890106,6
0.05,5842,94,537076,91.91785041930515,7
0.05,5843,91,537167,91.91769336071184,10
0.05,5844,89,537256,91.91719418306245,12
0.05,5845,93,537349,91.91737940472117,8
0.05,5846,95,537444,91.91790661877886,6
0.05,5847,95,537539,91.91843365253078,6
0.05,5848,96,537635,91.91913147546589,6
0.05,5849,95,537730,91.91965811965812,6
0.05,5850,94,537824,91.92001367287644,7
0.05,5851,96,537920,91.92071086807928,6
0.05,5852,92,538012,91.92072441483,10
0.05,5853,94,538106,91.92107960368979,7
0.05,5854,94,538200,91.92143467122118,7
0.05,5855,92,538292,91.9214480874317,9
0.05,5856,93,538385,91.92163223493256,8
0.05,5857,96,538481,91.92232843974053,6
0.05,5858,94,538575,91.92268305171531,7
0.05,5859,91,538666,91.92252559726963,10
0.05,5860,92,538758,91.92253881590172,9
0.05,5861,94,538852,91.92289321050836,7
0.05,5862,94,538946,91.9232474842231,7
0.05,5863,94,539040,91.92360163710778,8
0.05,5864,96,539136,91.92429667519181,6
0.05,5865,94,539230,91.92465052846914,7
0.05,5866,95,539325,91.92517470598261,6
0.05,5867,94,539419,91.92552828902522,7
0.05,5868,96,539515,91.92622252513205,6
0.05,5869,91,539606,91.92606473594549,10
0.05,5870,18,539624,91.91347300289559,14
0.05,5871,94,539718,91.91382833787466,9
0.05,5872,92,539810,91.91384301038651,9
0.05,5873,90,539900,91.91351719441607,11
0.05,5874,95,539995,91.91404255319149,6
0.05,5875,91,540086,91.91388699795779,10
0.05,5876,26,540112,91.90267143100222,7
0.05,5877,94,540206,91.90302824089827,7
0.05,5878,95,540301,91.90355502636503,6
0.05,5879,95,540396,91.90408163265306,6
0.05,5880,90,540486,91.90375786430879,11
0.05,5881,95,540581,91.90428425705542,6
0.05,5882,95,540676,91.9048104708482,7
0.05,5883,92,540768,91.9048266485384,11
0.05,5884,95,540863,91.9053525913339,6
0.05,5885,93,540956,91.90553856608902,9
0.05,5886,27,540983,91.89451333446577,6
0.05,5887,94,541077,91.89487092391305,7
0.05,5888,90,541167,91.89454915944982,11
0.05,5889,92,541259,91.89456706281834,9
0.05,5890,91,541350,91.89441520964182,10
0.05,5891,94,541444,91.89477257298032,7
0.05,5892,94,541538,91.89512981503479,7
0.05,5893,94,541632,91.89548693586698,7
0.05,5894,95,541727,91.89601357082273,6
0.05,5895,92,541819,91.89603120759837,9
0.05,5896,96,541915,91.896727149398,6
0.05,5897,94,542009,91.89708375720583,8
0.05,5898,95,542104,91.89760976436685,6
0.05,5899,94,542198,91.89796610169492,7
0.05,5900,92,542290,91.89798339264532,9
0.05,5901,96,542386,91.89867841409692,6
0.05,5902,96,542482,91.89937320006776,6
0.05,5903,93,542575,91.89955962059621,10
0.05,5904,91,542666,91.89940728196444,12
0.05,5905,96,542762,91.90010159160177,6
0.05,5906,94,542856,91.90045708481463,7
0.05,5907,95,542951,91.9009817197021,6
0.05,5908,95,543046,91.9015061770181,7
0.05,5909,89,543135,91.9010152284264,12
0.05,5910,92,543227,91.90103197428523,9
0.05,5911,94,543321,91.90138700947226,7
0.05,5912,94,543415,91.90174192457297,7
0.05,5913,24,543439,91.89026039905309,9
0.05,5914,95,543534,91.89078613693998,6
0.05,5915,95,543629,91.89131169709263,8
0.05,5916,96,543725,91.89200608416428,6
0.05,5917,94,543819,91.89236228455559,7
0.05,5918,92,543911,91.89238046967394,9
0.05,5919,20,543931,91.88023648648648,12
0.05,5920,93,544024,91.88042560378314,10
0.05,5921,96,544120,91.88112124282337,6
0.05,5922,93,544213,91.88131014688503,8
0.05,5923,92,544305,91.88133018230926,9
0.05,5924,95,544400,91.88185654008439,6
0.05,5925,92,544492,91.88187647654404,9
0.05,5926,93,544585,91.88206512569597,9
0.05,5927,92,544677,91.88208502024291,9
0.05,5928,94,544771,91.88244223309158,7
0.05,5929,93,544864,91.88263069139967,8
0.05,5930,94,544958,91.88298769178891,7
0.05,5931,94,545052,91.8833445718139,7
0.05,5932,93,545145,91.8835327827406,8
0.05,5933,93,545238,91.88372093023256,8
0.05,5934,96,545334,91.88441449031171,6
0.05,5935,96,545430,91.8851078167116,6
0.05,5936,96,545526,91.88580090955028,6
0.05,5937,96,545622,91.88649376894577,6
0.05,5938,94,545716,91.88684963798619,7
0.05,5939,92,545808,91.88686868686868,9
0.05,5940,94,545902,91.88722437300117,8
0.05,5941,93,545995,91.88741164591046,9
0.05,5942,94,546089,91.88776712098267,7
0.05,5943,25,546114,91.87651413189771,7
0.05,5944,95,546209,91.87703952901597,6
0.05,5945,94,546303,91.8773965691221,7
0.05,5946,94,546397,91.8777534891542,7
0.05,5947,94,546491,91.87811028917284,8
0.05,5948,95,546586,91.87863506471676,8
0.05,5949,93,546679,91.87882352941176,8
0.05,5950,95,546774,91.87934800873802,6
0.05,5951,90,546864,91.87903225806451,11
0.05,5952,96,546960,91.8797245086511,6
0.05,5953,95,547055,91.88024857238831,6
0.05,5954,96,547151,91.88094038623007,6
0.05,5955,94,547245,91.88129617192747,7
0.05,5956,94,547339,91.88165183817358,7
0.05,5957,96,547435,91.88234306814367,6
0.05,5958,93,547528,91.88253062594396,8
0.05,5959,96,547624,91.88322147651007,6
0.05,5960,95,547719,91.88374433819828,6
0.05,5961,23,547742,91.87219054008722,10
0.05,5962,94,547836,91.87254737548214,7
0.05,5963,90,547926,91.87223340040241,11
0.05,5964,95,548021,91.87275775356245,6
0.05,5965,95,548116,91.873281930942,6
0.05,5966,91,548207,91.87313557901793,10
0.05,5967,93,548300,91.87332439678285,8
0.05,5968,93,548393,91.87351315128163,8
0.05,5969,93,548486,91.87370184254607,8
0.05,5970,95,548581,91.87422542287725,6
0.05,5971,94,548675,91.87458137977227,8
0.05,5972,96,548771,91.8752720575925,6
0.05,5973,96,548867,91.8759625041848,6
0.05,5974,93,548960,91.87615062761506,8
0.05,5975,95,549055,91.87667336010709,7
0.05,5976,92,549147,91.87669399364229,9
0.05,5977,95,549242,91.87721646035463,6
0.05,5978,93,549335,91.87740424820204,8
0.05,5979,93,549428,91.87759197324415,9
0.05,5980,94,549522,91.87794683163351,8
0.05,5981,96,549618,91.87863590772317,6
0.05,5982,92,549710,91.87865619254555,9
0.05,5983,93,549803,91.8788435828877,9
0.05,5984,92,549895,91.87886382623225,10
0.05,5985,94,549989,91.8792181757434,7
0.05,5986,89,550078,91.87873726407216,12
0.05,5987,92,550170,91.87875751503006,9
0.05,5988,93,550263,91.87894473200868,8
0.05,5989,93,550356,91.87913188647747,8
0.05,5990,96,550452,91.87981972959439,6
0.05,5991,94,550546,91.88017356475301,9
0.05,5992,95,550641,91.88069414316703,7
0.05,5993,25,550666,91.86953620286954,7
0.05,5994,95,550761,91.87005838198499,6
0.05,5995,93,550854,91.87024683122081,8
0.05,5996,94,550948,91.87060196765049,7
0.05,5997,96,551044,91.87129043014338,6
0.05,5998,92,551136,91.87131188531421,9
0.05,5999,94,551230,91.87166666666667,7
0.05,6000,92,551322,91.87168805199134,10
0.05,6001,94,551416,91.87204265244918,7
0.05,6002,95,551511,91.87256371814092,6
0.05,6003,91,551602,91.8724183877415,10
0.05,6004,92,551694,91.87243963363863,9
0.05,6005,94,551788,91.87279387279388,7
0.05,6006,96,551884,91.8734809389046,6
0.05,6007,94,551978,91.87383488681758,7
0.05,6008,24,552002,91.86253952404726,8
0.05,6009,95,552097,91.8630615640599,6
0.05,6010,94,552191,91.86341706870736,7
0.05,6011,94,552285,91.86377245508982,7
0.05,6012,91,552376,91.86362880425744,10
0.05,6013,94,552470,91.86398403724642,7
0.05,6014,94,552564,91.8643391521197,7
0.05,6015,94,552658,91.86469414893617,7
0.05,6016,96,552754,91.86538141931194,6
0.05,6017,95,552849,91.86590229312064,6
0.05,6018,94,552943,91.86625685329788,7
0.05,6019,95,553038,91.86677740863787,6
0.05,6020,94,553132,91.86713170569672,7
0.05,6021,94,553226,91.86748588508802,7
0.05,6022,94,553320,91.86783994687033,7
0.05,6023,94,553414,91.86819389110225,7
0.05,6024,94,553508,91.86854771784232,7
0.05,6025,92,553600,91.86856953202788,10
0.05,6026,93,553693,91.86875725900116,8
0.05,6027,96,553789,91.86944260119442,6
0.05,6028,94,553883,91.86979598606734,7
0.05,6029,94,553977,91.87014925373134,7
0.05,6030,94,554071,91.87050240424473,8
0.05,6031,91,554162,91.87035809018568,10
0.05,6032,94,554256,91.87071108901044,7
0.05,6033,91,554347,91.8705667882002,10
0.05,6034,93,554440,91.87075393537697,8
0.05,6035,93,554533,91.87094102054341,8
0.05,6036,96,554629,91.87162497929435,6
0.05,6037,94,554723,91.87197747598543,8
0.05,6038,94,554817,91.87232985593641,8
0.05,6039,94,554911,91.8726821192053,7
0.05,6040,96,555007,91.87336533686475,6
0.05,6041,96,555103,91.87404832836809,6
0.05,6042,93,555196,91.87423465166309,8
0.05,6043,95,555291,91.87475181998677,6
0.05,6044,95,555386,91.8752688172043,6
0.05,6045,90,555476,91.87495865034734,11
0.05,6046,94,555570,91.87531007110964,7
0.05,6047,95,555665,91.87582671957672,6
0.05,6048,95,555760,91.87634319722268,7
0.05,6049,94,555854,91.87669421487604,7
0.05,6050,95,555949,91.87721037844985,6
0.05,6051,95,556044,91.87772637144745,6
0.05,6052,94,556138,91.87807698661821,7
0.05,6053,92,556230,91.8780971258672,9
0.05,6054,95,556325,91.878612716763,6
0.05,6055,94,556419,91.87896301188904,8
0.05,6056,94,556513,91.87931319134886,7
0.05,6057,95,556608,91.87982832618026,8
0.05,6058,90,556698,91.87951807228916,11
0.05,6059,94,556792,91.87986798679869,7
0.05,6060,96,556888,91.88054776439532,6
0.05,6061,94,556982,91.88089739359947,7
0.05,6062,94,557076,91.88124690747155,7
0.05,6063,95,557171,91.88176121372031,7
0.05,6064,95,557266,91.88227535037097,8
0.05,6065,95,557361,91.88278931750742,6
0.05,6066,96,557457,91.88346794132191,6
0.05,6067,96,557553,91.88414634146342,6
0.05,6068,96,557649,91.8848245180425,6
0.05,6069,94,557743,91.88517298187809,7
0.05,6070,92,557835,91.88519189589853,9
0.05,6071,94,557929,91.88554018445323,8
0.05,6072,94,558023,91.88588835830726,7
0.05,6073,92,558115,91.88590714520909,9
0.05,6074,94,558209,91.88625514403292,7
0.05,6075,95,558304,91.88676761026991,6
0.05,6076,94,558398,91.88711535297021,7
0.05,6077,96,558494,91.88779203685422,6
0.05,6078,94,558588,91.88813949662773,7
0.05,6079,91,558679,91.88799342105263,10
0.05,6080,90,558769,91.88768294688374,11
0.05,6081,93,558862,91.88786583360736,8
0.05,6082,92,558954,91.88788426763111,10
0.05,6083,90,559044,91.88757396449704,11
0.05,6084,89,559133,91.88709942481512,12
0.05,6085,93,559226,91.88728228721656,9
0.05,6086,94,559320,91.8876293740759,7
0.05,6087,94,559414,91.88797634691196,7
0.05,6088,96,559510,91.88865166694039,6
0.05,6089,95,559605,91.88916256157636,6
0.05,6090,96,559701,91.88983746511246,6
0.05,6091,92,559793,91.88985554826002,9
0.05,6092,95,559888,91.89036599376334,8
0.05,6093,94,559982,91.89071217591074,7
0.05,6094,93,560075,91.89089417555373,8
0.05,6095,94,560169,91.89124015748031,7
0.05,6096,94,560263,91.89158602591438,7
0.05,6097,93,560356,91.89176779271892,9
0.05,6098,94,560450,91.89211346122315,7
0.05,6099,92,560542,91.89213114754098,9
0.05,6100,91,560633,91.89198492050484,10
0.05,6101,95,560728,91.89249426417568,6
0.05,6102,94,560822,91.89283958708832,7
0.05,6103,94,560916,91.89318479685453,7
0.05,6104,95,561011,91.89369369369369,6
0.05,6105,94,561105,91.8940386505077,7
0.05,6106,88,561193,91.89340101522842,13
0.05,6107,93,561286,91.89358218729535,8
0.05,6108,96,561382,91.8942543787854,6
0.05,6109,94,561476,91.89459901800328,7
0.05,6110,96,561572,91.89527082310588,6
0.05,6111,94,561666,91.89561518324608,7
0.05,6112,94,561760,91.89595943072142,7
0.05,6113,94,561854,91.89630356558717,7
0.05,6114,91,561945,91.89615699100572,10
0.05,6115,93,562038,91.89633747547417,8
0.05,6116,94,562132,91.89668137976132,7
0.05,6117,95,562227,91.89718862373324,6
0.05,6118,95,562322,91.89769570191207,6
0.05,6119,95,562417,91.89820261437909,6
0.05,6120,94,562511,91.89854598921745,9
0.05,6121,94,562605,91.89888925187847,7
0.05,6122,27,562632,91.88829005389515,6
0.05,6123,94,562726,91.88863487916394,7
0.05,6124,94,562820,91.88897959183673,7
0.05,6125,92,562912,91.88899771465883,10
0.05,6126,94,563006,91.88934225559001,8
0.05,6127,95,563101,91.8898498694517,8
0.05,6128,94,563195,91.89019415891663,8
0.05,6129,95,563290,91.89070146818923,6
0.05,6130,92,563382,91.89071929538412,9
0.05,6131,96,563478,91.89138943248533,6
0.05,6132,94,563572,91.89173324637208,7
0.05,6133,92,563664,91.89175089664167,9
0.05,6134,91,563755,91.8916055419723,10
0.05,6135,91,563846,91.89146023468058,10
0.05,6136,95,563941,91.89196675900277,6
0.05,6137,93,564034,91.89214727924406,9
0.05,6138,94,564128,91.8924906336537,8
0.05,6139,92,564220,91.89250814332247,10
0.05,6140,91,564311,91.89236280736037,10
0.05,6141,94,564405,91.89270595897102,7
0.05,6142,92,564497,91.89272342503662,10
0.05,6143,95,564592,91.89322916666667,7
0.05,6144,91,564683,91.89308380797397,10
0.05,6145,93,564776,91.89326391148714,8
0.05,6146,95,564871,91.89376931836668,7
0.05,6147,89,564960,91.89329863370202,12
0.05,6148,96,565056,91.89396649861766,6
0.05,6149,91,565147,91.89382113821138,10
0.05,6150,95,565242,91.8943261258332,7
0.05,6151,90,565332,91.89401820546163,11
0.05,6152,94,565426,91.89436047456525,7
0.05,6153,95,565521,91.89486512837179,6
0.05,6154,96,565617,91.89553208773356,6
0.05,6155,94,565711,91.89587394411956,8
0.05,6156,94,565805,91.89621568945915,7
0.05,6157,94,565899,91.89655732380643,7
0.05,6158,92,565991,91.89657411917518,9
0.05,6159,94,566085,91.89691558441558,7
0.05,6160,94,566179,91.89725693880864,7
0.05,6161,95,566274,91.89776046738072,6
0.05,6162,94,566368,91.8981015739088,7
0.05,6163,93,566461,91.89828033744323,9
0.05,6164,96,566557,91.89894566098945,6
0.05,6165,91,566648,91.89879987025624,10
0.05,6166,93,566741,91.89897843359819,9
0.05,6167,92,566833,91.89899481193255,9
0.05,6168,95,566928,91.89949748743719,7
0.05,6169,92,567020,91.89951377633712,9
0.05,6170,95,567115,91.90001620482904,7
0.05,6171,96,567211,91.90068049254698,6
0.05,6172,95,567306,91.9011825692532,6
0.05,6173,95,567401,91.90168448331714,6
0.05,6174,92,567493,91.9017004048583,9
0.05,6175,92,567585,91.90171632124353,10
0.05,6176,94,567679,91.9020560142464,7
0.05,6177,94,567773,91.90239559728067,7
0.05,6178,93,567866,91.90257323191454,8
0.05,6179,94,567960,91.90291262135922,7
0.05,6180,94,568054,91.9032519009869,7
0.05,6181,92,568146,91.90326755095438,9
0.05,6182,94,568240,91.90360666343199,7
0.05,6183,92,568332,91.90362225097024,9
0.05,6184,91,568423,91.9034761519806,11
0.05,6185,94,568517,91.9038150662787,7
0.05,6186,84,568601,91.90253757879425,17
0.05,6187,93,568694,91.9027149321267,8
0.05,6188,95,568789,91.90321538212959,6
0.05,6189,94,568883,91.90355411954766,7
0.05,6190,95,568978,91.9040542723308,6
0.05,6191,96,569074,91.9047157622739,6
0.05,6192,96,569170,91.90537703859196,6
0.05,6193,94,569264,91.90571520826606,7
0.05,6194,94,569358,91.90605326876513,7
0.05,6195,94,569452,91.90639122014203,7
0.05,6196,95,569547,91.90689043085364,7
0.05,6197,95,569642,91.90738948047758,6
0.05,6198,95,569737,91.9078883690918,6
0.05,6199,92,569829,91.90790322580645,9
0.05,6200,91,569920,91.9077568134172,10
0.05,6201,94,570014,91.90809416317317,7
0.05,6202,23,570037,91.89698532967918,10
0.05,6203,90,570127,91.89667956157318,12
0.05,6204,95,570222,91.89717969379532,6
0.05,6205,93,570315,91.89735739606832,8
0.05,6206,95,570410,91.89785725793459,6
0.05,6207,93,570503,91.89803479381443,8
0.05,6208,94,570597,91.89837332903849,7
0.05,6209,94,570691,91.89871175523349,7
0.05,6210,94,570785,91.8990500724521,7
0.05,6211,94,570879,91.89938828074695,7
0.05,6212,92,570971,91.89940447448897,9
0.05,6213,94,571065,91.89974251689733,7
0.05,6214,95,571160,91.90024135156878,6
0.05,6215,94,571254,91.90057915057915,8
0.05,6216,96,571350,91.9012385394885,6
0.05,6217,92,571442,91.90125442264393,9
0.05,6218,95,571537,91.90175269335906,6
0.05,6219,93,571630,91.90192926045016,8
0.05,6220,95,571725,91.902427262498,6
0.05,6221,95,571820,91.90292510446801,6
0.05,6222,92,571912,91.90294070384059,9
0.05,6223,94,572006,91.90327763496144,7
0.05,6224,95,572101,91.9037751004016,8
0.05,6225,92,572193,91.90379055573402,9
0.05,6226,94,572287,91.90412718805203,7
0.05,6227,89,572376,91.90366088631984,12
0.05,6228,96,572472,91.90431851019426,6
0.05,6229,93,572565,91.90449438202248,8
0.05,6230,86,572651,91.90354678221794,15
0.05,6231,27,572678,91.89313222079589,6
0.05,6232,94,572772,91.89347023905022,7
0.05,6233,94,572866,91.89380814886108,7
0.05,6234,95,572961,91.89430633520449,6
0.05,6235,94,573055,91.89464400256574,7
0.05,6236,21,573076,91.88327721661055,11
0.05,6237,94,573170,91.88361654376402,7
0.05,6238,94,573264,91.88395576214137,7
0.05,6239,95,573359,91.88445512820513,7
0.05,6240,92,573451,91.88447364204454,9
0.05,6241,94,573545,91.8848125600769,7
0.05,6242,94,573639,91.88515136953387,7
0.05,6243,94,573733,91.88549007046765,8
0.05,6244,95,573828,91.88598879103283,6
0.05,6245,94,573922,91.88632724943965,7
0.05,6246,94,574016,91.88666559948776,7
0.05,6247,93,574109,91.8868437900128,8
0.05,6248,94,574203,91.88718194911186,7
0.05,6249,94,574297,91.88752,8
0.05,6250,95,574392,91.88801791713325,6
0.05,6251,91,574483,91.8878758797185,10
0.05,6252,95,574578,91.88837358068128,6
0.05,6253,94,574672,91.88871122481612,7
0.05,6254,27,574699,91.87833733013589,6
0.05,6255,94,574793,91.87867647058823,7
0.05,6256,94,574887,91.87901550263705,8
0.05,6257,93,574980,91.87919463087249,8
0.05,6258,93,575073,91.87937370186931,8
0.05,6259,94,575167,91.8797124600639,7
0.05,6260,94,575261,91.88005111004632,7
0.05,6261,96,575357,91.8807090386458,6
0.05,6262,94,575451,91.88104742136356,7
0.05,6263,91,575542,91.8809067688378,10
0.05,6264,93,575635,91.88108539505187,8
0.05,6265,92,575727,91.88110437280562,9
0.05,6266,94,575821,91.88144247646402,7
0.05,6267,96,575917,91.88209955328654,6
0.05,6268,93,576010,91.8822778752592,9
0.05,6269,96,576106,91.8829346092504,6
0.05,6270,94,576200,91.88327220538989,7
0.05,6271,96,576296,91.88392857142857,6
0.05,6272,91,576387,91.88378766140603,10
0.05,6273,94,576481,91.88412496015302,7
0.05,6274,94,576575,91.88446215139442,7
0.05,6275,92,576667,91.88448056086679,9
0.05,6276,94,576761,91.88481758801976,7
0.05,6277,94,576855,91.88515450780503,7
0.05,6278,95,576950,91.88565058130276,6
0.05,6279,92,577042,91.88566878980892,9
0.05,6280,95,577137,91.88616462346761,6
0.05,6281,91,577228,91.886023559376,10
0.05,6282,95,577323,91.88651917873628,6
0.05,6283,95,577418,91.88701464035645,6
0.05,6284,94,577512,91.8873508353222,7
0.05,6285,94,577606,91.88768692332167,7
0.05,6286,27,577633,91.87736599331954,6
0.05,6287,95,577728,91.87786259541984,7
0.05,6288,95,577823,91.87835903959294,6
0.05,6289,96,577919,91.87901430842608,6
0.05,6290,94,578013,91.87935145445876,7
0.05,6291,93,578106,91.87952956134774,10
0.05,6292,95,578201,91.88002542507549,6
0.05,6293,93,578294,91.88020336828725,8
0.05,6294,92,578386,91.88022239872915,9
0.05,6295,93,578479,91.88040025412961,8
0.05,6296,94,578573,91.88073685882166,7
0.05,6297,94,578667,91.88107335662114,7
0.05,6298,94,578761,91.88140974757899,7
0.05,6299,93,578854,91.8815873015873,8
0.05,6300,94,578948,91.88192350420569,8
0.05,6301,94,579042,91.88225960012694,7
0.05,6302,93,579135,91.88243693479295,8
0.05,6303,95,579230,91.88293147208122,7
0.05,6304,94,579324,91.8832672482157,7
0.05,6305,94,579418,91.88360291785601,7
0.05,6306,85,579503,91.88251149516411,16
0.05,6307,94,579597,91.88284717818642,8
0.05,6308,91,579688,91.88270724362023,10
0.05,6309,94,579782,91.88304278922345,7
0.05,6310,91,579873,91.88290286800824,11
0.05,6311,93,579966,91.88307984790875,8
0.05,6312,96,580062,91.88373198162522,6
0.05,6313,94,580156,91.88406715235983,7
0.05,6314,94,580250,91.88440221694378,7
0.05,6315,94,580344,91.88473717542749,7
0.05,6316,94,580438,91.88507202786133,7
0.05,6317,94,580532,91.88540677429566,7
0.05,6318,94,580626,91.88574141478082,7
0.05,6319,90,580716,91.88544303797468,11
0.05,6320,91,580807,91.88530295839266,11
0.05,6321,96,580903,91.88595381208478,6
0.05,6322,27,580930,91.87569191839317,6
0.05,6323,93,581023,91.8758697027198,8
0.05,6324,95,581118,91.87636363636364,6
0.05,6325,95,581213,91.87685741384762,6
0.05,6326,92,581305,91.87687687687688,10
0.05,6327,93,581398,91.87705436156763,8
0.05,6328,94,581492,91.87738979301628,7
0.05,6329,94,581586,91.87772511848341,7
0.05,6330,95,581681,91.87821829094929,6
0.05,6331,92,581773,91.8782375236892,10
0.05,6332,25,581798,91.86767724617086,8
0.05,6333,94,581892,91.8680138932744,7
0.05,6334,91,581983,91.8678768745067,10
0.05,6335,92,582075,91.86789772727273,9
0.05,6336,91,582166,91.86776077008048,10
0.05,6337,94,582260,91.86809719154307,7
0.05,6338,94,582354,91.86843350686227,7
0.05,6339,95,582449,91.86892744479495,6
0.05,6340,96,582545,91.86957893076801,6
0.05,6341,93,582638,91.86975717439293,9
0.05,6342,94,582732,91.87009301592306,7
0.05,6343,94,582826,91.8704287515763,7
0.05,6344,92,582918,91.87044917257683,9
0.05,6345,95,583013,91.87094232587457,7
0.05,6346,96,583109,91.87159287852529,6
0.05,6347,25,583134,91.86105860113422,8
0.05,6348,94,583228,91.8613954953536,7
0.05,6349,92,583320,91.86141732283464,9
0.05,6350,94,583414,91.8617540544796,8
0.05,6351,86,583500,91.86083123425692,15
0.05,6352,94,583594,91.86116795214859,7
0.05,6353,94,583688,91.86150456405414,7
0.05,6354,94,583782,91.8618410700236,7
0.05,6355,94,583876,91.86217747010699,7
0.05,6356,94,583970,91.86251376435426,8
0.05,6357,96,584066,91.86316451714376,6
0.05,6358,94,584160,91.863500550401,7
0.05,6359,88,584248,91.862893081761,13
0.05,6360,91,584339,91.86275742807734,10
0.05,6361,94,584433,91.86309336686577,8
0.05,6362,95,584528,91.86358635863586,6
0.05,6363,95,584623,91.86407919547455,7
0.05,6364,91,584714,91.86394344069129,11
0.05,6365,95,584809,91.86443606660383,6
0.05,6366,94,584903,91.86477147793309,7
0.05,6367,94,584997,91.8651067839196,7
0.05,6368,90,585087,91.86481394253416,11
0.05,6369,93,585180,91.86499215070644,8
0.05,6370,96,585276,91.8656411866269,6
0.05,6371,94,585370,91.86597614563716,9
0.05,6372,91,585461,91.86584026361211,10
0.05,6373,92,585553,91.86586131157829,9
0.05,6374,94,585647,91.86619607843137,7
0.05,6375,92,585739,91.86621706398996,9
0.05,6376,95,585834,91.86670848361298,7
0.05,6377,91,585925,91.86657259328943,10
0.05,6378,94,586019,91.8669070387208,7
0.05,6379,96,586115,91.86755485893417,6
0.05,6380,95,586210,91.86804576085252,6
0.05,6381,95,586305,91.86853650893137,6
0.05,6382,95,586400,91.86902710324298,6
0.05,6383,91,586491,91.86889097744361,10
0.05,6384,94,586585,91.86922474549726,7
0.05,6385,96,586681,91.86987159411213,6
0.05,6386,94,586775,91.87020510411774,7
0.05,6387,92,586867,91.8702254226675,12
0.05,6388,94,586961,91.8705587728909,7
0.05,6389,96,587057,91.87120500782473,6
0.05,6390,95,587152,91.87169457048975,7
0.05,6391,96,587248,91.87234042553192,6
0.05,6392,93,587341,91.87251681526669,8
0.05,6393,94,587435,91.8728495464498,7
0.05,6394,94,587529,91.8731821735731,8
0.05,6395,94,587623,91.87351469668543,7
0.05,6396,94,587717,91.87384711583555,7
0.05,6397,95,587812,91.8743357299156,6
0.05,6398,96,587908,91.87498046569776,6
0.05,6399,93,588001,91.87515625,8
0.05,6400,95,588096,91.87564443055773,6
0.05,6401,96,588192,91.87628865979381,6
0.05,6402,96,588288,91.8769326878026,6
0.05,6403,92,588380,91.87695190505934,9
0.05,6404,95,588475,91.87743950039032,7
0.05,6405,94,588569,91.87777083983765,7
0.05,6406,94,588663,91.87810207585453,7
0.05,6407,90,588753,91.87780898876404,11
0.05,6408,94,588847,91.87814011546263,7
0.05,6409,94,588941,91.87847113884555,7
0.05,6410,96,589037,91.87911402277336,6
0.05,6411,94,589131,91.87944479101684,7
0.05,6412,93,589224,91.87961952284422,8
0.05,6413,96,589320,91.88026192703461,6
0.05,6414,96,589416,91.88090413094311,6
0.05,6415,96,589512,91.88154613466334,6
0.05,6416,94,589606,91.88187626616799,7
0.05,6417,94,589700,91.88220629479589,7
0.05,6418,96,589796,91.88284779560679,6
0.05,6419,94,589890,91.88317757009345,7
0.05,6420,95,589985,91.88366298084411,6
0.05,6421,27,590012,91.87355963874182,6
0.05,6422,93,590105,91.8737350147906,8
0.05,6423,94,590199,91.87406600249066,7
0.05,6424,95,590294,91.87455252918288,6
0.05,6425,92,590386,91.87457205104263,9
0.05,6426,93,590479,91.87474716041699,8
0.05,6427,95,590574,91.87523335407592,6
0.05,6428,92,590666,91.87525276092705,9
0.05,6429,95,590761,91.87573872472784,6
0.05,6430,92,590853,91.87575804696004,9
0.05,6431,94,590947,91.87608830845771,7
0.05,6432,93,591040,91.87626301880927,10
0.05,6433,94,591134,91.87659309916071,7
0.05,6434,95,591229,91.87707847707847,6
0.05,6435,94,591323,91.87740832815413,7
0.05,6436,94,591417,91.87773807674382,7
0.05,6437,96,591513,91.87837837837837,6
0.05,6438,93,591606,91.87855257027489,8
0.05,6439,93,591699,91.87872670807454,8
0.05,6440,94,591793,91.87905604719764,8
0.05,6441,96,591889,91.87969574666252,6
0.05,6442,94,591983,91.88002483315226,7
0.05,6443,94,592077,91.88035381750466,7
0.05,6444,90,592167,91.8800620636152,11
0.05,6445,96,592263,91.88070121005275,6
0.05,6446,90,592353,91.88040949278734,11
0.05,6447,94,592447,91.88073821339951,7
0.05,6448,-47,592400,91.85920297720577,12
0.05,6449,94,592494,91.85953488372093,7
0.05,6450,94,592588,91.8598666873353,9
0.05,6451,27,592615,91.84981401115932,6
0.05,6452,94,592709,91.85014721834806,7
0.05,6453,94,592803,91.85048032228076,7
0.05,6454,94,592897,91.85081332300543,8
0.05,6455,95,592992,91.85130111524164,6
0.05,6456,96,593088,91.85194362707139,6
0.05,6457,94,593182,91.85227624651596,7
0.05,6458,27,593209,91.84223564019199,6
0.05,6459,95,593304,91.84272445820433,6
0.05,6460,96,593400,91.84336789970592,6
0.05,6461,93,593493,91.84354688950789,8
0.05,6462,94,593587,91.84388055082779,7
0.05,6463,96,593683,91.84452351485149,6
0.05,6464,94,593777,91.84485692188709,7
0.05,6465,96,593873,91.84549953603464,6
0.05,6466,93,593966,91.84567805783207,8
0.05,6467,92,594058,91.84570191713048,9
0.05,6468,95,594153,91.84618951924563,6
0.05,6469,94,594247,91.84652241112829,7
0.05,6470,94,594341,91.84685520012363,7
0.05,6471,96,594437,91.84749690976514,6
0.05,6472,93,594530,91.84767495751584,8
0.05,6473,94,594624,91.84800741427247,7
0.05,6474,94,594718,91.84833976833977,8
0.05,6475,96,594814,91.848980852378,6
0.05,6476,93,594907,91.84915856106223,8
0.05,6477,95,595002,91.84964495214572,6
0.05,6478,94,595096,91.84997684827906,7
0.05,6479,95,595191,91.85046296296296,6
0.05,6480,96,595287,91.85110322481098,6
0.05,6481,96,595383,91.8517432891083,7
0.05,6482,94,595477,91.8520746567947,7
0.05,6483,94,595571,91.85240592227021,7
0.05,6484,94,595665,91.8527370855821,7
0.05,6485,93,595758,91.85291396854764,8
0.05,6486,94,595852,91.85324495144134,7
0.05,6487,94,595946,91.8535758323058,7
0.05,6488,93,596039,91.85375250423795,8
0.05,6489,95,596134,91.8542372881356,8
0.05,6490,94,596228,91.8545678631952,7
0.05,6491,94,596322,91.85489833641405,7
0.05,6492,95,596417,91.85538271985214,7
0.05,6493,93,596510,91.8555589775177,8
0.05,6494,95,596605,91.85604311008468,6
0.05,6495,94,596699,91.85637315270937,7
0.05,6496,94,596793,91.85670309373558,7
0.05,6497,89,596882,91.85626346568175,13
0.05,6498,94,596976,91.85659332204955,7
0.05,6499,96,597072,91.85723076923077,6
0.05,6500,94,597166,91.85756037532687,7
0.05,6501,95,597261,91.85804367886804,6
0.05,6502,94,597355,91.85837305858834,7
0.05,6503,93,597448,91.85854858548585,8
0.05,6504,96,597544,91.85918524212144,6
0.05,6505,95,597639,91.85966799877036,6
0.05,6506,96,597735,91.86030428769018,6
0.05,6507,94,597829,91.86063306699447,7
0.05,6508,94,597923,91.86096174527577,8
0.05,6509,95,598018,91.86144393241167,6
0.05,6510,92,598110,91.86146521271694,9
0.05,6511,94,598204,91.86179361179362,7
0.05,6512,95,598299,91.8622754491018,6
0.05,6513,93,598392,91.86245010746086,8
0.05,6514,94,598486,91.86277820414428,7
0.05,6515,94,598580,91.86310620012277,7
0.05,6516,96,598676,91.86374098511585,6
0.05,6517,94,598770,91.86406873274011,7
0.05,6518,94,598864,91.86439637981286,7
0.05,6519,94,598958,91.86472392638036,7
0.05,6520,95,599053,91.86520472320197,7
0.05,6521,93,599146,91.8653787181846,8
0.05,6522,94,599240,91.86570596351372,7
0.05,6523,91,599331,91.86557326793378,10
0.05,6524,90,599421,91.86528735632184,11
0.05,6525,94,599515,91.86561446521605,7
0.05,6526,92,599607,91.86563505438946,9
0.05,6527,93,599700,91.8658088235294,8
0.05,6528,95,599795,91.86628886506357,6
0.05,6529,94,599889,91.86661562021439,7
0.05,6530,95,599984,91.86709539121115,6
0.05,6531,89,600073,91.86665646050214,12
0.05,6532,94,600167,91.8669830093372,7
0.05,6533,94,600261,91.86730945821854,7
0.05,6534,92,600353,91.86732976281561,9
0.05,6535,92,600445,91.86735006119952,9
0.05,6536,95,600540,91.867829279486,6
0.05,6537,92,600632,91.86784949525848,10
0.05,6538,94,600726,91.86817556201254,7
0.05,6539,95,600821,91.86865443425077,6
0.05,6540,94,600915,91.86898027824492,7
0.05,6541,94,601009,91.86930602262305,7
0.05,6542,92,601101,91.86932599724896,9
0.05,6543,94,601195,91.86965158924205,7
0.05,6544,96,601291,91.87028265851795,6
0.05,6545,96,601387,91.8709135349832,6
0.05,6546,96,601483,91.87154421872613,6
0.05,6547,95,601578,91.87202199144777,6
0.05,6548,90,601668,91.87173614292259,11
0.05,6549,91,601759,91.87160305343511,11
0.05,6550,92,601851,91.87162265303007,9
0.05,6551,95,601946,91.87210012210012,6
0.05,6552,95,602041,91.87257744544483,8
0.05,6553,94,602135,91.87290204455294,7
0.05,6554,93,602228,91.87307398932113,8
0.05,6555,94,602322,91.87339841366688,7
0.05,6556,94,602416,91.8737227390575,7
0.05,6557,95,602511,91.87419945105215,7
0.05,6558,94,602605,91.87452355542004,7
0.05,6559,96,602701,91.87515243902439,6
0.05,6560,92,602793,91.87517146776406,9
0.05,6561,96,602889,91.87580006095702,6
0.05,6562,95,602984,91.87627609325004,7
0.05,6563,95,603079,91.87675198049969,6
0.05,6564,95,603174,91.87722772277228,6
0.05,6565,96,603270,91.87785561985989,6
0.05,6566,94,603364,91.87817877265114,7
0.05,6567,94,603458,91.8785018270402,7
0.05,6568,94,603552,91.878824783072,7
0.05,6569,94,603646,91.87914764079147,8
0.05,6570,94,603740,91.87947040024349,7
0.05,6571,89,603829,91.87903225806451,13
0.05,6572,95,603924,91.87950707439525,6
0.05,6573,96,604020,91.88013386066322,6
0.05,6574,94,604114,91.88045627376425,7
0.05,6575,95,604209,91.88093065693431,6
0.05,6576,95,604304,91.88140489584917,6
0.05,6577,94,604398,91.8817269686835,7
0.05,6578,94,604492,91.88204894360845,7
0.05,6579,92,604584,91.88206686930091,9
0.05,6580,94,604678,91.88238869472724,7
0.05,6581,94,604772,91.88271042236403,7
0.05,6582,94,604866,91.88303205225581,7
0.05,6583,95,604961,91.88350546780073,6
0.05,6584,90,605051,91.88321943811694,11
0.05,6585,87,605138,91.88247798360158,14
0.05,6586,94,605232,91.88279945346895,7
0.05,6587,94,605326,91.88312082574377,7
0.05,6588,95,605421,91.88359386856882,6
0.05,6589,94,605515,91.88391502276176,7
0.05,6590,92,605607,91.88393263541192,9
0.05,6591,93,605700,91.88410194174757,8
0.05,6592,92,605792,91.88411952070378,9
0.05,6593,93,605885,91.88428874734608,8
0.05,6594,93,605978,91.88445792266869,8
0.05,6595,94,606072,91.88477865372953,7
0.05,6596,94,606166,91.88509928755495,7
0.05,6597,94,606260,91.88541982418914,8
0.05,6598,92,606352,91.88543718745264,9
0.05,6599,91,606443,91.88530303030304,10
0.05,6600,94,606537,91.8856233903954,7
0.05,6601,94,606631,91.88594365343835,7
0.05,6602,96,606727,91.88656671210056,6
0.05,6603,94,606821,91.88688673531193,7
0.05,6604,93,606914,91.88705526116578,9
0.05,6605,89,607003,91.88661822585529,12
0.05,6606,94,607097,91.88693809595883,7
0.05,6607,94,607191,91.8872578692494,7
0.05,6608,94,607285,91.88757754577092,7
0.05,6609,25,607310,91.87745839636914,8
0.05,6610,94,607404,91.87777945847829,7
0.05,6611,95,607499,91.87825166364186,6
0.05,6612,95,607594,91.87872372599425,6
0.05,6613,92,607686,91.8787420622921,9
0.05,6614,94,607780,91.8790627362056,9
0.05,6615,94,607874,91.87938331318017,7
0.05,6616,92,607966,91.87940154148406,11
0.05,6617,93,608059,91.87957086733152,8
0.05,6618,93,608152,91.87974014201541,8
0.05,6619,94,608246,91.88006042296072,7
0.05,6620,94,608340,91.88038060715904,7
0.05,6621,96,608436,91.88100271821202,6
0.05,6622,96,608532,91.88162464140117,6
0.05,6623,94,608626,91.88194444444444,7
0.05,6624,93,608719,91.88211320754716,8
0.05,6625,96,608815,91.8827346815575,6
0.05,6626,96,608911,91.88335596800965,6
0.05,6627,90,609001,91.8830718165359,11
0.05,6628,94,609095,91.8833911600543,7
0.05,6629,90,609185,91.88310708898945,11
0.05,6630,92,609277,91.88312471723722,9
0.05,6631,26,609303,91.87319059107358,8
0.05,6632,93,609396,91.8733604703754,8
0.05,6633,96,609492,91.87398251432018,6
0.05,6634,95,609587,91.87445365486059,6
0.05,6635,95,609682,91.87492465340567,6
0.05,6636,94,609776,91.87524483953594,9
0.05,6637,89,609865,91.87481169026815,12
0.05,6638,95,609960,91.87528242205151,6
0.05,6639,94,610054,91.87560240963856,7
0.05,6640,95,610149,91.87607288059027,6
0.05,6641,94,610243,91.87639265281541,7
0.05,6642,95,610338,91.87686286316423,6
0.05,6643,94,610432,91.87718242022878,7
0.05,6644,93,610525,91.87735139202408,8
0.05,6645,94,610619,91.87767077941619,7
0.05,6646,94,610713,91.87799007070859,7
0.05,6647,94,610807,91.87830926594465,7
0.05,6648,96,610903,91.87892916228004,6
0.05,6649,96,610999,91.87954887218045,6
0.05,6650,94,611093,91.87986768906931,7
0.05,6651,93,611186,91.88003607937462,8
0.05,6652,94,611280,91.88035472719073,7
0.05,6653,95,611375,91.88082356477307,6
0.05,6654,93,611468,91.8809917355372,8
0.05,6655,24,611492,91.87079326923077,8
0.05,6656,96,611588,91.87141354964699,6
0.05,6657,91,611679,91.87128266746771,10
0.05,6658,93,611772,91.8714521699955,8
0.05,6659,94,611866,91.87177177177178,7
0.05,6660,94,611960,91.87209127758595,7
0.05,6661,95,612055,91.8725607925548,6
0.05,6662,95,612150,91.87303016659162,6
0.05,6663,95,612245,91.87349939975991,6
0.05,6664,94,612339,91.87381845461366,7
0.05,6665,92,612431,91.87383738373838,9
0.05,6666,95,612526,91.87430628468577,6
0.05,6667,92,612618,91.874325134973,9
0.05,6668,92,612710,91.87434397960713,10
0.05,6669,92,612802,91.87436281859071,9
0.05,6670,94,612896,91.87468145705292,8
0.05,6671,94,612990,91.875,7
0.05,6672,92,613082,91.87501873220441,9
0.05,6673,94,613176,91.87533712915793,7
0.05,6674,94,613270,91.87565543071162,7
0.05,6675,90,613360,91.87537447573398,11
0.05,6676,93,613453,91.87554290849184,11
0.05,6677,92,613545,91.87556154537286,10
0.05,6678,96,613641,91.87617906872286,6
0.05,6679,94,613735,91.87649700598803,7
0.05,6680,93,613828,91.87666516988475,8
0.05,6681,94,613922,91.87698293923975,7
0.05,6682,94,614016,91.87730061349693,7
0.05,6683,93,614109,91.87746858168761,8
0.05,6684,93,614202,91.87763649962604,8
0.05,6685,94,614296,91.87795393359258,7
0.05,6686,96,614392,91.87857036040077,6
0.05,6687,93,614485,91.87873803827752,8
0.05,6688,94,614579,91.87905516519659,7
0.05,6689,95,614674,91.8795216741405,8
0.05,6690,96,614770,91.88013749813182,6
0.05,6691,27,614797,91.87044231918709,6
0.05,6692,94,614891,91.87076049604065,7
0.05,6693,94,614985,91.8710785778309,7
0.05,6694,92,615077,91.87109783420463,9
0.05,6695,95,615172,91.8715651135006,6
0.05,6696,95,615267,91.87203225324772,6
0.05,6697,94,615361,91.87234995521051,7
0.05,6698,96,615457,91.87296611434543,6
0.05,6699,96,615553,91.87358208955224,6
0.05,6700,89,615642,91.87315326070735,12
0.05,6701,92,615734,91.87317218740674,10
0.05,6702,94,615828,91.87348948232135,7
0.05,6703,95,615923,91.87395584725537,7
0.05,6704,94,616017,91.87427293064877,7
0.05,6705,94,616111,91.8745899194751,7
0.05,6706,91,616202,91.87445951990458,10
0.05,6707,27,616229,91.86478831246274,6
0.05,6708,92,616321,91.86480846623938,9
0.05,6709,94,616415,91.86512667660209,7
0.05,6710,95,616510,91.86559380122188,6
0.05,6711,94,616604,91.86591179976162,7
0.05,6712,93,616697,91.8660807388649,8
0.05,6713,26,616723,91.85627047959488,7
0.05,6714,94,616817,91.8565897244974,8
0.05,6715,95,616912,91.85705777248361,6
0.05,6716,93,617005,91.85722792913504,9
0.05,6717,92,617097,91.85724918130396,9
0.05,6718,93,617190,91.85741925881828,8
0.05,6719,94,617284,91.85773809523809,7
0.05,6720,93,617377,91.85790804939741,9
0.05,6721,92,617469,91.85792918774175,9
0.05,6722,96,617565,91.85854529228023,6
0.05,6723,94,617659,91.85886377156454,7
0.05,6724,96,617755,91.85947955390334,6
0.05,6725,93,617848,91.85964912280701,8
0.05,6726,94,617942,91.85996729597146,7
0.05,6727,96,618038,91.86058263971462,6
0.05,6728,91,618129,91.86045474810521,10
0.05,6729,93,618222,91.86062407132243,9
0.05,6730,94,618316,91.86094191056307,7
0.05,6731,94,618410,91.8612596553773,7
0.05,6732,92,618502,91.86128026139907,9
0.05,6733,92,618594,91.86130086130086,10
0.05,6734,94,618688,91.86161841128434,8
0.05,6735,94,618782,91.86193586698337,7
0.05,6736,93,618875,91.86210479441888,8
0.05,6737,94,618969,91.86242208370436,7
0.05,6738,93,619062,91.86259088885592,8
0.05,6739,92,619154,91.8626112759644,10
0.05,6740,94,619248,91.86292834890966,7
0.05,6741,95,619343,91.8633936517354,7
0.05,6742,93,619436,91.86356221266499,8
0.05,6743,95,619531,91.86402728351126,6
0.05,6744,94,619625,91.86434395848777,7
0.05,6745,93,619718,91.8645123035873,8
0.05,6746,93,619811,91.86468059878464,8
0.05,6747,92,619903,91.86470065204504,9
0.05,6748,95,619998,91.86516520966069,6
0.05,6749,90,620088,91.86488888888888,12
0.05,6750,93,620181,91.86505702858835,8
0.05,6751,94,620275,91.86537322274881,7
0.05,6752,27,620302,91.85576780690063,6
0.05,6753,93,620395,91.85593722238673,9
0.05,6754,93,620488,91.8561065877128,8
0.05,6755,94,620582,91.85642391947898,7
0.05,6756,95,620677,91.85688915199053,6
0.05,6757,96,620773,91.8575022195916,6
0.05,6758,94,620867,91.85781920402427,8
0.05,6759,94,620961,91.85813609467456,7
0.05,6760,94,621055,91.85845289158408,7
0.05,6761,95,621150,91.85891748003549,6
0.05,6762,96,621246,91.8595297944699,6
0.05,6763,96,621342,91.86014192785333,6
0.05,6764,95,621437,91.86060606060606,7
0.05,6765,94,621531,91.86092225835057,7
0.05,6766,94,621625,91.86123836264224,7
0.05,6767,96,621721,91.86184988179669,6
0.05,6768,94,621815,91.86216575565076,7
0.05,6769,96,621911,91.86277695716396,6
0.05,6770,94,622005,91.86309260079751,7
0.05,6771,96,622101,91.86370348493799,6
0.05,6772,92,622193,91.8637236084453,9
0.05,6773,84,622277,91.8625627398878,17
0.05,6774,95,622372,91.86302583025831,6
0.05,6775,96,622468,91.86363636363636,6
0.05,6776,95,622563,91.86409915891987,6
0.05,6777,92,622655,91.86411920920625,9
0.05,6778,92,622747,91.86413925357722,10
0.05,6779,96,622843,91.86474926253688,6
0.05,6780,92,622935,91.8647692080814,9
0.05,6781,95,623030,91.86523149513418,6
0.05,6782,94,623124,91.8655462184874,7
0.05,6783,93,623217,91.86571344339623,9
0.05,6784,94,623311,91.86602800294767,7
0.05,6785,94,623405,91.86634246979075,7
0.05,6786,92,623497,91.8663621629586,9
0.05,6787,91,623588,91.86623453152622,10
0.05,6788,94,623682,91.86654882898807,7
0.05,6789,95,623777,91.86701030927836,6
0.05,6790,95,623872,91.86747165365925,6
0.05,6791,92,623964,91.86749116607774,9
0.05,6792,94,624058,91.86780509347858,8
0.05,6793,96,624154,91.86841330585811,6
0.05,6794,94,624248,91.86872700515084,7
0.05,6795,93,624341,91.86889346674515,9
0.05,6796,94,624435,91.8692070030896,7
0.05,6797,93,624528,91.8693733451015,8
0.05,6798,94,624622,91.8696867186351,7
0.05,6799,91,624713,91.86955882352942,10
0.05,6800,95,624808,91.87001911483605,6
0.05,6801,95,624903,91.8704792708027,6
0.05,6802,90,624993,91.87020432162281,11
0.05,6803,94,625087,91.87051734273956,7
0.05,6804,95,625182,91.87097722263042,6
0.05,6805,95,625277,91.87143696738173,6
0.05,6806,94,625371,91.87174966945791,7
0.05,6807,93,625464,91.87191539365452,8
0.05,6808,95,625559,91.87237479806139,7
0.05,6809,91,625650,91.87224669603525,10
0.05,6810,94,625744,91.87255909558068,7
0.05,6811,94,625838,91.87287140340575,7
0.05,6812,91,625929,91.87274328489652,10
0.05,6813,95,626024,91.8732022307015,6
0.05,6814,92,626116,91.87322083639032,9
0.05,6815,93,626209,91.87338615023474,8
0.05,6816,93,626302,91.8735514155787,8
0.05,6817,94,626396,91.87386330302141,8
0.05,6818,94,626490,91.87417509898812,7
0.05,6819,94,626584,91.87448680351906,8
0.05,6820,95,626679,91.87494502272394,6
0.05,6821,91,626770,91.87481676927587,10
0.05,6822,95,626865,91.8752748058039,6
0.05,6823,96,626961,91.87587924970691,6
0.05,6824,91,627052,91.87575091575091,10
0.05,6825,94,627146,91.87606211544096,7
0.05,6826,96,627242,91.87666617840925,6
0.05,6827,96,627338,91.87727006444054,6
0.05,6828,93,627431,91.87743447063991,8
0.05,6829,96,627527,91.87803806734993,6
0.05,6830,95,627622,91.87849509588641,6
0.05,6831,95,627717,91.87895199063232,6
0.05,6832,94,627811,91.87926240304405,7
0.05,6833,93,627904,91.87942639742464,8
0.05,6834,90,627994,91.87915142648134,11
0.05,6835,96,628090,91.87975424224693,6
0.05,6836,90,628180,91.87947930378822,12
0.05,6837,92,628272,91.87949692892659,9
0.05,6838,94,628366,91.87980698932593,7
0.05,6839,93,628459,91.87997076023392,8
0.05,6840,94,628553,91.88028066072212,8
0.05,6841,96,628649,91.88088278281204,6
0.05,6842,96,628745,91.88148472892007,6
0.05,6843,94,628839,91.88179427235535,7
0.05,6844,92,628931,91.881811541271,9
0.05,6845,94,629025,91.88212094653812,7
0.05,6846,94,629119,91.88243026142837,7
0.05,6847,92,629211,91.88244742990655,10
0.05,6848,92,629303,91.8824645933713,9
0.05,6849,94,629397,91.88277372262773,7
0.05,6850,96,629493,91.8833746898263,6
0.05,6851,88,629581,91.8828079392878,13
0.05,6852,96,629677,91.88340872610536,7
0.05,6853,95,629772,91.8838634374088,6
0.05,6854,96,629868,91.88446389496718,6
0.05,6855,94,629962,91.88477246207701,7
0.05,6856,24,629986,91.87487239317485,10
0.05,6857,93,630079,91.87503645377662,8
0.05,6858,92,630171,91.87505467269281,9
0.05,6859,95,630266,91.87551020408164,6
0.05,6860,90,630356,91.87523684594082,11
0.05,6861,24,630380,91.86534538035558,10
0.05,6862,94,630474,91.86565641847588,7
0.05,6863,91,630565,91.8655303030303,10
0.05,6864,95,630660,91.86598689002184,6
0.05,6865,92,630752,91.86600640838917,9
0.05,6866,93,630845,91.86617154507063,8
0.05,6867,94,630939,91.86648223645894,7
0.05,6868,93,631032,91.86664725578687,8
0.05,6869,96,631128,91.86724890829694,6
0.05,6870,96,631224,91.86785038567893,6
0.05,6871,95,631319,91.86830616996508,6
0.05,6872,94,631413,91.86861632474901,7
0.05,6873,25,631438,91.85888856560955,7
0.05,6874,96,631534,91.85949090909091,6
0.05,6875,96,631630,91.86009307737056,6
0.05,6876,95,631725,91.86054965828123,7
0.05,6877,94,631819,91.86086071532422,7
0.05,6878,90,631909,91.86059020206426,11
0.05,6879,96,632005,91.86119186046511,6
0.05,6880,92,632097,91.86121203313472,9
0.05,6881,96,632193,91.86181342632956,6
0.05,6882,94,632287,91.86212407380502,7
0.05,6883,94,632381,91.86243463102848,7
0.05,6884,94,632475,91.86274509803921,7
0.05,6885,96,632571,91.86334591925646,6
0.05,6886,94,632665,91.86365616378684,7
0.05,6887,94,632759,91.86396631823462,7
0.05,6888,94,632853,91.86427638263899,7
0.05,6889,95,632948,91.86473149492018,6
0.05,6890,94,633042,91.86504135829342,8
0.05,6891,94,633136,91.86535113174695,7
0.05,6892,94,633230,91.86566081531988,7
0.05,6893,93,633323,91.86582535538149,9
0.05,6894,94,633417,91.86613488034808,7
0.05,6895,96,633513,91.8667343387471,6
0.05,6896,93,633606,91.86689865158765,8
0.05,6897,95,633701,91.86735285590026,6
0.05,6898,88,633789,91.8667922887375,13
0.05,6899,94,633883,91.86710144927537,7
0.05,6900,95,633978,91.86755542674975,6
0.05,6901,91,634069,91.8674297305129,10
0.05,6902,96,634165,91.86802839345212,6
0.05,6903,94,634259,91.8683371958285,7
0.05,6904,96,634355,91.86893555394641,6
0.05,6905,94,634449,91.86924413553432,7
0.05,6906,94,634543,91.86955262776893,7
0.05,6907,92,634635,91.86957151129126,9
0.05,6908,90,634725,91.8693009118541,11
0.05,6909,92,634817,91.86931982633864,9
0.05,6910,94,634911,91.8696281290696,7
0.05,6911,93,635004,91.86979166666667,8
0.05,6912,96,635100,91.87038912194416,6
0.05,6913,89,635189,91.86997396586636,12
0.05,6914,92,635281,91.869992769342,9
0.05,6915,91,635372,91.86986697513014,10
0.05,6916,95,635467,91.87031950267458,7
0.05,6917,94,635561,91.87062734894478,8
0.05,6918,94,635655,91.87093510622923,7
0.05,6919,95,635750,91.871387283237,6
0.05,6920,92,635842,91.8714058662043,10
0.05,6921,94,635936,91.87171337763652,7
0.05,6922,94,636030,91.87202080023111,7
0.05,6923,92,636122,91.87203928365106,9
0.05,6924,94,636216,91.87234657039711,7
0.05,6925,94,636310,91.8726537684089,8
0.05,6926,94,636404,91.87296087772485,7
0.05,6927,90,636494,91.87269053117782,11
0.05,6928,92,636586,91.87270890460384,9
0.05,6929,94,636680,91.87301587301587,7
0.05,6930,95,636775,91.87346703217429,7
0.05,6931,94,636869,91.87377380265436,7
0.05,6932,94,636963,91.87408048463868,7
0.05,6933,93,637056,91.87424286126334,8
0.05,6934,96,637152,91.87483777937996,6
0.05,6935,93,637245,91.875,8
0.05,6936,93,637338,91.87516217385037,8
0.05,6937,91,637429,91.87503603343903,10
0.05,6938,93,637522,91.8751981553538,8
0.05,6939,94,637616,91.87550432276657,7
0.05,6940,95,637711,91.87595447341882,6
0.05,6941,94,637805,91.87626044367617,7
0.05,6942,94,637899,91.87656632579576,7
0.05,6943,96,637995,91.87716013824885,6
0.05,6944,91,638086,91.87703383729301,10
0.05,6945,94,638180,91.87733947595738,7
0.05,6946,91,638271,91.87721318554772,11
0.05,6947,91,638362,91.87708693149108,10
0.05,6948,95,638457,91.87753633616347,7
0.05,6949,94,638551,91.87784172661871,7
0.05,6950,95,638646,91.87829089339664,7
0.05,6951,94,638740,91.87859608745684,7
0.05,6952,96,638836,91.87918883934992,6
0.05,6953,92,638928,91.87920621225194,9
0.05,6954,93,639021,91.87936736161035,8
0.05,6955,96,639117,91.87995974698103,6
0.05,6956,92,639209,91.87997700158114,10
0.05,6957,93,639302,91.88013797068123,8
0.05,6958,91,639393,91.88001149590458,10
0.05,6959,93,639486,91.8801724137931,8
0.05,6960,92,639578,91.88018962792702,9
0.05,6961,94,639672,91.88049411088768,7
0.05,6962,94,639766,91.88079850639092,7
0.05,6963,21,639787,91.87062033314187,11
0.05,6964,95,639882,91.8710696338837,6
0.05,6965,92,639974,91.87108814240597,9
0.05,6966,94,640068,91.87139371321946,7
0.05,6967,94,640162,91.87169919632606,7
0.05,6968,94,640256,91.87200459176353,7
0.05,6969,90,640346,91.87173601147776,11
0.05,6970,94,640440,91.8720413140152,7
0.05,6971,91,640531,91.87191623637406,10
0.05,6972,94,640625,91.87222142549835,7
0.05,6973,94,640719,91.87252652710066,7
0.05,6974,94,640813,91.87283154121864,7
0.05,6975,95,640908,91.87327981651376,6
0.05,6976,93,641001,91.87344130715208,8
0.05,6977,92,641093,91.87345944396675,9
0.05,6978,95,641188,91.8739074365955,6
0.05,6979,96,641284,91.87449856733524,6
0.05,6980,91,641375,91.87437329895431,10
0.05,6981,93,641468,91.87453451733028,8
0.05,6982,93,641561,91.87469568953172,8
0.05,6983,93,641654,91.87485681557847,8
0.05,6984,95,641749,91.87530422333572,6
0.05,6985,92,641841,91.87532207271686,9
0.05,6986,94,641935,91.87562616287391,7
0.05,6987,95,642030,91.87607326846022,8
0.05,6988,92,642122,91.87609100014308,9
0.05,6989,93,642215,91.87625178826896,9
0.05,6990,93,642308,91.87641253039622,8
0.05,6991,95,642403,91.87685926773456,6
0.05,6992,93,642496,91.87701987701988,9
0.05,6993,93,642589,91.87718044037747,8
0.05,6994,96,642685,91.87776983559685,6
0.05,6995,96,642781,91.87835906232132,6
0.05,6996,92,642873,91.87837644704874,9
0.05,6997,94,642967,91.87867962274936,8
0.05,6998,88,643055,91.87812544649236,13
0.05,6999,91,643146,91.878,10
0.05,7000,90,643236,91.87773175260676,11
0.05,7001,94,643330,91.87803484718651,7
0.05,7002,95,643425,91.8784806511495,6
0.05,7003,91,643516,91.87835522558538,11
0.05,7004,94,643610,91.87865810135618,7
0.05,7005,93,643703,91.8788181558664,8
0.05,7006,95,643798,91.87926359354931,6
0.05,7007,94,643892,91.87956621004567,8
0.05,7008,93,643985,91.87972606648594,8
0.05,7009,93,644078,91.87988587731812,8
0.05,7010,94,644172,91.88018827556697,7
0.05,7011,94,644266,91.88049058756418,8
0.05,7012,96,644362,91.8810779980037,7
0.05,7013,95,644457,91.88152266894782,6
0.05,7014,93,644550,91.8816821097648,8
0.05,7015,96,644646,91.88226909920182,6
0.05,7016,90,644736,91.88200085506627,11
0.05,7017,95,644831,91.88244514106583,6
0.05,7018,94,644925,91.88274683003277,7
0.05,7019,95,645020,91.88319088319088,6
0.05,7020,94,645114,91.88349238000285,7
0.05,7021,94,645208,91.88379379094275,7
0.05,7022,92,645300,91.88381033746262,9
0.05,7023,92,645392,91.88382687927107,9
0.05,7024,96,645488,91.8844128113879,6
0.05,7025,94,645582,91.88471391972674,7
0.05,7026,95,645677,91.8851572506048,6
0.05,7027,96,645773,91.88574274331246,6
0.05,7028,92,645865,91.88575899843505,9
0.05,7029,96,645961,91.88634423897582,6
0.05,7030,96,646057,91.88692931304224,6
0.05,7031,96,646153,91.88751422070534,6
0.05,7032,93,646246,91.88767240153562,8
0.05,7033,95,646341,91.88811487062837,6
0.05,7034,96,646437,91.88869936034115,6
0.05,7035,94,646531,91.88899943149517,7
0.05,7036,92,646623,91.88901520534318,10
0.05,7037,95,646718,91.88945723216823,6
0.05,7038,94,646812,91.8897570677653,7
0.05,7039,95,646907,91.89019886363636,8
0.05,7040,94,647001,91.89049850873455,7
0.05,7041,94,647095,91.89079806873048,7
0.05,7042,94,647189,91.89109754366036,7
0.05,7043,90,647279,91.89082907438956,11
0.05,7044,93,647372,91.89098651525904,8
0.05,7045,93,647465,91.89114391143912,8
0.05,7046,94,647559,91.89144316730524,7
0.05,7047,93,647652,91.89160045402951,8
0.05,7048,25,647677,91.88211093772166,8
0.05,7049,94,647771,91.88241134751773,7
0.05,7050,90,647861,91.88214437668415,11
0.05,7051,96,647957,91.88272830402722,6
0.05,7052,95,648052,91.88317028214944,6
0.05,7053,92,648144,91.88318684434364,9
0.05,7054,94,648238,91.8834868887314,8
0.05,7055,94,648332,91.88378684807256,7
0.05,7056,91,648423,91.88366161258325,10
0.05,7057,93,648516,91.88381977897421,8
0.05,7058,95,648611,91.88426122680266,6
0.05,7059,94,648705,91.88456090651557,7
0.05,7060,93,648798,91.88471887834584,8
0.05,7061,94,648892,91.88501840838289,7
0.05,7062,94,648986,91.88531785360328,7
0.05,7063,95,649081,91.88575877689694,6
0.05,7064,95,649176,91.88619957537155,6
0.05,7065,93,649269,91.88635720350976,8
0.05,7066,95,649364,91.88679779255696,6
0.05,7067,92,649456,91.88681380871533,9
0.05,7068,93,649549,91.88697128306691,8
0.05,7069,94,649643,91.88727015558699,7
0.05,7070,94,649737,91.88756894357233,7
0.05,7071,92,649829,91.88758484162896,9
0.05,7072,95,649924,91.88802488335925,6
0.05,7073,94,650018,91.88832343794176,7
0.05,7074,94,650112,91.8886219081272,8
0.05,7075,95,650207,91.88906161673262,6
0.05,7076,92,650299,91.88907729263812,11
0.05,7077,92,650391,91.88909296411416,9
0.05,7078,95,650486,91.88953241983332,7
0.05,7079,94,650580,91.88983050847457,7
0.05,7080,92,650672,91.8898460669397,9
0.05,7081,96,650768,91.89042643321096,6
0.05,7082,95,650863,91.89086545249188,6
0.05,7083,94,650957,91.89116318464144,7
0.05,7084,92,651049,91.89117854622442,9
0.05,7085,89,651138,91.89077053344623,12
0.05,7086,94,651232,91.89106815295612,7
0.05,7087,96,651328,91.89164785553048,6
0.05,7088,94,651422,91.89194526731556,7
0.05,7089,95,651517,91.89238363892807,6
0.05,7090,95,651612,91.89282188689889,6
0.05,7091,84,651696,91.8917089678511,17
0.05,7092,95,651791,91.89214718736783,6
0.05,7093,92,651883,91.89216239075274,9
0.05,7094,94,651977,91.89245947850598,7
0.05,7095,92,652069,91.8924746335964,9
0.05,7096,95,652164,91.89291249823869,7
0.05,7097,96,652260,91.89349112426035,6
0.05,7098,92,652352,91.89350612762361,10
0.05,7099,93,652445,91.89366197183098,8
0.05,7100,94,652539,91.89395859738065,7
0.05,7101,89,652628,91.89355111236272,12
0.05,7102,94,652722,91.89384766999859,7
0.05,7103,94,652816,91.89414414414415,7
0.05,7104,95,652911,91.89458128078817,8
0.05,7105,94,653005,91.89487756825218,8
0.05,7106,93,653098,91.89503306599127,8
0.05,7107,94,653192,91.89532920652786,7
0.05,7108,95,653287,91.89576593051062,6
0.05,7109,95,653382,91.89620253164557,6
0.05,7110,95,653477,91.89663900998453,6
0.05,7111,92,653569,91.89665354330708,9
0.05,7112,95,653664,91.89708983551245,7
0.05,7113,94,653758,91.89738543716615,7
0.05,7114,92,653850,91.89739985945187,9
0.05,7115,94,653944,91.89769533445757,8
0.05,7116,94,654038,91.89799072642967,7
0.05,7117,94,654132,91.8982860354032,7
0.05,7118,95,654227,91.89872173058014,8
0.05,7119,94,654321,91.89901685393258,7
0.05,7120,93,654414,91.89917146468193,8
0.05,7121,96,654510,91.89974726200505,6
0.05,7122,95,654605,91.90018250737049,7
0.05,7123,96,654701,91.90075800112297,6
0.05,7124,93,654794,91.90091228070176,8
0.05,7125,94,654888,91.90120684816166,7
0.05,7126,95,654983,91.90164164445068,7
0.05,7127,94,655077,91.90193602693603,7
0.05,7128,93,655170,91.90209005470614,8
0.05,7129,21,655191,91.8921458625526,11
0.05,7130,94,655285,91.89244145281167,7
0.05,7131,92,655377,91.89245653393158,9
0.05,7132,94,655471,91.8927519977569,7
0.05,7133,93,655564,91.89290720493412,9
0.05,7134,91,655655,91.8927820602663,10
0.05,7135,94,655749,91.89307735426009,7
0.05,7136,96,655845,91.89365279529214,6
0.05,7137,93,655938,91.89380778929672,8
0.05,7138,94,656032,91.89410281552038,7
0.05,7139,92,656124,91.89411764705882,9
0.05,7140,89,656213,91.89371236521495,12
0.05,7141,96,656309,91.89428731447774,6
0.05,7142,94,656403,91.89458210835784,7
0.05,7143,94,656497,91.89487681970884,7
0.05,7144,90,656587,91.89461161651505,11
0.05,7145,94,656681,91.89490624125385,7
0.05,7146,94,656775,91.89520078354555,7
0.05,7147,96,656871,91.89577504196978,6
0.05,7148,94,656965,91.89606938033292,7
0.05,7149,94,657059,91.89636363636363,7
0.05,7150,92,657151,91.89637812893302,9
0.05,7151,92,657243,91.89639261744966,9
0.05,7152,92,657335,91.89640710191529,9
0.05,7153,96,657431,91.89698071009225,6
0.05,7154,25,657456,91.88763102725368,8
0.05,7155,90,657546,91.88736724427054,12
0.05,7156,91,657637,91.88724325834848,10
0.05,7157,96,657733,91.88781782620843,6
0.05,7158,95,657828,91.88825254923871,6
0.05,7159,93,657921,91.88840782122905,8
0.05,7160,95,658016,91.88884234045524,6
0.05,7161,94,658110,91.88913711253839,8
0.05,7162,96,658206,91.88971101493787,6
0.05,7163,92,658298,91.8897264098269,10
0.05,7164,93,658391,91.88988136775994,8
0.05,7165,93,658484,91.89003628244488,8
0.05,7166,94,658578,91.89033068229385,7
0.05,7167,94,658672,91.890625,7
0.05,7168,92,658764,91.89064025666062,9
0.05,7169,94,658858,91.89093444909345,7
0.05,7170,22,658880,91.88118811881188,10
0.05,7171,95,658975,91.88162297824874,6
0.05,7172,96,659071,91.88219712811933,6
0.05,7173,96,659167,91.88277111792584,6
0.05,7174,96,659263,91.8833449477352,6
0.05,7175,96,659359,91.88391861761427,6
0.05,7176,93,659452,91.88407412567925,8
0.05,7177,95,659547,91.88450821955976,7
0.05,7178,94,659641,91.88480289733947,7
0.05,7179,95,659736,91.88523676880223,6
0.05,7180,93,659829,91.8853920066843,8
0.05,7181,96,659925,91.8859649122807,6
0.05,7182,93,660018,91.8861200055687,8
0.05,7183,95,660113,91.88655345211582,6
0.05,7184,95,660208,91.88698677800974,6
0.05,7185,92,660300,91.88700250487058,10
0.05,7186,95,660395,91.88743564769723,8
0.05,7187,94,660489,91.88772954924875,7
0.05,7188,94,660583,91.88802336903603,7
0.05,7189,93,660676,91.88817802503478,8
0.05,7190,93,660769,91.88833263801975,8
0.05,7191,93,660862,91.8884872080089,8
0.05,7192,95,660957,91.88891978312247,6
0.05,7193,95,661052,91.8893522379761,6
0.05,7194,94,661146,91.88964558721334,7
0.05,7195,95,661241,91.89007782101167,6
0.05,7196,96,661337,91.8906488814784,6
0.05,7197,96,661433,91.89121978327313,6
0.05,7198,94,661527,91.89151271009862,7
0.05,7199,94,661621,91.89180555555555,7
0.05,7200,94,661715,91.89209831967783,7
0.05,7201,93,661808,91.89225215217995,8
0.05,7202,92,661900,91.892267110926,9
0.05,7203,89,661989,91.89186563020544,12
0.05,7204,25,662014,91.8825815405968,9
0.05,7205,91,662105,91.88245906189287,10
0.05,7206,92,662197,91.88247537116692,9
0.05,7207,94,662291,91.88276914539401,8
0.05,7208,93,662384,91.8829241226245,8
0.05,7209,93,662477,91.88307905686547,8
0.05,7210,96,662573,91.88364997919845,6
0.05,7211,89,662662,91.88325013865779,13
0.05,7212,87,662749,91.88257313184528,14
0.05,7213,92,662841,91.88258940948157,10
0.05,7214,89,662930,91.88218988218988,12
0.05,7215,96,663026,91.88276053215077,6
0.05,7216,92,663118,91.88277677705418,9
0.05,7217,92,663210,91.88279301745636,9
0.05,7218,95,663305,91.88322482338273,6
0.05,7219,92,663397,91.88324099722992,9
0.05,7220,95,663492,91.88367262152056,6
0.05,7221,94,663586,91.88396566048186,7
0.05,7222,95,663681,91.88439706493146,6
0.05,7223,92,663773,91.8844130675526,9
0.05,7224,96,663869,91.88498269896193,6
0.05,7225,92,663961,91.8849986161085,9
0.05,7226,96,664057,91.88556800885569,6
0.05,7227,94,664151,91.88586054233537,7
0.05,7228,95,664246,91.8862913266012,6
0.05,7229,92,664338,91.8863070539419,9
0.05,7230,96,664434,91.88687595076753,6
0.05,7231,93,664527,91.88702986725664,9
0.05,7232,94,664621,91.88732199640536,7
0.05,7233,95,664716,91.88775228089577,6
0.05,7234,94,664810,91.88804422944023,7
0.05,7235,94,664904,91.88833609729132,7
0.05,7236,94,664998,91.88862788448252,7
0.05,7237,27,665025,91.87966289030119,6
0.05,7238,27,665052,91.8707003729797,6
0.05,7239,94,665146,91.87099447513812,7
0.05,7240,95,665241,91.87142659853612,6
0.05,7241,95,665336,91.87185860259596,7
0.05,7242,95,665431,91.87229048736711,7
0.05,7243,95,665526,91.87272225289895,6
0.05,7244,95,665621,91.87315389924086,6
0.05,7245,94,665715,91.8734474192658,8
0.05,7246,92,665807,91.87346488202014,9
0.05,7247,96,665903,91.87403421633555,6
0.05,7248,93,665996,91.8741895433853,8
0.05,7249,91,666087,91.87406896551724,10
0.05,7250,95,666182,91.87450006895601,6
0.05,7251,94,666276,91.87479316050745,7
0.05,7252,93,666369,91.87494829725631,8
0.05,7253,94,666463,91.87524124620899,8
0.05,7254,94,666557,91.87553411440386,7
0.05,7255,96,666653,91.87610253583242,6
0.05,7256,96,666749,91.8766708006063,6
0.05,7257,91,666840,91.8765500137779,10
0.05,7258,94,666934,91.8768425402948,8
0.05,7259,94,667028,91.8771349862259,8
0.05,7260,95,667123,91.87756507368131,7
0.05,7261,94,667217,91.87785733957587,7
0.05,7262,95,667312,91.87828720914223,6
0.05,7263,95,667407,91.87871696035242,6
0.05,7264,95,667502,91.87914659325533,6
0.05,7265,96,667598,91.87971373520506,6
0.05,7266,92,667690,91.87973028760149,9
0.05,7267,94,667784,91.8800220143093,8
0.05,7268,94,667878,91.88031366075114,7
0.05,7269,92,667970,91.88033012379643,9
0.05,7270,96,668066,91.88089671296933,6
0.05,7271,94,668160,91.88118811881188,7
0.05,7272,94,668254,91.88147944452083,7
0.05,7273,95,668349,91.88190816607094,6
0.05,7274,90,668439,91.88164948453608,12
0.05,7275,96,668535,91.88221550302364,6
0.05,7276,89,668624,91.88181943108424,12
0.05,7277,92,668716,91.88183566913987,9
0.05,7278,94,668810,91.88212666575079,7
0.05,7279,94,668904,91.88241758241759,7
0.05,7280,94,668998,91.88270841917318,7
0.05,7281,96,669094,91.88327382587201,6
0.05,7282,92,669186,91.88328985308252,10
0.05,7283,91,669277,91.88316858868754,10
0.05,7284,91,669368,91.88304735758408,10
0.05,7285,95,669463,91.88347515783694,6
0.05,7286,95,669558,91.88390284067518,6
0.05,7287,94,669652,91.88419319429198,7
0.05,7288,96,669748,91.884757854301,6
0.05,7289,96,669844,91.88532235939644,6
0.05,7290,27,669871,91.87642298724455,6
0.05,7291,94,669965,91.87671420735052,7
0.05,7292,94,670059,91.87700534759358,8
0.05,7293,93,670152,91.87715930902111,8
0.05,7294,95,670247,91.87758738862235,6
0.05,7295,96,670343,91.8781524122807,6
0.05,7296,95,670438,91.87858023845416,7
0.05,7297,96,670534,91.87914497122499,6
0.05,7298,94,670628,91.87943553911495,7
0.05,7299,95,670723,91.87986301369862,6
0.05,7300,94,670817,91.88015340364333,7
0.05,7301,95,670912,91.8805806628321,6
0.05,7302,95,671007,91.88100780501163,7
0.05,7303,96,671103,91.88157174151151,6
0.05,7304,96,671199,91.88213552361397,6
0.05,7305,92,671291,91.88215165617301,9
0.05,7306,93,671384,91.88230463938689,8
0.05,7307,93,671477,91.88245758073344,8
0.05,7308,94,671571,91.88274729785196,7
0.05,7309,94,671665,91.88303693570451,7
0.05,7310,96,671761,91.88360005471208,6
0.05,7311,94,671855,91.88388949671773,7
0.05,7312,95,671950,91.88431560235198,6
0.05,7313,94,672044,91.88460486737763,7
0.05,7314,94,672138,91.88489405331511,7
0.05,7315,95,672233,91.88531984691087,6
0.05,7316,92,672325,91.88533552002187,9
0.05,7317,96,672421,91.88589778628041,6
0.05,7318,95,672516,91.88632326820604,6
0.05,7319,93,672609,91.88647540983607,8
0.05,7320,95,672704,91.88690069662614,6
0.05,7321,94,672798,91.88718929254303,7
0.05,7322,94,672892,91.88747780964086,7
0.05,7323,92,672984,91.88749317312944,9
0.05,7324,93,673077,91.88764505119454,8
0.05,7325,95,673172,91.8880698880699,6
0.05,7326,92,673264,91.88808516446022,9
0.05,7327,94,673358,91.88837336244542,7
0.05,7328,95,673453,91.8887979260472,6
0.05,7329,92,673545,91.88881309686221,9
0.05,7330,92,673637,91.8888282635384,9
0.05,7331,96,673733,91.88938897981451,6
0.05,7332,95,673828,91.88981317332606,7
0.05,7333,94,673922,91.8901008999182,7
0.05,7334,92,674014,91.89011588275392,9
0.05,7335,95,674109,91.89053980370774,6
0.05,7336,93,674202,91.8906910181273,8
0.05,7337,94,674296,91.89097846824748,7
0.05,7338,95,674391,91.89140209837852,7
0.05,7339,94,674485,91.891689373297,7
0.05,7340,94,674579,91.89197656994959,7
0.05,7341,94,674673,91.89226368836829,8
0.05,7342,96,674769,91.89282309682692,6
0.05,7343,93,674862,91.89297385620915,9
0.05,7344,92,674954,91.8929884275017,9
0.05,7345,95,675049,91.89341138034304,6
0.05,7346,92,675141,91.8934258881176,10
0.05,7347,96,675237,91.89398475775721,6
0.05,7348,94,675331,91.89427132943257,7
0.05,7349,94,675425,91.89455782312925,7
0.05,7350,94,675519,91.89484423887906,7
0.05,7351,93,675612,91.8949945593036,8
0.05,7352,96,675708,91.89555283557732,6
0.05,7353,92,675800,91.89556703834648,9
0.05,7354,95,675895,91.89598912304555,6
0.05,7355,96,675991,91.89654703643285,6
0.05,7356,94,676085,91.89683294821259,7
0.05,7357,94,676179,91.89711878227779,7
0.05,7358,94,676273,91.89740453866014,7
0.05,7359,96,676369,91.89796195652174,6
0.05,7360,92,676461,91.89797581850291,9
0.05,7361,90,676551,91.89771801140995,11
0.05,7362,94,676645,91.89800353116937,7
0.05,7363,93,676738,91.89815317762086,8
0.05,7364,93,676831,91.89830278343517,8
0.05,7365,96,676927,91.89885962530546,6
0.05,7366,96,677023,91.8994163160038,6
0.05,7367,95,677118,91.89983713355049,6
0.05,7368,96,677214,91.90039354050754,6
0.05,7369,89,677303,91.9,12
0.05,7370,92,677395,91.90001356668023,9
0.05,7371,93,677488,91.90016277807922,8
0.05,7372,94,677582,91.90044757900448,7
0.05,7373,95,677677,91.90086791429346,6
0.05,7374,92,677769,91.9008813559322,9
0.05,7375,93,677862,91.90103036876356,8
0.05,7376,90,677952,91.90077267181782,11
0.05,7377,93,678045,91.90092165898618,8
0.05,7378,94,678139,91.90120612549126,7
0.05,7379,94,678233,91.90149051490515,7
0.05,7380,96,678329,91.90204579325295,6
0.05,7381,94,678423,91.90232999187212,7
0.05,7382,94,678517,91.902614113504,7
0.05,7383,93,678610,91.90276273022752,8
0.05,7384,93,678703,91.90291130670278,9
0.05,7385,94,678797,91.90319523422691,8
0.05,7386,95,678892,91.90361445783132,6
0.05,7387,93,678985,91.90376285868977,9
0.05,7388,96,679081,91.90431722831235,6
0.05,7389,92,679173,91.9043301759134,9
0.05,7390,93,679266,91.90447841969963,8
0.05,7391,93,679359,91.90462662337663,8
0.05,7392,93,679452,91.90477478696064,8
0.05,7393,95,679547,91.9051934000541,7
0.05,7394,96,679643,91.90574712643678,6
0.05,7395,94,679737,91.90603028664142,7
0.05,7396,91,679828,91.90590780045964,10
0.05,7397,93,679921,91.90605569072723,8
0.05,7398,96,680017,91.90660900121638,6
0.05,7399,89,680106,91.90621621621622,12
0.05,7400,89,680195,91.90582353735982,12
0.05,7401,27,680222,91.89705485004053,6
0.05,7402,95,680317,91.89747399702823,6
0.05,7403,94,680411,91.89775796866559,8
0.05,7404,96,680507,91.8983119513842,6
0.05,7405,94,680601,91.89859573318931,7
0.05,7406,90,680691,91.89833940866748,11
0.05,7407,96,680787,91.89889308855291,6
0.05,7408,94,680881,91.89917667701444,8
0.05,7409,92,680973,91.89919028340081,9
0.05,7410,94,681067,91.89947375522871,7
0.05,7411,89,681156,91.89908256880734,12
0.05,7412,92,681248,91.8990961823823,9
0.05,7413,94,681342,91.89937955219854,7
0.05,7414,94,681436,91.89966284558328,8
0.05,7415,95,681531,91.90008090614887,6
0.05,7416,96,681627,91.9006336793852,6
0.05,7417,94,681721,91.90091668913453,7
0.05,7418,95,681816,91.90133441164578,6
0.05,7419,94,681910,91.90161725067385,7
0.05,7420,91,682001,91.90149575528905,10
0.05,7421,94,682095,91.90177849636217,7
0.05,7422,96,682191,91.90233059409942,6
0.05,7423,96,682287,91.90288254310344,6
0.05,7424,93,682380,91.9030303030303,8
0.05,7425,92,682472,91.90304336116348,9
0.05,7426,94,682566,91.9033257035142,8
0.05,7427,94,682660,91.90360796984383,7
0.05,7428,93,682753,91.90375555256428,8
0.05,7429,94,682847,91.90403768506056,7
0.05,7430,94,682941,91.90431974162293,7
0.05,7431,92,683033,91.90433261571583,9
0.05,7432,92,683125,91.90434548634468,9
0.05,7433,95,683220,91.9047619047619,6
0.05,7434,96,683316,91.90531271015467,6
0.05,7435,94,683410,91.9055944055944,7
0.05,7436,95,683505,91.90601048810004,7
0.05,7437,92,683597,91.90602312449583,11
0.05,7438,92,683689,91.90603575749428,9
0.05,7439,94,683783,91.90631720430108,8
0.05,7440,93,683876,91.90646418492138,8
0.05,7441,95,683971,91.90687987100242,6
0.05,7442,96,684067,91.90742979981191,6
0.05,7443,95,684162,91.90784524449221,6
0.05,7444,95,684257,91.90826057756884,6
0.05,7445,95,684352,91.90867579908675,6
0.05,7446,92,684444,91.90868806230696,9
0.05,7447,96,684540,91.90923737916219,6
0.05,7448,93,684633,91.90938380990737,8
0.05,7449,96,684729,91.90993288590604,6
0.05,7450,92,684821,91.90994497382901,9
0.05,7451,92,684913,91.90995705850779,9
0.05,7452,94,685007,91.91023748825977,7
0.05,7453,94,685101,91.91051784276898,7
0.05,7454,90,685191,91.9102615694165,11
0.05,7455,93,685284,91.91040772532189,8
0.05,7456,95,685379,91.91082204639936,8
0.05,7457,92,685471,91.91083400375436,10
0.05,7458,93,685564,91.91098002413192,8
0.05,7459,96,685660,91.91152815013405,6
0.05,7460,94,685754,91.91180806862351,7
0.05,7461,92,685846,91.91181988742964,9
0.05,7462,94,685940,91.91209969181294,7
0.05,7463,93,686033,91.91224544480171,8
0.05,7464,94,686127,91.91252511721366,7
0.05,7465,93,686220,91.91267077417626,8
0.05,7466,96,686316,91.91321815990358,6
0.05,7467,96,686412,91.91376539903588,6
0.05,7468,96,686508,91.91431249163207,6
0.05,7469,95,686603,91.91472556894243,7
0.05,7470,94,686697,91.91500468478115,8
0.05,7471,93,686790,91.91514989293361,8
0.05,7472,94,686884,91.91542887729159,7
0.05,7473,96,686980,91.91597538132191,6
0.05,7474,94,687074,91.91625418060201,7
0.05,7475,95,687169,91.91666666666667,7
0.05,7476,94,687263,91.91694529891667,7
0.05,7477,92,687355,91.916956405456,9
0.05,7478,91,687446,91.91683380131033,10
0.05,7479,91,687537,91.91671122994653,10
0.05,7480,93,687630,91.9168560352894,8
0.05,7481,95,687725,91.91726811013098,7
0.05,7482,95,687820,91.9176800748363,6
0.05,7483,93,687913,91.91782469267771,9
0.05,7484,94,688007,91.9181028724115,7
0.05,7485,95,688102,91.91851456051296,6
0.05,7486,96,688198,91.91905970348604,6
0.05,7487,94,688292,91.9193376068376,7
0.05,7488,94,688386,91.91961543597276,7
0.05,7489,95,688481,91.9200267022697,7
0.05,7490,91,688572,91.9199038846616,10
0.05,7491,94,688666,91.9201815269621,7
0.05,7492,24,688690,91.91111704257307,8
0.05,7493,95,688785,91.91152922337871,6
0.05,7494,94,688879,91.9118078719146,9
0.05,7495,95,688974,91.91221985058698,6
0.05,7496,94,689068,91.9124983326664,8
0.05,7497,94,689162,91.91277674046412,7
0.05,7498,94,689256,91.91305507400986,7
0.05,7499,92,689348,91.91306666666667,9
0.05,7500,95,689443,91.91347820290628,6
0.05,7501,94,689537,91.91375633164489,7
0.05,7502,94,689631,91.9140343862455,7
0.05,7503,94,689725,91.91431236673775,7
0.05,7504,94,689819,91.91459027315123,7
0.05,7505,96,689915,91.91513455901945,6
0.05,7506,93,690008,91.91527907286533,8
0.05,7507,96,690104,91.9158231220032,6
0.05,7508,95,690199,91.91623385271008,6
0.05,7509,95,690294,91.91664447403463,6
0.05,7510,95,690389,91.9170549860205,6
0.05,7511,96,690485,91.91759850905218,6
0.05,7512,95,690580,91.91800878477306,6
0.05,7513,92,690672,91.9180196965664,9
0.05,7514,94,690766,91.91829673985363,7
0.05,7515,95,690861,91.91870675891431,6
0.05,7516,94,690955,91.91898363708927,7
0.05,7517,93,691048,91.91912742750732,8
0.05,7518,94,691142,91.91940417608724,8
0.05,7519,93,691235,91.91954787234043,9
0.05,7520,94,691329,91.91982449142401,7
0.05,7521,91,691420,91.91970220685988,10
0.05,7522,94,691514,91.91997873188888,7
0.05,7523,94,691608,91.92025518341308,7
0.05,7524,92,691700,91.9202657807309,9
0.05,7525,95,691795,91.92067499335637,8
0.05,7526,93,691888,91.92081838713963,8
0.05,7527,94,691982,91.9210945802338,7
0.05,7528,92,692074,91.92110506043299,9
0.05,7529,96,692170,91.92164674634795,6
0.05,7530,96,692266,91.92218828840791,6
0.05,7531,91,692357,91.92206585236325,10
0.05,7532,91,692448,91.92194344882517,10
0.05,7533,94,692542,91.92221927263074,7
0.05,7534,93,692635,91.92236230922363,8
0.05,7535,93,692728,91.92250530785563,8
0.05,7536,96,692824,91.92304630489585,6
0.05,7537,96,692920,91.92358715839745,6
0.05,7538,93,693013,91.92372993765751,8
0.05,7539,92,693105,91.9237400530504,10
0.05,7540,91,693196,91.92361755735314,10
0.05,7541,93,693289,91.92376027578892,9
0.05,7542,95,693384,91.92416810287683,6
0.05,7543,93,693477,91.9243107104984,8
0.05,7544,94,693571,91.9245858184228,7
0.05,7545,92,693663,91.92459581235092,9
0.05,7546,94,693757,91.92487080959322,8
0.05,7547,89,693846,91.92448330683625,12
0.05,7548,17,693863,91.91455821963174,15
0.05,7549,96,693959,91.91509933774834,6
0.05,7550,94,694053,91.91537544696067,7
0.05,7551,94,694147,91.91565148305085,8
0.05,7552,94,694241,91.91592744604793,7
0.05,7553,89,694330,91.91554143500133,12
0.05,7554,92,694422,91.9155526141628,9
0.05,7555,94,694516,91.9158284806776,7
0.05,7556,96,694612,91.91636892946937,6
0.05,7557,94,694706,91.91664461497751,7
0.05,7558,95,694801,91.91705252017462,6
0.05,7559,92,694893,91.91706349206349,9
0.05,7560,94,694987,91.91733897632588,7
0.05,7561,92,695079,91.9173499074319,9
0.05,7562,93,695172,91.9174930583102,8
0.05,7563,92,695264,91.91750396615548,9
0.05,7564,93,695357,91.91764705882353,8
0.05,7565,92,695449,91.91765794343114,9
0.05,7566,92,695541,91.91766882516188,9
0.05,7567,94,695635,91.91794397463002,7
0.05,7568,93,695728,91.91808693354473,8
0.05,7569,92,695820,91.91809775429326,9
0.05,7570,94,695914,91.91837273807951,7
0.05,7571,93,696007,91.91851558372953,8
0.05,7572,93,696100,91.91865839165456,8
0.05,7573,92,696192,91.91866913123845,9
0.05,7574,92,696284,91.9186798679868,9
0.05,7575,93,696377,91.91882259767688,8
0.05,7576,94,696471,91.91909726804803,7
0.05,7577,92,696563,91.91910794404856,9
0.05,7578,92,696655,91.91911861723183,9
0.05,7579,93,696748,91.91926121372032,8
0.05,7580,94,696842,91.91953568130853,8
0.05,7581,96,696938,91.92007385914008,6
0.05,7582,91,697029,91.91995252538572,10
0.05,7583,94,697123,91.92022679324894,7
0.05,7584,94,697217,91.92050098879368,7
0.05,7585,94,697311,91.92077511204852,7
0.05,7586,96,697407,91.92131277184657,6
0.05,7587,94,697501,91.92158671586716,7
0.05,7588,90,697591,91.92133350902623,11
0.05,7589,96,697687,91.92187088274045,6
0.05,7590,93,697780,91.92201291002503,8
0.05,7591,96,697876,91.92255005268704,6
0.05,7592,94,697970,91.92282365336494,7
0.05,7593,96,698066,91.9233605478009,6
0.05,7594,95,698161,91.92376563528637,6
0.05,7595,93,698254,91.92390731964191,8
0.05,7596,94,698348,91.92418059760432,7
0.05,7597,94,698442,91.92445380363253,7
0.05,7598,92,698534,91.92446374522963,9
0.05,7599,94,698628,91.92473684210526,8
0.05,7600,92,698720,91.9247467438495,9
0.05,7601,95,698815,91.92515127598,8
0.05,7602,95,698910,91.9255557016967,6
0.05,7603,92,699002,91.9255654918464,9
0.05,7604,96,699098,91.92610124917817,6
0.05,7605,92,699190,91.9261109650276,9
0.05,7606,92,699282,91.9261206783226,9
0.05,7607,23,699305,91.91706098843324,9
0.05,7608,95,699400,91.91746615849652,6
0.05,7609,93,699493,91.91760840998685,8
0.05,7610,94,699587,91.9178820128761,7
0.05,7611,96,699683,91.9184182869154,6
0.05,7612,93,699776,91.9185603572836,8
0.05,7613,94,699870,91.91883372734436,7
0.05,7614,95,699965,91.91923834537099,6
0.05,7615,26,699991,91.91058298319328,7
0.05,7616,90,700081,91.91033215176579,12
0.05,7617,83,700164,91.9091625098451,18
0.05,7618,95,700259,91.90956818480116,6
0.05,7619,27,700286,91.9010498687664,6
0.05,7620,26,700312,91.89240257184096,7
0.05,7621,92,700404,91.89241668853319,10
0.05,7622,94,700498,91.89269316542044,7
0.05,7623,95,700593,91.89310073452256,6
0.05,7624,95,700688,91.89350819672131,6
0.05,7625,94,700782,91.89378442171518,7
0.05,7626,96,700878,91.8943228005769,6
0.05,7627,93,700971,91.89446775039329,8
0.05,7628,94,701065,91.89474374098833,7
0.05,7629,95,701160,91.8951507208388,6
0.05,7630,94,701254,91.89542654960032,7
0.05,7631,90,701344,91.895178197065,11
0.05,7632,92,701436,91.89519192977859,9
0.05,7633,96,701532,91.89572963059994,6
0.05,7634,95,701627,91.89613621480026,7
0.05,7635,95,701722,91.89654269250917,6
0.05,7636,94,701816,91.89681812229934,7
0.05,7637,94,701910,91.89709347996858,7
0.05,7638,94,702004,91.89736876554522,7
0.05,7639,94,702098,91.89764397905759,7
0.05,7640,90,702188,91.8973956288444,11
0.05,7641,94,702282,91.89767076681497,7
0.05,7642,95,702377,91.89807667146408,6
0.05,7643,94,702471,91.89835164835165,7
0.05,7644,94,702565,91.89862655330282,8
0.05,7645,90,702655,91.89837823698666,11
0.05,7646,94,702749,91.89865306656205,7
0.05,7647,94,702843,91.89892782426779,7
0.05,7648,96,702939,91.8994639822199,6
0.05,7649,94,703033,91.8997385620915,7
0.05,7650,95,703128,91.90014377205594,6
0.05,7651,94,703222,91.90041819132253,7
0.05,7652,96,703318,91.90095387429766,6
0.05,7653,93,703411,91.90109746537757,8
0.05,7654,93,703504,91.90124101894187,10
0.05,7655,94,703598,91.90151515151516,7
0.05,7656,94,703692,91.90178921248531,7
0.05,7657,95,703787,91.90219378427788,6
0.05,7658,93,703880,91.90233711972843,8
0.05,7659,94,703974,91.90261096605744,8
0.05,7660,94,704068,91.90288474089544,7
0.05,7661,94,704162,91.90315844427043,7
0.05,7662,93,704255,91.90330157901604,8
0.05,7663,93,704348,91.90344467640918,8
0.05,7664,94,704442,91.9037181996086,7
0.05,7665,94,704536,91.90399165144795,7
0.05,7666,95,704631,91.90439546106691,6
0.05,7667,94,704725,91.9046687532603,8
0.05,7668,93,704818,91.90481157908462,8
0.05,7669,25,704843,91.89608865710561,9
0.05,7670,95,704938,91.89649328640334,6
0.05,7671,95,705033,91.89689781021897,6
0.05,7672,94,705127,91.8971719014727,7
0.05,7673,95,705222,91.8975762314308,6
0.05,7674,96,705318,91.89811074918566,6
0.05,7675,93,705411,91.89825429911413,9
0.05,7676,92,705503,91.89826755242933,9
0.05,7677,90,705593,91.8980203177911,11
0.05,7678,95,705688,91.89842427399401,6
0.05,7679,94,705782,91.89869791666666,7
0.05,7680,96,705878,91.89923187085014,6
0.05,7681,94,705972,91.89950533715178,7
0.05,7682,93,706065,91.89964857477548,9
0.05,7683,86,706151,91.89888079125456,15
0.05,7684,94,706245,91.89915419648666,7
0.05,7685,95,706340,91.89955763726256,6
0.05,7686,96,706436,91.90009106283335,6
0.05,7687,96,706532,91.90062434963579,6
0.05,7688,95,706627,91.90102744179997,7
0.05,7689,91,706718,91.90091027308192,10
0.05,7690,93,706811,91.90105317904043,8
0.05,7691,95,706906,91.90145605824233,7
0.05,7692,95,707001,91.90185883270506,7
0.05,7693,96,707097,91.90239147387575,6
0.05,7694,92,707189,91.90240415854451,9
0.05,7695,94,707283,91.90267671517671,7
0.05,7696,96,707379,91.90320904248408,6
0.05,7697,96,707475,91.9037412314887,6
0.05,7698,93,707568,91.90388362124952,8
0.05,7699,94,707662,91.90415584415584,7
0.05,7700,91,707753,91.90403843656668,10
0.05,7701,96,707849,91.90457024149572,6
0.05,7702,95,707944,91.90497208879657,6
0.05,7703,94,708038,91.9052440290758,7
0.05,7704,93,708131,91.90538611291369,9
0.05,7705,89,708220,91.90500908383078,12
0.05,7706,93,708313,91.90515116128195,8
0.05,7707,94,708407,91.9054229372081,7
0.05,7708,93,708500,91.90556492411467,8
0.05,7709,89,708589,91.90518806744488,12
0.05,7710,94,708683,91.90545973284918,7
0.05,7711,93,708776,91.90560165975104,9
0.05,7712,94,708870,91.90587320108907,7
0.05,7713,93,708963,91.90601503759399,8
0.05,7714,90,709053,91.90576798444589,11
0.05,7715,91,709144,91.90565059616381,11
0.05,7716,95,709239,91.90605157444602,7
0.05,7717,92,709331,91.90606374708474,9
0.05,7718,94,709425,91.90633501748931,7
0.05,7719,94,709519,91.90660621761658,7
0.05,7720,92,709611,91.90661831368993,9
0.05,7721,95,709706,91.90701890701891,7
0.05,7722,96,709802,91.90754887996893,6
0.05,7723,92,709894,91.90756084930088,9
0.05,7724,96,709990,91.90809061488673,6
0.05,7725,95,710085,91.9084908102511,6
0.05,7726,93,710178,91.90863206936716,8
0.05,7727,94,710272,91.90890269151139,7
0.05,7728,94,710366,91.90917324362789,7
0.05,7729,95,710461,91.90957309184994,6
0.05,7730,87,710548,91.9089380416505,14
0.05,7731,24,710572,91.90015519917227,10
0.05,7732,94,710666,91.900426742532,7
0.05,7733,94,710760,91.90069821567106,8
0.05,7734,94,710854,91.90096961861667,7
0.05,7735,93,710947,91.90111168562565,8
0.05,7736,94,711041,91.90138296497351,7
0.05,7737,94,711135,91.90165417420522,8
0.05,7738,94,711229,91.90192531334797,7
0.05,7739,93,711322,91.90206718346253,8
0.05,7740,94,711416,91.90233819919906,8
0.05,7741,93,711509,91.9024799793335,8
0.05,7742,95,711604,91.90288002066383,6
0.05,7743,94,711698,91.90315082644628,7
0.05,7744,92,711790,91.9031633311814,9
0.05,7745,95,711885,91.90356312935708,6
0.05,7746,94,711979,91.90383374209371,7
0.05,7747,93,712072,91.90397521941146,8
0.05,7748,92,712164,91.90398761130469,9
0.05,7749,95,712259,91.90438709677419,6
0.05,7750,96,712355,91.90491549477487,6
0.05,7751,93,712448,91.90505675954593,8
0.05,7752,94,712542,91.90532697020508,8
0.05,7753,93,712635,91.90546814547331,9
0.05,7754,92,712727,91.90548033526757,9
0.05,7755,94,712821,91.90575038679732,7
0.05,7756,96,712917,91.90627820033518,6
0.05,7757,94,713011,91.9065480794019,7
0.05,7758,95,713106,91.90694677149118,7
0.05,7759,93,713199,91.90708762886598,8
0.05,7760,95,713294,91.90748614869217,6
0.05,7761,96,713390,91.9080133986086,6
0.05,7762,95,713485,91.90841169650908,6
0.05,7763,94,713579,91.9086810922205,7
0.05,7764,94,713673,91.90895041854475,7
0.05,7765,92,713765,91.90896214267319,9
0.05,7766,94,713859,91.90923136346079,7
0.05,7767,96,713955,91.9097579814624,6
0.05,7768,93,714048,91.9098983138113,9
0.05,7769,93,714141,91.91003861003861,8
0.05,7770,92,714233,91.91005018659118,9
0.05,7771,92,714325,91.9100617601647,9
0.05,7772,96,714421,91.91058793258716,6
0.05,7773,92,714513,91.9105994340108,9
0.05,7774,96,714609,91.91112540192925,6
0.05,7775,90,714699,91.91087962962963,11
0.05,7776,27,714726,91.9025331104539,6
0.05,7777,92,714818,91.9025456415531,9
0.05,7778,92,714910,91.90255816943052,10
0.05,7779,94,715004,91.90282776349615,7
0.05,7780,94,715098,91.9030972882663,7
0.05,7781,95,715193,91.9034952454382,6
0.05,7782,90,715283,91.9032506745471,11
0.05,7783,93,715376,91.90339157245631,8
0.05,7784,94,715470,91.90366088631984,7
0.05,7785,95,715565,91.90405856665811,6
0.05,7786,95,715660,91.90445614485681,6
0.05,7787,94,715754,91.90472521828454,7
0.05,7788,95,715849,91.90512260880729,7
0.05,7789,94,715943,91.90539152759949,7
0.05,7790,95,716038,91.90578873058658,6
0.05,7791,95,716133,91.90618583162218,6
0.05,7792,95,716228,91.90658283074553,6
0.05,7793,95,716323,91.90697972799589,6
0.05,7794,94,716417,91.90724823604874,7
0.05,7795,94,716511,91.90751667521806,7
0.05,7796,95,716606,91.90791329998717,6
0.05,7797,94,716700,91.9081815850218,7
0.05,7798,95,716795,91.90857802282343,6
0.05,7799,93,716888,91.90871794871795,8
0.05,7800,92,716980,91.90872965004486,9
0.05,7801,95,717075,91.90912586516278,7
0.05,7802,92,717167,91.90913751121363,9
0.05,7803,94,717261,91.90940543311123,7
0.05,7804,96,717357,91.90992953235106,6
0.05,7805,96,717453,91.91045349730976,6
0.05,7806,92,717545,91.910464967337,9
0.05,7807,95,717640,91.91086065573771,6
0.05,7808,95,717735,91.91125624279677,7
0.05,7809,94,717829,91.91152368758003,7
0.05,7810,95,717924,91.91191908846498,6
0.05,7811,96,718020,91.91244239631337,6
0.05,7812,95,718115,91.91283757839498,6
0.05,7813,94,718209,91.91310468390068,7
0.05,7814,92,718301,91.91311580294305,9
0.05,7815,96,718397,91.91363868986694,6
0.05,7816,94,718491,91.91390559037994,7
0.05,7817,95,718586,91.91430033256587,6
0.05,7818,96,718682,91.91482286737434,6
0.05,7819,93,718775,91.91496163682865,8
0.05,7820,94,718869,91.91522823168393,7
0.05,7821,94,718963,91.91549475837381,7
0.05,7822,95,719058,91.91588904512335,6
0.05,7823,94,719152,91.9161554192229,7
0.05,7824,94,719246,91.91642172523962,7
0.05,7825,95,719341,91.91681574239713,8
0.05,7826,94,719435,91.91708189600102,7
0.05,7827,94,719529,91.9173479816045,8
0.05,7828,92,719621,91.91735853876612,9
0.05,7829,94,719715,91.9176245210728,7
0.05,7830,96,719811,91.91814583067297,6
0.05,7831,96,719907,91.91866700715015,6
0.05,7832,96,720003,91.91918805055535,6
0.05,7833,94,720097,91.919453663518,7
0.05,7834,94,720191,91.919719208679,7
0.05,7835,95,720286,91.920112302195,7
0.05,7836,94,720380,91.92037769554676,7
0.05,7837,96,720476,91.92089818831334,6
0.05,7838,91,720567,91.92078071182549,10
0.05,7839,93,720660,91.92091836734694,8
0.05,7840,96,720756,91.92143859201633,6
0.05,7841,93,720849,91.92157612853863,8
0.05,7842,96,720945,91.9220961366824,6
0.05,7843,89,721034,91.92172361040285,13
0.05,7844,21,721055,91.91268323773104,11
0.05,7845,95,721150,91.91307672699465,6
0.05,7846,94,721244,91.91334267873073,7
0.05,7847,93,721337,91.91348114169215,8
0.05,7848,93,721430,91.91361956937189,8
0.05,7849,21,721451,91.90458598726114,12
0.05,7850,92,721543,91.90459814036429,9
0.05,7851,95,721638,91.90499235863474,6
0.05,7852,88,721726,91.904495097415,13
0.05,7853,94,721820,91.9047619047619,7
0.05,7854,96,721916,91.90528325907066,6
0.05,7855,95,722011,91.90567718940937,7
0.05,7856,92,722103,91.905689194349,9
0.05,7857,95,722198,91.90608297276661,8
0.05,7858,25,722223,91.89756966535182,8
0.05,7859,95,722318,91.89796437659034,6
0.05,7860,87,722405,91.89734130517746,14
0.05,7861,96,722501,91.89786313915035,6
0.05,7862,93,722594,91.89800330662597,8
0.05,7863,92,722686,91.89801627670397,9
0.05,7864,95,722781,91.89841068022886,6
0.05,7865,96,722877,91.89893211289092,6
0.05,7866,95,722972,91.89932629973306,6
0.05,7867,95,723067,91.8997203863752,6
0.05,7868,93,723160,91.89986021095437,8
0.05,7869,95,723255,91.9002541296061,7
0.05,7870,95,723350,91.90064794816415,6
0.05,7871,94,723444,91.90091463414635,7
0.05,7872,92,723536,91.90092721961133,9
0.05,7873,94,723630,91.90119380238761,7
0.05,7874,92,723722,91.90120634920635,9
0.05,7875,94,723816,91.90147282884713,7
0.05,7876,92,723908,91.90148533705725,9
0.05,7877,94,724002,91.9017517136329,7
0.05,7878,96,724098,91.90227186191142,6
0.05,7879,94,724192,91.90253807106599,7
0.05,7880,93,724285,91.90267732521254,8
0.05,7881,94,724379,91.90294341537681,7
0.05,7882,93,724472,91.90308258277305,8
0.05,7883,96,724568,91.90360223236935,6
0.05,7884,89,724657,91.90323398858592,12
0.05,7885,93,724750,91.90337306619325,8
0.05,7886,95,724845,91.90376569037657,6
0.05,7887,93,724938,91.9039046653144,8
0.05,7888,95,725033,91.90429712257574,6
0.05,7889,94,725127,91.90456273764259,7
0.05,7890,94,725221,91.90482828538842,7
0.05,7891,94,725315,91.90509376583883,7
0.05,7892,93,725408,91.90523248447992,8
0.05,7893,95,725503,91.90562452495567,6
0.05,7894,93,725596,91.90576314122863,8
0.05,7895,91,725687,91.9056484295846,10
0.05,7896,94,725781,91.90591363809041,7
0.05,7897,94,725875,91.90617877943784,7
0.05,7898,92,725967,91.9061906570452,10
0.05,7899,88,726055,91.90569620253164,13
0.05,7900,95,726150,91.90608783698266,6
0.05,7901,95,726245,91.90647937231081,6
0.05,7902,92,726337,91.90649120587119,9
0.05,7903,93,726430,91.90662955465586,8
0.05,7904,94,726524,91.90689437065149,7
0.05,7905,93,726617,91.90703263344295,8
0.05,7906,93,726710,91.90717086126217,8
0.05,7907,95,726805,91.90756196256955,6
0.05,7908,27,726832,91.8993551650019,6
0.05,7909,92,726924,91.89936788874842,9
0.05,7910,95,727019,91.89975982808747,7
0.05,7911,95,727114,91.90015166835187,6
0.05,7912,94,727208,91.90041703525844,7
0.05,7913,95,727303,91.90080869345464,6
0.05,7914,92,727395,91.90082122552116,9
0.05,7915,93,727488,91.90096008084892,8
0.05,7916,93,727581,91.9010989010989,8
0.05,7917,94,727675,91.90136398080324,8
0.05,7918,90,727765,91.90112387927769,12
0.05,7919,91,727856,91.9010101010101,10
0.05,7920,93,727949,91.90114884484282,8
0.05,7921,95,728044,91.90154001514769,8
0.05,7922,95,728139,91.90193108670958,6
0.05,7923,93,728232,91.90206966178698,8
0.05,7924,95,728327,91.90246056782334,8
0.05,7925,95,728422,91.90285137522079,6
0.05,7926,96,728518,91.9033682351457,6
0.05,7927,94,728612,91.90363269424823,7
0.05,7928,94,728706,91.90389708664397,8
0.05,7929,94,728800,91.90416141235814,7
0.05,7930,95,728895,91.90455175892069,8
0.05,7931,93,728988,91.90468986384266,8
0.05,7932,93,729081,91.9048279339468,8
0.05,7933,94,729175,91.90509200907486,7
0.05,7934,93,729268,91.9052299936988,8
0.05,7935,94,729362,91.9054939516129,7
0.05,7936,92,729454,91.90550585863676,9
0.05,7937,95,729549,91.90589569160997,7
0.05,7938,96,729645,91.90641138682453,6
0.05,7939,27,729672,91.89823677581865,6
0.05,7940,94,729766,91.89850144818033,7
0.05,7941,90,729856,91.89826240241753,11
0.05,7942,95,729951,91.89865290192623,6
0.05,7943,93,730044,91.8987915407855,8
0.05,7944,90,730134,91.89855254877281,11
0.05,7945,94,730228,91.89881701485024,7
0.05,7946,96,730324,91.89933308166604,6
0.05,7947,93,730417,91.89947156517363,8
0.05,7948,93,730510,91.89961001383821,8
0.05,7949,95,730605,91.9,6
0.05,7950,94,730699,91.90026411772104,7
0.05,7951,93,730792,91.90040241448692,8
0.05,7952,93,730885,91.9005406764743,8
0.05,7953,91,730976,91.90042745788283,10
0.05,7954,95,731071,91.90081709616594,6
0.05,7955,92,731163,91.90082956259427,10
0.05,7956,95,731258,91.90121905240669,6
0.05,7957,92,731350,91.90123146519225,9
0.05,7958,93,731443,91.90136951878377,8
0.05,7959,93,731536,91.90150753768845,8
0.05,7960,92,731628,91.9015199095591,9
0.05,7961,91,731719,91.90140668173825,11
0.05,7962,93,731812,91.9015446439784,9
0.05,7963,94,731906,91.90180813661476,8
0.05,7964,93,731999,91.90194601381042,8
0.05,7965,96,732095,91.90246045694201,6
0.05,7966,94,732189,91.90272373540856,7
0.05,7967,94,732283,91.90298694779116,7
0.05,7968,96,732379,91.9035010666332,6
0.05,7969,92,732471,91.90351317440401,9
0.05,7970,94,732565,91.90377618868398,7
0.05,7971,94,732659,91.90403913697943,7
0.05,7972,92,732751,91.9040511727079,9
0.05,7973,96,732847,91.90456483571607,6
0.05,7974,94,732941,91.90482758620689,7
0.05,7975,94,733035,91.90509027081244,8
0.05,7976,93,733128,91.9052275291463,8
0.05,7977,94,733222,91.90549009776886,7
0.05,7978,94,733316,91.90575260057652,7
0.05,7979,92,733408,91.90576441102758,9
0.05,7980,95,733503,91.90615211126425,8
0.05,7981,94,733597,91.90641443247307,7
0.05,7982,95,733692,91.90680195415257,6
0.05,7983,93,733785,91.90693887775551,8
0.05,7984,88,733873,91.90644959298685,14
0.05,7985,92,733965,91.90646130728776,9
0.05,7986,89,734054,91.90609740828847,13
0.05,7987,94,734148,91.90635953930897,8
0.05,7988,92,734240,91.90637126048317,9
0.05,7989,96,734336,91.90688360450564,6
0.05,7990,96,734432,91.90739582029784,6
0.05,7991,94,734526,91.90765765765765,7
0.05,7992,93,734619,91.90779432003002,8
0.05,7993,92,734711,91.90780585439079,9
0.05,7994,94,734805,91.90806754221389,8
0.05,7995,96,734901,91.90857928964482,6
0.05,7996,92,734993,91.90859072152057,9
0.05,7997,96,735089,91.9091022755689,6
0.05,7998,96,735185,91.90961370171271,6
0.05,7999,91,735276,91.9095,10
0.05,8000,91,735367,91.90938632670917,10
0.05,8001,95,735462,91.90977255686079,7
0.05,8002,95,735557,91.91015869049106,6
0.05,8003,92,735649,91.91016991504247,9
0.05,8004,95,735744,91.9105559025609,6
0.05,8005,90,735834,91.91031726205345,11
0.05,8006,93,735927,91.91045335331584,8
0.05,8007,96,736023,91.91096403596404,6
0.05,8008,27,736050,91.90285928330628,6
0.05,8009,27,736077,91.89475655430712,6
0.05,8010,94,736171,91.89501934839596,7
0.05,8011,96,736267,91.89553170244633,6
0.05,8012,96,736363,91.896043928616,7
0.05,8013,93,736456,91.89618168205641,8
0.05,8014,95,736551,91.89656893325015,6
0.05,8015,92,736643,91.89658183632734,10
0.05,8016,94,736737,91.89684420606211,8
0.05,8017,92,736829,91.89685707158893,10
0.05,8018,94,736923,91.89711934156378,7
0.05,8019,93,737016,91.89725685785537,9
0.05,8020,94,737110,91.89751901259194,7
0.05,8021,95,737205,91.8979057591623,6
0.05,8022,95,737300,91.89829240932319,6
0.05,8023,92,737392,91.89830508474576,9
0.05,8024,96,737488,91.89881619937695,6
0.05,8025,94,737582,91.89907799651134,8
0.05,8026,27,737609,91.89099289896599,6
0.05,8027,90,737699,91.89075734927754,11
0.05,8028,91,737790,91.89064640677545,10
0.05,8029,92,737882,91.8906600249066,9
0.05,8030,92,737974,91.89067363964637,9
0.05,8031,95,738069,91.89106075697211,6
0.05,8032,93,738162,91.89119880492966,8
0.05,8033,93,738255,91.89133681852128,8
0.05,8034,88,738343,91.89085252022402,13
0.05,8035,25,738368,91.88252862120459,8
0.05,8036,94,738462,91.88279208659948,7
0.05,8037,94,738556,91.88305548643942,7
0.05,8038,94,738650,91.88331882074885,7
0.05,8039,94,738744,91.88358208955223,8
0.05,8040,95,738839,91.88396965551549,6
0.05,8041,95,738934,91.88435712509326,6
0.05,8042,92,739026,91.88437150317046,9
0.05,8043,91,739117,91.88426156141223,10
0.05,8044,94,739211,91.88452454940958,7
0.05,8045,95,739306,91.88491175739497,6
0.05,8046,95,739401,91.88529886914378,7
0.05,8047,90,739491,91.88506461232605,11
0.05,8048,93,739584,91.88520313082371,8
0.05,8049,96,739680,91.88571428571429,6
0.05,8050,94,739774,91.88597689727985,7
0.05,8051,95,739869,91.88636363636364,7
0.05,8052,95,739964,91.88675027939898,6
0.05,8053,95,740059,91.88713682642165,7
0.05,8054,96,740155,91.88764742396027,6
0.05,8055,92,740247,91.88766137040714,9
0.05,8056,94,740341,91.8879235447437,8
0.05,8057,95,740436,91.88830975428147,6
0.05,8058,93,740529,91.88844769822559,8
0.05,8059,92,740621,91.88846153846154,9
0.05,8060,95,740716,91.88884753752636,6
0.05,8061,94,740810,91.88910940213347,7
0.05,8062,92,740902,91.88912315515317,9
0.05,8063,96,740998,91.88963293650794,6
0.05,8064,94,741092,91.88989460632362,7
0.05,8065,94,741186,91.89015621125714,7
0.05,8066,94,741280,91.89041775133259,7
0.05,8067,80,741360,91.88894397620228,21
0.05,8068,85,741445,91.88809022183666,16
0.05,8069,96,741541,91.88859975216853,6
0.05,8070,91,741632,91.88848965431792,10
0.05,8071,95,741727,91.88887512388503,6
0.05,8072,95,741822,91.88926049795614,6
0.05,8073,94,741916,91.88952192221947,7
0.05,8074,91,742007,91.88941176470588,10
0.05,8075,94,742101,91.88967310549778,7
0.05,8076,92,742193,91.88968676488795,9
0.05,8077,96,742289,91.89019559296855,6
0.05,8078,95,742384,91.89058051739076,8
0.05,8079,96,742480,91.89108910891089,6
0.05,8080,95,742575,91.8914738274966,6
0.05,8081,93,742668,91.89161098737937,8
0.05,8082,96,742764,91.89211926265001,7
0.05,8083,95,742859,91.89250371103414,6
0.05,8084,94,742953,91.89276437847866,8
0.05,8085,92,743045,91.89277764036606,9
0.05,8086,93,743138,91.89291455422283,8
0.05,8087,94,743232,91.89317507418397,7
0.05,8088,94,743326,91.89343552973173,7
0.05,8089,94,743420,91.89369592088998,7
0.05,8090,94,743514,91.89395624768261,7
0.05,8091,96,743610,91.89446366782006,6
0.05,8092,94,743704,91.89472383541332,7
0.05,8093,96,743800,91.89523103533482,6
0.05,8094,92,743892,91.89524397776405,9
0.05,8095,93,743985,91.89538043478261,8
0.05,8096,96,744081,91.895887365691,6
0.05,8097,94,744175,91.89614719683873,7
0.05,8098,91,744266,91.89603654772193,11
0.05,8099,95,744361,91.89641975308642,6
0.05,8100,94,744455,91.89667942229354,7
0.05,8101,94,744549,91.89693902740065,7
0.05,8102,94,744643,91.89719856843145,7
0.05,8103,92,744735,91.89721125370187,9
0.05,8104,94,744829,91.89747069710056,7
0.05,8105,94,744923,91.89773007648655,7
0.05,8106,94,745017,91.89798939188356,7
0.05,8107,93,745110,91.89812530833744,8
0.05,8108,95,745205,91.89850783080527,7
0.05,8109,95,745300,91.89889025893959,6
0.05,8110,95,745395,91.89927259277525,6
0.05,8111,94,745489,91.8995315581854,8
0.05,8112,93,745582,91.89966720078885,8
0.05,8113,92,745674,91.8996795661819,9
0.05,8114,93,745767,91.89981515711645,8
0.05,8115,93,745860,91.89995071463775,8
0.05,8116,94,745954,91.90020943698411,7
0.05,8117,94,746048,91.90046809559004,7
0.05,8118,93,746141,91.9006035226013,8
0.05,8119,92,746233,91.9006157635468,9
0.05,8120,95,746328,91.90099741411156,6
0.05,8121,94,746422,91.90125584831323,7
0.05,8122,96,746518,91.90176043333744,6
0.05,8123,93,746611,91.90189561792221,8
0.05,8124,94,746705,91.90215384615385,7
0.05,8125,93,746798,91.90228894905242,8
0.05,8126,94,746892,91.90254706533776,8
0.05,8127,94,746986,91.90280511811024,7
0.05,8128,95,747081,91.90318612375447,6
0.05,8129,94,747175,91.90344403444034,7
0.05,8130,96,747271,91.9039478538925,6
0.05,8131,95,747366,91.90432857845549,6
0.05,8132,96,747462,91.90483216525267,6
0.05,8133,96,747558,91.90533562822719,6
0.05,8134,93,747651,91.90547019053473,8
0.05,8135,95,747746,91.9058505408063,6
0.05,8136,92,747838,91.90586211134325,9
0.05,8137,94,747932,91.90611943966577,7
0.05,8138,96,748028,91.9066224351886,6
0.05,8139,94,748122,91.90687960687961,7
0.05,8140,22,748144,91.89829259304754,10
0.05,8141,94,748238,91.89855072463769,7
0.05,8142,95,748333,91.89893159769127,6
0.05,8143,91,748424,91.89882121807466,10
0.05,8144,95,748519,91.89920196439533,6
0.05,8145,94,748613,91.89945985759883,9
0.05,8146,93,748706,91.89959494292377,8
0.05,8147,27,748733,91.89162984781541,6
0.05,8148,95,748828,91.8920112897288,6
0.05,8149,93,748921,91.8921472392638,8
0.05,8150,95,749016,91.89252852410748,7
0.05,8151,94,749110,91.89278704612364,7
0.05,8152,92,749202,91.89280019624678,9
0.05,8153,93,749295,91.89293598233995,8
0.05,8154,94,749389,91.89319435928878,7
0.05,8155,92,749481,91.89320745463462,9
0.05,8156,96,749577,91.89371092313351,6
0.05,8157,94,749671,91.893969110076,8
0.05,8158,96,749767,91.89447236180905,6
0.05,8159,91,749858,91.89436274509804,10
0.05,8160,96,749954,91.8948658252665,6
0.05,8161,94,750048,91.89512374418035,7
0.05,8162,27,750075,91.88717383314957,6
0.05,8163,96,750171,91.88767760901518,6
0.05,8164,94,750265,91.88793631353337,7
0.05,8165,95,750360,91.88831741366643,7
0.05,8166,95,750455,91.88869842047264,6
0.05,8167,92,750547,91.88871204701273,9
0.05,8168,94,750641,91.88897049822499,7
0.05,8169,95,750736,91.88935128518972,6
0.05,8170,92,750828,91.88936482682658,9
0.05,8171,94,750922,91.88962310327949,8
0.05,8172,95,751017,91.89000367062279,6
0.05,8173,96,751113,91.89050648397358,6
0.05,8174,95,751208,91.89088685015291,6
0.05,8175,91,751299,91.89077788649706,10
0.05,8176,93,751392,91.89091353797237,8
0.05,8177,94,751486,91.89117143555882,8
0.05,8178,94,751580,91.89142927008191,7
0.05,8179,92,751672,91.89144254278729,9
0.05,8180,94,751766,91.89170028113922,7
0.05,8181,91,751857,91.89159129797116,11
0.05,8182,21,751878,91.88292802150801,12
0.05,8183,93,751971,91.88306451612904,8
0.05,8184,94,752065,91.88332315210751,7
0.05,8185,96,752161,91.88382604446616,6
0.05,8186,94,752255,91.88408452424575,7
0.05,8187,91,752346,91.88397655105032,10
0.05,8188,93,752439,91.8841128342899,8
0.05,8189,94,752533,91.88437118437119,7
0.05,8190,93,752626,91.88450738615553,8
0.05,8191,94,752720,91.884765625,7
0.05,8192,94,752814,91.88502380080557,7
0.05,8193,92,752906,91.88503783256041,10
0.05,8194,95,753001,91.88541793776693,6
0.05,8195,95,753096,91.88579795021963,6
0.05,8196,95,753191,91.88617786995242,6
0.05,8197,94,753285,91.8864357160283,7
0.05,8198,94,753379,91.88669349920723,7
0.05,8199,94,753473,91.8869512195122,8
0.05,8200,92,753565,91.88696500426778,9
0.05,8201,96,753661,91.88746647159229,6
0.05,8202,92,753753,91.88748019017433,9
0.05,8203,91,753844,91.88737201365188,10
0.05,8204,93,753937,91.88750761730653,8
0.05,8205,95,754032,91.8878869120156,6
0.05,8206,93,754125,91.88802241988546,8
0.05,8207,94,754219,91.88827972709552,7
0.05,8208,96,754315,91.88878060665124,6
0.05,8209,96,754411,91.88928136419001,6
0.05,8210,95,754506,91.88966021191085,6
0.05,8211,94,754600,91.88991719434974,7
0.05,8212,92,754692,91.8899305978327,9
0.05,8213,94,754786,91.89018748478207,8
0.05,8214,85,754871,91.88934875228242,16
0.05,8215,93,754964,91.88948393378773,9
0.05,8216,91,755055,91.88937568455641,10
0.05,8217,95,755150,91.88975419810173,6
0.05,8218,95,755245,91.8901326195401,6
0.05,8219,91,755336,91.89002433090025,10
0.05,8220,96,755432,91.89052426712078,6
0.05,8221,89,755521,91.89017270737047,14
0.05,8222,93,755614,91.89030767359844,8
0.05,8223,95,755709,91.89068579766537,8
0.05,8224,92,755801,91.8906990881459,10
0.05,8225,95,755896,91.89107707269633,8
0.05,8226,96,755992,91.89157651634861,6
0.05,8227,95,756087,91.8919543023821,6
0.05,8228,96,756183,91.89245351804594,6
0.05,8229,95,756278,91.89283110571081,6
0.05,8230,92,756370,91.89284412586564,9
0.05,8231,96,756466,91.89334305150632,6
0.05,8232,92,756558,91.89335600631604,9
0.05,8233,90,756648,91.893126062667,11
0.05,8234,95,756743,91.89350333940497,6
0.05,8235,95,756838,91.89388052452647,6
0.05,8236,96,756934,91.8943790214884,6
0.05,8237,91,757025,91.89427045399368,10
0.05,8238,96,757121,91.89476878261925,7
0.05,8239,93,757214,91.89490291262136,8
0.05,8240,94,757308,91.89515835456862,8
0.05,8241,95,757403,91.89553506430478,7
0.05,8242,93,757496,91.89566905252941,8
0.05,8243,95,757591,91.89604560892771,7
0.05,8244,91,757682,91.89593693147361,10
0.05,8245,91,757773,91.89582828037837,10
0.05,8246,95,757868,91.89620468048987,6
0.05,8247,95,757963,91.89658098933074,6
0.05,8248,92,758055,91.89659352648806,9
0.05,8249,94,758149,91.89684848484849,7
0.05,8250,95,758244,91.89722457883893,7
0.05,8251,91,758335,91.89711585070286,10
0.05,8252,94,758429,91.89737065309585,7
0.05,8253,94,758523,91.89762539374848,8
0.05,8254,92,758615,91.89763779527559,9
0.05,8255,94,758709,91.89789244186046,7
0.05,8256,92,758801,91.89790480804166,9
0.05,8257,95,758896,91.89828045531605,7
0.05,8258,26,758922,91.89030148928441,6
0.05,8259,94,759016,91.8905569007264,7
0.05,8260,94,759110,91.89081225033289,7
0.05,8261,90,759200,91.89058339385137,11
0.05,8262,95,759295,91.89095969986688,6
0.05,8263,94,759389,91.89121490803485,7
0.05,8264,96,759485,91.89171203871749,6
0.05,8265,26,759511,91.88374062424388,7
0.05,8266,94,759605,91.8839966130398,7
0.05,8267,94,759699,91.88425253991292,7
0.05,8268,96,759795,91.88475027210062,6
0.05,8269,94,759889,91.88500604594921,10
0.05,8270,90,759979,91.88477814049087,11
0.05,8271,27,760006,91.87693423597679,6
0.05,8272,94,760100,91.87719086183972,7
0.05,8273,94,760194,91.87744742567078,7
0.05,8274,92,760286,91.87746223564955,9
0.05,8275,94,760380,91.87771870468825,7
0.05,8276,94,760474,91.87797511175546,8
0.05,8277,96,760570,91.87847306112587,6
0.05,8278,94,760664,91.87872931513468,7
0.05,8279,92,760756,91.87874396135265,9
0.05,8280,90,760846,91.8785170873083,11
0.05,8281,94,760940,91.87877324317797,7
0.05,8282,94,761034,91.87902933719667,8
0.05,8283,94,761128,91.87928536938676,7
0.05,8284,94,761222,91.87954133977067,7
0.05,8285,93,761315,91.87967656287714,8
0.05,8286,25,761340,91.87160613008326,8
0.05,8287,93,761433,91.87174227799228,8
0.05,8288,93,761526,91.87187839305103,8
0.05,8289,94,761620,91.87213510253318,7
0.05,8290,94,761714,91.87239175009046,7
0.05,8291,94,761808,91.8726483357453,7
0.05,8292,93,761901,91.87278427589533,8
0.05,8293,94,761995,91.8730407523511,7
0.05,8294,95,762090,91.87341772151899,6
0.05,8295,96,762186,91.87391513982642,6
0.05,8296,95,762281,91.87429191273955,6
0.05,8297,89,762370,91.87394552904314,12
0.05,8298,94,762464,91.87420171104952,7
0.05,8299,94,762558,91.8744578313253,7
0.05,8300,94,762652,91.87471388989279,7
0.05,8301,94,762746,91.87496988677427,7
0.05,8302,93,762839,91.87510538359629,8
0.05,8303,94,762933,91.8753612716763,7
0.05,8304,96,763029,91.87585791691752,6
0.05,8305,94,763123,91.87611365278113,8
0.05,8306,95,763218,91.87648970747563,6
0.05,8307,92,763310,91.87650457390467,9
0.05,8308,93,763403,91.87663978818149,8
0.05,8309,94,763497,91.87689530685921,8
0.05,8310,94,763591,91.87715076404764,7
0.05,8311,94,763685,91.87740615976901,7
0.05,8312,94,763779,91.87766149404547,7
0.05,8313,95,763874,91.8780370459466,6
0.05,8314,94,763968,91.87829224293445,7
0.05,8315,94,764062,91.87854737854738,7
0.05,8316,96,764158,91.8790429241313,6
0.05,8317,93,764251,91.87917768694398,9
0.05,8318,91,764342,91.87907200384662,10
0.05,8319,93,764435,91.87920673076923,9
0.05,8320,95,764530,91.87958178103594,8
0.05,8321,95,764625,91.87995674116799,7
0.05,8322,94,764719,91.88021146221314,8
0.05,8323,94,764813,91.8804661220567,7
0.05,8324,95,764908,91.88084084084085,8
0.05,8325,92,765000,91.88085515253422,9
0.05,8326,94,765094,91.88110964332893,7
0.05,8327,92,765186,91.88112391930835,9
0.05,8328,94,765280,91.88137831672469,7
0.05,8329,96,765376,91.88187274909964,6
0.05,8330,92,765468,91.88188692833994,9
0.05,8331,92,765560,91.88190110417666,9
0.05,8332,92,765652,91.88191527661107,10
0.05,8333,93,765745,91.88204943604512,8
0.05,8334,95,765840,91.88242351529694,6
0.05,8335,94,765934,91.88267754318618,7
0.05,8336,96,766030,91.88317140458199,6
0.05,8337,95,766125,91.88354521467978,6
0.05,8338,94,766219,91.88379901666866,7
0.05,8339,93,766312,91.88393285371703,8
0.05,8340,94,766406,91.8841865483755,7
0.05,8341,93,766499,91.88432030688084,8
0.05,8342,92,766591,91.88433417236006,9
0.05,8343,95,766686,91.88470757430488,8
0.05,8344,21,766707,91.87621330137807,13
0.05,8345,93,766800,91.87634795111431,8
0.05,8346,94,766894,91.87660237210974,8
0.05,8347,94,766988,91.87685673215141,7
0.05,8348,94,767082,91.87711103126122,7
0.05,8349,94,767176,91.87736526946108,8
0.05,8350,92,767268,91.87737995449646,9
0.05,8351,26,767294,91.86949233716476,8
0.05,8352,95,767389,91.86986711361187,6
0.05,8353,94,767483,91.87012209719894,7
0.05,8354,90,767573,91.86989826451227,11
0.05,8355,92,767665,91.86991383437051,9
0.05,8356,93,767758,91.87004906066771,8
0.05,8357,94,767852,91.87030390045466,8
0.05,8358,94,767946,91.87055867926786,7
0.05,8359,94,768040,91.87081339712918,8
0.05,8360,91,768131,91.87070924530559,10
0.05,8361,94,768225,91.87096388423822,8
0.05,8362,95,768320,91.87133803658973,6
0.05,8363,92,768412,91.87135341941655,9
0.05,8364,96,768508,91.87184698147041,6
0.05,8365,93,768601,91.87198183122162,8
0.05,8366,94,768695,91.8722361658898,7
0.05,8367,94,768789,91.87249043977056,7
0.05,8368,96,768885,91.87298363006333,6
0.05,8369,94,768979,91.87323775388292,7
0.05,8370,95,769074,91.87361127702783,6
0.05,8371,94,769168,91.87386526516961,7
0.05,8372,95,769263,91.87423862414904,6
0.05,8373,93,769356,91.87437305946979,8
0.05,8374,94,769450,91.87462686567164,7
0.05,8375,91,769541,91.87452244508118,10
0.05,8376,95,769636,91.87489554733197,6
0.05,8377,95,769731,91.87526856051564,6
0.05,8378,94,769825,91.87552213868004,7
0.05,8379,96,769921,91.87601431980907,6
0.05,8380,94,770015,91.8762677484787,8
0.05,8381,95,770110,91.8766404199475,7
0.05,8382,94,770204,91.87689371346774,7
0.05,8383,95,770299,91.87726622137404,6
0.05,8384,92,770391,91.8772808586762,9
0.05,8385,94,770485,91.87753398521345,7
0.05,8386,94,770579,91.87778705138905,7
0.05,8387,95,770674,91.87815927515499,6
0.05,8388,92,770766,91.87817379902253,9
0.05,8389,95,770861,91.87854588796186,6
0.05,8390,92,770953,91.87856036229293,9
0.05,8391,95,771048,91.8789323164919,6
0.05,8392,95,771143,91.87930418205647,9
0.05,8393,92,771235,91.87931856087681,9
0.05,8394,94,771329,91.87957117331744,7
0.05,8395,93,771422,91.87970462124821,8
0.05,8396,95,771517,91.8800762176968,6
0.05,8397,95,771612,91.88044772564896,7
0.05,8398,93,771705,91.88058102155019,8
0.05,8399,94,771799,91.88083333333333,7
0.05,8400,94,771893,91.8810855850494,8
0.05,8401,91,771984,91.88098071887646,10
0.05,8402,94,772078,91.8812328930144,9
0.05,8403,93,772171,91.88136601618277,8
0.05,8404,95,772266,91.88173706127306,6
0.05,8405,95,772361,91.88210801808232,6
0.05,8406,96,772457,91.88259783513739,6
0.05,8407,92,772549,91.88261179828734,9
0.05,8408,96,772645,91.88310143893447,6
0.05,8409,94,772739,91.8833531510107,7
0.05,8410,92,772831,91.88336701937938,9
0.05,8411,94,772925,91.88361864003804,7
0.05,8412,92,773017,91.88363247355284,9
0.05,8413,94,773111,91.88388400285238,7
0.05,8414,92,773203,91.88389780154486,9
0.05,8415,94,773297,91.88414923954373,7
0.05,8416,91,773388,91.88404419626946,10
0.05,8417,92,773480,91.8840579710145,9
0.05,8418,94,773574,91.88430930039198,7
0.05,8419,96,773670,91.88479809976248,6
0.05,8420,95,773765,91.8851680323002,6
0.05,8421,95,773860,91.88553787698883,7
0.05,8422,27,773887,91.8778345007717,6
0.05,8423,91,773978,91.87773029439695,10
0.05,8424,93,774071,91.87786350148367,8
0.05,8425,96,774167,91.8783527177783,6
0.05,8426,92,774259,91.87836715319806,9
0.05,8427,22,774281,91.87007593735169,10
0.05,8428,95,774376,91.87044726539328,6
0.05,8429,93,774469,91.870581257414,8
0.05,8430,95,774564,91.87095243743329,6
0.05,8431,93,774657,91.87108633776091,10
0.05,8432,87,774744,91.87050871575951,14
0.05,8433,91,774835,91.87040550154138,10
0.05,8434,89,774924,91.87006520450504,14
0.05,8435,94,775018,91.87031768610716,7
0.05,8436,95,775113,91.8706886334005,6
0.05,8437,92,775205,91.87070395828395,9
0.05,8438,94,775299,91.8709562744401,7
0.05,8439,92,775391,91.87097156398104,9
0.05,8440,95,775486,91.8713422580263,6
0.05,8441,94,775580,91.87159440890784,8
0.05,8442,93,775673,91.8717280587469,8
0.05,8443,95,775768,91.87209853150166,6
0.05,8444,94,775862,91.87235050325637,7
0.05,8445,94,775956,91.87260241534455,7
0.05,8446,96,776052,91.87309103823843,6
0.05,8447,94,776146,91.8733428030303,9
0.05,8448,94,776240,91.87359450822582,7
0.05,8449,94,776334,91.87384615384616,7
0.05,8450,94,776428,91.87409773991244,8
0.05,8451,90,776518,91.87387600567912,11
0.05,8452,94,776612,91.87412752868804,8
0.05,8453,94,776706,91.87437899219304,9
0.05,8454,82,776788,91.87321111768185,19
0.05,8455,96,776884,91.87369914853359,6
0.05,8456,95,776979,91.87406881873005,7
0.05,8457,95,777074,91.87443840151336,7
0.05,8458,96,777170,91.87492611419789,6
0.05,8459,96,777266,91.87541371158393,6
0.05,8460,94,777360,91.87566481503369,7
0.05,8461,94,777454,91.87591585913496,7
0.05,8462,96,777550,91.87640316672575,6
0.05,8463,96,777646,91.87689035916824,6
0.05,8464,94,777740,91.87714116952156,7
0.05,8465,23,777763,91.8690054334987,9
0.05,8466,92,777855,91.8690209046888,9
0.05,8467,95,777950,91.86939064714218,6
0.05,8468,96,778046,91.86987837997403,6
0.05,8469,93,778139,91.87001180637544,8
0.05,8470,91,778230,91.86990910164089,10
0.05,8471,95,778325,91.87027856468366,6
0.05,8472,94,778419,91.87052991856486,7
0.05,8473,95,778514,91.87089922114704,6
0.05,8474,24,778538,91.86289085545722,10
0.05,8475,95,778633,91.86326097215668,6
0.05,8476,96,778729,91.86374896779522,6
0.05,8477,93,778822,91.86388299127152,8
0.05,8478,95,778917,91.86425286000707,6
0.05,8479,95,779012,91.86462264150943,6
0.05,8480,27,779039,91.85697441339465,6
0.05,8481,90,779129,91.8567554821976,11
0.05,8482,92,779221,91.85677236826595,9
0.05,8483,92,779313,91.8567892503536,9
0.05,8484,93,779406,91.8569239835003,8
0.05,8485,87,779493,91.85635163799199,14
0.05,8486,93,779586,91.85648639095086,8
0.05,8487,94,779680,91.85673892554195,7
0.05,8488,92,779772,91.85675580162564,10
0.05,8489,95,779867,91.85712603062426,6
0.05,8490,96,779963,91.85761394417618,6
0.05,8491,93,780056,91.85774846914744,8
0.05,8492,94,780150,91.85800070646415,7
0.05,8493,92,780242,91.85801742406404,9
0.05,8494,94,780336,91.8582695703355,7
0.05,8495,93,780429,91.85840395480226,8
0.05,8496,89,780518,91.85806755325409,12
0.05,8497,94,780612,91.85831960461284,7
0.05,8498,96,780708,91.858806918461,6
0.05,8499,96,780804,91.85929411764705,6
0.05,8500,96,780900,91.85978120221151,6
0.05,8501,89,780989,91.85944483650906,12
0.05,8502,94,781083,91.85969657767846,7
0.05,8503,95,781178,91.86006585136407,6
0.05,8504,93,781271,91.86019988242211,8
0.05,8505,94,781365,91.86045144603808,7
0.05,8506,90,781455,91.86023274950041,11
0.05,8507,96,781551,91.86071932299012,6
0.05,8508,93,781644,91.86085321424375,8
0.05,8509,95,781739,91.86122209165687,6
0.05,8510,94,781833,91.86147338738104,7
0.05,8511,92,781925,91.86148966165413,9
0.05,8512,96,782021,91.86197580171502,6
0.05,8513,92,782113,91.8619920131548,9
0.05,8514,93,782206,91.86212566059895,9
0.05,8515,89,782295,91.86178957256928,12
0.05,8516,92,782387,91.86180580016438,9
0.05,8517,95,782482,91.8621742193003,6
0.05,8518,92,782574,91.86219039793403,9
0.05,8519,92,782666,91.86220657276995,9
0.05,8520,90,782756,91.861988029574,11
0.05,8521,25,782781,91.85414222013611,7
0.05,8522,92,782873,91.85415933356799,9
0.05,8523,95,782968,91.85452839042703,6
0.05,8524,27,782995,91.84692082111437,6
0.05,8525,96,783091,91.84740792868871,6
0.05,8526,94,783185,91.84766037293303,8
0.05,8527,92,783277,91.84767823639775,9
0.05,8528,90,783367,91.84746160159456,11
0.05,8529,93,783460,91.84759671746777,8
0.05,8530,94,783554,91.84784902121675,7
0.05,8531,94,783648,91.84810126582279,7
0.05,8532,95,783743,91.8484706433845,6
0.05,8533,94,783837,91.84872275603469,7
0.05,8534,96,783933,91.84920913884007,6
0.05,8535,95,784028,91.84957825679476,6
0.05,8536,94,784122,91.84983015110694,8
0.05,8537,94,784216,91.85008198641368,7
0.05,8538,94,784310,91.85033376273569,8
0.05,8539,93,784403,91.85046838407494,8
0.05,8540,93,784496,91.85060297389064,8
0.05,8541,90,784586,91.85038632638727,11
0.05,8542,92,784678,91.85040383940068,9
0.05,8543,94,784772,91.85065543071161,7
0.05,8544,96,784868,91.85114101813926,6
0.05,8545,94,784962,91.85139246431079,7
0.05,8546,94,785056,91.85164385164386,7
0.05,8547,92,785148,91.85166120729995,10
0.05,8548,88,785236,91.85121066791437,13
0.05,8549,89,785325,91.85087719298245,12
0.05,8550,94,785419,91.85112852297976,7
0.05,8551,94,785513,91.85137979420018,7
0.05,8552,94,785607,91.85163100666433,7
0.05,8553,91,785698,91.85153144727613,10
0.05,8554,94,785792,91.85178258328463,8
0.05,8555,93,785885,91.85191678354371,8
0.05,8556,92,785977,91.8519340890499,9
0.05,8557,92,786069,91.8519513905118,9
0.05,8558,94,786163,91.8522023600888,7
0.05,8559,94,786257,91.85245327102804,7
0.05,8560,91,786348,91.85235369699801,10
0.05,8561,96,786444,91.85283812193413,6
0.05,8562,93,786537,91.85297208922107,8
0.05,8563,94,786631,91.85322279308734,7
0.05,8564,96,786727,91.85370694687683,6
0.05,8565,92,786819,91.85372402521597,9
0.05,8566,90,786909,91.8535076456169,11
0.05,8567,94,787003,91.85375816993464,7
0.05,8568,95,787098,91.85412533551172,6
0.05,8569,93,787191,91.85425904317387,8
0.05,8570,95,787286,91.85462606463656,6
0.05,8571,96,787382,91.85510965935605,6
0.05,8572,95,787477,91.85547649597574,6
0.05,8573,95,787572,91.85584324702589,6
0.05,8574,96,787668,91.85632653061225,6
0.05,8575,83,787751,91.85529384328358,19
0.05,8576,96,787847,91.85577707823248,6
0.05,8577,93,787940,91.85591046864072,9
0.05,8578,93,788033,91.85604382795198,8
0.05,8579,91,788124,91.85594405594405,10
0.05,8580,96,788220,91.85642698986132,6
0.05,8581,94,788314,91.85667676532277,7
0.05,8582,93,788407,91.85680997320284,8
0.05,8583,94,788501,91.85705964585274,8
0.05,8584,95,788596,91.85742574257426,6
0.05,8585,94,788690,91.85767528534824,7
0.05,8586,92,788782,91.85769185978805,9
0.05,8587,91,788873,91.85759198882161,10
0.05,8588,93,788966,91.8577249970893,8
0.05,8589,93,789059,91.85785797438882,10
0.05,8590,95,789154,91.85822372250028,6
0.05,8591,94,789248,91.8584729981378,7
0.05,8592,96,789344,91.85895496334226,6
0.05,8593,94,789438,91.85920409588084,8
0.05,8594,93,789531,91.85933682373474,8
0.05,8595,95,789626,91.85970218706375,8
0.05,8596,94,789720,91.85995114574851,7
0.05,8597,95,789815,91.86031635264015,8
0.05,8598,95,789910,91.86068147459007,7
0.05,8599,93,790003,91.86081395348837,8
0.05,8600,95,790098,91.86117893268225,6
0.05,8601,91,790189,91.86107881887934,10
0.05,8602,94,790283,91.86132744391492,7
0.05,8603,96,790379,91.86180846118084,6
0.05,8604,92,790471,91.86182452062754,9
0.05,8605,90,790561,91.8616081803393,12
0.05,8606,95,790656,91.86197281282676,6
0.05,8607,89,790745,91.86164033457248,12
0.05,8608,92,790837,91.86165640608665,9
0.05,8609,96,790933,91.86213704994192,6
0.05,8610,94,791027,91.86238532110092,7
0.05,8611,94,791121,91.86263353460288,7
0.05,8612,96,791217,91.86311389759666,6
0.05,8613,92,791309,91.86312978871604,9
0.05,8614,95,791404,91.86349390597795,6
0.05,8615,94,791498,91.86374187558032,7
0.05,8616,90,791588,91.86352558895207,11
0.05,8617,92,791680,91.86354142492458,10
0.05,8618,94,791774,91.86378930270332,8
0.05,8619,95,791869,91.86415313225058,7
0.05,8620,96,791965,91.86463287321656,6
0.05,8621,92,792057,91.86464857341684,9
0.05,8622,94,792151,91.8648962078163,7
0.05,8623,93,792244,91.86502782931355,8
0.05,8624,92,792336,91.86504347826087,9
0.05,8625,96,792432,91.86552283793183,6
0.05,8626,93,792525,91.86565434102238,8
0.05,8627,94,792619,91.86590171534539,7
0.05,8628,92,792711,91.86591725576544,10
0.05,8629,93,792804,91.86604866743916,8
0.05,8630,91,792895,91.86594832580234,10
0.05,8631,93,792988,91.86607970342911,8
0.05,8632,96,793084,91.86655855438434,6
0.05,8633,94,793178,91.8668056520732,7
0.05,8634,92,793270,91.86682107701216,10
0.05,8635,92,793362,91.86683649837887,9
0.05,8636,94,793456,91.86708347805951,7
0.05,8637,93,793549,91.8672146330169,8
0.05,8638,90,793639,91.8669984951962,11
0.05,8639,95,793734,91.86736111111111,7
0.05,8640,94,793828,91.8676079157505,7
0.05,8641,93,793921,91.86773894931729,8
0.05,8642,90,794011,91.86752285086197,11
0.05,8643,94,794105,91.86776955113373,8
0.05,8644,91,794196,91.86766917293232,10
0.05,8645,94,794290,91.8679157992135,7
0.05,8646,94,794384,91.86816236845148,8
0.05,8647,95,794479,91.86852451433857,6
0.05,8648,93,794572,91.86865533587698,9
0.05,8649,93,794665,91.86878612716762,8
0.05,8650,96,794761,91.86926366894001,6
0.05,8651,95,794856,91.86962552011096,6
0.05,8652,89,794945,91.86929388651335,12
0.05,8653,94,795039,91.86954009706494,7
0.05,8654,91,795130,91.86943963027151,10
0.05,8655,92,795222,91.86945471349352,9
0.05,8656,96,795318,91.86993184706019,6
0.05,8657,90,795408,91.86971586971588,11
0.05,8658,95,795503,91.87007737614043,6
0.05,8659,93,795596,91.870207852194,8
0.05,8660,93,795689,91.870338298118,8
0.05,8661,94,795783,91.87058416070191,7
0.05,8662,94,795877,91.8708299665243,7
0.05,8663,96,795973,91.87130655586334,6
0.05,8664,94,796067,91.87155222158107,8
0.05,8665,94,796161,91.87179783060236,7
0.05,8666,91,796252,91.87169724241376,10
0.05,8667,96,796348,91.87217351176741,6
0.05,8668,95,796443,91.8725343176837,6
0.05,8669,91,796534,91.87243367935409,10
0.05,8670,94,796628,91.87267904509284,7
0.05,8671,95,796723,91.87303966789668,7
0.05,8672,95,796818,91.87340020754064,6
0.05,8673,92,796910,91.87341480285912,9
0.05,8674,93,797003,91.8735446685879,8
0.05,8675,93,797096,91.87367450437989,8
0.05,8676,94,797190,91.87391955745073,7
0.05,8677,94,797284,91.87416455404471,7
0.05,8678,90,797374,91.8739486115912,11
0.05,8679,94,797468,91.8741935483871,7
0.05,8680,92,797560,91.87420804054833,9
0.05,8681,94,797654,91.87445289103893,7
0.05,8682,23,797677,91.86652078774617,10
0.05,8683,93,797770,91.8666513127591,8
0.05,8684,94,797864,91.86689694876223,8
0.05,8685,95,797959,91.86725765599816,6
0.05,8686,94,798053,91.86750316564982,7
0.05,8687,94,798147,91.86774861878453,7
0.05,8688,93,798240,91.86787892737945,10
0.05,8689,93,798333,91.8680092059839,8
0.05,8690,96,798429,91.86848463928202,6
0.05,8691,94,798523,91.86872986654394,7
0.05,8692,91,798614,91.8686299321293,10
0.05,8693,91,798705,91.86853002070393,10
0.05,8694,92,798797,91.86854514088557,11
0.05,8695,94,798891,91.86879024839007,7
0.05,8696,95,798986,91.86915028170634,6
0.05,8697,93,799079,91.86928029432053,8
0.05,8698,94,799173,91.86952523278538,7
0.05,8699,96,799269,91.87,6
0.05,8700,92,799361,91.8700149408114,9
0.05,8701,93,799454,91.87014479430016,8
0.05,8702,96,799550,91.87061932666896,6
0.05,8703,92,799642,91.87063419117646,9
0.05,8704,91,799733,91.87053417576105,10
0.05,8705,94,799827,91.87077877325981,7
0.05,8706,96,799923,91.87125301481566,6
0.05,8707,94,800017,91.87149747358751,7
0.05,8708,95,800112,91.87185669996555,6
0.05,8709,92,800204,91.87187141216992,9
0.05,8710,95,800299,91.8722305131443,6
0.05,8711,96,800395,91.87270431588614,6
0.05,8712,93,800488,91.87283369677493,8
0.05,8713,94,800582,91.8730778058297,7
0.05,8714,92,800674,91.87309236947792,9
0.05,8715,94,800768,91.87333639284076,7
0.05,8716,94,800862,91.87358036021567,8
0.05,8717,93,800955,91.87370956641432,8
0.05,8718,94,801049,91.87395343502695,7
0.05,8719,96,801145,91.87442660550458,6
0.05,8720,96,801241,91.87489966746932,6
0.05,8721,93,801334,91.87502866315066,10
0.05,8722,95,801429,91.8753869081738,6
0.05,8723,92,801521,91.87540119211371,9
0.05,8724,95,801616,91.87575931232092,6
0.05,8725,94,801710,91.8760027504011,7
0.05,8726,95,801805,91.87636071960583,6
0.05,8727,92,801897,91.87637488542622,9
0.05,8728,92,801989,91.87638904800092,9
0.05,8729,94,802083,91.8766323024055,8
0.05,8730,27,802110,91.86920169510938,6
0.05,8731,92,802202,91.86921667430143,10
0.05,8732,94,802296,91.86946066643765,7
0.05,8733,95,802391,91.8698190977788,6
0.05,8734,93,802484,91.86994848311392,8
0.05,8735,95,802579,91.87030677655677,6
0.05,8736,92,802671,91.8703216206936,9
0.05,8737,93,802764,91.87045090409704,8
0.05,8738,92,802856,91.8704657283442,9
0.05,8739,27,802883,91.86304347826086,6
0.05,8740,92,802975,91.86305914655074,10
0.05,8741,93,803068,91.86318920155571,8
0.05,8742,94,803162,91.86343360402608,7
0.05,8743,92,803254,91.86344922232388,9
0.05,8744,93,803347,91.8635791881075,8
0.05,8745,96,803443,91.86405213812029,6
0.05,8746,94,803537,91.86429633017035,7
0.05,8747,92,803629,91.86431184270691,9
0.05,8748,95,803724,91.86467024802835,6
0.05,8749,94,803818,91.86491428571429,7
0.05,8750,91,803909,91.8648154496629,10
0.05,8751,91,804000,91.86471663619744,10
0.05,8752,94,804094,91.86496058494231,8
0.05,8753,94,804188,91.86520447795293,8
0.05,8754,88,804276,91.86476299257568,13
0.05,8755,93,804369,91.8648926450434,8
0.05,8756,94,804463,91.86513646225876,8
0.05,8757,95,804558,91.86549440511533,6
0.05,8758,91,804649,91.86539559310424,10
0.05,8759,27,804676,91.85799086757991,6
0.05,8760,93,804769,91.85812121903892,8
0.05,8761,93,804862,91.85825154074412,8
0.05,8762,92,804954,91.85826771653544,9
0.05,8763,94,805048,91.85851209493381,7
0.05,8764,93,805141,91.85864232743867,8
0.05,8765,95,805236,91.8590006844627,6
0.05,8766,92,805328,91.8590167674233,10
0.05,8767,94,805422,91.8592609489051,7
0.05,8768,94,805516,91.85950507469495,7
0.05,8769,95,805611,91.85986316989738,6
0.05,8770,93,805704,91.85999315927488,9
0.05,8771,93,805797,91.86012311901504,8
0.05,8772,95,805892,91.8604810213154,6
0.05,8773,94,805986,91.86072486893093,9
0.05,8774,92,806078,91.86074074074074,10
0.05,8775,93,806171,91.86087055606198,8
0.05,8776,94,806265,91.8611142759485,7
0.05,8777,94,806359,91.86135794030531,7
0.05,8778,94,806453,91.86160154915139,7
0.05,8779,92,806545,91.8616173120729,9
0.05,8780,91,806636,91.86151918915841,10
0.05,8781,94,806730,91.8617626964245,7
0.05,8782,91,806821,91.86166457930092,10
0.05,8783,93,806914,91.8617941712204,9
0.05,8784,95,807009,91.86215139442231,6
0.05,8785,95,807104,91.86250853630776,6
0.05,8786,96,807200,91.86297940138842,6
0.05,8787,94,807294,91.86322257624033,7
0.05,8788,94,807388,91.86346569575606,7
0.05,8789,92,807480,91.86348122866895,9
0.05,8790,94,807574,91.86372426345126,7
0.05,8791,93,807667,91.86385350318471,8
0.05,8792,93,807760,91.86398271352212,8
0.05,8793,95,807855,91.86433932226518,6
0.05,8794,96,807951,91.86480955088118,6
0.05,8795,91,808042,91.86471123237835,10
0.05,8796,94,808136,91.86495396157781,8
0.05,8797,94,808230,91.865196635599,8
0.05,8798,94,808324,91.86543925446074,7
0.05,8799,94,808418,91.86568181818181,7
0.05,8800,94,808512,91.86592432678104,7
0.05,8801,93,808605,91.86605316973416,8
0.05,8802,94,808699,91.86629558105192,7
0.05,8803,95,808794,91.86665152203544,6
0.05,8804,91,808885,91.86655309483248,10
0.05,8805,27,808912,91.85918691801045,6
0.05,8806,94,809006,91.85942999886454,7
0.05,8807,94,809100,91.85967302452316,7
0.05,8808,94,809194,91.85991599500511,7
0.05,8809,93,809287,91.86004540295119,8
0.05,8810,92,809379,91.86006128702758,9
0.05,8811,95,809474,91.8604176123468,6
0.05,8812,94,809568,91.8606603880631,8
0.05,8813,92,809660,91.86067619695939,9
0.05,8814,96,809756,91.86114577424844,6
0.05,8815,94,809850,91.86138838475499,7
0.05,8816,92,809942,91.86140410570489,9
0.05,8817,91,810033,91.86130641868904,11
0.05,8818,93,810126,91.86143553690894,8
0.05,8819,95,810221,91.86179138321995,6
0.05,8820,96,810317,91.86226051468087,6
0.05,8821,95,810412,91.86261618680571,7
0.05,8822,92,810504,91.86263175790548,9
0.05,8823,95,810599,91.8629873073436,6
0.05,8824,95,810694,91.86334277620396,6
0.05,8825,94,810788,91.86358486290506,7
0.05,8826,91,810879,91.86348702843549,10
0.05,8827,96,810975,91.86395559583144,6
0.05,8828,26,811001,91.85649563937025,6
0.05,8829,92,811093,91.85651189127972,9
0.05,8830,95,811188,91.8568678518854,6
0.05,8831,95,811283,91.85722373188406,6
0.05,8832,95,811378,91.85757953130307,6
0.05,8833,95,811473,91.8579352501698,6
0.05,8834,96,811569,91.85840407470289,6
0.05,8835,91,811660,91.85830692621096,11
0.05,8836,95,811755,91.85866244200521,8
0.05,8837,93,811848,91.85879158180583,8
0.05,8838,94,811942,91.85903382735603,7
0.05,8839,20,811962,91.85090497737556,13
0.05,8840,92,812054,91.85092184142066,9
0.05,8841,94,812148,91.85116489482017,7
0.05,8842,96,812244,91.85163406083907,6
0.05,8843,95,812339,91.85199004975124,7
0.05,8844,89,812428,91.85166760881854,12
0.05,8845,95,812523,91.85202351345241,7
0.05,8846,95,812618,91.85237933762858,8
0.05,8847,95,812713,91.85273508137432,6
0.05,8848,93,812806,91.85286473047802,11
0.05,8849,21,812827,91.84485875706214,12
0.05,8850,92,812919,91.84487628516551,9
0.05,8851,95,813014,91.84523271577045,6
0.05,8852,95,813109,91.84558906585339,6
0.05,8853,92,813201,91.84560650553422,10
0.05,8854,94,813295,91.84584980237155,7
0.05,8855,96,813391,91.84631887985546,6
0.05,8856,93,813484,91.84644913627639,8
0.05,8857,94,813578,91.84669225558817,7
0.05,8858,94,813672,91.84693532001354,7
0.05,8859,94,813766,91.84717832957111,8
0.05,8860,96,813862,91.84764699243878,6
0.05,8861,91,813953,91.84755134281201,10
0.05,8862,94,814047,91.84779420060927,7
0.05,8863,96,814143,91.84826263537906,6
0.05,8864,95,814238,91.84861816130852,6
0.05,8865,94,814332,91.84886081660275,7
0.05,8866,93,814425,91.84899063944964,9
0.05,8867,96,814521,91.84945872801083,6
0.05,8868,95,814616,91.84981395873267,6
0.05,8869,96,814712,91.85028184892897,6
0.05,8870,92,814804,91.85029872618645,9
0.05,8871,94,814898,91.85054102795311,7
0.05,8872,92,814990,91.85055787219655,9
0.05,8873,96,815086,91.85102546765833,6
0.05,8874,92,815178,91.85104225352113,9
0.05,8875,94,815272,91.85128436232537,7
0.05,8876,96,815368,91.85175171792272,6
0.05,8877,96,815464,91.85221896823609,6
0.05,8878,93,815557,91.85234823741412,9
0.05,8879,92,815649,91.85236486486487,11
0.05,8880,25,815674,91.84483729309763,8
0.05,8881,88,815762,91.8444044134204,13
0.05,8882,92,815854,91.84442192952831,9
0.05,8883,94,815948,91.84466456551102,7
0.05,8884,95,816043,91.84501969611705,6
0.05,8885,95,816138,91.84537474679271,6
0.05,8886,96,816234,91.84584224147632,6
0.05,8887,94,816328,91.84608460846084,7
0.05,8888,94,816422,91.84632692091348,7
0.05,8889,95,816517,91.8466816647919,6
0.05,8890,94,816611,91.8469238555843,7
0.05,8891,94,816705,91.84716599190283,7
0.05,8892,90,816795,91.84695828179467,12
0.05,8893,93,816888,91.84708792444344,8
0.05,8894,95,816983,91.84744238336144,7
0.05,8895,96,817079,91.84790917266187,6
0.05,8896,90,817169,91.84770147240643,11
0.05,8897,92,817261,91.84771858844684,9
0.05,8898,94,817355,91.84796044499382,8
0.05,8899,94,817449,91.84820224719101,7
0.05,8900,92,817541,91.8482193012021,9
0.05,8901,90,817631,91.84801168276792,11
0.05,8902,86,817717,91.84735482421655,15
0.05,8903,95,817812,91.8477088948787,6
0.05,8904,90,817902,91.84750140370578,12
0.05,8905,94,817996,91.847743094543,7
0.05,8906,88,818084,91.84731110362637,13
0.05,8907,94,818178,91.84755276156264,7
0.05,8908,93,818271,91.8476821192053,8
0.05,8909,96,818367,91.84814814814816,6
0.05,8910,92,818459,91.84816518909213,10
0.05,8911,96,818555,91.84863105924596,6
0.05,8912,91,818646,91.84853584651633,10
0.05,8913,94,818740,91.84877720439758,7
0.05,8914,87,818827,91.84823331463825,15
0.05,8915,92,818919,91.84825033647375,9
0.05,8916,94,819013,91.84849164517215,7
0.05,8917,94,819107,91.8487328997533,7
0.05,8918,95,819202,91.8490862204283,6
0.05,8919,91,819293,91.84899103139013,10
0.05,8920,95,819388,91.84934424391885,7
0.05,8921,96,819484,91.84980945976238,6
0.05,8922,96,819580,91.8502745713325,6
0.05,8923,95,819675,91.8506275212909,6
0.05,8924,94,819769,91.85086834733893,7
0.05,8925,94,819863,91.8511091194264,7
0.05,8926,95,819958,91.85146185728688,6
0.05,8927,94,820052,91.85170250896057,7
0.05,8928,94,820146,91.85194310673087,8
0.05,8929,96,820242,91.85240761478164,6
0.05,8930,94,820336,91.85264807972231,7
0.05,8931,92,820428,91.85266457680251,9
0.05,8932,95,820523,91.85301690361581,8
0.05,8933,92,820615,91.85303335571972,10
0.05,8934,92,820707,91.85304980414102,9
0.05,8935,94,820801,91.85329006266787,7
0.05,8936,94,820895,91.85353026742754,8
0.05,8937,96,820991,91.85399418214365,6
0.05,8938,92,821083,91.85401051571765,9
0.05,8939,93,821176,91.85413870246084,10
0.05,8940,94,821270,91.85437870484286,7
0.05,8941,95,821365,91.85473048535003,6
0.05,8942,93,821458,91.85485854858548,8
0.05,8943,93,821551,91.85498658318426,8
0.05,8944,95,821646,91.85533817775294,6
0.05,8945,94,821740,91.85557791191594,7
0.05,8946,95,821835,91.85592936179725,6
0.05,8947,94,821929,91.85616897630756,7
0.05,8948,92,822021,91.85618504860878,9
0.05,8949,96,822117,91.85664804469273,6
0.05,8950,90,822207,91.85644062115965,11
0.05,8951,94,822301,91.8566800714924,7
0.05,8952,93,822394,91.85680777393053,8
0.05,8953,92,822486,91.85682376591467,9
0.05,8954,93,822579,91.85695142378559,8
0.05,8955,94,822673,91.85719071013845,7
0.05,8956,93,822766,91.85731829853745,8
0.05,8957,94,822860,91.85755749051127,7
0.05,8958,94,822954,91.85779662908807,7
0.05,8959,94,823048,91.85803571428572,7
0.05,8960,94,823142,91.85827474612208,7
0.05,8961,96,823238,91.85873688908725,6
0.05,8962,93,823331,91.85886421956934,8
0.05,8963,94,823425,91.8591030789826,7
0.05,8964,92,823517,91.85911879531511,11
0.05,8965,96,823613,91.85958063796565,6
0.05,8966,96,823709,91.86004237760677,6
0.05,8967,94,823803,91.86028099910794,7
0.05,8968,95,823898,91.86063106254878,8
0.05,8969,91,823989,91.86053511705686,10
0.05,8970,93,824082,91.86066213354141,8
0.05,8971,92,824174,91.86067766384306,10
0.05,8972,96,824270,91.86113897247297,6
0.05,8973,94,824364,91.86137731223535,7
0.05,8974,96,824460,91.86183844011143,6
0.05,8975,93,824553,91.86196524064171,8
0.05,8976,94,824647,91.86220340871115,7
0.05,8977,95,824742,91.86255290710626,6
0.05,8978,91,824833,91.86245684374651,11
0.05,8979,93,824926,91.86258351893096,8
0.05,8980,90,825016,91.86237612738003,11
0.05,8981,95,825111,91.8627254509018,7
0.05,8982,94,825205,91.86296337526439,7
0.05,8983,95,825300,91.8633125556545,6
0.05,8984,88,825388,91.86288258208124,13
0.05,8985,93,825481,91.86300912530604,8
0.05,8986,94,825575,91.86324691220652,7
0.05,8987,94,825669,91.86348464619492,7
0.05,8988,94,825763,91.86372232728891,7
0.05,8989,93,825856,91.86384872080089,8
0.05,8990,92,825948,91.86386386386387,9
0.05,8991,94,826042,91.86410142348754,7
0.05,8992,94,826136,91.8643389302791,7
0.05,8993,93,826229,91.86446519902157,8
0.05,8994,93,826322,91.86459143968871,8
0.05,8995,95,826417,91.86493997332147,6
0.05,8996,96,826513,91.86539957763699,6
0.05,8997,94,826607,91.8656368081796,7
0.05,8998,90,826697,91.8654294921658,11
0.05,8999,94,826791,91.86566666666667,7
0.05,9000,96,826887,91.86612598600155,6
0.05,9001,96,826983,91.86658520328815,6
0.05,9002,93,827076,91.86671109630123,8
0.05,9003,27,827103,91.85950688582852,6
0.05,9004,94,827197,91.85974458634092,7
0.05,9005,94,827291,91.85998223406618,7
0.05,9006,94,827385,91.86021982902187,7
0.05,9007,95,827480,91.86056838365897,6
0.05,9008,94,827574,91.86080586080585,7
0.05,9009,93,827667,91.86093229744728,8
0.05,9010,95,827762,91.86128065697481,6
0.05,9011,92,827854,91.8612960497115,9
0.05,9012,94,827948,91.86153334073006,7
0.05,9013,95,828043,91.86188151763923,6
0.05,9014,94,828137,91.86211869107044,7
0.05,9015,92,828229,91.86213398402839,9
0.05,9016,93,828322,91.86226017522458,8
0.05,9017,95,828417,91.86260811709913,6
0.05,9018,93,828510,91.86273422774144,8
0.05,9019,92,828602,91.86274944567627,10
0.05,9020,92,828694,91.86276466023722,9
0.05,9021,87,828781,91.86222567058302,14
0.05,9022,95,828876,91.86257342347335,6
0.05,9023,95,828971,91.86292109929079,6
0.05,9024,95,829066,91.86326869806093,7
0.05,9025,90,829156,91.86306226456902,11
0.05,9026,96,829252,91.86352054946272,6
0.05,9027,94,829346,91.86375719982277,7
0.05,9028,95,829441,91.86410455199912,6
0.05,9029,89,829530,91.86378737541528,13
0.05,9030,94,829624,91.8640239176171,7
0.05,9031,94,829718,91.86426040744021,7
0.05,9032,93,829811,91.86438613970995,8
0.05,9033,95,829906,91.86473323001992,7
0.05,9034,93,829999,91.86485888212506,8
0.05,9035,96,830095,91.86531651173085,6
0.05,9036,92,830187,91.86533141529269,10
0.05,9037,95,830282,91.86567824739987,6
0.05,9038,94,830376,91.86591437105875,7
0.05,9039,96,830472,91.86637168141593,6
0.05,9040,94,830566,91.86660767614202,7
0.05,9041,92,830658,91.86662242866622,9
0.05,9042,95,830753,91.86696892624128,6
0.05,9043,96,830849,91.86742591773552,6
0.05,9044,94,830943,91.8676616915423,7
0.05,9045,94,831037,91.86789741322131,7
0.05,9046,94,831131,91.86813308278988,7
0.05,9047,93,831224,91.868258178603,9
0.05,9048,94,831318,91.86849375621615,7
0.05,9049,95,831413,91.86883977900553,7
0.05,9050,92,831505,91.86885427024639,9
0.05,9051,-48,831457,91.8534025629695,11
0.05,9052,96,831553,91.85386059869657,6
0.05,9053,94,831647,91.8540976364038,7
0.05,9054,96,831743,91.8545554942021,6
0.05,9055,94,831837,91.85479240282686,7
0.05,9056,94,831931,91.85502925913659,7
0.05,9057,92,832023,91.85504526385516,9
0.05,9058,94,832117,91.85528203996026,7
0.05,9059,88,832205,91.85485651214128,13
0.05,9060,94,832299,91.85509325681492,7
0.05,9061,94,832393,91.85532994923858,7
0.05,9062,94,832487,91.85556658942954,7
0.05,9063,96,832583,91.85602383053839,6
0.05,9064,94,832677,91.85626034197463,8
0.05,9065,95,832772,91.85660710346349,8
0.05,9066,25,832797,91.84923348406309,8
0.05,9067,94,832891,91.84947066607852,8
0.05,9068,95,832986,91.84981806152828,6
0.05,9069,94,833080,91.85005512679162,7
0.05,9070,93,833173,91.8501818983574,8
0.05,9071,90,833263,91.84997795414462,11
0.05,9072,94,833357,91.8502149233991,7
0.05,9073,88,833445,91.84979061053559,13
0.05,9074,94,833539,91.85002754820937,7
0.05,9075,91,833630,91.8499338915822,10
0.05,9076,92,833722,91.84995042414894,9
0.05,9077,95,833817,91.85029742233972,6
0.05,9078,93,833910,91.85042405551272,8
0.05,9079,93,834003,91.85055066079295,8
0.05,9080,94,834097,91.85078735822046,7
0.05,9081,93,834190,91.85091389561771,8
0.05,9082,92,834282,91.85093030936915,9
0.05,9083,94,834376,91.851166886834,7
0.05,9084,95,834471,91.85151348376445,6
0.05,9085,95,834566,91.85186000440238,6
0.05,9086,90,834656,91.85165621217124,11
0.05,9087,95,834751,91.85200264084507,6
0.05,9088,94,834845,91.85223897018373,7
0.05,9089,94,834939,91.85247524752475,7
0.05,9090,94,835033,91.85271147288528,7
0.05,9091,95,835128,91.85305763308403,6
0.05,9092,96,835224,91.85351369185088,6
0.05,9093,95,835319,91.85385968770618,6
0.05,9094,95,835414,91.85420560747663,7
0.05,9095,93,835507,91.85433157431838,8
0.05,9096,95,835602,91.85467736616467,6
0.05,9097,93,835695,91.8548032534623,8
0.05,9098,96,835791,91.85525881965052,6
0.05,9099,96,835887,91.85571428571428,6
0.05,9100,96,835983,91.85616965168663,6
0.05,9101,95,836078,91.856515051637,6
0.05,9102,95,836173,91.85686037570032,6
0.05,9103,93,836266,91.85698594024605,8
0.05,9104,91,836357,91.8568918176826,10
0.05,9105,92,836449,91.8569075334944,9
0.05,9106,93,836542,91.85703305149885,8
0.05,9107,95,836637,91.85737812911727,7
0.05,9108,95,836732,91.85772313096938,6
0.05,9109,92,836824,91.85773874862788,9
0.05,9110,95,836919,91.85808363516628,7
0.05,9111,93,837012,91.85820895522389,9
0.05,9112,96,837108,91.8586634478218,6
0.05,9113,94,837202,91.8588983980689,7
0.05,9114,94,837296,91.85913329676357,7
0.05,9115,96,837392,91.85958753839404,6
0.05,9116,94,837486,91.85982230997038,7
0.05,9117,92,837578,91.85983768370257,9
0.05,9118,91,837669,91.85974339291589,10
0.05,9119,87,837756,91.85921052631579,14
0.05,9120,95,837851,91.85955487336915,8
0.05,9121,92,837943,91.8595702696777,9
0.05,9122,91,838034,91.85947604954511,10
0.05,9123,96,838130,91.85992985532661,6
0.05,9124,88,838218,91.85950684931507,14
0.05,9125,93,838311,91.85963182117028,9
0.05,9126,96,838407,91.86008546072094,6
0.05,9127,94,838501,91.8603198948291,7
0.05,9128,94,838595,91.86055427757695,7
0.05,9129,93,838688,91.86067907995618,8
0.05,9130,95,838783,91.86102288905924,6
0.05,9131,94,838877,91.86125711782742,7
0.05,9132,94,838971,91.86149129530274,7
0.05,9133,94,839065,91.86172542150209,7
0.05,9134,95,839160,91.86206896551724,6
0.05,9135,94,839254,91.86230297723293,8
0.05,9136,94,839348,91.86253693772574,7
0.05,9137,94,839442,91.86277084701247,7
0.05,9138,94,839536,91.86300470510997,8
0.05,9139,94,839630,91.86323851203501,7
0.05,9140,93,839723,91.86336287058309,8
0.05,9141,94,839817,91.86359658718006,7
0.05,9142,92,839909,91.86361150607021,9
0.05,9143,19,839928,91.85564304461943,13
0.05,9144,94,840022,91.85587752870421,7
0.05,9145,94,840116,91.85611196151324,7
0.05,9146,93,840209,91.8562370176014,8
0.05,9147,92,840301,91.85625273283777,9
0.05,9148,94,840395,91.85648704776479,7
0.05,9149,96,840491,91.85693989071038,6
0.05,9150,93,840584,91.85706480166102,9
0.05,9151,95,840679,91.85740821678321,6
0.05,9152,90,840769,91.85720528788376,12
0.05,9153,96,840865,91.85765785448984,6
0.05,9154,94,840959,91.8578918623703,7
0.05,9155,92,841051,91.85790738313673,9
0.05,9156,90,841141,91.85770448836955,11
0.05,9157,94,841235,91.85793841450098,7
0.05,9158,94,841329,91.85817228955126,7
0.05,9159,90,841419,91.8579694323144,11
0.05,9160,94,841513,91.85820325291999,7
0.05,9161,94,841607,91.85843702248417,7
0.05,9162,96,841703,91.85888901014951,6
0.05,9163,90,841793,91.85868616324748,13
0.05,9164,92,841885,91.85870158210584,9
0.05,9165,96,841981,91.85915339297404,6
0.05,9166,19,842000,91.85120541071234,13
0.05,9167,92,842092,91.85122164048866,9
0.05,9168,95,842187,91.85156505616752,6
0.05,9169,92,842279,91.8515812431843,10
0.05,9170,94,842373,91.85181550539745,7
0.05,9171,96,842469,91.85226777147841,6
0.05,9172,94,842563,91.8525019077728,7
0.05,9173,23,842586,91.84499672988882,11
0.05,9174,96,842682,91.84544959128065,6
0.05,9175,94,842776,91.8456843940715,8
0.05,9176,96,842872,91.84613708183502,6
0.05,9177,93,842965,91.84626280235345,8
0.05,9178,94,843059,91.84649743980826,7
0.05,9179,94,843153,91.8467320261438,8
0.05,9180,96,843249,91.84718440257052,6
0.05,9181,95,843344,91.84752777172729,6
0.05,9182,94,843438,91.84776216922575,7
0.05,9183,89,843527,91.84745209059234,12
0.05,9184,96,843623,91.84790419161676,6
0.05,9185,92,843715,91.84792074896582,9
0.05,9186,95,843810,91.84826385109393,6
0.05,9187,95,843905,91.84860687853723,6
0.05,9188,96,844001,91.84905865709,6
0.05,9189,95,844096,91.84940152339499,6
0.05,9190,95,844191,91.84974431509085,6
0.05,9191,94,844285,91.84997824194951,7
0.05,9192,95,844380,91.85032089633417,7
0.05,9193,93,844473,91.8504459430063,9
0.05,9194,94,844567,91.85067971723763,7
0.05,9195,88,844655,91.85026098303611,13
0.05,9196,93,844748,91.8503859954333,8
0.05,9197,93,844841,91.85051098064797,8
0.05,9198,23,844864,91.84302641591478,9
0.05,9199,90,844954,91.84282608695652,11
0.05,9200,27,844981,91.83577871970438,6
0.05,9201,93,845074,91.83590523799174,8
0.05,9202,95,845169,91.83624904922308,6
0.05,9203,92,845261,91.83626684050412,9
0.05,9204,92,845353,91.83628462791961,9
0.05,9205,94,845447,91.83651966109059,7
0.05,9206,94,845541,91.83675464320626,7
0.05,9207,95,845636,91.83709817549956,7
0.05,9208,95,845731,91.83744163318492,6
0.05,9209,94,845825,91.83767643865363,7
0.05,9210,96,845921,91.83812832482901,6
0.05,9211,94,846015,91.83836300477638,7
0.05,9212,92,846107,91.83838054922393,9
0.05,9213,96,846203,91.83883221185152,6
0.05,9214,95,846298,91.83917525773195,6
0.05,9215,95,846393,91.83951822916667,6
0.05,9216,94,846487,91.83975263100793,7
0.05,9217,93,846580,91.83987849858971,8
0.05,9218,95,846675,91.84022128213472,6
0.05,9219,92,846767,91.84023861171367,9
0.05,9220,95,846862,91.84058128185663,6
0.05,9221,92,846954,91.8405985686402,9
0.05,9222,94,847048,91.84083270085655,7
0.05,9223,94,847142,91.84106678230702,8
0.05,9224,92,847234,91.8410840108401,9
0.05,9225,94,847328,91.84131801430739,7
0.05,9226,91,847419,91.84122683429067,10
0.05,9227,95,847514,91.84156913740789,6
0.05,9228,94,847608,91.84180301224401,7
0.05,9229,94,847702,91.84203683640304,7
0.05,9230,94,847796,91.84227060990142,7
0.05,9231,91,847887,91.8421793760832,10
0.05,9232,95,847982,91.84252139066392,8
0.05,9233,94,848076,91.8427550357375,7
0.05,9234,95,848171,91.84309691391445,7
0.05,9235,96,848267,91.84354699003897,6
0.05,9236,96,848363,91.84399696871279,6
0.05,9237,92,848455,91.84401385581295,9
0.05,9238,95,848550,91.84435544972399,7
0.05,9239,94,848644,91.84458874458875,7
0.05,9240,95,848739,91.84493020235905,6
0.05,9241,90,848829,91.84473057779701,11
0.05,9242,94,848923,91.84496375635617,7
0.05,9243,93,849016,91.8450887061878,9
0.05,9244,95,849111,91.8454299621417,6
0.05,9245,96,849207,91.8458792991564,6
0.05,9246,95,849302,91.84622039580404,6
0.05,9247,96,849398,91.846669550173,6
0.05,9248,96,849494,91.84711860741702,6
0.05,9249,94,849588,91.84735135135135,7
0.05,9250,94,849682,91.84758404496812,8
0.05,9251,95,849777,91.84792477302204,6
0.05,9252,94,849871,91.84815735437155,8
0.05,9253,92,849963,91.84817376269721,9
0.05,9254,95,850058,91.84851431658564,6
0.05,9255,93,850151,91.84863872082973,8
0.05,9256,95,850246,91.84897915091283,7
0.05,9257,94,850340,91.84921149276302,7
0.05,9258,92,850432,91.8492277783778,9
0.05,9259,95,850527,91.84956803455724,6
0.05,9260,94,850621,91.84980023755534,7
0.05,9261,96,850717,91.85024832649536,6
0.05,9262,79,850796,91.84886106013171,23
0.05,9263,94,850890,91.84909326424871,7
0.05,9264,93,850983,91.8492174851592,8
0.05,9265,95,851078,91.84955752212389,6
0.05,9266,94,851172,91.84978957591454,7
0.05,9267,94,851266,91.85002157962883,7
0.05,9268,96,851362,91.85046930628978,6
0.05,9269,94,851456,91.85070118662351,7
0.05,9270,94,851550,91.85093301693453,7
0.05,9271,26,851576,91.84383088869716,6
0.05,9272,94,851670,91.8440634098997,7
0.05,9273,91,851761,91.84397239594566,10
0.05,9274,92,851853,91.84398921832884,9
0.05,9275,95,851948,91.84432945235015,6
0.05,9276,95,852043,91.84466961302145,6
0.05,9277,94,852137,91.84490191851692,7
0.05,9278,94,852231,91.84513417394116,7
0.05,9279,94,852325,91.84536637931035,7
0.05,9280,94,852419,91.84559853464066,7
0.05,9281,95,852514,91.84593837535014,6
0.05,9282,94,852608,91.84617041904556,7
0.05,9283,95,852703,91.84651012494615,7
0.05,9284,93,852796,91.84663435648896,8
0.05,9285,94,852890,91.84686625026922,7
0.05,9286,96,852986,91.84731344890707,6
0.05,9287,93,853079,91.8474375538329,8
0.05,9288,94,853173,91.84766928625255,7
0.05,9289,94,853267,91.84790096878363,7
0.05,9290,94,853361,91.84813260144226,7
0.05,9291,94,853455,91.84836418424452,7
0.05,9292,94,853549,91.84859571720649,7
0.05,9293,95,853644,91.848934796643,7
0.05,9294,92,853736,91.84895104895105,9
0.05,9295,94,853830,91.84918244406197,7
0.05,9296,91,853921,91.84909110465742,11
0.05,9297,96,854017,91.84953753495375,6
0.05,9298,94,854111,91.84976879234327,7
0.05,9299,94,854205,91.85,7
0.05,9300,92,854297,91.85001612729813,9
0.05,9301,94,854391,91.85024725865405,7
0.05,9302,93,854484,91.85037084811351,8
0.05,9303,94,854578,91.85060189165951,7
0.05,9304,93,854671,91.85072541644277,8
0.05,9305,95,854766,91.85106382978724,6
0.05,9306,96,854862,91.85150961641774,6
0.05,9307,92,854954,91.85152556940267,9
0.05,9308,95,855049,91.8518637877323,6
0.05,9309,95,855144,91.85220193340494,7
0.05,9310,94,855238,91.85243260659435,7
0.05,9311,95,855333,91.8527706185567,6
0.05,9312,95,855428,91.85310855792977,6
0.05,9313,90,855518,91.85290959845393,11
0.05,9314,96,855614,91.85335480407944,6
0.05,9315,96,855710,91.85379991412623,6
0.05,9316,94,855804,91.8540302672534,7
0.05,9317,95,855899,91.85436789010517,7
0.05,9318,94,855993,91.85459813284687,7
0.05,9319,93,856086,91.85472103004292,9
0.05,9320,93,856179,91.854843900869,8
0.05,9321,95,856274,91.85518129156833,6
0.05,9322,91,856365,91.85508956344525,10
0.05,9323,94,856459,91.85531960531961,7
0.05,9324,94,856553,91.85554959785523,7
0.05,9325,93,856646,91.85567231396097,8
0.05,9326,94,856740,91.85590221936314,7
0.05,9327,89,856829,91.85559605488851,13
0.05,9328,96,856925,91.85604030442705,7
0.05,9329,95,857020,91.85637727759914,6
0.05,9330,84,857104,91.85553531239952,17
0.05,9331,96,857200,91.85597942563223,6
0.05,9332,91,857291,91.85588771027537,10
0.05,9333,95,857386,91.8562245553889,7
0.05,9334,93,857479,91.85634708087841,8
0.05,9335,94,857573,91.85657669237361,7
0.05,9336,96,857669,91.85702045624933,6
0.05,9337,88,857757,91.85660741058042,13
0.05,9338,94,857851,91.85683692044115,7
0.05,9339,23,857874,91.84946466809421,9
0.05,9340,95,857969,91.84980194839953,6
0.05,9341,94,858063,91.8500321130379,7
0.05,9342,94,858157,91.8502622284063,7
0.05,9343,93,858250,91.8503852739726,8
0.05,9344,93,858343,91.85050829320492,8
0.05,9345,90,858433,91.85031029317355,13
0.05,9346,95,858528,91.85064726650262,7
0.05,9347,92,858620,91.85066324347454,9
0.05,9348,94,858714,91.85089314365173,7
0.05,9349,94,858808,91.8511229946524,7
0.05,9350,94,858902,91.85135279649235,7
0.05,9351,95,858997,91.85168947818649,6
0.05,9352,93,859090,91.85181225275312,8
0.05,9353,94,859184,91.85204190720548,7
0.05,9354,93,859277,91.85216461785141,8
0.05,9355,94,859371,91.85239418554939,7
0.05,9356,94,859465,91.85262370417868,7
0.05,9357,95,859560,91.85296003419533,8
0.05,9358,92,859652,91.85297574527193,9
0.05,9359,27,859679,91.846047008547,6
0.05,9360,94,859773,91.84627710714668,7
0.05,9361,95,859868,91.84661397137364,7
0.05,9362,96,859964,91.84705756701912,6
0.05,9363,95,860059,91.84739427595045,7
0.05,9364,93,860152,91.84751735184196,9
0.05,9365,93,860245,91.84764040145205,8
0.05,9366,94,860339,91.84787018255578,7
0.05,9367,93,860432,91.84799316823228,8
0.05,9368,95,860527,91.84832959760914,6
0.05,9369,92,860619,91.84834578441836,9
0.05,9370,95,860714,91.84868210436453,6
0.05,9371,94,860808,91.84891165172856,7
0.05,9372,92,860900,91.84892777125786,9
0.05,9373,95,860995,91.84926392148496,6
0.05,9374,95,861090,91.8496,7
0.05,9375,94,861184,91.84982935153583,7
0.05,9376,94,861278,91.85005865415378,7
0.05,9377,92,861370,91.85007464278098,9
0.05,9378,93,861463,91.85019724917369,8
0.05,9379,94,861557,91.85042643923241,7
0.05,9380,94,861651,91.85065558042852,8
0.05,9381,93,861744,91.850778085696,9
0.05,9382,93,861837,91.85090056485133,8
0.05,9383,94,861931,91.85112958226769,8
0.05,9384,96,862027,91.85157165689931,6
0.05,9385,92,862119,91.85158747070105,9
0.05,9386,96,862215,91.85202940236498,6
0.05,9387,93,862308,91.85215168299958,8
0.05,9388,91,862399,91.85206092235595,10
0.05,9389,95,862494,91.85239616613418,6
0.05,9390,92,862586,91.85241188371846,9
0.05,9391,94,862680,91.85264054514481,7
0.05,9392,95,862775,91.85297562014266,6
0.05,9393,95,862870,91.85331062380243,6
0.05,9394,92,862962,91.85332623736029,9
0.05,9395,94,863056,91.85355470412942,7
0.05,9396,95,863151,91.85388953921465,6
0.05,9397,94,863245,91.85411789742498,7
0.05,9398,92,863337,91.85413341844877,9
0.05,9399,94,863431,91.85436170212766,8
0.05,9400,94,863525,91.85458993724072,8
0.05,9401,92,863617,91.85460540310572,9
0.05,9402,93,863710,91.85472721471871,8
0.05,9403,93,863803,91.85484900042535,8
0.05,9404,95,863898,91.85518341307815,6
0.05,9405,95,863993,91.85551775462471,6
0.05,9406,94,864087,91.85574572127139,8
0.05,9407,94,864181,91.85597363945578,7
0.05,9408,91,864272,91.855882665533,10
0.05,9409,95,864367,91.85621679064825,6
0.05,9410,92,864459,91.85623206885559,9
0.05,9411,93,864552,91.85635359116021,8
0.05,9412,96,864648,91.8567937958143,6
0.05,9413,95,864743,91.85712768217549,6
0.05,9414,94,864837,91.85735528412108,7
0.05,9415,95,864932,91.85768903993203,6
0.05,9416,93,865025,91.85781034299671,8
0.05,9417,95,865120,91.8581439796135,6
0.05,9418,94,865214,91.85837137700393,7
0.05,9419,94,865308,91.85859872611465,7
0.05,9420,91,865399,91.85850758942787,10
0.05,9421,94,865493,91.85873487582255,7
0.05,9422,92,865585,91.85874986734585,9
0.05,9423,92,865677,91.85876485568761,9
0.05,9424,96,865773,91.85920424403183,6
0.05,9425,94,865867,91.8594313600679,7
0.05,9426,93,865960,91.85955234963403,9
0.05,9427,95,866055,91.85988544760289,6
0.05,9428,94,866149,91.86011241913246,7
0.05,9429,91,866240,91.86002120890774,10
0.05,9430,95,866335,91.86035415120348,6
0.05,9431,93,866428,91.8604749787956,9
0.05,9432,92,866520,91.86048976995653,9
0.05,9433,92,866612,91.86050455798177,9
0.05,9434,94,866706,91.86073131955484,7
0.05,9435,93,866799,91.86085205595592,8
0.05,9436,93,866892,91.8609727667691,8
0.05,9437,95,866987,91.86130536130536,6
0.05,9438,94,867081,91.861531941943,8
0.05,9439,94,867175,91.86175847457628,7
0.05,9440,95,867270,91.86209088020337,6
0.05,9441,95,867365,91.86242321542046,6
0.05,9442,94,867459,91.86264958170074,7
0.05,9443,95,867554,91.86298178737823,7
0.05,9444,94,867648,91.8632080465855,7
0.05,9445,96,867744,91.86364598771966,7
0.05,9446,93,867837,91.86376627500793,9
0.05,9447,94,867931,91.86399237933955,7
0.05,9448,94,868025,91.86421843581331,7
0.05,9449,93,868118,91.86433862433863,8
0.05,9450,94,868212,91.86456459633901,7
0.05,9451,92,868304,91.86457892509522,10
0.05,9452,89,868393,91.86427589125145,12
0.05,9453,91,868484,91.8641844721811,10
0.05,9454,92,868576,91.8641988365944,9
0.05,9455,94,868670,91.86442470389171,7
0.05,9456,96,868766,91.86486200697895,6
0.05,9457,92,868858,91.86487629519983,9
0.05,9458,94,868952,91.86510201924094,7
0.05,9459,94,869046,91.86532769556025,8
0.05,9460,96,869142,91.86576471831731,6
0.05,9461,95,869237,91.86609596279857,6
0.05,9462,95,869332,91.86642713727147,6
0.05,9463,94,869426,91.86665257819104,7
0.05,9464,95,869521,91.86698362387745,6
0.05,9465,90,869611,91.86678639340799,11
0.05,9466,95,869706,91.86711735502271,6
0.05,9467,93,869799,91.867237008872,8
0.05,9468,96,869895,91.86767346076671,6
0.05,9469,94,869989,91.86789862724393,7
0.05,9470,96,870085,91.8683349171154,6
0.05,9471,91,870176,91.86824324324324,10
0.05,9472,91,870267,91.86815158872585,10
0.05,9473,95,870362,91.86848216170571,6
0.05,9474,25,870387,91.86142480211082,8
0.05,9475,96,870483,91.86186154495567,6
0.05,9476,96,870579,91.86229819563152,6
0.05,9477,94,870673,91.86252373918548,7
0.05,9478,94,870767,91.86274923515138,7
0.05,9479,94,870861,91.86297468354431,7
0.05,9480,96,870957,91.8634110325915,6
0.05,9481,95,871052,91.86374182661886,6
0.05,9482,94,871146,91.86396709901929,7
0.05,9483,95,871241,91.86429776465626,6
0.05,9484,94,871335,91.8645229309436,7
0.05,9485,94,871429,91.86474804975754,7
0.05,9486,93,871522,91.86486771371351,8
0.05,9487,94,871616,91.86509274873525,7
0.05,9488,94,871710,91.86531773632628,7
0.05,9489,94,871804,91.86554267650158,7
0.05,9490,96,871900,91.86597829522705,6
0.05,9491,91,871991,91.86588706278972,10
0.05,9492,95,872086,91.86621721268303,6
0.05,9493,90,872176,91.86602064461765,11
0.05,9494,88,872264,91.86561348077936,13
0.05,9495,92,872356,91.86562763268745,9
0.05,9496,96,872452,91.86606296725282,6
0.05,9497,94,872546,91.86628763950306,7
0.05,9498,92,872638,91.8663017159701,9
0.05,9499,96,872734,91.86673684210527,6
0.05,9500,95,872829,91.86706662456584,6
0.05,9501,93,872922,91.86718585560935,8
0.05,9502,91,873013,91.86709460170472,10
0.05,9503,93,873106,91.8672138047138,8
0.05,9504,94,873200,91.86743819042609,7
0.05,9505,91,873291,91.86734693877551,10
0.05,9506,95,873386,91.86767644893237,6
0.05,9507,92,873478,91.86769036600758,10
0.05,9508,96,873574,91.8681249342728,6
0.05,9509,95,873669,91.86845425867507,6
0.05,9510,94,873763,91.8686783724109,7
0.05,9511,90,873853,91.8684819175778,12
0.05,9512,95,873948,91.86881110059917,6
0.05,9513,91,874039,91.86871978137482,10
0.05,9514,93,874132,91.8688386757751,8
0.05,9515,91,874223,91.86874737284573,10
0.05,9516,93,874316,91.86886623936114,8
0.05,9517,94,874410,91.86909014498845,7
0.05,9518,92,874502,91.86910389746822,9
0.05,9519,95,874597,91.86943277310924,6
0.05,9520,90,874687,91.8692364247453,11
0.05,9521,96,874783,91.86967023734509,6
0.05,9522,93,874876,91.86978893205922,8
0.05,9523,88,874964,91.86938261234775,14
0.05,9524,94,875058,91.86960629921259,7
0.05,9525,94,875152,91.869829939114,7
0.05,9526,93,875245,91.86994856722998,8
0.05,9527,94,875339,91.87017212426532,7
0.05,9528,94,875433,91.87039563437926,8
0.05,9529,94,875527,91.87061909758657,7
0.05,9530,94,875621,91.870842513902,7
0.05,9531,95,875716,91.87117079311791,7
0.05,9532,94,875810,91.87139410468897,7
0.05,9533,93,875903,91.87151248164464,8
0.05,9534,92,875995,91.87152595700053,9
0.05,9535,95,876090,91.87185402684564,6
0.05,9536,94,876184,91.87207717311523,8
0.05,9537,93,876277,91.87219542881107,9
0.05,9538,89,876366,91.87189432854596,12
0.05,9539,93,876459,91.87201257861635,8
0.05,9540,96,876555,91.8724452363484,6
0.05,9541,95,876650,91.8727730035632,6
0.05,9542,94,876744,91.87299591323483,7
0.05,9543,95,876839,91.87332355406538,6
0.05,9544,93,876932,91.87344159245679,8
0.05,9545,95,877027,91.87376911795516,6
0.05,9546,93,877120,91.87388708494815,8
0.05,9547,93,877213,91.87400502723084,10
0.05,9548,93,877306,91.87412294481098,8
0.05,9549,92,877398,91.87413612565445,9
0.05,9550,94,877492,91.87435870589466,8
0.05,9551,93,877585,91.87447654941373,9
0.05,9552,27,877612,91.86768554380822,6
0.05,9553,92,877704,91.86769939292444,9
0.05,9554,96,877800,91.86813186813187,6
0.05,9555,96,877896,91.86856425282545,6
0.05,9556,94,877990,91.86878727634195,7
0.05,9557,95,878085,91.86911487758945,7
0.05,9558,93,878178,91.86923318338738,8
0.05,9559,95,878273,91.86956066945606,6
0.05,9560,93,878366,91.86967890388034,8
0.05,9561,94,878460,91.86990169420623,7
0.05,9562,93,878553,91.87001986824218,8
0.05,9563,91,878644,91.86992890004183,10
0.05,9564,94,878738,91.87015159435441,7
0.05,9565,96,878834,91.87058331591052,6
0.05,9566,94,878928,91.87080589526498,7
0.05,9567,91,879019,91.87071488294315,10
0.05,9568,94,879113,91.87093740202738,7
0.05,9569,26,879139,91.86405433646813,6
0.05,9570,95,879234,91.86438198725315,6
0.05,9571,95,879329,91.86470956957794,7
0.05,9572,92,879421,91.86472370207876,9
0.05,9573,94,879515,91.86494673072906,7
0.05,9574,95,879610,91.86527415143603,6
0.05,9575,94,879704,91.86549707602339,7
0.05,9576,94,879798,91.86571995405659,7
0.05,9577,96,879894,91.86615159741073,6
0.05,9578,95,879989,91.86647875561123,7
0.05,9579,94,880083,91.86670146137787,7
0.05,9580,96,880179,91.86713286713287,6
0.05,9581,92,880271,91.86714673345857,9
0.05,9582,94,880365,91.86736929980174,7
0.05,9583,94,880459,91.8675918196995,7
0.05,9584,93,880552,91.86770996348461,8
0.05,9585,93,880645,91.86782808262049,9
0.05,9586,92,880737,91.86784186919787,10
0.05,9587,96,880833,91.86827284105131,6
0.05,9588,95,880928,91.86859943685472,6
0.05,9589,93,881021,91.86871741397289,8
0.05,9590,93,881114,91.86883536648942,8
0.05,9591,94,881208,91.86905754795663,7
0.05,9592,91,881299,91.8689669550714,10
0.05,9593,96,881395,91.86939754012924,6
0.05,9594,94,881489,91.8696195935383,7
0.05,9595,93,881582,91.8697373905794,8
0.05,9596,93,881675,91.86985516307179,8
0.05,9597,95,881770,91.87018128776829,7
0.05,9598,95,881865,91.87050734451505,6
0.05,9599,94,881959,91.87072916666666,8
0.05,9600,96,882055,91.87115925424435,6
0.05,9601,27,882082,91.86440324932306,6
0.05,9602,87,882169,91.86389669894824,14
0.05,9603,90,882259,91.8637026239067,11
0.05,9604,94,882353,91.86392503904217,7
0.05,9605,95,882448,91.86425150947325,6
0.05,9606,95,882543,91.86457791193921,8
0.05,9607,94,882637,91.8648001665279,7
0.05,9608,93,882730,91.86491830575503,8
0.05,9609,95,882825,91.8652445369407,6
0.05,9610,91,882916,91.86515451045676,10
0.05,9611,95,883011,91.86548064918851,6
0.05,9612,95,883106,91.86580672006657,8
0.05,9613,87,883193,91.86530060328687,14
0.05,9614,94,883287,91.86552262090484,7
0.05,9615,91,883378,91.86543261231282,10
0.05,9616,94,883472,91.86565457003223,7
0.05,9617,96,883568,91.86608442503639,6
0.05,9618,95,883663,91.86641022975361,6
0.05,9619,95,883758,91.86673596673597,6
0.05,9620,94,883852,91.86695769670513,7
0.05,9621,94,883946,91.86717938058615,7
0.05,9622,96,884042,91.8676088537878,6
0.05,9623,94,884136,91.86783042394015,8
0.05,9624,93,884229,91.86794805194805,8
0.05,9625,94,884323,91.86816954082693,7
0.05,9626,95,884418,91.86849485821128,6
0.05,9627,95,884513,91.86882010801828,7
0.05,9628,93,884606,91.86893758438052,8
0.05,9629,94,884700,91.86915887850468,7
0.05,9630,93,884793,91.86927629529644,8
0.05,9631,96,884889,91.86970514950166,6
0.05,9632,94,884983,91.86992629502751,7
0.05,9633,89,885072,91.86962839941873,12
0.05,9634,96,885168,91.87005708354955,6
0.05,9635,93,885261,91.87017434620175,8
0.05,9636,95,885356,91.87049911798277,6
0.05,9637,96,885452,91.87092757833575,6
0.05,9638,96,885548,91.87135594978733,6
0.05,9639,94,885642,91.87157676348548,7
0.05,9640,93,885735,91.8716938076963,8
0.05,9641,93,885828,91.87181082762912,8
0.05,9642,95,885923,91.87213522762626,6
0.05,9643,95,886018,91.8724595603484,6
0.05,9644,93,886111,91.87257646448937,9
0.05,9645,94,886205,91.87279701430644,7
0.05,9646,95,886300,91.87312117756815,6
0.05,9647,92,886392,91.8731343283582,10
0.05,9648,96,886488,91.87356202715307,6
0.05,9649,94,886582,91.8737823834197,7
0.05,9650,92,886674,91.8737954616102,11
0.05,9651,94,886768,91.8740157480315,8
0.05,9652,91,886859,91.8739252045996,11
0.05,9653,93,886952,91.87404184793868,8
0.05,9654,95,887047,91.87436561367167,8
0.05,9655,96,887143,91.87479287489644,6
0.05,9656,91,887234,91.87470228849539,10
0.05,9657,91,887325,91.87461172085318,10
0.05,9658,95,887420,91.87493529350864,7
0.05,9659,95,887515,91.87525879917185,6
0.05,9660,95,887610,91.87558223786357,6
0.05,9661,96,887706,91.87600910784516,6
0.05,9662,93,887799,91.87612542688606,8
0.05,9663,91,887890,91.87603476821192,10
0.05,9664,93,887983,91.87615106052768,8
0.05,9665,94,888077,91.87637078419202,7
0.05,9666,94,888171,91.87659046239784,9
0.05,9667,95,888266,91.87691352916839,7
0.05,9668,96,888362,91.87733995242527,6
0.05,9669,91,888453,91.87724922440538,11
0.05,9670,92,888545,91.87726191707166,9
0.05,9671,94,888639,91.87748138957816,7
0.05,9672,94,888733,91.8777008167063,8
0.05,9673,92,888825,91.87771345875542,10
0.05,9674,92,888917,91.87772609819122,9
0.05,9675,94,889011,91.8779454319967,7
0.05,9676,94,889105,91.87816472047122,8
0.05,9677,24,889129,91.87115106426948,8
0.05,9678,94,889223,91.8713710094018,7
0.05,9679,93,889316,91.87148760330578,8
0.05,9680,94,889410,91.87170746823675,7
0.05,9681,95,889505,91.87203057219583,6
0.05,9682,92,889597,91.87204378808221,10
0.05,9683,94,889691,91.872263527468,7
0.05,9684,95,889786,91.87258647392875,6
0.05,9685,90,889876,91.87239314474499,11
0.05,9686,93,889969,91.87250954887995,8
0.05,9687,90,890059,91.87231626754748,11
0.05,9688,96,890155,91.87274228506554,6
0.05,9689,94,890249,91.87296181630548,7
0.05,9690,94,890343,91.87318130223919,7
0.05,9691,92,890435,91.8731943871234,10
0.05,9692,95,890530,91.87351697101,6
0.05,9693,94,890624,91.8737363317516,7
0.05,9694,94,890718,91.87395564724085,7
0.05,9695,94,890812,91.87417491749174,7
0.05,9696,95,890907,91.87449726719603,6
0.05,9697,92,890999,91.87451020829037,9
0.05,9698,90,891089,91.8743169398907,11
0.05,9699,96,891185,91.87474226804123,6
0.05,9700,91,891276,91.87465209772188,12
0.05,9701,91,891367,91.87456194599052,10
0.05,9702,92,891459,91.87457487375039,9
0.05,9703,95,891554,91.87489694971146,6
0.05,9704,95,891649,91.87521895929933,6
0.05,9705,95,891744,91.87554090253451,6
0.05,9706,23,891767,91.86844545173587,10
0.05,9707,94,891861,91.8686650185414,7
0.05,9708,95,891956,91.8689875373365,6
0.05,9709,96,892052,91.86941297631309,6
0.05,9710,90,892142,91.86922047163011,11
0.05,9711,96,892238,91.86964579901154,6
0.05,9712,94,892332,91.86986512920828,7
0.05,9713,96,892428,91.87029030265596,6
0.05,9714,95,892523,91.87061245496655,6
0.05,9715,96,892619,91.87103746397695,6
0.05,9716,95,892714,91.8713594730884,6
0.05,9717,94,892808,91.87157851409755,7
0.05,9718,93,892901,91.87169461878794,9
0.05,9719,95,892996,91.87201646090536,6
0.05,9720,94,893090,91.87223536673181,7
0.05,9721,93,893183,91.87235136803127,8
0.05,9722,94,893277,91.87257019438445,7
0.05,9723,27,893304,91.86589880707528,6
0.05,9724,93,893397,91.86601542416453,8
0.05,9725,96,893493,91.86644046884639,6
0.05,9726,93,893586,91.86655700627121,8
0.05,9727,94,893680,91.86677631578948,7
0.05,9728,96,893776,91.86720115119745,6
0.05,9729,94,893870,91.86742034943474,7
0.05,9730,94,893964,91.86763950262049,7
0.05,9731,96,894060,91.86806411837237,6
0.05,9732,94,894154,91.8682831603822,8
0.05,9733,95,894249,91.86860489007603,7
0.05,9734,96,894345,91.86902927580894,6
0.05,9735,-44,894301,91.85507395234183,8
0.05,9736,94,894395,91.85529423847181,8
0.05,9737,93,894488,91.85541178886835,8
0.05,9738,94,894582,91.85563199507136,7
0.05,9739,93,894675,91.85574948665298,8
0.05,9740,95,894770,91.85607227184067,6
0.05,9741,94,894864,91.85629234243481,7
0.05,9742,95,894959,91.85661500564508,6
0.05,9743,93,895052,91.85673234811166,8
0.05,9744,92,895144,91.85674704976911,9
0.05,9745,95,895239,91.85706956700184,6
0.05,9746,96,895335,91.8574946137273,6
0.05,9747,93,895428,91.85761181780879,8
0.05,9748,94,895522,91.85783157246897,7
0.05,9749,95,895617,91.85815384615384,6
0.05,9750,95,895712,91.85847605373807,6
0.05,9751,89,895801,91.85818293683347,13
0.05,9752,93,895894,91.85830001025326,8
0.05,9753,95,895989,91.85862210375231,6
0.05,9754,93,896082,91.85873910814966,8
0.05,9755,93,896175,91.85885608856088,8
0.05,9756,93,896268,91.85897304499333,8
0.05,9757,92,896360,91.858987497438,9
0.05,9758,93,896453,91.85910441643611,8
0.05,9759,95,896548,91.8594262295082,8
0.05,9760,95,896643,91.85974797664174,7
0.05,9761,93,896736,91.859864781807,8
0.05,9762,93,896829,91.85998156304414,8
0.05,9763,94,896923,91.8602007374027,8
0.05,9764,94,897017,91.86041986687148,7
0.05,9765,93,897110,91.86053655539628,10
0.05,9766,93,897203,91.86065322002662,8
0.05,9767,94,897297,91.86087223587224,7
0.05,9768,94,897391,91.8610912068789,7
0.05,9769,96,897487,91.86151484135108,6
0.05,9770,94,897581,91.86173370177055,7
0.05,9771,94,897675,91.86195251739665,8
0.05,9772,95,897770,91.862273610969,6
0.05,9773,96,897866,91.86269695109475,6
0.05,9774,90,897956,91.86250639386189,11
0.05,9775,90,898046,91.86231587561375,11
0.05,9776,96,898142,91.86273908151784,6
0.05,9777,91,898233,91.86265084884434,10
0.05,9778,95,898328,91.86297167399529,6
0.05,9779,95,898423,91.86329243353784,6
0.05,9780,94,898517,91.86351088845721,7
0.05,9781,92,898609,91.8635248415457,9
0.05,9782,93,898702,91.86364100991516,8
0.05,9783,93,898795,91.86375715453802,8
0.05,9784,95,898890,91.86407766990291,7
0.05,9785,96,898986,91.86450030656039,6
0.05,9786,94,899080,91.86471850413814,9
0.05,9787,95,899175,91.86503882304864,6
0.05,9788,92,899267,91.86505261007252,10
0.05,9789,90,899357,91.86486210418795,11
0.05,9790,94,899451,91.86508017567154,8
0.05,9791,95,899546,91.86540032679738,6
0.05,9792,94,899640,91.86561829878485,8
0.05,9793,93,899733,91.86573412293241,8
0.05,9794,95,899828,91.86605410923941,6
0.05,9795,92,899920,91.86606778276848,9
0.05,9796,93,900013,91.86618352556906,8
0.05,9797,92,900105,91.86619718309859,9
0.05,9798,94,900199,91.86641494030003,7
0.05,9799,94,900293,91.86663265306123,7
0.05,9800,94,900387,91.86685032139577,7
0.05,9801,96,900483,91.86727198530912,6
0.05,9802,92,900575,91.86728552483933,9
0.05,9803,93,900668,91.86740106079151,8
0.05,9804,93,900761,91.86751657317696,8
0.05,9805,93,900854,91.86763206200285,8
0.05,9806,92,900946,91.86764555929439,9
0.05,9807,95,901041,91.86796492659055,6
0.05,9808,93,901134,91.86808033438679,8
0.05,9809,93,901227,91.86819571865443,8
0.05,9810,92,901319,91.86820915299154,9
0.05,9811,94,901413,91.8684264166327,7
0.05,9812,94,901507,91.86864363599307,9
0.05,9813,94,901601,91.86886081108621,7
0.05,9814,94,901695,91.86907794192562,7
0.05,9815,94,901789,91.86929502852486,7
0.05,9816,95,901884,91.86961393501069,7
0.05,9817,94,901978,91.86983092279486,7
0.05,9818,95,902073,91.87014970974641,6
0.05,9819,90,902163,91.86995926680244,11
0.05,9820,93,902256,91.87007433051625,10
0.05,9821,95,902351,91.87039299531664,6
0.05,9822,92,902443,91.87040618955513,9
0.05,9823,92,902535,91.8704193811075,9
0.05,9824,92,902627,91.87043256997455,9
0.05,9825,93,902720,91.87054752696926,8
0.05,9826,92,902812,91.87056070011194,9
0.05,9827,95,902907,91.87087912087912,7
0.05,9828,93,903000,91.87099399735477,8
0.05,9829,24,903024,91.86408952187182,8
0.05,9830,92,903116,91.86410334655682,9
0.05,9831,95,903211,91.86442229454842,6
0.05,9832,93,903304,91.86453778094173,8
0.05,9833,94,903398,91.86475493186903,8
0.05,9834,95,903493,91.86507371631927,6
0.05,9835,94,903587,91.86529076860512,8
0.05,9836,93,903680,91.86540611975195,8
0.05,9837,95,903775,91.86572474080097,6
0.05,9838,95,903870,91.86604329708304,6
0.05,9839,96,903966,91.86646341463414,6
0.05,9840,95,904061,91.86678183111472,6
0.05,9841,95,904156,91.86710018288966,8
0.05,9842,94,904250,91.8673168749365,7
0.05,9843,93,904343,91.86743193823649,8
0.05,9844,96,904439,91.86785170137125,6
0.05,9845,95,904534,91.86816981515337,6
0.05,9846,95,904629,91.86848786432417,6
0.05,9847,94,904723,91.86870430544273,7
0.05,9848,94,904817,91.8689207026094,7
0.05,9849,94,904911,91.86913705583757,7
0.05,9850,95,905006,91.8694548776774,7
0.05,9851,96,905102,91.86987413723102,6
0.05,9852,94,905196,91.87009032781894,8
0.05,9853,94,905290,91.8703064745281,7
0.05,9854,92,905382,91.8703196347032,9
0.05,9855,94,905476,91.87053571428571,7
0.05,9856,90,905566,91.87034594704271,11
0.05,9857,94,905660,91.87056198011767,8
0.05,9858,96,905756,91.87098082969875,6
0.05,9859,94,905850,91.8711967545639,8
0.05,9860,90,905940,91.87100699726194,11
0.05,9861,92,906032,91.87102007706348,9
0.05,9862,94,906126,91.87123593227213,7
0.05,9863,94,906220,91.87145174371452,7
0.05,9864,92,906312,91.87146477445515,9
0.05,9865,92,906404,91.87147780255422,9
0.05,9866,92,906496,91.87149082801257,9
0.05,9867,94,906590,91.87170652614512,8
0.05,9868,93,906683,91.87182085317662,8
0.05,9869,96,906779,91.87223910840932,6
0.05,9870,92,906871,91.87225205146389,9
0.05,9871,93,906964,91.87236628849271,9
0.05,9872,96,907060,91.87278436138965,6
0.05,9873,94,907154,91.87299979744785,7
0.05,9874,93,907247,91.87311392405063,8
0.05,9875,94,907341,91.87332928311056,7
0.05,9876,95,907436,91.87364584387971,6
0.05,9877,92,907528,91.87365863535129,9
0.05,9878,93,907621,91.87377264905355,8
0.05,9879,94,907715,91.87398785425101,7
0.05,9880,94,907809,91.87420301588908,7
0.05,9881,89,907898,91.87391216352965,12
0.05,9882,94,907992,91.87412728928463,7
0.05,9883,94,908086,91.87434237150951,8
0.05,9884,88,908174,91.87395042994436,14
0.05,9885,95,908269,91.8742666396925,6
0.05,9886,94,908363,91.87448164256094,7
0.05,9887,91,908454,91.8743932038835,10
0.05,9888,91,908545,91.87430478309233,10
0.05,9889,94,908639,91.87451971688574,7
0.05,9890,95,908734,91.87483570923061,6
0.05,9891,93,908827,91.87494945410432,8
0.05,9892,92,908919,91.8749620944102,9
0.05,9893,93,909012,91.87507580351728,8
0.05,9894,96,909108,91.8754926730672,6
0.05,9895,95,909203,91.87580840743735,7
0.05,9896,94,909297,91.87602303728403,7
0.05,9897,95,909392,91.8763386542736,7
0.05,9898,96,909488,91.87675522780079,6
0.05,9899,94,909582,91.8769696969697,7
0.05,9900,94,909676,91.87718412281588,7
0.05,9901,92,909768,91.87719652595435,9
0.05,9902,25,909793,91.8704433000101,8
0.05,9903,93,909886,91.87055735056543,8
0.05,9904,96,909982,91.87097425542655,6
0.05,9905,93,910075,91.87108822935595,8
0.05,9906,93,910168,91.87120218027657,8
0.05,9907,94,910262,91.871417036738,7
0.05,9908,93,910355,91.87153093147644,8
0.05,9909,94,910449,91.87174571140262,7
0.05,9910,92,910541,91.87175865200282,9
0.05,9911,94,910635,91.87197336561744,8
0.05,9912,92,910727,91.87198628064158,9
0.05,9913,90,910817,91.87179745814001,11
0.05,9914,94,910911,91.87201210287444,8
0.05,9915,89,911000,91.87172246873739,12
0.05,9916,93,911093,91.87183624079863,10
0.05,9917,93,911186,91.87194998991733,8
0.05,9918,88,911274,91.87155963302752,14
0.05,9919,95,911369,91.871875,6
0.05,9920,91,911460,91.87178711823405,10
0.05,9921,95,911555,91.87210239870994,7
0.05,9922,94,911649,91.87231683966543,7
0.05,9923,95,911744,91.87263200322451,6
0.05,9924,89,911833,91.87234256926952,12
0.05,9925,94,911927,91.87255692121701,7
0.05,9926,94,912021,91.87277122997885,7
0.05,9927,94,912115,91.87298549556809,7
0.05,9928,25,912140,91.86625037768154,8
0.05,9929,90,912230,91.86606243705941,12
0.05,9930,95,912325,91.86637800825697,6
0.05,9931,88,912413,91.86598872331857,13
0.05,9932,89,912502,91.86570019128159,13
0.05,9933,94,912596,91.86591503925911,7
0.05,9934,86,912682,91.86532460996477,15
0.05,9935,94,912776,91.86553945249598,7
0.05,9936,94,912870,91.86575425178626,8
0.05,9937,26,912896,91.85912658482592,7
0.05,9938,96,912992,91.85954321360298,6
0.05,9939,94,913086,91.85975855130785,7
0.05,9940,95,913181,91.86007443919122,6
0.05,9941,94,913275,91.86028968014485,7
0.05,9942,96,913371,91.86070602433873,6
0.05,9943,93,913464,91.86082059533386,8
0.05,9944,96,913560,91.86123680241327,6
0.05,9945,91,913651,91.86115021114016,11
0.05,9946,24,913675,91.85432793807178,9
0.05,9947,89,913764,91.854041013269,12
0.05,9948,92,913856,91.85405568398834,9
0.05,9949,96,913952,91.85447236180904,6
0.05,9950,95,914047,91.85478846347101,6
0.05,9951,94,914141,91.85500401929261,8
0.05,9952,96,914237,91.85542047623832,6
0.05,9953,93,914330,91.8555354631304,8
0.05,9954,89,914419,91.85524861878453,12
0.05,9955,95,914514,91.8555644837284,6
0.05,9956,92,914606,91.85557898965551,9
0.05,9957,94,914700,91.85579433621209,7
0.05,9958,93,914793,91.85590922783412,9
0.05,9959,92,914885,91.85592369477912,10
0.05,9960,94,914979,91.85613894187331,7
0.05,9961,95,915074,91.85645452720337,6
0.05,9962,93,915167,91.85656930643381,8
0.05,9963,96,915263,91.85698514652749,6
0.05,9964,95,915358,91.85730055193176,6
0.05,9965,93,915451,91.85741521171985,8
0.05,9966,94,915545,91.85763017959266,7
0.05,9967,96,915641,91.85804574638844,6
0.05,9968,94,915735,91.85826060788445,7
0.05,9969,92,915827,91.85827482447343,9
0.05,9970,94,915921,91.8584896198977,9
0.05,9971,96,916017,91.85890493381469,6
0.05,9972,27,916044,91.85240148400682,6
0.05,9973,94,916138,91.8526168036896,7
0.05,9974,94,916232,91.8528320802005,7
0.05,9975,94,916326,91.85304731355252,7
0.05,9976,96,916422,91.85346296481909,6
0.05,9977,94,916516,91.85367809180197,7
0.05,9978,94,916610,91.8538931756689,7
0.05,9979,94,916704,91.85410821643286,7
0.05,9980,94,916798,91.8543232141068,7
0.05,9981,92,916890,91.8543378080545,9
0.05,9982,90,916980,91.85415205849945,11
0.05,9983,95,917075,91.8544671474359,8
0.05,9984,96,917171,91.85488232348523,6
0.05,9985,94,917265,91.85509713599039,7
0.05,9986,96,917361,91.85551216581555,6
0.05,9987,91,917452,91.85542651181417,10
0.05,9988,96,917548,91.85584142556813,6
0.05,9989,93,917641,91.85595595595595,8
0.05,9990,94,917735,91.85617055349815,7
0.05,9991,94,917829,91.85638510808647,7
0.05,9992,95,917924,91.85669968978284,6
0.05,9993,90,918014,91.85651390834501,12
0.05,9994,92,918106,91.85652826413207,9
0.05,9995,95,918201,91.85684273709484,6
0.05,9996,90,918291,91.85665699709914,11
0.05,9997,94,918385,91.85687137427486,7
0.05,9998,92,918477,91.85688568856885,9
0.05,9999,92,918569,91.8569,10
