0.05,0,-147,-147,-147.0,49
0.05,1,91,-56,-28.0,25
0.05,2,-55,-111,-37.0,30
0.05,3,5,-106,-26.5,43
0.05,4,93,-13,-2.6,8
0.05,5,24,11,1.8333333333333333,9
0.05,6,76,87,12.428571428571429,40
0.05,7,90,177,22.125,11
0.05,8,85,262,29.11111111111111,17
0.05,9,96,358,35.8,8
0.05,10,93,451,41.0,9
0.05,11,95,546,45.5,7
0.05,12,96,642,49.38461538461539,6
0.05,13,90,732,52.285714285714285,11
0.05,14,96,828,55.2,6
0.05,15,96,924,57.75,6
0.05,16,18,942,55.411764705882355,15
0.05,17,23,965,53.611111111111114,10
0.05,18,92,1057,55.63157894736842,9
0.05,19,95,1152,57.6,7
0.05,20,96,1248,59.42857142857143,6
0.05,21,96,1344,61.09090909090909,6
0.05,22,93,1437,62.47826086956522,9
0.05,23,95,1532,63.833333333333336,6
0.05,24,24,1556,62.24,9
0.05,25,90,1646,63.30769230769231,12
0.05,26,95,1741,64.48148148148148,7
0.05,27,95,1836,65.57142857142857,6
0.05,28,96,1932,66.62068965517241,6
0.05,29,24,1956,65.2,9
0.05,30,23,1979,63.83870967741935,10
0.05,31,93,2072,64.75,8
0.05,32,95,2167,65.66666666666667,7
0.05,33,95,2262,66.52941176470588,7
0.05,34,95,2357,67.34285714285714,6
0.05,35,96,2453,68.13888888888889,6
0.05,36,21,2474,66.86486486486487,12
0.05,37,22,2496,65.6842105263158,12
0.05,38,24,2520,64.61538461538461,9
0.05,39,93,2613,65.325,9
0.05,40,95,2708,66.04878048780488,7
0.05,41,95,2803,66.73809523809524,7
0.05,42,93,2896,67.34883720930233,8
0.05,43,95,2991,67.97727272727273,7
0.05,44,96,3087,68.6,6
0.05,45,95,3182,69.17391304347827,7
0.05,46,96,3278,69.74468085106383,6
0.05,47,96,3374,70.29166666666667,6
0.05,48,95,3469,70.79591836734694,7
0.05,49,95,3564,71.28,7
0.05,50,94,3658,71.72549019607843,8
0.05,51,96,3754,72.1923076923077,6
0.05,52,96,3850,72.64150943396227,6
0.05,53,96,3946,73.07407407407408,6
0.05,54,95,4041,73.47272727272727,6
0.05,55,96,4137,73.875,6
0.05,56,94,4231,74.2280701754386,7
0.05,57,95,4326,74.58620689655173,7
0.05,58,94,4420,74.91525423728814,8
0.05,59,95,4515,75.25,7
0.05,60,95,4610,75.57377049180327,6
0.05,61,21,4631,74.69354838709677,12
0.05,62,95,4726,75.01587301587301,7
0.05,63,92,4818,75.28125,10
0.05,64,95,4913,75.58461538461539,7
0.05,65,24,4937,74.8030303030303,9
0.05,66,95,5032,75.1044776119403,6
0.05,67,95,5127,75.3970588235294,7
0.05,68,95,5222,75.68115942028986,6
0.05,69,96,5318,75.97142857142858,6
0.05,70,95,5413,76.2394366197183,6
0.05,71,95,5508,76.5,6
0.05,72,96,5604,76.76712328767124,6
0.05,73,95,5699,77.01351351351352,6
0.05,74,95,5794,77.25333333333333,7
0.05,75,95,5889,77.48684210526316,7
0.05,76,96,5985,77.72727272727273,6
0.05,77,95,6080,77.94871794871794,7
0.05,78,95,6175,78.16455696202532,7
0.05,79,91,6266,78.325,11
0.05,80,93,6359,78.50617283950618,8
0.05,81,95,6454,78.70731707317073,7
0.05,82,93,6547,78.87951807228916,9
0.05,83,96,6643,79.08333333333333,6
0.05,84,94,6737,79.25882352941177,8
0.05,85,96,6833,79.45348837209302,6
0.05,86,96,6929,79.64367816091954,6
0.05,87,89,7018,79.75,13
0.05,88,92,7110,79.88764044943821,9
0.05,89,95,7205,80.05555555555556,6
0.05,90,96,7301,80.23076923076923,6
0.05,91,93,7394,80.3695652173913,8
0.05,92,91,7485,80.48387096774194,11
0.05,93,95,7580,80.63829787234043,7
0.05,94,95,7675,80.78947368421052,6
0.05,95,93,7768,80.91666666666667,9
0.05,96,94,7862,81.05154639175258,7
0.05,97,93,7955,81.1734693877551,10
0.05,98,93,8048,81.29292929292929,8
0.05,99,95,8143,81.43,7
0.05,100,93,8236,81.54455445544555,9
0.05,101,95,8331,81.67647058823529,6
0.05,102,93,8424,81.7864077669903,8
0.05,103,94,8518,81.90384615384616,9
0.05,104,-45,8473,80.6952380952381,9
0.05,105,24,8497,80.16037735849056,9
0.05,106,95,8592,80.29906542056075,7
0.05,107,93,8685,80.41666666666667,10
0.05,108,96,8781,80.55963302752293,6
0.05,109,93,8874,80.67272727272727,12
0.05,110,96,8970,80.8108108108108,6
0.05,111,91,9061,80.90178571428571,10
0.05,112,91,9152,80.99115044247787,10
0.05,113,95,9247,81.1140350877193,7
0.05,114,95,9342,81.23478260869565,8
0.05,115,95,9437,81.35344827586206,7
0.05,116,27,9464,80.88888888888889,6
0.05,117,94,9558,81.0,8
0.05,118,96,9654,81.12605042016807,6
0.05,119,92,9746,81.21666666666667,12
0.05,120,95,9841,81.3305785123967,8
0.05,121,92,9933,81.41803278688525,10
0.05,122,95,10028,81.52845528455285,6
0.05,123,25,10053,81.0725806451613,8
0.05,124,91,10144,81.152,12
0.05,125,92,10236,81.23809523809524,10
0.05,126,93,10329,81.33070866141732,9
0.05,127,87,10416,81.375,14
0.05,128,95,10511,81.48062015503876,7
0.05,129,95,10606,81.58461538461539,6
0.05,130,93,10699,81.67175572519083,9
0.05,131,27,10726,81.25757575757575,6
0.05,132,96,10822,81.36842105263158,6
0.05,133,96,10918,81.4776119402985,6
0.05,134,95,11013,81.57777777777778,6
0.05,135,95,11108,81.67647058823529,6
0.05,136,95,11203,81.77372262773723,7
0.05,137,95,11298,81.8695652173913,6
0.05,138,96,11394,81.97122302158273,6
0.05,139,92,11486,82.04285714285714,10
0.05,140,95,11581,82.13475177304964,6
0.05,141,95,11676,82.22535211267606,8
0.05,142,95,11771,82.31468531468532,6
0.05,143,26,11797,81.92361111111111,7
0.05,144,95,11892,82.01379310344828,7
0.05,145,96,11988,82.10958904109589,6
0.05,146,94,12082,82.19047619047619,8
0.05,147,95,12177,82.27702702702703,7
0.05,148,95,12272,82.36241610738254,6
0.05,149,95,12367,82.44666666666667,6
0.05,150,92,12459,82.50993377483444,10
0.05,151,79,12538,82.48684210526316,23
0.05,152,95,12633,82.56862745098039,6
0.05,153,95,12728,82.64935064935065,7
0.05,154,96,12824,82.73548387096774,6
0.05,155,93,12917,82.80128205128206,8
0.05,156,92,13009,82.85987261146497,10
0.05,157,95,13104,82.9367088607595,7
0.05,158,92,13196,82.99371069182389,9
0.05,159,94,13290,83.0625,9
0.05,160,95,13385,83.13664596273291,8
0.05,161,-46,13339,82.3395061728395,10
0.05,162,95,13434,82.41717791411043,7
0.05,163,94,13528,82.48780487804878,9
0.05,164,24,13552,82.13333333333334,9
0.05,165,94,13646,82.20481927710843,7
0.05,166,24,13670,81.8562874251497,9
0.05,167,96,13766,81.94047619047619,6
0.05,168,95,13861,82.01775147928994,6
0.05,169,96,13957,82.1,6
0.05,170,20,13977,81.73684210526316,12
0.05,171,93,14070,81.80232558139535,8
0.05,172,95,14165,81.878612716763,7
0.05,173,94,14259,81.94827586206897,8
0.05,174,96,14355,82.02857142857142,6
0.05,175,94,14449,82.0965909090909,7
0.05,176,93,14542,82.15819209039547,8
0.05,177,95,14637,82.23033707865169,6
0.05,178,92,14729,82.28491620111731,10
0.05,179,93,14822,82.34444444444445,8
0.05,180,-54,14768,81.59116022099448,18
0.05,181,96,14864,81.67032967032966,6
0.05,182,93,14957,81.73224043715847,9
0.05,183,96,15053,81.80978260869566,6
0.05,184,93,15146,81.87027027027027,8
0.05,185,92,15238,81.9247311827957,9
0.05,186,95,15333,81.99465240641712,6
0.05,187,95,15428,82.06382978723404,7
0.05,188,24,15452,81.75661375661376,9
0.05,189,95,15547,81.82631578947368,7
0.05,190,95,15642,81.89528795811518,7
0.05,191,95,15737,81.96354166666667,6
0.05,192,95,15832,82.03108808290155,7
0.05,193,96,15928,82.10309278350516,6
0.05,194,93,16021,82.15897435897436,9
0.05,195,95,16116,82.22448979591837,6
0.05,196,93,16209,82.27918781725889,9
0.05,197,95,16304,82.34343434343434,7
0.05,198,95,16399,82.4070351758794,6
0.05,199,95,16494,82.47,6
0.05,200,95,16589,82.53233830845771,6
0.05,201,93,16682,82.58415841584159,8
0.05,202,93,16775,82.63546798029557,9
0.05,203,94,16869,82.69117647058823,7
0.05,204,96,16965,82.7560975609756,6
0.05,205,96,17061,82.82038834951456,6
0.05,206,94,17155,82.8743961352657,7
0.05,207,93,17248,82.92307692307692,8
0.05,208,95,17343,82.98086124401914,7
0.05,209,93,17436,83.02857142857142,10
0.05,210,95,17531,83.08530805687204,7
0.05,211,92,17623,83.12735849056604,12
0.05,212,96,17719,83.18779342723005,6
0.05,213,94,17813,83.23831775700934,8
0.05,214,96,17909,83.29767441860466,6
0.05,215,95,18004,83.35185185185185,7
0.05,216,94,18098,83.40092165898618,8
0.05,217,94,18192,83.44954128440367,7
0.05,218,93,18285,83.4931506849315,9
0.05,219,95,18380,83.54545454545455,7
0.05,220,91,18471,83.57918552036199,11
0.05,221,93,18564,83.62162162162163,8
0.05,222,94,18658,83.66816143497758,7
0.05,223,95,18753,83.71875,7
0.05,224,94,18847,83.76444444444445,7
0.05,225,95,18942,83.8141592920354,7
0.05,226,96,19038,83.86784140969164,6
0.05,227,94,19132,83.91228070175438,7
0.05,228,95,19227,83.96069868995633,7
0.05,229,95,19322,84.00869565217391,6
0.05,230,24,19346,83.74891774891775,9
0.05,231,94,19440,83.79310344827586,8
0.05,232,95,19535,83.8412017167382,7
0.05,233,95,19630,83.88888888888889,7
0.05,234,-49,19581,83.32340425531915,13
0.05,235,95,19676,83.37288135593221,7
0.05,236,94,19770,83.41772151898734,8
0.05,237,94,19864,83.46218487394958,8
0.05,238,93,19957,83.5020920502092,10
0.05,239,95,20052,83.55,7
0.05,240,95,20147,83.59751037344398,6
0.05,241,95,20242,83.64462809917356,7
0.05,242,25,20267,83.40329218106996,8
0.05,243,95,20362,83.45081967213115,6
0.05,244,91,20453,83.48163265306123,11
0.05,245,93,20546,83.52032520325203,9
0.05,246,95,20641,83.56680161943319,6
0.05,247,91,20732,83.59677419354838,11
0.05,248,94,20826,83.63855421686748,8
0.05,249,93,20919,83.676,9
0.05,250,95,21014,83.7211155378486,8
0.05,251,25,21039,83.48809523809524,8
0.05,252,96,21135,83.53754940711462,6
0.05,253,96,21231,83.58661417322834,6
0.05,254,95,21326,83.6313725490196,6
0.05,255,93,21419,83.66796875,9
0.05,256,23,21442,83.43190661478599,10
0.05,257,96,21538,83.48062015503876,6
0.05,258,91,21629,83.50965250965251,10
0.05,259,95,21724,83.55384615384615,6
0.05,260,95,21819,83.59770114942529,7
0.05,261,96,21915,83.64503816793894,6
0.05,262,96,22011,83.69201520912547,6
0.05,263,94,22105,83.73106060606061,10
0.05,264,95,22200,83.77358490566037,7
0.05,265,94,22294,83.81203007518798,8
0.05,266,95,22389,83.85393258426966,7
0.05,267,95,22484,83.8955223880597,7
0.05,268,96,22580,83.94052044609666,6
0.05,269,94,22674,83.97777777777777,7
0.05,270,95,22769,84.01845018450184,7
0.05,271,95,22864,84.05882352941177,6
0.05,272,95,22959,84.0989010989011,7
0.05,273,94,23053,84.13503649635037,7
0.05,274,95,23148,84.17454545454545,7
0.05,275,96,23244,84.21739130434783,6
0.05,276,95,23339,84.25631768953069,6
0.05,277,94,23433,84.29136690647482,8
0.05,278,94,23527,84.32616487455198,9
0.05,279,95,23622,84.36428571428571,6
0.05,280,94,23716,84.39857651245552,7
0.05,281,95,23811,84.43617021276596,7
0.05,282,94,23905,84.46996466431095,7
0.05,283,92,23997,84.49647887323944,10
0.05,284,95,24092,84.53333333333333,7
0.05,285,96,24188,84.57342657342657,6
0.05,286,95,24283,84.60975609756098,7
0.05,287,95,24378,84.64583333333333,7
0.05,288,96,24474,84.68512110726644,6
0.05,289,93,24567,84.71379310344828,9
0.05,290,95,24662,84.7491408934708,6
0.05,291,95,24757,84.78424657534246,7
0.05,292,96,24853,84.82252559726962,6
0.05,293,95,24948,84.85714285714286,7
0.05,294,93,25041,84.88474576271186,9
0.05,295,27,25068,84.6891891891892,6
0.05,296,95,25163,84.72390572390573,8
0.05,297,95,25258,84.75838926174497,6
0.05,298,25,25283,84.55852842809365,8
0.05,299,95,25378,84.59333333333333,7
0.05,300,96,25474,84.6312292358804,6
0.05,301,94,25568,84.66225165562913,7
0.05,302,93,25661,84.6897689768977,8
0.05,303,89,25750,84.70394736842105,13
0.05,304,94,25844,84.7344262295082,8
0.05,305,93,25937,84.76143790849673,9
0.05,306,93,26030,84.78827361563518,10
0.05,307,96,26126,84.82467532467533,6
0.05,308,92,26218,84.84789644012945,10
0.05,309,94,26312,84.87741935483871,7
0.05,310,93,26405,84.90353697749197,8
0.05,311,94,26499,84.9326923076923,7
0.05,312,95,26594,84.96485623003196,6
0.05,313,94,26688,84.99363057324841,7
0.05,314,93,26781,85.01904761904763,8
0.05,315,95,26876,85.0506329113924,7
0.05,316,27,26903,84.86750788643533,6
0.05,317,95,26998,84.8993710691824,6
0.05,318,96,27094,84.93416927899686,6
0.05,319,96,27190,84.96875,6
0.05,320,96,27286,85.00311526479751,6
0.05,321,92,27378,85.0248447204969,11
0.05,322,95,27473,85.05572755417957,6
0.05,323,95,27568,85.08641975308642,6
0.05,324,93,27661,85.11076923076924,9
0.05,325,90,27751,85.12576687116564,11
0.05,326,95,27846,85.1559633027523,7
0.05,327,95,27941,85.1859756097561,7
0.05,328,95,28036,85.21580547112463,7
0.05,329,95,28131,85.24545454545455,7
0.05,330,95,28226,85.27492447129909,7
0.05,331,93,28319,85.29819277108433,9
0.05,332,25,28344,85.11711711711712,8
0.05,333,94,28438,85.1437125748503,8
0.05,334,88,28526,85.15223880597014,14
0.05,335,25,28551,84.97321428571429,8
0.05,336,96,28647,85.00593471810089,6
0.05,337,95,28742,85.03550295857988,7
0.05,338,94,28836,85.06194690265487,8
0.05,339,95,28931,85.09117647058824,7
0.05,340,94,29025,85.11730205278593,8
0.05,341,94,29119,85.14327485380117,8
0.05,342,95,29214,85.17201166180757,6
0.05,343,96,29310,85.20348837209302,6
0.05,344,24,29334,85.02608695652174,9
0.05,345,95,29429,85.05491329479769,7
0.05,346,95,29524,85.0835734870317,7
0.05,347,96,29620,85.11494252873563,6
0.05,348,95,29715,85.1432664756447,7
0.05,349,94,29809,85.16857142857143,7
0.05,350,93,29902,85.19088319088318,9
0.05,351,95,29997,85.21875,7
0.05,352,96,30093,85.24929178470255,6
0.05,353,24,30117,85.07627118644068,9
0.05,354,92,30209,85.09577464788732,10
0.05,355,95,30304,85.12359550561797,7
0.05,356,95,30399,85.15126050420169,7
0.05,357,94,30493,85.17597765363128,9
0.05,358,95,30588,85.2033426183844,7
0.05,359,24,30612,85.03333333333333,9
0.05,360,95,30707,85.06094182825485,6
0.05,361,91,30798,85.07734806629834,10
0.05,362,95,30893,85.10468319559229,7
0.05,363,95,30988,85.13186813186813,7
0.05,364,95,31083,85.15890410958905,8
0.05,365,94,31177,85.18306010928961,8
0.05,366,95,31272,85.20980926430518,6
0.05,367,95,31367,85.23641304347827,6
0.05,368,95,31462,85.26287262872629,6
0.05,369,87,31549,85.26756756756757,15
0.05,370,91,31640,85.28301886792453,10
0.05,371,94,31734,85.30645161290323,7
0.05,372,96,31830,85.33512064343164,6
0.05,373,95,31925,85.36096256684492,6
0.05,374,25,31950,85.2,8
0.05,375,95,32045,85.22606382978724,6
0.05,376,93,32138,85.24668435013263,8
0.05,377,23,32161,85.08201058201058,14
0.05,378,94,32255,85.10554089709763,8
0.05,379,94,32349,85.12894736842105,8
0.05,380,95,32444,85.15485564304461,6
0.05,381,24,32468,84.99476439790575,9
0.05,382,95,32563,85.02088772845953,6
0.05,383,-44,32519,84.68489583333333,8
0.05,384,96,32615,84.71428571428571,6
0.05,385,96,32711,84.74352331606218,6
0.05,386,91,32802,84.75968992248062,11
0.05,387,92,32894,84.77835051546391,9
0.05,388,93,32987,84.79948586118252,8
0.05,389,95,33082,84.82564102564102,6
0.05,390,93,33175,84.846547314578,8
0.05,391,96,33271,84.875,6
0.05,392,25,33296,84.72264631043257,7
0.05,393,91,33387,84.73857868020305,11
0.05,394,96,33483,84.76708860759494,6
0.05,395,96,33579,84.79545454545455,6
0.05,396,25,33604,84.64483627204031,8
0.05,397,94,33698,84.66834170854271,7
0.05,398,94,33792,84.69172932330827,7
0.05,399,93,33885,84.7125,8
0.05,400,96,33981,84.74064837905237,6
0.05,401,94,34075,84.7636815920398,7
0.05,402,93,34168,84.78411910669975,8
0.05,403,94,34262,84.8069306930693,8
0.05,404,93,34355,84.82716049382717,8
0.05,405,95,34450,84.85221674876847,6
0.05,406,95,34545,84.87714987714988,7
0.05,407,91,34636,84.8921568627451,10
0.05,408,91,34727,84.90709046454768,10
0.05,409,95,34822,84.93170731707318,7
0.05,410,94,34916,84.95377128953771,7
0.05,411,95,35011,84.97815533980582,7
0.05,412,94,35105,85.0,7
0.05,413,95,35200,85.02415458937197,6
0.05,414,93,35293,85.0433734939759,8
0.05,415,27,35320,84.90384615384616,6
0.05,416,94,35414,84.92565947242207,7
0.05,417,91,35505,84.9401913875598,10
0.05,418,94,35599,84.9618138424821,7
0.05,419,96,35695,84.98809523809524,6
0.05,420,92,35787,85.00475059382423,9
0.05,421,94,35881,85.0260663507109,8
0.05,422,95,35976,85.04964539007092,6
0.05,423,91,36067,85.06367924528301,10
0.05,424,95,36162,85.08705882352942,6
0.05,425,93,36255,85.1056338028169,8
0.05,426,93,36348,85.12412177985948,8
0.05,427,93,36441,85.14252336448598,8
0.05,428,93,36534,85.16083916083916,8
0.05,429,27,36561,85.02558139534884,6
0.05,430,95,36656,85.04872389791183,6
0.05,431,89,36745,85.05787037037037,12
0.05,432,25,36770,84.91916859122402,8
0.05,433,92,36862,84.93548387096774,9
0.05,434,95,36957,84.95862068965518,6
0.05,435,88,37045,84.96559633027523,13
0.05,436,95,37140,84.98855835240275,6
0.05,437,92,37232,85.00456621004567,10
0.05,438,90,37322,85.01594533029613,11
0.05,439,22,37344,84.87272727272727,10
0.05,440,93,37437,84.89115646258503,8
0.05,441,94,37531,84.91176470588235,7
0.05,442,94,37625,84.93227990970655,7
0.05,443,93,37718,84.95045045045045,8
0.05,444,96,37814,84.9752808988764,6
0.05,445,92,37906,84.99103139013452,9
0.05,446,94,38000,85.01118568232663,7
0.05,447,92,38092,85.02678571428571,10
0.05,448,95,38187,85.04899777282851,6
0.05,449,96,38283,85.07333333333334,6
0.05,450,27,38310,84.94456762749445,6
0.05,451,94,38404,84.96460176991151,7
0.05,452,96,38500,84.98896247240619,6
0.05,453,93,38593,85.00660792951543,8
0.05,454,94,38687,85.02637362637363,7
0.05,455,94,38781,85.04605263157895,7
0.05,456,96,38877,85.07002188183807,6
0.05,457,96,38973,85.0938864628821,6
0.05,458,94,39067,85.11328976034858,7
0.05,459,93,39160,85.1304347826087,8
0.05,460,94,39254,85.14967462039046,7
0.05,461,93,39347,85.16666666666667,8
0.05,462,96,39443,85.19006479481641,6
0.05,463,92,39535,85.20474137931035,9
0.05,464,92,39627,85.21935483870968,9
0.05,465,91,39718,85.23175965665236,11
0.05,466,95,39813,85.2526766595289,6
0.05,467,93,39906,85.26923076923077,8
0.05,468,95,40001,85.28997867803838,6
0.05,469,96,40097,85.31276595744681,6
0.05,470,92,40189,85.32696390658174,9
0.05,471,92,40281,85.34110169491525,9
0.05,472,96,40377,85.36363636363636,6
0.05,473,93,40470,85.37974683544304,9
0.05,474,92,40562,85.39368421052632,9
0.05,475,95,40657,85.41386554621849,6
0.05,476,95,40752,85.43396226415095,8
0.05,477,93,40845,85.44979079497908,8
0.05,478,94,40939,85.46764091858037,10
0.05,479,96,41035,85.48958333333333,6
0.05,480,96,41131,85.51143451143452,6
0.05,481,94,41225,85.52904564315352,7
0.05,482,93,41318,85.54451345755693,8
0.05,483,94,41412,85.56198347107438,7
0.05,484,92,41504,85.57525773195876,9
0.05,485,96,41600,85.59670781893004,6
0.05,486,94,41694,85.61396303901438,8
0.05,487,92,41786,85.62704918032787,9
0.05,488,94,41880,85.6441717791411,7
0.05,489,93,41973,85.65918367346939,8
0.05,490,93,42066,85.67413441955193,8
0.05,491,96,42162,85.6951219512195,6
0.05,492,94,42256,85.71196754563894,8
0.05,493,96,42352,85.7327935222672,6
0.05,494,95,42447,85.75151515151515,7
0.05,495,94,42541,85.76814516129032,7
0.05,496,92,42633,85.78068410462777,9
0.05,497,91,42724,85.79116465863454,10
0.05,498,95,42819,85.80961923847696,8
0.05,499,92,42911,85.822,9
0.05,500,96,43007,85.84231536926147,6
0.05,501,96,43103,85.86254980079681,6
0.05,502,94,43197,85.87872763419483,7
0.05,503,93,43290,85.89285714285714,8
0.05,504,85,43375,85.89108910891089,17
0.05,505,92,43467,85.90316205533597,9
0.05,506,94,43561,85.91913214990139,7
0.05,507,92,43653,85.93110236220473,9
0.05,508,94,43747,85.94695481335953,7
0.05,509,96,43843,85.96666666666667,6
0.05,510,25,43868,85.84735812133073,7
0.05,511,96,43964,85.8671875,6
0.05,512,96,44060,85.8869395711501,6
0.05,513,94,44154,85.90272373540856,7
0.05,514,94,44248,85.91844660194175,7
0.05,515,94,44342,85.93410852713178,7
0.05,516,93,44435,85.94777562862669,8
0.05,517,96,44531,85.96718146718146,6
0.05,518,96,44627,85.98651252408477,6
0.05,519,95,44722,86.00384615384615,6
0.05,520,92,44814,86.01535508637237,10
0.05,521,95,44909,86.03256704980843,6
0.05,522,25,44934,85.91586998087953,7
0.05,523,91,45025,85.92557251908397,10
0.05,524,91,45116,85.93523809523809,10
0.05,525,96,45212,85.95437262357414,6
0.05,526,90,45302,85.96204933586338,11
0.05,527,92,45394,85.97348484848484,9
0.05,528,94,45488,85.98865784499054,7
0.05,529,93,45581,86.00188679245284,8
0.05,530,96,45677,86.02071563088512,6
0.05,531,96,45773,86.03947368421052,6
0.05,532,94,45867,86.05440900562851,7
0.05,533,94,45961,86.0692883895131,7
0.05,534,94,46055,86.08411214953271,7
0.05,535,96,46151,86.1026119402985,6
0.05,536,96,46247,86.12104283054003,6
0.05,537,91,46338,86.13011152416357,10
0.05,538,95,46433,86.14656771799629,6
0.05,539,94,46527,86.16111111111111,7
0.05,540,94,46621,86.17560073937153,7
0.05,541,94,46715,86.19003690036901,7
0.05,542,93,46808,86.20257826887661,8
0.05,543,94,46902,86.21691176470588,8
0.05,544,95,46997,86.23302752293579,6
0.05,545,95,47092,86.24908424908425,6
0.05,546,94,47186,86.26325411334552,7
0.05,547,93,47279,86.27554744525547,8
0.05,548,94,47373,86.2896174863388,7
0.05,549,95,47468,86.30545454545455,6
0.05,550,94,47562,86.31941923774954,7
0.05,551,17,47579,86.19384057971014,15
0.05,552,91,47670,86.20253164556962,10
0.05,553,91,47761,86.21119133574007,10
0.05,554,94,47855,86.22522522522523,8
0.05,555,27,47882,86.11870503597122,6
0.05,556,91,47973,86.12746858168761,10
0.05,557,94,48067,86.1415770609319,7
0.05,558,94,48161,86.15563506261181,7
0.05,559,25,48186,86.04642857142858,8
0.05,560,94,48280,86.06060606060606,7
0.05,561,88,48368,86.06405693950178,13
0.05,562,93,48461,86.07637655417406,8
0.05,563,93,48554,86.08865248226951,8
0.05,564,94,48648,86.10265486725663,9
0.05,565,96,48744,86.12014134275618,6
0.05,566,89,48833,86.1252204585538,13
0.05,567,94,48927,86.13908450704226,7
0.05,568,96,49023,86.15641476274165,6
0.05,569,86,49109,86.1561403508772,15
0.05,570,94,49203,86.16987740805604,7
0.05,571,91,49294,86.17832167832168,10
0.05,572,95,49389,86.19371727748691,6
0.05,573,95,49484,86.20905923344948,6
0.05,574,94,49578,86.22260869565217,7
0.05,575,95,49673,86.23784722222223,6
0.05,576,93,49766,86.24956672443675,8
0.05,577,95,49861,86.26470588235294,6
0.05,578,94,49955,86.27806563039724,7
0.05,579,93,50048,86.28965517241379,8
0.05,580,95,50143,86.30464716006885,6
0.05,581,94,50237,86.31786941580756,8
0.05,582,95,50332,86.3327615780446,6
0.05,583,95,50427,86.34760273972603,6
0.05,584,23,50450,86.23931623931624,10
0.05,585,88,50538,86.24232081911263,13
0.05,586,95,50633,86.25724020442931,6
0.05,587,94,50727,86.2704081632653,7
0.05,588,93,50820,86.28183361629881,8
0.05,589,94,50914,86.29491525423728,7
0.05,590,94,51008,86.30795262267344,7
0.05,591,94,51102,86.32094594594595,7
0.05,592,93,51195,86.33220910623946,8
0.05,593,91,51286,86.34006734006734,10
0.05,594,92,51378,86.34957983193277,9
0.05,595,96,51474,86.36577181208054,6
0.05,596,95,51569,86.38023450586265,6
0.05,597,95,51664,86.39464882943143,8
0.05,598,92,51756,86.40400667779633,9
0.05,599,94,51850,86.41666666666667,7
0.05,600,94,51944,86.42928452579035,7
0.05,601,95,52039,86.44352159468438,6
0.05,602,94,52133,86.45605306799337,8
0.05,603,96,52229,86.47185430463576,6
0.05,604,92,52321,86.48099173553719,9
0.05,605,27,52348,86.38283828382838,6
0.05,606,93,52441,86.39373970345964,9
0.05,607,95,52536,86.40789473684211,6
0.05,608,94,52630,86.42036124794745,7
0.05,609,95,52725,86.43442622950819,7
0.05,610,96,52821,86.45008183306055,6
0.05,611,94,52915,86.4624183006536,7
0.05,612,95,53010,86.4763458401305,7
0.05,613,96,53106,86.49185667752442,6
0.05,614,26,53132,86.39349593495935,6
0.05,615,94,53226,86.40584415584415,7
0.05,616,93,53319,86.4165316045381,8
0.05,617,91,53410,86.42394822006473,10
0.05,618,96,53506,86.43941841680129,6
0.05,619,94,53600,86.45161290322581,7
0.05,620,96,53696,86.4669887278583,6
0.05,621,92,53788,86.47588424437299,9
0.05,622,93,53881,86.48635634028892,8
0.05,623,93,53974,86.49679487179488,8
0.05,624,95,54069,86.5104,7
0.05,625,95,54164,86.52396166134186,7
0.05,626,94,54258,86.53588516746412,7
0.05,627,95,54353,86.54936305732484,7
0.05,628,92,54445,86.55802861685214,9
0.05,629,94,54539,86.56984126984128,7
0.05,630,93,54632,86.58003169572108,8
0.05,631,26,54658,86.48417721518987,7
0.05,632,92,54750,86.49289099526067,9
0.05,633,94,54844,86.50473186119874,7
0.05,634,94,54938,86.51653543307087,7
0.05,635,95,55033,86.52987421383648,6
0.05,636,96,55129,86.5447409733124,6
0.05,637,94,55223,86.5564263322884,7
0.05,638,94,55317,86.5680751173709,7
0.05,639,94,55411,86.5796875,7
0.05,640,93,55504,86.58970358814352,8
0.05,641,94,55598,86.601246105919,7
0.05,642,92,55690,86.60964230171074,9
0.05,643,95,55785,86.62267080745342,6
0.05,644,96,55881,86.63720930232559,6
0.05,645,92,55973,86.64551083591331,9
0.05,646,94,56067,86.65687789799073,7
0.05,647,96,56163,86.67129629629629,6
0.05,648,92,56255,86.67950693374422,9
0.05,649,95,56350,86.6923076923077,6
0.05,650,93,56443,86.70199692780338,8
0.05,651,95,56538,86.71472392638037,6
0.05,652,24,56562,86.6186830015314,8
0.05,653,93,56655,86.62844036697248,8
0.05,654,95,56750,86.6412213740458,6
0.05,655,95,56845,86.65396341463415,6
0.05,656,94,56939,86.66514459665144,7
0.05,657,27,56966,86.57446808510639,6
0.05,658,89,57055,86.57814871016691,12
0.05,659,95,57150,86.5909090909091,7
0.05,660,92,57242,86.59909228441755,9
0.05,661,95,57337,86.6117824773414,6
0.05,662,94,57431,86.62292609351432,7
0.05,663,94,57525,86.63403614457832,7
0.05,664,96,57621,86.64812030075188,6
0.05,665,92,57713,86.65615615615616,9
0.05,666,96,57809,86.67016491754123,6
0.05,667,92,57901,86.67814371257485,9
0.05,668,22,57923,86.5814648729447,10
0.05,669,94,58017,86.59253731343284,7
0.05,670,95,58112,86.60506706408346,6
0.05,671,93,58205,86.61458333333333,8
0.05,672,25,58230,86.52303120356612,8
0.05,673,96,58326,86.53709198813057,6
0.05,674,96,58422,86.55111111111111,6
0.05,675,86,58508,86.55029585798816,15
0.05,676,95,58603,86.56277695716396,6
0.05,677,94,58697,86.57374631268436,7
0.05,678,96,58793,86.58762886597938,6
0.05,679,24,58817,86.49558823529412,9
0.05,680,94,58911,86.50660792951543,8
0.05,681,94,59005,86.51759530791789,7
0.05,682,94,59099,86.5285505124451,7
0.05,683,89,59188,86.53216374269006,12
0.05,684,92,59280,86.54014598540147,9
0.05,685,96,59376,86.5539358600583,6
0.05,686,93,59469,86.56331877729258,8
0.05,687,93,59562,86.57267441860465,9
0.05,688,96,59658,86.58635703918723,6
0.05,689,95,59753,86.59855072463768,6
0.05,690,94,59847,86.60926193921853,7
0.05,691,93,59940,86.61849710982659,8
0.05,692,96,60036,86.63203463203463,6
0.05,693,95,60131,86.64409221902017,6
0.05,694,93,60224,86.65323741007194,8
0.05,695,95,60319,86.66522988505747,6
0.05,696,94,60413,86.67575322812051,7
0.05,697,93,60506,86.68481375358166,8
0.05,698,95,60601,86.6967095851216,7
0.05,699,92,60693,86.70428571428572,9
0.05,700,96,60789,86.71754636233952,6
0.05,701,90,60879,86.72222222222223,11
0.05,702,96,60975,86.73541963015647,6
0.05,703,93,61068,86.74431818181819,8
0.05,704,94,61162,86.75460992907801,8
0.05,705,96,61258,86.76770538243626,6
0.05,706,95,61353,86.77934936350778,7
0.05,707,94,61447,86.78954802259886,7
0.05,708,95,61542,86.80112834978843,6
0.05,709,94,61636,86.8112676056338,7
0.05,710,92,61728,86.81856540084388,9
0.05,711,94,61822,86.82865168539325,8
0.05,712,93,61915,86.83730715287517,8
0.05,713,94,62009,86.84733893557423,8
0.05,714,94,62103,86.85734265734266,7
0.05,715,96,62199,86.87011173184358,6
0.05,716,95,62294,86.88145048814505,6
0.05,717,93,62387,86.8899721448468,8
0.05,718,94,62481,86.89986091794158,7
0.05,719,94,62575,86.90972222222223,7
0.05,720,92,62667,86.91678224687934,9
0.05,721,90,62757,86.92105263157895,11
0.05,722,93,62850,86.92946058091286,8
0.05,723,95,62945,86.94060773480663,6
0.05,724,94,63039,86.9503448275862,7
0.05,725,94,63133,86.96005509641873,7
0.05,726,92,63225,86.96698762035763,9
0.05,727,90,63315,86.97115384615384,11
0.05,728,96,63411,86.98353909465021,6
0.05,729,93,63504,86.99178082191781,8
0.05,730,92,63596,86.99863201094391,9
0.05,731,96,63692,87.01092896174863,6
0.05,732,96,63788,87.0231923601637,6
0.05,733,94,63882,87.03269754768392,7
0.05,734,92,63974,87.03945578231293,9
0.05,735,90,64064,87.04347826086956,11
0.05,736,27,64091,86.96200814111262,6
0.05,737,94,64185,86.97154471544715,7
0.05,738,94,64279,86.98105548037888,7
0.05,739,93,64372,86.98918918918919,8
0.05,740,91,64463,86.99460188933872,10
0.05,741,92,64555,87.00134770889488,9
0.05,742,95,64650,87.0121130551817,6
0.05,743,96,64746,87.0241935483871,6
0.05,744,94,64840,87.03355704697987,7
0.05,745,96,64936,87.0455764075067,6
0.05,746,96,65032,87.05756358768407,6
0.05,747,94,65126,87.06684491978609,7
0.05,748,94,65220,87.07610146862483,7
0.05,749,26,65246,86.99466666666666,7
0.05,750,25,65271,86.9121171770972,8
0.05,751,94,65365,86.92154255319149,8
0.05,752,96,65461,86.933598937583,6
0.05,753,94,65555,86.94297082228117,7
0.05,754,94,65649,86.95231788079471,7
0.05,755,96,65745,86.96428571428571,6
0.05,756,93,65838,86.97225891677675,8
0.05,757,94,65932,86.98153034300792,7
0.05,758,93,66025,86.98945981554677,8
0.05,759,93,66118,86.99736842105263,9
0.05,760,92,66210,87.00394218134034,9
0.05,761,94,66304,87.01312335958005,8
0.05,762,96,66400,87.02490170380078,6
0.05,763,94,66494,87.03403141361257,7
0.05,764,91,66585,87.03921568627452,10
0.05,765,94,66679,87.04830287206266,7
0.05,766,94,66773,87.0573663624511,7
0.05,767,93,66866,87.06510416666667,8
0.05,768,94,66960,87.074122236671,7
0.05,769,93,67053,87.08181818181818,8
0.05,770,94,67147,87.09079118028535,7
0.05,771,94,67241,87.09974093264249,7
0.05,772,96,67337,87.11125485122898,6
0.05,773,93,67430,87.11886304909561,8
0.05,774,95,67525,87.12903225806451,6
0.05,775,95,67620,87.13917525773196,6
0.05,776,96,67716,87.15057915057915,6
0.05,777,89,67805,87.15295629820051,12
0.05,778,92,67897,87.15917843388961,9
0.05,779,95,67992,87.16923076923077,6
0.05,780,94,68086,87.17797695262485,7
0.05,781,89,68175,87.18030690537084,12
0.05,782,95,68270,87.19029374201789,6
0.05,783,95,68365,87.20025510204081,6
0.05,784,92,68457,87.20636942675159,9
0.05,785,94,68551,87.2150127226463,7
0.05,786,96,68647,87.2261753494282,6
0.05,787,92,68739,87.23223350253807,9
0.05,788,24,68763,87.15209125475285,9
0.05,789,96,68859,87.16329113924051,6
0.05,790,94,68953,87.17193426042984,7
0.05,791,94,69047,87.18055555555556,7
0.05,792,93,69140,87.18789407313997,8
0.05,793,94,69234,87.19647355163728,8
0.05,794,88,69322,87.19748427672955,13
0.05,795,94,69416,87.20603015075378,7
0.05,796,96,69512,87.21706398996236,6
0.05,797,96,69608,87.2280701754386,6
0.05,798,95,69703,87.2377972465582,6
0.05,799,93,69796,87.245,8
0.05,800,93,69889,87.2521847690387,8
0.05,801,94,69983,87.26059850374065,7
0.05,802,92,70075,87.266500622665,9
0.05,803,95,70170,87.27611940298507,6
0.05,804,92,70262,87.28198757763975,9
0.05,805,92,70354,87.287841191067,9
0.05,806,90,70444,87.2912019826518,11
0.05,807,92,70536,87.29702970297029,9
0.05,808,93,70629,87.30407911001237,8
0.05,809,95,70724,87.31358024691357,6
0.05,810,94,70818,87.32182490752157,7
0.05,811,94,70912,87.33004926108374,7
0.05,812,94,71006,87.33825338253382,9
0.05,813,94,71100,87.34643734643734,7
0.05,814,96,71196,87.35705521472393,6
0.05,815,92,71288,87.36274509803921,9
0.05,816,91,71379,87.3671970624235,10
0.05,817,94,71473,87.37530562347189,7
0.05,818,94,71567,87.38339438339439,7
0.05,819,91,71658,87.38780487804878,10
0.05,820,96,71754,87.39829476248478,6
0.05,821,94,71848,87.40632603406326,7
0.05,822,95,71943,87.41555285540704,6
0.05,823,94,72037,87.42354368932038,7
0.05,824,93,72130,87.43030303030304,8
0.05,825,91,72221,87.43462469733656,10
0.05,826,95,72316,87.44377267230955,6
0.05,827,94,72410,87.45169082125604,7
0.05,828,94,72504,87.45958986731002,7
0.05,829,92,72596,87.46506024096385,9
0.05,830,94,72690,87.47292418772564,7
0.05,831,95,72785,87.48197115384616,6
0.05,832,94,72879,87.48979591836735,7
0.05,833,93,72972,87.49640287769785,8
0.05,834,83,73055,87.49101796407186,18
0.05,835,94,73149,87.4988038277512,8
0.05,836,27,73176,87.42652329749104,6
0.05,837,96,73272,87.43675417661098,6
0.05,838,94,73366,87.44457687723481,7
0.05,839,93,73459,87.45119047619048,9
0.05,840,94,73553,87.4589774078478,7
0.05,841,93,73646,87.46555819477435,9
0.05,842,94,73740,87.47330960854093,7
0.05,843,94,73834,87.48104265402844,7
0.05,844,93,73927,87.48757396449705,8
0.05,845,95,74022,87.49645390070921,7
0.05,846,92,74114,87.5017709563164,9
0.05,847,96,74210,87.51179245283019,6
0.05,848,92,74302,87.5170789163722,9
0.05,849,95,74397,87.52588235294118,6
0.05,850,91,74488,87.52996474735605,10
0.05,851,93,74581,87.53638497652582,8
0.05,852,94,74675,87.54396248534584,7
0.05,853,95,74770,87.55269320843091,6
0.05,854,95,74865,87.56140350877193,6
0.05,855,93,74958,87.5677570093458,8
0.05,856,93,75051,87.57409568261377,8
0.05,857,96,75147,87.58391608391608,6
0.05,858,93,75240,87.59022118742725,8
0.05,859,94,75334,87.59767441860465,7
0.05,860,94,75428,87.60511033681766,7
0.05,861,93,75521,87.61136890951276,9
0.05,862,94,75615,87.61877172653534,7
0.05,863,96,75711,87.62847222222223,6
0.05,864,93,75804,87.63468208092486,8
0.05,865,92,75896,87.63972286374134,9
0.05,866,94,75990,87.6470588235294,7
0.05,867,92,76082,87.65207373271889,9
0.05,868,92,76174,87.65707710011507,9
0.05,869,94,76268,87.66436781609195,7
0.05,870,94,76362,87.67164179104478,7
0.05,871,93,76455,87.67775229357798,8
0.05,872,96,76551,87.6872852233677,6
0.05,873,92,76643,87.69221967963387,9
0.05,874,93,76736,87.69828571428572,8
0.05,875,95,76831,87.70662100456622,6
0.05,876,96,76927,87.71607753705815,6
0.05,877,94,77021,87.72323462414579,7
0.05,878,93,77114,87.72923777019341,8
0.05,879,93,77207,87.73522727272727,8
0.05,880,25,77232,87.66401816118048,8
0.05,881,92,77324,87.66893424036282,10
0.05,882,96,77420,87.67836919592298,6
0.05,883,93,77513,87.68438914027149,8
0.05,884,96,77609,87.69378531073447,6
0.05,885,94,77703,87.70090293453724,7
0.05,886,93,77796,87.70687711386697,8
0.05,887,93,77889,87.71283783783784,8
0.05,888,94,77983,87.7199100112486,7
0.05,889,96,78079,87.72921348314607,6
0.05,890,92,78171,87.73400673400674,9
0.05,891,96,78267,87.7432735426009,6
0.05,892,94,78361,87.75027995520716,7
0.05,893,95,78456,87.75838926174497,6
0.05,894,94,78550,87.76536312849161,7
0.05,895,93,78643,87.77120535714286,8
0.05,896,91,78734,87.77480490523969,10
0.05,897,96,78830,87.78396436525613,6
0.05,898,93,78923,87.78976640711902,8
0.05,899,92,79015,87.79444444444445,9
0.05,900,95,79110,87.80244173140954,6
0.05,901,94,79204,87.80931263858093,7
0.05,902,92,79296,87.81395348837209,9
0.05,903,92,79388,87.81858407079646,9
0.05,904,93,79481,87.82430939226519,9
0.05,905,89,79570,87.82560706401766,12
0.05,906,92,79662,87.83020948180815,9
0.05,907,94,79756,87.83700440528635,7
0.05,908,93,79849,87.84268426842684,8
0.05,909,94,79943,87.84945054945055,7
0.05,910,93,80036,87.85510428100989,8
0.05,911,90,80126,87.85745614035088,11
0.05,912,94,80220,87.86418400876232,7
0.05,913,93,80313,87.86980306345733,8
0.05,914,96,80409,87.87868852459016,6
0.05,915,94,80503,87.8853711790393,7
0.05,916,23,80526,87.81461286804799,10
0.05,917,93,80619,87.8202614379085,8
0.05,918,94,80713,87.82698585418933,7
0.05,919,94,80807,87.83369565217392,7
0.05,920,-45,80762,87.68946796959827,10
0.05,921,95,80857,87.69739696312364,6
0.05,922,94,80951,87.70422535211267,7
0.05,923,27,80978,87.63852813852814,6
0.05,924,92,81070,87.64324324324325,9
0.05,925,93,81163,87.64902807775378,8
0.05,926,96,81259,87.65803667745415,6
0.05,927,95,81354,87.66594827586206,6
0.05,928,94,81448,87.67276641550053,7
0.05,929,90,81538,87.6752688172043,11
0.05,930,96,81634,87.6842105263158,6
0.05,931,93,81727,87.68991416309012,8
0.05,932,95,81822,87.69774919614147,6
0.05,933,94,81916,87.70449678800857,7
0.05,934,95,82011,87.71229946524065,6
0.05,935,94,82105,87.71901709401709,7
0.05,936,94,82199,87.7257203842049,7
0.05,937,94,82293,87.73240938166312,7
0.05,938,91,82384,87.73588924387647,10
0.05,939,24,82408,87.66808510638297,9
0.05,940,90,82498,87.67056323060574,12
0.05,941,93,82591,87.67622080679405,9
0.05,942,94,82685,87.6829268292683,7
0.05,943,92,82777,87.6875,9
0.05,944,94,82871,87.6941798941799,7
0.05,945,92,82963,87.69873150105708,9
0.05,946,92,83055,87.70327349524815,9
0.05,947,95,83150,87.71097046413502,6
0.05,948,94,83244,87.71759747102213,7
0.05,949,96,83340,87.72631578947369,6
0.05,950,95,83435,87.73396424815984,7
0.05,951,94,83529,87.7405462184874,7
0.05,952,93,83622,87.74606505771249,8
0.05,953,93,83715,87.75157232704403,8
0.05,954,94,83809,87.75811518324608,7
0.05,955,95,83904,87.76569037656904,6
0.05,956,25,83929,87.70010449320795,8
0.05,957,94,84023,87.70668058455115,7
0.05,958,94,84117,87.71324296141815,7
0.05,959,93,84210,87.71875,8
0.05,960,94,84304,87.72528616024974,7
0.05,961,91,84395,87.72869022869023,10
0.05,962,90,84485,87.73104880581516,11
0.05,963,95,84580,87.73858921161826,6
0.05,964,94,84674,87.74507772020725,7
0.05,965,94,84768,87.75155279503106,7
0.05,966,94,84862,87.75801447776628,7
0.05,967,94,84956,87.76446280991736,7
0.05,968,95,85051,87.7719298245614,6
0.05,969,94,85145,87.77835051546391,8
0.05,970,94,85239,87.7847579814624,7
0.05,971,94,85333,87.79115226337449,7
0.05,972,94,85427,87.79753340184995,7
0.05,973,95,85522,87.80492813141684,7
0.05,974,96,85618,87.81333333333333,6
0.05,975,94,85712,87.81967213114754,7
0.05,976,94,85806,87.82599795291709,8
0.05,977,94,85900,87.8323108384458,7
0.05,978,93,85993,87.83758937691522,8
0.05,979,95,86088,87.84489795918367,6
0.05,980,23,86111,87.77879714576962,9
0.05,981,94,86205,87.78513238289206,7
0.05,982,94,86299,87.79145473041709,7
0.05,983,94,86393,87.79776422764228,7
0.05,984,93,86486,87.80304568527919,8
0.05,985,94,86580,87.80933062880325,8
0.05,986,94,86674,87.81560283687944,7
0.05,987,22,86696,87.74898785425101,11
0.05,988,93,86789,87.75429726996967,8
0.05,989,88,86877,87.75454545454545,14
0.05,990,95,86972,87.76185671039354,6
0.05,991,91,87063,87.76512096774194,10
0.05,992,94,87157,87.77139979859012,7
0.05,993,95,87252,87.77867203219316,6
0.05,994,92,87344,87.78291457286433,9
0.05,995,92,87436,87.78714859437751,9
0.05,996,92,87528,87.7913741223671,9
0.05,997,92,87620,87.79559118236473,9
0.05,998,95,87715,87.8028028028028,7
0.05,999,94,87809,87.809,7
0.05,1000,94,87903,87.81518481518482,7
0.05,1001,92,87995,87.81936127744511,9
0.05,1002,94,88089,87.82552342971087,7
0.05,1003,92,88181,87.8296812749004,9
0.05,1004,88,88269,87.82985074626866,13
0.05,1005,95,88364,87.83697813121272,6
0.05,1006,94,88458,87.84309831181729,8
0.05,1007,-47,88411,87.70932539682539,11
0.05,1008,94,88505,87.71555996035679,7
0.05,1009,93,88598,87.72079207920792,8
0.05,1010,92,88690,87.72502472799209,9
0.05,1011,90,88780,87.72727272727273,11
0.05,1012,92,88872,87.7314906219151,9
0.05,1013,95,88967,87.73865877712032,6
0.05,1014,95,89062,87.74581280788178,6
0.05,1015,94,89156,87.75196850393701,7
0.05,1016,95,89251,87.75909537856441,6
0.05,1017,95,89346,87.76620825147347,6
0.05,1018,92,89438,87.7703631010795,9
0.05,1019,95,89533,87.77745098039216,6
0.05,1020,91,89624,87.78060724779628,10
0.05,1021,94,89718,87.7866927592955,8
0.05,1022,94,89812,87.79276637341154,7
0.05,1023,94,89906,87.798828125,7
0.05,1024,96,90002,87.80682926829269,6
0.05,1025,94,90096,87.81286549707602,7
0.05,1026,94,90190,87.8188899707887,8
0.05,1027,93,90283,87.82392996108949,8
0.05,1028,93,90376,87.82896015549076,8
0.05,1029,94,90470,87.83495145631068,7
0.05,1030,93,90563,87.83996120271581,8
0.05,1031,92,90655,87.84399224806202,9
0.05,1032,92,90747,87.84801548886738,9
0.05,1033,89,90836,87.84912959381045,12
0.05,1034,94,90930,87.85507246376811,7
0.05,1035,94,91024,87.86100386100387,7
0.05,1036,93,91117,87.86595949855352,8
0.05,1037,90,91207,87.8680154142582,11
0.05,1038,96,91303,87.87584215591916,6
0.05,1039,94,91397,87.88173076923077,7
0.05,1040,96,91493,87.8895292987512,6
0.05,1041,94,91587,87.8953934740883,7
0.05,1042,93,91680,87.90028763183126,8
0.05,1043,95,91775,87.90708812260536,6
0.05,1044,96,91871,87.91483253588517,6
0.05,1045,92,91963,87.9187380497132,10
0.05,1046,93,92056,87.92359121298949,8
0.05,1047,21,92077,87.85973282442748,11
0.05,1048,94,92171,87.86558627264061,7
0.05,1049,95,92266,87.87238095238095,6
0.05,1050,95,92361,87.8791627021884,7
0.05,1051,96,92457,87.88688212927757,6
0.05,1052,94,92551,87.89268755935423,7
0.05,1053,96,92647,87.90037950664137,6
0.05,1054,93,92740,87.90521327014218,9
0.05,1055,93,92833,87.91003787878788,9
0.05,1056,91,92924,87.91296121097446,10
0.05,1057,94,93018,87.91871455576559,7
0.05,1058,95,93113,87.92540132200189,6
0.05,1059,17,93130,87.85849056603773,15
0.05,1060,94,93224,87.86427898209237,7
0.05,1061,95,93319,87.87099811676083,6
0.05,1062,95,93414,87.87770460959548,6
0.05,1063,94,93508,87.88345864661655,7
0.05,1064,96,93604,87.89107981220657,6
0.05,1065,96,93700,87.89868667917449,6
0.05,1066,94,93794,87.90440487347703,7
0.05,1067,94,93888,87.91011235955057,7
0.05,1068,95,93983,87.91674462114125,6
0.05,1069,90,94073,87.91869158878505,11
0.05,1070,19,94092,87.85434173669468,13
0.05,1071,94,94186,87.86007462686567,7
0.05,1072,94,94280,87.86579683131407,7
0.05,1073,94,94374,87.87150837988827,7
0.05,1074,94,94468,87.87720930232558,7
0.05,1075,25,94493,87.81877323420075,8
0.05,1076,21,94514,87.75673166202414,11
0.05,1077,93,94607,87.76159554730984,8
0.05,1078,94,94701,87.76737720111214,8
0.05,1079,91,94792,87.77037037037037,10
0.05,1080,94,94886,87.77613320999075,7
0.05,1081,95,94981,87.78280961182995,6
0.05,1082,92,95073,87.78670360110803,9
0.05,1083,95,95168,87.79335793357933,6
0.05,1084,92,95260,87.79723502304148,10
0.05,1085,96,95356,87.80478821362799,6
0.05,1086,94,95450,87.81048758049678,7
0.05,1087,94,95544,87.81617647058823,7
0.05,1088,95,95639,87.82277318640955,7
0.05,1089,94,95733,87.82844036697247,7
0.05,1090,94,95827,87.83409715857012,7
0.05,1091,25,95852,87.77655677655677,8
0.05,1092,92,95944,87.7804208600183,9
0.05,1093,95,96039,87.78702010968921,6
0.05,1094,94,96133,87.79269406392694,7
0.05,1095,96,96229,87.80018248175182,7
0.05,1096,94,96323,87.80583409298086,8
0.05,1097,21,96344,87.74499089253187,11
0.05,1098,94,96438,87.75068243858053,7
0.05,1099,93,96531,87.75545454545454,8
0.05,1100,95,96626,87.76203451407811,6
0.05,1101,95,96721,87.76860254083485,7
0.05,1102,94,96815,87.77425203989121,7
0.05,1103,92,96907,87.77807971014492,9
0.05,1104,96,97003,87.78552036199095,6
0.05,1105,94,97097,87.79113924050633,7
0.05,1106,92,97189,87.79494128274617,9
0.05,1107,93,97282,87.79963898916968,8
0.05,1108,92,97374,87.8034265103697,9
0.05,1109,95,97469,87.8099099099099,6
0.05,1110,94,97563,87.81548154815482,7
0.05,1111,94,97657,87.82104316546763,7
0.05,1112,94,97751,87.82659478885894,7
0.05,1113,94,97845,87.83213644524237,7
0.05,1114,94,97939,87.83766816143498,8
0.05,1115,96,98035,87.84498207885305,6
0.05,1116,96,98131,87.85228290062668,6
0.05,1117,92,98223,87.85599284436493,9
0.05,1118,95,98318,87.86237712243074,6
0.05,1119,95,98413,87.86875,6
0.05,1120,95,98508,87.87511150758252,6
0.05,1121,25,98533,87.81907308377896,8
0.05,1122,93,98626,87.82368655387356,8
0.05,1123,94,98720,87.82918149466192,7
0.05,1124,94,98814,87.83466666666666,7
0.05,1125,95,98909,87.84103019538188,6
0.05,1126,96,99005,87.84826974267968,6
0.05,1127,93,99098,87.85283687943263,8
0.05,1128,94,99192,87.85828166519043,7
0.05,1129,94,99286,87.86371681415929,7
0.05,1130,93,99379,87.868258178603,8
0.05,1131,94,99473,87.87367491166077,7
0.05,1132,94,99567,87.87908208296558,7
0.05,1133,89,99656,87.88007054673722,12
0.05,1134,94,99750,87.88546255506608,7
0.05,1135,94,99844,87.89084507042253,7
0.05,1136,96,99940,87.89797713280564,6
0.05,1137,95,100035,87.90421792618629,6
0.05,1138,90,100125,87.90605794556629,11
0.05,1139,94,100219,87.91140350877193,7
0.05,1140,95,100314,87.91761612620509,6
0.05,1141,95,100409,87.92381786339755,6
0.05,1142,88,100497,87.9238845144357,13
0.05,1143,96,100593,87.93094405594405,6
0.05,1144,94,100687,87.93624454148471,7
0.05,1145,94,100781,87.94153577661432,7
0.05,1146,93,100874,87.94594594594595,8
0.05,1147,92,100966,87.94947735191637,9
0.05,1148,94,101060,87.95474325500435,7
0.05,1149,94,101154,87.96,7
0.05,1150,93,101247,87.96437880104257,8
0.05,1151,94,101341,87.96961805555556,7
0.05,1152,93,101434,87.97398091934085,8
0.05,1153,94,101528,87.9792027729636,7
0.05,1154,92,101620,87.98268398268398,9
0.05,1155,93,101713,87.98702422145328,8
0.05,1156,94,101807,87.99222126188418,7
0.05,1157,94,101901,87.99740932642487,7
0.05,1158,93,101994,88.00172562553925,8
0.05,1159,93,102087,88.00603448275862,8
0.05,1160,94,102181,88.01119724375539,7
0.05,1161,95,102276,88.0172117039587,7
0.05,1162,95,102371,88.02321582115219,6
0.05,1163,94,102465,88.02835051546391,8
0.05,1164,93,102558,88.03261802575108,8
0.05,1165,94,102652,88.0377358490566,7
0.05,1166,91,102743,88.04027420736932,10
0.05,1167,94,102837,88.04537671232876,7
0.05,1168,94,102931,88.05047048759624,7
0.05,1169,96,103027,88.05726495726496,6
0.05,1170,94,103121,88.06233988044407,8
0.05,1171,95,103216,88.06825938566553,6
0.05,1172,95,103311,88.07416879795396,6
0.05,1173,94,103405,88.07921635434413,8
0.05,1174,94,103499,88.08425531914894,7
0.05,1175,93,103592,88.08843537414965,8
0.05,1176,94,103686,88.09345794392523,7
0.05,1177,95,103781,88.0993208828523,6
0.05,1178,94,103875,88.10432569974554,7
0.05,1179,94,103969,88.10932203389831,7
0.05,1180,95,104064,88.1151566469094,6
0.05,1181,95,104159,88.12098138747885,6
0.05,1182,94,104253,88.12595097210482,7
0.05,1183,96,104349,88.13260135135135,6
0.05,1184,93,104442,88.1367088607595,8
0.05,1185,96,104538,88.1433389544688,6
0.05,1186,94,104632,88.14827295703454,7
0.05,1187,93,104725,88.1523569023569,8
0.05,1188,94,104819,88.15727502102607,7
0.05,1189,96,104915,88.16386554621849,6
0.05,1190,94,105009,88.16876574307305,7
0.05,1191,94,105103,88.17365771812081,9
0.05,1192,92,105195,88.17686504610226,9
0.05,1193,92,105287,88.18006700167504,9
0.05,1194,93,105380,88.18410041841004,8
0.05,1195,95,105475,88.18979933110369,6
0.05,1196,94,105569,88.19465329991645,7
0.05,1197,92,105661,88.19782971619365,9
0.05,1198,94,105755,88.20266889074229,7
0.05,1199,17,105772,88.14333333333333,15
0.05,1200,94,105866,88.14820982514571,7
0.05,1201,91,105957,88.15058236272878,10
0.05,1202,94,106051,88.1554447215295,7
0.05,1203,94,106145,88.16029900332227,8
0.05,1204,95,106240,88.16597510373444,6
0.05,1205,94,106334,88.17081260364843,7
0.05,1206,96,106430,88.17729908864955,6
0.05,1207,93,106523,88.18129139072848,8
0.05,1208,92,106615,88.18444995864351,9
0.05,1209,92,106707,88.18760330578512,9
0.05,1210,94,106801,88.19240297274979,7
0.05,1211,89,106890,88.1930693069307,12
0.05,1212,96,106986,88.199505358615,6
0.05,1213,94,107080,88.20428336079077,7
0.05,1214,93,107173,88.2082304526749,9
0.05,1215,91,107264,88.21052631578948,10
0.05,1216,96,107360,88.21692686935086,6
0.05,1217,94,107454,88.22167487684729,8
0.05,1218,92,107546,88.2247744052502,9
0.05,1219,95,107641,88.23032786885246,6
0.05,1220,92,107733,88.23341523341523,10
0.05,1221,91,107824,88.23567921440262,10
0.05,1222,93,107917,88.23957481602616,8
0.05,1223,89,108006,88.24019607843137,12
0.05,1224,91,108097,88.24244897959184,10
0.05,1225,96,108193,88.24877650897227,6
0.05,1226,93,108286,88.25264873675631,8
0.05,1227,93,108379,88.25651465798046,8
0.05,1228,94,108473,88.26118795768917,7
0.05,1229,93,108566,88.2650406504065,9
0.05,1230,92,108658,88.268074735987,9
0.05,1231,96,108754,88.27435064935065,6
0.05,1232,95,108849,88.27980535279805,6
0.05,1233,94,108943,88.28444084278769,7
0.05,1234,94,109037,88.28906882591093,7
0.05,1235,94,109131,88.29368932038835,10
0.05,1236,91,109222,88.29587712206953,10
0.05,1237,94,109316,88.30048465266559,7
0.05,1238,95,109411,88.30589184826474,6
0.05,1239,94,109505,88.31048387096774,8
0.05,1240,91,109596,88.31265108783239,10
0.05,1241,95,109691,88.31803542673107,6
0.05,1242,95,109786,88.32341110217216,7
0.05,1243,93,109879,88.32717041800643,8
0.05,1244,95,109974,88.33253012048193,6
0.05,1245,95,110069,88.3378812199037,6
0.05,1246,94,110163,88.34242181234964,7
0.05,1247,94,110257,88.34695512820512,7
0.05,1248,93,110350,88.35068054443555,10
0.05,1249,21,110371,88.2968,11
0.05,1250,96,110467,88.30295763389289,6
0.05,1251,93,110560,88.30670926517571,8
0.05,1252,94,110654,88.31125299281724,7
0.05,1253,89,110743,88.31180223285486,12
0.05,1254,27,110770,88.26294820717132,6
0.05,1255,96,110866,88.26910828025478,6
0.05,1256,94,110960,88.27366746221162,7
0.05,1257,94,111054,88.27821939586646,7
0.05,1258,91,111145,88.28038125496425,10
0.05,1259,95,111240,88.28571428571429,6
0.05,1260,93,111333,88.28945281522601,8
0.05,1261,94,111427,88.29397781299525,7
0.05,1262,96,111523,88.30007917656374,6
0.05,1263,96,111619,88.30617088607595,6
0.05,1264,96,111715,88.31225296442688,6
0.05,1265,94,111809,88.31674565560822,7
0.05,1266,94,111903,88.32123125493291,7
0.05,1267,94,111997,88.32570977917982,7
0.05,1268,27,112024,88.27738376674547,6
0.05,1269,91,112115,88.27952755905511,10
0.05,1270,92,112207,88.28245476003147,9
0.05,1271,94,112301,88.2869496855346,7
0.05,1272,95,112396,88.29222309505106,6
0.05,1273,91,112487,88.29434850863423,10
0.05,1274,94,112581,88.29882352941176,7
0.05,1275,94,112675,88.30329153605015,7
0.05,1276,94,112769,88.30775254502741,7
0.05,1277,95,112864,88.31298904538342,6
0.05,1278,94,112958,88.31743549648162,7
0.05,1279,92,113050,88.3203125,9
0.05,1280,93,113143,88.3239656518345,8
0.05,1281,92,113235,88.32683307332293,9
0.05,1282,94,113329,88.33125487139517,7
0.05,1283,93,113422,88.33489096573209,9
0.05,1284,94,113516,88.33929961089494,7
0.05,1285,95,113611,88.34447900466563,6
0.05,1286,92,113703,88.34731934731934,9
0.05,1287,25,113728,88.29813664596273,8
0.05,1288,94,113822,88.30256012412723,7
0.05,1289,95,113917,88.30775193798449,6
0.05,1290,94,114011,88.31216111541441,7
0.05,1291,94,114105,88.31656346749226,8
0.05,1292,94,114199,88.32095901005414,7
0.05,1293,95,114294,88.32612055641422,6
0.05,1294,95,114389,88.33127413127413,6
0.05,1295,92,114481,88.33410493827161,10
0.05,1296,94,114575,88.3384734001542,7
0.05,1297,27,114602,88.29121725731895,6
0.05,1298,94,114696,88.29561200923787,7
0.05,1299,96,114792,88.30153846153846,6
0.05,1300,95,114887,88.30668716372021,6
0.05,1301,94,114981,88.3110599078341,8
0.05,1302,96,115077,88.31696085955487,6
0.05,1303,94,115171,88.3213190184049,7
0.05,1304,94,115265,88.32567049808429,7
0.05,1305,96,115361,88.33154670750383,6
0.05,1306,95,115456,88.33664881407805,6
0.05,1307,94,115550,88.34097859327217,7
0.05,1308,96,115646,88.34682964094729,6
0.05,1309,94,115740,88.35114503816794,7
0.05,1310,96,115836,88.35697940503432,6
0.05,1311,95,115931,88.36204268292683,7
0.05,1312,90,116021,88.36329017517136,12
0.05,1313,92,116113,88.36605783866058,9
0.05,1314,96,116209,88.37186311787072,6
0.05,1315,94,116303,88.37613981762918,8
0.05,1316,92,116395,88.37889141989369,9
0.05,1317,90,116485,88.38012139605463,11
0.05,1318,92,116577,88.38286580742987,9
0.05,1319,96,116673,88.38863636363637,6
0.05,1320,95,116768,88.39364118092354,6
0.05,1321,94,116862,88.39788199697428,7
0.05,1322,94,116956,88.4021164021164,7
0.05,1323,96,117052,88.40785498489426,6
0.05,1324,94,117146,88.41207547169812,7
0.05,1325,94,117240,88.41628959276018,7
0.05,1326,94,117334,88.42049736247174,7
0.05,1327,95,117429,88.42545180722891,7
0.05,1328,95,117524,88.43039879608729,6
0.05,1329,94,117618,88.43458646616541,7
0.05,1330,95,117713,88.43951915852742,6
0.05,1331,96,117809,88.4451951951952,6
0.05,1332,92,117901,88.44786196549137,11
0.05,1333,91,117992,88.44977511244377,10
0.05,1334,94,118086,88.45393258426967,7
0.05,1335,95,118181,88.45883233532935,6
0.05,1336,94,118275,88.46297681376215,7
0.05,1337,93,118368,88.46636771300449,8
0.05,1338,95,118463,88.47124719940254,7
0.05,1339,96,118559,88.47686567164179,6
0.05,1340,94,118653,88.48098434004474,7
0.05,1341,90,118743,88.48211624441133,12
0.05,1342,-44,118699,88.38346984363366,8
0.05,1343,94,118793,88.38764880952381,7
0.05,1344,27,118820,88.34200743494424,6
0.05,1345,91,118911,88.34398216939078,10
0.05,1346,94,119005,88.34818114328137,7
0.05,1347,89,119094,88.3486646884273,12
0.05,1348,94,119188,88.35285396590066,8
0.05,1349,92,119280,88.35555555555555,9
0.05,1350,94,119374,88.35973353071799,8
0.05,1351,96,119470,88.36538461538461,6
0.05,1352,91,119561,88.36733185513674,10
0.05,1353,95,119656,88.37223042836041,6
0.05,1354,94,119750,88.37638376383764,7
0.05,1355,96,119846,88.38200589970502,6
0.05,1356,94,119940,88.3861459100958,7
0.05,1357,96,120036,88.3917525773196,6
0.05,1358,94,120130,88.39587932303164,7
0.05,1359,93,120223,88.39926470588236,8
0.05,1360,94,120317,88.4033798677443,7
0.05,1361,94,120411,88.40748898678414,7
0.05,1362,94,120505,88.41159207630227,7
0.05,1363,95,120600,88.41642228739003,6
0.05,1364,96,120696,88.42197802197802,6
0.05,1365,93,120789,88.42532942898976,8
0.05,1366,94,120883,88.42940746159474,7
0.05,1367,94,120977,88.43347953216374,7
0.05,1368,96,121073,88.43900657414171,6
0.05,1369,95,121168,88.44379562043795,6
0.05,1370,94,121262,88.44784828592269,7
0.05,1371,92,121354,88.45043731778425,9
0.05,1372,93,121447,88.45375091041515,8
0.05,1373,92,121539,88.45633187772926,9
0.05,1374,94,121633,88.46036363636364,7
0.05,1375,95,121728,88.46511627906976,7
0.05,1376,95,121823,88.46986201888163,6
0.05,1377,95,121918,88.47460087082729,6
0.05,1378,17,121935,88.42277012327774,15
0.05,1379,94,122029,88.4268115942029,7
0.05,1380,96,122125,88.43229543808835,6
0.05,1381,24,122149,88.38567293777135,9
0.05,1382,93,122242,88.38900939985538,8
0.05,1383,94,122336,88.39306358381504,7
0.05,1384,93,122429,88.39638989169676,8
0.05,1385,95,122524,88.4011544011544,7
0.05,1386,95,122619,88.40591204037491,6
0.05,1387,92,122711,88.4085014409222,9
0.05,1388,92,122803,88.41108711303096,9
0.05,1389,94,122897,88.41510791366906,7
0.05,1390,94,122991,88.41912293314162,7
0.05,1391,96,123087,88.42456896551724,6
0.05,1392,94,123181,88.42857142857143,7
0.05,1393,94,123275,88.43256814921091,7
0.05,1394,94,123369,88.43655913978495,7
0.05,1395,94,123463,88.44054441260745,7
0.05,1396,96,123559,88.44595561918396,6
0.05,1397,96,123655,88.45135908440629,6
0.05,1398,95,123750,88.45604002859186,6
0.05,1399,93,123843,88.45928571428571,8
0.05,1400,91,123934,88.46109921484654,11
0.05,1401,93,124027,88.46433666191156,8
0.05,1402,26,124053,88.41981468282252,8
0.05,1403,95,124148,88.42450142450143,6
0.05,1404,27,124175,88.38078291814946,6
0.05,1405,92,124267,88.38335704125178,10
0.05,1406,96,124363,88.38877043354655,6
0.05,1407,94,124457,88.39275568181819,7
0.05,1408,96,124553,88.39815471965933,6
0.05,1409,95,124648,88.40283687943263,6
0.05,1410,92,124740,88.4053862508859,9
0.05,1411,96,124836,88.41076487252124,6
0.05,1412,94,124930,88.41472045293702,8
0.05,1413,94,125024,88.41867043847242,7
0.05,1414,93,125117,88.42190812720848,9
0.05,1415,93,125210,88.42514124293785,8
0.05,1416,96,125306,88.43048694424841,6
0.05,1417,96,125402,88.4358251057828,6
0.05,1418,94,125496,88.43974630021141,8
0.05,1419,94,125590,88.44366197183099,7
0.05,1420,94,125684,88.44757213230119,7
0.05,1421,94,125778,88.45147679324894,7
0.05,1422,93,125871,88.45467322557977,9
0.05,1423,94,125965,88.45856741573034,7
0.05,1424,96,126061,88.46385964912281,6
0.05,1425,93,126154,88.46704067321178,8
0.05,1426,95,126249,88.47161878065873,6
0.05,1427,95,126344,88.47619047619048,7
0.05,1428,18,126362,88.42687193841847,14
0.05,1429,94,126456,88.43076923076923,7
0.05,1430,94,126550,88.43466107617051,7
0.05,1431,95,126645,88.43924581005587,6
0.05,1432,95,126740,88.44382414515003,7
0.05,1433,94,126834,88.44769874476988,7
0.05,1434,94,126928,88.45156794425087,7
0.05,1435,92,127020,88.45403899721448,9
0.05,1436,93,127113,88.4572025052192,8
0.05,1437,95,127208,88.46175243393603,6
0.05,1438,90,127298,88.4628214037526,11
0.05,1439,94,127392,88.46666666666667,7
0.05,1440,95,127487,88.47120055517001,7
0.05,1441,94,127581,88.4750346740638,7
0.05,1442,94,127675,88.47886347886347,9
0.05,1443,96,127771,88.48407202216066,6
0.05,1444,90,127861,88.48512110726644,11
0.05,1445,92,127953,88.48755186721992,9
0.05,1446,94,128047,88.4913614374568,8
0.05,1447,92,128139,88.49378453038673,9
0.05,1448,94,128233,88.4975845410628,7
0.05,1449,88,128321,88.49724137931034,14
0.05,1450,96,128417,88.50241212956581,6
0.05,1451,94,128511,88.50619834710744,7
0.05,1452,93,128604,88.50929112181693,8
0.05,1453,91,128695,88.51100412654746,10
0.05,1454,94,128789,88.5147766323024,7
0.05,1455,95,128884,88.51923076923077,6
0.05,1456,96,128980,88.52436513383665,6
0.05,1457,93,129073,88.52743484224966,8
0.05,1458,24,129097,88.48320767649075,8
0.05,1459,96,129193,88.48835616438356,6
0.05,1460,95,129288,88.49281314168378,6
0.05,1461,92,129380,88.49521203830369,9
0.05,1462,89,129469,88.49555707450445,12
0.05,1463,96,129565,88.5006830601093,6
0.05,1464,94,129659,88.50443686006825,7
0.05,1465,93,129752,88.5075034106412,8
0.05,1466,95,129847,88.51192910702113,7
0.05,1467,94,129941,88.51566757493188,7
0.05,1468,95,130036,88.52008168822329,7
0.05,1469,94,130130,88.52380952380952,7
0.05,1470,91,130221,88.52549286199864,10
0.05,1471,93,130314,88.52853260869566,9
0.05,1472,95,130409,88.53292600135778,6
0.05,1473,96,130505,88.53799185888738,6
0.05,1474,94,130599,88.54169491525424,8
0.05,1475,95,130694,88.54607046070461,6
0.05,1476,94,130788,88.54976303317535,7
0.05,1477,94,130882,88.55345060893099,7
0.05,1478,92,130974,88.55578093306288,9
0.05,1479,95,131069,88.56013513513514,6
0.05,1480,94,131163,88.56380823767725,7
0.05,1481,92,131255,88.56612685560054,9
0.05,1482,91,131346,88.5677680377613,10
0.05,1483,96,131442,88.57277628032345,6
0.05,1484,94,131536,88.57643097643097,7
0.05,1485,89,131625,88.57671601615074,12
0.05,1486,93,131718,88.57969065232011,8
0.05,1487,94,131812,88.58333333333333,7
0.05,1488,94,131906,88.5869711215581,7
0.05,1489,95,132001,88.59127516778524,6
0.05,1490,94,132095,88.59490274983233,7
0.05,1491,94,132189,88.5985254691689,8
0.05,1492,96,132285,88.60348292029471,6
0.05,1493,93,132378,88.60642570281125,8
0.05,1494,96,132474,88.6113712374582,6
0.05,1495,91,132565,88.6129679144385,10
0.05,1496,94,132659,88.61656646626587,7
0.05,1497,94,132753,88.62016021361816,7
0.05,1498,95,132848,88.62441627751835,6
0.05,1499,94,132942,88.628,7
0.05,1500,92,133034,88.63024650233177,9
0.05,1501,20,133054,88.58455392809587,13
0.05,1502,93,133147,88.58749168330007,8
0.05,1503,94,133241,88.59109042553192,8
0.05,1504,-52,133189,88.49767441860465,18
0.05,1505,96,133285,88.50265604249668,6
0.05,1506,94,133379,88.50630391506304,8
0.05,1507,95,133474,88.5106100795756,6
0.05,1508,89,133563,88.51093439363817,12
0.05,1509,92,133655,88.51324503311258,10
0.05,1510,94,133749,88.51687624090006,7
0.05,1511,94,133843,88.52050264550265,7
0.05,1512,95,133938,88.52478519497687,6
0.05,1513,95,134033,88.52906208718626,7
0.05,1514,93,134126,88.53201320132013,8
0.05,1515,96,134222,88.53693931398416,6
0.05,1516,95,134317,88.54119973632169,7
0.05,1517,94,134411,88.54479578392622,7
0.05,1518,94,134505,88.54838709677419,7
0.05,1519,94,134599,88.55197368421052,8
0.05,1520,93,134692,88.55489809335963,8
0.05,1521,95,134787,88.55913272010513,6
0.05,1522,94,134881,88.56270518713066,7
0.05,1523,94,134975,88.56627296587926,7
0.05,1524,93,135068,88.56918032786885,8
0.05,1525,93,135161,88.57208387942333,8
0.05,1526,92,135253,88.5743287491814,9
0.05,1527,93,135346,88.57722513089006,8
0.05,1528,94,135440,88.58077174623938,7
0.05,1529,96,135536,88.58562091503268,6
0.05,1530,95,135631,88.5898105813194,7
0.05,1531,94,135725,88.59334203655352,7
0.05,1532,94,135819,88.59686888454011,7
0.05,1533,93,135912,88.59973924380704,8
0.05,1534,95,136007,88.60390879478827,6
0.05,1535,93,136100,88.60677083333333,8
0.05,1536,96,136196,88.61158100195185,6
0.05,1537,95,136291,88.61573472041613,6
0.05,1538,93,136384,88.61858349577648,8
0.05,1539,94,136478,88.62207792207792,7
0.05,1540,94,136572,88.62556781310838,7
0.05,1541,94,136666,88.6290531776913,7
0.05,1542,24,136690,88.58716785482825,8
0.05,1543,95,136785,88.59132124352331,6
0.05,1544,93,136878,88.59417475728155,9
0.05,1545,95,136973,88.59831824062096,6
0.05,1546,21,136994,88.5546218487395,11
0.05,1547,94,137088,88.55813953488372,7
0.05,1548,25,137113,88.51710781149129,8
0.05,1549,95,137208,88.52129032258064,6
0.05,1550,22,137230,88.47840103159253,10
0.05,1551,94,137324,88.48195876288659,7
0.05,1552,90,137414,88.48293625241467,11
0.05,1553,94,137508,88.48648648648648,7
0.05,1554,94,137602,88.49003215434084,7
0.05,1555,94,137696,88.49357326478149,7
0.05,1556,92,137788,88.49582530507386,9
0.05,1557,93,137881,88.4987163029525,8
0.05,1558,94,137975,88.50224502886466,7
0.05,1559,95,138070,88.50641025641026,6
0.05,1560,96,138166,88.51121076233184,6
0.05,1561,94,138260,88.51472471190782,7
0.05,1562,94,138354,88.51823416506718,7
0.05,1563,96,138450,88.5230179028133,6
0.05,1564,96,138546,88.52779552715656,6
0.05,1565,25,138571,88.48722860791827,8
0.05,1566,94,138665,88.49074664964901,7
0.05,1567,94,138759,88.49426020408163,8
0.05,1568,96,138855,88.49904397705545,6
0.05,1569,24,138879,88.45796178343949,9
0.05,1570,95,138974,88.46212603437301,6
0.05,1571,92,139066,88.46437659033079,9
0.05,1572,92,139158,88.4666242848061,9
0.05,1573,94,139252,88.47013977128336,7
0.05,1574,93,139345,88.47301587301587,8
0.05,1575,95,139440,88.4771573604061,6
0.05,1576,92,139532,88.47939124920735,9
0.05,1577,94,139626,88.48288973384031,7
0.05,1578,93,139719,88.48575047498417,10
0.05,1579,92,139811,88.48797468354431,9
0.05,1580,27,139838,88.44908285895004,6
0.05,1581,90,139928,88.45006321112515,11
0.05,1582,91,140019,88.45167403663929,10
0.05,1583,94,140113,88.45517676767676,8
0.05,1584,92,140205,88.45741324921136,9
0.05,1585,94,140299,88.4609079445145,7
0.05,1586,96,140395,88.46565847511027,6
0.05,1587,93,140488,88.46851385390428,8
0.05,1588,93,140581,88.47136563876651,8
0.05,1589,91,140672,88.47295597484276,10
0.05,1590,96,140768,88.47768698931489,6
0.05,1591,92,140860,88.47989949748744,9
0.05,1592,92,140952,88.48210922787194,9
0.05,1593,93,141045,88.48494353826851,8
0.05,1594,94,141139,88.4884012539185,7
0.05,1595,95,141234,88.49248120300751,6
0.05,1596,92,141326,88.49467752035066,9
0.05,1597,95,141421,88.49874843554443,6
0.05,1598,93,141514,88.50156347717324,8
0.05,1599,94,141608,88.505,7
0.05,1600,90,141698,88.50593379138039,11
0.05,1601,94,141792,88.50936329588015,7
0.05,1602,92,141884,88.51154086088584,9
0.05,1603,95,141979,88.51558603491272,7
0.05,1604,94,142073,88.5190031152648,7
0.05,1605,91,142164,88.52054794520548,11
0.05,1606,93,142257,88.52333540759179,8
0.05,1607,91,142348,88.52487562189054,11
0.05,1608,95,142443,88.5288999378496,6
0.05,1609,96,142539,88.53354037267081,6
0.05,1610,94,142633,88.53693358162631,7
0.05,1611,94,142727,88.54032258064517,8
0.05,1612,92,142819,88.54246745195289,9
0.05,1613,94,142913,88.5458488228005,7
0.05,1614,95,143008,88.54984520123838,8
0.05,1615,92,143100,88.5519801980198,9
0.05,1616,94,143194,88.55534941249228,7
0.05,1617,-50,143144,88.46971569839307,14
0.05,1618,96,143240,88.47436689314391,6
0.05,1619,94,143334,88.47777777777777,7
0.05,1620,91,143425,88.4793337446021,10
0.05,1621,96,143521,88.48397040690506,6
0.05,1622,94,143615,88.48736906962415,7
0.05,1623,91,143706,88.48891625615764,10
0.05,1624,83,143789,88.48553846153847,18
0.05,1625,94,143883,88.48892988929889,7
0.05,1626,95,143978,88.49293177627536,6
0.05,1627,95,144073,88.49692874692875,6
0.05,1628,94,144167,88.50030693677103,8
0.05,1629,94,144261,88.5036809815951,7
0.05,1630,21,144282,88.46229307173513,11
0.05,1631,94,144376,88.4656862745098,7
0.05,1632,93,144469,88.46846295162278,8
0.05,1633,94,144563,88.4718482252142,7
0.05,1634,96,144659,88.47645259938838,6
0.05,1635,94,144753,88.47982885085574,7
0.05,1636,95,144848,88.48381185094685,6
0.05,1637,95,144943,88.48778998778998,6
0.05,1638,92,145035,88.48993288590604,9
0.05,1639,94,145129,88.49329268292684,7
0.05,1640,92,145221,88.49542961608775,9
0.05,1641,92,145313,88.49756394640683,9
0.05,1642,94,145407,88.50091296409008,7
0.05,1643,95,145502,88.50486618004867,7
0.05,1644,96,145598,88.50942249240121,6
0.05,1645,94,145692,88.51275820170109,7
0.05,1646,92,145784,88.51487553126897,9
0.05,1647,95,145879,88.51881067961165,6
0.05,1648,95,145974,88.52274105518497,6
0.05,1649,94,146068,88.52606060606061,7
0.05,1650,92,146160,88.5281647486372,9
0.05,1651,95,146255,88.5320823244552,6
0.05,1652,92,146347,88.53418027828191,9
0.05,1653,95,146442,88.53808948004837,6
0.05,1654,95,146537,88.54199395770392,8
0.05,1655,94,146631,88.54528985507247,7
0.05,1656,93,146724,88.54797827398913,8
0.05,1657,95,146819,88.5518697225573,6
0.05,1658,96,146915,88.55635925256179,6
0.05,1659,93,147008,88.55903614457831,8
0.05,1660,94,147102,88.56231186032511,8
0.05,1661,96,147198,88.5667870036101,6
0.05,1662,94,147292,88.57005411906194,7
0.05,1663,96,147388,88.57451923076923,6
0.05,1664,92,147480,88.57657657657657,9
0.05,1665,95,147575,88.58043217286915,7
0.05,1666,93,147668,88.58308338332334,8
0.05,1667,95,147763,88.5869304556355,6
0.05,1668,93,147856,88.5895745955662,9
0.05,1669,94,147950,88.59281437125749,7
0.05,1670,93,148043,88.59545182525434,8
0.05,1671,94,148137,88.59868421052632,7
0.05,1672,94,148231,88.60191273161985,7
0.05,1673,94,148325,88.60513739545998,7
0.05,1674,96,148421,88.60955223880597,6
0.05,1675,95,148516,88.61336515513126,7
0.05,1676,92,148608,88.61538461538461,9
0.05,1677,90,148698,88.61620977353992,11
0.05,1678,-46,148652,88.53603335318643,10
0.05,1679,94,148746,88.53928571428571,7
0.05,1680,94,148840,88.54253420582987,7
0.05,1681,93,148933,88.54518430439953,8
0.05,1682,94,149027,88.54842543077837,7
0.05,1683,92,149119,88.55047505938242,9
0.05,1684,94,149213,88.55370919881305,7
0.05,1685,94,149307,88.55693950177935,7
0.05,1686,94,149401,88.56016597510373,7
0.05,1687,25,149426,88.52251184834124,7
0.05,1688,95,149521,88.5263469508585,6
0.05,1689,94,149615,88.52958579881657,7
0.05,1690,95,149710,88.53341218214075,6
0.05,1691,94,149804,88.53664302600473,7
0.05,1692,93,149897,88.53927938570585,8
0.05,1693,92,149989,88.54132231404958,9
0.05,1694,92,150081,88.5433628318584,9
0.05,1695,96,150177,88.54775943396227,6
0.05,1696,94,150271,88.550972304066,7
0.05,1697,94,150365,88.55418138987044,8
0.05,1698,94,150459,88.55738669805768,7
0.05,1699,86,150545,88.55588235294118,15
0.05,1700,94,150639,88.55908289241623,7
0.05,1701,93,150732,88.56169212690952,8
0.05,1702,94,150826,88.56488549618321,7
0.05,1703,93,150919,88.5674882629108,8
0.05,1704,96,151015,88.57184750733138,6
0.05,1705,95,151110,88.57561547479484,6
0.05,1706,93,151203,88.57820738137083,8
0.05,1707,24,151227,88.5403981264637,9
0.05,1708,94,151321,88.54359274429491,7
0.05,1709,92,151413,88.54561403508772,10
0.05,1710,94,151507,88.54880187025131,8
0.05,1711,94,151601,88.5519859813084,7
0.05,1712,93,151694,88.55458260361938,8
0.05,1713,94,151788,88.55775962660444,8
0.05,1714,95,151883,88.56151603498542,6
0.05,1715,93,151976,88.56410256410257,8
0.05,1716,94,152070,88.56726849155504,7
0.05,1717,92,152162,88.56926658905704,9
0.05,1718,92,152254,88.57126236183828,9
0.05,1719,95,152349,88.575,7
0.05,1720,95,152444,88.57873329459616,6
0.05,1721,90,152534,88.57955865272939,11
0.05,1722,96,152630,88.58386535113175,6
0.05,1723,91,152721,88.58526682134571,10
0.05,1724,93,152814,88.58782608695653,9
0.05,1725,93,152907,88.59038238702202,8
0.05,1726,94,153001,88.59351476548929,7
0.05,1727,95,153096,88.59722222222223,7
0.05,1728,95,153191,88.60092539039907,6
0.05,1729,93,153284,88.60346820809248,8
0.05,1730,91,153375,88.60485268630849,10
0.05,1731,94,153469,88.60796766743648,7
0.05,1732,95,153564,88.61165608770918,6
0.05,1733,94,153658,88.61476355247981,8
0.05,1734,95,153753,88.61844380403458,6
0.05,1735,95,153848,88.6221198156682,7
0.05,1736,93,153941,88.62464018422568,9
0.05,1737,95,154036,88.6283084004603,6
0.05,1738,95,154131,88.63197239792984,6
0.05,1739,96,154227,88.63620689655173,6
0.05,1740,93,154320,88.63871338311316,8
0.05,1741,91,154411,88.64006888633754,10
0.05,1742,92,154503,88.64199655765921,9
0.05,1743,93,154596,88.64449541284404,8
0.05,1744,94,154690,88.64756446991404,7
0.05,1745,93,154783,88.65005727376861,8
0.05,1746,94,154877,88.6531196336577,7
0.05,1747,94,154971,88.65617848970251,7
0.05,1748,93,155064,88.65866209262435,8
0.05,1749,92,155156,88.66057142857143,9
0.05,1750,95,155251,88.66419189034838,7
0.05,1751,93,155344,88.66666666666667,8
0.05,1752,94,155438,88.66970907016542,7
0.05,1753,94,155532,88.672748004561,7
0.05,1754,91,155623,88.67407407407407,10
0.05,1755,96,155719,88.67824601366742,6
0.05,1756,94,155813,88.6812749003984,8
0.05,1757,94,155907,88.68430034129693,7
0.05,1758,95,156002,88.6878908470722,6
0.05,1759,90,156092,88.68863636363636,11
0.05,1760,93,156185,88.69108461101646,8
0.05,1761,91,156276,88.69239500567537,11
0.05,1762,93,156369,88.69483834373227,8
0.05,1763,93,156462,88.69727891156462,8
0.05,1764,94,156556,88.70028328611897,7
0.05,1765,94,156650,88.70328425821064,7
0.05,1766,-49,156601,88.62535370684776,12
0.05,1767,24,156625,88.58880090497738,8
0.05,1768,94,156719,88.59185980780101,7
0.05,1769,96,156815,88.59604519774011,6
0.05,1770,93,156908,88.59853190287973,8
0.05,1771,96,157004,88.60270880361173,6
0.05,1772,94,157098,88.60575296108291,7
0.05,1773,95,157193,88.60935738444194,6
0.05,1774,94,157287,88.61239436619718,7
0.05,1775,94,157381,88.61542792792793,7
0.05,1776,94,157475,88.61845807540799,7
0.05,1777,94,157569,88.6214848143982,7
0.05,1778,90,157659,88.62225969645868,11
0.05,1779,96,157755,88.62640449438203,6
0.05,1780,90,157845,88.62717574396406,11
0.05,1781,92,157937,88.62906846240179,9
0.05,1782,94,158031,88.6320807627594,7
0.05,1783,95,158126,88.63565022421524,7
0.05,1784,96,158222,88.63977591036415,6
0.05,1785,94,158316,88.6427771556551,7
0.05,1786,95,158411,88.64633463905987,6
0.05,1787,94,158505,88.6493288590604,7
0.05,1788,94,158599,88.65231973169368,7
0.05,1789,91,158690,88.6536312849162,10
0.05,1790,95,158785,88.6571747627024,7
0.05,1791,93,158878,88.65959821428571,8
0.05,1792,92,158970,88.66146123814835,9
0.05,1793,95,159065,88.664994425864,6
0.05,1794,93,159158,88.66740947075209,8
0.05,1795,96,159254,88.67149220489978,6
0.05,1796,93,159347,88.67390094602115,8
0.05,1797,93,159440,88.67630700778643,8
0.05,1798,94,159534,88.6792662590328,7
0.05,1799,94,159628,88.68222222222222,7
0.05,1800,92,159720,88.68406440866185,9
0.05,1801,93,159813,88.68645948945615,8
0.05,1802,94,159907,88.68940654464781,7
0.05,1803,96,160003,88.69345898004434,6
0.05,1804,94,160097,88.69639889196677,7
0.05,1805,95,160192,88.69988925802879,7
0.05,1806,91,160283,88.70116214720531,10
0.05,1807,93,160376,88.70353982300885,8
0.05,1808,95,160471,88.7070204532891,6
0.05,1809,95,160566,88.71049723756906,6
0.05,1810,94,160660,88.71341800110436,7
0.05,1811,92,160752,88.71523178807946,9
0.05,1812,95,160847,88.71869829012687,6
0.05,1813,94,160941,88.72160970231532,7
0.05,1814,27,160968,88.68760330578512,6
0.05,1815,94,161062,88.69052863436123,7
0.05,1816,95,161157,88.69400110071547,8
0.05,1817,94,161251,88.6969196919692,7
0.05,1818,94,161345,88.69983507421661,7
0.05,1819,95,161440,88.7032967032967,6
0.05,1820,93,161533,88.7056562328391,9
0.05,1821,93,161626,88.70801317233808,8
0.05,1822,92,161718,88.70981897970378,10
0.05,1823,94,161812,88.71271929824562,7
0.05,1824,96,161908,88.71671232876713,6
0.05,1825,93,162001,88.71905805038335,8
0.05,1826,94,162095,88.72194854953476,7
0.05,1827,96,162191,88.72592997811816,6
0.05,1828,94,162285,88.72881355932203,8
0.05,1829,94,162379,88.73169398907103,8
0.05,1830,91,162470,88.73293282359367,10
0.05,1831,94,162564,88.73580786026201,7
0.05,1832,91,162655,88.73704309874523,10
0.05,1833,90,162745,88.73773173391494,11
0.05,1834,94,162839,88.74059945504086,7
0.05,1835,92,162931,88.74237472766885,9
0.05,1836,96,163027,88.74632553075666,6
0.05,1837,94,163121,88.74918389553864,7
0.05,1838,94,163215,88.75203915171289,8
0.05,1839,94,163309,88.75489130434782,7
0.05,1840,93,163402,88.75719717544813,9
0.05,1841,95,163497,88.76058631921823,7
0.05,1842,96,163593,88.76451437873033,7
0.05,1843,91,163684,88.76572668112799,10
0.05,1844,94,163778,88.76856368563686,7
0.05,1845,91,163869,88.76977248104009,10
0.05,1846,95,163964,88.77314564158094,6
0.05,1847,94,164058,88.77597402597402,7
0.05,1848,94,164152,88.77879935100054,7
0.05,1849,94,164246,88.78162162162162,7
0.05,1850,93,164339,88.78390059427336,8
0.05,1851,95,164434,88.78725701943844,6
0.05,1852,94,164528,88.79007015650296,7
0.05,1853,94,164622,88.79288025889967,7
0.05,1854,95,164717,88.79622641509434,6
0.05,1855,92,164809,88.79795258620689,9
0.05,1856,94,164903,88.80075390414648,7
0.05,1857,90,164993,88.80139935414424,11
0.05,1858,94,165087,88.8041958041958,7
0.05,1859,94,165181,88.80698924731183,8
0.05,1860,91,165272,88.8081676518001,10
0.05,1861,95,165367,88.81149301825994,7
0.05,1862,91,165458,88.81266774020398,10
0.05,1863,27,165485,88.77950643776823,6
0.05,1864,94,165579,88.78230563002681,7
0.05,1865,95,165674,88.78563772775992,6
0.05,1866,94,165768,88.78843063738618,7
0.05,1867,95,165863,88.79175588865097,6
0.05,1868,94,165957,88.79454253611557,7
0.05,1869,96,166053,88.79839572192513,6
0.05,1870,94,166147,88.80117584179582,7
0.05,1871,95,166242,88.80448717948718,6
0.05,1872,94,166336,88.80726107848372,7
0.05,1873,95,166431,88.81056563500533,8
0.05,1874,93,166524,88.8128,8
0.05,1875,95,166619,88.81609808102345,6
0.05,1876,95,166714,88.8193926478423,7
0.05,1877,93,166807,88.82161874334399,8
0.05,1878,90,166897,88.82224587546567,11
0.05,1879,95,166992,88.82553191489362,6
0.05,1880,94,167086,88.82828282828282,7
0.05,1881,91,167177,88.82943676939426,10
0.05,1882,88,167265,88.82899628252788,13
0.05,1883,94,167359,88.83174097664543,7
0.05,1884,94,167453,88.8344827586207,7
0.05,1885,96,167549,88.83828207847296,6
0.05,1886,92,167641,88.83995760466348,9
0.05,1887,93,167734,88.84216101694915,8
0.05,1888,95,167829,88.84542085759661,6
0.05,1889,93,167922,88.84761904761905,8
0.05,1890,93,168015,88.84981491274458,8
0.05,1891,96,168111,88.85359408033827,6
0.05,1892,93,168204,88.85578446909668,8
0.05,1893,95,168299,88.85902851108764,6
0.05,1894,94,168393,88.8617414248021,7
0.05,1895,94,168487,88.86445147679325,7
0.05,1896,95,168582,88.86768581971533,6
0.05,1897,92,168674,88.86933614330874,9
0.05,1898,91,168765,88.87045813586099,10
0.05,1899,94,168859,88.87315789473685,8
0.05,1900,93,168952,88.8753287743293,8
0.05,1901,27,168979,88.84279705573081,6
0.05,1902,96,169075,88.84655806621124,6
0.05,1903,94,169169,88.84926470588235,8
0.05,1904,94,169263,88.851968503937,7
0.05,1905,94,169357,88.85466946484785,7
0.05,1906,96,169453,88.85841636077609,6
0.05,1907,93,169546,88.86058700209644,8
0.05,1908,93,169639,88.8627553693033,8
0.05,1909,91,169730,88.86387434554973,10
0.05,1910,92,169822,88.86551543694401,9
0.05,1911,95,169917,88.86872384937239,7
0.05,1912,94,170011,88.87140616832201,7
0.05,1913,93,170104,88.8735632183908,8
0.05,1914,95,170199,88.87676240208877,7
0.05,1915,94,170293,88.8794363256785,7
0.05,1916,93,170386,88.88158581116328,8
0.05,1917,91,170477,88.88269030239833,10
0.05,1918,95,170572,88.88587806149036,6
0.05,1919,94,170666,88.88854166666667,7
0.05,1920,95,170761,88.89172306090578,6
0.05,1921,96,170857,88.89542143600416,6
0.05,1922,94,170951,88.89807592303693,7
0.05,1923,93,171044,88.9002079002079,8
0.05,1924,92,171136,88.90181818181819,9
0.05,1925,87,171223,88.90083073727934,14
0.05,1926,90,171313,88.90140114167099,11
0.05,1927,95,171408,88.9045643153527,6
0.05,1928,95,171503,88.90772420943495,7
0.05,1929,95,171598,88.91088082901554,6
0.05,1930,94,171692,88.9135163127913,7
0.05,1931,95,171787,88.91666666666667,7
0.05,1932,96,171883,88.9203310915675,6
0.05,1933,95,171978,88.92347466390899,6
0.05,1934,94,172072,88.92609819121446,7
0.05,1935,94,172166,88.92871900826447,8
0.05,1936,94,172260,88.93133711925658,7
0.05,1937,94,172354,88.93395252837978,8
0.05,1938,95,172449,88.93708096957194,6
0.05,1939,95,172544,88.940206185567,6
0.05,1940,94,172638,88.94281298299846,8
0.05,1941,94,172732,88.94541709577754,7
0.05,1942,94,172826,88.9480185280494,7
0.05,1943,95,172921,88.95113168724279,6
0.05,1944,94,173015,88.95372750642673,7
0.05,1945,92,173107,88.95529290853032,10
0.05,1946,93,173200,88.95737031330252,8
0.05,1947,92,173292,88.95893223819301,9
0.05,1948,94,173386,88.96151872755259,7
0.05,1949,94,173480,88.96410256410256,7
0.05,1950,93,173573,88.96617119425936,8
0.05,1951,94,173667,88.96875,7
0.05,1952,92,173759,88.97030209933436,9
0.05,1953,94,173853,88.97287615148413,7
0.05,1954,96,173949,88.97647058823529,6
0.05,1955,93,174042,88.97852760736197,8
0.05,1956,92,174134,88.98007153806847,9
0.05,1957,92,174226,88.98161389172625,9
0.05,1958,95,174321,88.98468606431852,6
0.05,1959,90,174411,88.98520408163266,11
0.05,1960,92,174503,88.98674145843957,10
0.05,1961,25,174528,88.95412844036697,7
0.05,1962,95,174623,88.95720835455934,7
0.05,1963,93,174716,88.95926680244399,8
0.05,1964,96,174812,88.96284987277353,6
0.05,1965,95,174907,88.96592065106816,7
0.05,1966,95,175002,88.9689883070666,6
0.05,1967,93,175095,88.97103658536585,8
0.05,1968,92,175187,88.9725749111224,9
0.05,1969,25,175212,88.94010152284264,8
0.05,1970,94,175306,88.94266869609335,7
0.05,1971,95,175401,88.94574036511156,6
0.05,1972,94,175495,88.94830207805373,7
0.05,1973,96,175591,88.95187436676798,6
0.05,1974,95,175686,88.95493670886076,6
0.05,1975,94,175780,88.9574898785425,7
0.05,1976,96,175876,88.9610520991401,6
0.05,1977,95,175971,88.96410515672396,6
0.05,1978,91,176062,88.96513390601314,10
0.05,1979,92,176154,88.96666666666667,9
0.05,1980,92,176246,88.96819787985866,10
0.05,1981,96,176342,88.97174571140262,6
0.05,1982,94,176436,88.97428139183056,7
0.05,1983,94,176530,88.97681451612904,7
0.05,1984,92,176622,88.97833753148615,10
0.05,1985,95,176717,88.98136958710977,6
0.05,1986,94,176811,88.98389531957726,7
0.05,1987,94,176905,88.9864185110664,7
0.05,1988,94,176999,88.98893916540975,7
0.05,1989,94,177093,88.99145728643217,7
0.05,1990,27,177120,88.9603214465093,6
0.05,1991,94,177214,88.96285140562249,11
0.05,1992,94,177308,88.96537882589061,8
0.05,1993,90,177398,88.96589769307924,11
0.05,1994,93,177491,88.96791979949874,9
0.05,1995,95,177586,88.97094188376754,7
0.05,1996,94,177680,88.97346019028542,7
0.05,1997,94,177774,88.97597597597597,7
0.05,1998,94,177868,88.97848924462231,7
0.05,1999,91,177959,88.9795,10
0.05,2000,94,178053,88.98200899550226,7
0.05,2001,94,178147,88.98451548451548,7
0.05,2002,94,178241,88.98701947079381,7
0.05,2003,92,178333,88.98852295409182,9
0.05,2004,93,178426,88.99052369077307,8
0.05,2005,94,178520,88.99302093718843,8
0.05,2006,94,178614,88.99551569506727,7
0.05,2007,27,178641,88.96464143426294,6
0.05,2008,94,178735,88.96714783474366,7
0.05,2009,90,178825,88.96766169154229,11
0.05,2010,96,178921,88.97115862754848,6
0.05,2011,96,179017,88.97465208747515,6
0.05,2012,87,179104,88.97367113760556,14
0.05,2013,95,179199,88.97666335650447,6
0.05,2014,96,179295,88.9801488833747,6
0.05,2015,94,179389,88.98263888888889,9
0.05,2016,94,179483,88.98512642538424,7
0.05,2017,94,179577,88.98761149653122,7
0.05,2018,96,179673,88.99108469539375,6
0.05,2019,94,179767,88.99356435643564,7
0.05,2020,94,179861,88.99604156358238,7
0.05,2021,94,179955,88.99851632047478,7
0.05,2022,93,180048,89.0004943153732,8
0.05,2023,94,180142,89.00296442687747,7
0.05,2024,94,180236,89.00543209876543,7
0.05,2025,95,180331,89.00839091806515,7
0.05,2026,91,180422,89.00937345831278,10
0.05,2027,96,180518,89.01282051282051,6
0.05,2028,94,180612,89.01527846229669,8
0.05,2029,94,180706,89.01773399014779,7
0.05,2030,91,180797,89.01870999507632,10
0.05,2031,96,180893,89.02214566929133,6
0.05,2032,94,180987,89.0245941957698,7
0.05,2033,96,181083,89.02802359882006,6
0.05,2034,94,181177,89.03046683046684,8
0.05,2035,96,181273,89.03388998035363,6
0.05,2036,95,181368,89.03681885125184,6
0.05,2037,94,181462,89.03925417075564,7
0.05,2038,94,181556,89.04168710152035,7
0.05,2039,93,181649,89.0436274509804,8
0.05,2040,87,181736,89.04262616364527,14
0.05,2041,94,181830,89.04505386875613,7
0.05,2042,95,181925,89.04796867351934,6
0.05,2043,93,182018,89.04990215264188,8
0.05,2044,94,182112,89.05232273838631,7
0.05,2045,96,182208,89.05571847507332,6
0.05,2046,27,182235,89.02540302882267,6
0.05,2047,94,182329,89.02783203125,7
0.05,2048,91,182420,89.02879453391898,10
0.05,2049,94,182514,89.03121951219512,7
0.05,2050,94,182608,89.0336421257923,7
0.05,2051,93,182701,89.03557504873294,8
0.05,2052,94,182795,89.03799318071115,7
0.05,2053,94,182889,89.04040895813047,7
0.05,2054,93,182982,89.04233576642336,9
0.05,2055,95,183077,89.04523346303502,7
0.05,2056,27,183104,89.01507049100633,6
0.05,2057,94,183198,89.01749271137027,7
0.05,2058,92,183290,89.01894123360854,9
0.05,2059,92,183382,89.02038834951456,9
0.05,2060,94,183476,89.0228044638525,7
0.05,2061,91,183567,89.02376333656645,10
0.05,2062,93,183660,89.02569074163839,8
0.05,2063,95,183755,89.02858527131782,6
0.05,2064,94,183849,89.03099273607748,7
0.05,2065,93,183942,89.03291384317522,8
0.05,2066,93,184035,89.03483309143687,9
0.05,2067,94,184129,89.0372340425532,8
0.05,2068,90,184219,89.03769937167714,11
0.05,2069,96,184315,89.04106280193237,6
0.05,2070,95,184410,89.04394012554322,6
0.05,2071,92,184502,89.04536679536679,9
0.05,2072,94,184596,89.04775687409551,7
0.05,2073,93,184689,89.049662487946,8
0.05,2074,96,184785,89.05301204819277,6
0.05,2075,90,184875,89.05346820809248,11
0.05,2076,95,184970,89.05633124699085,6
0.05,2077,95,185065,89.05919153031762,6
0.05,2078,94,185159,89.06156806156807,7
0.05,2079,94,185253,89.0639423076923,7
0.05,2080,94,185347,89.06631427198462,7
0.05,2081,93,185440,89.06820365033622,8
0.05,2082,94,185534,89.07057129140662,7
0.05,2083,94,185628,89.07293666026871,7
0.05,2084,94,185722,89.07529976019184,8
0.05,2085,95,185817,89.07813998082455,6
0.05,2086,88,185905,89.07762338284618,13
0.05,2087,94,185999,89.07998084291188,7
0.05,2088,94,186093,89.082336045955,7
0.05,2089,90,186183,89.08277511961722,11
0.05,2090,96,186279,89.08608321377332,6
0.05,2091,94,186373,89.08843212237093,7
0.05,2092,96,186469,89.09173435260392,6
0.05,2093,94,186563,89.09407831900668,7
0.05,2094,94,186657,89.09642004773269,7
0.05,2095,95,186752,89.09923664122137,6
0.05,2096,94,186846,89.10157367668097,7
0.05,2097,94,186940,89.10390848427073,7
0.05,2098,94,187034,89.10624106717485,7
0.05,2099,23,187057,89.0747619047619,10
0.05,2100,94,187151,89.07710613993336,7
0.05,2101,95,187246,89.07992388201713,7
0.05,2102,95,187341,89.08273894436519,7
0.05,2103,91,187432,89.08365019011407,10
0.05,2104,94,187526,89.08598574821853,7
0.05,2105,94,187620,89.08831908831908,7
0.05,2106,92,187712,89.08970099667773,9
0.05,2107,93,187805,89.0915559772296,8
0.05,2108,94,187899,89.09388335704125,7
0.05,2109,96,187995,89.09715639810426,6
0.05,2110,96,188091,89.10042633822833,6
0.05,2111,91,188182,89.10132575757575,10
0.05,2112,96,188278,89.10459062943681,6
0.05,2113,94,188372,89.10690633869442,7
0.05,2114,94,188466,89.10921985815602,7
0.05,2115,96,188562,89.1124763705104,6
0.05,2116,94,188656,89.11478507321682,7
0.05,2117,94,188750,89.11709159584514,8
0.05,2118,93,188843,89.11892402076451,8
0.05,2119,90,188933,89.1193396226415,11
0.05,2120,95,189028,89.12211221122112,6
0.05,2121,93,189121,89.12393967954759,8
0.05,2122,94,189215,89.12623645784268,7
0.05,2123,94,189309,89.12853107344633,7
0.05,2124,96,189405,89.13176470588235,6
0.05,2125,95,189500,89.13452492944496,6
0.05,2126,94,189594,89.13681241184767,8
0.05,2127,92,189686,89.13815789473684,9
0.05,2128,92,189778,89.13950211366839,10
0.05,2129,92,189870,89.14084507042253,9
0.05,2130,95,189965,89.14359455654622,7
0.05,2131,96,190061,89.14681050656661,6
0.05,2132,94,190155,89.14908579465542,7
0.05,2133,94,190249,89.15135895032802,7
0.05,2134,27,190276,89.12224824355972,6
0.05,2135,94,190370,89.12453183520599,8
0.05,2136,93,190463,89.1263453439401,8
0.05,2137,94,190557,89.12862488306828,7
0.05,2138,93,190650,89.1304347826087,8
0.05,2139,95,190745,89.13317757009345,6
0.05,2140,96,190841,89.13638486688464,6
0.05,2141,94,190935,89.13865546218487,7
0.05,2142,96,191031,89.14185720951937,6
0.05,2143,95,191126,89.14458955223881,6
0.05,2144,92,191218,89.14592074592075,10
0.05,2145,94,191312,89.14818266542405,7
0.05,2146,94,191406,89.15044247787611,7
0.05,2147,96,191502,89.1536312849162,6
0.05,2148,93,191595,89.15542112610517,8
0.05,2149,95,191690,89.15813953488372,6
0.05,2150,94,191784,89.16039051603906,8
0.05,2151,92,191876,89.16171003717471,9
0.05,2152,94,191970,89.16395726892708,7
0.05,2153,96,192066,89.16713091922006,6
0.05,2154,94,192160,89.16937354988399,7
0.05,2155,95,192255,89.17207792207792,6
0.05,2156,95,192350,89.17477978674084,6
0.05,2157,94,192444,89.17701575532901,7
0.05,2158,93,192537,89.17878647522001,9
0.05,2159,90,192627,89.17916666666666,11
0.05,2160,94,192721,89.18139750115687,7
0.05,2161,96,192817,89.1845513413506,6
0.05,2162,92,192909,89.18585298196949,9
0.05,2163,95,193004,89.18853974121997,7
0.05,2164,96,193100,89.19168591224019,7
0.05,2165,92,193192,89.19298245614036,9
0.05,2166,91,193283,89.19381633594831,10
0.05,2167,94,193377,89.1960332103321,7
0.05,2168,93,193470,89.19778699861688,8
0.05,2169,93,193563,89.19953917050691,8
0.05,2170,90,193653,89.19990787655458,11
0.05,2171,93,193746,89.20165745856353,9
0.05,2172,94,193840,89.2038656235619,7
0.05,2173,27,193867,89.1752529898804,6
0.05,2174,96,193963,89.1783908045977,6
0.05,2175,95,194058,89.1810661764706,7
0.05,2176,95,194153,89.1837390904915,6
0.05,2177,94,194247,89.18595041322314,7
0.05,2178,92,194339,89.1872418540615,9
0.05,2179,92,194431,89.18853211009174,9
0.05,2180,91,194522,89.18936267767079,10
0.05,2181,96,194618,89.19248395967003,6
0.05,2182,92,194710,89.19377004122767,9
0.05,2183,92,194802,89.19505494505495,9
0.05,2184,91,194893,89.195881006865,10
0.05,2185,93,194986,89.19762122598353,8
0.05,2186,92,195078,89.19890260631001,9
0.05,2187,94,195172,89.20109689213893,7
0.05,2188,94,195266,89.20328917313842,7
0.05,2189,93,195359,89.20502283105023,8
0.05,2190,94,195453,89.20721131903241,7
0.05,2191,94,195547,89.20939781021897,8
0.05,2192,91,195638,89.21021431828545,10
0.05,2193,93,195731,89.21194165907019,8
0.05,2194,93,195824,89.21366742596811,8
0.05,2195,94,195918,89.21584699453553,7
0.05,2196,90,196008,89.21620391442876,11
0.05,2197,27,196035,89.18789808917198,6
0.05,2198,93,196128,89.18963165075034,8
0.05,2199,96,196224,89.19272727272727,6
0.05,2200,95,196319,89.19536574284416,7
0.05,2201,94,196413,89.1975476839237,7
0.05,2202,95,196508,89.20018157058557,6
0.05,2203,93,196601,89.2019056261343,8
0.05,2204,93,196694,89.20362811791384,8
0.05,2205,94,196788,89.20580235720762,7
0.05,2206,91,196879,89.20661531490711,11
0.05,2207,93,196972,89.20833333333333,8
0.05,2208,92,197064,89.20959710276144,9
0.05,2209,94,197158,89.21176470588236,7
0.05,2210,89,197247,89.21166892808684,12
0.05,2211,94,197341,89.2138336347197,7
0.05,2212,92,197433,89.21509263443289,9
0.05,2213,86,197519,89.21364046973802,15
0.05,2214,94,197613,89.2158013544018,7
0.05,2215,94,197707,89.21796028880867,7
0.05,2216,96,197803,89.22101939557962,6
0.05,2217,94,197897,89.22317403065826,7
0.05,2218,93,197990,89.22487607030193,8
0.05,2219,94,198084,89.22702702702702,7
0.05,2220,92,198176,89.22827555155335,9
0.05,2221,95,198271,89.23087308730874,7
0.05,2222,94,198365,89.23301844354476,7
0.05,2223,92,198457,89.23426258992805,9
0.05,2224,90,198547,89.23460674157303,11
0.05,2225,95,198642,89.23719676549865,6
0.05,2226,94,198736,89.23933542882801,7
0.05,2227,95,198831,89.24192100538599,6
0.05,2228,91,198922,89.24270973530732,10
0.05,2229,93,199015,89.24439461883408,8
0.05,2230,94,199109,89.24652622142537,7
0.05,2231,92,199201,89.24775985663082,9
0.05,2232,93,199294,89.24944021495746,8
0.05,2233,96,199390,89.25246195165622,6
0.05,2234,94,199484,89.25458612975392,7
0.05,2235,94,199578,89.2567084078712,7
0.05,2236,96,199674,89.25972284309343,6
0.05,2237,93,199767,89.26139410187668,8
0.05,2238,94,199861,89.26351049575703,7
0.05,2239,26,199887,89.23526785714286,7
0.05,2240,94,199981,89.23739402052655,8
0.05,2241,95,200076,89.2399643175736,6
0.05,2242,93,200169,89.24164065983058,8
0.05,2243,91,200260,89.24242424242425,10
0.05,2244,90,200350,89.24276169265033,11
0.05,2245,94,200444,89.24487978628673,7
0.05,2246,94,200538,89.24699599465954,7
0.05,2247,93,200631,89.24866548042705,8
0.05,2248,95,200726,89.25122276567363,6
0.05,2249,27,200753,89.22355555555555,6
0.05,2250,94,200847,89.22567747667703,8
0.05,2251,93,200940,89.22735346358792,9
0.05,2252,95,201035,89.22991566799823,8
0.05,2253,95,201130,89.23247559893522,7
0.05,2254,86,201216,89.23104212860311,16
0.05,2255,91,201307,89.23182624113475,10
0.05,2256,96,201403,89.23482498892335,6
0.05,2257,94,201497,89.23693534100974,7
0.05,2258,93,201590,89.23860115095175,8
0.05,2259,91,201681,89.23938053097345,10
0.05,2260,93,201774,89.24104378593543,8
0.05,2261,96,201870,89.24403183023873,6
0.05,2262,96,201966,89.24701723376049,6
0.05,2263,96,202062,89.25,6
0.05,2264,92,202154,89.25121412803531,9
0.05,2265,96,202250,89.25419240953221,6
0.05,2266,96,202346,89.25716806352007,6
0.05,2267,95,202441,89.25970017636685,6
0.05,2268,96,202537,89.26267078007933,6
0.05,2269,95,202632,89.26519823788546,6
0.05,2270,93,202725,89.26684280052841,8
0.05,2271,92,202817,89.26804577464789,9
0.05,2272,92,202909,89.26924769027717,9
0.05,2273,92,203001,89.27044854881267,9
0.05,2274,94,203095,89.27252747252747,7
0.05,2275,93,203188,89.27416520210896,8
0.05,2276,93,203281,89.2758014931928,8
0.05,2277,93,203374,89.2774363476734,8
0.05,2278,93,203467,89.27906976744185,8
0.05,2279,94,203561,89.2811403508772,7
0.05,2280,95,203656,89.28364752301623,6
0.05,2281,94,203750,89.28571428571429,7
0.05,2282,95,203845,89.28821725799386,7
0.05,2283,95,203940,89.2907180385289,6
0.05,2284,93,204033,89.29234135667396,8
0.05,2285,93,204126,89.29396325459318,8
0.05,2286,93,204219,89.29558373414955,8
0.05,2287,96,204315,89.29851398601399,6
0.05,2288,92,204407,89.29969418960245,9
0.05,2289,96,204503,89.30262008733625,6
0.05,2290,96,204599,89.30554343081624,6
0.05,2291,94,204693,89.30759162303664,7
0.05,2292,94,204787,89.30963802878325,8
0.05,2293,94,204881,89.31168265039233,7
0.05,2294,95,204976,89.31416122004357,6
0.05,2295,94,205070,89.31620209059234,7
0.05,2296,95,205165,89.31867653461036,6
0.05,2297,94,205259,89.3207136640557,8
0.05,2298,96,205355,89.32361896476729,6
0.05,2299,96,205451,89.32652173913044,6
0.05,2300,91,205542,89.32724902216428,10
0.05,2301,94,205636,89.32927888792355,7
0.05,2302,96,205732,89.33217542336084,6
0.05,2303,93,205825,89.33376736111111,8
0.05,2304,93,205918,89.3353579175705,9
0.05,2305,94,206012,89.33738074588031,7
0.05,2306,93,206105,89.33896835717381,8
0.05,2307,94,206199,89.34098786828423,7
0.05,2308,93,206292,89.34257254222607,8
0.05,2309,96,206388,89.34545454545454,6
0.05,2310,93,206481,89.34703591518823,8
0.05,2311,95,206576,89.34948096885813,7
0.05,2312,92,206668,89.35062689148292,9
0.05,2313,96,206764,89.35350043215212,6
0.05,2314,94,206858,89.35550755939525,7
0.05,2315,94,206952,89.35751295336787,8
0.05,2316,94,207046,89.3595166163142,7
0.05,2317,94,207140,89.36151855047454,7
0.05,2318,96,207236,89.36438119879259,6
0.05,2319,95,207331,89.36681034482758,6
0.05,2320,92,207423,89.36794485135718,9
0.05,2321,96,207519,89.37080103359173,6
0.05,2322,94,207613,89.37279380111924,7
0.05,2323,96,207709,89.37564543889845,6
0.05,2324,94,207803,89.37763440860215,7
0.05,2325,93,207896,89.37919174548581,8
0.05,2326,92,207988,89.38031800601632,9
0.05,2327,96,208084,89.38316151202748,6
0.05,2328,96,208180,89.38600257621297,6
0.05,2329,90,208270,89.3862660944206,11
0.05,2330,95,208365,89.38867438867439,7
0.05,2331,94,208459,89.39065180102916,7
0.05,2332,95,208554,89.39305615087869,6
0.05,2333,92,208646,89.39417309340189,9
0.05,2334,94,208740,89.39614561027837,7
0.05,2335,92,208832,89.3972602739726,9
0.05,2336,95,208927,89.39965768078733,6
0.05,2337,93,209020,89.40119760479043,8
0.05,2338,96,209116,89.40401881145789,6
0.05,2339,94,209210,89.40598290598291,7
0.05,2340,95,209305,89.40837249038873,6
0.05,2341,94,209399,89.41033304867635,8
0.05,2342,94,209493,89.4122919334187,7
0.05,2343,96,209589,89.4151023890785,6
0.05,2344,96,209685,89.41791044776119,6
0.05,2345,96,209781,89.42071611253196,6
0.05,2346,92,209873,89.4218150830848,10
0.05,2347,93,209966,89.42333901192504,8
0.05,2348,95,210061,89.42571306939124,6
0.05,2349,94,210155,89.42765957446808,7
0.05,2350,93,210248,89.42917907273501,9
0.05,2351,95,210343,89.43154761904762,6
0.05,2352,95,210438,89.4339141521462,6
0.05,2353,94,210532,89.43585386576041,7
0.05,2354,93,210625,89.43736730360934,9
0.05,2355,91,210716,89.43803056027164,10
0.05,2356,92,210808,89.43911752227407,9
0.05,2357,94,210902,89.44105173876166,7
0.05,2358,96,210998,89.44383213225943,6
0.05,2359,92,211090,89.44491525423729,9
0.05,2360,95,211185,89.44726810673444,6
0.05,2361,90,211275,89.44750211685013,11
0.05,2362,94,211369,89.44942869234025,8
0.05,2363,94,211463,89.45135363790186,7
0.05,2364,95,211558,89.4536997885835,6
0.05,2365,93,211651,89.45519864750634,8
0.05,2366,96,211747,89.45796366708915,6
0.05,2367,94,211841,89.45988175675676,7
0.05,2368,95,211936,89.46222034613761,6
0.05,2369,89,212025,89.4620253164557,12
0.05,2370,94,212119,89.46393926613243,7
0.05,2371,94,212213,89.4658516020236,7
0.05,2372,95,212308,89.46818373367046,7
0.05,2373,86,212394,89.46672283066555,15
0.05,2374,96,212490,89.46947368421053,7
0.05,2375,94,212584,89.47138047138047,7
0.05,2376,95,212679,89.47370635254522,6
0.05,2377,94,212773,89.47560975609755,7
0.05,2378,87,212860,89.47456914670029,14
0.05,2379,96,212956,89.47731092436975,6
0.05,2380,91,213047,89.47795044099118,10
0.05,2381,94,213141,89.47984886649874,8
0.05,2382,94,213235,89.48174569869911,7
0.05,2383,94,213329,89.48364093959732,7
0.05,2384,95,213424,89.4859538784067,6
0.05,2385,93,213517,89.48742665549037,8
0.05,2386,92,213609,89.48847926267281,10
0.05,2387,93,213702,89.48994974874371,8
0.05,2388,94,213796,89.49183758894935,7
0.05,2389,94,213890,89.49372384937239,7
0.05,2390,95,213985,89.49602676704308,6
0.05,2391,95,214080,89.49832775919732,6
0.05,2392,96,214176,89.50104471374843,6
0.05,2393,94,214270,89.50292397660819,7
0.05,2394,95,214365,89.50521920668058,6
0.05,2395,94,214459,89.50709515859766,7
0.05,2396,94,214553,89.50896954526492,7
0.05,2397,94,214647,89.51084236864054,7
0.05,2398,94,214741,89.51271363067946,8
0.05,2399,94,214835,89.51458333333333,7
0.05,2400,93,214928,89.51603498542273,8
0.05,2401,92,215020,89.51706910907578,9
0.05,2402,95,215115,89.51935081148564,6
0.05,2403,92,215207,89.5203826955075,9
0.05,2404,93,215300,89.52182952182952,8
0.05,2405,94,215394,89.52369077306733,7
0.05,2406,95,215489,89.52596593269631,7
0.05,2407,94,215583,89.52782392026577,7
0.05,2408,93,215676,89.52926525529266,8
0.05,2409,92,215768,89.53029045643153,9
0.05,2410,95,215863,89.53255910410618,6
0.05,2411,92,215955,89.53358208955224,9
0.05,2412,95,216050,89.53584749274762,6
0.05,2413,27,216077,89.50994200497101,6
0.05,2414,95,216172,89.51221532091097,6
0.05,2415,94,216266,89.51407284768212,7
0.05,2416,94,216360,89.51592883740173,7
0.05,2417,95,216455,89.51819685690653,6
0.05,2418,93,216548,89.51963621331129,8
0.05,2419,90,216638,89.51983471074381,11
0.05,2420,95,216733,89.52209830648492,6
0.05,2421,94,216827,89.52394715111478,7
0.05,2422,93,216920,89.52538175815106,8
0.05,2423,94,217014,89.52722772277228,8
0.05,2424,91,217105,89.52783505154639,10
0.05,2425,95,217200,89.53009068425392,6
0.05,2426,96,217296,89.5327564894932,6
0.05,2427,94,217390,89.5345963756178,7
0.05,2428,94,217484,89.53643474680939,7
0.05,2429,94,217578,89.53827160493827,7
0.05,2430,93,217671,89.53969559851913,8
0.05,2431,94,217765,89.54152960526316,7
0.05,2432,95,217860,89.54377311960542,6
0.05,2433,93,217953,89.54519309778144,8
0.05,2434,95,218048,89.54743326488706,7
0.05,2435,95,218143,89.54967159277504,6
0.05,2436,95,218238,89.55190808370948,7
0.05,2437,94,218332,89.55373256767842,7
0.05,2438,95,218427,89.55596555965559,6
0.05,2439,96,218523,89.55860655737705,6
0.05,2440,92,218615,89.55960671855797,9
0.05,2441,91,218706,89.56019656019656,10
0.05,2442,95,218801,89.56242325010233,6
0.05,2443,91,218892,89.56301145662847,11
0.05,2444,93,218985,89.56441717791411,10
0.05,2445,93,219078,89.56582174979559,8
0.05,2446,93,219171,89.56722517368206,8
0.05,2447,94,219265,89.56903594771242,7
0.05,2448,95,219360,89.57125357288689,6
0.05,2449,92,219452,89.57224489795918,9
0.05,2450,93,219545,89.57364341085271,8
0.05,2451,94,219639,89.57544861337684,7
0.05,2452,27,219666,89.54993885038728,6
0.05,2453,93,219759,89.55134474327629,8
0.05,2454,93,219852,89.55274949083503,8
0.05,2455,91,219943,89.55333876221498,10
0.05,2456,94,220037,89.55514855514855,8
0.05,2457,94,220131,89.55695687550855,7
0.05,2458,93,220224,89.5583570557137,9
0.05,2459,96,220320,89.5609756097561,6
0.05,2460,94,220414,89.56277935798455,7
0.05,2461,94,220508,89.56458164094232,7
0.05,2462,96,220604,89.56719447827852,6
0.05,2463,94,220698,89.56899350649351,7
0.05,2464,94,220792,89.5707910750507,8
0.05,2465,91,220883,89.57137064071371,10
0.05,2466,95,220978,89.57357113903527,6
0.05,2467,92,221070,89.57455429497568,9
0.05,2468,94,221164,89.57634669906845,7
0.05,2469,95,221259,89.57854251012145,6
0.05,2470,94,221353,89.58033184945366,7
0.05,2471,95,221448,89.58252427184466,6
0.05,2472,93,221541,89.58390618681763,8
0.05,2473,94,221635,89.58569118835894,7
0.05,2474,94,221729,89.58747474747474,7
0.05,2475,95,221824,89.58966074313409,6
0.05,2476,96,221920,89.59224868792894,6
0.05,2477,95,222015,89.59443099273608,6
0.05,2478,94,222109,89.59620814844695,7
0.05,2479,96,222205,89.59879032258064,6
0.05,2480,96,222301,89.60137041515517,6
0.05,2481,94,222395,89.60314262691378,7
0.05,2482,91,222486,89.60370519532823,10
0.05,2483,96,222582,89.60628019323671,6
0.05,2484,93,222675,89.6076458752515,8
0.05,2485,95,222770,89.60981496379726,6
0.05,2486,92,222862,89.61077603538399,9
0.05,2487,96,222958,89.61334405144694,6
0.05,2488,94,223052,89.61510646846124,7
0.05,2489,94,223146,89.61686746987952,8
0.05,2490,94,223240,89.61862705740667,8
0.05,2491,95,223335,89.62078651685393,6
0.05,2492,92,223427,89.62174087444845,9
0.05,2493,93,223520,89.62309542902968,9
0.05,2494,95,223615,89.625250501002,6
0.05,2495,94,223709,89.6270032051282,7
0.05,2496,95,223804,89.62915498598318,6
0.05,2497,94,223898,89.63090472377903,7
0.05,2498,94,223992,89.63265306122449,7
0.05,2499,95,224087,89.6348,6
0.05,2500,91,224178,89.63534586165534,10
0.05,2501,93,224271,89.63669064748201,8
0.05,2502,96,224367,89.6392329204954,6
0.05,2503,94,224461,89.64097444089457,7
0.05,2504,95,224556,89.6431137724551,6
0.05,2505,94,224650,89.64485235434957,7
0.05,2506,91,224741,89.64539289988033,10
0.05,2507,92,224833,89.646331738437,9
0.05,2508,93,224926,89.64766839378238,8
0.05,2509,93,225019,89.64900398406374,8
0.05,2510,94,225113,89.65073675826363,7
0.05,2511,95,225208,89.65286624203821,7
0.05,2512,95,225303,89.6549940310386,6
0.05,2513,93,225396,89.6563245823389,8
0.05,2514,94,225490,89.65805168986084,7
0.05,2515,96,225586,89.66057233704292,6
0.05,2516,95,225681,89.6626936829559,6
0.05,2517,27,225708,89.63780778395552,6
0.05,2518,95,225803,89.63993648273124,6
0.05,2519,96,225899,89.64246031746032,6
0.05,2520,92,225991,89.64339547798492,9
0.05,2521,94,226085,89.64512291831879,8
0.05,2522,94,226179,89.64684898929845,7
0.05,2523,90,226269,89.64698890649763,11
0.05,2524,92,226361,89.6479207920792,9
0.05,2525,96,226457,89.65043547110055,6
0.05,2526,92,226549,89.65136525524338,9
0.05,2527,96,226645,89.65387658227849,6
0.05,2528,96,226741,89.65638592328983,6
0.05,2529,91,226832,89.65691699604743,10
0.05,2530,94,226926,89.65863295140261,7
0.05,2531,25,226951,89.6330963665087,9
0.05,2532,93,227044,89.63442558231347,8
0.05,2533,94,227138,89.63614838200473,7
0.05,2534,96,227234,89.63865877712031,6
0.05,2535,93,227327,89.63998422712933,8
0.05,2536,26,227353,89.61489948758376,6
0.05,2537,93,227446,89.61623325453112,8
0.05,2538,94,227540,89.61795982670343,7
0.05,2539,95,227635,89.62007874015748,6
0.05,2540,93,227728,89.62140889413617,8
0.05,2541,96,227824,89.62391817466562,6
0.05,2542,95,227919,89.62603224537948,6
0.05,2543,94,228013,89.62775157232704,8
0.05,2544,91,228104,89.62829076620825,10
0.05,2545,94,228198,89.63000785545954,8
0.05,2546,89,228287,89.62976050255202,12
0.05,2547,95,228382,89.63186813186813,6
0.05,2548,96,228478,89.63436641820321,6
0.05,2549,95,228573,89.6364705882353,7
0.05,2550,96,228669,89.63896511172089,6
0.05,2551,95,228764,89.641065830721,6
0.05,2552,95,228859,89.64316490403446,6
0.05,2553,96,228955,89.64565387627252,6
0.05,2554,25,228980,89.62035225048923,7
0.05,2555,93,229073,89.6216744913928,8
0.05,2556,96,229169,89.62416894798592,6
0.05,2557,93,229262,89.62548866301799,8
0.05,2558,90,229352,89.62563501367721,11
0.05,2559,95,229447,89.627734375,6
0.05,2560,96,229543,89.63022256930887,6
0.05,2561,94,229637,89.6319281811085,7
0.05,2562,94,229731,89.63363246195864,7
0.05,2563,94,229825,89.63533541341654,8
0.05,2564,93,229918,89.63664717348928,8
0.05,2565,91,230009,89.63717848791894,10
0.05,2566,93,230102,89.63848850798598,9
0.05,2567,91,230193,89.63901869158879,11
0.05,2568,92,230285,89.63993771895679,9
0.05,2569,91,230376,89.64046692607003,10
0.05,2570,95,230471,89.64255153636718,6
0.05,2571,94,230565,89.64424572317263,7
0.05,2572,96,230661,89.64671589584142,6
0.05,2573,96,230757,89.64918414918415,6
0.05,2574,94,230851,89.65087378640777,7
0.05,2575,93,230944,89.65217391304348,8
0.05,2576,94,231038,89.65386107877377,7
0.05,2577,94,231132,89.655546935609,7
0.05,2578,94,231226,89.65723148507173,8
0.05,2579,92,231318,89.65813953488372,9
0.05,2580,95,231413,89.66020922123208,8
0.05,2581,96,231509,89.66266460108443,6
0.05,2582,95,231604,89.66473093302362,6
0.05,2583,94,231698,89.66640866873065,7
0.05,2584,94,231792,89.66808510638297,7
0.05,2585,94,231886,89.66976024748647,7
0.05,2586,94,231980,89.67143409354465,7
0.05,2587,96,232076,89.67387944358578,6
0.05,2588,93,232169,89.6751641560448,8
0.05,2589,96,232265,89.67760617760618,6
0.05,2590,96,232361,89.68004631416441,6
0.05,2591,25,232386,89.6550925925926,8
0.05,2592,94,232480,89.65676822213652,8
0.05,2593,92,232572,89.65767154973015,9
0.05,2594,94,232666,89.65934489402697,7
0.05,2595,93,232759,89.66063174114022,8
0.05,2596,93,232852,89.66191759722757,8
0.05,2597,94,232946,89.66358737490377,7
0.05,2598,93,233039,89.66487110427087,8
0.05,2599,96,233135,89.66730769230769,6
0.05,2600,94,233229,89.66897347174164,7
0.05,2601,96,233325,89.67140661029977,6
0.05,2602,94,233419,89.67306953515175,7
0.05,2603,90,233509,89.67319508448541,11
0.05,2604,19,233528,89.64606525911708,13
0.05,2605,94,233622,89.64773599386032,7
0.05,2606,90,233712,89.64787111622555,11
0.05,2607,93,233805,89.64915644171779,8
0.05,2608,93,233898,89.65044078190877,8
0.05,2609,94,233992,89.65210727969348,7
0.05,2610,94,234086,89.65377250095749,7
0.05,2611,93,234179,89.65505359877488,9
0.05,2612,94,234273,89.65671641791045,8
0.05,2613,94,234367,89.6583779648049,7
0.05,2614,93,234460,89.65965583173997,9
0.05,2615,95,234555,89.66169724770643,6
0.05,2616,94,234649,89.6633549866259,7
0.05,2617,91,234740,89.66386554621849,10
0.05,2618,94,234834,89.66552119129439,7
0.05,2619,95,234929,89.66755725190839,6
0.05,2620,93,235022,89.66882869133919,8
0.05,2621,94,235116,89.67048054919908,7
0.05,2622,94,235210,89.67213114754098,7
0.05,2623,95,235305,89.67416158536585,6
0.05,2624,27,235332,89.65028571428572,6
0.05,2625,96,235428,89.65270373191166,6
0.05,2626,94,235522,89.65435858393604,7
0.05,2627,94,235616,89.65601217656013,7
0.05,2628,96,235712,89.65842525675161,6
0.05,2629,94,235806,89.66007604562738,8
0.05,2630,94,235900,89.66172557962751,8
0.05,2631,89,235989,89.66147416413374,12
0.05,2632,91,236080,89.66198252943411,10
0.05,2633,26,236106,89.6378132118451,8
0.05,2634,92,236198,89.63870967741936,9
0.05,2635,93,236291,89.63998482549317,8
0.05,2636,92,236383,89.64087978763747,9
0.05,2637,94,236477,89.64253222137984,7
0.05,2638,89,236566,89.64228874573702,12
0.05,2639,94,236660,89.64393939393939,7
0.05,2640,93,236753,89.64521014767134,8
0.05,2641,94,236847,89.64685844057531,7
0.05,2642,94,236941,89.64850548618993,7
0.05,2643,92,237033,89.64939485627836,10
0.05,2644,94,237127,89.65103969754253,7
0.05,2645,94,237221,89.65268329554044,7
0.05,2646,94,237315,89.65432565168115,7
0.05,2647,27,237342,89.63066465256797,6
0.05,2648,92,237434,89.6315590788977,9
0.05,2649,94,237528,89.63320754716982,7
0.05,2650,95,237623,89.63523198792909,7
0.05,2651,93,237716,89.63650075414782,8
0.05,2652,93,237809,89.63776856388994,8
0.05,2653,94,237903,89.63941220798795,7
0.05,2654,92,237995,89.64030131826742,9
0.05,2655,94,238089,89.64194277108433,7
0.05,2656,93,238182,89.64320662401204,8
0.05,2657,93,238275,89.64446952595937,8
0.05,2658,94,238369,89.64610755923279,7
0.05,2659,94,238463,89.64774436090225,7
0.05,2660,92,238555,89.64862833521232,9
0.05,2661,94,238649,89.65026296018031,7
0.05,2662,95,238744,89.6522718738265,6
0.05,2663,90,238834,89.6524024024024,11
0.05,2664,95,238929,89.65440900562852,6
0.05,2665,95,239024,89.65641410352588,6
0.05,2666,84,239108,89.65429321334832,17
0.05,2667,96,239204,89.65667166416792,6
0.05,2668,95,239299,89.65867366054702,6
0.05,2669,90,239389,89.65880149812735,11
0.05,2670,95,239484,89.66080119805316,6
0.05,2671,94,239578,89.6624251497006,7
0.05,2672,95,239673,89.66442199775533,6
0.05,2673,94,239767,89.66604338070307,7
0.05,2674,94,239861,89.66766355140187,7
0.05,2675,96,239957,89.67002989536621,6
0.05,2676,96,240053,89.67239447142323,6
0.05,2677,94,240147,89.67401045556386,7
0.05,2678,93,240240,89.67525195968645,8
0.05,2679,94,240334,89.67686567164179,7
0.05,2680,92,240426,89.67773218948153,9
0.05,2681,95,240521,89.67971662938106,7
0.05,2682,95,240616,89.68169959001118,6
0.05,2683,93,240709,89.68293591654248,8
0.05,2684,93,240802,89.68417132216015,8
0.05,2685,94,240896,89.68577810871184,7
0.05,2686,95,240991,89.68775586155564,7
0.05,2687,95,241086,89.68973214285714,6
0.05,2688,94,241180,89.69133506879881,7
0.05,2689,93,241273,89.69256505576209,8
0.05,2690,94,241367,89.694165737644,7
0.05,2691,94,241461,89.69576523031203,7
0.05,2692,96,241557,89.69810620126253,6
0.05,2693,25,241582,89.67409057164069,8
0.05,2694,94,241676,89.67569573283859,7
0.05,2695,95,241771,89.6776706231454,6
0.05,2696,91,241862,89.67816091954023,10
0.05,2697,92,241954,89.67902149740549,9
0.05,2698,92,242046,89.67988143756946,9
0.05,2699,93,242139,89.68111111111111,8
0.05,2700,89,242228,89.68085894113291,12
0.05,2701,94,242322,89.68245743893412,8
0.05,2702,95,242417,89.68442471328154,6
0.05,2703,91,242508,89.68491124260355,10
0.05,2704,92,242600,89.68576709796673,9
0.05,2705,22,242622,89.66075388026607,10
0.05,2706,92,242714,89.66161802733653,9
0.05,2707,94,242808,89.66322008862629,7
0.05,2708,91,242899,89.66371354743448,10
0.05,2709,89,242988,89.66346863468635,12
0.05,2710,94,243082,89.66506824050165,7
0.05,2711,93,243175,89.66629793510324,8
0.05,2712,25,243200,89.64246221894582,8
0.05,2713,93,243293,89.64369933677229,8
0.05,2714,94,243387,89.64530386740331,7
0.05,2715,96,243483,89.64764359351989,6
0.05,2716,96,243579,89.64998159735002,6
0.05,2717,96,243675,89.6523178807947,6
0.05,2718,96,243771,89.65465244575212,6
0.05,2719,94,243865,89.65625,7
0.05,2720,92,243957,89.65711135611907,9
0.05,2721,94,244051,89.65870683321087,7
0.05,2722,92,244143,89.65956665442526,9
0.05,2723,94,244237,89.66116005873715,7
0.05,2724,91,244328,89.66165137614679,10
0.05,2725,95,244423,89.66360968451944,6
0.05,2726,94,244517,89.66519985331867,7
0.05,2727,92,244609,89.66605571847508,9
0.05,2728,94,244703,89.66764382557713,7
0.05,2729,95,244798,89.66959706959707,6
0.05,2730,94,244892,89.6711827169535,7
0.05,2731,21,244913,89.64604685212299,11
0.05,2732,93,245006,89.64727405781193,8
0.05,2733,88,245094,89.64667154352597,13
0.05,2734,95,245189,89.64862888482632,7
0.05,2735,93,245282,89.64985380116958,8
0.05,2736,94,245376,89.65144318597004,7
0.05,2737,93,245469,89.65266617969321,8
0.05,2738,94,245563,89.65425337714494,7
0.05,2739,94,245657,89.6558394160584,7
0.05,2740,95,245752,89.65778912805546,6
0.05,2741,91,245843,89.65827862873815,10
0.05,2742,93,245936,89.65949690120306,8
0.05,2743,27,245963,89.63666180758017,6
0.05,2744,96,246059,89.63897996357012,6
0.05,2745,90,246149,89.63911143481428,11
0.05,2746,94,246243,89.64069894430287,7
0.05,2747,96,246339,89.64301310043668,6
0.05,2748,93,246432,89.64423426700618,8
0.05,2749,94,246526,89.64581818181819,7
0.05,2750,93,246619,89.64703744093057,8
0.05,2751,90,246709,89.64716569767442,11
0.05,2752,94,246803,89.64874682164911,7
0.05,2753,93,246896,89.64996368917937,8
0.05,2754,94,246990,89.65154264972777,7
0.05,2755,94,247084,89.65312046444122,7
0.05,2756,93,247177,89.65433442147261,8
0.05,2757,93,247270,89.65554749818709,8
0.05,2758,94,247364,89.65712214570496,7
0.05,2759,96,247460,89.65942028985508,6
0.05,2760,94,247554,89.66099239406012,7
0.05,2761,94,247648,89.66256335988415,7
0.05,2762,92,247740,89.66340933767644,9
0.05,2763,96,247836,89.6657018813314,6
0.05,2764,94,247930,89.66726943942133,7
0.05,2765,95,248025,89.66919739696313,6
0.05,2766,92,248117,89.67003975424647,9
0.05,2767,94,248211,89.67160404624278,7
0.05,2768,95,248306,89.67352834958469,6
0.05,2769,95,248401,89.67545126353791,7
0.05,2770,94,248495,89.6770119090581,7
0.05,2771,93,248588,89.67821067821068,8
0.05,2772,95,248683,89.68012982329607,6
0.05,2773,94,248777,89.68168709444845,7
0.05,2774,93,248870,89.68288288288288,8
0.05,2775,94,248964,89.68443804034582,8
0.05,2776,95,249059,89.68635217861001,6
0.05,2777,96,249155,89.6886249100072,6
0.05,2778,94,249249,89.69017632241814,7
0.05,2779,92,249341,89.6910071942446,9
0.05,2780,93,249434,89.69219705142035,8
0.05,2781,27,249461,89.66966211358735,6
0.05,2782,93,249554,89.67085878548329,8
0.05,2783,94,249648,89.67241379310344,8
0.05,2784,94,249742,89.67396768402155,7
0.05,2785,96,249838,89.67623833452978,6
0.05,2786,95,249933,89.67814854682454,6
0.05,2787,93,250026,89.6793400286944,8
0.05,2788,94,250120,89.6808892076013,7
0.05,2789,96,250216,89.6831541218638,6
0.05,2790,95,250311,89.68505911859549,6
0.05,2791,95,250406,89.68696275071633,6
0.05,2792,96,250502,89.68922305764411,6
0.05,2793,95,250597,89.69112383679312,7
0.05,2794,95,250692,89.69302325581396,7
0.05,2795,95,250787,89.69492131616595,7
0.05,2796,93,250880,89.69610296746514,8
0.05,2797,94,250974,89.6976411722659,7
0.05,2798,95,251069,89.69953554841014,6
0.05,2799,94,251163,89.70107142857142,7
0.05,2800,94,251257,89.70260621206712,7
0.05,2801,93,251350,89.7037830121342,8
0.05,2802,93,251443,89.70495897252944,9
0.05,2803,96,251539,89.70720399429386,6
0.05,2804,92,251631,89.70802139037433,9
0.05,2805,96,251727,89.71026372059872,6
0.05,2806,95,251822,89.71214820092625,6
0.05,2807,94,251916,89.71367521367522,7
0.05,2808,88,252004,89.71306514773941,13
0.05,2809,95,252099,89.71494661921709,6
0.05,2810,96,252195,89.7171824973319,6
0.05,2811,95,252290,89.71906116642958,6
0.05,2812,95,252385,89.72093849982225,6
0.05,2813,94,252479,89.72245913290689,7
0.05,2814,89,252568,89.72220248667851,13
0.05,2815,92,252660,89.72301136363636,9
0.05,2816,95,252755,89.72488462903799,6
0.05,2817,90,252845,89.7249822569198,11
0.05,2818,95,252940,89.72685349414687,6
0.05,2819,92,253032,89.72765957446809,9
0.05,2820,95,253127,89.72952853598015,6
0.05,2821,94,253221,89.73104181431609,8
0.05,2822,94,253315,89.73255402054552,8
0.05,2823,91,253406,89.73300283286119,10
0.05,2824,94,253500,89.73451327433628,7
0.05,2825,94,253594,89.73602264685067,7
0.05,2826,93,253687,89.73717721966749,8
0.05,2827,93,253780,89.73833097595474,8
0.05,2828,94,253874,89.73983739837398,7
0.05,2829,93,253967,89.74098939929328,8
0.05,2830,94,254061,89.74249381843872,8
0.05,2831,95,254156,89.74435028248588,6
0.05,2832,22,254178,89.72043769855277,11
0.05,2833,91,254269,89.72088920254058,10
0.05,2834,27,254296,89.69876543209877,6
0.05,2835,96,254392,89.70098730606487,6
0.05,2836,94,254486,89.70250264363764,7
0.05,2837,94,254580,89.70401691331924,8
0.05,2838,94,254674,89.70553011623811,7
0.05,2839,94,254768,89.70704225352112,7
0.05,2840,96,254864,89.70925730376628,6
0.05,2841,-46,254818,89.66150598170303,10
0.05,2842,92,254910,89.66232852620472,9
0.05,2843,94,255004,89.66385372714487,7
0.05,2844,94,255098,89.66537785588753,7
0.05,2845,96,255194,89.66760365425158,6
0.05,2846,94,255288,89.66912539515279,7
0.05,2847,94,255382,89.67064606741573,7
0.05,2848,96,255478,89.67286767286767,6
0.05,2849,93,255571,89.6740350877193,8
0.05,2850,25,255596,89.65135040336725,8
0.05,2851,92,255688,89.65217391304348,9
0.05,2852,95,255783,89.65404837013669,6
0.05,2853,95,255878,89.65592151366504,7
0.05,2854,93,255971,89.65709281961472,8
0.05,2855,87,256058,89.656162464986,14
0.05,2856,94,256152,89.65768288414421,7
0.05,2857,93,256245,89.6588523442967,8
0.05,2858,92,256337,89.65967121371109,9
0.05,2859,94,256431,89.66118881118881,7
0.05,2860,94,256525,89.6627053477805,8
0.05,2861,95,256620,89.66457023060796,6
0.05,2862,93,256713,89.66573524275236,9
0.05,2863,96,256809,89.6679469273743,6
0.05,2864,24,256833,89.64502617801047,8
0.05,2865,94,256927,89.64654570830426,7
0.05,2866,27,256954,89.6246948029299,6
0.05,2867,96,257050,89.62691771269178,6
0.05,2868,95,257145,89.62879051934472,6
0.05,2869,94,257239,89.63031358885017,7
0.05,2870,94,257333,89.63183559735283,7
0.05,2871,94,257427,89.633356545961,7
0.05,2872,95,257522,89.63522450400278,7
0.05,2873,94,257616,89.63674321503132,7
0.05,2874,91,257707,89.63721739130435,10
0.05,2875,88,257795,89.63664812239222,13
0.05,2876,96,257891,89.63885992353146,6
0.05,2877,94,257985,89.64037526059764,7
0.05,2878,95,258080,89.64223688780827,6
0.05,2879,94,258174,89.64375,7
0.05,2880,92,258266,89.6445678583825,9
0.05,2881,93,258359,89.64573213046495,8
0.05,2882,94,258453,89.64724245577523,8
0.05,2883,94,258547,89.6487517337032,7
0.05,2884,90,258637,89.64887348353552,11
0.05,2885,90,258727,89.64899514899516,11
0.05,2886,92,258819,89.64980949082093,9
0.05,2887,95,258914,89.6516620498615,6
0.05,2888,94,259008,89.65316718587746,7
0.05,2889,89,259097,89.65294117647059,12
0.05,2890,94,259191,89.65444482877896,7
0.05,2891,92,259283,89.65525587828492,9
0.05,2892,94,259377,89.65675769097822,8
0.05,2893,92,259469,89.65756738078784,9
0.05,2894,93,259562,89.65872193436961,8
0.05,2895,92,259654,89.65953038674033,9
0.05,2896,94,259748,89.66102865032792,8
0.05,2897,95,259843,89.66287094547964,6
0.05,2898,96,259939,89.66505691617799,6
0.05,2899,94,260033,89.66655172413793,8
0.05,2900,93,260126,89.66770079283006,9
0.05,2901,94,260220,89.66919365954514,7
0.05,2902,94,260314,89.67068549776094,7
0.05,2903,95,260409,89.67252066115702,6
0.05,2904,95,260504,89.67435456110155,7
0.05,2905,92,260596,89.67515485203029,9
0.05,2906,95,260691,89.67698658410733,6
0.05,2907,94,260785,89.67847317744155,7
0.05,2908,94,260879,89.6799587487109,8
0.05,2909,90,260969,89.68006872852234,11
0.05,2910,94,261063,89.68155273102026,7
0.05,2911,94,261157,89.68303571428571,7
0.05,2912,93,261250,89.68417439066255,9
0.05,2913,96,261346,89.68634179821551,6
0.05,2914,95,261441,89.68816466552316,6
0.05,2915,94,261535,89.68964334705075,7
0.05,2916,91,261626,89.69009256085019,11
0.05,2917,94,261720,89.6915695681974,7
0.05,2918,94,261814,89.69304556354916,7
0.05,2919,94,261908,89.6945205479452,7
0.05,2920,94,262002,89.69599452242383,7
0.05,2921,93,262095,89.69712525667352,8
0.05,2922,96,262191,89.69928156004106,6
0.05,2923,27,262218,89.67783857729138,6
0.05,2924,94,262312,89.67931623931624,7
0.05,2925,94,262406,89.6807928913192,8
0.05,2926,93,262499,89.68192688759822,8
0.05,2927,94,262593,89.68340163934427,7
0.05,2928,96,262689,89.68555821099352,6
0.05,2929,96,262785,89.68771331058021,6
0.05,2930,96,262881,89.68986693961105,7
0.05,2931,94,262975,89.69133697135061,7
0.05,2932,94,263069,89.6928060006819,7
0.05,2933,92,263161,89.6935923653715,9
0.05,2934,96,263257,89.69574105621805,6
0.05,2935,93,263350,89.69686648501363,8
0.05,2936,92,263442,89.6976506639428,9
0.05,2937,94,263536,89.69911504424779,7
0.05,2938,95,263631,89.70091867982308,6
0.05,2939,89,263720,89.70068027210884,12
0.05,2940,94,263814,89.70214212852771,7
0.05,2941,95,263909,89.70394289598913,6
0.05,2942,96,264005,89.70608222901801,6
0.05,2943,94,264099,89.70754076086956,7
0.05,2944,94,264193,89.70899830220714,7
0.05,2945,96,264289,89.7111337406653,6
0.05,2946,94,264383,89.7125890736342,7
0.05,2947,92,264475,89.71336499321573,9
0.05,2948,96,264571,89.715496778569,6
0.05,2949,95,264666,89.71728813559322,6
0.05,2950,94,264760,89.71873941036937,8
0.05,2951,95,264855,89.72052845528455,6
0.05,2952,94,264949,89.72197764984762,7
0.05,2953,94,265043,89.72342586323629,7
0.05,2954,94,265137,89.7248730964467,7
0.05,2955,94,265231,89.72631935047362,7
0.05,2956,95,265326,89.72810280689889,8
0.05,2957,96,265422,89.73022312373224,6
0.05,2958,93,265515,89.73132815140251,8
0.05,2959,94,265609,89.73277027027027,7
0.05,2960,92,265701,89.73353596757852,9
0.05,2961,94,265795,89.73497636731938,7
0.05,2962,94,265889,89.73641579480257,7
0.05,2963,95,265984,89.73819163292848,6
0.05,2964,95,266079,89.73996627318718,7
0.05,2965,95,266174,89.74173971679029,6
0.05,2966,93,266267,89.74283788338388,9
0.05,2967,27,266294,89.72169811320755,6
0.05,2968,93,266387,89.72280229033345,8
0.05,2969,95,266482,89.72457912457912,6
0.05,2970,96,266578,89.7266913497139,6
0.05,2971,94,266672,89.72812920592193,7
0.05,2972,96,266768,89.73023881601077,6
0.05,2973,95,266863,89.7320107599193,6
0.05,2974,94,266957,89.73344537815126,7
0.05,2975,93,267050,89.73454301075269,8
0.05,2976,24,267074,89.7124622102788,9
0.05,2977,23,267097,89.6900604432505,9
0.05,2978,94,267191,89.69150721718698,7
0.05,2979,96,267287,89.69362416107383,6
0.05,2980,95,267382,89.69540422676954,7
0.05,2981,94,267476,89.69684775318578,7
0.05,2982,93,267569,89.69795507877976,8
0.05,2983,96,267665,89.70006702412869,6
0.05,2984,96,267761,89.70217755443886,6
0.05,2985,94,267855,89.70361687876758,8
0.05,2986,96,267951,89.70572480749917,6
0.05,2987,94,268045,89.70716198125837,7
0.05,2988,92,268137,89.70792907326866,9
0.05,2989,94,268231,89.70936454849499,8
0.05,2990,94,268325,89.71079906385825,7
0.05,2991,94,268419,89.71223262032086,7
0.05,2992,96,268515,89.71433344470431,6
0.05,2993,94,268609,89.71576486305945,7
0.05,2994,93,268702,89.71686143572622,8
0.05,2995,94,268796,89.71829105473965,8
0.05,2996,93,268889,89.71938605271939,8
0.05,2997,92,268981,89.72014676450968,9
0.05,2998,96,269077,89.72224074691565,6
0.05,2999,94,269171,89.72366666666667,8
0.05,3000,94,269265,89.72509163612129,7
0.05,3001,94,269359,89.72651565622918,7
0.05,3002,93,269452,89.72760572760573,8
0.05,3003,93,269545,89.72869507323568,8
0.05,3004,95,269640,89.73044925124792,6
0.05,3005,94,269734,89.73186959414504,7
0.05,3006,94,269828,89.73328899235118,7
0.05,3007,91,269919,89.73371010638297,10
0.05,3008,95,270014,89.73546028580924,6
0.05,3009,90,270104,89.73554817275748,11
0.05,3010,95,270199,89.73729657920957,7
0.05,3011,94,270293,89.73871181938911,7
0.05,3012,27,270320,89.71788914702954,6
0.05,3013,94,270414,89.7193098871931,7
0.05,3014,93,270507,89.72039800995024,8
0.05,3015,93,270600,89.72148541114058,8
0.05,3016,94,270694,89.72290354656944,7
0.05,3017,95,270789,89.72465208747515,6
0.05,3018,95,270884,89.72639947002318,7
0.05,3019,96,270980,89.72847682119205,6
0.05,3020,95,271075,89.73022178086727,6
0.05,3021,92,271167,89.73097286565189,9
0.05,3022,95,271262,89.7327158451869,6
0.05,3023,94,271356,89.73412698412699,7
0.05,3024,93,271449,89.73520661157025,8
0.05,3025,93,271542,89.73628552544614,9
0.05,3026,95,271637,89.73802444664685,6
0.05,3027,95,271732,89.73976221928666,6
0.05,3028,94,271826,89.7411687025421,8
0.05,3029,96,271922,89.74323432343235,6
0.05,3030,94,272016,89.74463873309139,7
0.05,3031,-50,271966,89.69854881266491,13
0.05,3032,93,272059,89.69963732278272,9
0.05,3033,96,272155,89.70171390903099,6
0.05,3034,92,272247,89.70247116968699,9
0.05,3035,94,272341,89.70388669301713,7
0.05,3036,94,272435,89.705301284162,7
0.05,3037,93,272528,89.7063857801185,8
0.05,3038,93,272621,89.70746956235604,8
0.05,3039,94,272715,89.70888157894737,7
0.05,3040,95,272810,89.71062150608353,6
0.05,3041,-47,272763,89.66568047337279,11
0.05,3042,95,272858,89.66743345382847,6
0.05,3043,91,272949,89.66787122207622,10
0.05,3044,20,272969,89.64499178981937,12
0.05,3045,94,273063,89.64642153644124,7
0.05,3046,94,273157,89.64785034460125,7
0.05,3047,94,273251,89.64927821522309,7
0.05,3048,94,273345,89.65070514922925,7
0.05,3049,96,273441,89.6527868852459,6
0.05,3050,92,273533,89.65355621107834,9
0.05,3051,95,273628,89.65530799475754,6
0.05,3052,94,273722,89.6567310841795,7
0.05,3053,94,273816,89.6581532416503,7
0.05,3054,26,273842,89.63731587561375,8
0.05,3055,92,273934,89.6380890052356,9
0.05,3056,93,274027,89.63918874713772,8
0.05,3057,94,274121,89.64061478090255,7
0.05,3058,93,274214,89.64171297809742,8
0.05,3059,94,274308,89.64313725490196,7
0.05,3060,93,274401,89.64423391048678,8
0.05,3061,93,274494,89.64532984977139,8
0.05,3062,94,274588,89.64675155076722,8
0.05,3063,95,274683,89.64849869451697,6
0.05,3064,92,274775,89.64926590538336,10
0.05,3065,92,274867,89.65003261578605,9
0.05,3066,91,274958,89.6504727746984,10
0.05,3067,94,275052,89.65189048239895,7
0.05,3068,94,275146,89.65330726621049,7
0.05,3069,94,275240,89.65472312703584,7
0.05,3070,94,275334,89.65613806577662,7
0.05,3071,94,275428,89.65755208333333,7
0.05,3072,25,275453,89.6365115522291,8
0.05,3073,96,275549,89.63858165256994,7
0.05,3074,95,275644,89.64032520325203,6
0.05,3075,94,275738,89.64174252275683,7
0.05,3076,92,275830,89.64250893727657,9
0.05,3077,94,275924,89.64392462638077,7
0.05,3078,93,276017,89.64501461513478,8
0.05,3079,96,276113,89.64707792207793,6
0.05,3080,94,276207,89.64849074975658,8
0.05,3081,92,276299,89.64925373134328,9
0.05,3082,94,276393,89.65066493674992,7
0.05,3083,94,276487,89.65207522697796,7
0.05,3084,95,276582,89.65380875202594,6
0.05,3085,93,276675,89.6548930654569,8
0.05,3086,95,276770,89.65662455458374,6
0.05,3087,96,276866,89.65867875647669,6
0.05,3088,95,276961,89.66040789899644,6
0.05,3089,93,277054,89.66148867313916,9
0.05,3090,89,277143,89.66127466839211,12
0.05,3091,94,277237,89.66267787839585,8
0.05,3092,94,277331,89.66408018105399,8
0.05,3093,93,277424,89.66515837104072,8
0.05,3094,94,277518,89.66655896607432,7
0.05,3095,92,277610,89.66731266149871,10
0.05,3096,96,277706,89.66935744268648,6
0.05,3097,96,277802,89.67140090380892,6
0.05,3098,95,277897,89.6731203614069,6
0.05,3099,93,277990,89.6741935483871,8
0.05,3100,93,278083,89.67526604321186,8
0.05,3101,94,278177,89.67666021921342,8
0.05,3102,94,278271,89.67805349661617,8
0.05,3103,92,278363,89.67880154639175,9
0.05,3104,93,278456,89.67987117552335,8
0.05,3105,96,278552,89.68190598840953,6
0.05,3106,94,278646,89.6832957837142,7
0.05,3107,94,278740,89.68468468468468,7
0.05,3108,27,278767,89.6645223544548,6
0.05,3109,95,278862,89.66623794212218,7
0.05,3110,94,278956,89.66763098682095,8
0.05,3111,94,279050,89.66902313624679,7
0.05,3112,93,279143,89.67009315772566,8
0.05,3113,92,279235,89.6708413615928,9
0.05,3114,94,279329,89.67223113964687,7
0.05,3115,92,279421,89.6729781771502,10
0.05,3116,94,279515,89.6743663779275,7
0.05,3117,94,279609,89.67575368826171,7
0.05,3118,92,279701,89.67649887784546,9
0.05,3119,96,279797,89.67852564102564,6
0.05,3120,96,279893,89.68055110541493,6
0.05,3121,93,279986,89.68161434977578,8
0.05,3122,94,280080,89.68299711815563,7
0.05,3123,96,280176,89.68501920614597,6
0.05,3124,94,280270,89.6864,7
0.05,3125,94,280364,89.68777991042866,7
0.05,3126,96,280460,89.68979852894148,6
0.05,3127,95,280555,89.69149616368287,6
0.05,3128,91,280646,89.69191434963247,10
0.05,3129,96,280742,89.69392971246006,6
0.05,3130,94,280836,89.69530501437241,7
0.05,3131,95,280931,89.6969987228608,6
0.05,3132,90,281021,89.69709543568464,11
0.05,3133,91,281112,89.69751116783664,10
0.05,3134,92,281204,89.69824561403509,9
0.05,3135,89,281293,89.69802295918367,12
0.05,3136,93,281386,89.69907554988843,8
0.05,3137,92,281478,89.69980879541109,9
0.05,3138,93,281571,89.70086014654349,8
0.05,3139,95,281666,89.70254777070063,6
0.05,3140,94,281760,89.70391595033429,7
0.05,3141,91,281851,89.70432845321452,10
0.05,3142,93,281944,89.70537702831689,8
0.05,3143,27,281971,89.68543256997455,6
0.05,3144,95,282066,89.68712241653418,8
0.05,3145,96,282162,89.68912905276542,6
0.05,3146,95,282257,89.69081665077852,6
0.05,3147,92,282349,89.6915501905972,9
0.05,3148,94,282443,89.69291838678946,7
0.05,3149,94,282537,89.69428571428571,7
0.05,3150,94,282631,89.69565217391305,7
0.05,3151,94,282725,89.69701776649747,8
0.05,3152,94,282819,89.69838249286394,7
0.05,3153,96,282915,89.7003804692454,6
0.05,3154,96,283011,89.70237717908083,6
0.05,3155,95,283106,89.7040557667934,6
0.05,3156,95,283201,89.70573329109915,6
0.05,3157,91,283292,89.70614312856239,10
0.05,3158,93,283385,89.70718581829694,8
0.05,3159,95,283480,89.70886075949367,6
0.05,3160,96,283576,89.7108509965201,6
0.05,3161,92,283668,89.71157495256168,9
0.05,3162,91,283759,89.71198229528929,10
0.05,3163,95,283854,89.71365360303413,7
0.05,3164,96,283950,89.71563981042654,6
0.05,3165,91,284041,89.71604548325963,10
0.05,3166,92,284133,89.71676665614146,9
0.05,3167,95,284228,89.71843434343434,6
0.05,3168,93,284321,89.71946986431051,8
0.05,3169,93,284414,89.7205047318612,8
0.05,3170,95,284509,89.72216966256701,7
0.05,3171,95,284604,89.72383354350568,6
0.05,3172,95,284699,89.7254963756697,7
0.05,3173,96,284795,89.72747321991179,6
0.05,3174,94,284889,89.7288188976378,7
0.05,3175,96,284985,89.7307934508816,6
0.05,3176,94,285079,89.73213723638654,7
0.05,3177,91,285170,89.73253618628068,10
0.05,3178,96,285266,89.73450770682605,6
0.05,3179,93,285359,89.73553459119496,8
0.05,3180,94,285453,89.73687519647909,7
0.05,3181,95,285548,89.73852922690132,6
0.05,3182,91,285639,89.73892554194157,10
0.05,3183,89,285728,89.73869346733669,12
0.05,3184,93,285821,89.7397174254317,8
0.05,3185,94,285915,89.74105461393597,7
0.05,3186,94,286009,89.74239096328836,8
0.05,3187,95,286104,89.74404015056462,7
0.05,3188,96,286200,89.74600188146755,6
0.05,3189,93,286293,89.74702194357367,8
0.05,3190,94,286387,89.74835474772799,7
0.05,3191,91,286478,89.74874686716792,10
0.05,3192,94,286572,89.7500782962731,7
0.05,3193,92,286664,89.7507827175955,9
0.05,3194,95,286759,89.75242566510173,6
0.05,3195,96,286855,89.75438047559449,6
0.05,3196,96,286951,89.75633406318424,6
0.05,3197,93,287044,89.7573483427142,8
0.05,3198,95,287139,89.75898718349484,6
0.05,3199,95,287234,89.760625,6
0.05,3200,94,287328,89.76194939081537,7
0.05,3201,91,287419,89.76233603997501,10
0.05,3202,91,287510,89.76272244770527,10
0.05,3203,90,287600,89.76279650436953,11
0.05,3204,94,287694,89.76411856474259,7
0.05,3205,92,287786,89.76481597005615,9
0.05,3206,94,287880,89.76613657623948,7
0.05,3207,94,287974,89.76745635910224,7
0.05,3208,96,288070,89.76939856653163,6
0.05,3209,94,288164,89.77071651090343,7
0.05,3210,92,288256,89.77141077545936,9
0.05,3211,96,288352,89.7733499377335,6
0.05,3212,94,288446,89.77466542172425,7
0.05,3213,93,288539,89.77566894835097,8
0.05,3214,94,288633,89.77698289269051,7
0.05,3215,94,288727,89.7782960199005,7
0.05,3216,93,288820,89.77929748212621,8
0.05,3217,94,288914,89.78060907395898,7
0.05,3218,96,289010,89.78254116185151,6
0.05,3219,94,289104,89.78385093167702,7
0.05,3220,93,289197,89.78484942564421,8
0.05,3221,94,289291,89.78615766604594,7
0.05,3222,95,289386,89.78777536456717,6
0.05,3223,92,289478,89.78846153846153,9
0.05,3224,93,289571,89.78945736434109,8
0.05,3225,96,289667,89.79138251704897,6
0.05,3226,27,289694,89.77192438797645,6
0.05,3227,94,289788,89.77323420074349,7
0.05,3228,96,289884,89.77516258903685,6
0.05,3229,96,289980,89.77708978328174,6
0.05,3230,89,290069,89.776849272671,12
0.05,3231,92,290161,89.77753712871286,9
0.05,3232,96,290257,89.77946180018559,6
0.05,3233,93,290350,89.78045763760049,8
0.05,3234,92,290442,89.78114374034003,9
0.05,3235,94,290536,89.78244746600741,7
0.05,3236,94,290630,89.78375038616002,8
0.05,3237,92,290722,89.78443483631871,9
0.05,3238,94,290816,89.78573633837604,8
0.05,3239,96,290912,89.78765432098766,6
0.05,3240,96,291008,89.78957112002469,6
0.05,3241,94,291102,89.79086983343615,7
0.05,3242,96,291198,89.79278445883442,6
0.05,3243,92,291290,89.79346485819975,9
0.05,3244,93,291383,89.7944530046225,8
0.05,3245,95,291478,89.79605668515096,6
0.05,3246,92,291570,89.79673544810595,9
0.05,3247,96,291666,89.79864532019704,6
0.05,3248,93,291759,89.79963065558634,8
0.05,3249,96,291855,89.80153846153846,6
0.05,3250,95,291950,89.80313749615503,6
0.05,3251,94,292044,89.80442804428044,7
0.05,3252,95,292139,89.80602520750077,6
0.05,3253,94,292233,89.80731407498463,7
0.05,3254,94,292327,89.80860215053764,7
0.05,3255,96,292423,89.81050368550369,6
0.05,3256,94,292517,89.81178999078907,7
0.05,3257,95,292612,89.8133824432167,7
0.05,3258,93,292705,89.81436023320038,8
0.05,3259,92,292797,89.81503067484662,9
0.05,3260,94,292891,89.8163140141061,7
0.05,3261,91,292982,89.81667688534641,10
0.05,3262,93,293075,89.81765246705486,8
0.05,3263,92,293167,89.81832107843137,9
0.05,3264,95,293262,89.81990811638592,6
0.05,3265,96,293358,89.82180036742193,6
0.05,3266,95,293453,89.82338536883991,6
0.05,3267,94,293547,89.82466340269278,7
0.05,3268,95,293642,89.8262465585806,7
0.05,3269,94,293736,89.82752293577981,8
0.05,3270,94,293830,89.82879853255885,7
0.05,3271,95,293925,89.83037897310514,6
0.05,3272,92,294017,89.83104185762298,9
0.05,3273,94,294111,89.83231521075137,7
0.05,3274,93,294204,89.83328244274809,8
0.05,3275,95,294299,89.83485958485959,6
0.05,3276,95,294394,89.83643576441868,6
0.05,3277,92,294486,89.83709579011592,9
0.05,3278,93,294579,89.8380603842635,8
0.05,3279,95,294674,89.83963414634147,6
0.05,3280,94,294768,89.84090216397439,7
0.05,3281,95,294863,89.84247410115783,6
0.05,3282,92,294955,89.84313128236369,9
0.05,3283,92,295047,89.8437880633374,9
0.05,3284,94,295141,89.84505327245053,7
0.05,3285,93,295234,89.84601339013999,9
0.05,3286,92,295326,89.84666869485854,9
0.05,3287,94,295420,89.84793187347933,7
0.05,3288,21,295441,89.82699908786866,11
0.05,3289,95,295536,89.82857142857142,6
0.05,3290,95,295631,89.83014281373443,6
0.05,3291,94,295725,89.83140947752126,7
0.05,3292,94,295819,89.83267537200122,7
0.05,3293,91,295910,89.83302975106254,10
0.05,3294,96,296006,89.83490136570562,6
0.05,3295,94,296100,89.83616504854369,7
0.05,3296,93,296193,89.83712465878071,8
0.05,3297,95,296288,89.83869011522134,6
0.05,3298,96,296384,89.84055774477115,6
0.05,3299,95,296479,89.84212121212121,6
0.05,3300,94,296573,89.84338079369888,7
0.05,3301,94,296667,89.84463961235615,7
0.05,3302,94,296761,89.84589766878595,7
0.05,3303,96,296857,89.8477602905569,6
0.05,3304,95,296952,89.84931921331317,6
0.05,3305,95,297047,89.85087719298245,7
0.05,3306,92,297139,89.85152706380406,9
0.05,3307,96,297235,89.85338573155985,6
0.05,3308,93,297328,89.85433665760048,8
0.05,3309,93,297421,89.85528700906345,9
0.05,3310,96,297517,89.85714285714286,6
0.05,3311,95,297612,89.8586956521739,6
0.05,3312,94,297706,89.85994566857833,7
0.05,3313,94,297800,89.86119493059746,7
0.05,3314,93,297893,89.86214177978884,8
0.05,3315,93,297986,89.86308805790108,9
0.05,3316,94,298080,89.86433524268918,7
0.05,3317,95,298175,89.86588306208559,6
0.05,3318,94,298269,89.8671286532088,7
0.05,3319,94,298363,89.86837349397591,7
0.05,3320,94,298457,89.86961758506474,7
0.05,3321,94,298551,89.87086092715232,8
0.05,3322,93,298644,89.87180258802287,8
0.05,3323,94,298738,89.87304452466907,7
0.05,3324,92,298830,89.87368421052632,9
0.05,3325,95,298925,89.8752254960914,6
0.05,3326,94,299019,89.87646528403968,8
0.05,3327,96,299115,89.87830528846153,6
0.05,3328,95,299210,89.87984379693602,7
0.05,3329,94,299304,89.88108108108108,8
0.05,3330,96,299400,89.88291804262984,6
0.05,3331,95,299495,89.8844537815126,6
0.05,3332,95,299590,89.88598859885988,6
0.05,3333,96,299686,89.8878224355129,6
0.05,3334,94,299780,89.88905547226386,7
0.05,3335,93,299873,89.88998800959233,8
0.05,3336,88,299961,89.88942163620018,14
0.05,3337,27,299988,89.87058118633912,6
0.05,3338,94,300082,89.87181790955376,7
0.05,3339,92,300174,89.87245508982036,9
0.05,3340,94,300268,89.8736905118228,8
0.05,3341,96,300364,89.8755236385398,6
0.05,3342,93,300457,89.87645827101406,9
0.05,3343,95,300552,89.877990430622,6
0.05,3344,89,300641,89.87772795216742,12
0.05,3345,90,300731,89.8777644949193,11
0.05,3346,96,300827,89.87959366596952,6
0.05,3347,95,300922,89.88112305854241,6
0.05,3348,27,300949,89.86234696924456,6
0.05,3349,96,301045,89.86417910447761,6
0.05,3350,94,301139,89.86541330945987,7
0.05,3351,94,301233,89.86664677804296,7
0.05,3352,95,301328,89.86817775126752,6
0.05,3353,93,301421,89.8691115086464,8
0.05,3354,93,301514,89.87004470938898,8
0.05,3355,94,301608,89.87127532777116,7
0.05,3356,95,301703,89.87280309800417,8
0.05,3357,86,301789,89.87164979154258,15
0.05,3358,92,301881,89.87228341768383,9
0.05,3359,92,301973,89.87291666666667,9
0.05,3360,95,302068,89.87444213031836,6
0.05,3361,95,302163,89.87596668649613,7
0.05,3362,93,302256,89.87689562890276,9
0.05,3363,93,302349,89.87782401902497,8
0.05,3364,95,302444,89.87934621099554,6
0.05,3365,91,302535,89.87967914438502,10
0.05,3366,94,302629,89.88090288090288,7
0.05,3367,94,302723,89.88212589073635,7
0.05,3368,95,302818,89.88364499851588,6
0.05,3369,94,302912,89.88486646884273,7
0.05,3370,91,303003,89.88519727083951,10
0.05,3371,92,303095,89.88582443653618,9
0.05,3372,95,303190,89.88734064630893,7
0.05,3373,91,303281,89.88767042086545,10
0.05,3374,95,303376,89.88918518518518,7
0.05,3375,92,303468,89.88981042654028,9
0.05,3376,93,303561,89.89073141841871,9
0.05,3377,94,303655,89.89194789816459,7
0.05,3378,96,303751,89.89375554897899,6
0.05,3379,-46,303705,89.85355029585799,10
0.05,3380,92,303797,89.8541851523218,9
0.05,3381,93,303890,89.85511531638085,8
0.05,3382,27,303917,89.83653561927284,6
0.05,3383,94,304011,89.8377659574468,7
0.05,3384,96,304107,89.83958641063515,6
0.05,3385,96,304203,89.84140578854105,6
0.05,3386,94,304297,89.8426335990552,7
0.05,3387,85,304382,89.84120425029516,16
0.05,3388,93,304475,89.84213632339923,8
0.05,3389,94,304569,89.84336283185841,7
0.05,3390,93,304662,89.84429371866706,8
0.05,3391,94,304756,89.84551886792453,7
0.05,3392,95,304851,89.84703801945182,6
0.05,3393,94,304945,89.84826163818504,7
0.05,3394,94,305039,89.84948453608247,7
0.05,3395,96,305135,89.85129564193169,6
0.05,3396,95,305230,89.85281130409184,6
0.05,3397,94,305324,89.85403178340201,7
0.05,3398,90,305414,89.85407472786113,11
0.05,3399,94,305508,89.85529411764706,8
0.05,3400,94,305602,89.85651279035578,7
0.05,3401,94,305696,89.85773074661964,8
0.05,3402,94,305790,89.85894798707024,7
0.05,3403,96,305886,89.86075205640422,6
0.05,3404,96,305982,89.8625550660793,6
0.05,3405,94,306076,89.86376981796829,8
0.05,3406,94,306170,89.86498385676548,7
0.05,3407,94,306264,89.86619718309859,7
0.05,3408,27,306291,89.84775594015841,6
0.05,3409,91,306382,89.84809384164222,11
0.05,3410,94,306476,89.84931105247728,7
0.05,3411,93,306569,89.85023446658852,8
0.05,3412,94,306663,89.85145033694697,7
0.05,3413,95,306758,89.85295840656121,6
0.05,3414,94,306852,89.85417276720351,7
0.05,3415,91,306943,89.85450819672131,10
0.05,3416,93,307036,89.85542873865964,9
0.05,3417,92,307128,89.8560561732007,9
0.05,3418,95,307223,89.85756069026031,8
0.05,3419,90,307313,89.85760233918128,11
0.05,3420,96,307409,89.8593978368898,6
0.05,3421,94,307503,89.86060783167738,8
0.05,3422,96,307599,89.8624014022787,6
0.05,3423,93,307692,89.86331775700934,8
0.05,3424,94,307786,89.86452554744525,9
0.05,3425,93,307879,89.86544074722708,8
0.05,3426,94,307973,89.8666472133061,7
0.05,3427,95,308068,89.86814469078179,6
0.05,3428,94,308162,89.86934966462526,7
0.05,3429,96,308258,89.87113702623907,6
0.05,3430,96,308354,89.87292334596327,7
0.05,3431,95,308449,89.87441724941725,6
0.05,3432,95,308544,89.8759102825517,6
0.05,3433,93,308637,89.87682003494467,8
0.05,3434,96,308733,89.87860262008734,6
0.05,3435,89,308822,89.87834691501746,12
0.05,3436,95,308917,89.87983706720978,6
0.05,3437,96,309013,89.88161721931355,6
0.05,3438,94,309107,89.88281477173597,7
0.05,3439,95,309202,89.8843023255814,6
0.05,3440,96,309298,89.88607962801511,6
0.05,3441,90,309388,89.88611272515979,11
0.05,3442,91,309479,89.88643624745862,10
0.05,3443,94,309573,89.88763066202091,7
0.05,3444,94,309667,89.888824383164,8
0.05,3445,93,309760,89.88972721996518,8
0.05,3446,94,309854,89.8909196402669,7
0.05,3447,96,309950,89.89269141531322,6
0.05,3448,92,310042,89.89330240649464,9
0.05,3449,92,310134,89.89391304347826,9
0.05,3450,96,310230,89.89568241089539,6
0.05,3451,93,310323,89.89658169177288,8
0.05,3452,93,310416,89.89748045178106,9
0.05,3453,94,310510,89.89866821077013,7
0.05,3454,93,310603,89.89956584659913,8
0.05,3455,95,310698,89.90104166666667,6
0.05,3456,94,310792,89.90222736476714,7
0.05,3457,94,310886,89.90341237709659,8
0.05,3458,94,310980,89.90459670424978,7
0.05,3459,94,311074,89.9057803468208,7
0.05,3460,96,311170,89.90754117307137,6
0.05,3461,93,311263,89.90843443096476,8
0.05,3462,93,311356,89.90932717297142,8
0.05,3463,94,311450,89.91050808314088,7
0.05,3464,90,311540,89.91053391053391,11
0.05,3465,92,311632,89.91113675706866,9
0.05,3466,94,311726,89.91231612344967,7
0.05,3467,93,311819,89.91320645905421,9
0.05,3468,92,311911,89.91380801383684,9
0.05,3469,94,312005,89.9149855907781,7
0.05,3470,94,312099,89.9161624891962,7
0.05,3471,93,312192,89.91705069124424,8
0.05,3472,94,312286,89.91822631730493,7
0.05,3473,95,312381,89.91968911917098,6
0.05,3474,94,312475,89.92086330935251,7
0.05,3475,94,312569,89.92203682393556,7
0.05,3476,94,312663,89.92320966350302,7
0.05,3477,94,312757,89.92438182863715,8
0.05,3478,95,312852,89.92584075883875,6
0.05,3479,94,312946,89.92701149425288,7
0.05,3480,95,313041,89.92846883079575,6
0.05,3481,93,313134,89.9293509477312,8
0.05,3482,91,313225,89.92965834051105,10
0.05,3483,96,313321,89.93140068886338,6
0.05,3484,94,313415,89.93256814921091,7
0.05,3485,94,313509,89.93373493975903,7
0.05,3486,94,313603,89.93490106108402,8
0.05,3487,96,313699,89.93663990825688,6
0.05,3488,94,313793,89.9378045285182,7
0.05,3489,90,313883,89.9378223495702,12
0.05,3490,94,313977,89.93898596390719,7
0.05,3491,94,314071,89.9401489117984,7
0.05,3492,94,314165,89.9413111938162,7
0.05,3493,96,314261,89.9430452203778,6
0.05,3494,96,314357,89.9447782546495,6
0.05,3495,94,314451,89.94593821510297,7
0.05,3496,93,314544,89.94681155275951,8
0.05,3497,93,314637,89.94768439108061,8
0.05,3498,92,314729,89.94827093455272,10
0.05,3499,94,314823,89.94942857142857,7
0.05,3500,92,314915,89.95001428163381,9
0.05,3501,93,315008,89.95088520845232,8
0.05,3502,25,315033,89.93234370539538,8
0.05,3503,96,315129,89.93407534246575,6
0.05,3504,92,315221,89.93466476462197,9
0.05,3505,96,315317,89.93639475185397,6
0.05,3506,94,315411,89.93755346449957,7
0.05,3507,93,315504,89.93842645381984,8
0.05,3508,94,315598,89.93958392704474,7
0.05,3509,94,315692,89.94074074074074,7
0.05,3510,95,315787,89.94218171461122,7
0.05,3511,92,315879,89.94276765375854,9
0.05,3512,96,315975,89.94449188727583,6
0.05,3513,94,316069,89.94564598747866,7
0.05,3514,92,316161,89.94623044096728,9
0.05,3515,95,316256,89.94766780432309,6
0.05,3516,96,316352,89.94938868353711,6
0.05,3517,94,316446,89.95054007959068,7
0.05,3518,94,316540,89.95169082125604,7
0.05,3519,96,316636,89.95340909090909,6
0.05,3520,95,316731,89.95484237432548,6
0.05,3521,94,316825,89.95599091425326,7
0.05,3522,94,316919,89.95713880215725,7
0.05,3523,94,317013,89.9582860385925,7
0.05,3524,96,317109,89.96,6
0.05,3525,96,317205,89.96171298922292,6
0.05,3526,93,317298,89.96257442585767,8
0.05,3527,96,317394,89.96428571428571,6
0.05,3528,23,317417,89.94531028620005,10
0.05,3529,95,317512,89.94674220963172,6
0.05,3530,93,317605,89.94760691022373,8
0.05,3531,91,317696,89.94790486976217,10
0.05,3532,94,317790,89.94905179733937,8
0.05,3533,96,317886,89.95076400679118,6
0.05,3534,94,317980,89.95190947666195,7
0.05,3535,94,318074,89.95305429864253,8
0.05,3536,93,318167,89.95391574780888,8
0.05,3537,96,318263,89.95562464669305,6
0.05,3538,92,318355,89.95620231703872,9
0.05,3539,91,318446,89.95649717514124,11
0.05,3540,93,318539,89.95735667890426,8
0.05,3541,93,318632,89.95821569734613,8
0.05,3542,94,318726,89.95935647756139,8
0.05,3543,96,318822,89.96106094808127,6
0.05,3544,96,318918,89.96276445698166,6
0.05,3545,94,319012,89.9639029892837,7
0.05,3546,92,319104,89.9644770228362,9
0.05,3547,94,319198,89.96561443066517,9
0.05,3548,94,319292,89.96675119752042,7
0.05,3549,94,319386,89.96788732394366,7
0.05,3550,92,319478,89.9684595888482,9
0.05,3551,96,319574,89.97015765765765,6
0.05,3552,94,319668,89.97129186602871,7
0.05,3553,94,319762,89.9724254361283,7
0.05,3554,27,319789,89.95471167369901,6
0.05,3555,94,319883,89.95584926884139,7
0.05,3556,94,319977,89.95698622434637,7
0.05,3557,92,320069,89.95756042720629,10
0.05,3558,95,320164,89.95897724079798,6
0.05,3559,93,320257,89.95983146067415,8
0.05,3560,91,320348,89.96012356079753,10
0.05,3561,89,320437,89.95985401459853,12
0.05,3562,94,320531,89.96098793151839,7
0.05,3563,93,320624,89.96184062850729,8
0.05,3564,94,320718,89.96297335203366,7
0.05,3565,96,320814,89.964666292765,6
0.05,3566,93,320907,89.96551724137932,8
0.05,3567,94,321001,89.96664798206278,7
0.05,3568,92,321093,89.96721770804147,9
0.05,3569,94,321187,89.96834733893557,8
0.05,3570,95,321282,89.96975637076449,6
0.05,3571,96,321378,89.97144456886898,6
0.05,3572,96,321474,89.97313182199832,6
0.05,3573,92,321566,89.97369893676553,10
0.05,3574,94,321660,89.97482517482517,7
0.05,3575,96,321756,89.97651006711409,6
0.05,3576,91,321847,89.97679619793122,10
0.05,3577,94,321941,89.97792062604807,8
0.05,3578,94,322035,89.97904442581726,7
0.05,3579,95,322130,89.9804469273743,6
0.05,3580,94,322224,89.98156939402402,8
0.05,3581,96,322320,89.98324958123953,6
0.05,3582,93,322413,89.98409154339939,8
0.05,3583,93,322506,89.98493303571429,8
0.05,3584,96,322602,89.98661087866108,6
0.05,3585,94,322696,89.9877300613497,7
0.05,3586,94,322790,89.98884862001673,7
0.05,3587,95,322885,89.9902452619844,6
0.05,3588,92,322977,89.99080523822792,9
0.05,3589,92,323069,89.99136490250696,9
0.05,3590,89,323158,89.9910888331941,12
0.05,3591,94,323252,89.99220489977728,7
0.05,3592,93,323345,89.99304202616199,8
0.05,3593,93,323438,89.99387868670006,9
0.05,3594,95,323533,89.99527121001391,6
0.05,3595,95,323628,89.99666295884316,7
0.05,3596,94,323722,89.99777592438143,7
0.05,3597,96,323818,89.99944413563091,6
0.05,3598,96,323914,90.00111141983885,6
0.05,3599,94,324008,90.00222222222222,7
0.05,3600,94,324102,90.00333240766454,7
0.05,3601,94,324196,90.00444197667963,7
0.05,3602,93,324289,90.00527338329171,8
0.05,3603,94,324383,90.00638179800222,7
0.05,3604,95,324478,90.00776699029126,6
0.05,3605,92,324570,90.00831946755407,9
0.05,3606,94,324664,90.00942611588577,7
0.05,3607,93,324757,90.01025498891353,8
0.05,3608,96,324853,90.01191465779995,6
0.05,3609,94,324947,90.01301939058172,7
0.05,3610,94,325041,90.01412351149266,7
0.05,3611,95,325136,90.01550387596899,6
0.05,3612,93,325229,90.01632991973429,8
0.05,3613,92,325321,90.01687880464858,10
0.05,3614,94,325415,90.0179806362379,7
0.05,3615,94,325509,90.01908185840708,7
0.05,3616,96,325605,90.02073541609069,6
0.05,3617,94,325699,90.02183526810393,7
0.05,3618,96,325795,90.02348715114672,6
0.05,3619,21,325816,90.00441988950276,12
0.05,3620,93,325909,90.00524716929026,8
0.05,3621,94,326003,90.00635008282717,7
0.05,3622,94,326097,90.00745238752415,7
0.05,3623,92,326189,90.00800220750551,9
0.05,3624,92,326281,90.00855172413793,10
0.05,3625,95,326376,90.00992829564258,6
0.05,3626,94,326470,90.01102839812518,7
0.05,3627,93,326563,90.01185226019845,8
0.05,3628,94,326657,90.01295122623313,7
0.05,3629,94,326751,90.01404958677686,7
0.05,3630,93,326844,90.01487193610576,8
0.05,3631,95,326939,90.01624449339207,6
0.05,3632,94,327033,90.01734104046243,7
0.05,3633,93,327126,90.01816180517336,8
0.05,3634,93,327219,90.01898211829436,8
0.05,3635,93,327312,90.01980198019803,8
0.05,3636,92,327404,90.02034643937311,9
0.05,3637,94,327498,90.02144035184168,7
0.05,3638,95,327593,90.0228084638637,6
0.05,3639,95,327688,90.02417582417583,7
0.05,3640,92,327780,90.02471848393299,9
0.05,3641,93,327873,90.02553542009885,8
0.05,3642,93,327966,90.02635190776833,8
0.05,3643,92,328058,90.02689352360044,9
0.05,3644,93,328151,90.02770919067216,8
0.05,3645,94,328245,90.02879868348876,7
0.05,3646,90,328335,90.02879078694818,11
0.05,3647,95,328430,90.03015350877193,6
0.05,3648,93,328523,90.03096738832556,8
0.05,3649,94,328617,90.03205479452055,7
0.05,3650,94,328711,90.03314160503972,7
0.05,3651,94,328805,90.0342278203724,7
0.05,3652,94,328899,90.03531344100739,8
0.05,3653,92,328991,90.03585112205802,10
0.05,3654,94,329085,90.03693570451436,7
0.05,3655,93,329178,90.03774617067833,8
0.05,3656,94,329272,90.03882964178288,7
0.05,3657,96,329368,90.04045926735921,6
0.05,3658,93,329461,90.04126810603991,9
0.05,3659,93,329554,90.04207650273224,8
0.05,3660,92,329646,90.04261130838569,10
0.05,3661,92,329738,90.04314582195522,9
0.05,3662,96,329834,90.04477204477205,7
0.05,3663,90,329924,90.04475982532752,11
0.05,3664,94,330018,90.04583901773533,7
0.05,3665,94,330112,90.0469176213857,8
0.05,3666,95,330207,90.04826833924189,6
0.05,3667,95,330302,90.04961832061069,6
0.05,3668,94,330396,90.05069501226492,7
0.05,3669,94,330490,90.05177111716621,7
0.05,3670,92,330582,90.05230182511578,9
0.05,3671,94,330676,90.05337690631808,7
0.05,3672,95,330771,90.05472365913423,8
0.05,3673,94,330865,90.05579749591726,7
0.05,3674,94,330959,90.05687074829932,7
0.05,3675,90,331049,90.05685527747552,11
0.05,3676,95,331144,90.05819961925482,6
0.05,3677,94,331238,90.05927134312127,7
0.05,3678,96,331334,90.06088611035608,6
0.05,3679,92,331426,90.06141304347825,9
0.05,3680,85,331511,90.06003803314317,17
0.05,3681,91,331602,90.06029331884845,10
0.05,3682,94,331696,90.06136301927776,7
0.05,3683,90,331786,90.06134636264929,11
0.05,3684,95,331881,90.06268656716418,6
0.05,3685,93,331974,90.06348345089528,8
0.05,3686,95,332069,90.06482234879306,6
0.05,3687,94,332163,90.06588937093275,7
0.05,3688,94,332257,90.06695581458389,7
0.05,3689,95,332352,90.06829268292682,6
0.05,3690,92,332444,90.06881603901381,9
0.05,3691,92,332536,90.06933911159263,9
0.05,3692,93,332629,90.07013268345518,8
0.05,3693,92,332721,90.07065511640498,9
0.05,3694,92,332813,90.07117726657646,9
0.05,3695,96,332909,90.07278138528139,6
0.05,3696,94,333003,90.07384365701921,7
0.05,3697,95,333098,90.07517577068685,6
0.05,3698,93,333191,90.07596647742633,8
0.05,3699,94,333285,90.07702702702703,7
0.05,3700,95,333380,90.07835720075656,6
0.05,3701,94,333474,90.07941653160454,7
0.05,3702,94,333568,90.08047529030516,7
0.05,3703,89,333657,90.08018358531318,12
0.05,3704,95,333752,90.08151147098515,6
0.05,3705,94,333846,90.08256880733946,8
0.05,3706,91,333937,90.08281629349878,10
0.05,3707,94,334031,90.08387270765911,8
0.05,3708,96,334127,90.08546778107306,6
0.05,3709,95,334222,90.0867924528302,6
0.05,3710,93,334315,90.08757747237941,8
0.05,3711,95,334410,90.08890086206897,6
0.05,3712,96,334506,90.09049286291409,6
0.05,3713,92,334598,90.0910070005385,9
0.05,3714,94,334692,90.09205921938089,7
0.05,3715,94,334786,90.09311087190528,7
0.05,3716,94,334880,90.09416195856873,8
0.05,3717,93,334973,90.09494351802044,8
0.05,3718,94,335067,90.09599354665232,7
0.05,3719,93,335160,90.09677419354838,8
0.05,3720,92,335252,90.09728567589357,9
0.05,3721,95,335347,90.09860290166577,7
0.05,3722,94,335441,90.0996508192318,8
0.05,3723,94,335535,90.10069817400644,7
0.05,3724,94,335629,90.10174496644295,7
0.05,3725,95,335724,90.10305958132045,6
0.05,3726,95,335819,90.10437349074323,6
0.05,3727,95,335914,90.10568669527898,6
0.05,3728,96,336010,90.10726736390453,6
0.05,3729,95,336105,90.10857908847186,6
0.05,3730,94,336199,90.10962208523185,7
0.05,3731,93,336292,90.11039657020365,8
0.05,3732,92,336384,90.11090275917492,9
0.05,3733,94,336478,90.11194429566149,7
0.05,3734,94,336572,90.11298527443105,7
0.05,3735,94,336666,90.11402569593147,8
0.05,3736,95,336761,90.11533315493712,6
0.05,3737,94,336855,90.11637239165329,7
0.05,3738,92,336947,90.11687617009896,9
0.05,3739,17,336964,90.09732620320855,15
0.05,3740,95,337059,90.09863672814755,6
0.05,3741,92,337151,90.0991448423303,9
0.05,3742,94,337245,90.10018701576276,7
0.05,3743,92,337337,90.10069444444444,9
0.05,3744,93,337430,90.10146862483312,8
0.05,3745,91,337521,90.10170848905499,11
0.05,3746,96,337617,90.10328262610088,6
0.05,3747,95,337712,90.10458911419424,6
0.05,3748,94,337806,90.10562816751134,7
0.05,3749,94,337900,90.10666666666667,7
0.05,3750,94,337994,90.10770461210343,7
0.05,3751,94,338088,90.10874200426439,7
0.05,3752,20,338108,90.09006128430589,12
0.05,3753,94,338202,90.09110282365477,7
0.05,3754,95,338297,90.09241011984021,6
0.05,3755,94,338391,90.09345047923323,8
0.05,3756,96,338487,90.09502262443439,7
0.05,3757,96,338583,90.09659393294305,6
0.05,3758,93,338676,90.09736632083,8
0.05,3759,94,338770,90.09840425531915,7
0.05,3760,95,338865,90.09970752459452,6
0.05,3761,95,338960,90.1010101010101,6
0.05,3762,94,339054,90.10204623970236,7
0.05,3763,90,339144,90.1020191285866,11
0.05,3764,92,339236,90.10252324037185,9
0.05,3765,94,339330,90.1035581518853,7
0.05,3766,93,339423,90.10432705070347,8
0.05,3767,93,339516,90.10509554140127,8
0.05,3768,94,339610,90.10612894667021,7
0.05,3769,91,339701,90.10636604774535,10
0.05,3770,94,339795,90.1073985680191,7
0.05,3771,91,339886,90.10763520678685,10
0.05,3772,96,339982,90.10919692552346,6
0.05,3773,92,340074,90.10969793322735,9
0.05,3774,96,340170,90.1112582781457,6
0.05,3775,94,340264,90.11228813559322,7
0.05,3776,93,340357,90.11305268731797,9
0.05,3777,95,340452,90.11434621492853,8
0.05,3778,94,340546,90.11537443768192,7
0.05,3779,96,340642,90.11693121693122,6
0.05,3780,92,340734,90.11742925152076,9
0.05,3781,94,340828,90.11845584346906,7
0.05,3782,96,340924,90.12001057361883,6
0.05,3783,94,341018,90.12103594080338,7
0.05,3784,94,341112,90.1220607661823,7
0.05,3785,94,341206,90.1230850501849,7
0.05,3786,26,341232,90.10615262740956,7
0.05,3787,94,341326,90.10718057022176,7
0.05,3788,95,341421,90.10847189231987,6
0.05,3789,91,341512,90.10870712401055,10
0.05,3790,94,341606,90.10973357953047,7
0.05,3791,92,341698,90.11023206751055,9
0.05,3792,89,341787,90.1099393619826,13
0.05,3793,92,341879,90.11043753294676,9
0.05,3794,95,341974,90.11172595520422,6
0.05,3795,95,342069,90.11301369863014,6
0.05,3796,94,342163,90.11403739794575,7
0.05,3797,23,342186,90.09636650868879,9
0.05,3798,96,342282,90.09792050539616,6
0.05,3799,94,342376,90.09894736842105,8
0.05,3800,95,342471,90.10023677979478,6
0.05,3801,94,342565,90.10126249342451,7
0.05,3802,94,342659,90.10228766763082,8
0.05,3803,96,342755,90.10383806519454,6
0.05,3804,94,342849,90.10486202365308,7
0.05,3805,94,342943,90.10588544403574,7
0.05,3806,90,343033,90.10585763068032,11
0.05,3807,93,343126,90.10661764705883,9
0.05,3808,94,343220,90.10763980047257,7
0.05,3809,96,343316,90.10918635170604,6
0.05,3810,92,343408,90.10968249803202,9
0.05,3811,17,343425,90.0905036726128,16
0.05,3812,88,343513,90.08995541568319,13
0.05,3813,94,343607,90.09098059779758,7
0.05,3814,96,343703,90.09252948885977,6
0.05,3815,92,343795,90.09302935010483,9
0.05,3816,90,343885,90.0930049777312,11
0.05,3817,93,343978,90.09376636982714,8
0.05,3818,96,344074,90.09531290913851,6
0.05,3819,95,344169,90.09659685863875,7
0.05,3820,95,344264,90.09788013609003,6
0.05,3821,93,344357,90.09863945578232,8
0.05,3822,96,344453,90.1001831022757,6
0.05,3823,95,344548,90.10146443514644,6
0.05,3824,95,344643,90.10274509803922,6
0.05,3825,92,344735,90.10324098274961,9
0.05,3826,93,344828,90.10399790958975,8
0.05,3827,93,344921,90.10475444096134,8
0.05,3828,94,345015,90.10577174196918,7
0.05,3829,92,345107,90.10626631853786,9
0.05,3830,96,345203,90.10780475071783,6
0.05,3831,-46,345157,90.07228601252609,9
0.05,3832,94,345251,90.07331072267154,7
0.05,3833,95,345346,90.07459572248305,7
0.05,3834,93,345439,90.07535853976532,8
0.05,3835,94,345533,90.07638164754952,7
0.05,3836,94,345627,90.07740422204847,8
0.05,3837,96,345723,90.07894736842105,6
0.05,3838,94,345817,90.07996874185986,7
0.05,3839,94,345911,90.08098958333333,7
0.05,3840,92,346003,90.081489195522,9
0.05,3841,94,346097,90.08250910983863,7
0.05,3842,94,346191,90.08352849336455,7
0.05,3843,94,346285,90.08454734651404,8
0.05,3844,96,346381,90.08608582574773,6
0.05,3845,94,346475,90.08710348413936,7
0.05,3846,94,346569,90.08812061346504,7
0.05,3847,94,346663,90.08913721413721,7
0.05,3848,94,346757,90.09015328656794,7
0.05,3849,92,346849,90.09064935064936,9
0.05,3850,95,346944,90.09192417553882,6
0.05,3851,96,347040,90.09345794392523,6
0.05,3852,96,347136,90.09499091616922,6
0.05,3853,94,347230,90.09600415153088,7
0.05,3854,95,347325,90.09727626459144,7
0.05,3855,93,347418,90.09802904564316,8
0.05,3856,92,347510,90.09852216748769,9
0.05,3857,96,347606,90.10005184033177,6
0.05,3858,95,347701,90.10132158590308,6
0.05,3859,96,347797,90.10284974093264,6
0.05,3860,95,347892,90.1041181041181,6
0.05,3861,87,347979,90.10331434489902,14
0.05,3862,94,348073,90.1043230649754,8
0.05,3863,95,348168,90.1055900621118,7
0.05,3864,94,348262,90.10659767141009,7
0.05,3865,95,348357,90.10786342472841,6
0.05,3866,95,348452,90.10912852340316,7
0.05,3867,94,348546,90.11013443640124,8
0.05,3868,95,348641,90.11139829413285,6
0.05,3869,91,348732,90.11162790697675,10
0.05,3870,96,348828,90.11314905709119,6
0.05,3871,96,348924,90.1146694214876,6
0.05,3872,95,349019,90.1159308029951,6
0.05,3873,94,349113,90.1169334021683,7
0.05,3874,95,349208,90.1181935483871,6
0.05,3875,93,349301,90.11893704850361,8
0.05,3876,94,349395,90.11993809646634,7
0.05,3877,94,349489,90.12093862815884,7
0.05,3878,94,349583,90.12193864398041,7
0.05,3879,94,349677,90.1229381443299,8
0.05,3880,94,349771,90.12393712960578,7
0.05,3881,94,349865,90.12493560020609,7
0.05,3882,96,349961,90.12644862219933,6
0.05,3883,94,350055,90.12744593202883,7
0.05,3884,95,350150,90.12870012870013,6
0.05,3885,95,350245,90.12995367987648,7
0.05,3886,93,350338,90.13069205042449,8
0.05,3887,92,350430,90.13117283950618,9
0.05,3888,95,350525,90.1324247878632,6
0.05,3889,94,350619,90.13341902313624,9
0.05,3890,93,350712,90.13415574402467,8
0.05,3891,91,350803,90.13437821171634,11
0.05,3892,93,350896,90.13511430773183,8
0.05,3893,94,350990,90.13610683102209,8
0.05,3894,91,351081,90.13632862644415,10
0.05,3895,94,351175,90.13732032854209,7
0.05,3896,95,351270,90.13856812933025,6
0.05,3897,96,351366,90.14007183170857,6
0.05,3898,96,351462,90.14157476275969,6
0.05,3899,95,351557,90.1428205128205,6
0.05,3900,91,351648,90.14304024609075,10
0.05,3901,94,351742,90.14402870322911,8
0.05,3902,94,351836,90.145016653856,7
0.05,3903,96,351932,90.14651639344262,6
0.05,3904,94,352026,90.14750320102432,7
0.05,3905,94,352120,90.14848950332821,7
0.05,3906,95,352215,90.14973125159969,6
0.05,3907,93,352308,90.15046059365405,8
0.05,3908,94,352402,90.15144538245076,8
0.05,3909,94,352496,90.15242966751919,8
0.05,3910,94,352590,90.15341344924572,8
0.05,3911,96,352686,90.15490797546012,6
0.05,3912,93,352779,90.15563506261181,9
0.05,3913,92,352871,90.1561062851303,9
0.05,3914,93,352964,90.15683269476374,8
0.05,3915,94,353058,90.15781409601634,7
0.05,3916,96,353154,90.15930559101353,6
0.05,3917,94,353248,90.16028586013272,7
0.05,3918,96,353344,90.16177596325593,6
0.05,3919,93,353437,90.1625,8
0.05,3920,95,353532,90.1637337413925,6
0.05,3921,92,353624,90.16420193778684,10
0.05,3922,94,353718,90.16517970940606,7
0.05,3923,94,353812,90.16615698267074,7
0.05,3924,96,353908,90.16764331210192,6
0.05,3925,90,353998,90.16760061130923,11
0.05,3926,94,354092,90.16857652151769,7
0.05,3927,94,354186,90.16955193482688,8
0.05,3928,95,354281,90.17078136930516,7
0.05,3929,94,354375,90.17175572519083,7
0.05,3930,96,354471,90.17323836174002,6
0.05,3931,92,354563,90.17370295015259,9
0.05,3932,20,354583,90.15586066615815,12
0.05,3933,95,354678,90.15709201830198,6
0.05,3934,84,354762,90.15552731893266,17
0.05,3935,94,354856,90.15650406504065,7
0.05,3936,95,354951,90.15773431546863,8
0.05,3937,93,355044,90.1584560690706,8
0.05,3938,25,355069,90.14191419141915,8
0.05,3939,95,355164,90.14314720812183,6
0.05,3940,94,355258,90.14412585638163,8
0.05,3941,96,355354,90.14561136478945,6
0.05,3942,94,355448,90.14658889170683,7
0.05,3943,95,355543,90.14781947261663,6
0.05,3944,94,355637,90.1487959442332,7
0.05,3945,93,355730,90.14951849974658,8
0.05,3946,92,355822,90.149987332151,9
0.05,3947,94,355916,90.15096251266463,7
0.05,3948,95,356011,90.15219042795644,6
0.05,3949,94,356105,90.15316455696203,7
0.05,3950,94,356199,90.15413819286256,8
0.05,3951,93,356292,90.15485829959515,8
0.05,3952,94,356386,90.15583101441943,7
0.05,3953,94,356480,90.15680323722812,7
0.05,3954,95,356575,90.15802781289507,7
0.05,3955,27,356602,90.14206268958544,6
0.05,3956,94,356696,90.14303765478898,7
0.05,3957,94,356790,90.14401212733704,7
0.05,3958,93,356883,90.14473351856529,8
0.05,3959,95,356978,90.1459595959596,6
0.05,3960,93,357071,90.14668013127998,8
0.05,3961,94,357165,90.14765270065624,8
0.05,3962,87,357252,90.14685844057531,14
0.05,3963,94,357346,90.14783047426842,7
0.05,3964,94,357440,90.14880201765448,7
0.05,3965,95,357535,90.15002521432173,6
0.05,3966,95,357630,90.151247794303,7
0.05,3967,90,357720,90.15120967741936,11
0.05,3968,93,357813,90.15192743764172,8
0.05,3969,95,357908,90.15314861460958,8
0.05,3970,96,358004,90.15462100226644,6
0.05,3971,95,358099,90.15584088620342,7
0.05,3972,93,358192,90.15655675811729,9
0.05,3973,92,358284,90.15702063412179,9
0.05,3974,92,358376,90.15748427672956,9
0.05,3975,96,358472,90.158953722334,6
0.05,3976,95,358567,90.16017098315314,7
0.05,3977,94,358661,90.16113624937154,7
0.05,3978,96,358757,90.16260366926363,6
0.05,3979,92,358849,90.16306532663316,9
0.05,3980,94,358943,90.16402913840743,7
0.05,3981,93,359036,90.16474133601206,8
0.05,3982,94,359130,90.16570424303289,7
0.05,3983,91,359221,90.16591365461848,10
0.05,3984,92,359313,90.166373902133,9
0.05,3985,93,359406,90.16708479678876,8
0.05,3986,94,359500,90.16804614998746,7
0.05,3987,93,359593,90.16875626880642,8
0.05,3988,90,359683,90.16871396339936,11
0.05,3989,95,359778,90.16992481203008,6
0.05,3990,94,359872,90.17088449010274,7
0.05,3991,94,359966,90.17184368737475,7
0.05,3992,27,359993,90.15602304032056,6
0.05,3993,90,360083,90.15598397596395,11
0.05,3994,91,360174,90.15619524405507,10
0.05,3995,89,360263,90.15590590590591,12
0.05,3996,94,360357,90.15686765073805,7
0.05,3997,94,360451,90.15782891445723,7
0.05,3998,94,360545,90.15878969742435,7
0.05,3999,95,360640,90.16,6
0.05,4000,94,360734,90.16095976005998,7
0.05,4001,92,360826,90.16141929035483,9
0.05,4002,94,360920,90.16237821633774,8
0.05,4003,94,361014,90.16333666333666,7
0.05,4004,94,361108,90.16429463171036,7
0.05,4005,94,361202,90.16525212181728,7
0.05,4006,96,361298,90.16670826054404,6
0.05,4007,94,361392,90.16766467065868,7
0.05,4008,93,361485,90.16837116487902,9
0.05,4009,92,361577,90.16882793017456,9
0.05,4010,92,361669,90.1692844677138,9
0.05,4011,93,361762,90.16999002991027,8
0.05,4012,94,361856,90.17094443060054,7
0.05,4013,92,361948,90.17140009965122,9
0.05,4014,94,362042,90.17235367372353,7
0.05,4015,94,362136,90.17330677290836,8
0.05,4016,94,362230,90.17425939756036,8
0.05,4017,95,362325,90.17546042807366,6
0.05,4018,93,362418,90.17616322468275,8
0.05,4019,95,362513,90.1773631840796,7
0.05,4020,96,362609,90.17881124098483,6
0.05,4021,96,362705,90.18025857782197,6
0.05,4022,89,362794,90.17996520009943,12
0.05,4023,94,362888,90.18091451292247,7
0.05,4024,95,362983,90.18211180124223,6
0.05,4025,27,363010,90.16641828117238,6
0.05,4026,96,363106,90.16786689843556,6
0.05,4027,93,363199,90.16857000993049,9
0.05,4028,95,363294,90.16976917349218,6
0.05,4029,93,363387,90.17047146401985,9
0.05,4030,94,363481,90.17142148350285,7
0.05,4031,90,363571,90.17137896825396,11
0.05,4032,96,363667,90.17282420034714,6
0.05,4033,96,363763,90.17426871591472,6
0.05,4034,95,363858,90.17546468401487,6
0.05,4035,94,363952,90.17641228939544,7
0.05,4036,94,364046,90.17735942531583,8
0.05,4037,94,364140,90.17830609212481,7
0.05,4038,95,364235,90.17949987620698,7
0.05,4039,94,364329,90.18044554455446,8
0.05,4040,93,364422,90.181143281366,8
0.05,4041,94,364516,90.18208807521029,8
0.05,4042,92,364608,90.18253771951521,9
0.05,4043,96,364704,90.1839762611276,6
0.05,4044,94,364798,90.1849196538937,7
0.05,4045,92,364890,90.18536826495304,9
0.05,4046,92,364982,90.18581665431184,9
0.05,4047,25,365007,90.16971343873517,7
0.05,4048,94,365101,90.17065942207952,7
0.05,4049,93,365194,90.17135802469136,9
0.05,4050,95,365289,90.17254998765736,6
0.05,4051,92,365381,90.17300098716683,9
0.05,4052,95,365476,90.17419195657537,6
0.05,4053,94,365570,90.17513566847558,7
0.05,4054,94,365664,90.17607891491986,7
0.05,4055,93,365757,90.17677514792899,8
0.05,4056,93,365850,90.17747103771259,8
0.05,4057,94,365944,90.17841301133564,8
0.05,4058,92,366036,90.17886178861788,9
0.05,4059,96,366132,90.18029556650247,6
0.05,4060,92,366224,90.18074365919725,9
0.05,4061,96,366320,90.18217626784835,6
0.05,4062,93,366413,90.18286980063992,8
0.05,4063,94,366507,90.1838090551181,7
0.05,4064,94,366601,90.18474784747848,7
0.05,4065,92,366693,90.18519429414658,9
0.05,4066,93,366786,90.18588640275387,8
0.05,4067,94,366880,90.18682399213372,7
0.05,4068,91,366971,90.18702383878103,10
0.05,4069,95,367066,90.18820638820638,6
0.05,4070,22,367088,90.17145664455907,10
0.05,4071,93,367181,90.17215127701375,9
0.05,4072,94,367275,90.17309108765038,7
0.05,4073,92,367367,90.17353951890034,10
0.05,4074,92,367459,90.17398773006136,9
0.05,4075,95,367554,90.17517173699706,6
0.05,4076,92,367646,90.17561932793721,9
0.05,4077,94,367740,90.17655713585091,7
0.05,4078,26,367766,90.16082373130669,7
0.05,4079,94,367860,90.16176470588235,7
0.05,4080,94,367954,90.16270521930899,7
0.05,4081,93,368047,90.16340029397354,8
0.05,4082,92,368139,90.16385011021308,9
0.05,4083,94,368233,90.16478942213516,8
0.05,4084,93,368326,90.1654834761322,8
0.05,4085,95,368421,90.16666666666667,6
0.05,4086,92,368513,90.16711524345486,9
0.05,4087,92,368605,90.16756360078278,9
0.05,4088,95,368700,90.16874541452678,6
0.05,4089,92,368792,90.16919315403423,10
0.05,4090,95,368887,90.17037399168908,6
0.05,4091,92,368979,90.1708211143695,9
0.05,4092,90,369069,90.1707793794283,11
0.05,4093,96,369165,90.17220322423059,6
0.05,4094,94,369259,90.17313797313797,7
0.05,4095,92,369351,90.173583984375,9
0.05,4096,94,369445,90.17451793995606,8
0.05,4097,94,369539,90.1754514397267,8
0.05,4098,94,369633,90.17638448402049,7
0.05,4099,93,369726,90.1770731707317,9
0.05,4100,93,369819,90.17776152158011,8
0.05,4101,94,369913,90.17869332033155,8
0.05,4102,94,370007,90.17962466487936,7
0.05,4103,93,370100,90.18031189083821,8
0.05,4104,92,370192,90.18075517661389,9
0.05,4105,93,370285,90.18144179249879,9
0.05,4106,93,370378,90.18212807401997,8
0.05,4107,92,370470,90.18257059396299,9
0.05,4108,92,370562,90.18301289851546,10
0.05,4109,95,370657,90.18418491484185,8
0.05,4110,96,370753,90.1855996108003,6
0.05,4111,90,370843,90.18555447470817,11
0.05,4112,93,370936,90.18623875516654,8
0.05,4113,96,371032,90.18765192027224,6
0.05,4114,95,371127,90.18882138517618,6
0.05,4115,95,371222,90.18999028182702,6
0.05,4116,94,371316,90.1909157153267,7
0.05,4117,94,371410,90.19184069936863,7
0.05,4118,90,371500,90.19179412478756,12
0.05,4119,93,371593,90.19247572815534,8
0.05,4120,92,371685,90.19291434117933,9
0.05,4121,95,371780,90.19408054342553,6
0.05,4122,94,371874,90.19500363812757,7
0.05,4123,92,371966,90.19544131910766,9
0.05,4124,89,372055,90.19515151515151,12
0.05,4125,91,372146,90.19534658264664,10
0.05,4126,95,372241,90.19651078265083,6
0.05,4127,94,372335,90.19743217054264,8
0.05,4128,92,372427,90.19786873334948,9
0.05,4129,95,372522,90.19903147699758,6
0.05,4130,95,372617,90.20019365771,7
0.05,4131,95,372712,90.20135527589545,6
0.05,4132,26,372738,90.18582143721268,7
0.05,4133,95,372833,90.18698597000484,6
0.05,4134,93,372926,90.18766626360339,8
0.05,4135,94,373020,90.18858800773694,7
0.05,4136,95,373115,90.18975102731449,6
0.05,4137,92,373207,90.19018849685838,9
0.05,4138,94,373301,90.19110896351776,7
0.05,4139,94,373395,90.19202898550725,8
0.05,4140,92,373487,90.19246558802222,10
0.05,4141,94,373581,90.1933848382424,7
0.05,4142,95,373676,90.19454501568912,6
0.05,4143,96,373772,90.19594594594595,6
0.05,4144,94,373866,90.19686369119421,7
0.05,4145,95,373961,90.19802219006272,6
0.05,4146,94,374055,90.19893899204244,7
0.05,4147,93,374148,90.19961427193829,8
0.05,4148,93,374241,90.2002892263196,8
0.05,4149,94,374335,90.20120481927711,7
0.05,4150,94,374429,90.2021199710913,7
0.05,4151,89,374518,90.20183044315992,12
0.05,4152,26,374544,90.18637129785697,7
0.05,4153,94,374638,90.18728935965335,7
0.05,4154,96,374734,90.18868832731648,6
0.05,4155,95,374829,90.18984600577478,7
0.05,4156,95,374924,90.19100312725523,6
0.05,4157,94,375018,90.1919191919192,7
0.05,4158,94,375112,90.19283481606155,8
0.05,4159,93,375205,90.19350961538461,8
0.05,4160,96,375301,90.19490507089643,6
0.05,4161,94,375395,90.19581931763575,7
0.05,4162,94,375489,90.19673312515013,7
0.05,4163,96,375585,90.19812680115274,6
0.05,4164,95,375680,90.19927971188476,6
0.05,4165,94,375774,90.20019203072492,7
0.05,4166,95,375869,90.2013438924886,6
0.05,4167,94,375963,90.20225527831094,7
0.05,4168,92,376055,90.20268649556249,10
0.05,4169,95,376150,90.20383693045564,6
0.05,4170,96,376246,90.20522656437305,6
0.05,4171,94,376340,90.20613614573347,7
0.05,4172,92,376432,90.20656601965013,9
0.05,4173,90,376522,90.2065165309056,11
0.05,4174,96,376618,90.20790419161676,6
0.05,4175,93,376711,90.20857279693486,8
0.05,4176,93,376804,90.20924108211635,8
0.05,4177,96,376900,90.21062709430349,6
0.05,4178,96,376996,90.21201244316822,6
0.05,4179,91,377087,90.21220095693779,10
0.05,4180,96,377183,90.21358526668261,6
0.05,4181,94,377277,90.21449067431851,8
0.05,4182,20,377297,90.19770499641406,12
0.05,4183,95,377392,90.19885277246654,6
0.05,4184,95,377487,90.2,6
0.05,4185,94,377581,90.20090778786431,7
0.05,4186,94,377675,90.20181514210653,7
0.05,4187,94,377769,90.20272206303724,7
0.05,4188,94,377863,90.20362855096681,7
0.05,4189,92,377955,90.20405727923628,9
0.05,4190,93,378048,90.20472440944881,8
0.05,4191,93,378141,90.20539122137404,8
0.05,4192,94,378235,90.20629620796565,7
0.05,4193,94,378329,90.20720076299476,8
0.05,4194,94,378423,90.20810488676996,7
0.05,4195,93,378516,90.20877025738798,8
0.05,4196,95,378611,90.20991184179175,7
0.05,4197,93,378704,90.21057646498332,8
0.05,4198,94,378798,90.21147892355323,7
0.05,4199,96,378894,90.21285714285715,6
0.05,4200,92,378986,90.21328255177339,9
0.05,4201,94,379080,90.21418372203712,7
0.05,4202,89,379169,90.21389483702117,12
0.05,4203,89,379258,90.21360608943863,12
0.05,4204,92,379350,90.2140309155767,9
0.05,4205,93,379443,90.21469329529243,8
0.05,4206,90,379533,90.21464226289517,11
0.05,4207,94,379627,90.21554182509506,7
0.05,4208,94,379721,90.21644095984794,7
0.05,4209,94,379815,90.21733966745843,7
0.05,4210,94,379909,90.21823794823082,7
0.05,4211,95,380004,90.21937321937322,6
0.05,4212,90,380094,90.21932114882506,13
0.05,4213,95,380189,90.22045562411012,6
0.05,4214,93,380282,90.22111506524318,9
0.05,4215,94,380376,90.22201138519924,7
0.05,4216,94,380470,90.22290728005692,7
0.05,4217,95,380565,90.22403982930298,6
0.05,4218,23,380588,90.20810618630007,10
0.05,4219,91,380679,90.20829383886256,10
0.05,4220,96,380775,90.20966595593461,6
0.05,4221,94,380869,90.21056371387968,8
0.05,4222,95,380964,90.21169784513378,7
0.05,4223,94,381058,90.2125946969697,7
0.05,4224,95,381153,90.2137278106509,7
0.05,4225,95,381248,90.21486038807383,6
0.05,4226,93,381341,90.21551928081382,8
0.05,4227,93,381434,90.21617786187322,8
0.05,4228,95,381529,90.21730905651454,6
0.05,4229,94,381623,90.21820330969267,7
0.05,4230,96,381719,90.219569841645,6
0.05,4231,93,381812,90.22022684310019,9
0.05,4232,92,381904,90.2206472950626,9
0.05,4233,90,381994,90.22059518186113,11
0.05,4234,93,382087,90.22125147579693,8
0.05,4235,94,382181,90.22214353163362,7
0.05,4236,94,382275,90.22303516639131,7
0.05,4237,93,382368,90.22369042000943,8
0.05,4238,95,382463,90.22481717386177,6
0.05,4239,95,382558,90.22594339622641,6
0.05,4240,92,382650,90.22636170714455,10
0.05,4241,95,382745,90.22748703441773,6
0.05,4242,93,382838,90.22814046665096,8
0.05,4243,94,382932,90.22902921771913,7
0.05,4244,96,383028,90.23038869257951,6
0.05,4245,94,383122,90.2312764955252,7
0.05,4246,93,383215,90.23192842006122,9
0.05,4247,93,383308,90.23258003766479,9
0.05,4248,92,383400,90.2329959990586,9
0.05,4249,95,383495,90.23411764705882,6
0.05,4250,93,383588,90.23476828981416,9
0.05,4251,95,383683,90.23588899341486,6
0.05,4252,91,383774,90.23606865741829,10
0.05,4253,94,383868,90.23695345557122,7
0.05,4254,27,383895,90.22209165687427,6
0.05,4255,90,383985,90.2220394736842,11
0.05,4256,90,384075,90.22198731501057,11
0.05,4257,94,384169,90.22287458900892,7
0.05,4258,93,384262,90.22352664944823,8
0.05,4259,94,384356,90.22441314553991,7
0.05,4260,93,384449,90.22506453884064,8
0.05,4261,94,384543,90.2259502580948,8
0.05,4262,94,384637,90.22683556181093,7
0.05,4263,94,384731,90.22772045028142,7
0.05,4264,94,384825,90.22860492379836,7
0.05,4265,95,384920,90.22972339428036,6
0.05,4266,92,385012,90.23013827044763,10
0.05,4267,92,385104,90.23055295220243,9
0.05,4268,92,385196,90.23096743968142,9
0.05,4269,94,385290,90.23185011709602,7
0.05,4270,94,385384,90.23273238117537,7
0.05,4271,26,385410,90.21769662921348,7
0.05,4272,94,385504,90.21858179265153,7
0.05,4273,95,385599,90.2197005147403,6
0.05,4274,94,385693,90.22058479532164,8
0.05,4275,91,385784,90.22076707202993,10
0.05,4276,93,385877,90.22141688099136,8
0.05,4277,94,385971,90.22230014025246,7
0.05,4278,91,386062,90.22248188829165,10
0.05,4279,91,386153,90.22266355140187,10
0.05,4280,95,386248,90.22377949077318,6
0.05,4281,96,386344,90.22512844465203,6
0.05,4282,93,386437,90.22577632500584,8
0.05,4283,27,386464,90.21101774042951,6
0.05,4284,94,386558,90.21190198366395,7
0.05,4285,93,386651,90.21255249650024,8
0.05,4286,90,386741,90.21250291579193,12
0.05,4287,94,386835,90.21338619402985,7
0.05,4288,94,386929,90.21426906038704,7
0.05,4289,96,387025,90.21561771561771,6
0.05,4290,92,387117,90.21603355861104,9
0.05,4291,94,387211,90.21691519105312,7
0.05,4292,91,387302,90.2170976007454,12
0.05,4293,93,387395,90.21774569166278,8
0.05,4294,-44,387351,90.18649592549477,8
0.05,4295,96,387447,90.18784916201118,6
0.05,4296,95,387542,90.18896904817315,6
0.05,4297,95,387637,90.19008841321545,6
0.05,4298,93,387730,90.19074203303094,8
0.05,4299,94,387824,90.19162790697675,7
0.05,4300,94,387918,90.19251336898395,7
0.05,4301,96,388014,90.19386331938634,6
0.05,4302,94,388108,90.19474785033698,7
0.05,4303,92,388200,90.19516728624535,9
0.05,4304,93,388293,90.19581881533101,8
0.05,4305,94,388387,90.1967022758941,7
0.05,4306,96,388483,90.19804968655677,6
0.05,4307,27,388510,90.18337975858867,6
0.05,4308,95,388605,90.18449756323973,6
0.05,4309,27,388632,90.16983758700697,6
0.05,4310,95,388727,90.17095801438181,6
0.05,4311,94,388821,90.17184601113172,7
0.05,4312,95,388916,90.17296545328078,6
0.05,4313,90,389006,90.17292535929532,11
0.05,4314,91,389097,90.1731170336037,10
0.05,4315,94,389191,90.17400370713624,7
0.05,4316,93,389284,90.17465832754228,8
0.05,4317,94,389378,90.17554423344141,7
0.05,4318,95,389473,90.17666126418152,7
0.05,4319,95,389568,90.17777777777778,6
0.05,4320,92,389660,90.1781994908586,9
0.05,4321,93,389753,90.17885238315594,8
0.05,4322,90,389843,90.17881101087208,12
0.05,4323,94,389937,90.17969472710453,7
0.05,4324,91,390028,90.17988439306359,10
0.05,4325,93,390121,90.18053629218677,8
0.05,4326,94,390215,90.1814189969956,7
0.05,4327,94,390309,90.18230129390018,7
0.05,4328,91,390400,90.18249018249018,10
0.05,4329,95,390495,90.18360277136259,6
0.05,4330,95,390590,90.18471484645579,7
0.05,4331,91,390681,90.18490304709141,11
0.05,4332,91,390772,90.18509116085853,10
0.05,4333,95,390867,90.18620212275034,8
0.05,4334,94,390961,90.18708189158016,7
0.05,4335,94,391055,90.18796125461255,7
0.05,4336,94,391149,90.1888402121282,7
0.05,4337,94,391243,90.18971876440756,7
0.05,4338,96,391339,90.19105784743029,6
0.05,4339,95,391434,90.19216589861752,6
0.05,4340,90,391524,90.19212163096061,11
0.05,4341,96,391620,90.1934592353754,6
0.05,4342,27,391647,90.17890858853328,6
0.05,4343,94,391741,90.17978821362799,9
0.05,4344,93,391834,90.18043728423476,8
0.05,4345,92,391926,90.18085595950299,9
0.05,4346,94,392020,90.18173452956061,8
0.05,4347,95,392115,90.18284268629255,6
0.05,4348,96,392211,90.18418027132674,6
0.05,4349,94,392305,90.18505747126437,7
0.05,4350,92,392397,90.18547460353942,9
0.05,4351,93,392490,90.1861213235294,8
0.05,4352,91,392581,90.18630829313118,10
0.05,4353,93,392674,90.1869545245751,8
0.05,4354,94,392768,90.18783008036739,8
0.05,4355,96,392864,90.18916437098255,6
0.05,4356,93,392957,90.18980950195089,8
0.05,4357,92,393049,90.19022487379532,9
0.05,4358,94,393143,90.19109887588897,7
0.05,4359,92,393235,90.19151376146789,9
0.05,4360,95,393330,90.19261637239165,6
0.05,4361,93,393423,90.19325997248968,8
0.05,4362,95,393518,90.19436167774467,6
0.05,4363,96,393614,90.19569202566453,6
0.05,4364,95,393709,90.19679266895761,7
0.05,4365,93,393802,90.19743472285845,8
0.05,4366,94,393896,90.19830547286466,7
0.05,4367,95,393991,90.19940476190476,7
0.05,4368,95,394086,90.20050354772259,6
0.05,4369,92,394178,90.20091533180778,9
0.05,4370,94,394272,90.20178448867536,7
0.05,4371,95,394367,90.20288197621225,6
0.05,4372,95,394462,90.20397896181112,6
0.05,4373,95,394557,90.20507544581619,7
0.05,4374,92,394649,90.20548571428571,9
0.05,4375,93,394742,90.20612431444242,8
0.05,4376,96,394838,90.20744802376056,6
0.05,4377,90,394928,90.20740063956144,11
0.05,4378,96,395024,90.20872345284312,6
0.05,4379,94,395118,90.2095890410959,7
0.05,4380,95,395213,90.2106824925816,6
0.05,4381,92,395305,90.2110908261068,9
0.05,4382,94,395399,90.21195528177047,7
0.05,4383,96,395495,90.21327554744525,6
0.05,4384,93,395588,90.21391106043329,8
0.05,4385,92,395680,90.21431828545371,9
0.05,4386,94,395774,90.21518121723274,7
0.05,4387,93,395867,90.21581586144029,8
0.05,4388,94,395961,90.21667805878332,7
0.05,4389,91,396052,90.21685649202733,10
0.05,4390,94,396146,90.2177180596675,7
0.05,4391,94,396240,90.21857923497268,7
0.05,4392,94,396334,90.21944001821079,7
0.05,4393,94,396428,90.22030040964952,7
0.05,4394,94,396522,90.22116040955632,7
0.05,4395,93,396615,90.22179253867152,9
0.05,4396,92,396707,90.2221969524676,9
0.05,4397,96,396803,90.22351068667577,6
0.05,4398,92,396895,90.22391452602864,9
0.05,4399,94,396989,90.22477272727272,7
0.05,4400,93,397082,90.22540331742786,8
0.05,4401,90,397172,90.22535211267606,11
0.05,4402,95,397267,90.22643652055417,6
0.05,4403,94,397361,90.22729336966394,7
0.05,4404,94,397455,90.22814982973894,8
0.05,4405,21,397476,90.21243758511122,12
0.05,4406,91,397567,90.21261629226231,10
0.05,4407,94,397661,90.21347549909255,7
0.05,4408,93,397754,90.21410750737128,9
0.05,4409,94,397848,90.21496598639456,7
0.05,4410,90,397938,90.21491725232373,11
0.05,4411,94,398032,90.2157751586582,7
0.05,4412,94,398126,90.216632676184,8
0.05,4413,94,398220,90.21748980516539,7
0.05,4414,94,398314,90.21834654586637,7
0.05,4415,96,398410,90.21965579710145,6
0.05,4416,96,398506,90.22096445551279,6
0.05,4417,96,398602,90.22227252150294,6
0.05,4418,96,398698,90.22357999547408,6
0.05,4419,93,398791,90.22420814479638,8
0.05,4420,94,398885,90.22506220312147,7
0.05,4421,94,398979,90.2259158751696,7
0.05,4422,95,399074,90.22699525209134,6
0.05,4423,90,399164,90.22694394213381,11
0.05,4424,94,399258,90.22779661016949,7
0.05,4425,93,399351,90.22842295526435,8
0.05,4426,95,399446,90.22950079060311,6
0.05,4427,91,399537,90.22967479674797,10
0.05,4428,93,399630,90.23030029351999,8
0.05,4429,96,399726,90.2316027088036,6
0.05,4430,90,399816,90.23155044008125,11
0.05,4431,92,399908,90.23194945848375,9
0.05,4432,96,400004,90.23325062034739,6
0.05,4433,93,400097,90.23387460532251,8
0.05,4434,94,400191,90.2347237880496,7
0.05,4435,95,400286,90.23579801623085,7
0.05,4436,94,400380,90.236646382691,7
0.05,4437,92,400472,90.23704371338441,9
0.05,4438,94,400566,90.2378914169858,7
0.05,4439,95,400661,90.23896396396397,6
0.05,4440,94,400755,90.2398108534114,8
0.05,4441,94,400849,90.24065736154886,7
0.05,4442,94,400943,90.24150348863381,8
0.05,4443,95,401038,90.24257425742574,6
0.05,4444,93,401131,90.24319460067491,8
0.05,4445,91,401222,90.24336482231219,10
0.05,4446,95,401317,90.24443445019114,7
0.05,4447,93,401410,90.24505395683454,8
0.05,4448,96,401506,90.24634749381883,6
0.05,4449,93,401599,90.24696629213483,8
0.05,4450,94,401693,90.24780948101551,7
0.05,4451,93,401786,90.24842767295597,8
0.05,4452,90,401876,90.24837188412306,11
0.05,4453,25,401901,90.23372249663224,8
0.05,4454,96,401997,90.23501683501684,6
0.05,4455,96,402093,90.2363105924596,6
0.05,4456,95,402188,90.237379403186,6
0.05,4457,89,402277,90.23710183938987,12
0.05,4458,95,402372,90.23816999327204,6
0.05,4459,92,402464,90.23856502242153,9
0.05,4460,93,402557,90.23918403945304,8
0.05,4461,92,402649,90.23957866427611,9
0.05,4462,96,402745,90.24086937037868,6
0.05,4463,95,402840,90.24193548387096,6
0.05,4464,95,402935,90.24300111982083,6
0.05,4465,94,403029,90.24384236453201,7
0.05,4466,92,403121,90.24423550481308,9
0.05,4467,90,403211,90.24418084153984,11
0.05,4468,96,403307,90.24546878496308,6
0.05,4469,96,403403,90.24675615212529,6
0.05,4470,96,403499,90.24804294341311,6
0.05,4471,96,403595,90.24932915921288,6
0.05,4472,27,403622,90.23518891124525,6
0.05,4473,89,403711,90.23491282968261,12
0.05,4474,93,403804,90.23553072625698,8
0.05,4475,93,403897,90.23614834673816,9
0.05,4476,94,403991,90.23698905517087,7
0.05,4477,91,404082,90.23715944618134,10
0.05,4478,92,404174,90.23755302522885,9
0.05,4479,93,404267,90.23816964285714,8
0.05,4480,26,404293,90.22383396563266,6
0.05,4481,94,404387,90.22467648371263,7
0.05,4482,94,404481,90.22551862592015,7
0.05,4483,92,404573,90.22591436217662,9
0.05,4484,91,404664,90.22608695652174,10
0.05,4485,94,404758,90.22692822113241,7
0.05,4486,95,404853,90.22799197682193,7
0.05,4487,94,404947,90.22883244206774,7
0.05,4488,94,405041,90.2296725328581,7
0.05,4489,89,405130,90.22939866369711,12
0.05,4490,95,405225,90.23046092184369,6
0.05,4491,94,405319,90.2313000890472,7
0.05,4492,96,405415,90.23258401958603,6
0.05,4493,93,405508,90.23319982198487,8
0.05,4494,94,405602,90.23403781979978,7
0.05,4495,96,405698,90.23532028469751,6
0.05,4496,27,405725,90.22125861685568,6
0.05,4497,93,405818,90.22187638950645,8
0.05,4498,93,405911,90.22249388753056,9
0.05,4499,92,406003,90.22288888888889,10
0.05,4500,93,406096,90.22350588758054,8
0.05,4501,95,406191,90.2245668591737,7
0.05,4502,94,406285,90.22540528536531,7
0.05,4503,93,406378,90.22602131438721,8
0.05,4504,93,406471,90.2266370699223,8
0.05,4505,95,406566,90.2276964047936,6
0.05,4506,96,406662,90.22897714666075,6
0.05,4507,95,406757,90.23003549245786,7
0.05,4508,95,406852,90.23109336881792,6
0.05,4509,93,406945,90.23170731707317,8
0.05,4510,90,407035,90.23165595211705,12
0.05,4511,94,407129,90.23249113475177,7
0.05,4512,27,407156,90.2184799468203,6
0.05,4513,93,407249,90.21909614532565,8
0.05,4514,94,407343,90.21993355481727,7
0.05,4515,96,407439,90.22121346324181,6
0.05,4516,95,407534,90.22227141908347,6
0.05,4517,96,407630,90.22355024347056,6
0.05,4518,94,407724,90.22438592608984,7
0.05,4519,94,407818,90.22522123893805,7
0.05,4520,91,407909,90.22539261225393,11
0.05,4521,94,408003,90.22622733303848,7
0.05,4522,96,408099,90.22750386911342,6
0.05,4523,92,408191,90.22789566755084,9
0.05,4524,96,408287,90.22917127071823,6
0.05,4525,93,408380,90.22978347326557,8
0.05,4526,93,408473,90.2303954053457,9
0.05,4527,93,408566,90.23100706713781,8
0.05,4528,94,408660,90.23183925811438,7
0.05,4529,91,408751,90.23200883002208,10
0.05,4530,93,408844,90.23261973074376,8
0.05,4531,94,408938,90.23345101500442,7
0.05,4532,94,409032,90.23428193249504,7
0.05,4533,91,409123,90.23445081605647,10
0.05,4534,92,409215,90.2348401323043,9
0.05,4535,95,409310,90.23589065255732,6
0.05,4536,94,409404,90.23672029975755,7
0.05,4537,93,409497,90.23732921992067,8
0.05,4538,96,409593,90.23859881031063,6
0.05,4539,92,409685,90.23898678414096,9
0.05,4540,94,409779,90.23981501871835,7
0.05,4541,94,409873,90.24064288859533,7
0.05,4542,94,409967,90.24147039401277,7
0.05,4543,93,410060,90.24207746478874,9
0.05,4544,93,410153,90.24268426842684,8
0.05,4545,92,410245,90.24307083150022,9
0.05,4546,92,410337,90.24345722454366,9
0.05,4547,96,410433,90.24472295514512,6
0.05,4548,95,410528,90.24576830072543,6
0.05,4549,95,410623,90.24681318681318,7
0.05,4550,94,410717,90.24763788178423,7
0.05,4551,94,410811,90.24846221441125,8
0.05,4552,91,410902,90.24862727871734,10
0.05,4553,95,410997,90.24967061923584,6
0.05,4554,95,411092,90.25071350164654,6
0.05,4555,96,411188,90.25197541703248,6
0.05,4556,90,411278,90.25192012288787,11
0.05,4557,90,411368,90.2518648530057,11
0.05,4558,95,411463,90.25290633910946,6
0.05,4559,92,411555,90.2532894736842,9
0.05,4560,93,411648,90.25389169041877,8
0.05,4561,94,411742,90.25471284524332,7
0.05,4562,95,411837,90.25575279421433,6
0.05,4563,96,411933,90.25701139351446,6
0.05,4564,94,412027,90.25783132530121,7
0.05,4565,93,412120,90.25843188786685,9
0.05,4566,96,412216,90.25968907379024,6
0.05,4567,94,412310,90.26050788091068,7
0.05,4568,94,412404,90.2613263296126,8
0.05,4569,96,412500,90.26258205689278,6
0.05,4570,95,412595,90.26361846423102,7
0.05,4571,92,412687,90.26399825021872,9
0.05,4572,93,412780,90.26459654493767,8
0.05,4573,93,412873,90.26519457804984,8
0.05,4574,92,412965,90.2655737704918,9
0.05,4575,94,413059,90.26638986013987,7
0.05,4576,94,413153,90.2672055931833,7
0.05,4577,96,413249,90.26845784185234,6
0.05,4578,94,413343,90.2692727669797,7
0.05,4579,96,413439,90.27052401746725,6
0.05,4580,94,413533,90.27133813577821,7
0.05,4581,26,413559,90.25731121780882,7
0.05,4582,94,413653,90.25812786384465,7
0.05,4583,94,413747,90.25894415357766,7
0.05,4584,94,413841,90.259760087241,7
0.05,4585,96,413937,90.26101177496729,6
0.05,4586,94,414031,90.26182690211468,7
0.05,4587,91,414122,90.26198779424585,10
0.05,4588,90,414212,90.26193070385705,11
0.05,4589,94,414306,90.26274509803922,7
0.05,4590,94,414400,90.26355913744283,7
0.05,4591,-45,414355,90.23410278745645,8
0.05,4592,91,414446,90.23426954060527,10
0.05,4593,95,414541,90.23530692207227,6
0.05,4594,94,414635,90.23612622415669,7
0.05,4595,94,414729,90.2369451697128,7
0.05,4596,94,414823,90.23776375897324,7
0.05,4597,95,414918,90.23879947803393,7
0.05,4598,95,415013,90.23983474668407,6
0.05,4599,96,415109,90.24108695652174,6
0.05,4600,94,415203,90.2419039339274,7
0.05,4601,95,415298,90.24293785310735,6
0.05,4602,94,415392,90.24375407343037,7
0.05,4603,95,415487,90.24478714161599,7
0.05,4604,93,415580,90.24538545059718,8
0.05,4605,96,415676,90.24663482414242,6
0.05,4606,93,415769,90.24723247232473,8
0.05,4607,95,415864,90.24826388888889,6
0.05,4608,88,415952,90.24777609025818,13
0.05,4609,96,416048,90.24902386117137,6
0.05,4610,92,416140,90.24940360008675,9
0.05,4611,95,416235,90.25043365134432,6
0.05,4612,94,416329,90.25124647734663,7
0.05,4613,95,416424,90.2522756827048,6
0.05,4614,94,416518,90.25308775731311,7
0.05,4615,95,416613,90.25411611785096,7
0.05,4616,96,416709,90.25536062378167,6
0.05,4617,96,416805,90.25660459073192,6
0.05,4618,94,416899,90.25741502489717,8
0.05,4619,93,416992,90.25800865800866,8
0.05,4620,94,417086,90.25881843756763,7
0.05,4621,88,417174,90.25832972739074,13
0.05,4622,94,417268,90.25913908717283,8
0.05,4623,95,417363,90.26016435986159,6
0.05,4624,94,417457,90.26097297297298,8
0.05,4625,95,417552,90.26199740596628,7
0.05,4626,94,417646,90.26280527339529,7
0.05,4627,92,417738,90.26318063958513,9
0.05,4628,95,417833,90.26420393173471,7
0.05,4629,96,417929,90.26544276457884,6
0.05,4630,94,418023,90.26624919023969,7
0.05,4631,94,418117,90.26705526770293,8
0.05,4632,95,418212,90.26807684006043,6
0.05,4633,94,418306,90.26888217522658,7
0.05,4634,91,418397,90.26903991370011,10
0.05,4635,94,418491,90.26984469370147,7
0.05,4636,94,418585,90.27064912659047,7
0.05,4637,91,418676,90.27080638206124,10
0.05,4638,92,418768,90.27117913343393,9
0.05,4639,92,418860,90.27155172413794,9
0.05,4640,94,418954,90.2723550958845,7
0.05,4641,95,419049,90.27337354588539,6
0.05,4642,94,419143,90.27417617919448,7
0.05,4643,88,419231,90.27368647717485,13
0.05,4644,95,419326,90.27470398277718,6
0.05,4645,96,419422,90.2759362892811,6
0.05,4646,96,419518,90.27716806541855,6
0.05,4647,95,419613,90.27818416523236,6
0.05,4648,94,419707,90.27898472789848,7
0.05,4649,96,419803,90.28021505376344,6
0.05,4650,96,419899,90.28144485056977,6
0.05,4651,95,419994,90.28245915735168,6
0.05,4652,96,420090,90.28368794326241,6
0.05,4653,94,420184,90.28448646325741,7
0.05,4654,93,420277,90.28506981740064,8
0.05,4655,94,420371,90.2858676975945,7
0.05,4656,92,420463,90.2862357741035,9
0.05,4657,94,420557,90.28703306139974,7
0.05,4658,92,420649,90.28740072977034,9
0.05,4659,94,420743,90.2881974248927,7
0.05,4660,92,420835,90.28856468568976,10
0.05,4661,94,420929,90.28936078936079,7
0.05,4662,95,421024,90.29037100579026,6
0.05,4663,94,421118,90.29116638078902,7
0.05,4664,94,421212,90.29196141479099,7
0.05,4665,91,421303,90.29211315902272,10
0.05,4666,92,421395,90.29247910863509,9
0.05,4667,90,421485,90.29241645244215,11
0.05,4668,94,421579,90.29321053758835,7
0.05,4669,95,421674,90.29421841541756,6
0.05,4670,94,421768,90.29501177478056,8
0.05,4671,92,421860,90.29537671232876,9
0.05,4672,93,421953,90.29595548897925,8
0.05,4673,94,422047,90.29674796747967,7
0.05,4674,26,422073,90.28299465240642,7
0.05,4675,95,422168,90.28400342172797,6
0.05,4676,94,422262,90.28479794740218,7
0.05,4677,96,422358,90.28601966652415,6
0.05,4678,89,422447,90.28574481726865,12
0.05,4679,96,422543,90.28696581196581,6
0.05,4680,93,422636,90.28754539628285,8
0.05,4681,93,422729,90.28812473302008,8
0.05,4682,93,422822,90.2887038223361,8
0.05,4683,95,422917,90.28970964987191,8
0.05,4684,95,423012,90.29071504802562,6
0.05,4685,91,423103,90.29086641058473,10
0.05,4686,95,423198,90.29187113292085,6
0.05,4687,95,423293,90.29287542662117,7
0.05,4688,96,423389,90.29409255704842,6
0.05,4689,95,423484,90.2950959488273,6
0.05,4690,96,423580,90.29631208697506,6
0.05,4691,95,423675,90.29731457800511,7
0.05,4692,94,423769,90.29810355849138,7
0.05,4693,94,423863,90.2988922028121,8
0.05,4694,94,423957,90.2996805111821,8
0.05,4695,94,424051,90.30046848381602,8
0.05,4696,91,424142,90.30061741537152,10
0.05,4697,92,424234,90.3009791400596,9
0.05,4698,94,424328,90.30176633326239,7
0.05,4699,93,424421,90.30234042553191,8
0.05,4700,93,424514,90.30291427355881,8
0.05,4701,94,424608,90.30370055295619,7
0.05,4702,94,424702,90.30448649798001,7
0.05,4703,96,424798,90.30569727891157,6
0.05,4704,94,424892,90.30648246546228,8
0.05,4705,94,424986,90.30726731831705,8
0.05,4706,94,425080,90.30805183768855,7
0.05,4707,94,425174,90.3088360237893,7
0.05,4708,94,425268,90.3096198768316,7
0.05,4709,92,425360,90.3099787685775,9
0.05,4710,94,425454,90.31076204627468,7
0.05,4711,94,425548,90.31154499151104,7
0.05,4712,96,425644,90.31275196265648,6
0.05,4713,94,425738,90.31353415358507,7
0.05,4714,96,425834,90.31474019088017,6
0.05,4715,94,425928,90.31552162849873,7
0.05,4716,94,426022,90.31630273478906,7
0.05,4717,93,426115,90.31687155574396,8
0.05,4718,92,426207,90.31722822631913,9
0.05,4719,92,426299,90.31758474576272,9
0.05,4720,96,426395,90.31878839228978,6
0.05,4721,93,426488,90.31935620499789,8
0.05,4722,95,426583,90.32034723692568,6
0.05,4723,94,426677,90.32112616426757,7
0.05,4724,95,426772,90.32211640211641,6
0.05,4725,95,426867,90.32310622090563,7
0.05,4726,92,426959,90.32346096890205,9
0.05,4727,91,427050,90.32360406091371,10
0.05,4728,94,427144,90.32438147599916,7
0.05,4729,95,427239,90.32536997885835,6
0.05,4730,93,427332,90.32593532022828,8
0.05,4731,94,427426,90.32671174978867,7
0.05,4732,95,427521,90.32769913374182,6
0.05,4733,94,427615,90.3284748626954,8
0.05,4734,92,427707,90.32882787750792,9
0.05,4735,93,427800,90.32939189189189,8
0.05,4736,92,427892,90.32974456407008,9
0.05,4737,93,427985,90.33030814689742,8
0.05,4738,96,428081,90.33150453682211,6
0.05,4739,21,428102,90.3168776371308,11
0.05,4740,94,428196,90.31765450326935,7
0.05,4741,92,428288,90.31800927878533,9
0.05,4742,93,428381,90.31857474172465,8
0.05,4743,93,428474,90.31913996627318,10
0.05,4744,96,428570,90.32033719704953,6
0.05,4745,96,428666,90.32153392330383,6
0.05,4746,93,428759,90.32209816726353,8
0.05,4747,95,428854,90.32308340353833,6
0.05,4748,92,428946,90.3234365129501,9
0.05,4749,94,429040,90.3242105263158,7
0.05,4750,96,429136,90.32540517785729,6
0.05,4751,91,429227,90.32554713804714,10
0.05,4752,91,429318,90.325689038502,10
0.05,4753,92,429410,90.32604122843921,9
0.05,4754,95,429505,90.32702418506835,6
0.05,4755,94,429599,90.32779646761985,7
0.05,4756,94,429693,90.32856842547824,7
0.05,4757,95,429788,90.32955023118957,7
0.05,4758,93,429881,90.33011136793444,8
0.05,4759,95,429976,90.33109243697479,6
0.05,4760,92,430068,90.33144297416509,9
0.05,4761,91,430159,90.33158336833263,10
0.05,4762,91,430250,90.33172370354818,10
0.05,4763,94,430344,90.33249370277078,7
0.05,4764,94,430438,90.33326337880378,7
0.05,4765,96,430534,90.33445237096097,7
0.05,4766,94,430628,90.33522131319488,7
0.05,4767,96,430724,90.33640939597315,6
0.05,4768,96,430820,90.33759698049906,6
0.05,4769,94,430914,90.33836477987421,7
0.05,4770,94,431008,90.33913225738839,7
0.05,4771,95,431103,90.34010896898575,6
0.05,4772,96,431199,90.34129478315525,6
0.05,4773,95,431294,90.34227063259321,6
0.05,4774,94,431388,90.34303664921465,7
0.05,4775,93,431481,90.34359296482413,8
0.05,4776,95,431576,90.34456772032657,7
0.05,4777,94,431670,90.34533277521976,7
0.05,4778,93,431763,90.3458882611425,8
0.05,4779,91,431854,90.3460251046025,10
0.05,4780,94,431948,90.34678937460782,8
0.05,4781,90,432038,90.34671685487244,11
0.05,4782,94,432132,90.34748066067321,7
0.05,4783,96,432228,90.34866220735786,6
0.05,4784,91,432319,90.34879832810867,10
0.05,4785,93,432412,90.34935227747597,8
0.05,4786,93,432505,90.34990599540421,8
0.05,4787,95,432600,90.35087719298245,6
0.05,4788,94,432694,90.35163917310503,7
0.05,4789,-57,432637,90.32087682672234,20
0.05,4790,95,432732,90.32185347526612,7
0.05,4791,93,432825,90.32241235392321,8
0.05,4792,94,432919,90.32317963697058,7
0.05,4793,93,433012,90.32373800584064,9
0.05,4794,92,433104,90.32408759124088,9
0.05,4795,92,433196,90.32443703085904,9
0.05,4796,91,433287,90.32457786116322,10
0.05,4797,94,433381,90.32534389328887,7
0.05,4798,93,433474,90.3259012294228,8
0.05,4799,95,433569,90.326875,6
0.05,4800,95,433664,90.32784836492398,6
0.05,4801,94,433758,90.32861307788421,7
0.05,4802,91,433849,90.32875286279409,10
0.05,4803,96,433945,90.32993338884263,6
0.05,4804,95,434040,90.3309053069719,6
0.05,4805,94,434134,90.33166874739908,8
0.05,4806,94,434228,90.33243187018931,7
0.05,4807,95,434323,90.33340266222962,6
0.05,4808,93,434416,90.33395716365149,9
0.05,4809,95,434511,90.33492723492724,6
0.05,4810,96,434607,90.33610475992518,6
0.05,4811,91,434698,90.33624272651704,10
0.05,4812,94,434792,90.3370039476418,7
0.05,4813,89,434881,90.33672621520564,12
0.05,4814,94,434975,90.33748701973,7
0.05,4815,94,435069,90.33824750830564,7
0.05,4816,96,435165,90.33942287730953,6
0.05,4817,94,435259,90.34018264840182,7
0.05,4818,18,435277,90.32517119734385,14
0.05,4819,96,435373,90.32634854771784,6
0.05,4820,95,435468,90.32731798382079,6
0.05,4821,95,435563,90.32828701783492,6
0.05,4822,94,435657,90.32904831018038,7
0.05,4823,95,435752,90.33001658374793,6
0.05,4824,94,435846,90.33077720207254,7
0.05,4825,94,435940,90.33153750518028,7
0.05,4826,94,436034,90.33229749326703,8
0.05,4827,93,436127,90.33285004142502,8
0.05,4828,94,436221,90.33360944294886,7
0.05,4829,95,436316,90.33457556935818,7
0.05,4830,94,436410,90.33533429931691,7
0.05,4831,95,436505,90.33629966887418,6
0.05,4832,91,436596,90.33643699565488,10
0.05,4833,95,436691,90.33740173769135,7
0.05,4834,93,436784,90.33795243019648,8
0.05,4835,92,436876,90.33829611248966,9
0.05,4836,94,436970,90.33905313210668,7
0.05,4837,94,437064,90.33980983877635,7
0.05,4838,96,437160,90.34097954122753,6
0.05,4839,93,437253,90.34152892561984,8
0.05,4840,92,437345,90.34187151414997,9
0.05,4841,94,437439,90.34262701363073,7
0.05,4842,96,437535,90.34379516828412,6
0.05,4843,95,437630,90.34475639966969,7
0.05,4844,95,437725,90.34571723426212,6
0.05,4845,92,437817,90.34605860503508,9
0.05,4846,90,437907,90.34598720858263,11
0.05,4847,95,438002,90.34694719471948,6
0.05,4848,93,438095,90.34749432872758,8
0.05,4849,95,438190,90.34845360824742,6
0.05,4850,92,438282,90.34879406307978,9
0.05,4851,93,438375,90.34934047815334,9
0.05,4852,91,438466,90.34947455182362,10
0.05,4853,96,438562,90.35063864853728,6
0.05,4854,94,438656,90.3513903192585,7
0.05,4855,93,438749,90.35193574958814,8
0.05,4856,94,438843,90.3526868437307,7
0.05,4857,94,438937,90.35343762865377,7
0.05,4858,94,439031,90.35418810454826,7
0.05,4859,94,439125,90.35493827160494,7
0.05,4860,94,439219,90.3556881300144,8
0.05,4861,96,439315,90.35684903331962,6
0.05,4862,27,439342,90.34382068681883,6
0.05,4863,95,439437,90.34477796052632,8
0.05,4864,93,439530,90.34532374100719,8
0.05,4865,94,439624,90.34607480476778,7
0.05,4866,90,439714,90.34600369837682,12
0.05,4867,93,439807,90.34654889071487,8
0.05,4868,94,439901,90.34729924009036,7
0.05,4869,21,439922,90.33305954825462,11
0.05,4870,94,440016,90.33381235885855,7
0.05,4871,94,440110,90.33456486042692,7
0.05,4872,94,440204,90.33531705315,7
0.05,4873,21,440225,90.32109150594994,12
0.05,4874,93,440318,90.32164102564103,8
0.05,4875,93,440411,90.32219031993438,8
0.05,4876,96,440507,90.32335452122206,6
0.05,4877,91,440598,90.32349323493234,10
0.05,4878,94,440692,90.32424677187949,7
0.05,4879,94,440786,90.325,7
0.05,4880,94,440880,90.32575291948372,7
0.05,4881,93,440973,90.3263006964359,9
0.05,4882,92,441065,90.32664345689126,9
0.05,4883,94,441159,90.32739557739558,7
0.05,4884,94,441253,90.32814738996929,7
0.05,4885,92,441345,90.32848956201391,9
0.05,4886,96,441441,90.32965009208102,6
0.05,4887,94,441535,90.33040098199673,7
0.05,4888,96,441631,90.33156064634895,6
0.05,4889,94,441725,90.3323108384458,7
0.05,4890,94,441819,90.33306072377837,7
0.05,4891,93,441912,90.33360588716272,8
0.05,4892,95,442007,90.33455957490293,6
0.05,4893,96,442103,90.3357172047405,6
0.05,4894,90,442193,90.33564862104188,11
0.05,4895,94,442287,90.33639705882354,7
0.05,4896,95,442382,90.33734939759036,6
0.05,4897,91,442473,90.33748468762761,10
0.05,4898,96,442569,90.33864053888549,6
0.05,4899,95,442664,90.3395918367347,6
0.05,4900,94,442758,90.34033870638645,7
0.05,4901,93,442851,90.34088127294982,8
0.05,4902,94,442945,90.3416275749541,7
0.05,4903,94,443039,90.3423735725938,7
0.05,4904,93,443132,90.34291539245667,8
0.05,4905,94,443226,90.34366082348146,7
0.05,4906,95,443321,90.34460974118606,6
0.05,4907,88,443409,90.34413202933985,13
0.05,4908,96,443505,90.34528417192911,6
0.05,4909,25,443530,90.33197556008146,8
0.05,4910,92,443622,90.33231521075137,9
0.05,4911,94,443716,90.33306188925081,7
0.05,4912,95,443811,90.3340118054142,6
0.05,4913,93,443904,90.33455433455434,8
0.05,4914,94,443998,90.3353001017294,7
0.05,4915,95,444093,90.33624898291293,6
0.05,4916,94,444187,90.33699410209478,7
0.05,4917,96,444283,90.33814558763726,6
0.05,4918,94,444377,90.3388900182964,7
0.05,4919,94,444471,90.33963414634147,8
0.05,4920,92,444563,90.33997155049786,9
0.05,4921,90,444653,90.33990247866721,11
0.05,4922,94,444747,90.34064594759293,7
0.05,4923,94,444841,90.34138911454103,7
0.05,4924,95,444936,90.3423350253807,6
0.05,4925,96,445032,90.34348355663825,6
0.05,4926,94,445126,90.34422569514918,7
0.05,4927,95,445221,90.34517045454545,6
0.05,4928,95,445316,90.34611483059444,6
0.05,4929,93,445409,90.34665314401623,8
0.05,4930,93,445502,90.34719123909957,10
0.05,4931,94,445596,90.34793187347933,7
0.05,4932,91,445687,90.34806405838232,10
0.05,4933,96,445783,90.34920956627482,6
0.05,4934,94,445877,90.3499493414387,7
0.05,4935,93,445970,90.35048622366288,9
0.05,4936,95,446065,90.35142799270812,7
0.05,4937,94,446159,90.35216686917781,7
0.05,4938,94,446253,90.35290544644666,7
0.05,4939,95,446348,90.35384615384615,6
0.05,4940,96,446444,90.35498886865007,6
0.05,4941,96,446540,90.35613112100364,6
0.05,4942,95,446635,90.35707060489581,6
0.05,4943,92,446727,90.35740291262135,10
0.05,4944,96,446823,90.35854398382205,6
0.05,4945,96,446919,90.359684593611,6
0.05,4946,18,446937,90.34505761067314,14
0.05,4947,94,447031,90.34579628132579,7
0.05,4948,93,447124,90.34633259244292,8
0.05,4949,96,447220,90.34747474747475,6
0.05,4950,94,447314,90.3482124823268,7
0.05,4951,90,447404,90.3481421647819,12
0.05,4952,93,447497,90.34867756915001,8
0.05,4953,95,447592,90.34961647153816,6
0.05,4954,95,447687,90.35055499495459,6
0.05,4955,92,447779,90.35088781275222,9
0.05,4956,93,447872,90.35142223118822,8
0.05,4957,94,447966,90.35215812827754,7
0.05,4958,94,448060,90.35289372857432,7
0.05,4959,93,448153,90.35342741935484,8
0.05,4960,95,448248,90.35436403950817,6
0.05,4961,94,448342,90.35509875050383,7
0.05,4962,93,448435,90.3556316743905,8
0.05,4963,93,448528,90.35616438356165,8
0.05,4964,92,448620,90.35649546827794,9
0.05,4965,22,448642,90.34273056786145,10
0.05,4966,94,448736,90.34346688141736,7
0.05,4967,95,448831,90.34440418679549,7
0.05,4968,26,448857,90.331455021131,7
0.05,4969,95,448952,90.33239436619718,6
0.05,4970,96,449048,90.33353450010058,6
0.05,4971,96,449144,90.33467417538213,6
0.05,4972,96,449240,90.33581339231851,6
0.05,4973,93,449333,90.33634901487736,8
0.05,4974,96,449429,90.33748743718593,6
0.05,4975,90,449519,90.3374196141479,11
0.05,4976,96,449615,90.33855736387382,6
0.05,4977,92,449707,90.3388911209321,9
0.05,4978,93,449800,90.33942558746736,9
0.05,4979,93,449893,90.33995983935743,8
0.05,4980,94,449987,90.3406946396306,7
0.05,4981,94,450081,90.34142914492172,7
0.05,4982,95,450176,90.34236403772827,6
0.05,4983,94,450270,90.34309791332264,7
0.05,4984,94,450364,90.34383149448345,7
0.05,4985,92,450456,90.34416365824308,9
0.05,4986,94,450550,90.3448967315019,7
0.05,4987,94,450644,90.34562951082599,7
0.05,4988,96,450740,90.34676287833233,6
0.05,4989,95,450835,90.34769539078157,6
0.05,4990,94,450929,90.34842716890402,7
0.05,4991,92,451021,90.34875801282051,10
0.05,4992,94,451115,90.349489284999,7
0.05,4993,96,451211,90.35062074489387,6
0.05,4994,92,451303,90.35095095095095,9
0.05,4995,94,451397,90.35168134507606,7
0.05,4996,95,451492,90.35261156694017,6
0.05,4997,96,451588,90.35374149659864,6
0.05,4998,92,451680,90.35407081416284,9
0.05,4999,94,451774,90.3548,7
0.05,5000,96,451870,90.35592881423715,6
0.05,5001,94,451964,90.35665733706517,7
0.05,5002,92,452056,90.35698580851489,9
0.05,5003,92,452148,90.35731414868106,9
0.05,5004,92,452240,90.35764235764236,9
0.05,5005,93,452333,90.35817019576508,8
0.05,5006,91,452424,90.35829838226483,10
0.05,5007,94,452518,90.35902555910543,7
0.05,5008,94,452612,90.35975244559792,8
0.05,5009,94,452706,90.36047904191616,8
0.05,5010,94,452800,90.36120534823388,7
0.05,5011,94,452894,90.36193136472465,8
0.05,5012,96,452990,90.36305605425893,6
0.05,5013,92,453082,90.36338252891903,9
0.05,5014,95,453177,90.36430707876372,6
0.05,5015,91,453268,90.36443381180223,10
0.05,5016,93,453361,90.36495913892765,8
0.05,5017,95,453456,90.36588282184137,6
0.05,5018,93,453549,90.36640765092648,9
0.05,5019,94,453643,90.36713147410359,7
0.05,5020,94,453737,90.36785500896235,7
0.05,5021,90,453827,90.36778176025489,11
0.05,5022,93,453920,90.36830579335059,8
0.05,5023,92,454012,90.36863057324841,9
0.05,5024,96,454108,90.3697512437811,6
0.05,5025,96,454204,90.3708714683645,6
0.05,5026,90,454294,90.37079769246071,11
0.05,5027,95,454389,90.3717183770883,6
0.05,5028,94,454483,90.37243984887651,7
0.05,5029,94,454577,90.37316103379722,8
0.05,5030,93,454670,90.37368316438084,9
0.05,5031,95,454765,90.37460254372019,6
0.05,5032,94,454859,90.37532286906418,7
0.05,5033,94,454953,90.37604290822408,7
0.05,5034,95,455048,90.37696127110229,6
0.05,5035,96,455144,90.3780778395552,6
0.05,5036,92,455236,90.37839984117531,9
0.05,5037,93,455329,90.37892020643112,9
0.05,5038,93,455422,90.37944036515182,8
0.05,5039,94,455516,90.38015873015873,7
0.05,5040,93,455609,90.38067843681809,8
0.05,5041,91,455700,90.38080126933757,10
0.05,5042,95,455795,90.38171723180646,7
0.05,5043,26,455821,90.36895321173672,7
0.05,5044,96,455917,90.37006937561942,6
0.05,5045,96,456013,90.37118509710662,6
0.05,5046,95,456108,90.37210223895383,7
0.05,5047,95,456203,90.37301901743264,6
0.05,5048,93,456296,90.37353931471579,8
0.05,5049,94,456390,90.37425742574257,7
0.05,5050,93,456483,90.37477727182736,8
0.05,5051,93,456576,90.37529691211401,9
0.05,5052,94,456670,90.37601424896101,7
0.05,5053,94,456764,90.37673130193906,8
0.05,5054,92,456856,90.37705242334323,9
0.05,5055,95,456951,90.3779667721519,6
0.05,5056,96,457047,90.37907850504251,6
0.05,5057,92,457139,90.37939897192567,9
0.05,5058,92,457231,90.37971931211702,9
0.05,5059,27,457258,90.36719367588933,6
0.05,5060,94,457352,90.36791147994468,8
0.05,5061,91,457443,90.36803634926906,10
0.05,5062,95,457538,90.36895121469485,7
0.05,5063,94,457632,90.3696682464455,8
0.05,5064,94,457726,90.37038499506417,8
0.05,5065,96,457822,90.37149624950652,6
0.05,5066,25,457847,90.35859482928754,8
0.05,5067,94,457941,90.3593133385951,7
0.05,5068,95,458036,90.36022884198067,6
0.05,5069,94,458130,90.36094674556213,8
0.05,5070,94,458224,90.36166436600276,7
0.05,5071,93,458317,90.36218454258675,8
0.05,5072,92,458409,90.3625073920757,10
0.05,5073,92,458501,90.36283011430824,10
0.05,5074,94,458595,90.36354679802956,7
0.05,5075,94,458689,90.36426319936959,7
0.05,5076,91,458780,90.3643884183573,10
0.05,5077,96,458876,90.36549822764869,6
0.05,5078,96,458972,90.36660759992124,6
0.05,5079,94,459066,90.36732283464566,7
0.05,5080,93,459159,90.36784097618579,8
0.05,5081,91,459250,90.36796536796537,10
0.05,5082,96,459346,90.3690733818611,6
0.05,5083,96,459442,90.37018095987412,6
0.05,5084,93,459535,90.37069813176008,8
0.05,5085,89,459624,90.3704286276052,12
0.05,5086,91,459715,90.37055238844113,10
0.05,5087,92,459807,90.37087264150944,9
0.05,5088,93,459900,90.37138927097662,8
0.05,5089,95,459995,90.37229862475442,6
0.05,5090,94,460089,90.37301119622865,7
0.05,5091,96,460185,90.37411626080126,6
0.05,5092,93,460278,90.374631847634,8
0.05,5093,96,460374,90.37573616018845,6
0.05,5094,94,460468,90.37644749754661,7
0.05,5095,94,460562,90.37715855572998,8
0.05,5096,92,460654,90.37747694722385,9
0.05,5097,95,460749,90.37838367987446,6
0.05,5098,94,460843,90.37909393998824,7
0.05,5099,95,460938,90.38,6
0.05,5100,95,461033,90.38090570476378,6
0.05,5101,91,461124,90.38102704821638,10
0.05,5102,93,461217,90.38154027042916,8
0.05,5103,94,461311,90.38224921630093,7
0.05,5104,93,461404,90.38276199804113,8
0.05,5105,95,461499,90.38366627497062,7
0.05,5106,95,461594,90.38457019776777,6
0.05,5107,91,461685,90.38469068128425,11
0.05,5108,95,461780,90.38559404971619,6
0.05,5109,93,461873,90.38610567514677,8
0.05,5110,96,461969,90.38720406965369,6
0.05,5111,94,462063,90.38791079812206,7
0.05,5112,96,462159,90.38900840993546,6
0.05,5113,94,462253,90.38971450919045,7
0.05,5114,94,462347,90.39042033235582,7
0.05,5115,92,462439,90.39073494917905,9
0.05,5116,94,462533,90.39144029704906,7
0.05,5117,95,462628,90.39234075810863,7
0.05,5118,93,462721,90.39285016604805,8
0.05,5119,92,462813,90.3931640625,9
0.05,5120,94,462907,90.39386838508103,7
0.05,5121,94,463001,90.3945724326435,7
0.05,5122,95,463096,90.39547140347453,6
0.05,5123,95,463191,90.39637002341921,6
0.05,5124,96,463287,90.39746341463415,6
0.05,5125,96,463383,90.39855637924308,6
0.05,5126,95,463478,90.39945387165984,7
0.05,5127,95,463573,90.40035101404057,6
0.05,5128,95,463668,90.40124780658998,6
0.05,5129,92,463760,90.40155945419103,9
0.05,5130,94,463854,90.4022607678815,8
0.05,5131,95,463949,90.40315666406859,7
0.05,5132,96,464045,90.40424702902786,6
0.05,5133,93,464138,90.40475262952863,8
0.05,5134,94,464232,90.40545277507303,7
0.05,5135,94,464326,90.40615264797508,7
0.05,5136,95,464421,90.40704691454157,6
0.05,5137,95,464516,90.40794083300895,6
0.05,5138,93,464609,90.408445222806,9
0.05,5139,92,464701,90.40875486381323,9
0.05,5140,94,464795,90.40945341373273,7
0.05,5141,92,464887,90.40976273823415,9
0.05,5142,92,464979,90.41007194244604,9
0.05,5143,95,465074,90.41096423017107,7
0.05,5144,92,465166,90.41127308066083,9
0.05,5145,96,465262,90.41235911387486,6
0.05,5146,94,465356,90.41305614921313,7
0.05,5147,95,465451,90.41394716394717,6
0.05,5148,92,465543,90.41425519518353,9
0.05,5149,93,465636,90.41475728155339,8
0.05,5150,94,465730,90.41545331003688,7
0.05,5151,86,465816,90.41459627329192,15
0.05,5152,96,465912,90.41568018629924,6
0.05,5153,96,466008,90.41676367869616,6
0.05,5154,96,466104,90.41784675072745,6
0.05,5155,95,466199,90.41873545384018,7
0.05,5156,92,466291,90.41904207872794,9
0.05,5157,95,466386,90.419930205506,7
0.05,5158,96,466482,90.42101182399689,6
0.05,5159,94,466576,90.4217054263566,8
0.05,5160,93,466669,90.4222049990312,8
0.05,5161,95,466764,90.42309182487408,6
0.05,5162,96,466860,90.42417199302731,6
0.05,5163,94,466954,90.42486444616576,7
0.05,5164,96,467050,90.42594385285577,6
0.05,5165,94,467144,90.42663569492838,8
0.05,5166,92,467236,90.42694019740662,9
0.05,5167,96,467332,90.4280185758514,7
0.05,5168,93,467425,90.42851615399498,8
0.05,5169,91,467516,90.42862669245648,10
0.05,5170,94,467610,90.42931734674144,7
0.05,5171,94,467704,90.43000773395205,7
0.05,5172,93,467797,90.43050454281848,8
0.05,5173,95,467892,90.43138770776962,6
0.05,5174,94,467986,90.432077294686,7
0.05,5175,93,468079,90.43257341576506,9
0.05,5176,94,468173,90.43326250724358,7
0.05,5177,96,468269,90.43433758207802,6
0.05,5178,91,468360,90.4344468044024,10
0.05,5179,94,468454,90.43513513513514,7
0.05,5180,96,468550,90.43620922601815,6
0.05,5181,94,468644,90.43689695098418,7
0.05,5182,93,468737,90.4373914721204,8
0.05,5183,93,468830,90.43788580246914,8
0.05,5184,93,468923,90.43837994214078,8
0.05,5185,94,469017,90.43906671808716,7
0.05,5186,92,469109,90.43936764989397,9
0.05,5187,94,469203,90.44005397070161,7
0.05,5188,95,469298,90.44093274233957,7
0.05,5189,96,469394,90.44200385356454,6
0.05,5190,94,469488,90.4426892698902,7
0.05,5191,95,469583,90.44356702619415,7
0.05,5192,91,469674,90.44367417677643,11
0.05,5193,93,469767,90.4441663457836,8
0.05,5194,94,469861,90.44485081809432,7
0.05,5195,96,469957,90.44591993841416,6
0.05,5196,93,470050,90.44641139118723,8
0.05,5197,93,470143,90.44690265486726,8
0.05,5198,94,470237,90.44758607424505,7
0.05,5199,95,470332,90.44846153846154,6
0.05,5200,91,470423,90.44856758315709,10
0.05,5201,95,470518,90.44944252210688,7
0.05,5202,94,470612,90.4501249279262,7
0.05,5203,93,470705,90.45061491160645,8
0.05,5204,94,470799,90.45129682997118,8
0.05,5205,93,470892,90.45178640030734,8
0.05,5206,94,470986,90.45246783176493,7
0.05,5207,96,471082,90.45353302611367,6
0.05,5208,92,471174,90.45382990977154,9
0.05,5209,93,471267,90.45431861804222,8
0.05,5210,94,471361,90.45499904049127,7
0.05,5211,95,471456,90.45587106676899,8
0.05,5212,92,471548,90.4561672741224,9
0.05,5213,94,471642,90.45684695051784,7
0.05,5214,95,471737,90.45771812080537,7
0.05,5215,95,471832,90.45858895705521,6
0.05,5216,95,471927,90.45945945945945,6
0.05,5217,95,472022,90.46032962821005,7
0.05,5218,94,472116,90.46100785591109,7
0.05,5219,96,472212,90.46206896551725,6
0.05,5220,93,472305,90.46255506607929,8
0.05,5221,91,472396,90.46265798544619,10
0.05,5222,93,472489,90.46314378709553,8
0.05,5223,87,472576,90.4624808575804,14
0.05,5224,96,472672,90.46354066985646,6
0.05,5225,94,472766,90.46421737466514,7
0.05,5226,90,472856,90.46412856322938,11
0.05,5227,94,472950,90.46480489671002,7
0.05,5228,95,473045,90.46567221266017,6
0.05,5229,94,473139,90.46634799235181,7
0.05,5230,94,473233,90.46702351366851,7
0.05,5231,95,473328,90.46788990825688,6
0.05,5232,90,473418,90.46780049684693,11
0.05,5233,27,473445,90.45567443637754,6
0.05,5234,92,473537,90.45596943648519,9
0.05,5235,94,473631,90.4566462948816,7
0.05,5236,94,473725,90.4573228947871,7
0.05,5237,96,473821,90.45838106147384,6
0.05,5238,94,473915,90.4590570719603,7
0.05,5239,93,474008,90.45954198473282,8
0.05,5240,94,474102,90.46021751574128,7
0.05,5241,95,474197,90.4610835558947,6
0.05,5242,25,474222,90.44859813084112,7
0.05,5243,90,474312,90.44851258581235,11
0.05,5244,92,474404,90.44880838894186,10
0.05,5245,95,474499,90.44967594357605,6
0.05,5246,94,474593,90.45035258242805,7
0.05,5247,90,474683,90.45026676829268,11
0.05,5248,95,474778,90.45113354924747,6
0.05,5249,96,474874,90.45219047619048,6
0.05,5250,92,474966,90.4524852409065,9
0.05,5251,96,475062,90.45354150799696,6
0.05,5252,95,475157,90.45440700552065,6
0.05,5253,95,475252,90.45527217358203,7
0.05,5254,90,475342,90.45518553758325,12
0.05,5255,91,475433,90.45528919330289,11
0.05,5256,92,475525,90.45558303214762,9
0.05,5257,90,475615,90.45549638645873,11
0.05,5258,93,475708,90.45598022437726,8
0.05,5259,95,475803,90.45684410646388,7
0.05,5260,96,475899,90.4578977380726,6
0.05,5261,94,475993,90.45857088559482,8
0.05,5262,96,476089,90.45962378871366,6
0.05,5263,94,476183,90.46029635258358,7
0.05,5264,94,476277,90.46096866096866,7
0.05,5265,96,476373,90.46202050892518,6
0.05,5266,94,476467,90.4626922346687,7
0.05,5267,84,476551,90.46146545178436,17
0.05,5268,94,476645,90.46213702789903,7
0.05,5269,92,476737,90.46242884250475,9
0.05,5270,27,476764,90.45038892050844,6
0.05,5271,93,476857,90.45087253414265,8
0.05,5272,95,476952,90.45173525507302,6
0.05,5273,27,476979,90.43970420932878,6
0.05,5274,91,477070,90.43981042654029,10
0.05,5275,96,477166,90.44086429112964,6
0.05,5276,96,477262,90.44191775630092,6
0.05,5277,93,477355,90.44240242516105,8
0.05,5278,94,477449,90.44307634021595,8
0.05,5279,91,477540,90.44318181818181,10
0.05,5280,94,477634,90.44385533042984,7
0.05,5281,94,477728,90.4445285876562,7
0.05,5282,95,477823,90.44539087639599,6
0.05,5283,91,477914,90.44549583648751,10
0.05,5284,93,478007,90.44597918637653,8
0.05,5285,95,478102,90.4468407113129,6
0.05,5286,96,478198,90.44789105352751,6
0.05,5287,94,478292,90.44856278366112,7
0.05,5288,94,478386,90.44923425978446,8
0.05,5289,-44,478342,90.42381852551985,8
0.05,5290,96,478438,90.42487242487242,6
0.05,5291,92,478530,90.42517006802721,9
0.05,5292,92,478622,90.42546759871529,9
0.05,5293,94,478716,90.4261428031734,7
0.05,5294,89,478805,90.42587346553353,12
0.05,5295,94,478899,90.42654833836858,7
0.05,5296,93,478992,90.42703417028507,8
0.05,5297,93,479085,90.42751981879955,8
0.05,5298,93,479178,90.42800528401585,8
0.05,5299,95,479273,90.4288679245283,6
0.05,5300,94,479367,90.4295415959253,7
0.05,5301,96,479463,90.43059222934741,6
0.05,5302,95,479558,90.43145389402225,6
0.05,5303,93,479651,90.43193815987934,8
0.05,5304,92,479743,90.43223374175307,9
0.05,5305,93,479836,90.43271767810026,8
0.05,5306,94,479930,90.43338986244582,7
0.05,5307,94,480024,90.43406179351922,7
0.05,5308,95,480119,90.43492183085327,7
0.05,5309,93,480212,90.43540489642184,8
0.05,5310,93,480305,90.43588778007909,8
0.05,5311,93,480398,90.43637048192771,8
0.05,5312,94,480492,90.43704121964991,7
0.05,5313,91,480583,90.43714715844938,10
0.05,5314,93,480676,90.4376293508937,8
0.05,5315,96,480772,90.43867569601204,6
0.05,5316,96,480868,90.43972164754561,6
0.05,5317,91,480959,90.43982700263257,11
0.05,5318,94,481053,90.44049633389734,7
0.05,5319,93,481146,90.44097744360903,8
0.05,5320,95,481241,90.44183424168389,6
0.05,5321,90,481331,90.44175122134536,11
0.05,5322,94,481425,90.44241968814578,7
0.05,5323,96,481521,90.44346356123215,6
0.05,5324,94,481615,90.44413145539906,7
0.05,5325,91,481706,90.44423582425836,10
0.05,5326,94,481800,90.4449033226957,8
0.05,5327,95,481895,90.44575825825825,6
0.05,5328,89,481984,90.4454869581535,12
0.05,5329,94,482078,90.44615384615385,8
0.05,5330,95,482173,90.44700806602889,6
0.05,5331,95,482268,90.44786196549137,6
0.05,5332,95,482363,90.44871554472155,6
0.05,5333,93,482456,90.44919385076865,8
0.05,5334,95,482551,90.45004686035614,7
0.05,5335,95,482646,90.45089955022489,6
0.05,5336,94,482740,90.4515645493723,7
0.05,5337,96,482836,90.45260397152492,6
0.05,5338,94,482930,90.45326840232254,7
0.05,5339,94,483024,90.45393258426967,7
0.05,5340,95,483119,90.45478374836173,6
0.05,5341,94,483213,90.45544739797829,7
0.05,5342,92,483305,90.45573647763429,10
0.05,5343,94,483399,90.45639970059881,8
0.05,5344,94,483493,90.45706267539757,7
0.05,5345,95,483588,90.45791245791246,6
0.05,5346,95,483683,90.4587619225734,6
0.05,5347,95,483778,90.45961106955872,6
0.05,5348,92,483870,90.45989904655076,9
0.05,5349,96,483966,90.46093457943925,6
0.05,5350,96,484062,90.46196972528499,6
0.05,5351,94,484156,90.4626307922272,7
0.05,5352,95,484251,90.46347842331403,7
0.05,5353,96,484347,90.46451251400822,6
0.05,5354,94,484441,90.46517273576097,7
0.05,5355,94,484535,90.46583271097835,7
0.05,5356,94,484629,90.4664924397984,7
0.05,5357,95,484724,90.46733855916386,6
0.05,5358,92,484816,90.4676245568203,9
0.05,5359,89,484905,90.46735074626865,12
0.05,5360,92,484997,90.46763663495616,9
0.05,5361,94,485091,90.46829541215965,7
0.05,5362,95,485186,90.4691404064889,6
0.05,5363,94,485280,90.46979865771812,8
0.05,5364,92,485372,90.47008387698042,9
0.05,5365,96,485468,90.47111442415206,6
0.05,5366,93,485561,90.47158561580027,8
0.05,5367,93,485654,90.4720566318927,8
0.05,5368,96,485750,90.4730862357981,6
0.05,5369,93,485843,90.47355679702048,10
0.05,5370,26,485869,90.46155278346677,6
0.05,5371,93,485962,90.4620253164557,8
0.05,5372,94,486056,90.46268378931696,7
0.05,5373,25,486081,90.45050241905471,8
0.05,5374,92,486173,90.45079069767442,9
0.05,5375,96,486269,90.45182291666667,6
0.05,5376,90,486359,90.45173888785568,11
0.05,5377,94,486453,90.45239866121234,7
0.05,5378,94,486547,90.4530581892545,7
0.05,5379,91,486638,90.45315985130111,10
0.05,5380,93,486731,90.45363315368891,9
0.05,5381,96,486827,90.45466369379413,6
0.05,5382,94,486921,90.45532231097901,7
0.05,5383,94,487015,90.45598068350668,7
0.05,5384,95,487110,90.45682451253482,6
0.05,5385,96,487206,90.4578536947642,6
0.05,5386,94,487300,90.45851123074067,7
0.05,5387,94,487394,90.45916852264291,7
0.05,5388,94,487488,90.4598255706068,7
0.05,5389,96,487584,90.46085343228201,6
0.05,5390,94,487678,90.46150992394732,7
0.05,5391,94,487772,90.46216617210682,7
0.05,5392,93,487865,90.46263675134433,8
0.05,5393,92,487957,90.46292176492399,10
0.05,5394,93,488050,90.46339202965709,8
0.05,5395,95,488145,90.46423276501112,6
0.05,5396,94,488239,90.46488790068557,7
0.05,5397,94,488333,90.46554279362726,7
0.05,5398,89,488422,90.46527134654566,12
0.05,5399,95,488517,90.4661111111111,6
0.05,5400,94,488611,90.46676541381225,7
0.05,5401,93,488704,90.46723435764531,8
0.05,5402,94,488798,90.46788821025356,7
0.05,5403,94,488892,90.46854182087343,7
0.05,5404,95,488987,90.46938020351526,7
0.05,5405,94,489081,90.4700332963374,7
0.05,5406,95,489176,90.47087109302755,6
0.05,5407,95,489271,90.47170857988165,6
0.05,5408,94,489365,90.47236088001479,7
0.05,5409,26,489391,90.46044362292052,6
0.05,5410,96,489487,90.46146738126039,6
0.05,5411,93,489580,90.4619364375462,8
0.05,5412,95,489675,90.46277480140402,6
0.05,5413,94,489769,90.4634281492427,7
0.05,5414,96,489865,90.46445060018468,6
0.05,5415,92,489957,90.4647341211226,10
0.05,5416,94,490051,90.46538674543105,7
0.05,5417,94,490145,90.46603912882982,8
0.05,5418,95,490240,90.46687580734452,6
0.05,5419,89,490329,90.46660516605166,13
0.05,5420,94,490423,90.46725696365984,7
0.05,5421,95,490518,90.46809295462928,6
0.05,5422,94,490612,90.46874423750691,7
0.05,5423,95,490707,90.46957964601769,7
0.05,5424,94,490801,90.47023041474654,7
0.05,5425,94,490895,90.47088094360487,7
0.05,5426,93,490988,90.47134696885941,8
0.05,5427,88,491076,90.47089167280767,14
0.05,5428,94,491170,90.47154172039049,7
0.05,5429,96,491266,90.47255985267034,6
0.05,5430,93,491359,90.47302522555698,8
0.05,5431,94,491453,90.47367452135494,7
0.05,5432,95,491548,90.47450763850543,6
0.05,5433,96,491644,90.47552447552448,6
0.05,5434,95,491739,90.47635694572217,6
0.05,5435,96,491835,90.47737306843267,6
0.05,5436,94,491929,90.47802096744529,7
0.05,5437,94,492023,90.47866862817212,7
0.05,5438,96,492119,90.47968376539805,6
0.05,5439,93,492212,90.48014705882353,8
0.05,5440,93,492305,90.48061018195185,9
0.05,5441,93,492398,90.48107313487688,8
0.05,5442,94,492492,90.48171963990447,7
0.05,5443,93,492585,90.48218221895665,8
0.05,5444,94,492679,90.48282828282828,7
0.05,5445,93,492772,90.48329048843188,8
0.05,5446,94,492866,90.48393611162108,8
0.05,5447,92,492958,90.48421439060206,10
0.05,5448,94,493052,90.48485960726738,7
0.05,5449,92,493144,90.4851376146789,10
0.05,5450,95,493239,90.48596587782059,8
0.05,5451,94,493333,90.48661041819516,8
0.05,5452,96,493429,90.48762149275628,6
0.05,5453,95,493524,90.48844884488449,6
0.05,5454,93,493617,90.48890925756187,8
0.05,5455,90,493707,90.48881964809384,11
0.05,5456,94,493801,90.48946307494961,7
0.05,5457,92,493893,90.48973983144009,9
0.05,5458,94,493987,90.49038285400256,7
0.05,5459,90,494077,90.49029304029304,11
0.05,5460,94,494171,90.4909357260575,7
0.05,5461,94,494265,90.49157817649213,7
0.05,5462,93,494358,90.49203734211972,8
0.05,5463,93,494451,90.49249633967788,8
0.05,5464,94,494545,90.49313815187557,8
0.05,5465,94,494639,90.49377972923527,7
0.05,5466,95,494734,90.49460398756173,6
0.05,5467,93,494827,90.49506217995611,9
0.05,5468,94,494921,90.49570305357469,7
0.05,5469,93,495014,90.49616087751372,8
0.05,5470,94,495108,90.49680131602997,7
0.05,5471,93,495201,90.49725877192982,8
0.05,5472,92,495293,90.49753334551434,10
0.05,5473,94,495387,90.4981731823164,7
0.05,5474,94,495481,90.49881278538813,7
0.05,5475,94,495575,90.49945215485756,8
0.05,5476,93,495668,90.49990870914735,8
0.05,5477,94,495762,90.50054764512596,7
0.05,5478,94,495856,90.5011863478737,7
0.05,5479,94,495950,90.50182481751825,7
0.05,5480,88,496038,90.50136836343732,13
0.05,5481,94,496132,90.50200656694636,7
0.05,5482,95,496227,90.50282691956959,6
0.05,5483,94,496321,90.50346462436178,7
0.05,5484,94,496415,90.50410209662716,7
0.05,5485,90,496505,90.50401020780167,11
0.05,5486,94,496599,90.50464734827774,7
0.05,5487,94,496693,90.50528425655976,7
0.05,5488,93,496786,90.50573875022774,8
0.05,5489,94,496880,90.5063752276867,7
0.05,5490,94,496974,90.50701147331998,8
0.05,5491,96,497070,90.50801165331391,6
0.05,5492,94,497164,90.5086473693792,7
0.05,5493,93,497257,90.50910083727703,8
0.05,5494,96,497353,90.51010009099181,6
0.05,5495,94,497447,90.51073508005823,7
0.05,5496,94,497541,90.5113698380935,7
0.05,5497,93,497634,90.51182248090214,8
0.05,5498,94,497728,90.51245681032916,7
0.05,5499,89,497817,90.51218181818182,12
0.05,5500,95,497912,90.51299763679332,7
0.05,5501,96,498008,90.51399491094148,6
0.05,5502,94,498102,90.51462838451754,7
0.05,5503,94,498196,90.51526162790698,7
0.05,5504,95,498291,90.51607629427792,6
0.05,5505,94,498385,90.51670904467854,7
0.05,5506,93,498478,90.51715997820955,8
0.05,5507,94,498572,90.51779230210603,7
0.05,5508,94,498666,90.51842439644219,7
0.05,5509,96,498762,90.51941923774955,6
0.05,5510,92,498854,90.5196878969334,10
0.05,5511,94,498948,90.52031930333817,8
0.05,5512,93,499041,90.52076909123889,8
0.05,5513,92,499133,90.52103735944867,9
0.05,5514,95,499228,90.52184950135992,6
0.05,5515,94,499322,90.52248005801306,7
0.05,5516,95,499417,90.52329164400942,6
0.05,5517,93,499510,90.52374048568322,8
0.05,5518,91,499601,90.52382678021381,11
0.05,5519,96,499697,90.52481884057971,6
0.05,5520,94,499791,90.52544828835356,7
0.05,5521,94,499885,90.52607750814923,8
0.05,5522,94,499979,90.52670650009053,8
0.05,5523,96,500075,90.52769732078204,6
0.05,5524,92,500167,90.52796380090497,9
0.05,5525,95,500262,90.52877307274701,7
0.05,5526,94,500356,90.52940112176587,7
0.05,5527,94,500450,90.53002894356005,7
0.05,5528,96,500546,90.53101826731778,6
0.05,5529,94,500640,90.53164556962025,8
0.05,5530,94,500734,90.5322726450913,7
0.05,5531,93,500827,90.53271872740419,8
0.05,5532,94,500921,90.53334538225194,7
0.05,5533,93,501014,90.53379110950488,8
0.05,5534,96,501110,90.53477868112014,6
0.05,5535,96,501206,90.53576589595376,6
0.05,5536,94,501300,90.53639154776955,7
0.05,5537,91,501391,90.53647526182738,10
0.05,5538,93,501484,90.53692002166456,8
0.05,5539,95,501579,90.53772563176895,6
0.05,5540,94,501673,90.53835047825302,7
0.05,5541,93,501766,90.53879465896789,8
0.05,5542,96,501862,90.53977990257982,6
0.05,5543,96,501958,90.5407647907648,6
0.05,5544,96,502054,90.54174932371505,6
0.05,5545,93,502147,90.5421925712225,8
0.05,5546,89,502236,90.54191454840455,12
0.05,5547,93,502329,90.54235760634462,8
0.05,5548,94,502423,90.54298071724635,7
0.05,5549,94,502517,90.5436036036036,7
0.05,5550,96,502613,90.54458656098001,6
0.05,5551,94,502707,90.54520893371757,7
0.05,5552,95,502802,90.54601116513597,6
0.05,5553,94,502896,90.54663305725603,7
0.05,5554,95,502991,90.54743474347434,6
0.05,5555,94,503085,90.54805615550755,7
0.05,5556,96,503181,90.54903725031492,6
0.05,5557,95,503276,90.54983807124864,6
0.05,5558,94,503370,90.55045871559633,7
0.05,5559,96,503466,90.55143884892087,6
0.05,5560,93,503559,90.55187915842474,8
0.05,5561,94,503653,90.55249910104278,7
0.05,5562,91,503744,90.55257954341182,10
0.05,5563,96,503840,90.55355859094176,6
0.05,5564,95,503935,90.55435759209344,6
0.05,5565,96,504031,90.55533596837945,6
0.05,5566,95,504126,90.55613436321178,7
0.05,5567,94,504220,90.55675287356321,7
0.05,5568,94,504314,90.55737116178847,7
0.05,5569,96,504410,90.55834829443447,6
0.05,5570,94,504504,90.5589660743134,7
0.05,5571,94,504598,90.55958363244795,7
0.05,5572,96,504694,90.56055984209581,6
0.05,5573,93,504787,90.56099748833871,8
0.05,5574,93,504880,90.56143497757847,8
0.05,5575,92,504972,90.56169296987088,9
0.05,5576,93,505065,90.56213017751479,9
0.05,5577,94,505159,90.56274650412334,7
0.05,5578,96,505255,90.56372109697078,6
0.05,5579,92,505347,90.56397849462365,9
0.05,5580,96,505443,90.56495251746999,6
0.05,5581,94,505537,90.56556789681117,7
0.05,5582,92,505629,90.56582482536271,9
0.05,5583,93,505722,90.56626074498567,8
0.05,5584,94,505816,90.56687555953447,7
0.05,5585,94,505910,90.56749015395631,7
0.05,5586,96,506006,90.56846250223734,6
0.05,5587,93,506099,90.56889763779527,8
0.05,5588,94,506193,90.56951154052604,7
0.05,5589,96,506289,90.57048300536673,6
0.05,5590,94,506383,90.57109640493651,7
0.05,5591,94,506477,90.5717095851216,7
0.05,5592,91,506568,90.57178616127302,10
0.05,5593,94,506662,90.57239899892743,7
0.05,5594,92,506754,90.57265415549598,10
0.05,5595,27,506781,90.56129378127234,6
0.05,5596,93,506874,90.56172949794532,8
0.05,5597,96,506970,90.56270096463022,6
0.05,5598,95,507065,90.56349348097875,7
0.05,5599,94,507159,90.56410714285714,8
0.05,5600,93,507252,90.56454204606321,8
0.05,5601,95,507347,90.5653338093538,6
0.05,5602,92,507439,90.56558986257362,10
0.05,5603,93,507532,90.56602426837973,8
0.05,5604,95,507627,90.56681534344335,6
0.05,5605,93,507720,90.56724937566892,8
0.05,5606,94,507814,90.56786160156946,7
0.05,5607,92,507906,90.56811697574894,9
0.05,5608,95,508001,90.56890711356748,6
0.05,5609,95,508096,90.56969696969696,6
0.05,5610,95,508191,90.570486544288,6
0.05,5611,94,508285,90.57109764789736,7
0.05,5612,92,508377,90.5713522180652,9
0.05,5613,96,508473,90.57231920199501,6
0.05,5614,92,508565,90.57257346393588,11
0.05,5615,94,508659,90.57318376068376,7
0.05,5616,93,508752,90.5736158091508,8
0.05,5617,92,508844,90.57386970452119,9
0.05,5618,94,508938,90.57447944474106,7
0.05,5619,95,509033,90.5752669039146,6
0.05,5620,96,509129,90.5762319871909,6
0.05,5621,93,509222,90.5766631092138,8
0.05,5622,96,509318,90.57762760092477,6
0.05,5623,93,509411,90.57805832147938,8
0.05,5624,92,509503,90.5783111111111,9
0.05,5625,89,509592,90.5780305723427,12
0.05,5626,93,509685,90.57846099164742,9
0.05,5627,92,509777,90.57871357498223,9
0.05,5628,95,509872,90.57949902291703,7
0.05,5629,96,509968,90.58046181172291,6
0.05,5630,94,510062,90.58106908186824,7
0.05,5631,95,510157,90.58185369318181,7
0.05,5632,96,510253,90.58281555121604,6
0.05,5633,95,510348,90.58359957401491,6
0.05,5634,93,510441,90.58402839396628,8
0.05,5635,94,510535,90.5846344925479,7
0.05,5636,94,510629,90.58524037608657,7
0.05,5637,95,510724,90.58602341255765,6
0.05,5638,95,510819,90.58680617130697,6
0.05,5639,94,510913,90.58741134751773,7
0.05,5640,95,511008,90.5881935826981,6
0.05,5641,95,511103,90.58897554058845,7
0.05,5642,94,511197,90.58958001063264,7
0.05,5643,95,511292,90.59036144578313,6
0.05,5644,94,511386,90.59096545615589,7
0.05,5645,90,511476,90.59086078639744,11
0.05,5646,92,511568,90.59111032406588,9
0.05,5647,92,511660,90.59135977337111,9
0.05,5648,92,511752,90.59160913436007,9
0.05,5649,93,511845,90.5920353982301,8
0.05,5650,94,511939,90.59263847106706,8
0.05,5651,94,512033,90.59324133050248,7
0.05,5652,95,512128,90.59402087387228,6
0.05,5653,95,512223,90.59480014149275,7
0.05,5654,94,512317,90.59540229885057,7
0.05,5655,95,512412,90.5961810466761,6
0.05,5656,93,512505,90.59660597489835,8
0.05,5657,93,512598,90.59703075291623,8
0.05,5658,96,512694,90.59798550980739,6
0.05,5659,94,512788,90.59858657243817,7
0.05,5660,95,512883,90.5993640699523,7
0.05,5661,94,512977,90.59996467679265,7
0.05,5662,96,513073,90.6009182412149,6
0.05,5663,88,513161,90.60045903954803,13
0.05,5664,95,513256,90.60123565754634,6
0.05,5665,90,513346,90.60112954465231,11
0.05,5666,94,513440,90.60172931004058,7
0.05,5667,87,513527,90.60109386026818,14
0.05,5668,91,513618,90.60116422649497,10
0.05,5669,95,513713,90.60194003527337,7
0.05,5670,94,513807,90.60253923470287,7
0.05,5671,96,513903,90.60349083215797,6
0.05,5672,91,513994,90.60356072624714,10
0.05,5673,96,514090,90.60451180824815,6
0.05,5674,95,514185,90.60528634361233,6
0.05,5675,91,514276,90.60535588442565,11
0.05,5676,93,514369,90.60577769948917,9
0.05,5677,91,514460,90.60584712927087,10
0.05,5678,96,514556,90.60679697129777,6
0.05,5679,94,514650,90.60739436619718,7
0.05,5680,91,514741,90.60746347474036,10
0.05,5681,94,514835,90.60806054206266,7
0.05,5682,94,514929,90.60865739926095,7
0.05,5683,94,515023,90.60925404644617,7
0.05,5684,90,515113,90.60914687774846,11
0.05,5685,93,515206,90.6095673584242,8
0.05,5686,96,515302,90.61051521012837,6
0.05,5687,94,515396,90.61111111111111,7
0.05,5688,91,515487,90.611179469151,10
0.05,5689,92,515579,90.61142355008788,9
0.05,5690,93,515672,90.61184326128975,8
0.05,5691,95,515767,90.61261419536191,6
0.05,5692,94,515861,90.61320920428597,7
0.05,5693,93,515954,90.61362838075166,8
0.05,5694,96,516050,90.6145741878841,6
0.05,5695,93,516143,90.61499297752809,8
0.05,5696,96,516239,90.61593821309461,6
0.05,5697,94,516333,90.61653211653211,7
0.05,5698,92,516425,90.6167748727847,9
0.05,5699,95,516520,90.61754385964912,6
0.05,5700,92,516612,90.61778635327136,9
0.05,5701,93,516705,90.61820413889863,8
0.05,5702,95,516800,90.61897247062949,6
0.05,5703,94,516894,90.6195652173913,7
0.05,5704,95,516989,90.62033304119194,6
0.05,5705,91,517080,90.62039957939011,10
0.05,5706,94,517174,90.62099176449973,7
0.05,5707,93,517267,90.62140854940435,8
0.05,5708,96,517363,90.62235067437379,6
0.05,5709,94,517457,90.622942206655,7
0.05,5710,96,517553,90.62388373314656,6
0.05,5711,94,517647,90.62447478991596,8
0.05,5712,94,517741,90.62506563976895,7
0.05,5713,96,517837,90.62600630031501,6
0.05,5714,94,517931,90.62659667541557,7
0.05,5715,88,518019,90.62613715885234,13
0.05,5716,94,518113,90.62672730453035,7
0.05,5717,90,518203,90.62661769849598,11
0.05,5718,96,518299,90.62755726525616,6
0.05,5719,94,518393,90.62814685314686,7
0.05,5720,94,518487,90.62873623492396,7
0.05,5721,93,518580,90.62915064662705,8
0.05,5722,95,518675,90.62991438056963,6
0.05,5723,96,518771,90.63085255066387,6
0.05,5724,96,518867,90.6317903930131,6
0.05,5725,95,518962,90.6325532658051,6
0.05,5726,96,519058,90.63349048367382,6
0.05,5727,95,519153,90.63425279329608,6
0.05,5728,94,519247,90.63484028626287,7
0.05,5729,95,519342,90.63560209424084,6
0.05,5730,92,519434,90.63584016751004,9
0.05,5731,95,519529,90.63660153524076,7
0.05,5732,92,519621,90.63683935112506,9
0.05,5733,96,519717,90.6377746773631,6
0.05,5734,91,519808,90.63783783783784,10
0.05,5735,96,519904,90.63877266387726,6
0.05,5736,96,520000,90.63970716402301,6
0.05,5737,91,520091,90.63976995468805,10
0.05,5738,95,520186,90.64052970900853,6
0.05,5739,95,520281,90.64128919860627,7
0.05,5740,95,520376,90.64204842361958,6
0.05,5741,94,520470,90.64263322884013,7
0.05,5742,93,520563,90.64304370538046,8
0.05,5743,96,520659,90.64397632311977,6
0.05,5744,96,520755,90.64490861618799,6
0.05,5745,23,520778,90.63313609467455,9
0.05,5746,94,520872,90.63372194188273,7
0.05,5747,91,520963,90.63378566457898,10
0.05,5748,90,521053,90.63367542181248,11
0.05,5749,94,521147,90.63426086956521,7
0.05,5750,21,521168,90.62215266910103,11
0.05,5751,93,521261,90.62256606397774,9
0.05,5752,95,521356,90.62332695984703,8
0.05,5753,94,521450,90.62391379909629,7
0.05,5754,23,521473,90.61216333622937,9
0.05,5755,92,521565,90.61240444753301,9
0.05,5756,94,521659,90.61299287823519,7
0.05,5757,92,521751,90.61323376172282,9
0.05,5758,95,521846,90.61399548532731,7
0.05,5759,95,521941,90.61475694444445,6
0.05,5760,94,522035,90.61534455823642,7
0.05,5761,94,522129,90.61593196806665,7
0.05,5762,96,522225,90.61686621551276,6
0.05,5763,92,522317,90.61710617626647,9
0.05,5764,91,522408,90.61717259323504,11
0.05,5765,94,522502,90.6177592785293,8
0.05,5766,92,522594,90.61799895959771,9
0.05,5767,92,522686,90.61823855755894,9
0.05,5768,94,522780,90.61882475299012,7
0.05,5769,95,522875,90.61958405545927,7
0.05,5770,90,522965,90.6194766938139,11
0.05,5771,94,523059,90.62006237006237,7
0.05,5772,94,523153,90.62064784340897,7
0.05,5773,96,523249,90.62157949428473,6
0.05,5774,94,523343,90.62216450216451,7
0.05,5775,93,523436,90.62257617728532,8
0.05,5776,94,523530,90.62316081010906,7
0.05,5777,95,523625,90.6239183108342,6
0.05,5778,92,523717,90.62415642844783,9
0.05,5779,94,523811,90.62474048442907,7
0.05,5780,94,523905,90.62532433834977,7
0.05,5781,96,524001,90.62625389138707,6
0.05,5782,94,524095,90.6268372816877,7
0.05,5783,95,524190,90.62759336099585,6
0.05,5784,94,524284,90.62817631806396,8
0.05,5785,94,524378,90.628759073626,8
0.05,5786,93,524471,90.62916882668048,8
0.05,5787,95,524566,90.62992398064962,6
0.05,5788,26,524592,90.61875971670409,6
0.05,5789,93,524685,90.61917098445596,8
0.05,5790,95,524780,90.61992747366604,7
0.05,5791,95,524875,90.62068370165746,6
0.05,5792,93,524968,90.6210944243052,8
0.05,5793,-47,524921,90.59734207801174,11
0.05,5794,91,525012,90.59741156169112,10
0.05,5795,95,525107,90.59817115251897,7
0.05,5796,92,525199,90.59841297222701,9
0.05,5797,91,525290,90.59848223525354,10
0.05,5798,95,525385,90.59924124849113,7
0.05,5799,96,525481,90.6001724137931,6
0.05,5800,94,525575,90.60075848991553,7
0.05,5801,94,525669,90.6013443640124,7
0.05,5802,92,525761,90.60158538686886,9
0.05,5803,92,525853,90.60182632667126,9
0.05,5804,93,525946,90.60223944875108,8
0.05,5805,94,526040,90.60282466414054,7
0.05,5806,88,526128,90.6023764422249,13
0.05,5807,94,526222,90.60296143250689,7
0.05,5808,93,526315,90.60337407471165,8
0.05,5809,95,526410,90.60413080895009,6
0.05,5810,94,526504,90.60471519531922,7
0.05,5811,90,526594,90.60461114934618,11
0.05,5812,96,526690,90.60553930844658,6
0.05,5813,93,526783,90.60595115239079,8
0.05,5814,95,526878,90.6067067927773,6
0.05,5815,96,526974,90.6076341127923,6
0.05,5816,92,527066,90.60787347429947,9
0.05,5817,94,527160,90.60845651426607,7
0.05,5818,91,527251,90.60852380134044,10
0.05,5819,94,527345,90.60910652920963,7
0.05,5820,94,527439,90.60968905686308,7
0.05,5821,94,527533,90.61027138440399,7
0.05,5822,96,527629,90.611196977503,6
0.05,5823,94,527723,90.61177884615384,7
0.05,5824,92,527815,90.61201716738198,9
0.05,5825,87,527902,90.61139718503262,14
0.05,5826,94,527996,90.61197871975287,7
0.05,5827,85,528081,90.61101578586135,16
0.05,5828,93,528174,90.61142563046835,8
0.05,5829,95,528269,90.61217838765009,6
0.05,5830,92,528361,90.61241639512949,9
0.05,5831,90,528451,90.61231138545953,11
0.05,5832,96,528547,90.6132350420024,6
0.05,5833,96,528643,90.61415838189922,6
0.05,5834,94,528737,90.61473864610112,8
0.05,5835,96,528833,90.61566141192597,6
0.05,5836,92,528925,90.61589857803666,9
0.05,5837,96,529021,90.61682082905105,6
0.05,5838,96,529117,90.61774276417195,6
0.05,5839,93,529210,90.6181506849315,9
0.05,5840,94,529304,90.61872966957712,7
0.05,5841,95,529399,90.61947963026361,6
0.05,5842,93,529492,90.61988704432655,8
0.05,5843,94,529586,90.62046543463381,7
0.05,5844,94,529680,90.62104362703165,7
0.05,5845,94,529774,90.62162162162163,7
0.05,5846,94,529868,90.62219941850522,7
0.05,5847,94,529962,90.62277701778386,8
0.05,5848,92,530054,90.62301248076594,9
0.05,5849,96,530150,90.62393162393163,6
0.05,5850,94,530244,90.62450863100325,7
0.05,5851,95,530339,90.62525632262475,6
0.05,5852,95,530434,90.6260037587562,6
0.05,5853,92,530526,90.62623846942262,9
0.05,5854,93,530619,90.6266438941076,8
0.05,5855,94,530713,90.6272199453552,7
0.05,5856,93,530806,90.62762506402595,8
0.05,5857,93,530899,90.62803004438375,8
0.05,5858,94,530993,90.62860556408944,9
0.05,5859,94,531087,90.62918088737202,7
0.05,5860,93,531180,90.62958539498379,9
0.05,5861,94,531274,90.63016035482771,7
0.05,5862,91,531365,90.63022343510148,10
0.05,5863,94,531459,90.63079809004093,7
0.05,5864,92,531551,90.631031543052,9
0.05,5865,95,531646,90.63177633822025,7
0.05,5866,95,531741,90.63252087949549,6
0.05,5867,94,531835,90.63309475119291,7
0.05,5868,95,531930,90.63383881410803,6
0.05,5869,94,532024,90.63441226575809,7
0.05,5870,95,532119,90.63515585079203,6
0.05,5871,95,532214,90.6358991825613,6
0.05,5872,95,532309,90.6366422611953,6
0.05,5873,91,532400,90.6367041198502,11
0.05,5874,27,532427,90.62587234042553,6
0.05,5875,94,532521,90.62644656228727,7
0.05,5876,96,532617,90.62736089841756,6
0.05,5877,94,532711,90.62793467165703,7
0.05,5878,94,532805,90.62850824970234,7
0.05,5879,96,532901,90.62942176870749,6
0.05,5880,94,532995,90.62999489882672,7
0.05,5881,94,533089,90.63056783407005,7
0.05,5882,92,533181,90.63080061193268,9
0.05,5883,91,533272,90.63086335825969,10
0.05,5884,94,533366,90.63143585386577,7
0.05,5885,96,533462,90.63234794427456,6
0.05,5886,91,533553,90.63241039578733,10
0.05,5887,94,533647,90.63298233695652,7
0.05,5888,93,533740,90.63338427576838,8
0.05,5889,96,533836,90.63429541595926,6
0.05,5890,93,533929,90.63469699541673,8
0.05,5891,89,534018,90.63441955193483,12
0.05,5892,92,534110,90.63465128118106,9
0.05,5893,93,534203,90.6350525958602,9
0.05,5894,95,534298,90.63579304495335,6
0.05,5895,94,534392,90.63636363636364,7
0.05,5896,93,534485,90.6367644565033,8
0.05,5897,95,534580,90.63750423872499,6
0.05,5898,96,534676,90.6384132903882,6
0.05,5899,95,534771,90.63915254237288,6
0.05,5900,89,534860,90.63887476698865,13
0.05,5901,94,534954,90.63944425618435,7
0.05,5902,93,535047,90.63984414704387,8
0.05,5903,94,535141,90.64041327913279,7
0.05,5904,94,535235,90.64098221845893,7
0.05,5905,91,535326,90.6410430071114,10
0.05,5906,96,535422,90.64195022854241,6
0.05,5907,87,535509,90.64133378469872,14
0.05,5908,27,535536,90.6305635471315,6
0.05,5909,90,535626,90.63045685279188,11
0.05,5910,93,535719,90.63085772288953,8
0.05,5911,95,535814,90.63159675236807,6
0.05,5912,96,535910,90.63250465076949,6
0.05,5913,92,536002,90.63273588096044,9
0.05,5914,93,536095,90.63313609467455,8
0.05,5915,96,536191,90.6340432724814,6
0.05,5916,93,536284,90.63444312996451,8
0.05,5917,95,536379,90.63518080432578,7
0.05,5918,92,536471,90.63541138705862,9
0.05,5919,94,536565,90.63597972972973,7
0.05,5920,92,536657,90.63621009964533,9
0.05,5921,96,536753,90.63711583924349,6
0.05,5922,93,536846,90.63751477291913,8
0.05,5923,94,536940,90.63808237677245,7
0.05,5924,93,537033,90.63848101265823,8
0.05,5925,94,537127,90.63904826189673,7
0.05,5926,94,537221,90.6396153197233,7
0.05,5927,94,537315,90.64018218623482,7
0.05,5928,92,537407,90.64041153651543,9
0.05,5929,88,537495,90.63996627318718,13
0.05,5930,94,537589,90.64053279379532,7
0.05,5931,96,537685,90.64143627781525,6
0.05,5932,93,537778,90.64183381088826,8
0.05,5933,96,537874,90.64273677114932,6
0.05,5934,93,537967,90.64313395113732,9
0.05,5935,94,538061,90.64369946091644,7
0.05,5936,96,538157,90.64460165066532,6
0.05,5937,94,538251,90.64516672280229,7
0.05,5938,93,538344,90.64556322613234,8
0.05,5939,96,538440,90.64646464646465,7
0.05,5940,91,538531,90.6465241541828,10
0.05,5941,93,538624,90.64692022887917,8
0.05,5942,94,538718,90.6474844354703,7
0.05,5943,95,538813,90.64821668909825,6
0.05,5944,94,538907,90.64878048780488,7
0.05,5945,91,538998,90.64883955600403,10
0.05,5946,94,539092,90.64940306036657,7
0.05,5947,94,539186,90.64996637525219,7
0.05,5948,25,539211,90.63893091275844,8
0.05,5949,91,539302,90.63899159663866,10
0.05,5950,93,539395,90.63938833809443,8
0.05,5951,93,539488,90.63978494623656,8
0.05,5952,93,539581,90.6401814211322,9
0.05,5953,94,539675,90.64074571716493,8
0.05,5954,94,539769,90.64130982367759,7
0.05,5955,95,539864,90.64204163868368,6
0.05,5956,93,539957,90.64243746852442,8
0.05,5957,92,540049,90.64266532393421,9
0.05,5958,94,540143,90.64322872965262,7
0.05,5959,96,540239,90.64412751677852,6
0.05,5960,95,540334,90.64485824526086,6
0.05,5961,94,540428,90.64542099966454,8
0.05,5962,27,540455,90.63474761026329,6
0.05,5963,95,540550,90.63547954393024,7
0.05,5964,92,540642,90.63570829840738,9
0.05,5965,95,540737,90.63643982567885,6
0.05,5966,96,540833,90.63733869616223,6
0.05,5967,93,540926,90.6377345844504,8
0.05,5968,93,541019,90.63813034009047,8
0.05,5969,95,541114,90.6388609715243,7
0.05,5970,93,541207,90.63925640596214,8
0.05,5971,95,541302,90.63998660415271,6
0.05,5972,95,541397,90.64071655784363,6
0.05,5973,94,541491,90.64127887512555,7
0.05,5974,95,541586,90.64200836820083,6
0.05,5975,94,541680,90.64257028112449,7
0.05,5976,92,541772,90.64279738999498,9
0.05,5977,93,541865,90.64319170291067,9
0.05,5978,95,541960,90.64392038802475,7
0.05,5979,94,542054,90.64448160535117,7
0.05,5980,95,542149,90.64520983113192,6
0.05,5981,94,542243,90.64577064526914,7
0.05,5982,92,542335,90.64599699147585,9
0.05,5983,92,542427,90.64622326203208,9
0.05,5984,95,542522,90.6469507101086,7
0.05,5985,96,542618,90.6478449716004,6
0.05,5986,94,542712,90.648404877234,7
0.05,5987,94,542806,90.64896459585839,7
0.05,5988,95,542901,90.64969110035064,7
0.05,5989,95,542996,90.65041736227045,7
0.05,5990,95,543091,90.65114338173927,7
0.05,5991,93,543184,90.65153538050734,8
0.05,5992,95,543279,90.65226097113299,7
0.05,5993,94,543373,90.65281948615282,7
0.05,5994,93,543466,90.65321100917431,9
0.05,5995,96,543562,90.65410273515677,6
0.05,5996,96,543658,90.65499416374854,6
0.05,5997,95,543753,90.65571857285762,6
0.05,5998,90,543843,90.65560926821136,11
0.05,5999,95,543938,90.65633333333334,6
0.05,6000,96,544034,90.65722379603399,6
0.05,6001,93,544127,90.65761412862379,9
0.05,6002,26,544153,90.64684324504414,6
0.05,6003,93,544246,90.64723517654896,8
0.05,6004,94,544340,90.64779350541215,7
0.05,6005,94,544434,90.64835164835165,7
0.05,6006,96,544530,90.64924255035791,6
0.05,6007,94,544624,90.64980026631159,8
0.05,6008,96,544720,90.65069063072059,6
0.05,6009,96,544816,90.65158069883528,6
0.05,6010,94,544910,90.65213774746299,7
0.05,6011,94,545004,90.65269461077844,7
0.05,6012,93,545097,90.65308498253783,8
0.05,6013,94,545191,90.65364150315929,7
0.05,6014,93,545284,90.65403158769742,8
0.05,6015,95,545379,90.65475398936171,7
0.05,6016,95,545474,90.65547615090577,6
0.05,6017,26,545500,90.64473246925888,7
0.05,6018,94,545594,90.64528991526832,7
0.05,6019,96,545690,90.64617940199335,6
0.05,6020,95,545785,90.64690250788905,6
0.05,6021,94,545879,90.64745931584191,7
0.05,6022,96,545975,90.64834799933588,6
0.05,6023,94,546069,90.64890438247012,7
0.05,6024,94,546163,90.64946058091286,7
0.05,6025,94,546257,90.65001659475605,7
0.05,6026,27,546284,90.63945578231292,6
0.05,6027,95,546379,90.64017916390179,6
0.05,6028,95,546474,90.6409023055233,6
0.05,6029,94,546568,90.64145936981758,7
0.05,6030,94,546662,90.64201624937822,7
0.05,6031,95,546757,90.64273872679045,6
0.05,6032,94,546851,90.64329520968009,7
0.05,6033,94,546945,90.64385150812065,7
0.05,6034,25,546970,90.63297431648716,8
0.05,6035,94,547064,90.63353214049039,7
0.05,6036,96,547160,90.63442107006792,6
0.05,6037,94,547254,90.63497846969194,7
0.05,6038,89,547343,90.6347077330684,12
0.05,6039,25,547368,90.62384105960265,8
0.05,6040,95,547463,90.62456546929316,8
0.05,6041,95,547558,90.62528963919232,6
0.05,6042,92,547650,90.62551712725468,9
0.05,6043,93,547743,90.62590999338187,8
0.05,6044,96,547839,90.62679900744416,6
0.05,6045,21,547860,90.61528283162421,11
0.05,6046,96,547956,90.61617330907889,6
0.05,6047,94,548050,90.61673280423281,7
0.05,6048,94,548144,90.61729211439908,7
0.05,6049,96,548240,90.61818181818182,6
0.05,6050,95,548335,90.61890596595605,6
0.05,6051,94,548429,90.6194646397885,8
0.05,6052,93,548522,90.61985792169172,8
0.05,6053,94,548616,90.62041625371656,8
0.05,6054,93,548709,90.62080924855492,8
0.05,6055,93,548802,90.62120211360634,8
0.05,6056,94,548896,90.62175994716857,7
0.05,6057,94,548990,90.62231759656652,7
0.05,6058,93,549083,90.6227100181548,8
0.05,6059,93,549176,90.62310231023102,8
0.05,6060,94,549270,90.62365946213497,7
0.05,6061,94,549364,90.62421643022105,8
0.05,6062,95,549459,90.62493814943097,6
0.05,6063,92,549551,90.62516490765171,9
0.05,6064,92,549643,90.62539159109646,10
0.05,6065,94,549737,90.62594790636334,7
0.05,6066,94,549831,90.62650403823966,7
0.05,6067,93,549924,90.6268951878708,8
0.05,6068,94,550018,90.62745098039215,7
0.05,6069,92,550110,90.62767710049424,9
0.05,6070,95,550205,90.62839729863285,6
0.05,6071,94,550299,90.62895256916995,7
0.05,6072,93,550392,90.62934299357813,8
0.05,6073,94,550486,90.62989792558446,7
0.05,6074,-46,550440,90.60740740740741,10
0.05,6075,94,550534,90.60796576695195,8
0.05,6076,96,550630,90.608853052493,6
0.05,6077,96,550726,90.60974004606778,6
0.05,6078,96,550822,90.61062674782036,6
0.05,6079,26,550848,90.6,7
0.05,6080,94,550942,90.60055911856603,8
0.05,6081,25,550967,90.58977310095364,7
0.05,6082,94,551061,90.59033371691599,7
0.05,6083,95,551156,90.59105851413544,6
0.05,6084,96,551252,90.59194741166803,6
0.05,6085,94,551346,90.59250739401907,7
0.05,6086,94,551440,90.59306719237719,7
0.05,6087,96,551536,90.5939553219448,6
0.05,6088,91,551627,90.59402200689769,10
0.05,6089,96,551723,90.59490968801313,6
0.05,6090,92,551815,90.59514037103924,10
0.05,6091,94,551909,90.5956992777413,7
0.05,6092,94,552003,90.59625800098473,7
0.05,6093,94,552097,90.59681654085986,7
0.05,6094,93,552190,90.59721082854799,9
0.05,6095,95,552285,90.59793307086615,6
0.05,6096,95,552380,90.59865507626702,6
0.05,6097,95,552475,90.59937684486717,6
0.05,6098,94,552569,90.59993441547795,8
0.05,6099,93,552662,90.60032786885246,8
0.05,6100,93,552755,90.60072119324701,8
0.05,6101,95,552850,90.60144215011472,7
0.05,6102,94,552944,90.60199901687695,8
0.05,6103,94,553038,90.60255570117955,7
0.05,6104,95,553133,90.60327600327601,6
0.05,6105,96,553229,90.60415984277759,6
0.05,6106,94,553323,90.60471589978712,7
0.05,6107,92,553415,90.60494433529797,9
0.05,6108,96,553511,90.60582746767065,6
0.05,6109,94,553605,90.6063829787234,7
0.05,6110,94,553699,90.60693830796923,7
0.05,6111,94,553793,90.60749345549738,7
0.05,6112,94,553887,90.60804842139703,7
0.05,6113,94,553981,90.60860320575728,7
0.05,6114,93,554074,90.60899427636959,8
0.05,6115,94,554168,90.60954872465663,8
0.05,6116,95,554263,90.61026647049206,6
0.05,6117,93,554356,90.6106570774763,8
0.05,6118,93,554449,90.61104755679033,8
0.05,6119,94,554543,90.61160130718955,7
0.05,6120,93,554636,90.6119915046561,8
0.05,6121,96,554732,90.61287161058478,7
0.05,6122,94,554826,90.61342479176874,7
0.05,6123,93,554919,90.61381450032658,8
0.05,6124,92,555011,90.61404081632654,9
0.05,6125,90,555101,90.61394058112961,12
0.05,6126,93,555194,90.61433001468909,8
0.05,6127,92,555286,90.61455613577023,9
0.05,6128,96,555382,90.61543481807799,6
0.05,6129,92,555474,90.61566068515498,9
0.05,6130,92,555566,90.61588647855162,9
0.05,6131,95,555661,90.61660143509458,6
0.05,6132,96,555757,90.61747921082667,6
0.05,6133,24,555781,90.60661884577763,9
0.05,6134,96,555877,90.60749796251018,6
0.05,6135,96,555973,90.60837679269882,6
0.05,6136,95,556068,90.60909239041877,6
0.05,6137,94,556162,90.60964483545129,7
0.05,6138,94,556256,90.61019710050496,7
0.05,6139,94,556350,90.61074918566776,7
0.05,6140,93,556443,90.61113825109916,8
0.05,6141,95,556538,90.6118528166721,6
0.05,6142,92,556630,90.61207878886538,9
0.05,6143,94,556724,90.61263020833333,7
0.05,6144,96,556820,90.61350691619202,6
0.05,6145,94,556914,90.61405792385291,7
0.05,6146,92,557006,90.61428339027168,9
0.05,6147,92,557098,90.61450878334418,9
0.05,6148,96,557194,90.61538461538461,6
0.05,6149,94,557288,90.61593495934959,8
0.05,6150,93,557381,90.61632254917899,8
0.05,6151,90,557471,90.61622236671002,11
0.05,6152,94,557565,90.6167723061921,7
0.05,6153,93,557658,90.61715957101073,8
0.05,6154,94,557752,90.61770917952884,7
0.05,6155,96,557848,90.61858349577648,6
0.05,6156,94,557942,90.61913269449407,7
0.05,6157,94,558036,90.61968171484249,7
0.05,6158,92,558128,90.61990582886833,9
0.05,6159,95,558223,90.62061688311688,6
0.05,6160,94,558317,90.62116539522805,7
0.05,6161,95,558412,90.62187601428107,6
0.05,6162,94,558506,90.62242414408567,7
0.05,6163,92,558598,90.62264763140817,9
0.05,6164,94,558692,90.62319545823196,7
0.05,6165,95,558787,90.62390528705807,7
0.05,6166,94,558881,90.62445273228474,7
0.05,6167,95,558976,90.62516212710766,6
0.05,6168,93,559069,90.62554709029015,8
0.05,6169,94,559163,90.62609400324149,7
0.05,6170,92,559255,90.62631664235943,9
0.05,6171,94,559349,90.62686325340246,7
0.05,6172,94,559443,90.62740968734813,7
0.05,6173,94,559537,90.62795594428248,7
0.05,6174,94,559631,90.62850202429149,8
0.05,6175,92,559723,90.62872409326425,9
0.05,6176,95,559818,90.62943176299174,7
0.05,6177,94,559912,90.62997733894464,7
0.05,6178,93,560005,90.63036089982198,8
0.05,6179,93,560098,90.63074433656958,8
0.05,6180,94,560192,90.63128943536644,8
0.05,6181,92,560284,90.63151083791654,9
0.05,6182,94,560378,90.63205563642245,7
0.05,6183,95,560473,90.63276196636481,7
0.05,6184,95,560568,90.63346806790622,6
0.05,6185,95,560663,90.63417394115746,7
0.05,6186,94,560757,90.63471795700663,7
0.05,6187,94,560851,90.6352617970265,8
0.05,6188,92,560943,90.63548230731944,10
0.05,6189,92,561035,90.6357027463651,9
0.05,6190,95,561130,90.63640768858019,6
0.05,6191,96,561226,90.63727390180878,6
0.05,6192,95,561321,90.63797836266752,6
0.05,6193,94,561415,90.63852114949951,8
0.05,6194,95,561510,90.63922518159806,7
0.05,6195,96,561606,90.6400903808909,6
0.05,6196,95,561701,90.64079393254801,6
0.05,6197,90,561791,90.64069054533721,11
0.05,6198,94,561885,90.64123245684787,7
0.05,6199,94,561979,90.64177419354839,7
0.05,6200,92,562071,90.64199322689889,9
0.05,6201,94,562165,90.6425346662367,7
0.05,6202,96,562261,90.64339835563437,6
0.05,6203,96,562357,90.6442617666022,6
0.05,6204,95,562452,90.64496373892023,7
0.05,6205,93,562545,90.64534321624235,8
0.05,6206,92,562637,90.6455614628645,9
0.05,6207,93,562730,90.64594072164948,8
0.05,6208,93,562823,90.64631985827025,8
0.05,6209,94,562917,90.64685990338164,7
0.05,6210,95,563012,90.6475607792626,6
0.05,6211,94,563106,90.6481004507405,7
0.05,6212,96,563202,90.64896185417673,6
0.05,6213,96,563298,90.64982298036692,6
0.05,6214,95,563393,90.65052292839904,6
0.05,6215,96,563489,90.65138352638353,6
0.05,6216,94,563583,90.65192214894644,7
0.05,6217,93,563676,90.65229977484722,8
0.05,6218,93,563769,90.65267727930535,8
0.05,6219,94,563863,90.6532154340836,7
0.05,6220,92,563955,90.65343192412796,9
0.05,6221,93,564048,90.65380906460945,8
0.05,6222,96,564144,90.65466816647918,6
0.05,6223,95,564239,90.65536632390746,6
0.05,6224,93,564332,90.65574297188755,8
0.05,6225,96,564428,90.65660134918086,6
0.05,6226,92,564520,90.65681708687971,9
0.05,6227,94,564614,90.65735388567758,7
0.05,6228,92,564706,90.65756943329588,9
0.05,6229,95,564801,90.65826645264848,6
0.05,6230,95,564896,90.65896324827476,8
0.05,6231,93,564989,90.65933889602054,8
0.05,6232,91,565080,90.65939355045724,10
0.05,6233,96,565176,90.66025024061598,6
0.05,6234,90,565266,90.66014434643144,11
0.05,6235,93,565359,90.66051956382296,8
0.05,6236,92,565451,90.66073432740099,9
0.05,6237,92,565543,90.66094902212248,9
0.05,6238,93,565636,90.661323930117,9
0.05,6239,93,565729,90.66169871794872,8
0.05,6240,94,565823,90.66223361640763,8
0.05,6241,94,565917,90.66276834347966,7
0.05,6242,96,566013,90.66362325804901,6
0.05,6243,92,566105,90.66383728379245,9
0.05,6244,94,566199,90.66437149719776,7
0.05,6245,94,566293,90.66490553954532,7
0.05,6246,92,566385,90.66511925724348,9
0.05,6247,94,566479,90.66565300896286,7
0.05,6248,94,566573,90.66618658985438,7
0.05,6249,95,566668,90.66688,7
0.05,6250,93,566761,90.66725323948168,10
0.05,6251,96,566857,90.66810620601407,6
0.05,6252,94,566951,90.66863905325444,8
0.05,6253,94,567045,90.66917173009274,7
0.05,6254,94,567139,90.66970423661071,7
0.05,6255,93,567232,90.67007672634271,8
0.05,6256,94,567326,90.67060891801182,7
0.05,6257,91,567417,90.67066155321189,10
0.05,6258,96,567513,90.6715130212494,6
0.05,6259,92,567605,90.67172523961662,10
0.05,6260,96,567701,90.67257626577224,6
0.05,6261,94,567795,90.67310763334397,7
0.05,6262,94,567889,90.67363883123105,7
0.05,6263,95,567984,90.67432950191571,6
0.05,6264,96,568080,90.67517956903431,6
0.05,6265,93,568173,90.67555059048836,8
0.05,6266,94,568267,90.67608105951811,7
0.05,6267,93,568360,90.67645181876196,8
0.05,6268,95,568455,90.67714148987079,6
0.05,6269,95,568550,90.67783094098884,6
0.05,6270,94,568644,90.67836070802105,7
0.05,6271,91,568735,90.67841198979592,10
0.05,6272,94,568829,90.67894149529731,7
0.05,6273,96,568925,90.67978960790565,6
0.05,6274,95,569020,90.6804780876494,6
0.05,6275,27,569047,90.67033142128744,6
0.05,6276,95,569142,90.67102118846583,6
0.05,6277,94,569236,90.67155144950621,7
0.05,6278,27,569263,90.6614110527154,6
0.05,6279,93,569356,90.66178343949045,8
0.05,6280,94,569450,90.66231491800669,8
0.05,6281,91,569541,90.66236867239732,12
0.05,6282,95,569636,90.66305904822536,6
0.05,6283,92,569728,90.66327180140038,9
0.05,6284,95,569823,90.66396181384248,6
0.05,6285,94,569917,90.66449252306714,7
0.05,6286,95,570012,90.66518212183871,6
0.05,6287,96,570108,90.66603053435115,6
0.05,6288,94,570202,90.66656066147242,7
0.05,6289,95,570297,90.66724960254372,6
0.05,6290,96,570393,90.6680972818312,6
0.05,6291,96,570489,90.66894469167197,6
0.05,6292,94,570583,90.66947401875099,7
0.05,6293,92,570675,90.66968541468064,9
0.05,6294,94,570769,90.67021445591739,7
0.05,6295,92,570861,90.67042566709021,9
0.05,6296,94,570955,90.67095442274099,7
0.05,6297,94,571049,90.67148301047952,7
0.05,6298,94,571143,90.67201143038578,7
0.05,6299,94,571237,90.67253968253968,7
0.05,6300,96,571333,90.67338517695603,6
0.05,6301,93,571426,90.67375436369406,8
0.05,6302,95,571521,90.67444074250356,6
0.05,6303,96,571617,90.67528553299492,6
0.05,6304,93,571710,90.67565424266455,9
0.05,6305,93,571803,90.67602283539486,8
0.05,6306,27,571830,90.66592674805771,6
0.05,6307,25,571855,90.65551680405834,8
0.05,6308,94,571949,90.65604691710256,8
0.05,6309,94,572043,90.65657686212361,7
0.05,6310,94,572137,90.65710663920139,7
0.05,6311,94,572231,90.65763624841571,7
0.05,6312,94,572325,90.65816568984634,7
0.05,6313,95,572420,90.65885334178017,7
0.05,6314,94,572514,90.65938242280285,7
0.05,6315,88,572602,90.6589613679544,13
0.05,6316,96,572698,90.65980687034985,6
0.05,6317,93,572791,90.66017727128838,8
0.05,6318,95,572886,90.66086406076911,6
0.05,6319,93,572979,90.66123417721519,8
0.05,6320,89,573068,90.66097136529031,12
0.05,6321,95,573163,90.66165770325846,7
0.05,6322,95,573258,90.66234382413411,6
0.05,6323,92,573350,90.66255534471853,9
0.05,6324,94,573444,90.66308300395256,7
0.05,6325,96,573540,90.66392665191275,6
0.05,6326,27,573567,90.6538643907065,6
0.05,6327,96,573663,90.65470922882427,6
0.05,6328,25,573688,90.64433559804077,7
0.05,6329,93,573781,90.64470774091627,8
0.05,6330,94,573875,90.6452377191597,7
0.05,6331,92,573967,90.64545167403664,9
0.05,6332,95,574062,90.64613927048792,6
0.05,6333,93,574155,90.64651089359015,8
0.05,6334,95,574250,90.64719810576165,7
0.05,6335,95,574345,90.6478851010101,6
0.05,6336,94,574439,90.64841407606123,8
0.05,6337,93,574532,90.64878510571158,8
0.05,6338,94,574626,90.64931377188832,7
0.05,6339,89,574715,90.64905362776025,13
0.05,6340,94,574809,90.64958208484467,7
0.05,6341,94,574903,90.65011037527594,7
0.05,6342,91,574994,90.65016553681224,10
0.05,6343,90,575084,90.65006305170239,11
0.05,6344,95,575179,90.65074862096138,6
0.05,6345,96,575275,90.65159155373463,6
0.05,6346,95,575370,90.65227666614149,6
0.05,6347,95,575465,90.65296156269692,8
0.05,6348,92,575557,90.65317372814617,9
0.05,6349,94,575651,90.65370078740158,7
0.05,6350,93,575744,90.65407022516139,8
0.05,6351,94,575838,90.65459697732997,7
0.05,6352,92,575930,90.65480875177082,9
0.05,6353,94,576024,90.65533522190746,7
0.05,6354,90,576114,90.6552321007081,11
0.05,6355,91,576205,90.65528634361233,10
0.05,6356,95,576300,90.65596979707409,6
0.05,6357,96,576396,90.65681031770997,6
0.05,6358,94,576490,90.6573360591288,7
0.05,6359,95,576585,90.65801886792453,6
0.05,6360,92,576677,90.65822983807577,9
0.05,6361,85,576762,90.65734045897517,16
0.05,6362,94,576856,90.65786578657865,7
0.05,6363,92,576948,90.65807668133249,10
0.05,6364,94,577042,90.6586017282011,7
0.05,6365,92,577134,90.6588124410933,9
0.05,6366,92,577226,90.65902308779646,9
0.05,6367,90,577316,90.65891959798995,11
0.05,6368,94,577410,90.65944418276024,7
0.05,6369,93,577503,90.65981161695447,8
0.05,6370,93,577596,90.66017893580286,8
0.05,6371,96,577692,90.66101694915254,6
0.05,6372,92,577784,90.66122705162404,9
0.05,6373,93,577877,90.66159397552558,8
0.05,6374,95,577972,90.66227450980392,6
0.05,6375,92,578064,90.6624843161857,9
0.05,6376,96,578160,90.66332131096127,6
0.05,6377,94,578254,90.66384446534964,7
0.05,6378,92,578346,90.6640539269478,9
0.05,6379,94,578440,90.66457680250784,7
0.05,6380,94,578534,90.66509951418273,7
0.05,6381,92,578626,90.66530868066437,10
0.05,6382,91,578717,90.66536111546294,10
0.05,6383,94,578811,90.66588345864662,7
0.05,6384,94,578905,90.66640563821457,7
0.05,6385,96,579001,90.66724083933605,6
0.05,6386,93,579094,90.66760607483951,8
0.05,6387,95,579189,90.66828428303069,6
0.05,6388,90,579279,90.66817968383158,11
0.05,6389,90,579369,90.66807511737089,11
0.05,6390,95,579464,90.66875293381318,6
0.05,6391,92,579556,90.66896120150187,9
0.05,6392,96,579652,90.66979508837791,6
0.05,6393,90,579742,90.66969033468877,11
0.05,6394,94,579836,90.67021110242376,7
0.05,6395,93,579929,90.67057535959975,9
0.05,6396,92,580021,90.67078317961544,9
0.05,6397,95,580116,90.67145983119725,6
0.05,6398,93,580209,90.67182372245664,9
0.05,6399,94,580303,90.67234375,7
0.05,6400,96,580399,90.67317606623965,6
0.05,6401,96,580495,90.67400812246173,6
0.05,6402,93,580588,90.67437138841169,8
0.05,6403,95,580683,90.67504684572143,7
0.05,6404,94,580777,90.67556596409055,8
0.05,6405,93,580870,90.67592881673431,8
0.05,6406,94,580964,90.67644763539879,7
0.05,6407,95,581059,90.67712234706617,6
0.05,6408,27,581086,90.66718676860664,6
0.05,6409,94,581180,90.66770670826833,7
0.05,6410,93,581273,90.66807050382155,8
0.05,6411,93,581366,90.66843418590143,8
0.05,6412,92,581458,90.66864182130048,9
0.05,6413,93,581551,90.66900530090427,9
0.05,6414,91,581642,90.66905689789556,11
0.05,6415,94,581736,90.66957605985037,7
0.05,6416,94,581830,90.67009505999688,7
0.05,6417,94,581924,90.67061389841072,7
0.05,6418,94,582018,90.67113257516748,7
0.05,6419,95,582113,90.67180685358255,6
0.05,6420,96,582209,90.67263666095624,6
0.05,6421,94,582303,90.67315478044223,7
0.05,6422,96,582399,90.67398411957029,6
0.05,6423,95,582494,90.67465753424658,6
0.05,6424,94,582588,90.67517509727627,7
0.05,6425,95,582683,90.67584811702459,7
0.05,6426,96,582779,90.67667652092734,6
0.05,6427,93,582872,90.67703795892969,8
0.05,6428,94,582966,90.67755482967802,7
0.05,6429,93,583059,90.67791601866251,8
0.05,6430,92,583151,90.67812159850723,9
0.05,6431,94,583245,90.6786380597015,7
0.05,6432,94,583339,90.67915436032955,7
0.05,6433,95,583434,90.67982592477463,8
0.05,6434,90,583524,90.67972027972029,11
0.05,6435,95,583619,90.68039154754506,7
0.05,6436,94,583713,90.68090725493242,7
0.05,6437,95,583808,90.68157812985399,6
0.05,6438,95,583903,90.68224879639696,7
0.05,6439,93,583996,90.68260869565218,8
0.05,6440,95,584091,90.68327899394504,7
0.05,6441,91,584182,90.68332815895684,10
0.05,6442,94,584276,90.68384293031197,7
0.05,6443,93,584369,90.68420235878337,9
0.05,6444,94,584463,90.68471683475562,7
0.05,6445,92,584555,90.68492088116662,9
0.05,6446,88,584643,90.68450442066077,13
0.05,6447,93,584736,90.6848635235732,8
0.05,6448,95,584831,90.68553264071949,6
0.05,6449,92,584923,90.68573643410852,10
0.05,6450,94,585017,90.6862501937684,7
0.05,6451,94,585111,90.68676379417235,7
0.05,6452,95,585206,90.68743220207655,6
0.05,6453,94,585300,90.68794546017973,7
0.05,6454,96,585396,90.68876839659178,6
0.05,6455,93,585489,90.68912639405204,8
0.05,6456,96,585585,90.68994889267462,6
0.05,6457,96,585681,90.6907711365748,6
0.05,6458,96,585777,90.69159312587088,6
0.05,6459,95,585872,90.6922600619195,6
0.05,6460,87,585959,90.69168859309704,14
0.05,6461,93,586052,90.69204580625194,8
0.05,6462,94,586146,90.69255763577286,7
0.05,6463,95,586241,90.69322400990099,6
0.05,6464,95,586336,90.6938901778809,7
0.05,6465,95,586431,90.69455613980823,6
0.05,6466,95,586526,90.69522189577857,6
0.05,6467,92,586618,90.69542362399505,9
0.05,6468,93,586711,90.69577987324162,8
0.05,6469,93,586804,90.69613601236476,8
0.05,6470,94,586898,90.696646577036,7
0.05,6471,95,586993,90.69731149567367,6
0.05,6472,93,587086,90.6976672331222,9
0.05,6473,94,587180,90.69817732468334,7
0.05,6474,94,587274,90.69868725868726,7
0.05,6475,93,587367,90.69904261890055,8
0.05,6476,92,587459,90.69924347691833,9
0.05,6477,96,587555,90.70006174745292,6
0.05,6478,94,587649,90.7005710757833,8
0.05,6479,94,587743,90.70108024691358,7
0.05,6480,96,587839,90.70189785526925,6
0.05,6481,96,587935,90.70271521135452,6
0.05,6482,95,588030,90.70337806571033,6
0.05,6483,94,588124,90.7038864898211,7
0.05,6484,89,588213,90.70362374710871,12
0.05,6485,94,588307,90.70413197656491,7
0.05,6486,94,588401,90.70464004932943,7
0.05,6487,94,588495,90.70514796547472,7
0.05,6488,96,588591,90.70596393897365,6
0.05,6489,93,588684,90.70631741140215,8
0.05,6490,96,588780,90.70713295331998,6
0.05,6491,94,588874,90.70764017252003,7
0.05,6492,93,588967,90.70799322347143,8
0.05,6493,95,589062,90.70865414228518,6
0.05,6494,92,589154,90.70885296381832,9
0.05,6495,94,589248,90.70935960591133,7
0.05,6496,93,589341,90.70971217484993,8
0.05,6497,94,589435,90.71021852877809,7
0.05,6498,94,589529,90.71072472688105,7
0.05,6499,94,589623,90.71123076923077,7
0.05,6500,92,589715,90.71142901092139,9
0.05,6501,95,589810,90.71208858812673,6
0.05,6502,87,589897,90.71151776103336,15
0.05,6503,95,589992,90.71217712177122,6
0.05,6504,92,590084,90.71237509607994,9
0.05,6505,92,590176,90.71257300952966,9
0.05,6506,95,590271,90.71323190410327,6
0.05,6507,27,590298,90.70344191763982,6
0.05,6508,95,590393,90.70410201259794,6
0.05,6509,91,590484,90.70414746543779,11
0.05,6510,92,590576,90.70434649055444,9
0.05,6511,88,590664,90.7039312039312,13
0.05,6512,94,590758,90.70443727928757,7
0.05,6513,25,590783,90.69435062941358,8
0.05,6514,94,590877,90.69485801995395,7
0.05,6515,94,590971,90.69536525475752,8
0.05,6516,25,590996,90.68528464017186,7
0.05,6517,94,591090,90.68579318809451,7
0.05,6518,96,591186,90.68660837551772,6
0.05,6519,95,591281,90.6872699386503,6
0.05,6520,92,591373,90.6874712467413,9
0.05,6521,94,591467,90.68797914750077,7
0.05,6522,89,591556,90.68772037406102,12
0.05,6523,91,591647,90.68776824034335,10
0.05,6524,92,591739,90.68796934865901,9
0.05,6525,92,591831,90.68817039534171,10
0.05,6526,95,591926,90.68883100965222,6
0.05,6527,94,592020,90.68933823529412,7
0.05,6528,94,592114,90.68984530555981,7
0.05,6529,95,592209,90.69050535987749,6
0.05,6530,94,592303,90.6910120961568,7
0.05,6531,95,592398,90.69167176974892,6
0.05,6532,92,592490,90.69187203428747,9
0.05,6533,94,592584,90.69237832874197,7
0.05,6534,96,592680,90.69319051262433,6
0.05,6535,96,592776,90.69400244798041,6
0.05,6536,96,592872,90.69481413492427,6
0.05,6537,95,592967,90.69547262159682,7
0.05,6538,95,593062,90.6961309068665,6
0.05,6539,95,593157,90.6967889908257,7
0.05,6540,92,593249,90.69698822809968,10
0.05,6541,95,593344,90.69764597982268,6
0.05,6542,94,593438,90.69815069539966,7
0.05,6543,93,593531,90.69850244498778,8
0.05,6544,92,593623,90.6987012987013,9
0.05,6545,27,593650,90.68897036358081,6
0.05,6546,95,593745,90.68962883763555,6
0.05,6547,91,593836,90.68967623701894,10
0.05,6548,95,593931,90.69033440219881,6
0.05,6549,92,594023,90.69053435114503,10
0.05,6550,96,594119,90.69134483284995,6
0.05,6551,94,594213,90.69184981684981,7
0.05,6552,94,594307,90.69235464672668,7
0.05,6553,95,594402,90.69301190112908,7
0.05,6554,94,594496,90.69351639969489,7
0.05,6555,96,594592,90.69432580841976,6
0.05,6556,96,594688,90.6951349702608,6
0.05,6557,96,594784,90.69594388533089,6
0.05,6558,94,594878,90.69644762921178,7
0.05,6559,96,594974,90.69725609756098,6
0.05,6560,96,595070,90.6980643194635,6
0.05,6561,94,595164,90.69856750990552,7
0.05,6562,96,595260,90.69937528569253,6
0.05,6563,95,595355,90.70003046922608,6
0.05,6564,94,595449,90.7005331302361,7
0.05,6565,94,595543,90.70103563813585,7
0.05,6566,94,595637,90.70153799299528,7
0.05,6567,92,595729,90.70173568818514,9
0.05,6568,27,595756,90.69203836200334,6
0.05,6569,88,595844,90.69162861491628,13
0.05,6570,94,595938,90.69213209557145,8
0.05,6571,93,596031,90.69248326232501,8
0.05,6572,87,596118,90.69192149703332,14
0.05,6573,93,596211,90.69227258898692,8
0.05,6574,94,596305,90.69277566539924,7
0.05,6575,95,596400,90.69343065693431,6
0.05,6576,94,596494,90.69393340428766,7
0.05,6577,93,596587,90.69428397689268,8
0.05,6578,91,596678,90.69433044535644,10
0.05,6579,96,596774,90.6951367781155,6
0.05,6580,93,596867,90.69548700805349,9
0.05,6581,91,596958,90.69553327256153,10
0.05,6582,95,597053,90.69618714871639,6
0.05,6583,95,597148,90.69684082624545,6
0.05,6584,94,597242,90.69734244495065,7
0.05,6585,94,597336,90.69784391132706,7
0.05,6586,90,597426,90.69773796872627,11
0.05,6587,96,597522,90.69854280510019,6
0.05,6588,94,597616,90.69904386098042,7
0.05,6589,95,597711,90.69969650986343,6
0.05,6590,94,597805,90.70019723865877,7
0.05,6591,93,597898,90.70054611650485,8
0.05,6592,94,597992,90.70104656453815,8
0.05,6593,94,598086,90.70154686078253,7
0.05,6594,93,598179,90.70189537528431,8
0.05,6595,92,598271,90.70209217707702,9
0.05,6596,94,598365,90.70259208731241,7
0.05,6597,95,598460,90.70324340709305,6
0.05,6598,94,598554,90.70374299136233,7
0.05,6599,96,598650,90.70454545454545,6
0.05,6600,95,598745,90.7051961823966,6
0.05,6601,96,598841,90.70599818236897,6
0.05,6602,96,598937,90.70679993942147,6
0.05,6603,23,598960,90.69654754694125,10
0.05,6604,91,599051,90.69659348978047,10
0.05,6605,93,599144,90.69694217378141,8
0.05,6606,93,599237,90.69729075223248,8
0.05,6607,93,599330,90.6976392251816,8
0.05,6608,94,599424,90.69813890149796,7
0.05,6609,93,599517,90.69848714069592,8
0.05,6610,94,599611,90.69898653758887,7
0.05,6611,94,599705,90.69948578342408,7
0.05,6612,94,599799,90.69998487827007,7
0.05,6613,94,599893,90.70048382219534,8
0.05,6614,95,599988,90.70113378684808,6
0.05,6615,94,600082,90.70163240628779,7
0.05,6616,94,600176,90.7021308750189,7
0.05,6617,95,600271,90.70278029616198,7
0.05,6618,95,600366,90.70342952107569,6
0.05,6619,95,600461,90.70407854984894,7
0.05,6620,94,600555,90.70457634798369,7
0.05,6621,27,600582,90.69495620658411,6
0.05,6622,96,600678,90.6957572097237,6
0.05,6623,95,600773,90.69640700483092,6
0.05,6624,96,600869,90.69720754716981,6
0.05,6625,93,600962,90.69755508602475,8
0.05,6626,93,601055,90.69790251999396,8
0.05,6627,95,601150,90.6985515992758,6
0.05,6628,94,601244,90.69904963041182,7
0.05,6629,27,601271,90.6894419306184,6
0.05,6630,95,601366,90.69009199215805,7
0.05,6631,94,601460,90.69059107358262,7
0.05,6632,95,601555,90.69124076586763,6
0.05,6633,96,601651,90.69204100090442,6
0.05,6634,94,601745,90.69253956292388,7
0.05,6635,93,601838,90.69288728149488,8
0.05,6636,94,601932,90.69338556576767,7
0.05,6637,94,602026,90.6938836999096,7
0.05,6638,95,602121,90.69453230908269,6
0.05,6639,93,602214,90.69487951807228,8
0.05,6640,95,602309,90.69552778196055,6
0.05,6641,95,602404,90.69617585064739,7
0.05,6642,93,602497,90.69652265542676,8
0.05,6643,91,602588,90.69656833232992,10
0.05,6644,96,602684,90.69736644093304,6
0.05,6645,93,602777,90.69771291002107,8
0.05,6646,96,602873,90.69851060628855,6
0.05,6647,96,602969,90.69930806257521,6
0.05,6648,95,603064,90.69995488043315,7
0.05,6649,89,603153,90.6996992481203,13
0.05,6650,93,603246,90.7000451059991,8
0.05,6651,85,603331,90.69918821407096,16
0.05,6652,94,603425,90.6996843529235,7
0.05,6653,96,603521,90.7004809137361,6
0.05,6654,92,603613,90.70067618332081,9
0.05,6655,96,603709,90.70147235576923,6
0.05,6656,93,603802,90.70181763557157,8
0.05,6657,88,603890,90.701411835386,13
0.05,6658,94,603984,90.70190719327226,7
0.05,6659,93,604077,90.70225225225225,8
0.05,6660,94,604171,90.70274733523495,7
0.05,6661,93,604264,90.70309216451516,8
0.05,6662,95,604359,90.70373705538046,7
0.05,6663,96,604455,90.7045318127251,6
0.05,6664,89,604544,90.70427606901725,12
0.05,6665,95,604639,90.70492049204921,7
0.05,6666,95,604734,90.7055647217639,6
0.05,6667,94,604828,90.70605878824234,7
0.05,6668,92,604920,90.70625281151597,9
0.05,6669,91,605011,90.70629685157421,11
0.05,6670,95,605106,90.70694048868236,6
0.05,6671,92,605198,90.70713429256595,9
0.05,6672,94,605292,90.70762775363404,8
0.05,6673,94,605386,90.7081210668265,7
0.05,6674,93,605479,90.70846441947566,8
0.05,6675,94,605573,90.70895745955661,8
0.05,6676,94,605667,90.70945035195447,7
0.05,6677,92,605759,90.70964360587003,9
0.05,6678,93,605852,90.70998652492888,8
0.05,6679,94,605946,90.71047904191617,7
0.05,6680,92,606038,90.71067205508157,9
0.05,6681,95,606133,90.71131397785095,7
0.05,6682,96,606229,90.71210534191232,6
0.05,6683,93,606322,90.71244763614602,8
0.05,6684,96,606418,90.71323859386686,6
0.05,6685,93,606511,90.71358061621298,8
0.05,6686,94,606605,90.71407208015553,7
0.05,6687,96,606701,90.71486244019138,6
0.05,6688,93,606794,90.71520406637764,8
0.05,6689,90,606884,90.71509715994021,11
0.05,6690,91,606975,90.71513973994918,10
0.05,6691,94,607069,90.71563060370592,7
0.05,6692,93,607162,90.71597191095174,8
0.05,6693,93,607255,90.71631311622349,8
0.05,6694,95,607350,90.71695294996266,6
0.05,6695,93,607443,90.71729390681004,8
0.05,6696,94,607537,90.71778408242497,7
0.05,6697,96,607633,90.71857270827113,6
0.05,6698,94,607727,90.71906254664876,7
0.05,6699,95,607822,90.71970149253731,6
0.05,6700,94,607916,90.72019101626623,8
0.05,6701,93,608009,90.72053118472098,8
0.05,6702,96,608105,90.72131881247202,6
0.05,6703,94,608199,90.72180787589498,7
0.05,6704,94,608293,90.72229679343774,7
0.05,6705,94,608387,90.72278556516552,7
0.05,6706,94,608481,90.72327419114359,7
0.05,6707,93,608574,90.72361359570662,8
0.05,6708,95,608669,90.72425100611119,6
0.05,6709,94,608763,90.724739195231,7
0.05,6710,91,608854,90.7247802115929,10
0.05,6711,95,608949,90.72541716328963,7
0.05,6712,95,609044,90.72605392521972,6
0.05,6713,94,609138,90.72654155495978,7
0.05,6714,95,609233,90.72717795979152,8
0.05,6715,92,609325,90.72736748064324,9
0.05,6716,94,609419,90.72785469703737,8
0.05,6717,96,609515,90.72863947603453,6
0.05,6718,95,609610,90.72927518976039,6
0.05,6719,94,609704,90.7297619047619,8
0.05,6720,92,609796,90.72995090016367,9
0.05,6721,94,609890,90.73043736983041,7
0.05,6722,92,609982,90.73062620853786,10
0.05,6723,94,610076,90.73111243307555,8
0.05,6724,93,610169,90.73144981412639,8
0.05,6725,92,610261,90.7316384180791,9
0.05,6726,94,610355,90.73212427530846,7
0.05,6727,94,610449,90.73260998810939,7
0.05,6728,94,610543,90.73309555654629,7
0.05,6729,94,610637,90.73358098068351,7
0.05,6730,95,610732,90.73421482692022,6
0.05,6731,95,610827,90.73484848484848,6
0.05,6732,93,610920,90.73518491014407,8
0.05,6733,94,611014,90.73566973566973,7
0.05,6734,94,611108,90.73615441722346,7
0.05,6735,96,611204,90.73693586698337,6
0.05,6736,95,611299,90.73756865073474,6
0.05,6737,92,611391,90.73775601068566,9
0.05,6738,95,611486,90.73838848493841,6
0.05,6739,89,611575,90.73813056379822,12
0.05,6740,95,611670,90.73876279483756,6
0.05,6741,92,611762,90.73894986650845,9
0.05,6742,96,611858,90.73973009046418,6
0.05,6743,95,611953,90.74036180308423,6
0.05,6744,93,612046,90.74069681245366,8
0.05,6745,96,612142,90.74147643047732,6
0.05,6746,96,612238,90.74225581740032,6
0.05,6747,95,612333,90.74288678126852,6
0.05,6748,94,612427,90.74336938805749,8
0.05,6749,92,612519,90.74355555555556,9
0.05,6750,94,612613,90.7440379203081,7
0.05,6751,26,612639,90.7344490521327,7
0.05,6752,93,612732,90.73478454020436,8
0.05,6753,93,612825,90.735119928931,8
0.05,6754,94,612919,90.73560325684679,7
0.05,6755,93,613012,90.73593842510361,8
0.05,6756,93,613105,90.7362734941542,8
0.05,6757,94,613199,90.73675643681563,7
0.05,6758,96,613295,90.73753513833407,6
0.05,6759,95,613390,90.73816568047337,6
0.05,6760,93,613483,90.73850022186068,8
0.05,6761,91,613574,90.7385388938184,11
0.05,6762,94,613668,90.73902114446251,7
0.05,6763,96,613764,90.7397989355411,6
0.05,6764,94,613858,90.74028085735402,7
0.05,6765,17,613875,90.72938220514337,15
0.05,6766,95,613970,90.73001329983745,6
0.05,6767,94,614064,90.73049645390071,7
0.05,6768,96,614160,90.73127492982715,6
0.05,6769,94,614254,90.7317577548006,7
0.05,6770,94,614348,90.73224043715847,7
0.05,6771,94,614442,90.73272297696397,8
0.05,6772,94,614536,90.73320537428023,7
0.05,6773,93,614629,90.73354000590493,8
0.05,6774,94,614723,90.7340221402214,7
0.05,6775,92,614815,90.73420897284534,9
0.05,6776,95,614910,90.73483842408145,6
0.05,6777,95,615005,90.73546768958394,7
0.05,6778,94,615099,90.73594925505236,7
0.05,6779,95,615194,90.73657817109145,7
0.05,6780,95,615289,90.73720690163692,6
0.05,6781,89,615378,90.73695075199056,12
0.05,6782,94,615472,90.7374318148312,7
0.05,6783,25,615497,90.72774174528301,8
0.05,6784,92,615589,90.72792925571113,9
0.05,6785,93,615682,90.72826407309167,8
0.05,6786,95,615777,90.72889347281567,6
0.05,6787,95,615872,90.72952268709487,6
0.05,6788,92,615964,90.72970982471645,10
0.05,6789,96,616060,90.73048600883652,6
0.05,6790,93,616153,90.73082020321013,8
0.05,6791,94,616247,90.73130153121319,7
0.05,6792,96,616343,90.73207713823054,6
0.05,6793,94,616437,90.73255813953489,7
0.05,6794,93,616530,90.73289183222958,8
0.05,6795,96,616626,90.7336668628605,6
0.05,6796,94,616720,90.73414741797852,7
0.05,6797,92,616812,90.73433362753751,9
0.05,6798,94,616906,90.73481394322694,7
0.05,6799,94,617000,90.73529411764706,7
0.05,6800,92,617092,90.73548007645934,9
0.05,6801,94,617186,90.73596001176125,7
0.05,6802,95,617281,90.73658679994121,6
0.05,6803,94,617375,90.73706643151088,7
0.05,6804,21,617396,90.7268185157972,12
0.05,6805,91,617487,90.7268586541287,10
0.05,6806,94,617581,90.72733950345233,8
0.05,6807,93,617674,90.72767332549941,8
0.05,6808,94,617768,90.72815391393743,7
0.05,6809,93,617861,90.72848751835537,10
0.05,6810,95,617956,90.7291146674497,6
0.05,6811,92,618048,90.72930123311802,10
0.05,6812,96,618144,90.73007485689124,6
0.05,6813,96,618240,90.73084825359554,6
0.05,6814,92,618332,90.73103448275862,9
0.05,6815,94,618426,90.73151408450704,7
0.05,6816,96,618522,90.73228692973449,6
0.05,6817,94,618616,90.73276620709886,7
0.05,6818,94,618710,90.73324534389207,7
0.05,6819,94,618804,90.73372434017595,7
0.05,6820,96,618900,90.7344964081513,6
0.05,6821,93,618993,90.73482849604221,8
0.05,6822,92,619085,90.73501392349407,9
0.05,6823,96,619181,90.73578546307151,6
0.05,6824,95,619276,90.73641025641025,6
0.05,6825,96,619372,90.73718136536772,6
0.05,6826,93,619465,90.73751281675699,8
0.05,6827,96,619561,90.7382835383714,6
0.05,6828,95,619656,90.73890759994143,6
0.05,6829,96,619752,90.73967789165447,6
0.05,6830,93,619845,90.74000878348704,8
0.05,6831,95,619940,90.74063231850117,6
0.05,6832,27,619967,90.73130396604712,6
0.05,6833,91,620058,90.73134328358209,10
0.05,6834,93,620151,90.73167520117045,8
0.05,6835,94,620245,90.73215330602692,8
0.05,6836,91,620336,90.73219248208278,10
0.05,6837,96,620432,90.73296285463586,6
0.05,6838,94,620526,90.7334405614856,8
0.05,6839,94,620620,90.73391812865498,8
0.05,6840,94,620714,90.73439555620523,7
0.05,6841,96,620810,90.73516515638703,6
0.05,6842,93,620903,90.73549612742949,8
0.05,6843,92,620995,90.73568088836937,9
0.05,6844,92,621087,90.73586559532505,9
0.05,6845,92,621179,90.73605024832018,9
0.05,6846,94,621273,90.73652694610779,7
0.05,6847,93,621366,90.73685747663552,8
0.05,6848,92,621458,90.73704190392758,9
0.05,6849,94,621552,90.73751824817518,7
0.05,6850,91,621643,90.73755656108597,10
0.05,6851,93,621736,90.73788674839463,9
0.05,6852,90,621826,90.73777907485773,11
0.05,6853,93,621919,90.7381091333528,8
0.05,6854,27,621946,90.72881108679796,6
0.05,6855,93,622039,90.72914235705952,9
0.05,6856,19,622058,90.71868163920081,13
0.05,6857,89,622147,90.71843102945465,12
0.05,6858,96,622243,90.7192010497157,6
0.05,6859,96,622339,90.71997084548104,6
0.05,6860,93,622432,90.72030316280426,8
0.05,6861,94,622526,90.72078111337802,7
0.05,6862,94,622620,90.72125892466852,7
0.05,6863,96,622716,90.72202797202797,6
0.05,6864,94,622810,90.7225054624909,7
0.05,6865,95,622905,90.72312845907369,6
0.05,6866,92,622997,90.72331440221349,9
0.05,6867,25,623022,90.71374490390215,8
0.05,6868,93,623115,90.71407774057359,8
0.05,6869,94,623209,90.71455604075692,7
0.05,6870,92,623301,90.71474312327172,9
0.05,6871,96,623397,90.71551222351572,6
0.05,6872,92,623489,90.71569911246908,9
0.05,6873,94,623583,90.71617689845796,8
0.05,6874,94,623677,90.71665454545455,7
0.05,6875,94,623771,90.71713205351949,7
0.05,6876,92,623863,90.71731859822597,9
0.05,6877,92,623955,90.71750508868857,9
0.05,6878,94,624049,90.71798226486408,7
0.05,6879,94,624143,90.71845930232558,7
0.05,6880,94,624237,90.71893620113356,8
0.05,6881,92,624329,90.71912234815461,10
0.05,6882,95,624424,90.71974429754468,6
0.05,6883,94,624518,90.72022080185938,7
0.05,6884,96,624614,90.720987654321,6
0.05,6885,94,624708,90.7214638396747,7
0.05,6886,92,624800,90.72164948453609,9
0.05,6887,93,624893,90.72198025551684,8
0.05,6888,94,624987,90.72245608941792,7
0.05,6889,26,625013,90.71306240928882,7
0.05,6890,94,625107,90.71353939921637,7
0.05,6891,89,625196,90.71329077190946,12
0.05,6892,95,625291,90.71391266502249,6
0.05,6893,95,625386,90.71453437771976,6
0.05,6894,96,625482,90.7153009427121,6
0.05,6895,95,625577,90.7159222737819,6
0.05,6896,96,625673,90.716688415253,6
0.05,6897,94,625767,90.71716439547696,7
0.05,6898,92,625859,90.71735034062908,9
0.05,6899,93,625952,90.7176811594203,8
0.05,6900,92,626044,90.7178669758006,9
0.05,6901,92,626136,90.71805273833671,10
0.05,6902,95,626231,90.71867304070693,6
0.05,6903,95,626326,90.71929316338354,6
0.05,6904,96,626422,90.72005792903693,6
0.05,6905,91,626513,90.72009846510281,10
0.05,6906,95,626608,90.72071811206023,6
0.05,6907,95,626703,90.72133757961784,6
0.05,6908,93,626796,90.7216673903604,9
0.05,6909,93,626889,90.721997105644,8
0.05,6910,95,626984,90.72261611923021,6
0.05,6911,96,627080,90.72337962962963,6
0.05,6912,95,627175,90.72399826414002,6
0.05,6913,88,627263,90.72360428116865,13
0.05,6914,93,627356,90.72393347794649,8
0.05,6915,95,627451,90.72455176402545,6
0.05,6916,-116,627335,90.6946653173341,11
0.05,6917,93,627428,90.69499855449551,8
0.05,6918,92,627520,90.6951871657754,9
0.05,6919,91,627611,90.69523121387283,10
0.05,6920,93,627704,90.695564224823,8
0.05,6921,93,627797,90.69589713955504,8
0.05,6922,94,627891,90.69637440416004,7
0.05,6923,92,627983,90.69656268053149,9
0.05,6924,94,628077,90.69703971119134,7
0.05,6925,93,628170,90.69737222061796,9
0.05,6926,95,628265,90.6979933593186,7
0.05,6927,94,628359,90.69846997690532,7
0.05,6928,94,628453,90.6989464569202,7
0.05,6929,95,628548,90.6995670995671,6
0.05,6930,94,628642,90.70004328379743,7
0.05,6931,93,628735,90.70037507212926,8
0.05,6932,94,628829,90.70085100245204,7
0.05,6933,94,628923,90.70132679550044,7
0.05,6934,94,629017,90.70180245133382,7
0.05,6935,95,629112,90.70242214532873,7
0.05,6936,91,629203,90.70246504252559,10
0.05,6937,95,629298,90.70308446238109,6
0.05,6938,27,629325,90.69390402075227,6
0.05,6939,91,629416,90.69394812680115,10
0.05,6940,95,629511,90.69456850597896,6
0.05,6941,94,629605,90.69504465571882,8
0.05,6942,93,629698,90.69537663834078,8
0.05,6943,18,629716,90.68490783410138,14
0.05,6944,96,629812,90.6856731461483,6
0.05,6945,94,629906,90.68615030233228,7
0.05,6946,93,629999,90.68648337411832,8
0.05,6947,94,630093,90.68696027633851,7
0.05,6948,95,630188,90.68758094689883,6
0.05,6949,94,630282,90.68805755395684,9
0.05,6950,93,630375,90.68839015968925,8
0.05,6951,94,630469,90.6888665132336,7
0.05,6952,90,630559,90.68876743851575,11
0.05,6953,92,630651,90.68895599654874,9
0.05,6954,94,630745,90.68943206326384,7
0.05,6955,94,630839,90.68990799309948,8
0.05,6956,94,630933,90.69038378611471,7
0.05,6957,92,631025,90.69057200344926,9
0.05,6958,93,631118,90.69090386549792,8
0.05,6959,91,631209,90.69094827586207,10
0.05,6960,95,631304,90.69156730354834,6
0.05,6961,93,631397,90.69189887963229,8
0.05,6962,94,631491,90.69237397673416,7
0.05,6963,96,631587,90.69313612866169,6
0.05,6964,94,631681,90.69361091170137,7
0.05,6965,96,631777,90.69437266724088,6
0.05,6966,92,631869,90.69456006889622,9
0.05,6967,21,631890,90.6845579793341,11
0.05,6968,95,631985,90.6851772133735,6
0.05,6969,91,632076,90.68522238163558,10
0.05,6970,90,632166,90.68512408549707,11
0.05,6971,27,632193,90.67598967297762,6
0.05,6972,94,632287,90.67646637028538,8
0.05,6973,93,632380,90.67679954115286,8
0.05,6974,93,632473,90.67713261648746,8
0.05,6975,93,632566,90.67746559633028,8
0.05,6976,95,632661,90.67808513687831,6
0.05,6977,96,632757,90.67884780739467,6
0.05,6978,96,632853,90.67961025934947,6
0.05,6979,95,632948,90.68022922636104,7
0.05,6980,96,633044,90.68099126199685,6
0.05,6981,95,633139,90.68160985391006,6
0.05,6982,94,633233,90.68208506372619,7
0.05,6983,93,633326,90.68241695303551,8
0.05,6984,94,633420,90.68289191123837,7
0.05,6985,94,633514,90.68336673346694,8
0.05,6986,92,633606,90.68355517389438,9
0.05,6987,94,633700,90.68402976531196,7
0.05,6988,95,633795,90.68464730290457,6
0.05,6989,94,633889,90.68512160228899,7
0.05,6990,94,633983,90.68559576598484,7
0.05,6991,94,634077,90.68606979405034,7
0.05,6992,95,634172,90.68668668668668,7
0.05,6993,96,634268,90.68744638261367,6
0.05,6994,96,634364,90.68820586132952,6
0.05,6995,21,634385,90.67824471126357,11
0.05,6996,95,634480,90.67886236958697,6
0.05,6997,96,634576,90.67962274935697,6
0.05,6998,94,634670,90.68009715673668,7
0.05,6999,90,634760,90.68,11
0.05,7000,95,634855,90.68061705470647,6
0.05,7001,92,634947,90.68080548414738,10
0.05,7002,96,635043,90.68156504355277,6
0.05,7003,95,635138,90.68218161050828,6
0.05,7004,95,635233,90.68279800142756,6
0.05,7005,92,635325,90.68298601198973,9
0.05,7006,94,635419,90.68345939774511,7
0.05,7007,94,635513,90.68393264840182,7
0.05,7008,94,635607,90.6844057640177,7
0.05,7009,92,635699,90.6845934379458,9
0.05,7010,94,635793,90.68506632434746,7
0.05,7011,95,635888,90.68568168853395,6
0.05,7012,94,635982,90.68615428489947,7
0.05,7013,94,636076,90.68662674650699,8
0.05,7014,95,636171,90.6872416250891,6
0.05,7015,94,636265,90.68771379703534,8
0.05,7016,95,636360,90.68832834544678,6
0.05,7017,94,636454,90.68880022798518,7
0.05,7018,92,636546,90.6889870351902,9
0.05,7019,95,636641,90.68960113960114,6
0.05,7020,94,636735,90.69007263922518,7
0.05,7021,94,636829,90.69054400455711,7
0.05,7022,96,636925,90.69130001423893,6
0.05,7023,91,637016,90.69134396355354,10
0.05,7024,94,637110,90.69181494661922,7
0.05,7025,91,637201,90.6918588101338,10
0.05,7026,92,637293,90.69204496940372,9
0.05,7027,94,637387,90.692515651679,7
0.05,7028,94,637481,90.69298620002846,7
0.05,7029,95,637576,90.69359886201991,6
0.05,7030,91,637667,90.69364244062011,10
0.05,7031,94,637761,90.69411262798634,7
0.05,7032,94,637855,90.69458268164368,7
0.05,7033,95,637950,90.69519476826841,6
0.05,7034,95,638045,90.6958066808813,6
0.05,7035,94,638139,90.69627629334849,7
0.05,7036,95,638234,90.69688787835726,6
0.05,7037,94,638328,90.69735720375107,7
0.05,7038,95,638423,90.69796846142918,6
0.05,7039,90,638513,90.69786931818182,11
0.05,7040,89,638602,90.69762817781564,12
0.05,7041,95,638697,90.69823913660892,7
0.05,7042,95,638792,90.69884992190828,6
0.05,7043,93,638885,90.69917660420215,8
0.05,7044,95,638980,90.69978708303762,6
0.05,7045,96,639076,90.70053931308544,6
0.05,7046,95,639171,90.70114942528735,7
0.05,7047,93,639264,90.70147559591373,8
0.05,7048,94,639358,90.7019435380905,7
0.05,7049,90,639448,90.7018439716312,11
0.05,7050,95,639543,90.70245355268756,6
0.05,7051,95,639638,90.70306296086217,6
0.05,7052,96,639734,90.70381397986672,6
0.05,7053,93,639827,90.7041394953218,8
0.05,7054,94,639921,90.70460666194188,7
0.05,7055,95,640016,90.70521541950113,6
0.05,7056,96,640112,90.70596570780785,6
0.05,7057,95,640207,90.7065741003117,7
0.05,7058,96,640303,90.70732398356708,6
0.05,7059,95,640398,90.70793201133145,6
0.05,7060,95,640493,90.70853986687437,6
0.05,7061,92,640585,90.70872274143302,9
0.05,7062,95,640680,90.7093303128982,6
0.05,7063,95,640775,90.70993771234428,6
0.05,7064,94,640869,90.7104033970276,7
0.05,7065,95,640964,90.7110104726861,6
0.05,7066,96,641060,90.71175887929815,6
0.05,7067,92,641152,90.71194114318054,10
0.05,7068,94,641246,90.71240628094498,7
0.05,7069,95,641341,90.71301272984441,6
0.05,7070,90,641431,90.71291189365012,11
0.05,7071,92,641523,90.71309389140272,10
0.05,7072,96,641619,90.71384136858475,6
0.05,7073,95,641714,90.71444727169919,6
0.05,7074,93,641807,90.7147703180212,8
0.05,7075,93,641900,90.71509327303562,8
0.05,7076,94,641994,90.71555743959304,7
0.05,7077,96,642090,90.71630404068947,6
0.05,7078,95,642185,90.71690916796157,6
0.05,7079,95,642280,90.71751412429379,6
0.05,7080,93,642373,90.71783646377631,8
0.05,7081,92,642465,90.7180175091782,9
0.05,7082,94,642559,90.71848086968798,7
0.05,7083,92,642651,90.7186617730096,9
0.05,7084,93,642744,90.71898376852505,8
0.05,7085,95,642839,90.71958791984194,6
0.05,7086,27,642866,90.71059686750388,6
0.05,7087,94,642960,90.71106094808127,7
0.05,7088,95,643055,90.71166596134857,6
0.05,7089,94,643149,90.71212976022566,7
0.05,7090,92,643241,90.71231138062332,9
0.05,7091,92,643333,90.7124929498026,9
0.05,7092,94,643427,90.71295643592273,7
0.05,7093,93,643520,90.7132788271779,8
0.05,7094,92,643612,90.71346018322762,9
0.05,7095,95,643707,90.7140642615558,7
0.05,7096,92,643799,90.7142454558264,10
0.05,7097,93,643892,90.71456748379825,8
0.05,7098,94,643986,90.71503028595576,7
0.05,7099,94,644080,90.71549295774648,7
0.05,7100,94,644174,90.71595549922546,7
0.05,7101,94,644268,90.71641791044776,7
0.05,7102,96,644364,90.71716176263551,6
0.05,7103,92,644456,90.71734234234235,9
0.05,7104,94,644550,90.71780436312456,7
0.05,7105,93,644643,90.71812552772305,8
0.05,7106,92,644735,90.71830589559589,9
0.05,7107,90,644825,90.71820483961733,12
0.05,7108,94,644919,90.71866647911098,7
0.05,7109,26,644945,90.70956399437412,7
0.05,7110,23,644968,90.70004218815919,10
0.05,7111,92,645060,90.70022497187851,10
0.05,7112,93,645153,90.70054829185997,8
0.05,7113,92,645245,90.70073095305032,9
0.05,7114,96,645341,90.70147575544624,6
0.05,7115,93,645434,90.7017987633502,8
0.05,7116,95,645529,90.70240269776592,6
0.05,7117,94,645623,90.70286597358809,7
0.05,7118,94,645717,90.70332911925833,8
0.05,7119,94,645811,90.70379213483146,8
0.05,7120,96,645907,90.70453587979216,6
0.05,7121,92,645999,90.70471777590565,9
0.05,7122,96,646095,90.7054611820862,6
0.05,7123,27,646122,90.69651880965749,6
0.05,7124,94,646216,90.69698245614035,7
0.05,7125,95,646311,90.69758630367667,6
0.05,7126,94,646405,90.69804967026799,7
0.05,7127,95,646500,90.6986531986532,7
0.05,7128,94,646594,90.69911628559406,7
0.05,7129,93,646687,90.69943899018233,8
0.05,7130,94,646781,90.6999018370495,7
0.05,7131,91,646872,90.69994391475042,10
0.05,7132,93,646965,90.70026636758728,8
0.05,7133,94,647059,90.70072890384077,8
0.05,7134,94,647153,90.70119131044149,7
0.05,7135,92,647245,90.70137331838565,10
0.05,7136,94,647339,90.70183550511419,7
0.05,7137,92,647431,90.70201737181283,9
0.05,7138,96,647527,90.70275949012466,6
0.05,7139,92,647619,90.70294117647059,10
0.05,7140,92,647711,90.7031228119311,9
0.05,7141,94,647805,90.70358443013161,7
0.05,7142,94,647899,90.70404591908162,7
0.05,7143,94,647993,90.7045072788354,7
0.05,7144,89,648082,90.70426871938419,12
0.05,7145,95,648177,90.7048698572628,7
0.05,7146,95,648272,90.70547082692039,6
0.05,7147,94,648366,90.70593172915501,7
0.05,7148,96,648462,90.7066722618548,6
0.05,7149,93,648555,90.706993006993,9
0.05,7150,95,648650,90.70759334358831,6
0.05,7151,95,648745,90.70819351230425,6
0.05,7152,95,648840,90.70879351321123,6
0.05,7153,96,648936,90.70953312831982,6
0.05,7154,91,649027,90.70957372466806,11
0.05,7155,95,649122,90.71017328116267,6
0.05,7156,96,649218,90.71091239346094,6
0.05,7157,94,649312,90.71137189158983,7
0.05,7158,93,649405,90.7116915770359,8
0.05,7159,93,649498,90.71201117318435,8
0.05,7160,96,649594,90.71274961597543,6
0.05,7161,95,649689,90.7133482267523,6
0.05,7162,96,649785,90.7140862766997,6
0.05,7163,94,649879,90.714544946957,7
0.05,7164,94,649973,90.71500348918353,7
0.05,7165,92,650065,90.71518280770304,9
0.05,7166,93,650158,90.71550160457653,8
0.05,7167,93,650251,90.7158203125,8
0.05,7168,95,650346,90.71641791044776,6
0.05,7169,96,650442,90.71715481171547,6
0.05,7170,96,650538,90.7178915074606,6
0.05,7171,91,650629,90.71793084216397,12
0.05,7172,94,650723,90.718388400948,7
0.05,7173,95,650818,90.71898522442152,6
0.05,7174,94,650912,90.7194425087108,7
0.05,7175,94,651006,90.71989966555184,7
0.05,7176,94,651100,90.7203566949979,7
0.05,7177,94,651194,90.72081359710225,7
0.05,7178,94,651288,90.7212703719181,8
0.05,7179,91,651379,90.72130919220055,10
0.05,7180,94,651473,90.72176577078402,7
0.05,7181,95,651568,90.72236145920357,6
0.05,7182,94,651662,90.72281776416538,7
0.05,7183,92,651754,90.72299554565701,9
0.05,7184,95,651849,90.72359081419624,7
0.05,7185,93,651942,90.72390759810743,8
0.05,7186,24,651966,90.71462362599138,9
0.05,7187,96,652062,90.71535893155259,6
0.05,7188,95,652157,90.71595493114481,6
0.05,7189,27,652184,90.70709318497914,6
0.05,7190,95,652279,90.70769016826588,6
0.05,7191,96,652375,90.70842602892102,6
0.05,7192,94,652469,90.70888363686917,7
0.05,7193,94,652563,90.709341117598,7
0.05,7194,93,652656,90.709659485754,8
0.05,7195,95,652751,90.71025569760978,6
0.05,7196,96,652847,90.71099069056551,6
0.05,7197,93,652940,90.71130869686024,8
0.05,7198,95,653035,90.71190443117099,6
0.05,7199,94,653129,90.71236111111111,7
0.05,7200,95,653224,90.71295653381475,6
0.05,7201,96,653320,90.71369064148847,6
0.05,7202,94,653414,90.71414688324309,7
0.05,7203,93,653507,90.71446418656302,8
0.05,7204,96,653603,90.71519777931992,6
0.05,7205,87,653690,90.71468220927005,14
0.05,7206,93,653783,90.71499930623006,8
0.05,7207,93,653876,90.71531631520533,8
0.05,7208,94,653970,90.715771951727,7
0.05,7209,95,654065,90.71636615811373,7
0.05,7210,94,654159,90.7168215226737,7
0.05,7211,95,654254,90.71741541874654,6
0.05,7212,94,654348,90.71787051157632,7
0.05,7213,96,654444,90.71860271693929,6
0.05,7214,94,654538,90.71905751905751,7
0.05,7215,94,654632,90.71951219512195,8
0.05,7216,93,654725,90.71982818345573,8
0.05,7217,93,654818,90.72014408423387,8
0.05,7218,93,654911,90.72045989749273,8
0.05,7219,94,655005,90.72091412742382,8
0.05,7220,96,655101,90.72164520149563,6
0.05,7221,83,655184,90.72057601772362,19
0.05,7222,96,655280,90.7213069361761,6
0.05,7223,91,655371,90.72134551495017,10
0.05,7224,91,655462,90.72138408304498,10
0.05,7225,95,655557,90.72197619706616,7
0.05,7226,93,655650,90.72229140722291,8
0.05,7227,96,655746,90.72302158273381,6
0.05,7228,95,655841,90.72361322451238,6
0.05,7229,94,655935,90.7240663900415,7
0.05,7230,93,656028,90.72438113677224,9
0.05,7231,92,656120,90.72455752212389,9
0.05,7232,96,656216,90.7252868795797,6
0.05,7233,93,656309,90.72560132706663,9
0.05,7234,96,656405,90.72633033863166,7
0.05,7235,94,656499,90.72678275290215,7
0.05,7236,94,656593,90.72723504214453,7
0.05,7237,91,656684,90.72727272727273,11
0.05,7238,94,656778,90.7277248238707,7
0.05,7239,94,656872,90.72817679558011,8
0.05,7240,96,656968,90.72890484739676,6
0.05,7241,94,657062,90.72935653134493,7
0.05,7242,94,657156,90.7298080905702,7
0.05,7243,93,657249,90.7301214798454,8
0.05,7244,95,657344,90.73071083505866,6
0.05,7245,95,657439,90.73130002760143,6
0.05,7246,93,657532,90.73161308127501,8
0.05,7247,92,657624,90.73178807947019,9
0.05,7248,96,657720,90.73251482963167,6
0.05,7249,94,657814,90.73296551724138,7
0.05,7250,96,657910,90.73369190456489,6
0.05,7251,96,658006,90.73441809156095,6
0.05,7252,94,658100,90.73486833034606,8
0.05,7253,92,658192,90.73504273504274,9
0.05,7254,95,658287,90.73563059958649,6
0.05,7255,95,658382,90.73621830209481,6
0.05,7256,94,658476,90.73666804464655,7
0.05,7257,91,658567,90.73670432626068,11
0.05,7258,96,658663,90.7374293979887,6
0.05,7259,93,658756,90.73774104683196,9
0.05,7260,96,658852,90.7384657760639,6
0.05,7261,93,658945,90.73877719636464,9
0.05,7262,91,659036,90.73881316260498,10
0.05,7263,96,659132,90.73953744493392,6
0.05,7264,94,659226,90.73998623537508,7
0.05,7265,95,659321,90.74057252958987,6
0.05,7266,93,659414,90.7408834457135,8
0.05,7267,96,659510,90.74160704457897,6
0.05,7268,94,659604,90.74205530334297,7
0.05,7269,90,659694,90.74195323246218,11
0.05,7270,94,659788,90.74240132031358,7
0.05,7271,93,659881,90.74271177117711,8
0.05,7272,94,659975,90.74315963151382,7
0.05,7273,92,660067,90.74333241682706,9
0.05,7274,96,660163,90.74405498281787,6
0.05,7275,92,660255,90.74422759758109,9
0.05,7276,94,660349,90.74467500343547,7
0.05,7277,92,660441,90.74484748557296,9
0.05,7278,94,660535,90.74529468333563,7
0.05,7279,91,660626,90.74532967032967,10
0.05,7280,95,660721,90.74591402279907,7
0.05,7281,92,660813,90.74608624004395,10
0.05,7282,96,660909,90.74680763421667,6
0.05,7283,95,661004,90.74739154310818,6
0.05,7284,94,661098,90.74783802333562,7
0.05,7285,91,661189,90.74787263244579,10
0.05,7286,95,661284,90.74845615479622,6
0.05,7287,96,661380,90.74917672886937,6
0.05,7288,95,661475,90.74975991219647,6
0.05,7289,88,661563,90.74938271604938,13
0.05,7290,94,661657,90.74982855575367,7
0.05,7291,93,661750,90.75013713658804,8
0.05,7292,94,661844,90.75058275058275,7
0.05,7293,94,661938,90.751028242391,7
0.05,7294,93,662031,90.75133653187115,8
0.05,7295,94,662125,90.75178179824562,7
0.05,7296,92,662217,90.75195285733864,9
0.05,7297,95,662312,90.75253494107974,6
0.05,7298,95,662407,90.75311686532402,6
0.05,7299,94,662501,90.75356164383561,7
0.05,7300,93,662594,90.75386933296808,8
0.05,7301,96,662690,90.75458778416872,6
0.05,7302,93,662783,90.754895248528,8
0.05,7303,95,662878,90.75547645125958,6
0.05,7304,94,662972,90.75592060232718,7
0.05,7305,95,663067,90.75650150561182,6
0.05,7306,94,663161,90.75694539482687,7
0.05,7307,93,663254,90.75725232621784,8
0.05,7308,93,663347,90.75755917362156,8
0.05,7309,89,663436,90.75731874145006,13
0.05,7310,92,663528,90.75748871563398,9
0.05,7311,91,663619,90.75752188183807,11
0.05,7312,91,663710,90.75755503897169,10
0.05,7313,94,663804,90.75799835931092,7
0.05,7314,96,663900,90.75871496924128,6
0.05,7315,94,663994,90.75915800984144,7
0.05,7316,94,664088,90.75960092934262,7
0.05,7317,94,664182,90.76004372779448,7
0.05,7318,94,664276,90.76048640524662,7
0.05,7319,19,664295,90.7506830601093,13
0.05,7320,93,664388,90.75099030187133,8
0.05,7321,93,664481,90.75129745971046,8
0.05,7322,94,664575,90.75174108971733,7
0.05,7323,25,664600,90.74276351720371,7
0.05,7324,94,664694,90.74320819112629,7
0.05,7325,94,664788,90.74365274365275,8
0.05,7326,94,664882,90.74409717483282,7
0.05,7327,96,664978,90.74481441048034,6
0.05,7328,93,665071,90.74512211761495,8
0.05,7329,95,665166,90.74570259208731,6
0.05,7330,94,665260,90.74614650115946,7
0.05,7331,95,665355,90.74672667757774,6
0.05,7332,96,665451,90.74744306559388,6
0.05,7333,93,665544,90.74775020452687,10
0.05,7334,95,665639,90.74832992501705,6
0.05,7335,25,665664,90.73936750272628,8
0.05,7336,93,665757,90.73967561673709,8
0.05,7337,95,665852,90.74025620059962,6
0.05,7338,94,665946,90.74070036789753,7
0.05,7339,93,666039,90.74100817438692,8
0.05,7340,94,666133,90.74145211824002,7
0.05,7341,96,666229,90.7421683464996,6
0.05,7342,94,666323,90.74261201143946,7
0.05,7343,95,666418,90.7431917211329,6
0.05,7344,96,666514,90.74390742001361,6
0.05,7345,94,666608,90.74435066702968,7
0.05,7346,94,666702,90.74479379338506,7
0.05,7347,93,666795,90.74510070767556,8
0.05,7348,94,666889,90.7455436113757,7
0.05,7349,92,666981,90.74571428571429,10
0.05,7350,96,667077,90.74642905727111,6
0.05,7351,95,667172,90.74700761697497,6
0.05,7352,94,667266,90.74745002039984,7
0.05,7353,94,667360,90.7478923035083,7
0.05,7354,93,667453,90.74819850441877,8
0.05,7355,94,667547,90.74864056552474,7
0.05,7356,91,667638,90.74867473154819,10
0.05,7357,95,667733,90.74925251427018,6
0.05,7358,95,667828,90.74983013996467,7
0.05,7359,96,667924,90.75054347826087,6
0.05,7360,94,668018,90.7509849205271,7
0.05,7361,94,668112,90.75142624286879,7
0.05,7362,94,668206,90.75186744533478,8
0.05,7363,96,668302,90.75258011950027,6
0.05,7364,94,668396,90.7530210454854,7
0.05,7365,91,668487,90.75305457507467,11
0.05,7366,93,668580,90.75335957648976,8
0.05,7367,94,668674,90.75380021715526,7
0.05,7368,93,668767,90.75410503460442,8
0.05,7369,94,668861,90.75454545454545,7
0.05,7370,94,668955,90.75498575498575,7
0.05,7371,94,669049,90.75542593597396,7
0.05,7372,94,669143,90.75586599755866,7
0.05,7373,94,669237,90.75630593978845,7
0.05,7374,91,669328,90.75633898305085,10
0.05,7375,96,669424,90.75704989154013,6
0.05,7376,94,669518,90.75748949437441,7
0.05,7377,93,669611,90.75779343995663,9
0.05,7378,93,669704,90.75809730315761,8
0.05,7379,27,669731,90.74945799457994,6
0.05,7380,94,669825,90.74989838775234,7
0.05,7381,94,669919,90.75033866160932,7
0.05,7382,95,670014,90.75091426249492,8
0.05,7383,94,670108,90.7513542795233,8
0.05,7384,93,670201,90.75165876777251,8
0.05,7385,94,670295,90.75209856485242,7
0.05,7386,93,670388,90.75240286990659,8
0.05,7387,96,670484,90.75311315646995,6
0.05,7388,-44,670440,90.73487616727569,8
0.05,7389,94,670534,90.73531799729363,8
0.05,7390,95,670629,90.73589500744148,6
0.05,7391,93,670722,90.7362012987013,8
0.05,7392,95,670817,90.73677803327472,7
0.05,7393,92,670909,90.73694887746822,9
0.05,7394,94,671003,90.73739012846518,7
0.05,7395,90,671093,90.73729042725797,11
0.05,7396,94,671187,90.73773151277545,8
0.05,7397,93,671280,90.73803730738037,8
0.05,7398,27,671307,90.7294228949858,6
0.05,7399,92,671399,90.7295945945946,9
0.05,7400,94,671493,90.73003648155655,7
0.05,7401,92,671585,90.73020805187787,9
0.05,7402,94,671679,90.73064973659328,7
0.05,7403,93,671772,90.73095623987034,9
0.05,7404,95,671867,90.73153274814315,6
0.05,7405,93,671960,90.73183904941939,8
0.05,7406,93,672053,90.73214526798974,8
0.05,7407,93,672146,90.7324514038877,10
0.05,7408,93,672239,90.73275745714672,8
0.05,7409,92,672331,90.73292847503375,9
0.05,7410,94,672425,90.7333693158818,7
0.05,7411,27,672452,90.72477064220183,6
0.05,7412,92,672544,90.72494266828545,9
0.05,7413,95,672639,90.72551928783383,6
0.05,7414,95,672734,90.72609575185434,6
0.05,7415,93,672827,90.72640237324703,8
0.05,7416,96,672923,90.72711338816232,6
0.05,7417,96,673019,90.72782421137774,6
0.05,7418,95,673114,90.72840005391562,6
0.05,7419,94,673208,90.7288409703504,7
0.05,7420,95,673303,90.72941652068454,6
0.05,7421,94,673397,90.72985718135274,7
0.05,7422,94,673491,90.73029772329247,7
0.05,7423,92,673583,90.73046875,9
0.05,7424,96,673679,90.73117845117845,6
0.05,7425,91,673770,90.73121465122543,10
0.05,7426,92,673862,90.73138548539114,9
0.05,7427,90,673952,90.73128702207862,11
0.05,7428,94,674046,90.73172701574909,8
0.05,7429,93,674139,90.73203230148049,8
0.05,7430,95,674234,90.73260664782667,6
0.05,7431,90,674324,90.73250807319698,14
0.05,7432,94,674418,90.7329476658146,8
0.05,7433,94,674512,90.7333871401668,7
0.05,7434,93,674605,90.73369199731002,8
0.05,7435,91,674696,90.73372781065089,10
0.05,7436,94,674790,90.73416700282372,7
0.05,7437,94,674884,90.7346060769024,7
0.05,7438,94,674978,90.73504503293454,7
0.05,7439,93,675071,90.73534946236559,8
0.05,7440,94,675165,90.73578820051068,7
0.05,7441,94,675259,90.7362268207471,7
0.05,7442,94,675353,90.7366653231224,7
0.05,7443,93,675446,90.73696937130575,8
0.05,7444,94,675540,90.73740765614507,7
0.05,7445,89,675629,90.73717432178351,12
0.05,7446,94,675723,90.73761246139385,7
0.05,7447,94,675817,90.73805048335123,7
0.05,7448,88,675905,90.73768291045778,13
0.05,7449,95,676000,90.73825503355705,6
0.05,7450,92,676092,90.73842437256744,9
0.05,7451,91,676183,90.73845947396671,10
0.05,7452,94,676277,90.73889708842077,7
0.05,7453,89,676366,90.73866380466863,12
0.05,7454,95,676461,90.73923541247486,6
0.05,7455,91,676552,90.7392703862661,10
0.05,7456,95,676647,90.73984175942068,6
0.05,7457,21,676668,90.73049074818987,11
0.05,7458,91,676759,90.73052688027886,10
0.05,7459,95,676854,90.73109919571046,6
0.05,7460,96,676950,90.73180538801769,6
0.05,7461,94,677044,90.73224336638971,7
0.05,7462,96,677140,90.73294921613292,6
0.05,7463,91,677231,90.73298499464094,11
0.05,7464,94,677325,90.73342263898192,7
0.05,7465,96,677421,90.73412804714707,6
0.05,7466,95,677516,90.7346993437793,6
0.05,7467,94,677610,90.73513658275309,7
0.05,7468,93,677703,90.73543981791404,8
0.05,7469,96,677799,90.73614457831326,6
0.05,7470,92,677891,90.73631374648642,9
0.05,7471,94,677985,90.73675053533191,7
0.05,7472,94,678079,90.73718720727953,7
0.05,7473,94,678173,90.73762376237623,7
0.05,7474,94,678267,90.7380602006689,7
0.05,7475,94,678361,90.73849652220439,7
0.05,7476,94,678455,90.73893272702956,8
0.05,7477,94,678549,90.73936881519123,7
0.05,7478,90,678639,90.73926995587645,11
0.05,7479,91,678730,90.73930481283422,10
0.05,7480,94,678824,90.73974067638017,7
0.05,7481,90,678914,90.73964180700348,11
0.05,7482,93,679007,90.7399438727783,8
0.05,7483,96,679103,90.74064671298771,6
0.05,7484,94,679197,90.74108216432866,8
0.05,7485,90,679287,90.74098316858135,12
0.05,7486,94,679381,90.74141845866168,7
0.05,7487,25,679406,90.73263888888889,7
0.05,7488,94,679500,90.73307517692616,7
0.05,7489,91,679591,90.73311081441922,10
0.05,7490,92,679683,90.73327993592311,10
0.05,7491,94,679777,90.7337159636946,7
0.05,7492,91,679868,90.73375150140131,10
0.05,7493,96,679964,90.7344542300507,6
0.05,7494,94,680058,90.73488992661774,7
0.05,7495,94,680152,90.73532550693703,7
0.05,7496,92,680244,90.73549419767907,9
0.05,7497,91,680335,90.73552947452654,10
0.05,7498,94,680429,90.73596479530605,7
0.05,7499,94,680523,90.7364,7
0.05,7500,95,680618,90.73696840421277,6
0.05,7501,93,680711,90.73727006131698,8
0.05,7502,94,680805,90.73770491803279,7
0.05,7503,95,680900,90.73827292110875,6
0.05,7504,93,680993,90.73857428381079,8
0.05,7505,95,681088,90.73914201971756,8
0.05,7506,91,681179,90.73917676834954,10
0.05,7507,90,681269,90.73907831646244,11
0.05,7508,96,681365,90.73977893194832,6
0.05,7509,94,681459,90.74021304926764,8
0.05,7510,95,681554,90.74078018905605,6
0.05,7511,93,681647,90.7410809371672,8
0.05,7512,92,681739,90.7412485025955,9
0.05,7513,94,681833,90.74168219323928,7
0.05,7514,92,681925,90.7418496340652,9
0.05,7515,94,682019,90.74228312932411,8
0.05,7516,91,682110,90.74231741386191,10
0.05,7517,94,682204,90.74275073157754,7
0.05,7518,92,682296,90.74291794121558,9
0.05,7519,94,682390,90.74335106382979,7
0.05,7520,92,682482,90.7435181491823,9
0.05,7521,91,682573,90.7435522467429,10
0.05,7522,93,682666,90.74385218662768,8
0.05,7523,96,682762,90.74455077086657,6
0.05,7524,93,682855,90.74485049833888,8
0.05,7525,93,682948,90.74515014615997,8
0.05,7526,94,683042,90.74558256941677,8
0.05,7527,93,683135,90.74588204038257,8
0.05,7528,95,683230,90.74644707132421,7
0.05,7529,95,683325,90.74701195219123,6
0.05,7530,94,683419,90.74744389855265,7
0.05,7531,95,683514,90.74800849707913,6
0.05,7532,94,683608,90.74844019646888,7
0.05,7533,92,683700,90.74860631802495,9
0.05,7534,90,683790,90.74850696748507,11
0.05,7535,95,683885,90.74907112526539,6
0.05,7536,93,683978,90.74936977577285,8
0.05,7537,92,684070,90.74953568585832,9
0.05,7538,93,684163,90.74983419551664,8
0.05,7539,93,684256,90.7501326259947,8
0.05,7540,23,684279,90.74114838880784,10
0.05,7541,95,684374,90.74171307345532,6
0.05,7542,94,684468,90.74214503513191,7
0.05,7543,93,684561,90.74244432661717,8
0.05,7544,94,684655,90.74287607687211,7
0.05,7545,96,684751,90.74357275377683,6
0.05,7546,94,684845,90.7440042400954,7
0.05,7547,94,684939,90.74443561208267,7
0.05,7548,92,685031,90.744601934031,10
0.05,7549,91,685122,90.74463576158941,10
0.05,7550,92,685214,90.74480201297841,9
0.05,7551,95,685309,90.74536546610169,6
0.05,7552,93,685402,90.74566397457964,10
0.05,7553,96,685498,90.74635954461212,6
0.05,7554,94,685592,90.74679020516214,7
0.05,7555,94,685686,90.74722075172049,7
0.05,7556,96,685782,90.7479158396189,6
0.05,7557,96,685878,90.74861074358296,6
0.05,7558,94,685972,90.74904087842307,8
0.05,7559,92,686064,90.74920634920635,9
0.05,7560,95,686159,90.74976854913372,6
0.05,7561,94,686253,90.75019836022216,7
0.05,7562,96,686349,90.750892502975,6
0.05,7563,91,686440,90.7509254362771,11
0.05,7564,94,686534,90.75135492399207,8
0.05,7565,94,686628,90.75178429817605,7
0.05,7566,95,686723,90.75234571164266,6
0.05,7567,93,686816,90.75264270613108,8
0.05,7568,94,686910,90.75307173999207,7
0.05,7569,95,687005,90.75363276089828,6
0.05,7570,92,687097,90.75379738475763,10
0.05,7571,94,687191,90.75422609614368,7
0.05,7572,94,687285,90.75465469430873,8
0.05,7573,94,687379,90.7550831792976,7
0.05,7574,94,687473,90.75551155115511,7
0.05,7575,96,687569,90.75620380147835,6
0.05,7576,25,687594,90.74752540583344,8
0.05,7577,94,687688,90.74795460543679,7
0.05,7578,96,687784,90.74864757883626,6
0.05,7579,90,687874,90.74854881266491,11
0.05,7580,92,687966,90.74871388998812,9
0.05,7581,92,688058,90.74887892376681,9
0.05,7582,93,688151,90.74917578794673,10
0.05,7583,94,688245,90.74960443037975,7
0.05,7584,92,688337,90.7497692814766,9
0.05,7585,95,688432,90.75032955444239,6
0.05,7586,93,688525,90.75062607091077,8
0.05,7587,93,688618,90.75092250922509,8
0.05,7588,93,688711,90.75121886941626,8
0.05,7589,96,688807,90.75191040843215,6
0.05,7590,94,688901,90.75233829534976,7
0.05,7591,95,688996,90.75289778714436,6
0.05,7592,90,689086,90.7527986303174,11
0.05,7593,94,689180,90.75322623123519,7
0.05,7594,94,689274,90.75365371955233,7
0.05,7595,94,689368,90.75408109531332,7
0.05,7596,96,689464,90.75477162037646,6
0.05,7597,96,689560,90.75546196367465,6
0.05,7598,94,689654,90.7558889327543,7
0.05,7599,93,689747,90.75618421052631,8
0.05,7600,94,689841,90.7566109722405,7
0.05,7601,90,689931,90.75651144435675,11
0.05,7602,93,690024,90.75680652374062,8
0.05,7603,94,690118,90.75723303524461,7
0.05,7604,96,690214,90.75792241946088,6
0.05,7605,95,690309,90.75848014725217,7
0.05,7606,95,690404,90.75903772840805,6
0.05,7607,92,690496,90.75920084121977,9
0.05,7608,93,690589,90.75949533447233,8
0.05,7609,93,690682,90.75978975032851,8
0.05,7610,93,690775,90.76008408881881,8
0.05,7611,94,690869,90.76050972149238,7
0.05,7612,92,690961,90.76067253382372,9
0.05,7613,92,691053,90.76083530338849,10
0.05,7614,95,691148,90.76139198949441,6
0.05,7615,93,691241,90.76168592436974,9
0.05,7616,96,691337,90.76237363791519,6
0.05,7617,88,691425,90.76201102651615,13
0.05,7618,94,691519,90.76243601522509,7
0.05,7619,96,691615,90.76312335958005,6
0.05,7620,94,691709,90.76354809080173,7
0.05,7621,93,691802,90.76384151141433,8
0.05,7622,96,691898,90.76452840089203,6
0.05,7623,95,691993,90.76508394543546,6
0.05,7624,95,692088,90.7656393442623,6
0.05,7625,89,692177,90.76540781536848,12
0.05,7626,94,692271,90.76583191294087,7
0.05,7627,93,692364,90.76612480335605,8
0.05,7628,92,692456,90.76628653820947,10
0.05,7629,89,692545,90.76605504587155,12
0.05,7630,95,692640,90.76660988074957,8
0.05,7631,94,692734,90.76703354297693,8
0.05,7632,94,692828,90.76745709419626,7
0.05,7633,95,692923,90.76801152737752,6
0.05,7634,90,693013,90.76791093647675,11
0.05,7635,95,693108,90.76846516500785,7
0.05,7636,90,693198,90.76836454105015,11
0.05,7637,95,693293,90.76891856506938,6
0.05,7638,96,693389,90.76960335122398,6
0.05,7639,96,693485,90.77028795811518,6
0.05,7640,91,693576,90.77031802120142,10
0.05,7641,94,693670,90.77074064381053,7
0.05,7642,91,693761,90.77077063980113,10
0.05,7643,96,693857,90.77145473574045,6
0.05,7644,94,693951,90.77187704381949,7
0.05,7645,90,694041,90.77177609207429,11
0.05,7646,96,694137,90.77245978815222,6
0.05,7647,93,694230,90.7727510460251,8
0.05,7648,96,694326,90.77343443587397,6
0.05,7649,21,694347,90.7643137254902,12
0.05,7650,27,694374,90.75597961050843,6
0.05,7651,92,694466,90.75614218504965,10
0.05,7652,96,694562,90.75682738795244,6
0.05,7653,94,694656,90.75725111053045,7
0.05,7654,91,694747,90.75728282168517,10
0.05,7655,92,694839,90.75744514106583,9
0.05,7656,27,694866,90.7491184537025,6
0.05,7657,95,694961,90.74967354400627,8
0.05,7658,95,695056,90.75022848935892,7
0.05,7659,94,695150,90.75065274151436,7
0.05,7660,96,695246,90.75133794543794,6
0.05,7661,91,695337,90.75137039937353,10
0.05,7662,95,695432,90.75192483361607,6
0.05,7663,93,695525,90.75221816283924,10
0.05,7664,96,695621,90.7529028049576,6
0.05,7665,93,695714,90.75319593008088,8
0.05,7666,96,695810,90.75388026607538,6
0.05,7667,93,695903,90.75417318727177,8
0.05,7668,93,695996,90.75446603207719,8
0.05,7669,94,696090,90.75488917861799,7
0.05,7670,95,696185,90.75544257593535,6
0.05,7671,95,696280,90.75599582898853,6
0.05,7672,95,696375,90.75654893783397,6
0.05,7673,92,696467,90.75671097211362,9
0.05,7674,94,696561,90.7571335504886,7
0.05,7675,94,696655,90.75755601875977,7
0.05,7676,94,696749,90.75797837697017,7
0.05,7677,94,696843,90.7584006251628,7
0.05,7678,91,696934,90.7584320875114,11
0.05,7679,92,697026,90.75859375,9
0.05,7680,96,697122,90.7592761359198,6
0.05,7681,94,697216,90.75969799531372,7
0.05,7682,95,697311,90.76024990238189,6
0.05,7683,96,697407,90.76093180635085,6
0.05,7684,96,697503,90.76161353285622,6
0.05,7685,95,697598,90.76216497527973,7
0.05,7686,94,697692,90.76258618446728,7
0.05,7687,94,697786,90.76300728407908,7
0.05,7688,93,697879,90.76329821823384,9
0.05,7689,94,697973,90.76371911573472,7
0.05,7690,96,698069,90.76439994799115,6
0.05,7691,93,698162,90.7646905876235,8
0.05,7692,24,698186,90.7560119589237,9
0.05,7693,94,698280,90.75643358461139,8
0.05,7694,95,698375,90.75698505523067,6
0.05,7695,92,698467,90.75714656964657,9
0.05,7696,91,698558,90.75717812134597,10
0.05,7697,94,698652,90.75759937646141,7
0.05,7698,95,698747,90.75815040914405,6
0.05,7699,95,698842,90.7587012987013,7
0.05,7700,94,698936,90.75912219192313,8
0.05,7701,96,699032,90.75980264866268,6
0.05,7702,92,699124,90.75996365052576,9
0.05,7703,94,699218,90.76038421599169,7
0.05,7704,95,699313,90.76093445814406,7
0.05,7705,94,699407,90.76135478847651,7
0.05,7706,95,699502,90.76190476190476,7
0.05,7707,24,699526,90.75324338349766,9
0.05,7708,95,699621,90.75379426644182,6
0.05,7709,96,699717,90.7544747081712,6
0.05,7710,91,699808,90.75450654908572,11
0.05,7711,94,699902,90.75492738589212,7
0.05,7712,94,699996,90.75534811357448,8
0.05,7713,96,700092,90.75602800103708,6
0.05,7714,95,700187,90.75657809462086,6
0.05,7715,95,700282,90.7571280456195,6
0.05,7716,89,700371,90.7569003498769,12
0.05,7717,94,700465,90.75732054936512,7
0.05,7718,92,700557,90.75748153905947,9
0.05,7719,96,700653,90.75816062176166,6
0.05,7720,95,700748,90.75871001165652,6
0.05,7721,94,700842,90.75912975912976,7
0.05,7722,94,700936,90.75954939790238,7
0.05,7723,90,701026,90.7594510616261,11
0.05,7724,95,701121,90.76,6
0.05,7725,94,701215,90.76041936318923,7
0.05,7726,89,701304,90.76019153617186,13
0.05,7727,91,701395,90.76022256728778,11
0.05,7728,94,701489,90.76064173890542,7
0.05,7729,94,701583,90.76106080206986,7
0.05,7730,92,701675,90.76122105807787,9
0.05,7731,92,701767,90.76138127263322,10
0.05,7732,94,701861,90.76180007758956,7
0.05,7733,94,701955,90.76221877424359,7
0.05,7734,27,701982,90.75397543632837,6
0.05,7735,92,702074,90.75413650465357,9
0.05,7736,93,702167,90.75442678040584,8
0.05,7737,94,702261,90.75484621349186,7
0.05,7738,94,702355,90.75526553818322,7
0.05,7739,94,702449,90.75568475452197,7
0.05,7740,96,702545,90.75636222710244,6
0.05,7741,94,702639,90.75678119349006,7
0.05,7742,94,702733,90.75720005165957,7
0.05,7743,94,702827,90.7576188016529,7
0.05,7744,94,702921,90.75803744351194,7
0.05,7745,93,703014,90.75832687838884,8
0.05,7746,95,703109,90.7588744029947,6
0.05,7747,92,703201,90.7590345895715,9
0.05,7748,96,703297,90.75971093044264,6
0.05,7749,92,703389,90.75987096774193,10
0.05,7750,93,703482,90.7601599793575,9
0.05,7751,94,703576,90.76057791537667,7
0.05,7752,94,703670,90.76099574358312,7
0.05,7753,96,703766,90.76167139540883,6
0.05,7754,96,703862,90.76234687298518,6
0.05,7755,92,703954,90.76250644662197,9
0.05,7756,96,704050,90.76318164238752,6
0.05,7757,92,704142,90.76334106728538,10
0.05,7758,94,704236,90.76375821626499,8
0.05,7759,94,704330,90.76417525773196,7
0.05,7760,94,704424,90.76459219172787,7
0.05,7761,93,704517,90.76488018551919,8
0.05,7762,94,704611,90.76529692129331,7
0.05,7763,86,704697,90.7646831530139,16
0.05,7764,90,704787,90.76458467482293,11
0.05,7765,91,704878,90.76461498841103,10
0.05,7766,94,704972,90.76503154371058,7
0.05,7767,95,705067,90.76557672502575,6
0.05,7768,93,705160,90.76586433260394,8
0.05,7769,93,705253,90.76615186615187,8
0.05,7770,93,705346,90.7664393256981,8
0.05,7771,95,705441,90.76698404529078,6
0.05,7772,95,705536,90.76752862472662,6
0.05,7773,92,705628,90.76768716233599,9
0.05,7774,93,705721,90.76797427652733,8
0.05,7775,94,705815,90.76838991769547,7
0.05,7776,95,705910,90.76893403626077,6
0.05,7777,94,706004,90.76934944715865,8
0.05,7778,96,706100,90.7700218537087,6
0.05,7779,94,706194,90.77043701799487,7
0.05,7780,92,706286,90.77059503919804,10
0.05,7781,94,706380,90.7710100231303,8
0.05,7782,94,706474,90.771424900424,8
0.05,7783,93,706567,90.7717112024666,8
0.05,7784,92,706659,90.7718689788054,9
0.05,7785,88,706747,90.77151297200103,13
0.05,7786,95,706842,90.77205599075383,6
0.05,7787,94,706936,90.77247046738572,7
0.05,7788,94,707030,90.77288483759148,7
0.05,7789,27,707057,90.76469833119384,6
0.05,7790,93,707150,90.76498523937877,8
0.05,7791,90,707240,90.76488706365502,11
0.05,7792,90,707330,90.76478891312716,11
0.05,7793,92,707422,90.76494739543239,9
0.05,7794,96,707518,90.76561898652983,6
0.05,7795,94,707612,90.76603386351975,7
0.05,7796,93,707705,90.76632037963319,9
0.05,7797,94,707799,90.76673506027187,7
0.05,7798,94,707893,90.76714963456854,7
0.05,7799,94,707987,90.76756410256411,7
0.05,7800,90,708077,90.76746570952442,11
0.05,7801,94,708171,90.76788003076135,7
0.05,7802,94,708265,90.76829424580289,8
0.05,7803,90,708355,90.76819579702716,11
0.05,7804,94,708449,90.76860986547085,7
0.05,7805,91,708540,90.76863950807072,10
0.05,7806,93,708633,90.7689253234277,8
0.05,7807,94,708727,90.76933913934427,7
0.05,7808,91,708818,90.76936867716736,10
0.05,7809,94,708912,90.7697823303457,7
0.05,7810,95,709007,90.77032390218922,6
0.05,7811,92,709099,90.77048131080389,9
0.05,7812,95,709194,90.77102265455011,6
0.05,7813,95,709289,90.77156385973893,6
0.05,7814,94,709383,90.77197696737043,7
0.05,7815,93,709476,90.77226202661208,8
0.05,7816,96,709572,90.77293079186389,6
0.05,7817,96,709668,90.77359938603223,6
0.05,7818,94,709762,90.77401202199769,8
0.05,7819,94,709856,90.77442455242966,7
0.05,7820,94,709950,90.77483697736862,7
0.05,7821,95,710045,90.77537714139606,6
0.05,7822,94,710139,90.77578933912821,7
0.05,7823,94,710233,90.77620143149284,7
0.05,7824,92,710325,90.77635782747603,9
0.05,7825,96,710421,90.77702530028111,6
0.05,7826,96,710517,90.77769260252971,6
0.05,7827,96,710613,90.77835973428718,6
0.05,7828,96,710709,90.77902669561885,6
0.05,7829,94,710803,90.7794380587484,7
0.05,7830,94,710897,90.77984931681777,7
0.05,7831,93,710990,90.78013278855975,8
0.05,7832,94,711084,90.78054385292991,7
0.05,7833,93,711177,90.78082716364565,8
0.05,7834,95,711272,90.78136566687938,7
0.05,7835,94,711366,90.78177641653905,7
0.05,7836,92,711458,90.78193186168177,9
0.05,7837,95,711553,90.7824700178617,6
0.05,7838,91,711644,90.7824977675724,10
0.05,7839,95,711739,90.78303571428572,6
0.05,7840,95,711834,90.78357352378524,6
0.05,7841,93,711927,90.78385615914307,8
0.05,7842,95,712022,90.78439372689022,6
0.05,7843,94,712116,90.78480367159612,7
0.05,7844,92,712208,90.78495857233906,9
0.05,7845,94,712302,90.78536834055569,7
0.05,7846,94,712396,90.78577800433287,7
0.05,7847,94,712490,90.7861875637105,7
0.05,7848,95,712585,90.78672442349344,6
0.05,7849,94,712679,90.78713375796178,8
0.05,7850,94,712773,90.78754298815437,7
0.05,7851,94,712867,90.78795211411105,8
0.05,7852,94,712961,90.78836113587164,7
0.05,7853,94,713055,90.78877005347593,7
0.05,7854,93,713148,90.78905155951624,8
0.05,7855,88,713236,90.7886965376782,14
0.05,7856,92,713328,90.78885070637648,9
0.05,7857,94,713422,90.78925935352507,7
0.05,7858,92,713514,90.78941341137549,9
0.05,7859,94,713608,90.78982188295166,7
0.05,7860,89,713697,90.7895941992113,12
0.05,7861,95,713792,90.79012973798015,7
0.05,7862,92,713884,90.79028360676587,9
0.05,7863,96,713980,90.7909460834181,6
0.05,7864,93,714073,90.79122695486332,8
0.05,7865,94,714167,90.79163488431223,8
0.05,7866,91,714258,90.79166137028092,10
0.05,7867,94,714352,90.79206914082359,7
0.05,7868,89,714441,90.79184140297369,12
0.05,7869,94,714535,90.79224904701398,8
0.05,7870,89,714624,90.79202134417481,12
0.05,7871,94,714718,90.79242886178862,7
0.05,7872,96,714814,90.79309030864981,6
0.05,7873,95,714909,90.79362458724917,7
0.05,7874,92,715001,90.79377777777778,9
0.05,7875,93,715094,90.79405789740986,8
0.05,7876,93,715187,90.7943379459185,8
0.05,7877,94,715281,90.7947448591013,7
0.05,7878,94,715375,90.79515166899353,7
0.05,7879,95,715470,90.79568527918782,6
0.05,7880,92,715562,90.79583809161274,9
0.05,7881,96,715658,90.79649835067242,6
0.05,7882,92,715750,90.79665102118483,9
0.05,7883,95,715845,90.79718417047184,7
0.05,7884,95,715940,90.79771718452758,7
0.05,7885,94,716034,90.79812325640376,7
0.05,7886,93,716127,90.7984024343857,8
0.05,7887,94,716221,90.79880831643003,8
0.05,7888,94,716315,90.79921409557612,7
0.05,7889,95,716410,90.79974651457542,7
0.05,7890,96,716506,90.80040552528196,6
0.05,7891,90,716596,90.80030410542321,11
0.05,7892,96,716692,90.80096287849993,6
0.05,7893,94,716786,90.80136812769192,7
0.05,7894,95,716881,90.80189993666878,6
0.05,7895,95,716976,90.80243161094225,6
0.05,7896,93,717069,90.80270988983158,8
0.05,7897,94,717163,90.80311471258547,7
0.05,7898,94,717257,90.8035194328396,7
0.05,7899,96,717353,90.80417721518987,6
0.05,7900,89,717442,90.803948867232,13
0.05,7901,94,717536,90.80435332827132,7
0.05,7902,93,717629,90.80463115272681,10
0.05,7903,92,717721,90.80478238866397,9
0.05,7904,93,717814,90.80506008855156,8
0.05,7905,94,717908,90.80546420440172,7
0.05,7906,94,718002,90.80586821803465,7
0.05,7907,95,718097,90.80639858371269,6
0.05,7908,93,718190,90.80667593880389,8
0.05,7909,93,718283,90.80695322376738,8
0.05,7910,96,718379,90.807609657439,6
0.05,7911,91,718470,90.80763397371082,10
0.05,7912,95,718565,90.80816378111967,6
0.05,7913,94,718659,90.80856709628506,8
0.05,7914,93,718752,90.80884396715098,8
0.05,7915,92,718844,90.8089944416372,10
0.05,7916,94,718938,90.80939749905266,7
0.05,7917,94,719032,90.80980045466026,8
0.05,7918,95,719127,90.81032958706908,6
0.05,7919,91,719218,90.81035353535354,10
0.05,7920,94,719312,90.81075621764928,7
0.05,7921,93,719405,90.81103256753345,9
0.05,7922,93,719498,90.81130884765871,9
0.05,7923,90,719588,90.81120646138314,11
0.05,7924,94,719682,90.81160883280756,7
0.05,7925,95,719777,90.81213726974514,6
0.05,7926,95,719872,90.81266557335688,6
0.05,7927,91,719963,90.81268920282542,10
0.05,7928,90,720053,90.81258670702485,11
0.05,7929,96,720149,90.81324085750315,6
0.05,7930,95,720244,90.81376875551634,6
0.05,7931,93,720337,90.81404437720626,8
0.05,7932,96,720433,90.81469809655867,6
0.05,7933,-46,720387,90.79745399546256,10
0.05,7934,94,720481,90.79785759294266,7
0.05,7935,95,720576,90.79838709677419,6
0.05,7936,91,720667,90.7984124984251,10
0.05,7937,94,720761,90.79881582262534,8
0.05,7938,95,720856,90.79934500566821,6
0.05,7939,27,720883,90.79130982367758,6
0.05,7940,95,720978,90.79183981866264,6
0.05,7941,95,721073,90.79236968018131,7
0.05,7942,96,721169,90.79302530530026,6
0.05,7943,94,721263,90.79342900302115,7
0.05,7944,94,721357,90.79383259911894,7
0.05,7945,94,721451,90.79423609363202,7
0.05,7946,92,721543,90.79438781930288,9
0.05,7947,93,721636,90.79466532460997,8
0.05,7948,93,721729,90.79494276009561,8
0.05,7949,94,721823,90.79534591194968,7
0.05,7950,91,721914,90.7953716513646,10
0.05,7951,94,722008,90.79577464788733,8
0.05,7952,95,722103,90.79630328178045,7
0.05,7953,96,722199,90.79695750565753,6
0.05,7954,92,722291,90.79710873664362,9
0.05,7955,95,722386,90.79763700351936,6
0.05,7956,93,722479,90.79791378660299,8
0.05,7957,93,722572,90.79819050012566,8
0.05,7958,94,722666,90.7985927880387,7
0.05,7959,93,722759,90.79886934673367,8
0.05,7960,95,722854,90.79939706067077,6
0.05,7961,96,722950,90.8000502386335,6
0.05,7962,86,723036,90.79944744443048,15
0.05,7963,94,723130,90.79984932194877,7
0.05,7964,94,723224,90.80025109855619,7
0.05,7965,95,723319,90.80077830780819,7
0.05,7966,92,723411,90.80092883142964,9
0.05,7967,93,723504,90.8012048192771,8
0.05,7968,96,723600,90.80185719663697,6
0.05,7969,92,723692,90.80200752823086,10
0.05,7970,94,723786,90.80240873165224,8
0.05,7971,96,723882,90.80306071249373,6
0.05,7972,94,723976,90.80346168318073,7
0.05,7973,95,724071,90.80398796087283,6
0.05,7974,24,724095,90.79561128526646,9
0.05,7975,95,724190,90.79613841524574,6
0.05,7976,89,724279,90.79591325059546,12
0.05,7977,95,724374,90.79644021057909,7
0.05,7978,94,724468,90.79684170948741,8
0.05,7979,94,724562,90.79724310776942,7
0.05,7980,92,724654,90.79739381029947,9
0.05,7981,94,724748,90.79779503883738,7
0.05,7982,93,724841,90.79807090066392,8
0.05,7983,95,724936,90.79859719438878,6
0.05,7984,94,725030,90.79899812147777,7
0.05,7985,90,725120,90.79889807162535,11
0.05,7986,93,725213,90.79917365719294,8
0.05,7987,96,725309,90.79982473710565,6
0.05,7988,94,725403,90.80022530980098,7
0.05,7989,96,725499,90.8008760951189,6
0.05,7990,21,725520,90.79214115880366,11
0.05,7991,93,725613,90.79241741741741,8
0.05,7992,96,725709,90.7930689353184,7
0.05,7993,94,725803,90.79347010257693,7
0.05,7994,96,725899,90.79412132582864,6
0.05,7995,93,725992,90.7943971985993,8
0.05,7996,94,726086,90.79479804926848,7
0.05,7997,91,726177,90.79482370592648,10
0.05,7998,94,726271,90.79522440305038,7
0.05,7999,94,726365,90.795625,7
0.05,8000,94,726459,90.7960254968129,8
0.05,8001,94,726553,90.79642589352662,7
0.05,8002,94,726647,90.79682619017868,7
0.05,8003,94,726741,90.7972263868066,7
0.05,8004,91,726832,90.79725171767645,10
0.05,8005,93,726925,90.79752685485886,8
0.05,8006,87,727012,90.79705257899339,14
0.05,8007,92,727104,90.7972027972028,9
0.05,8008,94,727198,90.79760269696591,8
0.05,8009,95,727293,90.79812734082397,7
0.05,8010,94,727387,90.79852702534016,7
0.05,8011,96,727483,90.79917623564653,6
0.05,8012,93,727576,90.79945089230002,8
0.05,8013,92,727668,90.79960069877714,9
0.05,8014,96,727764,90.80024953212727,6
0.05,8015,92,727856,90.8003992015968,9
0.05,8016,96,727952,90.80104777348136,6
0.05,8017,96,728048,90.80169618358693,6
0.05,8018,94,728142,90.80209502431725,7
0.05,8019,94,728236,90.80249376558604,7
0.05,8020,94,728330,90.80289240743049,7
0.05,8021,94,728424,90.80329094988781,7
0.05,8022,95,728519,90.80381403465039,7
0.05,8023,94,728613,90.80421236291127,7
0.05,8024,95,728708,90.80473520249221,6
0.05,8025,96,728804,90.80538250685272,6
0.05,8026,94,728898,90.8057804908434,7
0.05,8027,95,728993,90.80630293971102,6
0.05,8028,94,729087,90.80670070992652,7
0.05,8029,96,729183,90.80734744707347,6
0.05,8030,95,729278,90.80786950566555,6
0.05,8031,91,729369,90.80789342629483,10
0.05,8032,94,729463,90.80829080044815,7
0.05,8033,94,729557,90.80868807567836,7
0.05,8034,94,729651,90.8090852520224,8
0.05,8035,94,729745,90.80948232951717,7
0.05,8036,93,729838,90.80975488366306,8
0.05,8037,96,729934,90.81040059716348,6
0.05,8038,96,730030,90.81104615001865,6
0.05,8039,96,730126,90.81169154228856,6
0.05,8040,95,730221,90.81221241139161,6
0.05,8041,91,730312,90.81223576224819,10
0.05,8042,92,730404,90.81238343901529,9
0.05,8043,94,730498,90.81277971158627,7
0.05,8044,88,730586,90.81243008079552,13
0.05,8045,96,730682,90.81307481978622,6
0.05,8046,94,730776,90.8134708587051,7
0.05,8047,93,730869,90.81374254473161,8
0.05,8048,92,730961,90.8138899242142,9
0.05,8049,94,731055,90.81428571428572,7
0.05,8050,95,731150,90.81480561420942,6
0.05,8051,96,731246,90.81544957774466,6
0.05,8052,94,731340,90.81584502669813,7
0.05,8053,93,731433,90.81611621554507,8
0.05,8054,95,731528,90.81663563004345,6
0.05,8055,95,731623,90.81715491559086,6
0.05,8056,93,731716,90.8174258408837,8
0.05,8057,96,731812,90.8180689997518,6
0.05,8058,96,731908,90.81871199900732,6
0.05,8059,95,732003,90.81923076923077,6
0.05,8060,26,732029,90.81118967869992,7
0.05,8061,95,732124,90.81170925328702,6
0.05,8062,91,732215,90.81173260572987,11
0.05,8063,88,732303,90.81138392857143,13
0.05,8064,94,732397,90.81177929324241,7
0.05,8065,94,732491,90.81217455988099,7
0.05,8066,94,732585,90.81256972852361,7
0.05,8067,92,732677,90.81271690629649,9
0.05,8068,96,732773,90.81335977196679,6
0.05,8069,94,732867,90.81375464684015,7
0.05,8070,93,732960,90.81402552347912,8
0.05,8071,94,733054,90.81442021803767,8
0.05,8072,94,733148,90.81481481481481,7
0.05,8073,94,733242,90.81520931384692,7
0.05,8074,95,733337,90.81572755417956,6
0.05,8075,86,733423,90.81513125309559,16
0.05,8076,92,733515,90.81527794973381,9
0.05,8077,96,733611,90.81591978212428,6
0.05,8078,94,733705,90.81631390023517,8
0.05,8079,93,733798,90.81658415841584,8
0.05,8080,94,733892,90.8169780967702,9
0.05,8081,96,733988,90.81761940113833,6
0.05,8082,96,734084,90.81826054682668,6
0.05,8083,95,734179,90.81877783275606,7
0.05,8084,94,734273,90.81917130488559,7
0.05,8085,93,734366,90.81944100915162,8
0.05,8086,93,734459,90.81971064671696,8
0.05,8087,90,734549,90.81960929772502,11
0.05,8088,94,734643,90.82000247249351,7
0.05,8089,92,734735,90.82014833127317,9
0.05,8090,92,734827,90.82029415399828,9
0.05,8091,92,734919,90.82043994068215,9
0.05,8092,96,735015,90.82107994563202,6
0.05,8093,94,735109,90.82147269582407,7
0.05,8094,94,735203,90.82186534898085,7
0.05,8095,95,735298,90.8223814229249,6
0.05,8096,94,735392,90.82277386686427,7
0.05,8097,96,735488,90.82341318844159,6
0.05,8098,95,735583,90.82392888010865,6
0.05,8099,90,735673,90.82382716049382,11
0.05,8100,93,735766,90.82409579064313,8
0.05,8101,89,735855,90.82387064922241,12
0.05,8102,94,735949,90.82426261878317,7
0.05,8103,94,736043,90.82465449160908,7
0.05,8104,94,736137,90.82504626773597,8
0.05,8105,95,736232,90.82556131260795,6
0.05,8106,93,736325,90.82582953003578,8
0.05,8107,27,736352,90.81795757276764,6
0.05,8108,95,736447,90.81847330127019,6
0.05,8109,94,736541,90.81886559802713,7
0.05,8110,94,736635,90.81925779805202,7
0.05,8111,92,736727,90.8194033530572,9
0.05,8112,92,736819,90.81954887218045,9
0.05,8113,92,736911,90.81969435543505,9
0.05,8114,95,737006,90.82020948860135,6
0.05,8115,93,737099,90.8204780680138,8
0.05,8116,96,737195,90.82111617592707,6
0.05,8117,92,737287,90.82126139443213,9
0.05,8118,95,737382,90.82177608079813,6
0.05,8119,27,737409,90.81391625615764,6
0.05,8120,95,737504,90.8144317202315,6
0.05,8121,25,737529,90.80632849051958,7
0.05,8122,95,737624,90.80684476178752,6
0.05,8123,93,737717,90.80711472181191,8
0.05,8124,89,737806,90.80689230769231,12
0.05,8125,95,737901,90.80740831897613,8
0.05,8126,94,737995,90.80780115663836,7
0.05,8127,93,738088,90.80807086614173,8
0.05,8128,96,738184,90.80870955837126,6
0.05,8129,93,738277,90.8089790897909,8
0.05,8130,95,738372,90.80949452711843,6
0.05,8131,92,738464,90.80964092474176,9
0.05,8132,92,738556,90.8097872863642,9
0.05,8133,88,738644,90.80944184902877,13
0.05,8134,94,738738,90.8098340503995,7
0.05,8135,92,738830,90.80998033431662,9
0.05,8136,95,738925,90.81049526852648,6
0.05,8137,93,739018,90.81076431555665,8
0.05,8138,94,739112,90.81115616169062,7
0.05,8139,94,739206,90.8115479115479,7
0.05,8140,91,739297,90.81157106006633,10
0.05,8141,92,739389,90.8117170228445,9
0.05,8142,96,739485,90.8123541692251,6
0.05,8143,96,739581,90.81299115913556,6
0.05,8144,96,739677,90.81362799263351,6
0.05,8145,93,739770,90.81389639086669,8
0.05,8146,96,739866,90.81453295691665,6
0.05,8147,91,739957,90.8145557191949,10
0.05,8148,94,740051,90.81494661921708,8
0.05,8149,92,740143,90.81509202453988,9
0.05,8150,95,740238,90.8156054471844,6
0.05,8151,96,740334,90.81624141315015,6
0.05,8152,94,740428,90.81663191463265,7
0.05,8153,90,740518,90.81653176355164,11
0.05,8154,94,740612,90.81692213366033,7
0.05,8155,92,740704,90.81706718979892,9
0.05,8156,94,740798,90.81745739855339,8
0.05,8157,95,740893,90.81797009070851,6
0.05,8158,95,740988,90.81848265718838,6
0.05,8159,94,741082,90.8188725490196,7
0.05,8160,96,741178,90.81950741330719,6
0.05,8161,95,741273,90.82001960303847,6
0.05,8162,91,741364,90.82004165135366,10
0.05,8163,95,741459,90.82055365017149,6
0.05,8164,94,741553,90.82094304960196,7
0.05,8165,93,741646,90.82120989468528,9
0.05,8166,96,741742,90.82184400636709,6
0.05,8167,96,741838,90.82247796278159,6
0.05,8168,96,741934,90.8231117639858,6
0.05,8169,94,742028,90.8235006119951,7
0.05,8170,94,742122,90.82388936482683,7
0.05,8171,94,742216,90.82427802251591,7
0.05,8172,94,742310,90.82466658509728,7
0.05,8173,93,742403,90.82493271348177,8
0.05,8174,18,742421,90.8160244648318,14
0.05,8175,91,742512,90.8160469667319,10
0.05,8176,96,742608,90.81668093432799,6
0.05,8177,94,742702,90.8170701883101,7
0.05,8178,95,742797,90.81758161144394,6
0.05,8179,90,742887,90.81748166259169,11
0.05,8180,94,742981,90.81787067595648,7
0.05,8181,94,743075,90.81825959423124,7
0.05,8182,94,743169,90.81864841745082,7
0.05,8183,93,743262,90.81891495601172,8
0.05,8184,94,743356,90.81930360415394,7
0.05,8185,94,743450,90.8196921573418,7
0.05,8186,95,743545,90.82020276047392,6
0.05,8187,94,743639,90.82059110893991,7
0.05,8188,96,743735,90.82122359262425,6
0.05,8189,92,743827,90.82136752136752,9
0.05,8190,96,743923,90.82199975582957,7
0.05,8191,96,744019,90.8226318359375,6
0.05,8192,96,744115,90.82326376174784,6
0.05,8193,23,744138,90.81498657554307,10
0.05,8194,95,744233,90.81549725442343,6
0.05,8195,95,744328,90.81600780868716,6
0.05,8196,90,744418,90.81590825911918,11
0.05,8197,96,744514,90.81654061966333,6
0.05,8198,25,744539,90.80851323332114,8
0.05,8199,92,744631,90.80865853658537,9
0.05,8200,95,744726,90.80916961346178,7
0.05,8201,95,744821,90.80968056571568,6
0.05,8202,94,744915,90.81006948677313,7
0.05,8203,94,745009,90.81045831301805,7
0.05,8204,27,745036,90.80268129189518,6
0.05,8205,95,745131,90.80319278576651,6
0.05,8206,95,745226,90.80370415498965,6
0.05,8207,93,745319,90.80397173489278,8
0.05,8208,94,745413,90.80436106712145,8
0.05,8209,94,745507,90.8047503045067,7
0.05,8210,96,745603,90.80538302277432,6
0.05,8211,92,745695,90.80552849488554,10
0.05,8212,94,745789,90.80591744794837,7
0.05,8213,96,745885,90.80654979303628,6
0.05,8214,96,745981,90.80718198417529,6
0.05,8215,94,746075,90.80757059396299,7
0.05,8216,94,746169,90.80795910916393,7
0.05,8217,96,746265,90.80859089802871,6
0.05,8218,96,746361,90.80922253315488,6
0.05,8219,94,746455,90.80961070559611,7
0.05,8220,95,746550,90.81012042330617,7
0.05,8221,94,746644,90.8105083921187,7
0.05,8222,94,746738,90.81089626656937,7
0.05,8223,96,746834,90.81152723735408,6
0.05,8224,93,746927,90.81179331306991,8
0.05,8225,93,747020,90.81205932409434,9
0.05,8226,90,747110,90.81196061747903,12
0.05,8227,94,747204,90.81234807972776,8
0.05,8228,94,747298,90.81273544780653,8
0.05,8229,94,747392,90.81312272174969,7
0.05,8230,94,747486,90.81350990159154,7
0.05,8231,94,747580,90.81389698736638,7
0.05,8232,92,747672,90.8140410542937,9
0.05,8233,94,747766,90.81442798153995,7
0.05,8234,95,747861,90.81493624772314,6
0.05,8235,94,747955,90.81532297231666,8
0.05,8236,95,748050,90.81583100643438,6
0.05,8237,27,748077,90.80808448652586,6
0.05,8238,94,748171,90.80847190192985,7
0.05,8239,95,748266,90.80898058252427,6
0.05,8240,93,748359,90.80924645067346,8
0.05,8241,96,748455,90.80987624363019,6
0.05,8242,96,748551,90.81050588378018,6
0.05,8243,94,748645,90.81089277049976,7
0.05,8244,93,748738,90.81115827774408,9
0.05,8245,93,748831,90.8114237205918,9
0.05,8246,94,748925,90.81181035528071,7
0.05,8247,95,749020,90.81231813773036,6
0.05,8248,93,749113,90.81258334343556,8
0.05,8249,94,749207,90.8129696969697,7
0.05,8250,94,749301,90.81335595685371,8
0.05,8251,21,749322,90.80489578284052,11
0.05,8252,92,749414,90.80504059130013,9
0.05,8253,96,749510,90.8056699781924,6
0.05,8254,94,749604,90.8060569351908,7
0.05,8255,96,749700,90.80668604651163,6
0.05,8256,27,749727,90.79895845948892,6
0.05,8257,-44,749683,90.7826350205861,8
0.05,8258,95,749778,90.78314565928079,6
0.05,8259,89,749867,90.78292978208232,12
0.05,8260,94,749961,90.7833192107493,7
0.05,8261,94,750055,90.78370854514645,7
0.05,8262,87,750142,90.78325063536246,14
0.05,8263,94,750236,90.7836398838335,7
0.05,8264,27,750263,90.77592256503327,6
0.05,8265,90,750353,90.77582869586257,11
0.05,8266,96,750449,90.77646062658764,6
0.05,8267,93,750542,90.77672955974843,8
0.05,8268,94,750636,90.77711936147055,7
0.05,8269,92,750728,90.77726723095526,11
0.05,8270,94,750822,90.77765687341314,7
0.05,8271,95,750917,90.77816731141199,8
0.05,8272,93,751010,90.77843587574036,8
0.05,8273,96,751106,90.77906695673194,6
0.05,8274,92,751198,90.77921450151058,9
0.05,8275,96,751294,90.77984533591106,6
0.05,8276,95,751389,90.78035520115984,6
0.05,8277,91,751480,90.78038173471853,10
0.05,8278,94,751574,90.78077062447156,7
0.05,8279,93,751667,90.781038647343,8
0.05,8280,93,751760,90.78130660548243,8
0.05,8281,92,751852,90.78145375513161,9
0.05,8282,91,751943,90.78148014004587,10
0.05,8283,94,752037,90.7818686624819,7
0.05,8284,90,752127,90.78177429088714,11
0.05,8285,95,752222,90.78228336953899,6
0.05,8286,96,752318,90.7829129962592,6
0.05,8287,91,752409,90.7829391891892,10
0.05,8288,94,752503,90.78332730124261,7
0.05,8289,93,752596,90.78359469240048,8
0.05,8290,94,752690,90.78398263176939,7
0.05,8291,96,752786,90.78461167390256,6
0.05,8292,95,752881,90.78511998070663,6
0.05,8293,95,752976,90.78562816493852,6
0.05,8294,95,753071,90.78613622664255,7
0.05,8295,94,753165,90.78652362584378,7
0.05,8296,96,753261,90.78715198264433,6
0.05,8297,92,753353,90.78729814413111,9
0.05,8298,94,753447,90.78768526328473,7
0.05,8299,20,753467,90.77915662650602,12
0.05,8300,96,753563,90.77978556800386,6
0.05,8301,27,753590,90.7721031076849,6
0.05,8302,95,753685,90.77261230880404,6
0.05,8303,95,753780,90.77312138728324,6
0.05,8304,95,753875,90.77363034316677,6
0.05,8305,94,753969,90.77401878160366,7
0.05,8306,90,754059,90.77392560491153,11
0.05,8307,93,754152,90.7741935483871,8
0.05,8308,96,754248,90.77482248164641,6
0.05,8309,94,754342,90.77521058965102,7
0.05,8310,96,754438,90.77583924918783,6
0.05,8311,92,754530,90.77598652550529,9
0.05,8312,96,754626,90.7766149404547,6
0.05,8313,95,754721,90.77712292518643,6
0.05,8314,95,754816,90.77763078773302,7
0.05,8315,94,754910,90.77801827801828,7
0.05,8316,93,755003,90.77828543946134,8
0.05,8317,94,755097,90.77867275787449,7
0.05,8318,92,755189,90.77881956965982,9
0.05,8319,94,755283,90.77920673076923,7
0.05,8320,93,755376,90.77947362095902,8
0.05,8321,90,755466,90.77937995674117,11
0.05,8322,95,755561,90.77988705995435,6
0.05,8323,26,755587,90.77210475732821,7
0.05,8324,22,755609,90.76384384384384,11
0.05,8325,96,755705,90.76447273600769,6
0.05,8326,96,755801,90.76510147712261,6
0.05,8327,92,755893,90.7652497598463,9
0.05,8328,92,755985,90.76539800696362,9
0.05,8329,92,756077,90.7655462184874,9
0.05,8330,92,756169,90.76569439443044,9
0.05,8331,91,756260,90.76572251560249,10
0.05,8332,95,756355,90.76623064922597,6
0.05,8333,92,756447,90.76637868970482,9
0.05,8334,93,756540,90.76664667066586,8
0.05,8335,95,756635,90.76715451055662,6
0.05,8336,92,756727,90.76730238694974,9
0.05,8337,90,756817,90.76721036219718,11
0.05,8338,96,756913,90.76783787024823,6
0.05,8339,96,757009,90.76846522781774,6
0.05,8340,95,757104,90.76897254525836,6
0.05,8341,93,757197,90.76923999040997,8
0.05,8342,95,757292,90.76974709337169,6
0.05,8343,96,757388,90.77037392138064,6
0.05,8344,94,757482,90.77076093469144,7
0.05,8345,96,757578,90.77138749101366,6
0.05,8346,94,757672,90.77177429016413,7
0.05,8347,94,757766,90.77216099664591,7
0.05,8348,96,757862,90.77278716013893,6
0.05,8349,94,757956,90.77317365269461,7
0.05,8350,94,758050,90.7735600526883,7
0.05,8351,96,758146,90.77418582375479,6
0.05,8352,93,758239,90.77445229258949,8
0.05,8353,92,758331,90.77459899449366,9
0.05,8354,95,758426,90.77510472770796,6
0.05,8355,94,758520,90.77549066539014,8
0.05,8356,95,758615,90.77599617087472,6
0.05,8357,94,758709,90.77638190954774,7
0.05,8358,93,758802,90.77664792439288,8
0.05,8359,94,758896,90.77703349282297,7
0.05,8360,94,758990,90.77741896902285,7
0.05,8361,94,759084,90.77780435302559,8
0.05,8362,95,759179,90.77830921917972,6
0.05,8363,94,759273,90.7786944045911,7
0.05,8364,93,759366,90.77895995218171,8
0.05,8365,95,759461,90.77946449916328,7
0.05,8366,94,759555,90.7798494083901,7
0.05,8367,96,759651,90.78047323135755,6
0.05,8368,93,759744,90.78073843947902,8
0.05,8369,94,759838,90.78112305854242,7
0.05,8370,95,759933,90.7816270457532,6
0.05,8371,94,760027,90.78201146679407,7
0.05,8372,93,760120,90.78227636450495,8
0.05,8373,94,760214,90.78266061619298,7
0.05,8374,94,760308,90.7830447761194,8
0.05,8375,92,760400,90.78319006685768,9
0.05,8376,95,760495,90.78369344634118,6
0.05,8377,92,760587,90.78383862497016,9
0.05,8378,94,760681,90.7842224609142,7
0.05,8379,96,760777,90.78484486873508,6
0.05,8380,94,760871,90.78522849301993,7
0.05,8381,92,760963,90.78537341923169,9
0.05,8382,94,761057,90.7857568889419,7
0.05,8383,93,761150,90.78602099236642,8
0.05,8384,95,761245,90.78652355396541,7
0.05,8385,95,761340,90.78702599570713,6
0.05,8386,95,761435,90.78752831763444,6
0.05,8387,94,761529,90.7879113018598,7
0.05,8388,96,761625,90.78853260221719,6
0.05,8389,93,761718,90.78879618593564,8
0.05,8390,95,761813,90.7892980574425,6
0.05,8391,95,761908,90.78979980934223,6
0.05,8392,94,762002,90.79018229476945,7
0.05,8393,93,762095,90.79044555634978,8
0.05,8394,94,762189,90.79082787373437,7
0.05,8395,94,762283,90.79121010004764,7
0.05,8396,96,762379,90.79183041562463,6
0.05,8397,85,762464,90.7911407477971,16
0.05,8398,91,762555,90.79116561495417,10
0.05,8399,94,762649,90.79154761904762,7
0.05,8400,95,762744,90.79204856564695,6
0.05,8401,95,762839,90.79254939300166,6
0.05,8402,94,762933,90.79293109603712,8
0.05,8403,93,763026,90.79319371727749,8
0.05,8404,93,763119,90.79345627602618,8
0.05,8405,94,763213,90.79383773495123,7
0.05,8406,96,763309,90.79445700011895,6
0.05,8407,15,763324,90.78544243577545,17
0.05,8408,94,763418,90.7858247116185,7
0.05,8409,27,763445,90.7782401902497,6
0.05,8410,92,763537,90.77838544762811,9
0.05,8411,90,763627,90.7782929148835,11
0.05,8412,96,763723,90.77891358611673,6
0.05,8413,94,763817,90.779296410744,8
0.05,8414,96,763913,90.77991681521094,6
0.05,8415,93,764006,90.78018060836501,8
0.05,8416,94,764100,90.78056314601402,7
0.05,8417,95,764195,90.78106438583987,6
0.05,8418,95,764290,90.78156550659223,6
0.05,8419,95,764385,90.78206650831353,6
0.05,8420,92,764477,90.78221113881962,10
0.05,8421,94,764571,90.78259320826407,7
0.05,8422,93,764664,90.7828564644426,8
0.05,8423,96,764760,90.78347578347578,6
0.05,8424,94,764854,90.78385756676558,7
0.05,8425,92,764946,90.78400189888441,9
0.05,8426,94,765040,90.78438352913255,7
0.05,8427,93,765133,90.78464641670622,8
0.05,8428,93,765226,90.78490924190295,8
0.05,8429,93,765319,90.78517200474496,8
0.05,8430,95,765414,90.78567192503854,6
0.05,8431,95,765509,90.78617172675521,7
0.05,8432,96,765605,90.78678999169928,6
0.05,8433,93,765698,90.78705240692436,8
0.05,8434,94,765792,90.7874333135744,8
0.05,8435,93,765885,90.78769559032717,8
0.05,8436,96,765981,90.78831338153373,6
0.05,8437,96,766077,90.78893102630956,6
0.05,8438,93,766170,90.7891930323498,8
0.05,8439,94,766264,90.78957345971564,7
0.05,8440,94,766358,90.7899537969435,7
0.05,8441,93,766451,90.79021558872306,9
0.05,8442,94,766545,90.79059575980102,8
0.05,8443,95,766640,90.79109426811938,6
0.05,8444,94,766734,90.79147424511545,7
0.05,8445,96,766830,90.79209093061804,6
0.05,8446,96,766926,90.79270747010773,6
0.05,8447,96,767022,90.79332386363636,7
0.05,8448,92,767114,90.79346668244763,9
0.05,8449,93,767207,90.79372781065089,8
0.05,8450,94,767301,90.79410720624779,8
0.05,8451,94,767395,90.79448651206815,7
0.05,8452,91,767486,90.79451082455932,10
0.05,8453,94,767580,90.79488999290277,7
0.05,8454,93,767673,90.79515079834418,9
0.05,8455,90,767763,90.79505676442763,11
0.05,8456,92,767855,90.79519924323046,9
0.05,8457,90,767945,90.7951052258217,11
0.05,8458,92,768037,90.79524766520865,9
0.05,8459,94,768131,90.79562647754138,7
0.05,8460,92,768223,90.79576882165229,9
0.05,8461,96,768319,90.79638383360907,6
0.05,8462,94,768413,90.79676237740753,7
0.05,8463,95,768508,90.79725897920605,6
0.05,8464,94,768602,90.79763733018311,7
0.05,8465,96,768698,90.79825183085282,6
0.05,8466,96,768794,90.79886618637062,6
0.05,8467,95,768889,90.79936230514879,7
0.05,8468,94,768983,90.79974022907074,7
0.05,8469,95,769078,90.80023612750885,6
0.05,8470,94,769172,90.80061385904853,8
0.05,8471,27,769199,90.79308309726157,6
0.05,8472,95,769294,90.79357960580668,6
0.05,8473,93,769387,90.79383998111872,9
0.05,8474,92,769479,90.79398230088495,9
0.05,8475,95,769574,90.79447852760737,6
0.05,8476,94,769668,90.79485667099209,7
0.05,8477,93,769761,90.79511677282377,8
0.05,8478,92,769853,90.79525887486732,9
0.05,8479,94,769947,90.79563679245283,7
0.05,8480,91,770038,90.7956608890461,10
0.05,8481,96,770134,90.79627446356992,6
0.05,8482,95,770229,90.79677001060945,7
0.05,8483,95,770324,90.7972654408298,6
0.05,8484,94,770418,90.79764289923395,7
0.05,8485,94,770512,90.79802026867782,7
0.05,8486,95,770607,90.79851537645811,6
0.05,8487,93,770700,90.79877474081056,8
0.05,8488,94,770794,90.79915184356226,7
0.05,8489,93,770887,90.79941107184924,9
0.05,8490,20,770907,90.7910729007184,12
0.05,8491,89,770996,90.79086198775317,12
0.05,8492,93,771089,90.7911221005534,8
0.05,8493,94,771183,90.79149988226983,8
0.05,8494,96,771279,90.79211300765157,6
0.05,8495,93,771372,90.79237288135593,8
0.05,8496,93,771465,90.79263269389196,8
0.05,8497,95,771560,90.79312779477524,6
0.05,8498,91,771651,90.79315213554536,10
0.05,8499,92,771743,90.79329411764706,9
0.05,8500,96,771839,90.79390659922362,6
0.05,8501,89,771928,90.79369560103505,12
0.05,8502,95,772023,90.79419028578148,6
0.05,8503,93,772116,90.79444967074318,8
0.05,8504,95,772211,90.7949441504997,6
0.05,8505,92,772303,90.79508582177287,9
0.05,8506,95,772398,90.79558011049724,6
0.05,8507,94,772492,90.79595674659144,7
0.05,8508,95,772587,90.79645081678223,7
0.05,8509,95,772682,90.79694477085782,7
0.05,8510,92,772774,90.79708612383973,9
0.05,8511,96,772870,90.79769736842105,6
0.05,8512,94,772964,90.79807353459415,7
0.05,8513,96,773060,90.79868451961475,6
0.05,8514,93,773153,90.79894304169113,8
0.05,8515,95,773248,90.79943635509629,6
0.05,8516,93,773341,90.79969472819067,8
0.05,8517,94,773435,90.80007043907021,7
0.05,8518,94,773529,90.80044606174434,8
0.05,8519,94,773623,90.80082159624413,8
0.05,8520,95,773718,90.80131439971834,7
0.05,8521,96,773814,90.80192443088477,6
0.05,8522,94,773908,90.80229965974422,7
0.05,8523,93,774001,90.80255748474895,8
0.05,8524,92,774093,90.80269794721407,9
0.05,8525,94,774187,90.80307295331926,7
0.05,8526,93,774280,90.80333059692741,9
0.05,8527,93,774373,90.80358818011257,8
0.05,8528,96,774469,90.80419744401453,6
0.05,8529,96,774565,90.80480656506448,6
0.05,8530,92,774657,90.80494666510374,9
0.05,8531,95,774752,90.80543834974215,6
0.05,8532,95,774847,90.80592991913747,7
0.05,8533,96,774943,90.80653855167564,6
0.05,8534,92,775035,90.8066783831283,9
0.05,8535,96,775131,90.80728678537957,6
0.05,8536,96,775227,90.80789504509781,6
0.05,8537,94,775321,90.80826891543687,7
0.05,8538,96,775417,90.80887691767185,6
0.05,8539,96,775513,90.80948477751757,6
0.05,8540,96,775609,90.81009249502401,6
0.05,8541,92,775701,90.81023179583235,9
0.05,8542,94,775795,90.81060517382653,7
0.05,8543,94,775889,90.81097846441948,8
0.05,8544,94,775983,90.8113516676419,7
0.05,8545,95,776078,90.81184179733208,6
0.05,8546,94,776172,90.81221481221482,7
0.05,8547,95,776267,90.81270472625175,6
0.05,8548,93,776360,90.81296058018482,8
0.05,8549,96,776456,90.81356725146199,6
0.05,8550,96,776552,90.81417378084434,6
0.05,8551,95,776647,90.81466323666979,6
0.05,8552,92,776739,90.81480182392143,9
0.05,8553,96,776835,90.81540799625905,6
0.05,8554,88,776923,90.81507890122735,13
0.05,8555,94,777017,90.81545114539504,7
0.05,8556,92,777109,90.8155895757859,9
0.05,8557,93,777202,90.8158448235569,8
0.05,8558,96,777298,90.81645051992055,6
0.05,8559,92,777390,90.81658878504673,9
0.05,8560,96,777486,90.81719425300783,6
0.05,8561,96,777582,90.81779957953749,6
0.05,8562,96,777678,90.81840476468527,6
0.05,8563,94,777772,90.81877627276974,7
0.05,8564,93,777865,90.81903093987157,8
0.05,8565,94,777959,90.81940228811581,8
0.05,8566,92,778051,90.81954009571612,9
0.05,8567,94,778145,90.81991129785247,7
0.05,8568,94,778239,90.82028241335045,8
0.05,8569,96,778335,90.82088681446908,6
0.05,8570,95,778430,90.82137440205344,7
0.05,8571,96,778526,90.82197853476436,6
0.05,8572,94,778620,90.8223492359734,7
0.05,8573,92,778712,90.82248658735713,9
0.05,8574,93,778805,90.82274052478134,8
0.05,8575,92,778897,90.82287779850746,9
0.05,8576,94,778991,90.82324822198905,7
0.05,8577,94,779085,90.82361855910469,7
0.05,8578,94,779179,90.8239888098846,7
0.05,8579,91,779270,90.82400932400932,10
0.05,8580,96,779366,90.82461251602378,6
0.05,8581,91,779457,90.82463295269169,10
0.05,8582,94,779551,90.82500291273448,7
0.05,8583,92,779643,90.82513979496738,9
0.05,8584,96,779739,90.82574257425743,6
0.05,8585,93,779832,90.82599580712788,8
0.05,8586,92,779924,90.82613252591126,9
0.05,8587,95,780019,90.82661853749418,6
0.05,8588,95,780114,90.82710443590639,6
0.05,8589,94,780208,90.82747380675204,7
0.05,8590,94,780302,90.82784309160749,7
0.05,8591,96,780398,90.82844506517691,6
0.05,8592,95,780493,90.8289305248458,6
0.05,8593,94,780587,90.82929951128695,7
0.05,8594,88,780675,90.82897033158814,13
0.05,8595,96,780771,90.82957189390414,6
0.05,8596,95,780866,90.83005699662672,6
0.05,8597,96,780962,90.8306582926262,6
0.05,8598,94,781056,90.83102686358879,7
0.05,8599,94,781150,90.8313953488372,7
0.05,8600,94,781244,90.83176374840134,7
0.05,8601,96,781340,90.83236456637991,6
0.05,8602,94,781434,90.8327327676392,7
0.05,8603,88,781522,90.83240353324035,13
0.05,8604,95,781617,90.83288785589774,7
0.05,8605,95,781712,90.83337206600046,6
0.05,8606,96,781808,90.83397234808876,6
0.05,8607,95,781903,90.8344563197026,6
0.05,8608,94,781997,90.83482402137298,8
0.05,8609,92,782089,90.83495934959349,9
0.05,8610,96,782185,90.8355591685054,6
0.05,8611,95,782280,90.83604273107292,6
0.05,8612,96,782376,90.83664228491814,6
0.05,8613,26,782402,90.8291153935454,6
0.05,8614,93,782495,90.82936738247243,8
0.05,8615,95,782590,90.82985143918292,6
0.05,8616,92,782682,90.82998723453638,9
0.05,8617,96,782778,90.83058714318868,6
0.05,8618,94,782872,90.83095486715396,8
0.05,8619,92,782964,90.83109048723898,10
0.05,8620,93,783057,90.83134207168541,8
0.05,8621,94,783151,90.83170958014382,7
0.05,8622,96,783247,90.83230894120376,6
0.05,8623,94,783341,90.8326762523191,7
0.05,8624,93,783434,90.83292753623188,8
0.05,8625,90,783524,90.83283097611871,11
0.05,8626,94,783618,90.83319809899155,7
0.05,8627,96,783714,90.83379694019472,6
0.05,8628,90,783804,90.83370031289837,11
0.05,8629,93,783897,90.83395133256083,8
0.05,8630,94,783991,90.83431815548605,7
0.05,8631,95,784086,90.83480074142724,6
0.05,8632,94,784180,90.83516738097995,7
0.05,8633,94,784274,90.83553393560342,7
0.05,8634,96,784370,90.8361320208454,6
0.05,8635,94,784464,90.83649837887911,7
0.05,8636,94,784558,90.83686465207826,7
0.05,8637,95,784653,90.83734660801112,6
0.05,8638,93,784746,90.83759694409075,8
0.05,8639,96,784842,90.83819444444444,6
0.05,8640,95,784937,90.83867607915751,6
0.05,8641,93,785030,90.83892617449665,8
0.05,8642,94,785124,90.83929191253037,7
0.05,8643,88,785212,90.83896344285053,13
0.05,8644,95,785307,90.83944476576056,7
0.05,8645,91,785398,90.83946333564654,10
0.05,8646,93,785491,90.83971319532786,8
0.05,8647,93,785584,90.83996299722479,8
0.05,8648,96,785680,90.84055960226615,6
0.05,8649,93,785773,90.84080924855492,8
0.05,8650,94,785867,90.84117443070166,7
0.05,8651,94,785961,90.84153952843273,7
0.05,8652,89,786050,90.84132670750029,12
0.05,8653,-44,786006,90.8257453200832,8
0.05,8654,92,786098,90.82588099364528,9
0.05,8655,94,786192,90.82624768946395,7
0.05,8656,27,786219,90.81887489892573,6
0.05,8657,96,786315,90.81947331947332,6
0.05,8658,96,786411,90.82007160180159,6
0.05,8659,92,786503,90.820207852194,9
0.05,8660,92,786595,90.82034407112343,9
0.05,8661,95,786690,90.82082659893788,6
0.05,8662,92,786782,90.8209627149948,9
0.05,8663,94,786876,90.8213296398892,7
0.05,8664,95,786971,90.82181188690133,6
0.05,8665,94,787065,90.82217862912532,7
0.05,8666,94,787159,90.82254528671974,7
0.05,8667,94,787253,90.82291185971388,7
0.05,8668,91,787344,90.82293228746107,10
0.05,8669,91,787435,90.82295271049597,10
0.05,8670,95,787530,90.82343443662783,8
0.05,8671,95,787625,90.82391605166052,6
0.05,8672,93,787718,90.82416695491756,8
0.05,8673,92,787810,90.82430251325802,9
0.05,8674,91,787901,90.8243227665706,10
0.05,8675,94,787995,90.8246887966805,8
0.05,8676,94,788089,90.8250547424225,7
0.05,8677,94,788183,90.82542060382576,7
0.05,8678,94,788277,90.82578638091947,7
0.05,8679,94,788371,90.82615207373271,7
0.05,8680,90,788461,90.82605690588642,11
0.05,8681,94,788555,90.82642248329878,7
0.05,8682,94,788649,90.82678797650581,8
0.05,8683,93,788742,90.82703823122985,8
0.05,8684,96,788838,90.82763385146805,6
0.05,8685,91,788929,90.82765369560212,10
0.05,8686,94,789023,90.82801887878439,7
0.05,8687,95,789118,90.82849907918968,7
0.05,8688,95,789213,90.82897916906434,7
0.05,8689,96,789309,90.8295742232451,6
0.05,8690,90,789399,90.82947877114256,11
0.05,8691,95,789494,90.82995858260469,6
0.05,8692,94,789588,90.83032324859082,7
0.05,8693,93,789681,90.83057280883368,8
0.05,8694,93,789774,90.83082231167337,8
0.05,8695,92,789866,90.83095676172952,9
0.05,8696,94,789960,90.83132114522249,8
0.05,8697,94,790054,90.83168544492987,7
0.05,8698,94,790148,90.83204966088056,10
0.05,8699,94,790242,90.83241379310344,7
0.05,8700,91,790333,90.83243305367199,10
0.05,8701,94,790427,90.83279705814755,7
0.05,8702,91,790518,90.83281627025164,10
0.05,8703,92,790610,90.83295036764706,9
0.05,8704,92,790702,90.8330844342332,9
0.05,8705,94,790796,90.83344819664599,7
0.05,8706,94,790890,90.83381187550246,7
0.05,8707,94,790984,90.83417547083143,7
0.05,8708,95,791079,90.83465380640716,6
0.05,8709,88,791167,90.83432835820895,14
0.05,8710,94,791261,90.83469176902767,8
0.05,8711,94,791355,90.83505509641873,8
0.05,8712,94,791449,90.83541834041088,8
0.05,8713,94,791543,90.83578150103283,7
0.05,8714,96,791639,90.83637406769937,6
0.05,8715,92,791731,90.83650757228087,9
0.05,8716,94,791825,90.83687048296433,7
0.05,8717,94,791919,90.83723331039229,7
0.05,8718,94,792013,90.83759605459342,7
0.05,8719,94,792107,90.83795871559633,7
0.05,8720,94,792201,90.83832129342966,8
0.05,8721,26,792227,90.83088741114423,8
0.05,8722,94,792321,90.83125071649661,7
0.05,8723,95,792416,90.8317285648785,6
0.05,8724,95,792511,90.83220630372493,6
0.05,8725,91,792602,90.83222553289022,10
0.05,8726,93,792695,90.83247393147703,8
0.05,8727,94,792789,90.83283684692942,7
0.05,8728,94,792883,90.83319967923015,7
0.05,8729,94,792977,90.83356242840779,7
0.05,8730,93,793070,90.8338105600733,8
0.05,8731,95,793165,90.83428767750802,7
0.05,8732,93,793258,90.83453566930035,9
0.05,8733,95,793353,90.83501259445843,7
0.05,8734,93,793446,90.83526044647968,8
0.05,8735,94,793540,90.83562271062272,7
0.05,8736,94,793634,90.8359848918393,8
0.05,8737,89,793723,90.8357747768368,12
0.05,8738,94,793817,90.83613685776405,8
0.05,8739,94,793911,90.83649885583525,7
0.05,8740,95,794006,90.83697517446517,7
0.05,8741,95,794101,90.83745138412263,6
0.05,8742,94,794195,90.83781310762896,7
0.05,8743,94,794289,90.8381747483989,8
0.05,8744,95,794384,90.83865065751858,7
0.05,8745,94,794478,90.83901211982621,7
0.05,8746,94,794572,90.83937349948553,7
0.05,8747,94,794666,90.83973479652492,7
0.05,8748,93,794759,90.83998171219568,8
0.05,8749,27,794786,90.83268571428572,6
0.05,8750,94,794880,90.83304765169694,7
0.05,8751,92,794972,90.83318098720292,9
0.05,8752,96,795068,90.83377127841882,6
0.05,8753,94,795162,90.83413296778616,7
0.05,8754,94,795256,90.83449457452885,7
0.05,8755,93,795349,90.83474189127456,8
0.05,8756,95,795444,90.83521754025351,6
0.05,8757,94,795538,90.83557889929207,7
0.05,8758,94,795632,90.83594017581916,7
0.05,8759,90,795722,90.83584474885845,11
0.05,8760,94,795816,90.83620591256705,7
0.05,8761,93,795909,90.83645286464278,8
0.05,8762,94,796003,90.8368138765263,8
0.05,8763,94,796097,90.83717480602465,7
0.05,8764,96,796193,90.83776383342841,6
0.05,8765,96,796289,90.83835272644308,6
0.05,8766,93,796382,90.83859929280256,8
0.05,8767,92,796474,90.83873175182482,10
0.05,8768,94,796568,90.83909225681377,7
0.05,8769,88,796656,90.83876852907639,13
0.05,8770,94,796750,90.83912894766846,7
0.05,8771,95,796845,90.83960328317373,8
0.05,8772,91,796936,90.83962156616893,10
0.05,8773,94,797030,90.83998176430363,7
0.05,8774,91,797121,90.84,10
0.05,8775,94,797215,90.84036007292616,8
0.05,8776,94,797309,90.84072006380312,7
0.05,8777,92,797401,90.84085213032581,9
0.05,8778,94,797495,90.84121198314159,7
0.05,8779,94,797589,90.84157175398633,7
0.05,8780,93,797682,90.8418175606423,8
0.05,8781,94,797776,90.84217718059668,7
0.05,8782,93,797869,90.84242286234772,8
0.05,8783,91,797960,90.8424408014572,10
0.05,8784,94,798054,90.84280022766079,7
0.05,8785,96,798150,90.8433872069201,6
0.05,8786,93,798243,90.84363263912599,8
0.05,8787,96,798339,90.84421939007738,6
0.05,8788,92,798431,90.8443508931619,9
0.05,8789,92,798523,90.84448236632537,9
0.05,8790,94,798617,90.84484131498122,7
0.05,8791,92,798709,90.84497270245677,9
0.05,8792,93,798802,90.84521778687592,8
0.05,8793,94,798896,90.8455765294519,7
0.05,8794,90,798986,90.84548038658329,11
0.05,8795,93,799079,90.84572532969531,8
0.05,8796,94,799173,90.846083892236,7
0.05,8797,94,799267,90.84644237326665,7
0.05,8798,94,799361,90.84680077281509,7
0.05,8799,93,799454,90.84704545454545,8
0.05,8800,91,799545,90.84706283376889,10
0.05,8801,93,799638,90.84730743012952,8
0.05,8802,93,799731,90.847551970919,8
0.05,8803,92,799823,90.84768287142208,9
0.05,8804,96,799919,90.84826802952868,6
0.05,8805,96,800015,90.84885305473541,6
0.05,8806,25,800040,90.84137617804019,7
0.05,8807,91,800131,90.84139418710264,10
0.05,8808,95,800226,90.84186627312975,6
0.05,8809,95,800321,90.84233825198638,6
0.05,8810,92,800413,90.84246964022245,9
0.05,8811,94,800507,90.84282796187017,7
0.05,8812,94,800601,90.8431862022013,7
0.05,8813,94,800695,90.84354436124347,7
0.05,8814,93,800788,90.84378899602949,8
0.05,8815,95,800883,90.84426043557168,6
0.05,8816,96,800979,90.84484518543722,6
0.05,8817,94,801073,90.84520299387616,7
0.05,8818,93,801166,90.84544732962921,8
0.05,8819,93,801259,90.84569160997732,10
0.05,8820,96,801355,90.84627593243397,6
0.05,8821,96,801451,90.84686012242122,6
0.05,8822,26,801477,90.83951037062224,6
0.05,8823,93,801570,90.8397552130553,8
0.05,8824,95,801665,90.84022662889518,6
0.05,8825,94,801759,90.84058463630184,8
0.05,8826,93,801852,90.84082927381897,8
0.05,8827,90,801942,90.84073402809243,12
0.05,8828,95,802037,90.84120511949259,7
0.05,8829,20,802057,90.83318233295583,12
0.05,8830,96,802153,90.83376741025931,6
0.05,8831,96,802249,90.83435235507247,6
0.05,8832,96,802345,90.83493716744029,6
0.05,8833,95,802440,90.8354086484039,6
0.05,8834,93,802533,90.83565365025467,8
0.05,8835,94,802627,90.83601177003169,7
0.05,8836,95,802722,90.83648296933349,6
0.05,8837,93,802815,90.836727766463,8
0.05,8838,96,802911,90.83731191311234,6
0.05,8839,90,803001,90.83721719457013,11
0.05,8840,25,803026,90.82977038796517,8
0.05,8841,95,803121,90.8302420266908,6
0.05,8842,93,803214,90.83048739115685,8
0.05,8843,96,803310,90.83107191316147,6
0.05,8844,94,803404,90.83143018654607,7
0.05,8845,95,803499,90.8319014243726,7
0.05,8846,94,803593,90.83225952300215,8
0.05,8847,92,803685,90.83239150090417,9
0.05,8848,94,803779,90.83274946321619,7
0.05,8849,93,803872,90.83299435028249,8
0.05,8850,92,803964,90.83312620042933,9
0.05,8851,94,804058,90.83348395842748,7
0.05,8852,95,804153,90.83395459166384,6
0.05,8853,94,804247,90.834312175288,7
0.05,8854,95,804342,90.83478260869565,7
0.05,8855,94,804436,90.83514001806685,7
0.05,8856,91,804527,90.83515863159083,10
0.05,8857,27,804554,90.82795213366448,6
0.05,8858,93,804647,90.82819731346653,8
0.05,8859,94,804741,90.8285553047404,7
0.05,8860,94,804835,90.82891321521274,7
0.05,8861,94,804929,90.82927104491085,7
0.05,8862,95,805024,90.82974162247545,6
0.05,8863,94,805118,90.83009927797833,7
0.05,8864,95,805213,90.83056965595037,6
0.05,8865,95,805308,90.83103992781412,6
0.05,8866,91,805399,90.831058982745,10
0.05,8867,95,805494,90.83152909336941,7
0.05,8868,94,805588,90.8318863456985,7
0.05,8869,94,805682,90.83224351747464,7
0.05,8870,94,805776,90.83260060872506,7
0.05,8871,14,805790,90.82394048692515,18
0.05,8872,95,805885,90.82441113490364,7
0.05,8873,93,805978,90.82465629930132,8
0.05,8874,95,806073,90.82512676056338,6
0.05,8875,94,806167,90.82548445245607,8
0.05,8876,91,806258,90.82550411174947,10
0.05,8877,94,806352,90.82586168055869,7
0.05,8878,94,806446,90.82621916882532,7
0.05,8879,96,806542,90.8268018018018,6
0.05,8880,92,806634,90.82693390383966,9
0.05,8881,93,806727,90.82717856338662,8
0.05,8882,96,806823,90.82776089159069,6
0.05,8883,94,806917,90.82811796488069,8
0.05,8884,94,807011,90.82847495779403,7
0.05,8885,95,807106,90.82894440693225,7
0.05,8886,96,807202,90.82952627433329,6
0.05,8887,91,807293,90.82954545454545,10
0.05,8888,93,807386,90.82978962762965,8
0.05,8889,96,807482,90.83037120359955,6
0.05,8890,93,807575,90.83061522888315,8
0.05,8891,94,807669,90.83097165991903,7
0.05,8892,95,807764,90.83144045878781,6
0.05,8893,93,807857,90.83168428153812,9
0.05,8894,93,807950,90.83192804946599,8
0.05,8895,91,808041,90.83194694244604,10
0.05,8896,92,808133,90.83207822861638,10
0.05,8897,94,808227,90.83243425488874,7
0.05,8898,96,808323,90.8330149454995,6
0.05,8899,92,808415,90.83314606741573,9
0.05,8900,94,808509,90.8335018537243,7
0.05,8901,95,808604,90.83396989440575,6
0.05,8902,95,808699,90.83443782994496,6
0.05,8903,92,808791,90.83456873315365,9
0.05,8904,94,808885,90.83492419988771,7
0.05,8905,96,808981,90.83550415450259,6
0.05,8906,93,809074,90.835747165151,8
0.05,8907,92,809166,90.83587786259542,9
0.05,8908,94,809260,90.83623302278595,8
0.05,8909,95,809355,90.83670033670033,6
0.05,8910,93,809448,90.83694310402873,8
0.05,8911,96,809544,90.8375224416517,6
0.05,8912,93,809637,90.8377650622686,8
0.05,8913,93,809730,90.83800762844963,9
0.05,8914,94,809824,90.83836231071228,7
0.05,8915,94,809918,90.83871691341409,8
0.05,8916,96,810014,90.83929572726254,6
0.05,8917,96,810110,90.83987441130299,6
0.05,8918,93,810203,90.84011660500056,8
0.05,8919,93,810296,90.84035874439462,8
0.05,8920,95,810391,90.84082501961663,6
0.05,8921,94,810485,90.84117910782336,7
0.05,8922,89,810574,90.84097276700662,12
0.05,8923,96,810670,90.84155087404751,6
0.05,8924,93,810763,90.84179271708683,8
0.05,8925,95,810858,90.84225857046829,6
0.05,8926,92,810950,90.84238826033382,9
0.05,8927,94,811044,90.84274193548387,7
0.05,8928,94,811138,90.84309553141449,7
0.05,8929,94,811232,90.8434490481523,7
0.05,8930,94,811326,90.84380248572388,7
0.05,8931,94,811420,90.84415584415585,7
0.05,8932,95,811515,90.8446210679503,6
0.05,8933,93,811608,90.84486232370719,8
0.05,8934,93,811701,90.84510352546167,8
0.05,8935,94,811795,90.84545658012533,7
0.05,8936,96,811891,90.84603334452277,6
0.05,8937,96,811987,90.84660997986127,7
0.05,8938,92,812079,90.84673900883767,9
0.05,8939,92,812171,90.84686800894855,9
0.05,8940,94,812265,90.847220668829,7
0.05,8941,93,812358,90.8474614180273,8
0.05,8942,95,812453,90.84792575198479,6
0.05,8943,94,812547,90.84827817531306,8
0.05,8944,94,812641,90.84863051984348,7
0.05,8945,92,812733,90.84875922199866,9
0.05,8946,93,812826,90.84899966469207,8
0.05,8947,96,812922,90.84957532409477,6
0.05,8948,23,812945,90.84199351882891,11
0.05,8949,94,813039,90.84234636871508,8
0.05,8950,27,813066,90.83521394257625,6
0.05,8951,94,813160,90.8355674709562,7
0.05,8952,94,813254,90.83592092036189,7
0.05,8953,94,813348,90.83627429081974,7
0.05,8954,94,813442,90.83662758235623,8
0.05,8955,94,813536,90.83698079499777,7
0.05,8956,94,813630,90.83733392877079,7
0.05,8957,95,813725,90.83779861576245,6
0.05,8958,94,813819,90.83815157941734,7
0.05,8959,91,813910,90.83816964285714,10
0.05,8960,92,814002,90.83829929695347,9
0.05,8961,95,814097,90.83876366882393,6
0.05,8962,94,814191,90.83911636728774,7
0.05,8963,93,814284,90.83935742971887,8
0.05,8964,91,814375,90.8393753485778,10
0.05,8965,94,814469,90.8397278608075,7
0.05,8966,95,814564,90.8401918144307,6
0.05,8967,94,814658,90.84054415700268,7
0.05,8968,96,814754,90.84111941130561,6
0.05,8969,95,814849,90.84158305462654,6
0.05,8970,92,814941,90.84171218370304,11
0.05,8971,94,815035,90.8420641997325,8
0.05,8972,93,815128,90.84230469185334,8
0.05,8973,94,815222,90.8426565634054,7
0.05,8974,94,815316,90.84300835654597,7
0.05,8975,91,815407,90.84302584670232,10
0.05,8976,92,815499,90.84315472875126,9
0.05,8977,93,815592,90.84339496547115,8
0.05,8978,94,815686,90.84374651965697,7
0.05,8979,96,815782,90.84432071269488,6
0.05,8980,96,815878,90.84489477786438,6
0.05,8981,27,815905,90.83778668448006,6
0.05,8982,94,815999,90.8381387064455,7
0.05,8983,95,816094,90.83860195903829,6
0.05,8984,96,816190,90.83917640511964,6
0.05,8985,95,816285,90.83963943912754,6
0.05,8986,94,816379,90.83999109825304,7
0.05,8987,94,816473,90.84034267912773,7
0.05,8988,94,816567,90.84069418177774,7
0.05,8989,92,816659,90.84082313681868,9
0.05,8990,96,816755,90.84139695250806,6
0.05,8991,92,816847,90.84152580071175,9
0.05,8992,95,816942,90.84198821305459,6
0.05,8993,94,817036,90.842339337336,7
0.05,8994,92,817128,90.84246803779878,9
0.05,8995,93,817221,90.84270787016452,8
0.05,8996,96,817317,90.8432810936979,6
0.05,8997,94,817411,90.84363191820404,7
0.05,8998,95,817506,90.84409378819869,6
0.05,8999,95,817601,90.84455555555556,6
0.05,9000,94,817695,90.84490612154205,7
0.05,9001,96,817791,90.84547878249278,6
0.05,9002,92,817883,90.84560701988227,9
0.05,9003,94,817977,90.84595735228787,7
0.05,9004,95,818072,90.84641865630205,6
0.05,9005,94,818166,90.84676882078614,7
0.05,9006,96,818262,90.84734095703342,6
0.05,9007,25,818287,90.84003108348135,8
0.05,9008,95,818382,90.84049284049284,8
0.05,9009,95,818477,90.84095449500555,7
0.05,9010,94,818571,90.84130507157919,7
0.05,9011,93,818664,90.84154460719041,8
0.05,9012,94,818758,90.84189504049706,7
0.05,9013,94,818852,90.84224539605059,7
0.05,9014,21,818873,90.8344980587909,12
0.05,9015,94,818967,90.83484915705412,7
0.05,9016,95,819062,90.83531107907287,6
0.05,9017,90,819152,90.83521845198491,11
0.05,9018,94,819246,90.83556935358688,7
0.05,9019,92,819338,90.83569844789356,9
0.05,9020,90,819428,90.83560580866866,11
0.05,9021,91,819519,90.83562403014852,10
0.05,9022,94,819613,90.83597473124237,7
0.05,9023,94,819707,90.83632535460993,8
0.05,9024,94,819801,90.83667590027702,8
0.05,9025,91,819892,90.83669399512519,10
0.05,9026,90,819982,90.83660130718954,11
0.05,9027,94,820076,90.83695170580417,8
0.05,9028,94,820170,90.83730202680252,7
0.05,9029,92,820262,90.837430786268,9
0.05,9030,94,820356,90.83778097663603,7
0.05,9031,21,820377,90.83004871567759,11
0.05,9032,94,820471,90.83039964574338,7
0.05,9033,94,820565,90.83075049811822,7
0.05,9034,92,820657,90.83087991145545,9
0.05,9035,96,820753,90.83145196989818,6
0.05,9036,94,820847,90.83180258935488,7
0.05,9037,94,820941,90.83215313122372,7
0.05,9038,96,821037,90.83272485894457,6
0.05,9039,94,821131,90.83307522123894,7
0.05,9040,94,821225,90.83342550602809,7
0.05,9041,95,821320,90.83388630833886,6
0.05,9042,94,821414,90.83423642596483,7
0.05,9043,96,821510,90.83480760725342,7
0.05,9044,96,821606,90.83537866224434,6
0.05,9045,94,821700,90.835728498784,7
0.05,9046,96,821796,90.83629932574334,6
0.05,9047,96,821892,90.8368700265252,6
0.05,9048,92,821984,90.83699856337716,9
0.05,9049,92,822076,90.8371270718232,9
0.05,9050,95,822171,90.83758700696056,6
0.05,9051,94,822265,90.83793636765355,7
0.05,9052,95,822360,90.83839611178615,6
0.05,9053,92,822452,90.83852440910096,9
0.05,9054,94,822546,90.83887355052457,7
0.05,9055,95,822641,90.83933303886926,6
0.05,9056,96,822737,90.83990283758419,6
0.05,9057,96,822833,90.84047251048797,6
0.05,9058,93,822926,90.8407108952423,8
0.05,9059,94,823020,90.84105960264901,8
0.05,9060,95,823115,90.84151859618143,7
0.05,9061,94,823209,90.84186713749725,7
0.05,9062,91,823300,90.84188458567803,10
0.05,9063,94,823394,90.84223300970874,7
0.05,9064,96,823490,90.84280198565912,6
0.05,9065,94,823584,90.84315023163468,8
0.05,9066,93,823677,90.84338811073123,8
0.05,9067,96,823773,90.84395677106308,6
0.05,9068,92,823865,90.84408424302569,9
0.05,9069,92,823957,90.84421168687982,9
0.05,9070,89,824046,90.84400837834859,12
0.05,9071,89,824135,90.84380511463844,12
0.05,9072,91,824226,90.84382232999008,10
0.05,9073,27,824253,90.83678642274631,6
0.05,9074,93,824346,90.83702479338842,8
0.05,9075,95,824441,90.83748347289554,6
0.05,9076,95,824536,90.83794205133854,8
0.05,9077,95,824631,90.83840052875082,6
0.05,9078,95,824726,90.83885890516576,7
0.05,9079,96,824822,90.83942731277533,6
0.05,9080,95,824917,90.83988547516793,6
0.05,9081,92,825009,90.84001321294869,9
0.05,9082,91,825100,90.84003082681933,11
0.05,9083,95,825195,90.84048877146631,6
0.05,9084,94,825289,90.84083654375344,7
0.05,9085,92,825381,90.84096412062513,9
0.05,9086,93,825474,90.8412017167382,8
0.05,9087,95,825569,90.84165933098592,6
0.05,9088,96,825665,90.84222686764221,6
0.05,9089,94,825759,90.84257425742574,7
0.05,9090,93,825852,90.84281157188428,8
0.05,9091,94,825946,90.84315882094148,7
0.05,9092,-48,825898,90.82788958539535,11
0.05,9093,96,825994,90.82845832416979,6
0.05,9094,96,826090,90.82902693787796,6
0.05,9095,93,826183,90.8292656112577,8
0.05,9096,91,826274,90.82928437946576,10
0.05,9097,91,826365,90.82930314354803,10
0.05,9098,94,826459,90.82965161006705,7
0.05,9099,94,826553,90.83,7
0.05,9100,92,826645,90.83012855730139,9
0.05,9101,95,826740,90.83058668424522,6
0.05,9102,96,826836,90.83115456442931,6
0.05,9103,93,826929,90.8313927943761,8
0.05,9104,90,827019,90.83130148270182,11
0.05,9105,90,827109,90.8312101910828,11
0.05,9106,96,827205,90.83177775337653,6
0.05,9107,94,827299,90.83212560386474,7
0.05,9108,96,827395,90.83269294104731,6
0.05,9109,95,827490,90.83315038419319,6
0.05,9110,94,827584,90.83349796948744,7
0.05,9111,93,827677,90.8337357330992,8
0.05,9112,94,827771,90.83408317787776,7
0.05,9113,94,827865,90.83443054641211,7
0.05,9114,95,827960,90.83488754799781,6
0.05,9115,88,828048,90.83457656867047,14
0.05,9116,-44,828004,90.81978721070527,8
0.05,9117,96,828100,90.82035534108357,6
0.05,9118,93,828193,90.82059436341704,8
0.05,9119,96,828289,90.82116228070176,6
0.05,9120,96,828385,90.82173007345686,6
0.05,9121,96,828481,90.8222977417233,6
0.05,9122,94,828575,90.82264605941027,7
0.05,9123,94,828669,90.8229943007453,7
0.05,9124,96,828765,90.82356164383562,6
0.05,9125,88,828853,90.82325224632918,13
0.05,9126,95,828948,90.82370987180892,7
0.05,9127,94,829042,90.8240578439965,7
0.05,9128,94,829136,90.82440573994961,8
0.05,9129,94,829230,90.82475355969332,7
0.05,9130,96,829326,90.82532033731245,6
0.05,9131,90,829416,90.82522996057818,12
0.05,9132,93,829509,90.82546808277674,8
0.05,9133,95,829604,90.82592511495511,6
0.05,9134,92,829696,90.82605363984675,9
0.05,9135,94,829790,90.82640105078809,8
0.05,9136,95,829885,90.82685783079785,7
0.05,9137,92,829977,90.82698621142482,9
0.05,9138,92,830069,90.82711456395667,10
0.05,9139,94,830163,90.82746170678337,7
0.05,9140,94,830257,90.82780877365715,7
0.05,9141,94,830351,90.82815576460293,7
0.05,9142,92,830443,90.82828393306355,9
0.05,9143,93,830536,90.82852143482064,8
0.05,9144,93,830629,90.82875888463641,8
0.05,9145,96,830725,90.82932429477367,6
0.05,9146,95,830820,90.82978025582157,6
0.05,9147,94,830914,90.83012680367294,7
0.05,9148,95,831009,90.83058257733086,7
0.05,9149,91,831100,90.83060109289617,10
0.05,9150,92,831192,90.83072888208939,9
0.05,9151,93,831285,90.8309659090909,8
0.05,9152,91,831376,90.8309843767071,10
0.05,9153,27,831403,90.8240113611536,6
0.05,9154,95,831498,90.82446750409612,6
0.05,9155,21,831519,90.81684141546526,12
0.05,9156,96,831615,90.8174074478541,6
0.05,9157,94,831709,90.8177549683337,7
0.05,9158,91,831800,90.81777486625177,10
0.05,9159,95,831895,90.81823144104804,6
0.05,9160,94,831989,90.81857875777753,7
0.05,9161,93,832082,90.81881685221568,8
0.05,9162,89,832171,90.81861835643348,12
0.05,9163,94,832265,90.81896551724138,7
0.05,9164,94,832359,90.81931260229132,7
0.05,9165,94,832453,90.81965961160812,7
0.05,9166,94,832547,90.82000654521654,7
0.05,9167,91,832638,90.82002617801047,10
0.05,9168,94,832732,90.82037299596466,8
0.05,9169,95,832827,90.82082878953108,6
0.05,9170,95,832922,90.82128448369862,6
0.05,9171,91,833013,90.82130396860009,10
0.05,9172,95,833108,90.82175951161015,6
0.05,9173,93,833201,90.82199694789622,8
0.05,9174,92,833293,90.82212534059946,9
0.05,9175,96,833389,90.82268962510898,6
0.05,9176,94,833483,90.8230358504958,7
0.05,9177,94,833577,90.82338200043583,7
0.05,9178,95,833672,90.82383701928315,6
0.05,9179,93,833765,90.82407407407408,8
0.05,9180,92,833857,90.82420215662782,9
0.05,9181,94,833951,90.8245480287519,7
0.05,9182,93,834044,90.82478492867254,8
0.05,9183,94,834138,90.82513066202091,8
0.05,9184,93,834231,90.82536744692433,8
0.05,9185,93,834324,90.82560418027433,8
0.05,9186,94,834418,90.82594971154893,7
0.05,9187,92,834510,90.82607749238137,10
0.05,9188,92,834602,90.82620524540211,9
0.05,9189,27,834629,90.81926006528836,6
0.05,9190,93,834722,90.81949733434882,8
0.05,9191,91,834813,90.81951697127937,10
0.05,9192,95,834908,90.81997171761122,7
0.05,9193,94,835002,90.82031759843376,8
0.05,9194,94,835096,90.82066340402393,7
0.05,9195,91,835187,90.82068290561114,10
0.05,9196,88,835275,90.82037620963358,13
0.05,9197,93,835368,90.82061317677756,8
0.05,9198,92,835460,90.82074138493314,9
0.05,9199,93,835553,90.82097826086957,8
0.05,9200,96,835649,90.82154113683295,6
0.05,9201,91,835740,90.8215605303195,10
0.05,9202,96,835836,90.82212322068891,6
0.05,9203,93,835929,90.82235984354628,8
0.05,9204,96,836025,90.82292232482347,6
0.05,9205,93,836118,90.82315880947209,8
0.05,9206,94,836212,90.82350385576191,7
0.05,9207,96,836308,90.82406602953954,6
0.05,9208,94,836402,90.8244109023781,7
0.05,9209,95,836497,90.82486427795874,6
0.05,9210,94,836591,90.82520898925198,7
0.05,9211,95,836686,90.82566217976553,7
0.05,9212,94,836780,90.82600672962118,7
0.05,9213,96,836876,90.82656826568265,6
0.05,9214,94,836970,90.82691264243081,7
0.05,9215,94,837064,90.82725694444444,7
0.05,9216,93,837157,90.82749267657589,8
0.05,9217,94,837251,90.82783684096333,8
0.05,9218,94,837345,90.82818093068663,7
0.05,9219,91,837436,90.82819956616052,11
0.05,9220,91,837527,90.82821819759245,10
0.05,9221,93,837620,90.82845369767946,8
0.05,9222,95,837715,90.82890599587986,6
0.05,9223,93,837808,90.82914137033825,8
0.05,9224,94,837902,90.82948509485095,8
0.05,9225,94,837996,90.82982874485151,7
0.05,9226,91,838087,90.8298471876016,10
0.05,9227,94,838181,90.83019072388383,7
0.05,9228,95,838276,90.83064253982013,6
0.05,9229,95,838371,90.83109425785482,7
0.05,9230,94,838465,90.83143754739464,8
0.05,9231,94,838559,90.83178076256499,7
0.05,9232,95,838654,90.83223221054912,6
0.05,9233,94,838748,90.8325752653238,7
0.05,9234,93,838841,90.8328099621007,8
0.05,9235,93,838934,90.83304460805543,8
0.05,9236,93,839027,90.8332792032045,8
0.05,9237,94,839121,90.83362199610305,7
0.05,9238,27,839148,90.8267128477108,6
0.05,9239,92,839240,90.82683982683983,9
0.05,9240,93,839333,90.82707499188399,8
0.05,9241,92,839425,90.8272019043497,9
0.05,9242,95,839520,90.82765335929894,6
0.05,9243,94,839614,90.82799653829511,7
0.05,9244,94,839708,90.8283396430503,7
0.05,9245,90,839798,90.82825005407744,12
0.05,9246,94,839892,90.82859305720774,7
0.05,9247,96,839988,90.82915224913495,6
0.05,9248,93,840081,90.82938696075252,8
0.05,9249,95,840176,90.82983783783784,6
0.05,9250,93,840269,90.83007242460275,8
0.05,9251,88,840357,90.82976653696498,13
0.05,9252,94,840451,90.83010915378796,7
0.05,9253,93,840544,90.83034363518479,10
0.05,9254,94,840638,90.83068611561318,7
0.05,9255,95,840733,90.83113656006914,6
0.05,9256,94,840827,90.83147888084693,7
0.05,9257,94,840921,90.83182112767336,7
0.05,9258,93,841014,90.83205529754834,8
0.05,9259,93,841107,90.83228941684665,8
0.05,9260,94,841201,90.83263146528452,7
0.05,9261,96,841297,90.83318937594473,6
0.05,9262,93,841390,90.83342329698802,8
0.05,9263,93,841483,90.83365716753022,8
0.05,9264,93,841576,90.8338909875877,8
0.05,9265,90,841666,90.83380099287719,11
0.05,9266,94,841760,90.83414265673896,7
0.05,9267,96,841856,90.83470004315926,6
0.05,9268,94,841950,90.8350415363038,7
0.05,9269,93,842043,90.83527508090614,8
0.05,9270,94,842137,90.83561643835617,7
0.05,9271,92,842229,90.83574201898188,9
0.05,9272,95,842324,90.83619109241884,6
0.05,9273,92,842416,90.83631658399827,10
0.05,9274,92,842508,90.83644204851753,9
0.05,9275,89,842597,90.83624407072014,12
0.05,9276,92,842689,90.83636951600732,9
0.05,9277,93,842782,90.8366027161026,8
0.05,9278,96,842878,90.83715917663541,6
0.05,9279,92,842970,90.83728448275862,9
0.05,9280,91,843061,90.83730201486908,10
0.05,9281,94,843155,90.83764274940745,7
0.05,9282,96,843251,90.83819885812775,7
0.05,9283,92,843343,90.8383239982766,9
0.05,9284,95,843438,90.83877221324717,6
0.05,9285,94,843532,90.83911264268792,7
0.05,9286,93,843625,90.83934532141703,8
0.05,9287,90,843715,90.83925495262704,11
0.05,9288,94,843809,90.83959522015287,7
0.05,9289,93,843902,90.83982777179763,8
0.05,9290,94,843996,90.84016790442364,8
0.05,9291,96,844092,90.84072320275506,6
0.05,9292,96,844188,90.84127838157754,6
0.05,9293,92,844280,90.84140305573489,9
0.05,9294,93,844373,90.84163528778913,8
0.05,9295,94,844467,90.84197504302927,7
0.05,9296,93,844560,90.84220716360116,8
0.05,9297,93,844653,90.84243923424393,8
0.05,9298,95,844748,90.84288633186364,6
0.05,9299,92,844840,90.84301075268817,10
0.05,9300,94,844934,90.84335017740028,7
0.05,9301,94,845028,90.84368952913351,7
0.05,9302,87,845115,90.84327636246373,14
0.05,9303,94,845209,90.84361564918315,7
0.05,9304,94,845303,90.8439548629769,8
0.05,9305,96,845399,90.844508918977,6
0.05,9306,92,845491,90.84463307188138,9
0.05,9307,94,845585,90.84497206703911,7
0.05,9308,94,845679,90.84531098936513,7
0.05,9309,95,845774,90.84575725026853,6
0.05,9310,94,845868,90.84609601546558,8
0.05,9311,95,845963,90.84654209621993,6
0.05,9312,96,846059,90.84709545796198,6
0.05,9313,93,846152,90.84732660511058,8
0.05,9314,96,846248,90.8478797638218,6
0.05,9315,94,846342,90.84821811936453,7
0.05,9316,94,846436,90.8485564022754,7
0.05,9317,96,846532,90.8491092509122,6
0.05,9318,94,846626,90.84944736559717,7
0.05,9319,93,846719,90.84967811158798,8
0.05,9320,93,846812,90.84990880806781,8
0.05,9321,96,846908,90.85046127440464,6
0.05,9322,88,846996,90.85015552933605,13
0.05,9323,95,847091,90.8506006006006,6
0.05,9324,93,847184,90.85083109919572,9
0.05,9325,94,847278,90.85116877546643,7
0.05,9326,93,847371,90.85139916371824,8
0.05,9327,94,847465,90.85173670668954,7
0.05,9328,96,847561,90.8522885625469,6
0.05,9329,96,847657,90.85284030010718,6
0.05,9330,95,847752,90.85328474975887,6
0.05,9331,94,847846,90.85362194599229,7
0.05,9332,94,847940,90.85395906996679,7
0.05,9333,95,848035,90.85440325691022,6
0.05,9334,95,848130,90.85484734868774,6
0.05,9335,92,848222,90.85497000856898,10
0.05,9336,91,848313,90.85498554139446,10
0.05,9337,94,848407,90.85532233883059,8
0.05,9338,18,848425,90.8475211478745,15
0.05,9339,96,848521,90.84807280513918,6
0.05,9340,92,848613,90.84819612461193,9
0.05,9341,91,848704,90.84821237422393,10
0.05,9342,93,848797,90.84844268436262,8
0.05,9343,95,848892,90.84888698630137,6
0.05,9344,92,848984,90.8490101658641,9
0.05,9345,92,849076,90.84913331906698,9
0.05,9346,95,849171,90.84957740451482,6
0.05,9347,92,849263,90.84970047068892,9
0.05,9348,90,849353,90.84960958391272,11
0.05,9349,91,849444,90.84962566844919,10
0.05,9350,94,849538,90.84996257084804,7
0.05,9351,93,849631,90.85019247219846,8
0.05,9352,95,849726,90.850636159521,7
0.05,9353,95,849821,90.85107975197776,6
0.05,9354,93,849914,90.85130946018172,8
0.05,9355,95,850009,90.85175288584865,6
0.05,9356,95,850104,90.85219621673613,6
0.05,9357,94,850198,90.85253259243429,7
0.05,9358,96,850294,90.85308259429426,6
0.05,9359,94,850388,90.8534188034188,7
0.05,9360,96,850484,90.85396859309903,6
0.05,9361,92,850576,90.85409100619526,9
0.05,9362,95,850671,90.85453380326818,6
0.05,9363,92,850763,90.85465612985904,9
0.05,9364,92,850855,90.85477843032568,9
0.05,9365,95,850950,90.85522101217168,6
0.05,9366,92,851042,90.8553432262197,9
0.05,9367,95,851137,90.85578565328778,6
0.05,9368,94,851231,90.85612125093392,7
0.05,9369,94,851325,90.85645677694771,7
0.05,9370,96,851421,90.85700565574645,6
0.05,9371,95,851516,90.85744771660265,6
0.05,9372,96,851612,90.85799637255948,6
0.05,9373,94,851706,90.85833155536591,7
0.05,9374,25,851731,90.85130666666667,8
0.05,9375,90,851821,90.85121587030717,11
0.05,9376,94,851915,90.85155166897728,7
0.05,9377,26,851941,90.8446363830241,7
0.05,9378,93,852034,90.84486619042542,8
0.05,9379,94,852128,90.84520255863539,7
0.05,9380,94,852222,90.84553885513272,7
0.05,9381,95,852317,90.84598166702196,6
0.05,9382,95,852412,90.8464243845252,6
0.05,9383,93,852505,90.84665387894289,10
0.05,9384,95,852600,90.84709643047417,6
0.05,9385,91,852691,90.84711272107394,10
0.05,9386,95,852786,90.84755512943433,6
0.05,9387,92,852878,90.84767788666383,9
0.05,9388,94,852972,90.84801363297476,8
0.05,9389,91,853063,90.84802981895633,10
0.05,9390,93,853156,90.84825897135555,10
0.05,9391,95,853251,90.84870102214651,6
0.05,9392,89,853340,90.84850420525923,12
0.05,9393,94,853434,90.84883968490526,7
0.05,9394,93,853527,90.84906865353912,8
0.05,9395,92,853619,90.84919114516816,9
0.05,9396,95,853714,90.84963286155156,6
0.05,9397,93,853807,90.84986167269632,9
0.05,9398,94,853901,90.85019682944994,8
0.05,9399,93,853994,90.8504255319149,8
0.05,9400,94,854088,90.85076055738752,7
0.05,9401,96,854184,90.851308232291,6
0.05,9402,95,854279,90.85174944166755,6
0.05,9403,94,854373,90.85208421948107,8
0.05,9404,93,854466,90.85231259968101,8
0.05,9405,94,854560,90.85264724643844,7
0.05,9406,94,854654,90.85298182204741,7
0.05,9407,94,854748,90.85331632653062,8
0.05,9408,94,854842,90.85365075991072,7
0.05,9409,26,854868,90.84675876726887,7
0.05,9410,96,854964,90.84730634364043,6
0.05,9411,94,855058,90.84764130896727,7
0.05,9412,96,855154,90.84818867523637,6
0.05,9413,94,855248,90.84852347567453,7
0.05,9414,95,855343,90.84896441848115,6
0.05,9415,94,855437,90.84929906542057,7
0.05,9416,94,855531,90.84963364128703,7
0.05,9417,88,855619,90.84933106816734,13
0.05,9418,96,855715,90.84987790635948,6
0.05,9419,94,855809,90.85021231422505,7
0.05,9420,95,855904,90.850652796943,7
0.05,9421,93,855997,90.85088091700275,8
0.05,9422,95,856092,90.85132123527539,6
0.05,9423,96,856188,90.8518675721562,6
0.05,9424,94,856282,90.85220159151194,8
0.05,9425,90,856372,90.85211118183747,11
0.05,9426,96,856468,90.85265726105867,6
0.05,9427,95,856563,90.85309715740348,6
0.05,9428,94,856657,90.85343090465585,7
0.05,9429,94,856751,90.85376458112407,7
0.05,9430,94,856845,90.85409818683067,7
0.05,9431,95,856940,90.85453774385073,6
0.05,9432,93,857033,90.85476518604898,9
0.05,9433,94,857127,90.85509857960568,7
0.05,9434,95,857222,90.85553789083201,6
0.05,9435,94,857316,90.85587113183553,8
0.05,9436,91,857407,90.85588640457773,10
0.05,9437,94,857501,90.85621953803772,7
0.05,9438,94,857595,90.85655260091112,7
0.05,9439,93,857688,90.85677966101694,8
0.05,9440,94,857782,90.85711259400487,7
0.05,9441,93,857875,90.8573395467062,8
0.05,9442,96,857971,90.85788414698719,6
0.05,9443,95,858066,90.85832274459975,6
0.05,9444,92,858158,90.85844362096347,9
0.05,9445,93,858251,90.85867033665043,9
0.05,9446,95,858346,90.85910871176034,6
0.05,9447,91,858437,90.85912362404741,10
0.05,9448,94,858531,90.85945602709282,7
0.05,9449,93,858624,90.85968253968254,8
0.05,9450,94,858718,90.86001481324728,7
0.05,9451,26,858744,90.85315277190013,6
0.05,9452,92,858836,90.85327409288057,10
0.05,9453,94,858930,90.85360693886186,7
0.05,9454,94,859024,90.8539397144368,7
0.05,9455,94,859118,90.85427241962775,7
0.05,9456,94,859212,90.85460505445701,7
0.05,9457,93,859305,90.85483188834849,8
0.05,9458,95,859400,90.85527011311979,7
0.05,9459,94,859494,90.85560253699789,7
0.05,9460,94,859588,90.85593489060354,7
0.05,9461,95,859683,90.8563728598605,6
0.05,9462,94,859777,90.85670506181972,7
0.05,9463,93,859870,90.85693153000845,8
0.05,9464,92,859962,90.85705229793977,9
0.05,9465,92,860054,90.85717304035495,9
0.05,9466,95,860149,90.85761064751242,6
0.05,9467,93,860242,90.85783692437685,8
0.05,9468,18,860260,90.85014257049319,14
0.05,9469,94,860354,90.85047518479409,7
0.05,9470,91,860445,90.85049097244219,11
0.05,9471,89,860534,90.85029560810811,12
0.05,9472,92,860626,90.85041697455928,10
0.05,9473,91,860717,90.85043276335233,10
0.05,9474,94,860811,90.85076517150395,7
0.05,9475,96,860907,90.85130856901647,6
0.05,9476,94,861001,90.85164081460378,7
0.05,9477,94,861095,90.8519729900823,8
0.05,9478,94,861189,90.85230509547421,7
0.05,9479,92,861281,90.85242616033756,9
0.05,9480,91,861372,90.85244172555637,10
0.05,9481,95,861467,90.85287913942206,6
0.05,9482,93,861560,90.85310555731309,8
0.05,9483,94,861654,90.85343736819907,7
0.05,9484,94,861748,90.85376910911967,7
0.05,9485,96,861844,90.85431161711996,6
0.05,9486,92,861936,90.85443238115316,9
0.05,9487,95,862031,90.85486930860034,6
0.05,9488,93,862124,90.85509537359047,8
0.05,9489,94,862218,90.8554267650158,7
0.05,9490,94,862312,90.85575808660836,7
0.05,9491,91,862403,90.85577328276443,10
0.05,9492,95,862498,90.8562098388286,6
0.05,9493,27,862525,90.84948388455867,6
0.05,9494,95,862620,90.84992101105846,6
0.05,9495,25,862645,90.84298652064027,8
0.05,9496,91,862736,90.84300305359588,10
0.05,9497,96,862832,90.84354600968625,6
0.05,9498,93,862925,90.84377302873986,8
0.05,9499,25,862950,90.83684210526316,7
0.05,9500,92,863042,90.83696453004947,10
0.05,9501,94,863136,90.83729741107135,7
0.05,9502,91,863227,90.83731453225298,10
0.05,9503,95,863322,90.83775252525253,6
0.05,9504,94,863416,90.83808521830615,7
0.05,9505,93,863509,90.83831264464548,8
0.05,9506,93,863602,90.83854002314084,8
0.05,9507,95,863697,90.83897770298695,6
0.05,9508,96,863793,90.83952045430645,6
0.05,9509,95,863888,90.83995793901157,6
0.05,9510,93,863981,90.84018504889076,9
0.05,9511,95,864076,90.84062237174096,6
0.05,9512,93,864169,90.84084936402817,8
0.05,9513,94,864263,90.84118141685937,8
0.05,9514,94,864357,90.84151339989491,7
0.05,9515,96,864453,90.84205548549811,6
0.05,9516,94,864547,90.84238730692445,7
0.05,9517,94,864641,90.84271905862576,7
0.05,9518,95,864736,90.8431557936758,9
0.05,9519,95,864831,90.84359243697479,6
0.05,9520,96,864927,90.84413401953576,6
0.05,9521,94,865021,90.8444654484352,7
0.05,9522,88,865109,90.84416675417411,13
0.05,9523,94,865203,90.8444981100378,8
0.05,9524,94,865297,90.84482939632547,7
0.05,9525,91,865388,90.84484568549233,10
0.05,9526,92,865480,90.84496693607642,9
0.05,9527,95,865575,90.84540302267003,6
0.05,9528,94,865669,90.84573407492917,8
0.05,9529,92,865761,90.84585519412381,9
0.05,9530,95,865856,90.84629105025705,7
0.05,9531,20,865876,90.8388585816198,12
0.05,9532,92,865968,90.83898038392951,9
0.05,9533,91,866059,90.83899727291798,10
0.05,9534,93,866152,90.83922391190352,8
0.05,9535,94,866246,90.83955536912751,7
0.05,9536,94,866340,90.83988675684178,7
0.05,9537,87,866427,90.8394841685888,14
0.05,9538,93,866520,90.83971066149492,8
0.05,9539,96,866616,90.84025157232705,6
0.05,9540,22,866638,90.83303636935332,11
0.05,9541,93,866731,90.83326346677845,8
0.05,9542,92,866823,90.83338572775857,9
0.05,9543,94,866917,90.83371751886001,7
0.05,9544,95,867012,90.83415400733368,6
0.05,9545,91,867103,90.834171380683,10
0.05,9546,94,867197,90.83450298523097,7
0.05,9547,93,867290,90.83472978634269,9
0.05,9548,90,867380,90.83464237092889,11
0.05,9549,95,867475,90.83507853403141,6
0.05,9550,96,867571,90.83561930687885,6
0.05,9551,94,867665,90.83595058626466,7
0.05,9552,92,867757,90.83607243797759,9
0.05,9553,96,867853,90.83661293698974,6
0.05,9554,96,867949,90.83715332286761,6
0.05,9555,93,868042,90.83737965676015,8
0.05,9556,89,868131,90.83718740190436,12
0.05,9557,94,868225,90.83751830926973,7
0.05,9558,94,868319,90.83784914740036,7
0.05,9559,94,868413,90.838179916318,7
0.05,9560,94,868507,90.83851061604435,7
0.05,9561,96,868603,90.83905040786446,6
0.05,9562,95,868698,90.83948551709715,7
0.05,9563,95,868793,90.83992053534087,6
0.05,9564,96,868889,90.84046001045478,6
0.05,9565,94,868983,90.84079029897553,7
0.05,9566,96,869079,90.84132957039824,6
0.05,9567,91,869170,90.84134615384616,10
0.05,9568,94,869264,90.84167624621172,7
0.05,9569,93,869357,90.84190177638453,9
0.05,9570,95,869452,90.84233622401003,6
0.05,9571,96,869548,90.84287505223568,6
0.05,9572,94,869642,90.84320484696542,7
0.05,9573,94,869736,90.84353457280133,7
0.05,9574,96,869832,90.84407310704961,6
0.05,9575,95,869927,90.84450710108605,6
0.05,9576,93,870020,90.84473217082594,8
0.05,9577,96,870116,90.84527041135937,6
0.05,9578,95,870211,90.84570414448272,8
0.05,9579,96,870307,90.84624217118999,6
0.05,9580,94,870401,90.84657133910865,7
0.05,9581,94,870495,90.84690043832185,7
0.05,9582,95,870590,90.84733382030679,6
0.05,9583,94,870684,90.84766277128547,7
0.05,9584,94,870778,90.84799165362546,7
0.05,9585,94,870872,90.84832046734822,7
0.05,9586,93,870965,90.84854490455825,8
0.05,9587,90,871055,90.84845640383813,11
0.05,9588,91,871146,90.84847220773803,10
0.05,9589,94,871240,90.8488008342023,7
0.05,9590,93,871333,90.8490251277239,8
0.05,9591,96,871429,90.84956213511259,6
0.05,9592,94,871523,90.8498905451892,8
0.05,9593,87,871610,90.8494892641234,14
0.05,9594,94,871704,90.84981761334028,7
0.05,9595,93,871797,90.85004168403502,8
0.05,9596,92,871889,90.85016150880483,10
0.05,9597,94,871983,90.85048968535112,8
0.05,9598,95,872078,90.85092197103864,6
0.05,9599,96,872174,90.85145833333333,6
0.05,9600,95,872269,90.85189042808041,6
0.05,9601,94,872363,90.8522182878567,7
0.05,9602,96,872459,90.85275434759971,6
0.05,9603,93,872552,90.85297792586422,8
0.05,9604,94,872646,90.85330557001562,7
0.05,9605,96,872742,90.85384134915678,6
0.05,9606,93,872835,90.85406474445716,8
0.05,9607,94,872929,90.85439217318901,7
0.05,9608,94,873023,90.85471953377042,7
0.05,9609,96,873119,90.85525494276796,6
0.05,9610,94,873213,90.85558214545833,7
0.05,9611,93,873306,90.85580524344569,8
0.05,9612,93,873399,90.85602829501717,9
0.05,9613,92,873491,90.85614728520908,9
0.05,9614,94,873585,90.85647425897037,7
0.05,9615,93,873678,90.85669717138103,9
0.05,9616,94,873772,90.85702401996464,8
0.05,9617,95,873867,90.85745477230194,6
0.05,9618,93,873960,90.85767751325501,8
0.05,9619,96,874056,90.85821205821206,6
0.05,9620,94,874150,90.85853861344974,7
0.05,9621,95,874245,90.85896902930783,6
0.05,9622,91,874336,90.85898368492154,10
0.05,9623,95,874431,90.85941396508728,6
0.05,9624,94,874525,90.85974025974026,7
0.05,9625,95,874620,90.86017037190942,6
0.05,9626,96,874716,90.86070426924276,6
0.05,9627,95,874811,90.86113419194018,6
0.05,9628,95,874906,90.86156402534012,6
0.05,9629,94,875000,90.86188992731049,7
0.05,9630,93,875093,90.86211193022531,9
0.05,9631,95,875188,90.8625415282392,6
0.05,9632,94,875282,90.86286722723969,7
0.05,9633,95,875377,90.86329665767074,6
0.05,9634,94,875471,90.8636222106902,7
0.05,9635,94,875565,90.86394769613948,7
0.05,9636,93,875658,90.86416934730725,8
0.05,9637,92,875750,90.8642871965138,9
0.05,9638,90,875840,90.8641975308642,12
0.05,9639,93,875933,90.86441908713692,8
0.05,9640,92,876025,90.86453687376829,9
0.05,9641,94,876119,90.8648620618129,7
0.05,9642,96,876215,90.86539458674686,6
0.05,9643,94,876309,90.8657196184156,8
0.05,9644,91,876400,90.86573354069466,10
0.05,9645,96,876496,90.86626580966204,6
0.05,9646,93,876589,90.86648699077433,8
0.05,9647,95,876684,90.86691542288557,6
0.05,9648,27,876711,90.86029640377241,6
0.05,9649,92,876803,90.86041450777202,9
0.05,9650,92,876895,90.86053258729666,9
0.05,9651,96,876991,90.86106506423539,6
0.05,9652,94,877085,90.86139024137574,7
0.05,9653,96,877181,90.86192251916304,6
0.05,9654,91,877272,90.86193682030036,10
0.05,9655,94,877366,90.8622618061309,7
0.05,9656,95,877461,90.86269027648338,6
0.05,9657,92,877553,90.86280803478981,9
0.05,9658,91,877644,90.86282223832696,10
0.05,9659,95,877739,90.86325051759835,6
0.05,9660,27,877766,90.85664009936859,6
0.05,9661,94,877860,90.85696543158767,7
0.05,9662,93,877953,90.85718720894133,8
0.05,9663,96,878049,90.85771937086092,6
0.05,9664,94,878143,90.85804449042938,7
0.05,9665,91,878234,90.85805917649493,11
0.05,9666,94,878328,90.85838419364849,7
0.05,9667,95,878423,90.8588125775755,6
0.05,9668,94,878517,90.85913744958114,7
0.05,9669,96,878613,90.85966907962772,6
0.05,9670,93,878706,90.85989039396132,9
0.05,9671,94,878800,90.86021505376344,7
0.05,9672,93,878893,90.86043626589476,9
0.05,9673,94,878987,90.8607608021501,7
0.05,9674,96,879083,90.86129198966408,6
0.05,9675,90,879173,90.86120297643654,11
0.05,9676,96,879269,90.8617340084737,6
0.05,9677,94,879363,90.8620582765034,7
0.05,9678,20,879383,90.8547370596136,12
0.05,9679,93,879476,90.85495867768596,8
0.05,9680,95,879571,90.85538684020246,6
0.05,9681,94,879665,90.85571162982855,7
0.05,9682,96,879761,90.85624289992771,6
0.05,9683,95,879856,90.85667079719124,6
0.05,9684,96,879952,90.85720185854414,6
0.05,9685,96,880048,90.85773281024159,6
0.05,9686,93,880141,90.85795395891401,8
0.05,9687,93,880234,90.85817506193229,8
0.05,9688,92,880326,90.85829290948499,9
0.05,9689,95,880421,90.85872033023736,6
0.05,9690,95,880516,90.8591476627799,6
0.05,9691,94,880610,90.85947172926124,7
0.05,9692,90,880700,90.85938305994016,11
0.05,9693,91,880791,90.85939756550444,10
0.05,9694,92,880883,90.85951521402785,9
0.05,9695,90,880973,90.85942656765677,11
0.05,9696,93,881066,90.85964731360214,8
0.05,9697,94,881160,90.85997112806764,7
0.05,9698,93,881253,90.86019177234766,8
0.05,9699,27,881280,90.85360824742268,6
0.05,9700,91,881371,90.85362333780023,10
0.05,9701,94,881465,90.85394763966192,7
0.05,9702,94,881559,90.85427187467793,7
0.05,9703,94,881653,90.85459604286892,8
0.05,9704,94,881747,90.85492014425554,7
0.05,9705,95,881842,90.85534720791263,6
0.05,9706,94,881936,90.85567116513856,7
0.05,9707,25,881961,90.84888751545117,7
0.05,9708,93,882054,90.849109074055,8
0.05,9709,93,882147,90.84933058702369,8
0.05,9710,91,882238,90.84934610235815,10
0.05,9711,94,882332,90.8496705107084,7
0.05,9712,91,882423,90.84968598785133,11
0.05,9713,94,882517,90.85001029442043,8
0.05,9714,95,882612,90.85043746783325,6
0.05,9715,93,882705,90.85065870728695,8
0.05,9716,94,882799,90.8509828136256,7
0.05,9717,95,882894,90.85140975509364,6
0.05,9718,96,882990,90.85193949994856,6
0.05,9719,94,883084,90.8522633744856,7
0.05,9720,93,883177,90.85248431231355,8
0.05,9721,94,883271,90.85280806418433,7
0.05,9722,94,883365,90.85313174946005,7
0.05,9723,94,883459,90.85345536816125,8
0.05,9724,95,883554,90.85388174807198,6
0.05,9725,95,883649,90.85430804030433,6
0.05,9726,92,883741,90.85442582502313,9
0.05,9727,95,883836,90.8548519736842,6
0.05,9728,95,883931,90.85527803474149,6
0.05,9729,94,884025,90.85560123329907,8
0.05,9730,96,884121,90.8561298941527,6
0.05,9731,94,884215,90.85645293875874,7
0.05,9732,94,884309,90.85677591698345,7
0.05,9733,94,884403,90.85709882884734,7
0.05,9734,94,884497,90.85742167437083,7
0.05,9735,94,884591,90.85774445357437,7
0.05,9736,94,884685,90.85806716647838,7
0.05,9737,95,884780,90.85849250359416,6
0.05,9738,96,884876,90.85902043330937,6
0.05,9739,96,884972,90.85954825462012,6
0.05,9740,96,885068,90.8600759675598,6
0.05,9741,87,885155,90.85967973722029,14
0.05,9742,95,885250,90.86010469054706,7
0.05,9743,93,885343,90.86032430213464,8
0.05,9744,93,885436,90.8605438686506,8
0.05,9745,90,885526,90.86045557151652,11
0.05,9746,94,885620,90.8607776751821,7
0.05,9747,94,885714,90.86109971276159,7
0.05,9748,93,885807,90.86131910965227,8
0.05,9749,92,885899,90.8614358974359,9
0.05,9750,96,885995,90.8619628756025,6
0.05,9751,94,886089,90.86228465955702,7
0.05,9752,94,886183,90.86260637752487,8
0.05,9753,90,886273,90.8625179413574,11
0.05,9754,91,886364,90.86253203485393,10
0.05,9755,94,886458,90.86285362853629,7
0.05,9756,95,886553,90.86327764681766,6
0.05,9757,94,886647,90.86359909817585,7
0.05,9758,94,886741,90.86392048365612,7
0.05,9759,94,886835,90.86424180327869,7
0.05,9760,93,886928,90.8644606085442,8
0.05,9761,95,887023,90.86488424503176,6
0.05,9762,91,887114,90.86489808460514,10
0.05,9763,95,887209,90.86532158951249,7
0.05,9764,95,887304,90.86574500768049,6
0.05,9765,91,887395,90.86575875486382,10
0.05,9766,95,887490,90.86618204156855,6
0.05,9767,93,887583,90.8664004914005,8
0.05,9768,92,887675,90.86651653188657,9
0.05,9769,93,887768,90.86673490276357,8
0.05,9770,94,887862,90.86705557261283,7
0.05,9771,90,887952,90.86696684404421,12
0.05,9772,92,888044,90.86708277908524,9
0.05,9773,95,888139,90.86750562717414,6
0.05,9774,94,888233,90.86782608695653,7
0.05,9775,94,888327,90.8681464811784,7
0.05,9776,94,888421,90.86846680985988,8
0.05,9777,96,888517,90.86899161382696,6
0.05,9778,93,888610,90.86920953062685,8
0.05,9779,94,888704,90.86952965235174,7
0.05,9780,92,888796,90.86964523054903,9
0.05,9781,90,888886,90.8695563279493,12
0.05,9782,93,888979,90.86977409792497,8
0.05,9783,94,889073,90.87009403107113,8
0.05,9784,96,889169,90.87061829330608,6
0.05,9785,94,889263,90.87093807480073,7
0.05,9786,94,889357,90.87125779094717,8
0.05,9787,95,889452,90.87167960768288,6
0.05,9788,90,889542,90.87159056083358,11
0.05,9789,95,889637,90.87201225740552,6
0.05,9790,94,889731,90.87233173322439,7
0.05,9791,85,889816,90.87173202614379,16
0.05,9792,93,889909,90.87194935157765,8
0.05,9793,95,890004,90.87237083928936,6
0.05,9794,92,890096,90.87248596222562,9
0.05,9795,94,890190,90.87280522662311,7
0.05,9796,95,890285,90.87322649790752,6
0.05,9797,94,890379,90.87354562155542,7
0.05,9798,94,890473,90.87386468006939,7
0.05,9799,90,890563,90.87377551020408,11
0.05,9800,94,890657,90.87409448015508,7
0.05,9801,95,890752,90.87451540501938,8
0.05,9802,94,890846,90.87483423441803,7
0.05,9803,86,890932,90.87433700530396,15
0.05,9804,96,891028,90.8748597654258,6
0.05,9805,94,891122,90.87517846216602,8
0.05,9806,95,891217,90.87559906189456,6
0.05,9807,96,891313,90.87612153344209,6
0.05,9808,92,891405,90.87623610969518,9
0.05,9809,94,891499,90.87655453618757,7
0.05,9810,92,891591,90.87666904494955,9
0.05,9811,96,891687,90.87719119445576,6
0.05,9812,95,891782,90.87761133190665,6
0.05,9813,94,891876,90.87792948848583,8
0.05,9814,96,891972,90.87845134997453,6
0.05,9815,93,892065,90.87866748166259,8
0.05,9816,92,892157,90.87878170520526,9
0.05,9817,95,892252,90.87920146669383,6
0.05,9818,96,892348,90.87972298604745,6
0.05,9819,93,892441,90.87993890020367,8
0.05,9820,94,892535,90.88025659301496,7
0.05,9821,93,892628,90.88047240887803,9
0.05,9822,94,892722,90.88078998269368,7
0.05,9823,95,892817,90.88120928338762,6
0.05,9824,95,892912,90.88162849872774,6
0.05,9825,86,892998,90.8811316914309,15
0.05,9826,94,893092,90.88144906889183,7
0.05,9827,94,893186,90.88176638176638,8
0.05,9828,95,893281,90.88218536982399,6
0.05,9829,92,893373,90.8822990844354,9
0.05,9830,93,893466,90.88251449496491,8
0.05,9831,27,893493,90.87601708706265,6
0.05,9832,94,893587,90.87633479100987,7
0.05,9833,92,893679,90.8764490543014,9
0.05,9834,94,893773,90.87676664972038,7
0.05,9835,92,893865,90.87688084587231,9
0.05,9836,94,893959,90.87719833282505,7
0.05,9837,95,894054,90.87761740191095,7
0.05,9838,21,894075,90.87051529626994,11
0.05,9839,94,894169,90.87083333333334,8
0.05,9840,94,894263,90.87115130576161,7
0.05,9841,94,894357,90.87146921357447,7
0.05,9842,88,894445,90.87117748653866,13
0.05,9843,95,894540,90.87159691182447,7
0.05,9844,95,894635,90.87201625190453,6
0.05,9845,91,894726,90.87202925045703,11
0.05,9846,93,894819,90.87224535391489,8
0.05,9847,95,894914,90.87266450040617,6
0.05,9848,95,895009,90.87308356178292,6
0.05,9849,95,895104,90.87350253807107,6
0.05,9850,93,895197,90.87371840422293,8
0.05,9851,96,895293,90.87423873325213,6
0.05,9852,94,895387,90.87455597280017,7
0.05,9853,95,895482,90.87497462959205,8
0.05,9854,96,895578,90.87549467275495,6
0.05,9855,27,895605,90.8690137987013,7
0.05,9856,90,895695,90.86892563660344,11
0.05,9857,95,895790,90.86934469466424,6
0.05,9858,92,895882,90.86945937721879,9
0.05,9859,94,895976,90.86977687626775,7
0.05,9860,92,896068,90.86989149173512,9
0.05,9861,94,896162,90.8702088825796,7
0.05,9862,95,896257,90.87062759809389,6
0.05,9863,95,896352,90.87104622871047,6
0.05,9864,93,896445,90.87126203750634,9
0.05,9865,93,896538,90.87147780255422,8
0.05,9866,94,896632,90.87179487179488,8
0.05,9867,27,896659,90.8653222537495,6
0.05,9868,95,896754,90.86574120984902,6
0.05,9869,93,896847,90.86595744680851,8
0.05,9870,93,896940,90.86617363995542,8
0.05,9871,93,897033,90.86638978930308,8
0.05,9872,96,897129,90.8669097538742,6
0.05,9873,94,897223,90.8672270609682,7
0.05,9874,92,897315,90.8673417721519,9
0.05,9875,95,897410,90.86776022681248,6
0.05,9876,94,897504,90.8680773514225,7
0.05,9877,95,897599,90.86849564689209,6
0.05,9878,96,897695,90.86901508249822,6
0.05,9879,93,897788,90.86923076923077,8
0.05,9880,92,897880,90.8693452079749,9
0.05,9881,94,897974,90.86966201173851,7
0.05,9882,94,898068,90.86997875139127,8
0.05,9883,93,898161,90.87019425333872,8
0.05,9884,94,898255,90.87051087506323,7
0.05,9885,96,898351,90.87102973902488,6
0.05,9886,94,898445,90.87134621219784,7
0.05,9887,94,898539,90.87166262135922,7
0.05,9888,93,898632,90.87187784406916,8
0.05,9889,92,898724,90.87199191102124,9
0.05,9890,94,898818,90.87230815893237,7
0.05,9891,94,898912,90.87262434290335,8
0.05,9892,93,899005,90.87283938138077,8
0.05,9893,92,899097,90.87295330503335,9
0.05,9894,96,899193,90.87347145022738,6
0.05,9895,90,899283,90.8733831851253,11
0.05,9896,92,899375,90.87349701929878,9
0.05,9897,91,899466,90.87350979995959,10
0.05,9898,92,899558,90.87362359834327,9
0.05,9899,94,899652,90.8739393939394,7
0.05,9900,94,899746,90.87425512574488,7
0.05,9901,94,899840,90.87457079377903,7
0.05,9902,96,899936,90.87508835706352,6
0.05,9903,96,900032,90.87560581583199,6
0.05,9904,93,900125,90.87582029278143,9
0.05,9905,94,900219,90.87613567534828,7
0.05,9906,96,900315,90.87665287170688,6
0.05,9907,94,900409,90.87696810658053,7
0.05,9908,96,900505,90.87748511454234,6
0.05,9909,94,900599,90.87780020181634,7
0.05,9910,94,900693,90.87811522550702,7
0.05,9911,95,900788,90.87853107344633,7
0.05,9912,96,900884,90.87904771512156,6
0.05,9913,94,900978,90.8793625176518,8
0.05,9914,96,901074,90.87987897125568,6
0.05,9915,94,901168,90.88019362646229,7
0.05,9916,95,901263,90.8806090551578,6
0.05,9917,90,901353,90.8805202661827,11
0.05,9918,95,901448,90.88093557818328,7
0.05,9919,95,901543,90.88135080645161,6
0.05,9920,94,901637,90.88166515472231,7
0.05,9921,95,901732,90.88208022576093,6
0.05,9922,92,901824,90.88219288521617,9
0.05,9923,95,901919,90.88260781942765,7
0.05,9924,94,902013,90.88292191435768,7
0.05,9925,95,902108,90.88333669151723,6
0.05,9926,94,902202,90.88365064974313,7
0.05,9927,95,902297,90.88406526994359,6
0.05,9928,95,902392,90.88447980662706,6
0.05,9929,89,902481,90.88429003021147,12
0.05,9930,96,902577,90.88480515557346,6
0.05,9931,92,902669,90.88491743858236,9
0.05,9932,92,902761,90.88502969898319,9
0.05,9933,94,902855,90.88534326555265,7
0.05,9934,92,902947,90.8854554604932,10
0.05,9935,94,903041,90.885768921095,7
0.05,9936,93,903134,90.88598168461306,8
0.05,9937,91,903225,90.88599315757698,10
0.05,9938,94,903319,90.88630646946373,7
0.05,9939,95,903414,90.88672032193159,7
0.05,9940,94,903508,90.88703349763605,7
0.05,9941,94,903602,90.88734661033997,7
0.05,9942,92,903694,90.88745851352711,9
0.05,9943,90,903784,90.88736926790024,12
0.05,9944,93,903877,90.8875816993464,8
0.05,9945,94,903971,90.88789463100744,7
0.05,9946,94,904065,90.88820749974867,7
0.05,9947,95,904160,90.8886208283072,7
0.05,9948,94,904254,90.88893356116192,7
0.05,9949,95,904349,90.88934673366835,6
0.05,9950,90,904439,90.88925736106924,11
0.05,9951,91,904530,90.88926848874598,11
0.05,9952,95,904625,90.88968150306441,6
0.05,9953,93,904718,90.88989351014668,8
0.05,9954,94,904812,90.89020592667002,7
0.05,9955,95,904907,90.89061872237846,6
0.05,9956,94,905001,90.89093100331425,7
0.05,9957,95,905096,90.89134364330187,6
0.05,9958,93,905189,90.89155537704589,8
0.05,9959,95,905284,90.89196787148595,6
0.05,9960,93,905377,90.89217950005019,8
0.05,9961,96,905473,90.8926922304758,6
0.05,9962,94,905567,90.89300411522633,7
0.05,9963,95,905662,90.89341629867523,7
0.05,9964,91,905753,90.89342699448068,10
0.05,9965,94,905847,90.8937387116195,7
0.05,9966,95,905942,90.8941506973011,6
0.05,9967,95,906037,90.89456260032102,6
0.05,9968,96,906133,90.89507473166817,6
0.05,9969,96,906229,90.89558676028085,6
0.05,9970,94,906323,90.89589810450306,7
0.05,9971,94,906417,90.89620938628158,7
0.05,9972,95,906512,90.89662087636619,6
0.05,9973,96,906608,90.897132544616,6
0.05,9974,88,906696,90.89684210526316,13
0.05,9975,94,906790,90.89715316760224,7
0.05,9976,95,906885,90.89756439811566,6
0.05,9977,96,906981,90.89807576668672,6
0.05,9978,92,907073,90.8981861910011,9
0.05,9979,95,907168,90.89859719438877,6
0.05,9980,94,907262,90.89890792505761,7
0.05,9981,94,907356,90.89921859346825,7
0.05,9982,94,907450,90.89952919963939,7
0.05,9983,27,907477,90.89312900641026,6
0.05,9984,94,907571,90.89344016024036,7
0.05,9985,94,907665,90.89375125175245,10
0.05,9986,91,907756,90.8937618904576,10
0.05,9987,93,907849,90.89397276732079,9
0.05,9988,96,907945,90.89448393232556,6
0.05,9989,96,908041,90.89499499499499,6
0.05,9990,90,908131,90.89490541487339,11
0.05,9991,94,908225,90.89521617293835,7
0.05,9992,93,908318,90.89542679875913,8
0.05,9993,92,908410,90.89553732239344,10
0.05,9994,96,908506,90.896048024012,6
0.05,9995,94,908600,90.89635854341736,7
0.05,9996,93,908693,90.8965689706912,8
0.05,9997,95,908788,90.89697939587917,7
0.05,9998,93,908881,90.8971897189719,8
0.05,9999,93,908974,90.8974,8
