0.2,0,-35,-35,-35.0,159
0.2,1,-71,-106,-53.0,108
0.2,2,-5,-111,-37.0,67
0.2,3,92,-19,-4.75,27
0.2,4,87,68,13.6,14
0.2,5,84,152,25.333333333333332,70
0.2,6,12,164,23.428571428571427,36
0.2,7,18,182,22.75,28
0.2,8,84,266,29.555555555555557,25
0.2,9,87,353,35.3,41
0.2,10,95,448,40.72727272727273,13
0.2,11,91,539,44.916666666666664,21
0.2,12,95,634,48.76923076923077,9
0.2,13,26,660,47.142857142857146,7
0.2,14,82,742,49.46666666666667,68
0.2,15,88,830,51.875,18
0.2,16,95,925,54.411764705882355,6
0.2,17,90,1015,56.388888888888886,15
0.2,18,93,1108,58.31578947368421,10
0.2,19,21,1129,56.45,21
0.2,20,21,1150,54.76190476190476,25
0.2,21,24,1174,53.36363636363637,8
0.2,22,94,1268,55.130434782608695,10
0.2,23,25,1293,53.875,11
0.2,24,88,1381,55.24,37
0.2,25,93,1474,56.69230769230769,12
0.2,26,22,1496,55.407407407407405,12
0.2,27,95,1591,56.82142857142857,7
0.2,28,20,1611,55.55172413793103,13
0.2,29,23,1634,54.46666666666667,9
0.2,30,21,1655,53.38709677419355,11
0.2,31,92,1747,54.59375,9
0.2,32,92,1839,55.72727272727273,9
0.2,33,91,1930,56.76470588235294,11
0.2,34,91,2021,57.74285714285714,11
0.2,35,91,2112,58.666666666666664,13
0.2,36,95,2207,59.648648648648646,6
0.2,37,94,2301,60.55263157894737,7
0.2,38,90,2391,61.30769230769231,11
0.2,39,95,2486,62.15,6
0.2,40,90,2576,62.829268292682926,11
0.2,41,89,2665,63.45238095238095,12
0.2,42,95,2760,64.18604651162791,9
0.2,43,81,2841,64.56818181818181,20
0.2,44,94,2935,65.22222222222223,7
0.2,45,89,3024,65.73913043478261,12
0.2,46,94,3118,66.34042553191489,7
0.2,47,-122,2996,62.416666666666664,17
0.2,48,95,3091,63.08163265306123,7
0.2,49,93,3184,63.68,8
0.2,50,94,3278,64.27450980392157,7
0.2,51,96,3374,64.88461538461539,6
0.2,52,92,3466,65.39622641509433,10
0.2,53,95,3561,65.94444444444444,6
0.2,54,90,3651,66.38181818181818,11
0.2,55,92,3743,66.83928571428571,9
0.2,56,95,3838,67.33333333333333,6
0.2,57,94,3932,67.79310344827586,7
0.2,58,24,3956,67.05084745762711,8
0.2,59,94,4050,67.5,7
0.2,60,93,4143,67.91803278688525,8
0.2,61,94,4237,68.33870967741936,7
0.2,62,16,4253,67.5079365079365,16
0.2,63,20,4273,66.765625,12
0.2,64,94,4367,67.18461538461538,8
0.2,65,91,4458,67.54545454545455,10
0.2,66,93,4551,67.92537313432835,9
0.2,67,96,4647,68.33823529411765,6
0.2,68,18,4665,67.6086956521739,19
0.2,69,94,4759,67.98571428571428,8
0.2,70,92,4851,68.32394366197182,9
0.2,71,25,4876,67.72222222222223,8
0.2,72,21,4897,67.08219178082192,13
0.2,73,-55,4842,65.43243243243244,19
0.2,74,-130,4712,62.82666666666667,27
0.2,75,94,4806,63.23684210526316,7
0.2,76,87,4893,63.54545454545455,14
0.2,77,91,4984,63.8974358974359,11
0.2,78,89,5073,64.21518987341773,13
0.2,79,93,5166,64.575,8
0.2,80,87,5253,64.85185185185185,14
0.2,81,95,5348,65.21951219512195,6
0.2,82,94,5442,65.56626506024097,8
0.2,83,93,5535,65.89285714285714,8
0.2,84,93,5628,66.21176470588236,8
0.2,85,91,5719,66.5,12
0.2,86,92,5811,66.79310344827586,11
0.2,87,95,5906,67.11363636363636,6
0.2,88,92,5998,67.3932584269663,9
0.2,89,86,6084,67.6,17
0.2,90,96,6180,67.91208791208791,6
0.2,91,21,6201,67.40217391304348,11
0.2,92,20,6221,66.89247311827957,12
0.2,93,94,6315,67.18085106382979,7
0.2,94,26,6341,66.74736842105263,7
0.2,95,95,6436,67.04166666666667,6
0.2,96,94,6530,67.31958762886597,8
0.2,97,26,6556,66.89795918367346,8
0.2,98,94,6650,67.17171717171718,8
0.2,99,92,6742,67.42,10
0.2,100,92,6834,67.66336633663366,9
0.2,101,94,6928,67.92156862745098,7
0.2,102,93,7021,68.16504854368932,8
0.2,103,20,7041,67.70192307692308,12
0.2,104,91,7132,67.92380952380952,10
0.2,105,27,7159,67.5377358490566,6
0.2,106,93,7252,67.77570093457943,8
0.2,107,93,7345,68.00925925925925,10
0.2,108,27,7372,67.63302752293578,6
0.2,109,96,7468,67.89090909090909,6
0.2,110,93,7561,68.11711711711712,8
0.2,111,27,7588,67.75,6
0.2,112,96,7684,68.0,6
0.2,113,88,7772,68.17543859649123,13
0.2,114,89,7861,68.35652173913043,14
0.2,115,-49,7812,67.34482758620689,12
0.2,116,90,7902,67.53846153846153,11
0.2,117,93,7995,67.7542372881356,8
0.2,118,94,8089,67.97478991596638,8
0.2,119,94,8183,68.19166666666666,7
0.2,120,91,8274,68.3801652892562,10
0.2,121,95,8369,68.59836065573771,6
0.2,122,94,8463,68.8048780487805,7
0.2,123,96,8559,69.0241935483871,6
0.2,124,95,8654,69.232,7
0.2,125,24,8678,68.87301587301587,8
0.2,126,93,8771,69.06299212598425,10
0.2,127,94,8865,69.2578125,7
0.2,128,95,8960,69.45736434108527,6
0.2,129,92,9052,69.63076923076923,10
0.2,130,94,9146,69.81679389312977,7
0.2,131,95,9241,70.00757575757575,6
0.2,132,91,9332,70.16541353383458,10
0.2,133,93,9425,70.33582089552239,8
0.2,134,87,9512,70.45925925925926,14
0.2,135,95,9607,70.63970588235294,8
0.2,136,92,9699,70.7956204379562,9
0.2,137,94,9793,70.96376811594203,9
0.2,138,88,9881,71.0863309352518,13
0.2,139,90,9971,71.22142857142858,11
0.2,140,94,10065,71.38297872340425,7
0.2,141,93,10158,71.53521126760563,8
0.2,142,92,10250,71.67832167832168,9
0.2,143,93,10343,71.82638888888889,8
0.2,144,90,10433,71.95172413793104,11
0.2,145,93,10526,72.0958904109589,9
0.2,146,23,10549,71.76190476190476,10
0.2,147,91,10640,71.89189189189189,10
0.2,148,94,10734,72.04026845637584,7
0.2,149,92,10826,72.17333333333333,9
0.2,150,94,10920,72.31788079470199,7
0.2,151,95,11015,72.46710526315789,6
0.2,152,93,11108,72.60130718954248,9
0.2,153,91,11199,72.72077922077922,10
0.2,154,-45,11154,71.96129032258065,8
0.2,155,22,11176,71.64102564102564,10
0.2,156,84,11260,71.71974522292993,17
0.2,157,91,11351,71.84177215189874,10
0.2,158,94,11445,71.98113207547169,8
0.2,159,93,11538,72.1125,10
0.2,160,93,11631,72.24223602484471,10
0.2,161,90,11721,72.35185185185185,13
0.2,162,25,11746,72.06134969325153,7
0.2,163,85,11831,72.14024390243902,16
0.2,164,95,11926,72.27878787878788,6
0.2,165,89,12015,72.37951807228916,12
0.2,166,95,12110,72.51497005988024,7
0.2,167,92,12202,72.63095238095238,10
0.2,168,92,12294,72.74556213017752,10
0.2,169,93,12387,72.86470588235294,8
0.2,170,89,12476,72.95906432748538,12
0.2,171,90,12566,73.05813953488372,11
0.2,172,95,12661,73.18497109826589,6
0.2,173,-56,12605,72.44252873563218,19
0.2,174,92,12697,72.55428571428571,9
0.2,175,95,12792,72.68181818181819,6
0.2,176,87,12879,72.76271186440678,15
0.2,177,95,12974,72.88764044943821,7
0.2,178,93,13067,73.0,8
0.2,179,-45,13022,72.34444444444445,9
0.2,180,93,13115,72.45856353591161,8
0.2,181,94,13209,72.57692307692308,7
0.2,182,93,13302,72.68852459016394,8
0.2,183,84,13386,72.75,17
0.2,184,95,13481,72.87027027027027,7
0.2,185,87,13568,72.94623655913979,14
0.2,186,91,13659,73.0427807486631,13
0.2,187,94,13753,73.15425531914893,7
0.2,188,93,13846,73.25925925925925,8
0.2,189,93,13939,73.36315789473684,8
0.2,190,91,14030,73.45549738219896,10
0.2,191,94,14124,73.5625,7
0.2,192,21,14145,73.29015544041451,11
0.2,193,96,14241,73.40721649484536,6
0.2,194,85,14326,73.46666666666667,16
0.2,195,85,14411,73.52551020408163,16
0.2,196,92,14503,73.61928934010152,10
0.2,197,93,14596,73.71717171717172,8
0.2,198,94,14690,73.81909547738694,7
0.2,199,91,14781,73.905,10
0.2,200,90,14871,73.98507462686567,11
0.2,201,94,14965,74.08415841584159,7
0.2,202,91,15056,74.16748768472907,12
0.2,203,91,15147,74.25,10
0.2,204,94,15241,74.34634146341463,7
0.2,205,93,15334,74.4368932038835,8
0.2,206,94,15428,74.53140096618357,8
0.2,207,-268,15160,72.88461538461539,26
0.2,208,20,15180,72.63157894736842,13
0.2,209,93,15273,72.72857142857143,8
0.2,210,94,15367,72.82938388625593,7
0.2,211,24,15391,72.59905660377359,8
0.2,212,89,15480,72.67605633802818,13
0.2,213,94,15574,72.77570093457943,7
0.2,214,93,15667,72.86976744186046,10
0.2,215,94,15761,72.9675925925926,7
0.2,216,95,15856,73.06912442396313,6
0.2,217,95,15951,73.1697247706422,6
0.2,218,95,16046,73.26940639269407,6
0.2,219,95,16141,73.36818181818182,6
0.2,220,96,16237,73.47058823529412,6
0.2,221,90,16327,73.54504504504504,11
0.2,222,90,16417,73.61883408071749,11
0.2,223,24,16441,73.39732142857143,10
0.2,224,96,16537,73.49777777777778,7
0.2,225,19,16556,73.2566371681416,17
0.2,226,95,16651,73.35242290748899,6
0.2,227,94,16745,73.44298245614036,7
0.2,228,21,16766,73.21397379912663,12
0.2,229,91,16857,73.29130434782608,10
0.2,230,93,16950,73.37662337662337,11
0.2,231,95,17045,73.46982758620689,6
0.2,232,19,17064,73.23605150214593,13
0.2,233,94,17158,73.32478632478633,7
0.2,234,95,17253,73.41702127659575,6
0.2,235,16,17269,73.17372881355932,17
0.2,236,24,17293,72.96624472573839,8
0.2,237,22,17315,72.75210084033614,10
0.2,238,96,17411,72.84937238493724,6
0.2,239,91,17502,72.925,10
0.2,240,95,17597,73.01659751037344,6
0.2,241,92,17689,73.09504132231405,9
0.2,242,25,17714,72.89711934156378,7
0.2,243,91,17805,72.97131147540983,11
0.2,244,95,17900,73.06122448979592,7
0.2,245,88,17988,73.1219512195122,13
0.2,246,94,18082,73.20647773279352,7
0.2,247,95,18177,73.29435483870968,6
0.2,248,94,18271,73.37751004016064,7
0.2,249,93,18364,73.456,9
0.2,250,96,18460,73.54581673306772,6
0.2,251,95,18555,73.63095238095238,9
0.2,252,91,18646,73.699604743083,10
0.2,253,96,18742,73.78740157480316,6
0.2,254,95,18837,73.87058823529412,6
0.2,255,95,18932,73.953125,7
0.2,256,25,18957,73.76264591439688,7
0.2,257,93,19050,73.83720930232558,8
0.2,258,96,19146,73.92277992277992,6
0.2,259,92,19238,73.99230769230769,11
0.2,260,92,19330,74.06130268199233,10
0.2,261,95,19425,74.1412213740458,8
0.2,262,92,19517,74.20912547528518,11
0.2,263,16,19533,73.98863636363636,17
0.2,264,90,19623,74.04905660377358,11
0.2,265,94,19717,74.12406015037594,7
0.2,266,91,19808,74.187265917603,10
0.2,267,95,19903,74.26492537313433,7
0.2,268,25,19928,74.0817843866171,9
0.2,269,26,19954,73.9037037037037,6
0.2,270,88,20042,73.95571955719558,14
0.2,271,84,20126,73.99264705882354,19
0.2,272,94,20220,74.06593406593407,8
0.2,273,95,20315,74.14233576642336,6
0.2,274,94,20409,74.21454545454546,7
0.2,275,95,20504,74.28985507246377,6
0.2,276,92,20596,74.35379061371842,9
0.2,277,90,20686,74.41007194244604,11
0.2,278,21,20707,74.21863799283155,11
0.2,279,94,20801,74.28928571428571,7
0.2,280,94,20895,74.35943060498221,10
0.2,281,96,20991,74.43617021276596,6
0.2,282,93,21084,74.5017667844523,9
0.2,283,95,21179,74.57394366197182,6
0.2,284,25,21204,74.4,7
0.2,285,96,21300,74.47552447552448,6
0.2,286,94,21394,74.54355400696865,8
0.2,287,93,21487,74.60763888888889,8
0.2,288,94,21581,74.67474048442907,7
0.2,289,94,21675,74.74137931034483,7
0.2,290,96,21771,74.81443298969072,6
0.2,291,92,21863,74.87328767123287,9
0.2,292,8,21871,74.64505119453925,28
0.2,293,93,21964,74.70748299319727,9
0.2,294,90,22054,74.7593220338983,12
0.2,295,94,22148,74.82432432432432,8
0.2,296,94,22242,74.88888888888889,7
0.2,297,93,22335,74.9496644295302,8
0.2,298,95,22430,75.01672240802675,6
0.2,299,92,22522,75.07333333333334,9
0.2,300,93,22615,75.1328903654485,8
0.2,301,96,22711,75.20198675496688,6
0.2,302,91,22802,75.25412541254126,10
0.2,303,92,22894,75.3092105263158,9
0.2,304,22,22916,75.1344262295082,11
0.2,305,89,23005,75.1797385620915,12
0.2,306,86,23091,75.21498371335505,15
0.2,307,92,23183,75.26948051948052,9
0.2,308,95,23278,75.33333333333333,6
0.2,309,92,23370,75.38709677419355,9
0.2,310,20,23390,75.20900321543408,13
0.2,311,94,23484,75.26923076923077,7
0.2,312,91,23575,75.31948881789137,10
0.2,313,92,23667,75.37261146496816,9
0.2,314,95,23762,75.43492063492063,6
0.2,315,90,23852,75.48101265822785,11
0.2,316,92,23944,75.53312302839117,9
0.2,317,91,24035,75.58176100628931,10
0.2,318,92,24127,75.6332288401254,10
0.2,319,91,24218,75.68125,10
0.2,320,94,24312,75.73831775700934,7
0.2,321,95,24407,75.79813664596273,6
0.2,322,91,24498,75.84520123839009,10
0.2,323,96,24594,75.9074074074074,6
0.2,324,87,24681,75.94153846153846,14
0.2,325,22,24703,75.7760736196319,10
0.2,326,23,24726,75.61467889908256,10
0.2,327,86,24812,75.64634146341463,16
0.2,328,93,24905,75.69908814589665,9
0.2,329,22,24927,75.53636363636363,12
0.2,330,91,25018,75.58308157099698,13
0.2,331,94,25112,75.63855421686748,7
0.2,332,92,25204,75.68768768768768,9
0.2,333,-46,25158,75.32335329341318,9
0.2,334,91,25249,75.37014925373134,10
0.2,335,90,25339,75.41369047619048,11
0.2,336,93,25432,75.46587537091987,8
0.2,337,94,25526,75.52071005917159,7
0.2,338,95,25621,75.57817109144543,8
0.2,339,88,25709,75.61470588235294,13
0.2,340,90,25799,75.65689149560117,11
0.2,341,19,25818,75.49122807017544,14
0.2,342,95,25913,75.54810495626822,7
0.2,343,24,25937,75.39825581395348,8
0.2,344,95,26032,75.45507246376812,8
0.2,345,93,26125,75.50578034682081,8
0.2,346,95,26220,75.56195965417868,7
0.2,347,94,26314,75.61494252873563,8
0.2,348,12,26326,75.432664756447,22
0.2,349,94,26420,75.48571428571428,8
0.2,350,92,26512,75.53276353276354,9
0.2,351,22,26534,75.38068181818181,11
0.2,352,94,26628,75.43342776203966,7
0.2,353,94,26722,75.48587570621469,12
0.2,354,95,26817,75.54084507042253,6
0.2,355,89,26906,75.57865168539325,12
0.2,356,88,26994,75.61344537815125,13
0.2,357,94,27088,75.66480446927375,7
0.2,358,95,27183,75.71866295264624,6
0.2,359,25,27208,75.57777777777778,7
0.2,360,90,27298,75.61772853185596,11
0.2,361,92,27390,75.66298342541437,9
0.2,362,91,27481,75.70523415977961,10
0.2,363,86,27567,75.73351648351648,15
0.2,364,92,27659,75.77808219178083,10
0.2,365,95,27754,75.83060109289617,6
0.2,366,95,27849,75.88283378746594,6
0.2,367,94,27943,75.9320652173913,7
0.2,368,95,28038,75.98373983739837,6
0.2,369,95,28133,76.03513513513514,7
0.2,370,92,28225,76.07816711590297,10
0.2,371,94,28319,76.1263440860215,7
0.2,372,90,28409,76.16353887399464,11
0.2,373,88,28497,76.1951871657754,14
0.2,374,93,28590,76.24,8
0.2,375,92,28682,76.28191489361703,11
0.2,376,95,28777,76.3315649867374,6
0.2,377,94,28871,76.37830687830687,8
0.2,378,19,28890,76.2269129287599,13
0.2,379,94,28984,76.27368421052631,7
0.2,380,94,29078,76.32020997375328,7
0.2,381,91,29169,76.3586387434555,10
0.2,382,93,29262,76.40208877284596,8
0.2,383,93,29355,76.4453125,8
0.2,384,25,29380,76.31168831168831,8
0.2,385,95,29475,76.360103626943,6
0.2,386,93,29568,76.40310077519379,8
0.2,387,20,29588,76.25773195876289,12
0.2,388,94,29682,76.30334190231362,8
0.2,389,93,29775,76.34615384615384,8
0.2,390,92,29867,76.38618925831202,9
0.2,391,89,29956,76.41836734693878,14
0.2,392,23,29979,76.2824427480916,9
0.2,393,25,30004,76.15228426395939,7
0.2,394,88,30092,76.18227848101266,14
0.2,395,87,30179,76.20959595959596,15
0.2,396,92,30271,76.24937027707809,11
0.2,397,89,30360,76.28140703517587,13
0.2,398,90,30450,76.3157894736842,13
0.2,399,27,30477,76.1925,6
0.2,400,89,30566,76.22443890274315,13
0.2,401,92,30658,76.2636815920398,9
0.2,402,89,30747,76.29528535980148,12
0.2,403,91,30838,76.33168316831683,10
0.2,404,90,30928,76.36543209876544,11
0.2,405,87,31015,76.39162561576354,14
0.2,406,93,31108,76.43243243243244,8
0.2,407,96,31204,76.48039215686275,6
0.2,408,92,31296,76.51833740831296,10
0.2,409,92,31388,76.55609756097562,9
0.2,410,94,31482,76.5985401459854,7
0.2,411,95,31577,76.64320388349515,6
0.2,412,27,31604,76.52300242130751,7
0.2,413,96,31700,76.57004830917874,6
0.2,414,96,31796,76.61686746987952,6
0.2,415,94,31890,76.65865384615384,7
0.2,416,91,31981,76.69304556354916,10
0.2,417,93,32074,76.73205741626795,10
0.2,418,13,32087,76.5799522673031,19
0.2,419,94,32181,76.62142857142857,9
0.2,420,92,32273,76.65795724465558,9
0.2,421,92,32365,76.69431279620854,9
0.2,422,95,32460,76.73758865248227,6
0.2,423,95,32555,76.78066037735849,6
0.2,424,89,32644,76.80941176470589,12
0.2,425,95,32739,76.85211267605634,6
0.2,426,90,32829,76.88290398126463,12
0.2,427,94,32923,76.92289719626169,7
0.2,428,94,33017,76.96270396270397,7
0.2,429,95,33112,77.0046511627907,7
0.2,430,95,33207,77.04640371229698,6
0.2,431,93,33300,77.08333333333333,8
0.2,432,86,33386,77.1039260969977,15
0.2,433,93,33479,77.1405529953917,8
0.2,434,95,33574,77.1816091954023,6
0.2,435,92,33666,77.21559633027523,9
0.2,436,90,33756,77.24485125858124,11
0.2,437,94,33850,77.28310502283105,7
0.2,438,91,33941,77.31435079726651,10
0.2,439,91,34032,77.34545454545454,10
0.2,440,94,34126,77.38321995464852,7
0.2,441,93,34219,77.41855203619909,8
0.2,442,90,34309,77.44695259593679,12
0.2,443,96,34405,77.48873873873873,6
0.2,444,92,34497,77.52134831460674,9
0.2,445,95,34592,77.56053811659193,6
0.2,446,20,34612,77.4317673378076,13
0.2,447,92,34704,77.46428571428571,9
0.2,448,91,34795,77.49443207126949,10
0.2,449,87,34882,77.51555555555555,14
0.2,450,95,34977,77.55432372505543,7
0.2,451,92,35069,77.58628318584071,9
0.2,452,94,35163,77.62251655629139,7
0.2,453,93,35256,77.65638766519824,8
0.2,454,92,35348,77.68791208791208,9
0.2,455,27,35375,77.57675438596492,6
0.2,456,95,35470,77.6148796498906,8
0.2,457,94,35564,77.65065502183405,8
0.2,458,88,35652,77.67320261437908,13
0.2,459,89,35741,77.69782608695652,12
0.2,460,91,35832,77.72668112798264,10
0.2,461,18,35850,77.59740259740259,14
0.2,462,95,35945,77.63498920086393,6
0.2,463,93,36038,77.66810344827586,8
0.2,464,95,36133,77.70537634408602,7
0.2,465,89,36222,77.72961373390558,12
0.2,466,91,36313,77.75802997858672,10
0.2,467,91,36404,77.78632478632478,10
0.2,468,91,36495,77.81449893390192,11
0.2,469,95,36590,77.85106382978724,6
0.2,470,96,36686,77.8895966029724,6
0.2,471,94,36780,77.92372881355932,7
0.2,472,17,36797,77.79492600422833,15
0.2,473,93,36890,77.82700421940929,8
0.2,474,91,36981,77.85473684210527,10
0.2,475,94,37075,77.88865546218487,8
0.2,476,94,37169,77.92243186582809,7
0.2,477,94,37263,77.9560669456067,7
0.2,478,95,37358,77.99164926931107,6
0.2,479,95,37453,78.02708333333334,7
0.2,480,88,37541,78.04781704781705,13
0.2,481,96,37637,78.0850622406639,6
0.2,482,92,37729,78.11387163561076,10
0.2,483,95,37824,78.14876033057851,6
0.2,484,91,37915,78.17525773195877,11
0.2,485,93,38008,78.20576131687243,9
0.2,486,80,38088,78.2094455852156,24
0.2,487,81,38169,78.21516393442623,22
0.2,488,92,38261,78.24335378323109,9
0.2,489,93,38354,78.2734693877551,8
0.2,490,89,38443,78.29531568228106,13
0.2,491,96,38539,78.33130081300813,6
0.2,492,94,38633,78.3630831643002,7
0.2,493,96,38729,78.39878542510121,6
0.2,494,92,38821,78.42626262626263,10
0.2,495,92,38913,78.45362903225806,9
0.2,496,96,39009,78.48893360160966,6
0.2,497,93,39102,78.51807228915662,8
0.2,498,92,39194,78.54509018036072,9
0.2,499,89,39283,78.566,12
0.2,500,95,39378,78.59880239520957,6
0.2,501,96,39474,78.63346613545816,6
0.2,502,92,39566,78.6600397614314,9
0.2,503,92,39658,78.68650793650794,9
0.2,504,92,39750,78.7128712871287,9
0.2,505,93,39843,78.7411067193676,8
0.2,506,23,39866,78.63116370808679,9
0.2,507,90,39956,78.65354330708661,11
0.2,508,92,40048,78.67976424361493,9
0.2,509,19,40067,78.56274509803922,13
0.2,510,84,40151,78.573385518591,17
0.2,511,96,40247,78.607421875,6
0.2,512,87,40334,78.62378167641326,14
0.2,513,92,40426,78.64980544747081,12
0.2,514,92,40518,78.67572815533981,9
0.2,515,94,40612,78.70542635658914,7
0.2,516,93,40705,78.73307543520309,8
0.2,517,94,40799,78.76254826254826,7
0.2,518,94,40893,78.79190751445087,7
0.2,519,88,40981,78.80961538461538,13
0.2,520,27,41008,78.71017274472169,6
0.2,521,76,41084,78.70498084291188,25
0.2,522,92,41176,78.73040152963671,9
0.2,523,94,41270,78.75954198473282,7
0.2,524,93,41363,78.78666666666666,9
0.2,525,92,41455,78.81178707224335,9
0.2,526,92,41547,78.83681214421253,9
0.2,527,94,41641,78.8655303030303,7
0.2,528,94,41735,78.89413988657844,7
0.2,529,96,41831,78.92641509433962,6
0.2,530,94,41925,78.954802259887,7
0.2,531,96,42021,78.98684210526316,6
0.2,532,93,42114,79.01313320825516,8
0.2,533,86,42200,79.02621722846442,15
0.2,534,95,42295,79.05607476635514,6
0.2,535,90,42385,79.07649253731343,13
0.2,536,93,42478,79.1024208566108,9
0.2,537,89,42567,79.12081784386618,12
0.2,538,92,42659,79.14471243042672,9
0.2,539,93,42752,79.17037037037036,8
0.2,540,94,42846,79.19778188539742,7
0.2,541,92,42938,79.22140221402213,9
0.2,542,92,43030,79.24493554327809,9
0.2,543,91,43121,79.26654411764706,10
0.2,544,92,43213,79.28990825688074,10
0.2,545,91,43304,79.31135531135531,11
0.2,546,93,43397,79.33638025594149,9
0.2,547,93,43490,79.36131386861314,8
0.2,548,92,43582,79.38433515482696,9
0.2,549,93,43675,79.4090909090909,8
0.2,550,90,43765,79.42831215970962,11
0.2,551,86,43851,79.44021739130434,15
0.2,552,91,43942,79.46112115732369,10
0.2,553,90,44032,79.48014440433214,11
0.2,554,94,44126,79.5063063063063,7
0.2,555,77,44203,79.50179856115108,24
0.2,556,95,44298,79.52962298025135,8
0.2,557,86,44384,79.54121863799283,15
0.2,558,94,44478,79.56708407871199,8
0.2,559,25,44503,79.46964285714286,8
0.2,560,26,44529,79.37433155080214,7
0.2,561,94,44623,79.40035587188612,9
0.2,562,92,44715,79.42273534635879,10
0.2,563,89,44804,79.43971631205673,13
0.2,564,92,44896,79.46194690265487,9
0.2,565,93,44989,79.48586572438163,8
0.2,566,26,45015,79.39153439153439,6
0.2,567,95,45110,79.41901408450704,8
0.2,568,95,45205,79.4463971880492,7
0.2,569,94,45299,79.4719298245614,7
0.2,570,95,45394,79.49912434325745,7
0.2,571,94,45488,79.52447552447552,7
0.2,572,15,45503,79.41186736474694,17
0.2,573,93,45596,79.43554006968641,8
0.2,574,88,45684,79.4504347826087,13
0.2,575,94,45778,79.47569444444444,7
0.2,576,24,45802,79.37954939341421,8
0.2,577,89,45891,79.3961937716263,12
0.2,578,90,45981,79.41450777202073,16
0.2,579,93,46074,79.43793103448276,9
0.2,580,90,46164,79.45611015490533,11
0.2,581,88,46252,79.47079037800687,15
0.2,582,93,46345,79.49399656946827,8
0.2,583,94,46439,79.51883561643835,7
0.2,584,92,46531,79.54017094017094,9
0.2,585,90,46621,79.5580204778157,11
0.2,586,94,46715,79.58262350936968,8
0.2,587,89,46804,79.59863945578232,12
0.2,588,89,46893,79.61460101867573,12
0.2,589,89,46982,79.63050847457627,14
0.2,590,96,47078,79.65820642978004,6
0.2,591,91,47169,79.67736486486487,10
0.2,592,92,47261,79.6981450252951,10
0.2,593,96,47357,79.72558922558923,6
0.2,594,93,47450,79.74789915966386,8
0.2,595,78,47528,79.74496644295301,23
0.2,596,96,47624,79.77219430485762,6
0.2,597,88,47712,79.78595317725753,13
0.2,598,85,47797,79.79465776293823,18
0.2,599,95,47892,79.82,6
0.2,600,91,47983,79.83860232945092,11
0.2,601,95,48078,79.86378737541528,7
0.2,602,20,48098,79.76451077943615,15
0.2,603,93,48191,79.7864238410596,8
0.2,604,87,48278,79.79834710743802,14
0.2,605,96,48374,79.82508250825083,6
0.2,606,95,48469,79.8500823723229,6
0.2,607,26,48495,79.76151315789474,6
0.2,608,95,48590,79.78653530377669,6
0.2,609,96,48686,79.81311475409836,6
0.2,610,95,48781,79.8379705400982,6
0.2,611,88,48869,79.85130718954248,13
0.2,612,95,48964,79.87601957585645,6
0.2,613,95,49059,79.90065146579805,7
0.2,614,91,49150,79.91869918699187,11
0.2,615,87,49237,79.9301948051948,14
0.2,616,89,49326,79.94489465153971,14
0.2,617,91,49417,79.96278317152104,10
0.2,618,94,49511,79.98546042003231,7
0.2,619,95,49606,80.00967741935484,6
0.2,620,92,49698,80.02898550724638,11
0.2,621,91,49789,80.04662379421222,11
0.2,622,91,49880,80.06420545746388,11
0.2,623,84,49964,80.07051282051282,17
0.2,624,95,50059,80.0944,6
0.2,625,94,50153,80.11661341853035,7
0.2,626,86,50239,80.12599681020734,15
0.2,627,95,50334,80.14968152866243,6
0.2,628,93,50427,80.17011128775835,8
0.2,629,95,50522,80.19365079365079,6
0.2,630,94,50616,80.21553090332804,8
0.2,631,93,50709,80.23575949367088,8
0.2,632,93,50802,80.25592417061611,8
0.2,633,91,50893,80.27287066246056,10
0.2,634,94,50987,80.29448818897637,9
0.2,635,92,51079,80.312893081761,9
0.2,636,91,51170,80.32967032967034,10
0.2,637,94,51264,80.35109717868339,7
0.2,638,88,51352,80.36306729264476,13
0.2,639,92,51444,80.38125,9
0.2,640,95,51539,80.40405616224649,6
0.2,641,93,51632,80.42367601246106,9
0.2,642,94,51726,80.4447900466563,7
0.2,643,96,51822,80.46894409937889,6
0.2,644,95,51917,80.49147286821706,8
0.2,645,91,52008,80.50773993808049,10
0.2,646,90,52098,80.52241112828439,11
0.2,647,89,52187,80.5354938271605,12
0.2,648,92,52279,80.55315870570108,10
0.2,649,95,52374,80.57538461538462,6
0.2,650,89,52463,80.58832565284179,12
0.2,651,94,52557,80.60889570552148,8
0.2,652,95,52652,80.63093415007657,6
0.2,653,94,52746,80.65137614678899,8
0.2,654,95,52841,80.67328244274809,6
0.2,655,92,52933,80.6905487804878,9
0.2,656,95,53028,80.71232876712328,6
0.2,657,84,53112,80.71732522796353,17
0.2,658,96,53208,80.74051593323217,6
0.2,659,91,53299,80.7560606060606,10
0.2,660,92,53391,80.7730711043873,9
0.2,661,94,53485,80.79305135951661,7
0.2,662,94,53579,80.81297134238311,7
0.2,663,21,53600,80.72289156626506,11
0.2,664,96,53696,80.74586466165414,6
0.2,665,95,53791,80.76726726726727,6
0.2,666,87,53878,80.77661169415292,14
0.2,667,93,53971,80.79491017964072,8
0.2,668,92,54063,80.81165919282512,9
0.2,669,89,54152,80.82388059701492,12
0.2,670,93,54245,80.84202682563338,8
0.2,671,89,54334,80.85416666666667,12
0.2,672,94,54428,80.87369985141159,7
0.2,673,93,54521,80.89169139465875,8
0.2,674,94,54615,80.91111111111111,7
0.2,675,94,54709,80.93047337278107,7
0.2,676,83,54792,80.93353028064993,18
0.2,677,92,54884,80.94985250737463,9
0.2,678,94,54978,80.96907216494846,7
0.2,679,95,55073,80.98970588235294,6
0.2,680,84,55157,80.99412628487518,18
0.2,681,88,55245,81.00439882697947,13
0.2,682,92,55337,81.02049780380673,11
0.2,683,88,55425,81.03070175438596,13
0.2,684,94,55519,81.04963503649635,8
0.2,685,92,55611,81.06559766763849,9
0.2,686,96,55707,81.08733624454149,6
0.2,687,92,55799,81.10319767441861,9
0.2,688,93,55892,81.12046444121916,8
0.2,689,93,55985,81.1376811594203,8
0.2,690,93,56078,81.1548480463097,8
0.2,691,96,56174,81.17630057803468,6
0.2,692,96,56270,81.1976911976912,7
0.2,693,26,56296,81.11815561959654,7
0.2,694,95,56391,81.13812949640288,6
0.2,695,93,56484,81.15517241379311,8
0.2,696,95,56579,81.17503586800574,7
0.2,697,88,56667,81.18481375358166,13
0.2,698,90,56757,81.19742489270386,12
0.2,699,20,56777,81.11,13
0.2,700,94,56871,81.1283880171184,8
0.2,701,95,56966,81.14814814814815,8
0.2,702,88,57054,81.15789473684211,13
0.2,703,91,57145,81.171875,10
0.2,704,92,57237,81.18723404255319,9
0.2,705,93,57330,81.20396600566572,8
0.2,706,91,57421,81.21782178217822,10
0.2,707,95,57516,81.23728813559322,6
0.2,708,93,57609,81.25387870239774,8
0.2,709,17,57626,81.16338028169014,16
0.2,710,94,57720,81.18143459915612,9
0.2,711,91,57811,81.19522471910112,10
0.2,712,88,57899,81.2047685834502,13
0.2,713,95,57994,81.22408963585434,6
0.2,714,93,58087,81.24055944055944,8
0.2,715,90,58177,81.25279329608938,11
0.2,716,95,58272,81.27196652719665,6
0.2,717,95,58367,81.29108635097494,8
0.2,718,95,58462,81.31015299026426,7
0.2,719,90,58552,81.32222222222222,11
0.2,720,91,58643,81.33564493758668,10
0.2,721,90,58733,81.34764542936288,11
0.2,722,95,58828,81.36652835408022,6
0.2,723,94,58922,81.38397790055248,8
0.2,724,92,59014,81.39862068965517,9
0.2,725,94,59108,81.4159779614325,7
0.2,726,93,59201,81.43191196698763,8
0.2,727,94,59295,81.44917582417582,8
0.2,728,92,59387,81.46364883401921,9
0.2,729,94,59481,81.48082191780821,8
0.2,730,95,59576,81.49931600547195,6
0.2,731,93,59669,81.51502732240438,9
0.2,732,92,59761,81.5293315143247,9
0.2,733,94,59855,81.54632152588556,8
0.2,734,94,59949,81.56326530612245,8
0.2,735,94,60043,81.58016304347827,7
0.2,736,93,60136,81.59565807327002,9
0.2,737,94,60230,81.61246612466125,7
0.2,738,96,60326,81.6319350473613,6
0.2,739,24,60350,81.55405405405405,8
0.2,740,91,60441,81.56680161943319,10
0.2,741,96,60537,81.58625336927224,6
0.2,742,-126,60411,81.30686406460296,25
0.2,743,23,60434,81.22849462365592,9
0.2,744,89,60523,81.23892617449664,12
0.2,745,93,60616,81.25469168900804,8
0.2,746,92,60708,81.26907630522088,9
0.2,747,93,60801,81.28475935828877,8
0.2,748,89,60890,81.29506008010681,12
0.2,749,95,60985,81.31333333333333,9
0.2,750,95,61080,81.33155792276965,7
0.2,751,89,61169,81.34175531914893,13
0.2,752,90,61259,81.35325365205843,11
0.2,753,92,61351,81.36737400530504,9
0.2,754,96,61447,81.38675496688742,6
0.2,755,88,61535,81.39550264550265,13
0.2,756,94,61629,81.41215323645972,7
0.2,757,96,61725,81.43139841688654,6
0.2,758,95,61820,81.44927536231884,7
0.2,759,90,61910,81.46052631578948,12
0.2,760,89,61999,81.47043363994744,12
0.2,761,93,62092,81.48556430446195,11
0.2,762,94,62186,81.50196592398427,7
0.2,763,88,62274,81.51047120418848,13
0.2,764,96,62370,81.52941176470588,6
0.2,765,93,62463,81.5443864229765,10
0.2,766,92,62555,81.55801825293351,10
0.2,767,91,62646,81.5703125,10
0.2,768,20,62666,81.49024707412224,12
0.2,769,92,62758,81.50389610389611,9
0.2,770,95,62853,81.52140077821012,8
0.2,771,93,62946,81.53626943005182,10
0.2,772,96,63042,81.55498059508409,6
0.2,773,93,63135,81.56976744186046,8
0.2,774,90,63225,81.58064516129032,11
0.2,775,91,63316,81.59278350515464,11
0.2,776,91,63407,81.6048906048906,10
0.2,777,94,63501,81.62082262210797,7
0.2,778,83,63584,81.62259306803594,18
0.2,779,93,63677,81.63717948717948,8
0.2,780,85,63762,81.64148527528809,17
0.2,781,90,63852,81.65217391304348,11
0.2,782,24,63876,81.57854406130268,9
0.2,783,86,63962,81.58418367346938,15
0.2,784,27,63989,81.51464968152867,6
0.2,785,83,64072,81.51653944020356,18
0.2,786,94,64166,81.53240152477764,7
0.2,787,95,64261,81.5494923857868,8
0.2,788,92,64353,81.56273764258555,9
0.2,789,94,64447,81.57848101265823,7
0.2,790,90,64537,81.58912768647282,11
0.2,791,90,64627,81.59974747474747,12
0.2,792,-46,64581,81.43883984867591,9
0.2,793,94,64675,81.45465994962217,9
0.2,794,92,64767,81.4679245283019,10
0.2,795,94,64861,81.48366834170854,8
0.2,796,95,64956,81.50062735257215,6
0.2,797,84,65040,81.50375939849624,17
0.2,798,93,65133,81.51814768460575,8
0.2,799,23,65156,81.445,9
0.2,800,94,65250,81.46067415730337,7
0.2,801,19,65269,81.38279301745636,13
0.2,802,92,65361,81.39601494396015,12
0.2,803,95,65456,81.41293532338308,7
0.2,804,92,65548,81.42608695652174,11
0.2,805,93,65641,81.44044665012407,8
0.2,806,93,65734,81.454770755886,9
0.2,807,92,65826,81.46782178217822,9
0.2,808,27,65853,81.40049443757725,6
0.2,809,92,65945,81.41358024691358,9
0.2,810,89,66034,81.422934648582,12
0.2,811,94,66128,81.4384236453202,8
0.2,812,86,66214,81.44403444034441,15
0.2,813,87,66301,81.45085995085995,15
0.2,814,85,66386,81.45521472392637,17
0.2,815,95,66481,81.4718137254902,6
0.2,816,93,66574,81.4859241126071,8
0.2,817,88,66662,81.49388753056235,13
0.2,818,94,66756,81.5091575091575,7
0.2,819,94,66850,81.52439024390245,7
0.2,820,95,66945,81.54080389768575,6
0.2,821,94,67039,81.5559610705596,7
0.2,822,94,67133,81.57108140947751,7
0.2,823,92,67225,81.58373786407768,9
0.2,824,93,67318,81.59757575757575,9
0.2,825,95,67413,81.6138014527845,6
0.2,826,95,67508,81.62998790810157,6
0.2,827,92,67600,81.64251207729468,9
0.2,828,90,67690,81.65259348612787,11
0.2,829,90,67780,81.66265060240964,11
0.2,830,92,67872,81.67509025270758,10
0.2,831,95,67967,81.69110576923077,6
0.2,832,94,68061,81.70588235294117,7
0.2,833,95,68156,81.72182254196643,8
0.2,834,92,68248,81.73413173652695,11
0.2,835,94,68342,81.7488038277512,7
0.2,836,17,68359,81.67144563918758,16
0.2,837,95,68454,81.68735083532219,6
0.2,838,90,68544,81.69725864123957,11
0.2,839,-52,68492,81.53809523809524,16
0.2,840,23,68515,81.46848989298454,11
0.2,841,-56,68459,81.30522565320665,19
0.2,842,18,68477,81.23013048635825,14
0.2,843,93,68570,81.24407582938389,8
0.2,844,91,68661,81.25562130177515,10
0.2,845,94,68755,81.27068557919621,7
0.2,846,90,68845,81.28099173553719,11
0.2,847,94,68939,81.29599056603773,7
0.2,848,92,69031,81.30859835100118,9
0.2,849,93,69124,81.32235294117648,9
0.2,850,90,69214,81.33254994124559,11
0.2,851,95,69309,81.34859154929578,6
0.2,852,87,69396,81.35521688159437,15
0.2,853,94,69490,81.37002341920375,7
0.2,854,89,69579,81.37894736842105,13
0.2,855,91,69670,81.39018691588785,10
0.2,856,94,69764,81.4049008168028,8
0.2,857,94,69858,81.41958041958041,7
0.2,858,94,69952,81.43422584400466,7
0.2,859,96,70048,81.45116279069768,6
0.2,860,89,70137,81.45993031358886,12
0.2,861,95,70232,81.47563805104409,6
0.2,862,92,70324,81.48783314020858,10
0.2,863,96,70420,81.50462962962963,6
0.2,864,86,70506,81.50982658959538,15
0.2,865,92,70598,81.52193995381063,9
0.2,866,92,70690,81.53402537485583,9
0.2,867,95,70785,81.54953917050692,6
0.2,868,95,70880,81.5650172612198,6
0.2,869,91,70971,81.57586206896552,10
0.2,870,92,71063,81.5878300803674,9
0.2,871,22,71085,81.51949541284404,12
0.2,872,92,71177,81.53150057273768,9
0.2,873,19,71196,81.4599542334096,13
0.2,874,96,71292,81.47657142857143,6
0.2,875,86,71378,81.48173515981735,15
0.2,876,88,71466,81.48916761687572,13
0.2,877,95,71561,81.50455580865604,6
0.2,878,92,71653,81.5164960182025,9
0.2,879,93,71746,81.52954545454546,9
0.2,880,96,71842,81.54597048808172,6
0.2,881,83,71925,81.54761904761905,18
0.2,882,16,71941,81.47338618346546,17
0.2,883,95,72036,81.48868778280543,6
0.2,884,90,72126,81.49830508474577,11
0.2,885,95,72221,81.5135440180587,6
0.2,886,89,72310,81.52198421645998,12
0.2,887,92,72402,81.53378378378379,9
0.2,888,94,72496,81.54780652418448,9
0.2,889,22,72518,81.4808988764045,10
0.2,890,94,72612,81.4949494949495,7
0.2,891,93,72705,81.50784753363229,8
0.2,892,24,72729,81.44344904815229,12
0.2,893,91,72820,81.45413870246085,10
0.2,894,93,72913,81.46703910614525,8
0.2,895,19,72932,81.39732142857143,14
0.2,896,96,73028,81.41360089186176,6
0.2,897,93,73121,81.42650334075724,8
0.2,898,89,73210,81.43492769744161,13
0.2,899,96,73306,81.45111111111112,6
0.2,900,94,73400,81.46503884572697,7
0.2,901,94,73494,81.4789356984479,8
0.2,902,94,73588,81.49280177187154,8
0.2,903,92,73680,81.50442477876106,9
0.2,904,94,73774,81.5182320441989,7
0.2,905,90,73864,81.52759381898454,11
0.2,906,91,73955,81.5380374862183,10
0.2,907,90,74045,81.54735682819383,11
0.2,908,90,74135,81.55665566556655,12
0.2,909,26,74161,81.49560439560439,7
0.2,910,96,74257,81.51152579582876,6
0.2,911,-58,74199,81.35855263157895,24
0.2,912,91,74290,81.36911281489594,10
0.2,913,90,74380,81.37855579868709,11
0.2,914,94,74474,81.39234972677596,7
0.2,915,94,74568,81.4061135371179,7
0.2,916,94,74662,81.41984732824427,7
0.2,917,95,74757,81.43464052287581,7
0.2,918,95,74852,81.449401523395,6
0.2,919,95,74947,81.4641304347826,6
0.2,920,96,75043,81.47991313789359,6
0.2,921,94,75137,81.49349240780911,7
0.2,922,96,75233,81.5092091007584,6
0.2,923,93,75326,81.52164502164503,8
0.2,924,94,75420,81.53513513513514,7
0.2,925,91,75511,81.54535637149029,11
0.2,926,95,75606,81.55987055016182,6
0.2,927,95,75701,81.57435344827586,6
0.2,928,19,75720,81.5069967707212,13
0.2,929,92,75812,81.51827956989247,9
0.2,930,86,75898,81.52309344790548,15
0.2,931,90,75988,81.53218884120172,12
0.2,932,91,76079,81.54233654876742,10
0.2,933,94,76173,81.55567451820129,7
0.2,934,92,76265,81.56684491978609,9
0.2,935,94,76359,81.5801282051282,8
0.2,936,92,76451,81.59124866595518,10
0.2,937,21,76472,81.52665245202559,11
0.2,938,94,76566,81.53993610223642,7
0.2,939,92,76658,81.55106382978724,9
0.2,940,27,76685,81.49309245483528,6
0.2,941,94,76779,81.50636942675159,9
0.2,942,92,76871,81.51749734888654,9
0.2,943,90,76961,81.52648305084746,11
0.2,944,87,77048,81.53227513227513,14
0.2,945,91,77139,81.54228329809725,10
0.2,946,23,77162,81.480464625132,9
0.2,947,93,77255,81.49261603375527,8
0.2,948,87,77342,81.49841938883034,15
0.2,949,96,77438,81.51368421052632,6
0.2,950,90,77528,81.52260778128286,11
0.2,951,95,77623,81.53676470588235,6
0.2,952,95,77718,81.55089192025184,6
0.2,953,93,77811,81.562893081761,8
0.2,954,94,77905,81.57591623036649,8
0.2,955,95,78000,81.58995815899581,6
0.2,956,96,78096,81.60501567398119,6
0.2,957,96,78192,81.62004175365344,6
0.2,958,17,78209,81.55265901981231,19
0.2,959,92,78301,81.56354166666667,9
0.2,960,89,78390,81.57127991675338,12
0.2,961,93,78483,81.58316008316008,8
0.2,962,94,78577,81.59605399792315,7
0.2,963,21,78598,81.53319502074689,12
0.2,964,96,78694,81.54818652849741,6
0.2,965,92,78786,81.55900621118012,9
0.2,966,92,78878,81.56980351602895,9
0.2,967,91,78969,81.57954545454545,10
0.2,968,95,79064,81.59339525283798,6
0.2,969,94,79158,81.60618556701031,10
0.2,970,87,79245,81.61174047373841,14
0.2,971,92,79337,81.6224279835391,9
0.2,972,95,79432,81.63617677286742,6
0.2,973,96,79528,81.65092402464066,6
0.2,974,92,79620,81.66153846153846,9
0.2,975,91,79711,81.67110655737704,10
0.2,976,94,79805,81.68372569089048,7
0.2,977,94,79899,81.6963190184049,9
0.2,978,93,79992,81.70786516853933,8
0.2,979,27,80019,81.65204081632653,7
0.2,980,89,80108,81.65953109072375,12
0.2,981,94,80202,81.67209775967413,8
0.2,982,91,80293,81.68158697863683,10
0.2,983,89,80382,81.6890243902439,12
0.2,984,92,80474,81.6994923857868,9
0.2,985,87,80561,81.70486815415822,14
0.2,986,93,80654,81.71631205673759,8
0.2,987,90,80744,81.7246963562753,12
0.2,988,94,80838,81.737108190091,8
0.2,989,94,80932,81.74949494949495,7
0.2,990,94,81026,81.76185671039354,7
0.2,991,89,81115,81.76915322580645,12
0.2,992,91,81206,81.77844914400805,10
0.2,993,89,81295,81.78571428571429,12
0.2,994,92,81387,81.79597989949748,9
0.2,995,89,81476,81.80321285140562,14
0.2,996,96,81572,81.81745235707122,6
0.2,997,93,81665,81.82865731462925,9
0.2,998,20,81685,81.76676676676676,12
0.2,999,94,81779,81.779,8
0.2,1000,-46,81733,81.65134865134866,10
0.2,1001,95,81828,81.66467065868264,7
0.2,1002,92,81920,81.67497507477567,9
0.2,1003,94,82014,81.68725099601593,7
0.2,1004,94,82108,81.69950248756219,7
0.2,1005,92,82200,81.70974155069582,9
0.2,1006,94,82294,81.7219463753724,8
0.2,1007,94,82388,81.73412698412699,7
0.2,1008,96,82484,81.74826560951438,6
0.2,1009,92,82576,81.75841584158415,9
0.2,1010,92,82668,81.76854599406528,9
0.2,1011,87,82755,81.77371541501977,14
0.2,1012,91,82846,81.78282329713721,10
0.2,1013,90,82936,81.79092702169625,11
0.2,1014,88,83024,81.79704433497537,15
0.2,1015,93,83117,81.80807086614173,8
0.2,1016,91,83208,81.81710914454277,10
0.2,1017,92,83300,81.82711198428291,9
0.2,1018,91,83391,81.8361138370952,10
0.2,1019,95,83486,81.84901960784313,8
0.2,1020,93,83579,81.85994123408423,8
0.2,1021,95,83674,81.87279843444227,6
0.2,1022,93,83767,81.88367546432063,8
0.2,1023,91,83858,81.892578125,11
0.2,1024,94,83952,81.90439024390244,7
0.2,1025,93,84045,81.91520467836257,8
0.2,1026,91,84136,81.92405063291139,10
0.2,1027,94,84230,81.93579766536965,7
0.2,1028,91,84321,81.94460641399417,10
0.2,1029,96,84417,81.95825242718446,6
0.2,1030,75,84492,81.95150339476237,26
0.2,1031,89,84581,81.95833333333333,12
0.2,1032,95,84676,81.97095837366892,6
0.2,1033,22,84698,81.91295938104449,10
0.2,1034,94,84792,81.92463768115942,7
0.2,1035,90,84882,81.93243243243244,11
0.2,1036,27,84909,81.87945998071359,6
0.2,1037,95,85004,81.89210019267823,6
0.2,1038,95,85099,81.90471607314726,6
0.2,1039,90,85189,81.9125,11
0.2,1040,94,85283,81.92411143131604,8
0.2,1041,94,85377,81.93570057581574,7
0.2,1042,95,85472,81.94822627037392,6
0.2,1043,94,85566,81.95977011494253,7
0.2,1044,-53,85513,81.83062200956938,16
0.2,1045,87,85600,81.83556405353728,14
0.2,1046,-49,85551,81.71060171919771,14
0.2,1047,95,85646,81.72328244274809,6
0.2,1048,94,85740,81.73498570066731,7
0.2,1049,92,85832,81.7447619047619,9
0.2,1050,93,85925,81.75547098001903,8
0.2,1051,26,85951,81.70247148288973,7
0.2,1052,94,86045,81.71415004748339,7
0.2,1053,96,86141,81.72770398481974,6
0.2,1054,93,86234,81.73838862559242,8
0.2,1055,96,86330,81.75189393939394,6
0.2,1056,95,86425,81.76442762535478,6
0.2,1057,91,86516,81.77315689981097,10
0.2,1058,91,86607,81.78186968838527,10
0.2,1059,92,86699,81.79150943396226,9
0.2,1060,94,86793,81.80301602262017,7
0.2,1061,94,86887,81.81450094161958,7
0.2,1062,95,86982,81.82690498588899,6
0.2,1063,94,87076,81.83834586466165,7
0.2,1064,93,87169,81.84882629107982,8
0.2,1065,95,87264,81.86116322701689,6
0.2,1066,94,87358,81.87253983130272,7
0.2,1067,93,87451,81.88295880149813,8
0.2,1068,94,87545,81.89429373246024,7
0.2,1069,93,87638,81.90467289719626,8
0.2,1070,96,87734,81.91783380018674,6
0.2,1071,81,87815,81.9169776119403,20
0.2,1072,94,87909,81.928238583411,7
0.2,1073,91,88000,81.93668528864059,10
0.2,1074,92,88092,81.94604651162791,10
0.2,1075,86,88178,81.94981412639405,15
0.2,1076,88,88266,81.95543175487465,13
0.2,1077,85,88351,81.9582560296846,16
0.2,1078,90,88441,81.96570898980538,11
0.2,1079,95,88536,81.97777777777777,6
0.2,1080,86,88622,81.98149861239592,15
0.2,1081,92,88714,81.99075785582255,10
0.2,1082,93,88807,82.00092336103417,8
0.2,1083,91,88898,82.00922509225093,10
0.2,1084,94,88992,82.02027649769585,8
0.2,1085,95,89087,82.03222836095765,6
0.2,1086,94,89181,82.04323827046917,7
0.2,1087,-46,89135,81.92555147058823,10
0.2,1088,95,89230,81.93755739210285,7
0.2,1089,91,89321,81.94587155963303,10
0.2,1090,27,89348,81.8955087076077,6
0.2,1091,11,89359,81.83058608058609,24
0.2,1092,94,89453,81.84172003659653,7
0.2,1093,94,89547,81.8528336380256,7
0.2,1094,91,89638,81.86118721461187,10
0.2,1095,96,89734,81.87408759124088,7
0.2,1096,92,89826,81.88331814038287,9
0.2,1097,92,89918,81.89253187613843,9
0.2,1098,93,90011,81.90263876251137,10
0.2,1099,91,90102,81.91090909090909,10
0.2,1100,95,90197,81.9227974568574,6
0.2,1101,90,90287,81.93012704174228,11
0.2,1102,27,90314,81.88032638259293,7
0.2,1103,-56,90258,81.7554347826087,19
0.2,1104,93,90351,81.76561085972851,9
0.2,1105,93,90444,81.7757685352622,8
0.2,1106,94,90538,81.78681120144535,7
0.2,1107,90,90628,81.7942238267148,11
0.2,1108,93,90721,81.80432822362489,8
0.2,1109,95,90816,81.81621621621622,6
0.2,1110,91,90907,81.82448244824482,10
0.2,1111,93,91000,81.83453237410072,9
0.2,1112,93,91093,81.84456424079066,10
0.2,1113,89,91182,81.85098743267504,12
0.2,1114,23,91205,81.79820627802691,9
0.2,1115,89,91294,81.80465949820788,12
0.2,1116,93,91387,81.81468218442257,8
0.2,1117,92,91479,81.82379248658319,9
0.2,1118,93,91572,81.83378016085791,8
0.2,1119,95,91667,81.84553571428572,6
0.2,1120,93,91760,81.85548617305977,9
0.2,1121,90,91850,81.86274509803921,11
0.2,1122,94,91944,81.87355298308103,8
0.2,1123,89,92033,81.87989323843416,12
0.2,1124,94,92127,81.89066666666666,7
0.2,1125,89,92216,81.89698046181172,13
0.2,1126,94,92310,81.90771960958297,8
0.2,1127,93,92403,81.91755319148936,8
0.2,1128,92,92495,81.92648361381754,9
0.2,1129,25,92520,81.87610619469027,7
0.2,1130,91,92611,81.8841732979664,10
0.2,1131,92,92703,81.89310954063605,9
0.2,1132,94,92797,81.90379523389232,8
0.2,1133,96,92893,81.91622574955909,6
0.2,1134,91,92984,81.92422907488987,10
0.2,1135,93,93077,81.93397887323944,9
0.2,1136,92,93169,81.94283201407212,9
0.2,1137,96,93265,81.95518453427066,6
0.2,1138,93,93358,81.96488147497806,8
0.2,1139,94,93452,81.97543859649123,9
0.2,1140,92,93544,81.98422436459246,9
0.2,1141,93,93637,81.9938704028021,8
0.2,1142,90,93727,82.00087489063867,12
0.2,1143,92,93819,82.00961538461539,10
0.2,1144,91,93910,82.0174672489083,11
0.2,1145,92,94002,82.0261780104712,9
0.2,1146,91,94093,82.03400174367917,10
0.2,1147,95,94188,82.04529616724739,6
0.2,1148,18,94206,81.98955613577023,16
0.2,1149,92,94298,81.99826086956521,9
0.2,1150,90,94388,82.00521285838401,11
0.2,1151,22,94410,81.953125,10
0.2,1152,93,94503,81.96270598438855,10
0.2,1153,91,94594,81.97053726169844,10
0.2,1154,27,94621,81.92294372294373,6
0.2,1155,95,94716,81.93425605536332,6
0.2,1156,93,94809,81.9438202247191,8
0.2,1157,92,94901,81.95250431778929,10
0.2,1158,89,94990,81.9585849870578,12
0.2,1159,93,95083,81.96810344827587,8
0.2,1160,96,95179,81.9801894918174,6
0.2,1161,88,95267,81.98537005163512,13
0.2,1162,92,95359,81.99398108340499,9
0.2,1163,96,95455,82.00601374570446,6
0.2,1164,94,95549,82.01630901287554,7
0.2,1165,14,95563,81.95797598627787,18
0.2,1166,95,95658,81.96915167095116,6
0.2,1167,92,95750,81.9777397260274,9
0.2,1168,91,95841,81.98545765611634,10
0.2,1169,92,95933,81.9940170940171,9
0.2,1170,96,96029,82.0059777967549,6
0.2,1171,26,96055,81.95819112627986,6
0.2,1172,94,96149,81.96845694799659,7
0.2,1173,90,96239,81.97529812606473,11
0.2,1174,94,96333,81.98553191489361,7
0.2,1175,94,96427,81.99574829931973,7
0.2,1176,23,96450,81.94562446898895,11
0.2,1177,83,96533,81.946519524618,18
0.2,1178,95,96628,81.95759117896523,6
0.2,1179,87,96715,81.96186440677967,14
0.2,1180,87,96802,81.96613039796783,14
0.2,1181,90,96892,81.97292724196278,12
0.2,1182,89,96981,81.97886728655959,12
0.2,1183,94,97075,81.98902027027027,8
0.2,1184,87,97162,81.99324894514768,15
0.2,1185,93,97255,82.00252951096121,8
0.2,1186,87,97342,82.0067396798652,14
0.2,1187,93,97435,82.01599326599326,8
0.2,1188,94,97529,82.02607232968882,8
0.2,1189,96,97625,82.03781512605042,7
0.2,1190,92,97717,82.04617968094038,10
0.2,1191,96,97813,82.05788590604027,6
0.2,1192,93,97906,82.06705783738474,8
0.2,1193,92,97998,82.07537688442211,9
0.2,1194,94,98092,82.08535564853557,7
0.2,1195,96,98188,82.09698996655518,6
0.2,1196,25,98213,82.04928989139515,8
0.2,1197,94,98307,82.05926544240401,8
0.2,1198,20,98327,82.00750625521268,13
0.2,1199,94,98421,82.0175,7
0.2,1200,95,98516,82.02830974188177,7
0.2,1201,93,98609,82.03743760399334,8
0.2,1202,95,98704,82.04821280133001,6
0.2,1203,85,98789,82.05066445182725,16
0.2,1204,95,98884,82.06141078838175,6
0.2,1205,94,98978,82.07131011608624,7
0.2,1206,94,99072,82.08119304059652,7
0.2,1207,94,99166,82.09105960264901,7
0.2,1208,91,99257,82.09842845326716,10
0.2,1209,91,99348,82.10578512396694,11
0.2,1210,96,99444,82.11725846407927,6
0.2,1211,88,99532,82.12211221122112,13
0.2,1212,90,99622,82.12860676009893,11
0.2,1213,90,99712,82.13509060955519,11
0.2,1214,95,99807,82.14567901234568,6
0.2,1215,94,99901,82.15542763157895,7
0.2,1216,87,99988,82.15940838126541,15
0.2,1217,88,100076,82.16420361247947,17
0.2,1218,94,100170,82.17391304347827,9
0.2,1219,95,100265,82.18442622950819,6
0.2,1220,91,100356,82.19164619164619,11
0.2,1221,94,100450,82.2013093289689,7
0.2,1222,95,100545,82.21177432542927,7
0.2,1223,87,100632,82.2156862745098,14
0.2,1224,94,100726,82.22530612244898,8
0.2,1225,93,100819,82.23409461663948,9
0.2,1226,93,100912,82.24286878565607,8
0.2,1227,95,101007,82.25325732899023,6
0.2,1228,91,101098,82.26037428803906,10
0.2,1229,96,101194,82.27154471544715,6
0.2,1230,86,101280,82.27457351746547,15
0.2,1231,93,101373,82.28327922077922,10
0.2,1232,93,101466,82.2919708029197,9
0.2,1233,94,101560,82.30145867098865,7
0.2,1234,92,101652,82.30931174089069,10
0.2,1235,0,101652,82.24271844660194,33
0.2,1236,90,101742,82.24898949070331,11
0.2,1237,20,101762,82.19870759289176,12
0.2,1238,90,101852,82.20500403551252,12
0.2,1239,92,101944,82.21290322580646,9
0.2,1240,91,102035,82.21998388396455,10
0.2,1241,95,102130,82.23027375201288,6
0.2,1242,92,102222,82.23813354786806,9
0.2,1243,92,102314,82.2459807073955,10
0.2,1244,-44,102270,82.144578313253,9
0.2,1245,87,102357,82.14847512038523,15
0.2,1246,93,102450,82.15717722534082,10
0.2,1247,90,102540,82.16346153846153,11
0.2,1248,88,102628,82.16813450760608,15
0.2,1249,89,102717,82.1736,12
0.2,1250,24,102741,82.12709832134293,8
0.2,1251,91,102832,82.13418530351437,10
0.2,1252,24,102856,82.0877893056664,9
0.2,1253,90,102946,82.09409888357257,12
0.2,1254,89,103035,82.0996015936255,12
0.2,1255,96,103131,82.11066878980891,6
0.2,1256,92,103223,82.11853619729514,9
0.2,1257,95,103318,82.12877583465819,8
0.2,1258,93,103411,82.13741064336776,8
0.2,1259,94,103505,82.14682539682539,7
0.2,1260,94,103599,82.15622521808089,7
0.2,1261,94,103693,82.16561014263074,7
0.2,1262,93,103786,82.1741884402217,8
0.2,1263,94,103880,82.18354430379746,9
0.2,1264,94,103974,82.19288537549407,7
0.2,1265,83,104057,82.19352290679305,18
0.2,1266,87,104144,82.19731649565904,14
0.2,1267,94,104238,82.20662460567823,7
0.2,1268,91,104329,82.21355397951143,10
0.2,1269,89,104418,82.21889763779528,12
0.2,1270,95,104513,82.22895357985838,6
0.2,1271,90,104603,82.23506289308176,11
0.2,1272,91,104694,82.241948153967,10
0.2,1273,91,104785,82.24882260596546,12
0.2,1274,90,104875,82.25490196078431,11
0.2,1275,88,104963,82.25940438871473,14
0.2,1276,91,105054,82.26624902114331,10
0.2,1277,96,105150,82.27699530516432,6
0.2,1278,7,105157,82.21813917122752,25
0.2,1279,79,105236,82.215625,23
0.2,1280,94,105330,82.22482435597189,7
0.2,1281,92,105422,82.23244929797193,10
0.2,1282,93,105515,82.24084177708495,8
0.2,1283,93,105608,82.24922118380063,8
0.2,1284,92,105700,82.2568093385214,9
0.2,1285,93,105793,82.2651632970451,8
0.2,1286,94,105887,82.27428127428128,9
0.2,1287,93,105980,82.28260869565217,8
0.2,1288,27,106007,82.23972071373157,6
0.2,1289,93,106100,82.24806201550388,8
0.2,1290,94,106194,82.2571649883811,7
0.2,1291,91,106285,82.26393188854489,11
0.2,1292,94,106379,82.27300850734726,7
0.2,1293,89,106468,82.27820710973725,15
0.2,1294,95,106563,82.28803088803089,8
0.2,1295,95,106658,82.29783950617283,7
0.2,1296,91,106749,82.30454895913647,11
0.2,1297,89,106838,82.30970724191063,12
0.2,1298,83,106921,82.31023864511162,18
0.2,1299,92,107013,82.31769230769231,9
0.2,1300,85,107098,82.31975403535742,16
0.2,1301,92,107190,82.32718894009217,9
0.2,1302,91,107281,82.33384497313891,10
0.2,1303,92,107373,82.34125766871166,9
0.2,1304,91,107464,82.34789272030652,10
0.2,1305,95,107559,82.35758039816233,6
0.2,1306,91,107650,82.36419280795715,10
0.2,1307,90,107740,82.37003058103976,11
0.2,1308,94,107834,82.37891520244462,7
0.2,1309,94,107928,82.38778625954198,7
0.2,1310,92,108020,82.3951182303585,11
0.2,1311,88,108108,82.39939024390245,13
0.2,1312,84,108192,82.4006092916984,17
0.2,1313,90,108282,82.40639269406392,11
0.2,1314,93,108375,82.41444866920152,11
0.2,1315,82,108457,82.41413373860182,19
0.2,1316,93,108550,82.42217160212604,8
0.2,1317,96,108646,82.43247344461305,6
0.2,1318,91,108737,82.43896891584534,10
0.2,1319,89,108826,82.44393939393939,12
0.2,1320,91,108917,82.45041635124906,10
0.2,1321,92,109009,82.45763993948563,9
0.2,1322,93,109102,82.46560846560847,8
0.2,1323,95,109197,82.47507552870091,6
0.2,1324,91,109288,82.48150943396226,10
0.2,1325,89,109377,82.48642533936652,12
0.2,1326,92,109469,82.49359457422759,9
0.2,1327,89,109558,82.49849397590361,12
0.2,1328,92,109650,82.50564334085779,9
0.2,1329,93,109743,82.51353383458647,9
0.2,1330,92,109835,82.52066115702479,9
0.2,1331,94,109929,82.52927927927928,8
0.2,1332,93,110022,82.5371342835709,8
0.2,1333,96,110118,82.5472263868066,6
0.2,1334,91,110209,82.55355805243445,10
0.2,1335,93,110302,82.56137724550898,8
0.2,1336,92,110394,82.56843679880329,10
0.2,1337,92,110486,82.57548579970104,9
0.2,1338,90,110576,82.58103061986557,11
0.2,1339,94,110670,82.58955223880596,7
0.2,1340,93,110763,82.59731543624162,9
0.2,1341,94,110857,82.60581222056632,7
0.2,1342,94,110951,82.61429635145197,7
0.2,1343,93,111044,82.62202380952381,8
0.2,1344,92,111136,82.62899628252788,9
0.2,1345,86,111222,82.63150074294205,15
0.2,1346,20,111242,82.58500371195248,13
0.2,1347,95,111337,82.59421364985164,6
0.2,1348,94,111431,82.60266864343959,8
0.2,1349,92,111523,82.60962962962962,9
0.2,1350,90,111613,82.61509992598076,11
0.2,1351,93,111706,82.62278106508876,9
0.2,1352,88,111794,82.62675535846267,13
0.2,1353,84,111878,82.62776957163959,17
0.2,1354,94,111972,82.63616236162362,7
0.2,1355,87,112059,82.63938053097345,14
0.2,1356,89,112148,82.64406779661017,12
0.2,1357,93,112241,82.65169366715759,8
0.2,1358,94,112335,82.66004415011038,8
0.2,1359,88,112423,82.66397058823529,13
0.2,1360,93,112516,82.67156502571639,8
0.2,1361,93,112609,82.6791483113069,8
0.2,1362,90,112699,82.68451944240645,11
0.2,1363,18,112717,82.63709677419355,16
0.2,1364,91,112808,82.64322344322345,10
0.2,1365,94,112902,82.65153733528551,9
0.2,1366,93,112995,82.65910753474762,8
0.2,1367,95,113090,82.66812865497076,8
0.2,1368,91,113181,82.67421475529584,11
0.2,1369,94,113275,82.68248175182482,7
0.2,1370,95,113370,82.69146608315098,6
0.2,1371,86,113456,82.6938775510204,15
0.2,1372,94,113550,82.7021121631464,7
0.2,1373,93,113643,82.70960698689956,8
0.2,1374,23,113666,82.66618181818181,10
0.2,1375,95,113761,82.6751453488372,6
0.2,1376,95,113856,82.68409586056644,6
0.2,1377,96,113952,82.69375907111757,6
0.2,1378,94,114046,82.70195794053662,8
0.2,1379,87,114133,82.70507246376812,14
0.2,1380,90,114223,82.7103548153512,11
0.2,1381,92,114315,82.71707670043415,9
0.2,1382,85,114400,82.71872740419379,16
0.2,1383,94,114494,82.72687861271676,7
0.2,1384,96,114590,82.73646209386281,6
0.2,1385,93,114683,82.74386724386724,10
0.2,1386,95,114778,82.75270367700072,7
0.2,1387,89,114867,82.757204610951,12
0.2,1388,94,114961,82.76529877609791,7
0.2,1389,96,115057,82.7748201438849,6
0.2,1390,96,115153,82.784327821711,6
0.2,1391,95,115248,82.79310344827586,6
0.2,1392,23,115271,82.75017946877243,9
0.2,1393,88,115359,82.75394548063127,13
0.2,1394,92,115451,82.7605734767025,9
0.2,1395,95,115546,82.76934097421203,7
0.2,1396,93,115639,82.7766642806013,8
0.2,1397,94,115733,82.78469241773963,7
0.2,1398,92,115825,82.79127948534668,9
0.2,1399,95,115920,82.8,6
0.2,1400,93,116013,82.80728051391863,8
0.2,1401,92,116105,82.81383737517832,9
0.2,1402,91,116196,82.81967213114754,10
0.2,1403,84,116280,82.82051282051282,17
0.2,1404,95,116375,82.82918149466192,6
0.2,1405,94,116469,82.83712660028449,10
0.2,1406,93,116562,82.84434968017058,8
0.2,1407,-44,116518,82.75426136363636,8
0.2,1408,96,116614,82.76366217175301,6
0.2,1409,90,116704,82.76879432624114,11
0.2,1410,92,116796,82.77533664068037,9
0.2,1411,91,116887,82.78116147308782,10
0.2,1412,91,116978,82.7869780608634,11
0.2,1413,90,117068,82.79207920792079,11
0.2,1414,84,117152,82.79293286219081,19
0.2,1415,95,117247,82.80155367231639,6
0.2,1416,85,117332,82.803105151729,17
0.2,1417,18,117350,82.75740479548661,14
0.2,1418,90,117440,82.76250880902043,11
0.2,1419,96,117536,82.7718309859155,6
0.2,1420,94,117630,82.77973258268825,8
0.2,1421,94,117724,82.78762306610408,7
0.2,1422,92,117816,82.79409697821504,9
0.2,1423,92,117908,82.8005617977528,9
0.2,1424,91,117999,82.80631578947369,10
0.2,1425,92,118091,82.81276297335204,11
0.2,1426,91,118182,82.81850035038542,10
0.2,1427,94,118276,82.82633053221288,8
0.2,1428,94,118370,82.83414975507348,7
0.2,1429,93,118463,82.84125874125874,8
0.2,1430,95,118558,82.84975541579315,7
0.2,1431,94,118652,82.85754189944134,7
0.2,1432,96,118748,82.86671318911375,6
0.2,1433,92,118840,82.87308228730822,9
0.2,1434,90,118930,82.8780487804878,11
0.2,1435,22,118952,82.83565459610028,11
0.2,1436,86,119038,82.83785664578984,15
0.2,1437,11,119049,82.78789986091795,22
0.2,1438,91,119140,82.79360667129951,12
0.2,1439,93,119233,82.80069444444445,8
0.2,1440,91,119324,82.80638445523941,11
0.2,1441,90,119414,82.81137309292649,11
0.2,1442,27,119441,82.77269577269577,6
0.2,1443,91,119532,82.77839335180056,10
0.2,1444,93,119625,82.78546712802768,9
0.2,1445,93,119718,82.79253112033194,8
0.2,1446,95,119813,82.80096751900484,6
0.2,1447,87,119900,82.80386740331491,14
0.2,1448,91,119991,82.80952380952381,10
0.2,1449,95,120086,82.81793103448275,8
0.2,1450,94,120180,82.82563749138525,7
0.2,1451,91,120271,82.83126721763085,10
0.2,1452,93,120364,82.83826565726083,8
0.2,1453,90,120454,82.84319119669877,11
0.2,1454,92,120546,82.84948453608247,10
0.2,1455,95,120641,82.85782967032966,9
0.2,1456,94,120735,82.86547700754976,7
0.2,1457,94,120829,82.87311385459533,7
0.2,1458,88,120917,82.87662782727895,13
0.2,1459,91,121008,82.88219178082191,10
0.2,1460,91,121099,82.88774811772758,10
0.2,1461,92,121191,82.89398084815322,9
0.2,1462,91,121282,82.89952153110048,10
0.2,1463,96,121378,82.9084699453552,6
0.2,1464,76,121454,82.9037542662116,25
0.2,1465,25,121479,82.86425648021829,9
0.2,1466,93,121572,82.87116564417178,8
0.2,1467,92,121664,82.87738419618529,9
0.2,1468,93,121757,82.88427501701838,8
0.2,1469,95,121852,82.89251700680272,6
0.2,1470,93,121945,82.89938817131203,9
0.2,1471,89,122034,82.90353260869566,12
0.2,1472,91,122125,82.90902919212492,10
0.2,1473,96,122221,82.91791044776119,6
0.2,1474,94,122315,82.92542372881356,7
0.2,1475,94,122409,82.9329268292683,8
0.2,1476,87,122496,82.93568043331076,14
0.2,1477,11,122507,82.8870094722598,21
0.2,1478,94,122601,82.89452332657201,7
0.2,1479,95,122696,82.9027027027027,6
0.2,1480,92,122788,82.90884537474679,9
0.2,1481,89,122877,82.91295546558705,12
0.2,1482,92,122969,82.91908293998651,9
0.2,1483,85,123054,82.92048517520216,16
0.2,1484,17,123071,82.87609427609428,15
0.2,1485,-47,123024,82.78869448183042,10
0.2,1486,92,123116,82.79488903833222,9
0.2,1487,89,123205,82.79905913978494,12
0.2,1488,96,123301,82.80792478173271,6
0.2,1489,91,123392,82.81342281879195,10
0.2,1490,93,123485,82.82025486250838,8
0.2,1491,91,123576,82.82573726541555,10
0.2,1492,90,123666,82.83054253181514,11
0.2,1493,91,123757,82.83601070950469,11
0.2,1494,89,123846,82.84013377926422,12
0.2,1495,95,123941,82.84826203208556,7
0.2,1496,96,124037,82.85704742818972,6
0.2,1497,94,124131,82.8644859813084,7
0.2,1498,92,124223,82.87058038692462,9
0.2,1499,94,124317,82.878,7
0.2,1500,94,124411,82.88540972684876,7
0.2,1501,96,124507,82.89414114513981,6
0.2,1502,94,124601,82.90153027278775,8
0.2,1503,93,124694,82.90824468085107,8
0.2,1504,94,124788,82.9156146179402,7
0.2,1505,91,124879,82.92098273572377,12
0.2,1506,22,124901,82.88055739880558,11
0.2,1507,92,124993,82.88660477453581,9
0.2,1508,90,125083,82.89131875414182,13
0.2,1509,94,125177,82.89867549668874,8
0.2,1510,96,125273,82.9073461283918,6
0.2,1511,94,125367,82.91468253968254,9
0.2,1512,91,125458,82.92002643754131,10
0.2,1513,81,125539,82.91875825627477,20
0.2,1514,96,125635,82.92739273927393,6
0.2,1515,92,125727,82.93337730870712,9
0.2,1516,94,125821,82.94067237969676,8
0.2,1517,90,125911,82.94532279314888,12
0.2,1518,95,126006,82.95325872284397,6
0.2,1519,93,126099,82.95986842105263,8
0.2,1520,87,126186,82.96252465483235,15
0.2,1521,92,126278,82.96846254927726,10
0.2,1522,90,126368,82.973079448457,11
0.2,1523,96,126464,82.98162729658793,8
0.2,1524,95,126559,82.98950819672132,6
0.2,1525,92,126651,82.9954128440367,9
0.2,1526,93,126744,83.00196463654224,8
0.2,1527,87,126831,83.00458115183245,14
0.2,1528,95,126926,83.01242642249836,6
0.2,1529,93,127019,83.01895424836601,8
0.2,1530,96,127115,83.02743305029392,8
0.2,1531,94,127209,83.0345953002611,7
0.2,1532,94,127303,83.04174820613177,7
0.2,1533,95,127398,83.04954367666232,6
0.2,1534,25,127423,83.01172638436482,9
0.2,1535,93,127516,83.01822916666667,8
0.2,1536,22,127538,82.97852960312296,10
0.2,1537,95,127633,82.98634590377114,6
0.2,1538,94,127727,82.99350227420403,7
0.2,1539,90,127817,82.99805194805195,11
0.2,1540,90,127907,83.00259571706684,11
0.2,1541,93,128000,83.00907911802854,8
0.2,1542,95,128095,83.01685029163966,6
0.2,1543,9,128104,82.96891191709845,23
0.2,1544,91,128195,82.97411003236246,10
0.2,1545,91,128286,82.97930142302717,10
0.2,1546,95,128381,82.98707175177763,7
0.2,1547,93,128474,82.99354005167959,8
0.2,1548,93,128567,83.0,9
0.2,1549,88,128655,83.00322580645161,13
0.2,1550,85,128740,83.00451321727917,16
0.2,1551,94,128834,83.01159793814433,7
0.2,1552,87,128921,83.01416613007083,14
0.2,1553,86,129007,83.01608751608751,15
0.2,1554,86,129093,83.01800643086817,15
0.2,1555,24,129117,82.98007712082263,9
0.2,1556,93,129210,82.98651252408477,8
0.2,1557,94,129304,82.99358151476251,7
0.2,1558,89,129393,82.99743425272611,12
0.2,1559,96,129489,83.00576923076923,6
0.2,1560,92,129581,83.01153106982703,9
0.2,1561,96,129677,83.01984635083227,6
0.2,1562,94,129771,83.02687140115164,8
0.2,1563,94,129865,83.03388746803068,7
0.2,1564,96,129961,83.04217252396167,6
0.2,1565,90,130051,83.04661558109834,11
0.2,1566,89,130140,83.05041480536056,12
0.2,1567,25,130165,83.01339285714286,8
0.2,1568,93,130258,83.01975780752072,8
0.2,1569,94,130352,83.02675159235669,7
0.2,1570,92,130444,83.03246339910885,11
0.2,1571,93,130537,83.03880407124682,8
0.2,1572,86,130623,83.04068658614113,15
0.2,1573,-48,130575,82.9574332909784,13
0.2,1574,93,130668,82.96380952380953,9
0.2,1575,92,130760,82.96954314720813,9
0.2,1576,87,130847,82.97209892200381,14
0.2,1577,91,130938,82.97718631178707,10
0.2,1578,90,131028,82.98163394553515,11
0.2,1579,94,131122,82.98860759493671,7
0.2,1580,94,131216,82.9955724225174,7
0.2,1581,94,131310,83.00252844500632,7
0.2,1582,92,131402,83.00821225521162,9
0.2,1583,20,131422,82.96843434343434,13
0.2,1584,25,131447,82.93186119873818,8
0.2,1585,94,131541,82.93883984867591,7
0.2,1586,87,131628,82.94139886578449,14
0.2,1587,95,131723,82.94899244332494,7
0.2,1588,95,131818,82.95657646318439,8
0.2,1589,90,131908,82.96100628930817,12
0.2,1590,94,132002,82.96794468887492,8
0.2,1591,92,132094,82.97361809045226,9
0.2,1592,89,132183,82.9774011299435,13
0.2,1593,94,132277,82.98431618569636,8
0.2,1594,94,132371,82.99122257053291,7
0.2,1595,95,132466,82.99874686716792,6
0.2,1596,94,132560,83.00563556668754,7
0.2,1597,92,132652,83.01126408010012,9
0.2,1598,88,132740,83.01438398999375,15
0.2,1599,95,132835,83.021875,6
0.2,1600,94,132929,83.02873204247345,8
0.2,1601,95,133024,83.0362047440699,6
0.2,1602,92,133116,83.04179663131629,9
0.2,1603,93,133209,83.04800498753117,9
0.2,1604,92,133301,83.05358255451713,11
0.2,1605,96,133397,83.06164383561644,6
0.2,1606,92,133489,83.06720597386435,9
0.2,1607,93,133582,83.07338308457712,8
0.2,1608,95,133677,83.08079552517091,6
0.2,1609,91,133768,83.08571428571429,10
0.2,1610,96,133864,83.0937306021105,6
0.2,1611,95,133959,83.10111662531017,9
0.2,1612,94,134053,83.10787352758834,8
0.2,1613,96,134149,83.11586121437422,6
0.2,1614,91,134240,83.12074303405572,11
0.2,1615,93,134333,83.12685643564356,8
0.2,1616,20,134353,83.0878169449598,12
0.2,1617,93,134446,83.09394313967861,8
0.2,1618,91,134537,83.09882643607165,10
0.2,1619,21,134558,83.0604938271605,12
0.2,1620,93,134651,83.06662553979025,8
0.2,1621,94,134745,83.07336621454994,7
0.2,1622,93,134838,83.07948243992607,8
0.2,1623,91,134929,83.08435960591133,10
0.2,1624,93,135022,83.09046153846154,9
0.2,1625,92,135114,83.09594095940959,10
0.2,1626,92,135206,83.10141364474492,10
0.2,1627,92,135298,83.1068796068796,9
0.2,1628,94,135392,83.11356660527932,8
0.2,1629,95,135487,83.12085889570552,6
0.2,1630,87,135574,83.12323727774371,14
0.2,1631,93,135667,83.12928921568627,8
0.2,1632,90,135757,83.13349663196571,13
0.2,1633,96,135853,83.14137086903305,6
0.2,1634,89,135942,83.14495412844036,12
0.2,1635,95,136037,83.15220048899755,6
0.2,1636,96,136133,83.16004886988394,6
0.2,1637,25,136158,83.12454212454213,8
0.2,1638,91,136249,83.12934716290421,10
0.2,1639,95,136344,83.13658536585366,6
0.2,1640,92,136436,83.14198659354052,9
0.2,1641,87,136523,83.14433617539586,14
0.2,1642,91,136614,83.14911746804626,10
0.2,1643,93,136707,83.1551094890511,8
0.2,1644,96,136803,83.1629179331307,6
0.2,1645,90,136893,83.1670716889429,11
0.2,1646,86,136979,83.16879174256223,17
0.2,1647,24,137003,83.13288834951456,9
0.2,1648,92,137095,83.13826561552456,9
0.2,1649,95,137190,83.14545454545454,8
0.2,1650,23,137213,83.10902483343428,13
0.2,1651,91,137304,83.1138014527845,10
0.2,1652,94,137398,83.12038717483364,7
0.2,1653,95,137493,83.12756952841596,7
0.2,1654,93,137586,83.13353474320242,8
0.2,1655,94,137680,83.14009661835749,8
0.2,1656,91,137771,83.14484007242004,10
0.2,1657,93,137864,83.15078407720145,8
0.2,1658,93,137957,83.15672091621458,8
0.2,1659,94,138051,83.16325301204819,7
0.2,1660,20,138071,83.12522576760988,12
0.2,1661,89,138160,83.12876052948255,12
0.2,1662,94,138254,83.13529765484066,7
0.2,1663,88,138342,83.13822115384616,13
0.2,1664,92,138434,83.14354354354354,9
0.2,1665,94,138528,83.1500600240096,7
0.2,1666,92,138620,83.15536892621476,9
0.2,1667,91,138711,83.16007194244604,10
0.2,1668,93,138804,83.16596764529659,8
0.2,1669,96,138900,83.17365269461078,6
0.2,1670,91,138991,83.17833632555356,10
0.2,1671,93,139084,83.1842105263158,8
0.2,1672,93,139177,83.19007770472206,8
0.2,1673,91,139268,83.194743130227,10
0.2,1674,94,139362,83.20119402985074,7
0.2,1675,88,139450,83.20405727923628,15
0.2,1676,94,139544,83.21049493142516,7
0.2,1677,96,139640,83.2181168057211,6
0.2,1678,92,139732,83.22334723049434,10
0.2,1679,21,139753,83.18630952380953,11
0.2,1680,92,139845,83.19155264723379,10
0.2,1681,90,139935,83.19560047562426,11
0.2,1682,96,140031,83.20320855614973,6
0.2,1683,94,140125,83.20961995249407,9
0.2,1684,92,140217,83.21483679525222,9
0.2,1685,93,140310,83.22064056939502,8
0.2,1686,92,140402,83.22584469472436,9
0.2,1687,95,140497,83.23281990521328,8
0.2,1688,94,140591,83.23919478981647,9
0.2,1689,-53,140538,83.1585798816568,16
0.2,1690,93,140631,83.16439976345357,8
0.2,1691,95,140726,83.17139479905437,6
0.2,1692,91,140817,83.17601890135853,10
0.2,1693,96,140913,83.1835891381346,6
0.2,1694,91,141004,83.1882005899705,10
0.2,1695,83,141087,83.18808962264151,18
0.2,1696,94,141181,83.19446081319977,8
0.2,1697,95,141276,83.20141342756183,6
0.2,1698,8,141284,83.15715126545027,25
0.2,1699,93,141377,83.16294117647058,8
0.2,1700,94,141471,83.16931216931216,8
0.2,1701,25,141496,83.13513513513513,7
0.2,1702,25,141521,83.10099823840282,8
0.2,1703,22,141543,83.06514084507042,14
0.2,1704,94,141637,83.07155425219942,7
0.2,1705,94,141731,83.07796014067995,8
0.2,1706,96,141827,83.0855301698887,6
0.2,1707,88,141915,83.0884074941452,13
0.2,1708,88,142003,83.09128145114101,13
0.2,1709,87,142090,83.09356725146199,14
0.2,1710,91,142181,83.09818819403857,11
0.2,1711,94,142275,83.10455607476635,8
0.2,1712,93,142368,83.11033274956218,10
0.2,1713,94,142462,83.11668611435239,7
0.2,1714,89,142551,83.1201166180758,16
0.2,1715,94,142645,83.12645687645687,7
0.2,1716,96,142741,83.13395457192779,6
0.2,1717,95,142836,83.14086146682189,6
0.2,1718,87,142923,83.14310645724258,14
0.2,1719,-51,142872,83.06511627906977,19
0.2,1720,96,142968,83.07263219058687,6
0.2,1721,91,143059,83.07723577235772,10
0.2,1722,91,143150,83.0818340104469,11
0.2,1723,94,143244,83.08816705336427,7
0.2,1724,91,143335,83.0927536231884,10
0.2,1725,94,143429,83.09907300115874,7
0.2,1726,90,143519,83.10306890561668,11
0.2,1727,85,143604,83.10416666666667,16
0.2,1728,89,143693,83.10757663389242,12
0.2,1729,94,143787,83.11387283236994,9
0.2,1730,92,143879,83.11900635470826,9
0.2,1731,87,143966,83.12124711316397,14
0.2,1732,90,144056,83.12521638776688,12
0.2,1733,91,144147,83.12975778546713,10
0.2,1734,85,144232,83.13083573487032,17
0.2,1735,96,144328,83.13824884792626,6
0.2,1736,92,144420,83.14335060449051,10
0.2,1737,81,144501,83.14211737629459,20
0.2,1738,89,144590,83.14548591144336,12
0.2,1739,95,144685,83.15229885057471,8
0.2,1740,96,144781,83.15967834577829,6
0.2,1741,95,144876,83.16647531572904,6
0.2,1742,92,144968,83.17154331612163,10
0.2,1743,96,145064,83.1788990825688,6
0.2,1744,22,145086,83.14383954154728,11
0.2,1745,91,145177,83.1483390607102,10
0.2,1746,95,145272,83.15512306811677,7
0.2,1747,90,145362,83.15903890160183,11
0.2,1748,96,145458,83.1663807890223,6
0.2,1749,94,145552,83.17257142857143,7
0.2,1750,90,145642,83.17647058823529,11
0.2,1751,92,145734,83.18150684931507,9
0.2,1752,92,145826,83.18653736451797,9
0.2,1753,93,145919,83.1921322690992,11
0.2,1754,93,146012,83.19772079772079,9
0.2,1755,94,146106,83.20387243735763,8
0.2,1756,93,146199,83.20944792259533,9
0.2,1757,92,146291,83.21444823663253,9
0.2,1758,94,146385,83.22057987492893,9
0.2,1759,89,146474,83.22386363636363,12
0.2,1760,90,146564,83.22771152754117,12
0.2,1761,91,146655,83.23212258796822,12
0.2,1762,27,146682,83.20022688598979,6
0.2,1763,92,146774,83.20521541950113,11
0.2,1764,91,146865,83.20963172804532,10
0.2,1765,95,146960,83.2163080407701,6
0.2,1766,90,147050,83.22014714204867,12
0.2,1767,92,147142,83.22511312217195,9
0.2,1768,91,147233,83.22950819672131,10
0.2,1769,93,147326,83.23502824858757,11
0.2,1770,93,147419,83.24054206662902,9
0.2,1771,90,147509,83.24435665914221,11
0.2,1772,95,147604,83.25098702763677,7
0.2,1773,88,147692,83.25366403607666,13
0.2,1774,91,147783,83.25802816901408,10
0.2,1775,92,147875,83.26295045045045,10
0.2,1776,91,147966,83.26730444569499,10
0.2,1777,89,148055,83.2705286839145,13
0.2,1778,96,148151,83.27768409218662,7
0.2,1779,88,148239,83.28033707865168,13
0.2,1780,95,148334,83.28691746209995,6
0.2,1781,94,148428,83.29292929292929,7
0.2,1782,91,148519,83.2972518227706,10
0.2,1783,93,148612,83.30269058295964,8
0.2,1784,92,148704,83.30756302521009,9
0.2,1785,91,148795,83.31187010078388,11
0.2,1786,94,148889,83.31785114717404,7
0.2,1787,92,148981,83.32270693512304,9
0.2,1788,90,149071,83.32643935159307,13
0.2,1789,92,149163,83.33128491620111,9
0.2,1790,89,149252,83.33445002791737,12
0.2,1791,94,149346,83.34040178571429,7
0.2,1792,26,149372,83.30842163970998,8
0.2,1793,84,149456,83.3088071348941,17
0.2,1794,92,149548,83.31364902506964,9
0.2,1795,93,149641,83.31904231625835,8
0.2,1796,94,149735,83.32498608792432,7
0.2,1797,95,149830,83.33147942157953,6
0.2,1798,94,149924,83.33740967204002,7
0.2,1799,88,150012,83.34,13
0.2,1800,27,150039,83.30871737923376,6
0.2,1801,95,150134,83.31520532741398,6
0.2,1802,-45,150089,83.24403771491959,8
0.2,1803,90,150179,83.24778270509978,11
0.2,1804,93,150272,83.25318559556787,9
0.2,1805,89,150361,83.2563676633444,12
0.2,1806,87,150448,83.2584394023243,14
0.2,1807,90,150538,83.26216814159292,11
0.2,1808,96,150634,83.26920950801548,6
0.2,1809,93,150727,83.27458563535912,8
0.2,1810,94,150821,83.28050800662618,7
0.2,1811,92,150913,83.28532008830022,10
0.2,1812,94,151007,83.29123000551571,8
0.2,1813,91,151098,83.2954796030871,10
0.2,1814,94,151192,83.30137741046832,7
0.2,1815,94,151286,83.30726872246696,7
0.2,1816,95,151381,83.3137039075399,7
0.2,1817,26,151407,83.28217821782178,7
0.2,1818,94,151501,83.28807036833425,7
0.2,1819,93,151594,83.29340659340659,8
0.2,1820,88,151682,83.29599121361889,15
0.2,1821,88,151770,83.29857299670691,13
0.2,1822,95,151865,83.30499177180472,6
0.2,1823,87,151952,83.30701754385964,15
0.2,1824,91,152043,83.31123287671232,10
0.2,1825,22,152065,83.2776560788609,10
0.2,1826,88,152153,83.28024083196497,13
0.2,1827,89,152242,83.28336980306345,12
0.2,1828,23,152265,83.25041006014216,10
0.2,1829,95,152360,83.2568306010929,6
0.2,1830,96,152456,83.26379027853632,6
0.2,1831,90,152546,83.2674672489083,12
0.2,1832,94,152640,83.27332242225859,8
0.2,1833,93,152733,83.27862595419847,9
0.2,1834,94,152827,83.28446866485014,7
0.2,1835,90,152917,83.28812636165577,11
0.2,1836,95,153012,83.29450190528034,7
0.2,1837,93,153105,83.29978237214364,8
0.2,1838,90,153195,83.30342577487765,11
0.2,1839,89,153284,83.30652173913043,12
0.2,1840,80,153364,83.30472569255839,22
0.2,1841,92,153456,83.30944625407166,9
0.2,1842,26,153482,83.27835051546391,7
0.2,1843,87,153569,83.28036876355749,15
0.2,1844,96,153665,83.28726287262873,6
0.2,1845,91,153756,83.29144095341279,10
0.2,1846,92,153848,83.29615592853276,9
0.2,1847,84,153932,83.2965367965368,18
0.2,1848,93,154025,83.30178474851272,8
0.2,1849,92,154117,83.30648648648649,10
0.2,1850,93,154210,83.31172339276067,10
0.2,1851,90,154300,83.31533477321814,11
0.2,1852,95,154395,83.32164058283864,7
0.2,1853,91,154486,83.32578209277239,14
0.2,1854,94,154580,83.33153638814017,7
0.2,1855,85,154665,83.33243534482759,16
0.2,1856,95,154760,83.338718362951,6
0.2,1857,96,154856,83.34553283100108,7
0.2,1858,83,154939,83.34534696073158,18
0.2,1859,91,155030,83.34946236559139,11
0.2,1860,92,155122,83.35411069317571,9
0.2,1861,92,155214,83.35875402792696,9
0.2,1862,89,155303,83.361782071927,12
0.2,1863,93,155396,83.36695278969957,8
0.2,1864,93,155489,83.37211796246649,8
0.2,1865,92,155581,83.37674169346195,10
0.2,1866,16,155597,83.34065345474022,18
0.2,1867,90,155687,83.34421841541756,11
0.2,1868,94,155781,83.34991974317818,7
0.2,1869,96,155877,83.35668449197861,6
0.2,1870,90,155967,83.36023516835917,11
0.2,1871,92,156059,83.36485042735043,9
0.2,1872,92,156151,83.36946075814201,10
0.2,1873,92,156243,83.37406616862327,9
0.2,1874,91,156334,83.37813333333334,10
0.2,1875,92,156426,83.38272921108742,9
0.2,1876,93,156519,83.38785295684603,9
0.2,1877,90,156609,83.39137380191693,11
0.2,1878,93,156702,83.39648749334752,8
0.2,1879,94,156796,83.40212765957448,8
0.2,1880,94,156890,83.40776182881446,7
0.2,1881,93,156983,83.41285866099894,9
0.2,1882,94,157077,83.41848114710568,7
0.2,1883,95,157172,83.42462845010616,6
0.2,1884,94,157266,83.43023872679045,7
0.2,1885,91,157357,83.43425238600211,10
0.2,1886,93,157450,83.4393216746158,8
0.2,1887,94,157544,83.44491525423729,8
0.2,1888,93,157637,83.44997353096876,8
0.2,1889,95,157732,83.45608465608466,6
0.2,1890,93,157825,83.46113167636172,8
0.2,1891,95,157920,83.46723044397463,6
0.2,1892,92,158012,83.47173798203909,9
0.2,1893,96,158108,83.47835269271383,6
0.2,1894,94,158202,83.48390501319261,8
0.2,1895,90,158292,83.4873417721519,11
0.2,1896,93,158385,83.49235635213495,9
0.2,1897,94,158479,83.49789251844047,7
0.2,1898,93,158572,83.5028962611901,9
0.2,1899,94,158666,83.50842105263158,7
0.2,1900,93,158759,83.51341399263545,9
0.2,1901,94,158853,83.51892744479495,7
0.2,1902,96,158949,83.52548607461902,6
0.2,1903,92,159041,83.52993697478992,9
0.2,1904,90,159131,83.53333333333333,11
0.2,1905,91,159222,83.53725078698845,10
0.2,1906,89,159311,83.54011536444678,12
0.2,1907,89,159400,83.54297693920336,12
0.2,1908,91,159491,83.54688318491357,10
0.2,1909,94,159585,83.55235602094241,8
0.2,1910,94,159679,83.5578231292517,7
0.2,1911,90,159769,83.56119246861925,11
0.2,1912,92,159861,83.5656037637219,10
0.2,1913,92,159953,83.57001044932079,9
0.2,1914,92,160045,83.57441253263707,9
0.2,1915,94,160139,83.57985386221294,8
0.2,1916,94,160233,83.58528951486699,7
0.2,1917,27,160260,83.55578727841501,6
0.2,1918,93,160353,83.56070870244919,8
0.2,1919,94,160447,83.56614583333334,8
0.2,1920,94,160541,83.57157730348777,7
0.2,1921,93,160634,83.57648283038502,8
0.2,1922,92,160726,83.58086323452937,9
0.2,1923,96,160822,83.58731808731808,6
0.2,1924,92,160914,83.59168831168832,9
0.2,1925,94,161008,83.59709241952233,7
0.2,1926,93,161101,83.60197197716658,8
0.2,1927,92,161193,83.60632780082987,9
0.2,1928,90,161283,83.60964230171074,12
0.2,1929,94,161377,83.61502590673575,7
0.2,1930,95,161472,83.62092180217503,6
0.2,1931,94,161566,83.62629399585921,7
0.2,1932,92,161658,83.63062596999482,9
0.2,1933,94,161752,83.63598759048604,7
0.2,1934,90,161842,83.63927648578812,11
0.2,1935,92,161934,83.64359504132231,10
0.2,1936,92,162026,83.64790913784202,9
0.2,1937,90,162116,83.65118679050568,11
0.2,1938,93,162209,83.65600825167613,8
0.2,1939,17,162226,83.62164948453608,17
0.2,1940,95,162321,83.6275115919629,7
0.2,1941,93,162414,83.6323377960865,8
0.2,1942,92,162506,83.63664436438498,9
0.2,1943,22,162528,83.60493827160494,11
0.2,1944,94,162622,83.61028277634962,7
0.2,1945,95,162717,83.61613566289826,6
0.2,1946,92,162809,83.62044170518747,12
0.2,1947,94,162903,83.62577002053388,7
0.2,1948,89,162992,83.62852744997434,12
0.2,1949,95,163087,83.63435897435897,6
0.2,1950,83,163170,83.63403382880574,18
0.2,1951,21,163191,83.60194672131148,12
0.2,1952,93,163284,83.60675883256529,9
0.2,1953,14,163298,83.5711361310133,21
0.2,1954,95,163393,83.5769820971867,6
0.2,1955,94,163487,83.5823108384458,8
0.2,1956,27,163514,83.55339805825243,6
0.2,1957,95,163609,83.55924412665986,6
0.2,1958,95,163704,83.56508422664625,8
0.2,1959,95,163799,83.57091836734693,6
0.2,1960,90,163889,83.57419683834779,12
0.2,1961,23,163912,83.54332313965341,10
0.2,1962,94,164006,83.54865002547122,7
0.2,1963,90,164096,83.55193482688391,12
0.2,1964,93,164189,83.55674300254454,8
0.2,1965,94,164283,83.56205493387588,7
0.2,1966,90,164373,83.56532791052364,11
0.2,1967,93,164466,83.5701219512195,8
0.2,1968,92,164558,83.57440325038091,9
0.2,1969,91,164649,83.57817258883249,10
0.2,1970,26,164675,83.54895991882293,7
0.2,1971,92,164767,83.55324543610547,9
0.2,1972,80,164847,83.55144450076027,21
0.2,1973,91,164938,83.55521783181358,10
0.2,1974,92,165030,83.55949367088607,10
0.2,1975,89,165119,83.56224696356276,12
0.2,1976,94,165213,83.56752655538695,7
0.2,1977,95,165308,83.57330637007078,9
0.2,1978,86,165394,83.57453259221829,15
0.2,1979,93,165487,83.57929292929293,8
0.2,1980,91,165578,83.58303886925795,12
0.2,1981,89,165667,83.58577194752775,12
0.2,1982,94,165761,83.59102370146243,7
0.2,1983,19,165780,83.55846774193549,13
0.2,1984,92,165872,83.56272040302267,9
0.2,1985,27,165899,83.53423967774421,6
0.2,1986,89,165988,83.536990437846,12
0.2,1987,94,166082,83.54225352112677,7
0.2,1988,26,166108,83.51332327802916,7
0.2,1989,96,166204,83.51959798994974,6
0.2,1990,94,166298,83.52486187845304,7
0.2,1991,90,166388,83.5281124497992,11
0.2,1992,17,166405,83.49473156046162,16
0.2,1993,94,166499,83.5,7
0.2,1994,89,166588,83.50275689223058,12
0.2,1995,96,166684,83.50901803607215,6
0.2,1996,90,166774,83.51226840260391,11
0.2,1997,95,166869,83.51801801801801,6
0.2,1998,86,166955,83.51925962981491,15
0.2,1999,93,167048,83.524,8
0.2,2000,94,167142,83.52923538230884,10
0.2,2001,86,167228,83.53046953046953,15
0.2,2002,94,167322,83.53569645531702,7
0.2,2003,95,167417,83.54141716566866,6
0.2,2004,95,167512,83.54713216957606,6
0.2,2005,92,167604,83.55134596211366,9
0.2,2006,90,167694,83.55455904334828,11
0.2,2007,93,167787,83.55926294820718,10
0.2,2008,94,167881,83.56445993031359,7
0.2,2009,93,167974,83.56915422885572,8
0.2,2010,93,168067,83.57384385877673,8
0.2,2011,95,168162,83.57952286282305,6
0.2,2012,90,168252,83.58271236959762,12
0.2,2013,96,168348,83.5888778550149,6
0.2,2014,96,168444,83.59503722084368,6
0.2,2015,91,168535,83.59871031746032,10
0.2,2016,93,168628,83.60337134357957,8
0.2,2017,92,168720,83.60753221010901,9
0.2,2018,92,168812,83.61168895492818,10
0.2,2019,78,168890,83.60891089108911,23
0.2,2020,94,168984,83.61405244928254,7
0.2,2021,94,169078,83.61918892185955,7
0.2,2022,95,169173,83.62481463173505,6
0.2,2023,91,169264,83.62845849802372,10
0.2,2024,89,169353,83.63111111111111,12
0.2,2025,90,169443,83.63425468904245,13
0.2,2026,93,169536,83.63887518500246,9
0.2,2027,94,169630,83.6439842209073,7
0.2,2028,89,169719,83.64662395268606,13
0.2,2029,91,169810,83.65024630541872,11
0.2,2030,94,169904,83.65534219596258,8
0.2,2031,93,169997,83.6599409448819,8
0.2,2032,93,170090,83.66453516969995,8
0.2,2033,91,170181,83.66814159292035,10
0.2,2034,94,170275,83.67321867321867,7
0.2,2035,93,170368,83.67779960707269,8
0.2,2036,93,170461,83.68237604320079,8
0.2,2037,27,170488,83.65456329735035,6
0.2,2038,94,170582,83.65963707699854,8
0.2,2039,89,170671,83.66225490196078,13
0.2,2040,91,170762,83.66585007349339,10
0.2,2041,94,170856,83.67091087169442,7
0.2,2042,90,170946,83.67400881057269,11
0.2,2043,94,171040,83.67906066536203,7
0.2,2044,92,171132,83.68312958435207,9
0.2,2045,88,171220,83.6852394916911,13
0.2,2046,90,171310,83.68832437713728,11
0.2,2047,92,171402,83.6923828125,9
0.2,2048,96,171498,83.69838945827233,6
0.2,2049,91,171589,83.7019512195122,12
0.2,2050,85,171674,83.70258410531449,17
0.2,2051,96,171770,83.70857699805069,6
0.2,2052,95,171865,83.71407696054554,7
0.2,2053,94,171959,83.7190847127556,8
0.2,2054,93,172052,83.723600973236,8
0.2,2055,90,172142,83.72665369649805,11
0.2,2056,94,172236,83.73164803111327,7
0.2,2057,84,172320,83.73177842565597,17
0.2,2058,94,172414,83.73676542010685,7
0.2,2059,-47,172367,83.67330097087378,12
0.2,2060,87,172454,83.67491508976225,14
0.2,2061,95,172549,83.680407371484,6
0.2,2062,94,172643,83.68540959767329,9
0.2,2063,90,172733,83.68846899224806,11
0.2,2064,94,172827,83.69346246973366,8
0.2,2065,93,172920,83.69796708615682,8
0.2,2066,91,173011,83.70149975810354,10
0.2,2067,93,173104,83.70599613152805,9
0.2,2068,91,173195,83.70952150797487,10
0.2,2069,94,173289,83.71449275362319,7
0.2,2070,95,173384,83.7199420569773,6
0.2,2071,92,173476,83.72393822393822,9
0.2,2072,96,173572,83.72986010612638,6
0.2,2073,84,173656,83.72999035679845,17
0.2,2074,91,173747,83.73349397590361,10
0.2,2075,91,173838,83.73699421965318,10
0.2,2076,24,173862,83.70823302840635,8
0.2,2077,94,173956,83.71318575553417,7
0.2,2078,90,174046,83.71620971620972,11
0.2,2079,94,174140,83.72115384615384,7
0.2,2080,95,174235,83.72657376261412,6
0.2,2081,92,174327,83.73054755043228,10
0.2,2082,92,174419,83.73451752280364,10
0.2,2083,22,174441,83.70489443378119,10
0.2,2084,20,174461,83.67434052757794,12
0.2,2085,87,174548,83.67593480345158,15
0.2,2086,95,174643,83.68136080498323,6
0.2,2087,93,174736,83.68582375478927,8
0.2,2088,93,174829,83.69028243178555,9
0.2,2089,86,174915,83.69138755980862,15
0.2,2090,95,175010,83.69679579148733,6
0.2,2091,90,175100,83.69980879541109,13
0.2,2092,91,175191,83.7032967032967,10
0.2,2093,93,175284,83.70773638968481,8
0.2,2094,95,175379,83.71312649164678,6
0.2,2095,94,175473,83.71803435114504,7
0.2,2096,91,175564,83.72150691463996,10
0.2,2097,95,175659,83.72688274547188,6
0.2,2098,15,175674,83.69414006669842,17
0.2,2099,95,175769,83.69952380952381,6
0.2,2100,95,175864,83.70490242741552,7
0.2,2101,91,175955,83.70837297811607,11
0.2,2102,93,176048,83.71279125059439,8
0.2,2103,90,176138,83.7157794676806,11
0.2,2104,87,176225,83.71733966745843,14
0.2,2105,94,176319,83.72222222222223,7
0.2,2106,92,176411,83.72615092548648,9
0.2,2107,94,176505,83.73102466793169,7
0.2,2108,90,176595,83.73399715504979,12
0.2,2109,90,176685,83.73696682464455,11
0.2,2110,90,176775,83.73993368072004,11
0.2,2111,25,176800,83.71212121212122,8
0.2,2112,95,176895,83.71746332229058,6
0.2,2113,93,176988,83.72185430463576,8
0.2,2114,92,177080,83.725768321513,9
0.2,2115,92,177172,83.7296786389414,9
0.2,2116,92,177264,83.73358526216344,9
0.2,2117,92,177356,83.7374881964117,9
0.2,2118,25,177381,83.70976875884851,8
0.2,2119,92,177473,83.71367924528302,9
0.2,2120,91,177564,83.71711456859971,11
0.2,2121,96,177660,83.72290292177192,6
0.2,2122,93,177753,83.72727272727273,11
0.2,2123,94,177847,83.73210922787194,7
0.2,2124,27,177874,83.70541176470589,6
0.2,2125,94,177968,83.71025399811853,7
0.2,2126,93,178061,83.71462153267512,8
0.2,2127,92,178153,83.71851503759399,9
0.2,2128,95,178248,83.72381399718178,6
0.2,2129,91,178339,83.72723004694836,10
0.2,2130,89,178428,83.72970436414829,12
0.2,2131,91,178519,83.73311444652909,10
0.2,2132,91,178610,83.73652133145804,10
0.2,2133,90,178700,83.73945641986879,11
0.2,2134,94,178794,83.74426229508197,7
0.2,2135,94,178888,83.74906367041199,8
0.2,2136,90,178978,83.75198876930276,11
0.2,2137,92,179070,83.75584658559401,9
0.2,2138,91,179161,83.75923328658251,10
0.2,2139,90,179251,83.76214953271028,11
0.2,2140,-52,179199,83.69873890705279,16
0.2,2141,95,179294,83.70401493930906,6
0.2,2142,96,179390,83.70975268315446,6
0.2,2143,91,179481,83.71315298507463,10
0.2,2144,87,179568,83.71468531468531,14
0.2,2145,89,179657,83.71714818266543,14
0.2,2146,91,179748,83.72054028877504,10
0.2,2147,96,179844,83.72625698324022,6
0.2,2148,95,179939,83.73150302466263,7
0.2,2149,95,180034,83.73674418604651,6
0.2,2150,91,180125,83.74012087401209,11
0.2,2151,92,180217,83.74395910780669,9
0.2,2152,94,180311,83.7487227124942,8
0.2,2153,95,180406,83.75394614670381,7
0.2,2154,96,180502,83.75962877030162,6
0.2,2155,89,180591,83.76205936920222,12
0.2,2156,92,180683,83.76587853500232,9
0.2,2157,80,180763,83.76413345690455,22
0.2,2158,93,180856,83.76841130152849,9
0.2,2159,96,180952,83.77407407407408,6
0.2,2160,87,181039,83.77556686719112,14
0.2,2161,27,181066,83.74930619796484,6
0.2,2162,92,181158,83.75312066574203,9
0.2,2163,95,181253,83.7583179297597,6
0.2,2164,92,181345,83.7621247113164,9
0.2,2165,88,181433,83.764081255771,13
0.2,2166,94,181527,83.76880479926166,7
0.2,2167,27,181554,83.74261992619927,6
0.2,2168,94,181648,83.7473490087598,7
0.2,2169,93,181741,83.7516129032258,9
0.2,2170,92,181833,83.75541225241824,9
0.2,2171,85,181918,83.75598526703499,16
0.2,2172,94,182012,83.76069949378738,8
0.2,2173,93,182105,83.76494940202392,8
0.2,2174,91,182196,83.76827586206896,10
0.2,2175,83,182279,83.76792279411765,18
0.2,2176,91,182370,83.77124483233808,10
0.2,2177,93,182463,83.77548209366391,9
0.2,2178,89,182552,83.77787976135842,13
0.2,2179,93,182645,83.78211009174312,8
0.2,2180,95,182740,83.78725355341587,7
0.2,2181,27,182767,83.76122823098075,6
0.2,2182,92,182859,83.76500229042603,9
0.2,2183,90,182949,83.76785714285714,11
0.2,2184,91,183040,83.77116704805492,10
0.2,2185,92,183132,83.77493138151875,9
0.2,2186,90,183222,83.77777777777777,11
0.2,2187,93,183315,83.78199268738574,9
0.2,2188,93,183408,83.78620374600274,8
0.2,2189,89,183497,83.78858447488585,12
0.2,2190,95,183592,83.79370150616157,7
0.2,2191,94,183686,83.79835766423358,8
0.2,2192,23,183709,83.77063383492933,9
0.2,2193,25,183734,83.74384685505925,7
0.2,2194,88,183822,83.74578587699317,13
0.2,2195,95,183917,83.75091074681238,6
0.2,2196,95,184012,83.75603095129722,6
0.2,2197,92,184104,83.75978161965423,9
0.2,2198,95,184199,83.76489313324238,6
0.2,2199,92,184291,83.76863636363636,9
0.2,2200,92,184383,83.77237619263971,10
0.2,2201,91,184474,83.77565849227975,10
0.2,2202,92,184566,83.77939173853835,9
0.2,2203,92,184658,83.78312159709618,9
0.2,2204,94,184752,83.78775510204082,7
0.2,2205,91,184843,83.79102447869447,10
0.2,2206,94,184937,83.7956502038967,7
0.2,2207,95,185032,83.80072463768116,6
0.2,2208,90,185122,83.80353100950657,11
0.2,2209,94,185216,83.80814479638009,7
0.2,2210,95,185311,83.8132066938037,6
0.2,2211,96,185407,83.81871609403255,6
0.2,2212,94,185501,83.82331676457298,7
0.2,2213,91,185592,83.82655826558266,11
0.2,2214,91,185683,83.82979683972911,10
0.2,2215,92,185775,83.83348375451264,9
0.2,2216,91,185866,83.83671628326567,10
0.2,2217,93,185959,83.84084761045987,8
0.2,2218,95,186054,83.84587652095539,6
0.2,2219,93,186147,83.85,8
0.2,2220,91,186238,83.85321927059883,10
0.2,2221,91,186329,83.85643564356435,10
0.2,2222,94,186423,83.86099865047234,7
0.2,2223,93,186516,83.86510791366906,8
0.2,2224,90,186606,83.86786516853932,11
0.2,2225,94,186700,83.87241689128481,7
0.2,2226,94,186794,83.87696452626852,8
0.2,2227,94,186888,83.88150807899461,7
0.2,2228,94,186982,83.88604755495739,7
0.2,2229,93,187075,83.89013452914799,9
0.2,2230,19,187094,83.8610488570148,13
0.2,2231,94,187188,83.86559139784946,7
0.2,2232,95,187283,83.8705776981639,6
0.2,2233,96,187379,83.87600716204118,6
0.2,2234,88,187467,83.87785234899329,13
0.2,2235,15,187482,83.84704830053667,17
0.2,2236,90,187572,83.8497988377291,11
0.2,2237,91,187663,83.85299374441466,10
0.2,2238,96,187759,83.85841893702546,6
0.2,2239,91,187850,83.86160714285714,10
0.2,2240,92,187942,83.86523873270862,9
0.2,2241,93,188035,83.86931311329171,8
0.2,2242,95,188130,83.87427552385198,6
0.2,2243,94,188224,83.87878787878788,8
0.2,2244,93,188317,83.88285077951002,8
0.2,2245,94,188411,83.88735529830811,7
0.2,2246,91,188502,83.89052069425901,10
0.2,2247,94,188596,83.8950177935943,7
0.2,2248,95,188691,83.89995553579368,6
0.2,2249,95,188786,83.90488888888889,6
0.2,2250,96,188882,83.91026210573078,6
0.2,2251,88,188970,83.91207815275311,14
0.2,2252,96,189066,83.91744340878829,6
0.2,2253,95,189161,83.9223602484472,6
0.2,2254,85,189246,83.92283813747228,16
0.2,2255,94,189340,83.927304964539,7
0.2,2256,94,189434,83.93176783340718,8
0.2,2257,93,189527,83.93578387953941,9
0.2,2258,91,189618,83.93891102257636,10
0.2,2259,94,189712,83.94336283185841,7
0.2,2260,95,189807,83.9482529854047,6
0.2,2261,95,189902,83.95313881520778,6
0.2,2262,96,189998,83.9584622182943,6
0.2,2263,95,190093,83.96333922261483,7
0.2,2264,25,190118,83.93730684326711,8
0.2,2265,95,190213,83.94218887908208,6
0.2,2266,92,190305,83.94574327304808,9
0.2,2267,25,190330,83.91975308641975,8
0.2,2268,95,190425,83.92463640370207,7
0.2,2269,92,190517,83.92819383259912,9
0.2,2270,18,190535,83.89916336415676,14
0.2,2271,90,190625,83.9018485915493,11
0.2,2272,23,190648,83.8750549934008,12
0.2,2273,91,190739,83.87818821459983,10
0.2,2274,95,190834,83.88307692307693,6
0.2,2275,85,190919,83.88356766256591,16
0.2,2276,93,191012,83.88757136583223,8
0.2,2277,91,191103,83.89069359086918,10
0.2,2278,91,191194,83.89381307591049,10
0.2,2279,91,191285,83.8969298245614,10
0.2,2280,94,191379,83.9013590530469,7
0.2,2281,93,191472,83.90534618755477,8
0.2,2282,86,191558,83.90626368812966,15
0.2,2283,93,191651,83.91024518388791,9
0.2,2284,92,191743,83.91378555798687,9
0.2,2285,93,191836,83.91776027996501,8
0.2,2286,89,191925,83.91998250983822,15
0.2,2287,87,192012,83.92132867132867,14
0.2,2288,94,192106,83.92573176059415,7
0.2,2289,93,192199,83.9296943231441,9
0.2,2290,94,192293,83.93408991706679,7
0.2,2291,86,192379,83.93499127399652,15
0.2,2292,90,192469,83.93763628434365,11
0.2,2293,89,192558,83.93984306887533,12
0.2,2294,95,192653,83.9446623093682,8
0.2,2295,94,192747,83.94904181184668,8
0.2,2296,91,192838,83.95211144971702,10
0.2,2297,93,192931,83.95604873803308,8
0.2,2298,95,193026,83.9608525445846,6
0.2,2299,96,193122,83.96608695652174,6
0.2,2300,89,193211,83.96827466318992,12
0.2,2301,94,193305,83.97263249348393,7
0.2,2302,94,193399,83.97698653929658,9
0.2,2303,88,193487,83.97873263888889,13
0.2,2304,91,193578,83.98177874186551,12
0.2,2305,93,193671,83.98568950563747,9
0.2,2306,84,193755,83.98569570871261,17
0.2,2307,90,193845,83.98830155979203,11
0.2,2308,92,193937,83.9917713295799,9
0.2,2309,90,194027,83.9943722943723,12
0.2,2310,94,194121,83.99870186066637,7
0.2,2311,96,194217,84.00389273356402,6
0.2,2312,89,194306,84.00605274535236,12
0.2,2313,94,194400,84.01037165082109,7
0.2,2314,25,194425,83.98488120950324,8
0.2,2315,94,194519,83.98920552677029,8
0.2,2316,95,194614,83.99395770392749,8
0.2,2317,88,194702,83.99568593615186,15
0.2,2318,87,194789,83.9969814575248,15
0.2,2319,90,194879,83.99956896551724,11
0.2,2320,23,194902,83.97328737613098,9
0.2,2321,93,194995,83.97717484926787,8
0.2,2322,86,195081,83.97804563065002,15
0.2,2323,96,195177,83.98321858864027,7
0.2,2324,96,195273,83.98838709677419,7
0.2,2325,86,195359,83.98925193465176,15
0.2,2326,95,195454,83.99398366996132,6
0.2,2327,94,195548,83.99828178694158,7
0.2,2328,92,195640,84.0017174753113,9
0.2,2329,94,195734,84.00600858369098,7
0.2,2330,92,195826,84.00943800943801,9
0.2,2331,93,195919,84.01329331046313,8
0.2,2332,89,196008,84.01543077582512,14
0.2,2333,94,196102,84.0197086546701,7
0.2,2334,90,196192,84.02226980728051,11
0.2,2335,92,196284,84.02568493150685,9
0.2,2336,90,196374,84.02824133504492,14
0.2,2337,84,196458,84.02822925577416,17
0.2,2338,93,196551,84.03206498503634,9
0.2,2339,92,196643,84.03547008547008,10
0.2,2340,93,196736,84.03929944468176,8
0.2,2341,26,196762,84.01451750640479,7
0.2,2342,96,196858,84.01963294921042,6
0.2,2343,94,196952,84.02389078498294,10
0.2,2344,94,197046,84.02814498933903,8
0.2,2345,25,197071,84.00298380221653,8
0.2,2346,86,197157,84.0038346825735,15
0.2,2347,92,197249,84.00724020442931,9
0.2,2348,92,197341,84.01064282673478,9
0.2,2349,91,197432,84.0136170212766,10
0.2,2350,94,197526,84.01786473840919,7
0.2,2351,91,197617,84.02083333333333,10
0.2,2352,86,197703,84.02167445813855,18
0.2,2353,17,197720,83.99320305862362,15
0.2,2354,95,197815,83.99787685774947,6
0.2,2355,96,197911,84.00297113752123,6
0.2,2356,24,197935,83.97751378871446,8
0.2,2357,89,198024,83.9796437659033,13
0.2,2358,91,198115,83.98261975413311,11
0.2,2359,90,198205,83.98516949152543,11
0.2,2360,94,198299,83.98941126641253,7
0.2,2361,96,198395,83.99449618966977,6
0.2,2362,93,198488,83.99830723656369,8
0.2,2363,96,198584,84.00338409475465,6
0.2,2364,92,198676,84.00676532769556,10
0.2,2365,82,198758,84.00591715976331,19
0.2,2366,94,198852,84.01013941698352,7
0.2,2367,89,198941,84.01224662162163,12
0.2,2368,20,198961,83.98522583368509,13
0.2,2369,90,199051,83.98776371308017,12
0.2,2370,92,199143,83.99114297764656,9
0.2,2371,91,199234,83.99409780775717,11
0.2,2372,94,199328,83.99831436999578,7
0.2,2373,94,199422,84.00252737994946,7
0.2,2374,83,199505,84.0021052631579,18
0.2,2375,91,199596,84.0050505050505,10
0.2,2376,92,199688,84.00841396718553,10
0.2,2377,96,199784,84.01345668629101,6
0.2,2378,25,199809,83.98865069356873,7
0.2,2379,96,199905,83.99369747899159,6
0.2,2380,94,199999,83.99790004199916,7
0.2,2381,20,200019,83.97103274559194,14
0.2,2382,92,200111,83.97440201426772,9
0.2,2383,96,200207,83.97944630872483,6
0.2,2384,94,200301,83.98364779874214,7
0.2,2385,95,200396,83.98826487845767,6
0.2,2386,24,200420,83.963133640553,10
0.2,2387,12,200432,83.93299832495812,20
0.2,2388,93,200525,83.93679363750523,8
0.2,2389,89,200614,83.93891213389121,12
0.2,2390,96,200710,83.943956503555,7
0.2,2391,92,200802,83.94732441471572,9
0.2,2392,94,200896,83.95152528207271,7
0.2,2393,92,200988,83.95488721804512,11
0.2,2394,94,201082,83.95908141962421,7
0.2,2395,92,201174,83.96243739565944,11
0.2,2396,96,201270,83.9674593241552,6
0.2,2397,96,201366,83.97247706422019,6
0.2,2398,20,201386,83.94581075448103,12
0.2,2399,91,201477,83.94875,12
0.2,2400,82,201559,83.94793835901707,20
0.2,2401,93,201652,83.95170691090757,8
0.2,2402,94,201746,83.9558884727424,7
0.2,2403,92,201838,83.95923460898503,9
0.2,2404,92,201930,83.96257796257797,9
0.2,2405,93,202023,83.96633416458853,8
0.2,2406,93,202116,83.97008724553386,8
0.2,2407,92,202208,83.9734219269103,9
0.2,2408,92,202300,83.97675383976754,9
0.2,2409,90,202390,83.97925311203319,14
0.2,2410,93,202483,83.98299460804645,8
0.2,2411,92,202575,83.9863184079602,9
0.2,2412,91,202666,83.98922503108165,10
0.2,2413,94,202760,83.993371996686,7
0.2,2414,27,202787,83.96977225672877,6
0.2,2415,86,202873,83.97061258278146,15
0.2,2416,91,202964,83.97352089366984,11
0.2,2417,92,203056,83.97684036393714,9
0.2,2418,95,203151,83.98139727159983,6
0.2,2419,96,203247,83.98636363636363,6
0.2,2420,94,203341,83.99049979347377,7
0.2,2421,89,203430,83.9925681255161,12
0.2,2422,96,203526,83.99752373091209,6
0.2,2423,93,203619,84.00123762376238,8
0.2,2424,93,203712,84.00494845360825,8
0.2,2425,95,203807,84.00948062654575,6
0.2,2426,91,203898,84.0123609394314,10
0.2,2427,92,203990,84.01565074135091,9
0.2,2428,95,204085,84.02017291066282,6
0.2,2429,88,204173,84.02181069958847,14
0.2,2430,86,204259,84.02262443438914,15
0.2,2431,80,204339,84.02097039473684,23
0.2,2432,91,204430,84.02383888203863,11
0.2,2433,94,204524,84.02793755135579,9
0.2,2434,94,204618,84.03203285420945,7
0.2,2435,94,204712,84.03612479474549,7
0.2,2436,86,204798,84.03693065244153,15
0.2,2437,-56,204742,83.97949138638228,20
0.2,2438,-52,204690,83.92373923739237,15
0.2,2439,92,204782,83.92704918032787,9
0.2,2440,93,204875,83.93076607947563,10
0.2,2441,95,204970,83.93529893529893,7
0.2,2442,90,205060,83.93778141629144,12
0.2,2443,25,205085,83.91366612111293,8
0.2,2444,24,205109,83.88916155419223,10
0.2,2445,93,205202,83.89288634505314,8
0.2,2446,92,205294,83.89619942787087,9
0.2,2447,92,205386,83.89950980392157,9
0.2,2448,94,205480,83.9036341363822,8
0.2,2449,90,205570,83.90612244897959,11
0.2,2450,89,205659,83.90820073439413,12
0.2,2451,90,205749,83.91068515497552,11
0.2,2452,25,205774,83.88666938442724,8
0.2,2453,96,205870,83.8916055419723,6
0.2,2454,76,205946,83.88839103869654,25
0.2,2455,96,206042,83.89332247557003,6
0.2,2456,92,206134,83.8966218966219,9
0.2,2457,93,206227,83.90032546786004,8
0.2,2458,94,206321,83.90443269621798,7
0.2,2459,96,206417,83.90934959349593,6
0.2,2460,92,206509,83.91263713937424,9
0.2,2461,92,206601,83.91592201462225,9
0.2,2462,92,206693,83.9192042224929,9
0.2,2463,86,206779,83.9200487012987,15
0.2,2464,95,206874,83.92454361054767,6
0.2,2465,93,206967,83.92822384428224,8
0.2,2466,94,207061,83.93230644507499,8
0.2,2467,94,207155,83.93638573743922,7
0.2,2468,93,207248,83.94005670311867,8
0.2,2469,91,207339,83.94291497975709,10
0.2,2470,93,207432,83.94658033184945,8
0.2,2471,93,207525,83.9502427184466,8
0.2,2472,94,207619,83.95430651031137,7
0.2,2473,94,207713,83.95836701697655,7
0.2,2474,90,207803,83.96080808080808,12
0.2,2475,87,207890,83.96203554119548,14
0.2,2476,27,207917,83.93903916027453,6
0.2,2477,92,208009,83.94229217110573,9
0.2,2478,92,208101,83.94554255748285,9
0.2,2479,92,208193,83.94879032258065,9
0.2,2480,94,208287,83.9528415961306,7
0.2,2481,91,208378,83.95568090249799,10
0.2,2482,85,208463,83.95610149013291,16
0.2,2483,94,208557,83.96014492753623,8
0.2,2484,91,208648,83.96297786720322,10
0.2,2485,89,208737,83.96500402252614,12
0.2,2486,96,208833,83.9698431845597,7
0.2,2487,95,208928,83.97427652733118,6
0.2,2488,93,209021,83.97790277219767,9
0.2,2489,94,209115,83.98192771084338,8
0.2,2490,94,209209,83.98594941790445,7
0.2,2491,96,209305,83.99077046548956,6
0.2,2492,93,209398,83.99438427597272,8
0.2,2493,92,209490,83.99759422614274,9
0.2,2494,87,209577,83.99879759519038,14
0.2,2495,95,209672,84.00320512820512,6
0.2,2496,90,209762,84.00560672807369,11
0.2,2497,94,209856,84.00960768614893,8
0.2,2498,92,209948,84.01280512204882,10
0.2,2499,93,210041,84.0164,8
0.2,2500,8,210049,83.9860055977609,25
0.2,2501,94,210143,83.99000799360512,7
0.2,2502,95,210238,83.99440671194567,7
0.2,2503,92,210330,83.99760383386581,9
0.2,2504,93,210423,84.00119760479042,8
0.2,2505,94,210517,84.00518754988029,7
0.2,2506,84,210601,84.00518548065416,17
0.2,2507,90,210691,84.00757575757575,11
0.2,2508,87,210778,84.0087684336389,14
0.2,2509,93,210871,84.01235059760957,8
0.2,2510,93,210964,84.01592990840302,8
0.2,2511,94,211058,84.01990445859873,7
0.2,2512,93,211151,84.02347791484281,8
0.2,2513,93,211244,84.02704852824185,8
0.2,2514,96,211340,84.03180914512923,6
0.2,2515,92,211432,84.03497615262322,10
0.2,2516,94,211526,84.03893524036552,7
0.2,2517,95,211621,84.04328832406672,6
0.2,2518,88,211709,84.04485907105995,13
0.2,2519,90,211799,84.04722222222222,11
0.2,2520,92,211891,84.05037683458944,9
0.2,2521,89,211980,84.05233941316416,12
0.2,2522,87,212067,84.05350772889417,14
0.2,2523,93,212160,84.05705229793978,10
0.2,2524,93,212253,84.06059405940594,8
0.2,2525,92,212345,84.06373713380839,9
0.2,2526,96,212441,84.06846062524733,6
0.2,2527,87,212528,84.06962025316456,14
0.2,2528,92,212620,84.07275603005141,9
0.2,2529,93,212713,84.07628458498024,8
0.2,2530,91,212804,84.07902015013829,10
0.2,2531,91,212895,84.08175355450237,10
0.2,2532,93,212988,84.08527437820766,8
0.2,2533,20,213008,84.05998421468034,12
0.2,2534,90,213098,84.06232741617357,11
0.2,2535,92,213190,84.0654574132492,9
0.2,2536,93,213283,84.06897910918407,9
0.2,2537,93,213376,84.07249802994484,8
0.2,2538,92,213468,84.0756203229618,9
0.2,2539,92,213560,84.07874015748031,10
0.2,2540,95,213655,84.08303817394726,8
0.2,2541,95,213750,84.08733280881196,6
0.2,2542,90,213840,84.08965788438852,11
0.2,2543,83,213923,84.08922955974843,18
0.2,2544,92,214015,84.09233791748527,10
0.2,2545,94,214109,84.0962293794187,7
0.2,2546,94,214203,84.10011778563015,7
0.2,2547,96,214299,84.10478806907378,6
0.2,2548,90,214389,84.10710082385249,12
0.2,2549,25,214414,84.08392156862745,8
0.2,2550,87,214501,84.08506468051745,14
0.2,2551,93,214594,84.0885579937304,8
0.2,2552,88,214682,84.09009009009009,13
0.2,2553,94,214776,84.09397024275646,7
0.2,2554,94,214870,84.09784735812133,7
0.2,2555,93,214963,84.10133020344288,9
0.2,2556,96,215059,84.10598357450137,6
0.2,2557,89,215148,84.1078967943706,12
0.2,2558,95,215243,84.11215318483782,7
0.2,2559,90,215333,84.114453125,11
0.2,2560,94,215427,84.11831315892229,7
0.2,2561,94,215521,84.12217017954723,8
0.2,2562,89,215610,84.12407335154116,14
0.2,2563,92,215702,84.12714508580343,9
0.2,2564,95,215797,84.13138401559455,6
0.2,2565,94,215891,84.1352299298519,7
0.2,2566,89,215980,84.13712504869497,12
0.2,2567,25,216005,84.11409657320873,7
0.2,2568,95,216100,84.1183339820942,6
0.2,2569,90,216190,84.12062256809338,11
0.2,2570,96,216286,84.12524309607157,6
0.2,2571,93,216379,84.1286936236392,8
0.2,2572,93,216472,84.13214146910221,8
0.2,2573,94,216566,84.13597513597513,9
0.2,2574,94,216660,84.13980582524272,8
0.2,2575,94,216754,84.14363354037268,7
0.2,2576,94,216848,84.14745828482732,7
0.2,2577,87,216935,84.14856477889838,14
0.2,2578,93,217028,84.15199689802249,8
0.2,2579,88,217116,84.15348837209302,14
0.2,2580,94,217210,84.15730337078652,7
0.2,2581,96,217306,84.16189000774594,6
0.2,2582,93,217399,84.16531165311653,8
0.2,2583,87,217486,84.16640866873065,14
0.2,2584,93,217579,84.16982591876209,8
0.2,2585,92,217671,84.17285382830626,9
0.2,2586,93,217764,84.17626594511016,8
0.2,2587,91,217855,84.17890262751159,11
0.2,2588,91,217946,84.1815372730784,10
0.2,2589,93,218039,84.18494208494208,9
0.2,2590,93,218132,84.18834426862216,8
0.2,2591,91,218223,84.19097222222223,10
0.2,2592,94,218317,84.1947551099113,8
0.2,2593,96,218413,84.19930609097918,6
0.2,2594,92,218505,84.20231213872832,10
0.2,2595,90,218595,84.20454545454545,12
0.2,2596,23,218618,84.180978051598,9
0.2,2597,91,218709,84.18360277136259,10
0.2,2598,91,218800,84.18622547133513,10
0.2,2599,91,218891,84.18884615384616,10
0.2,2600,93,218984,84.1922337562476,9
0.2,2601,80,219064,84.19062259800154,22
0.2,2602,93,219157,84.19400691509796,8
0.2,2603,93,219250,84.1973886328725,8
0.2,2604,95,219345,84.20153550863724,6
0.2,2605,95,219440,84.2056792018419,7
0.2,2606,89,219529,84.20751822017645,12
0.2,2607,88,219617,84.20897239263803,13
0.2,2608,90,219707,84.21119202759678,12
0.2,2609,23,219730,84.18773946360153,10
0.2,2610,88,219818,84.18919954040598,13
0.2,2611,96,219914,84.1937212863706,6
0.2,2612,95,220009,84.19785686949866,7
0.2,2613,80,220089,84.19625095638868,22
0.2,2614,27,220116,84.17437858508605,6
0.2,2615,94,220210,84.17813455657492,7
0.2,2616,93,220303,84.18150554069545,9
0.2,2617,94,220397,84.18525592055003,8
0.2,2618,94,220491,84.18900343642612,7
0.2,2619,86,220577,84.18969465648856,16
0.2,2620,94,220671,84.1934376192293,7
0.2,2621,92,220763,84.19641495041952,9
0.2,2622,91,220854,84.19900876858559,10
0.2,2623,88,220942,84.20045731707317,13
0.2,2624,94,221036,84.20419047619048,7
0.2,2625,85,221121,84.2044935262757,17
0.2,2626,93,221214,84.20784164446137,8
0.2,2627,96,221310,84.21232876712328,6
0.2,2628,96,221406,84.2168124762267,6
0.2,2629,94,221500,84.22053231939164,7
0.2,2630,96,221596,84.22500950209046,6
0.2,2631,95,221691,84.22910334346504,7
0.2,2632,87,221778,84.23015571591341,14
0.2,2633,93,221871,84.23348519362187,8
0.2,2634,90,221961,84.23567362428842,11
0.2,2635,92,222053,84.2386191198786,11
0.2,2636,92,222145,84.24156238149412,10
0.2,2637,90,222235,84.24374526156178,11
0.2,2638,88,222323,84.24516862447896,14
0.2,2639,91,222414,84.24772727272727,10
0.2,2640,93,222507,84.25104127224536,8
0.2,2641,25,222532,84.22861468584406,10
0.2,2642,91,222623,84.23117669315172,10
0.2,2643,91,222714,84.23373676248109,11
0.2,2644,93,222807,84.23705103969755,8
0.2,2645,94,222901,84.24074074074075,8
0.2,2646,94,222995,84.24442765394787,8
0.2,2647,94,223089,84.24811178247734,7
0.2,2648,96,223185,84.25254813137033,7
0.2,2649,92,223277,84.25547169811321,9
0.2,2650,84,223361,84.25537533006413,17
0.2,2651,27,223388,84.23378582202112,6
0.2,2652,95,223483,84.23784395024501,6
0.2,2653,96,223579,84.24227581009796,6
0.2,2654,94,223673,84.24595103578154,7
0.2,2655,86,223759,84.24661144578313,15
0.2,2656,94,223853,84.2502822732405,8
0.2,2657,93,223946,84.2535741158766,8
0.2,2658,94,224040,84.25723956374577,8
0.2,2659,94,224134,84.2609022556391,7
0.2,2660,95,224229,84.26493799323562,6
0.2,2661,96,224325,84.26934635612322,8
0.2,2662,94,224419,84.27300037551633,8
0.2,2663,94,224513,84.27665165165165,7
0.2,2664,95,224608,84.28067542213884,7
0.2,2665,88,224696,84.2820705176294,14
0.2,2666,93,224789,84.28533933258343,8
0.2,2667,94,224883,84.28898050974513,7
0.2,2668,93,224976,84.29224428624953,9
0.2,2669,92,225068,84.29513108614232,9
0.2,2670,90,225158,84.29726694122051,12
0.2,2671,94,225252,84.30089820359281,9
0.2,2672,91,225343,84.30340441451553,11
0.2,2673,92,225435,84.30628272251309,9
0.2,2674,93,225528,84.30953271028038,8
0.2,2675,89,225617,84.31128550074739,12
0.2,2676,92,225709,84.3141576391483,9
0.2,2677,25,225734,84.29200896191188,8
0.2,2678,96,225830,84.29637924598731,6
0.2,2679,77,225907,84.29365671641791,24
0.2,2680,90,225997,84.29578515479298,11
0.2,2681,95,226092,84.29977628635346,6
0.2,2682,94,226186,84.30339172568021,7
0.2,2683,18,226204,84.27868852459017,15
0.2,2684,94,226298,84.28230912476722,7
0.2,2685,94,226392,84.28592702903947,7
0.2,2686,27,226419,84.2646073688128,6
0.2,2687,15,226434,84.23883928571429,17
0.2,2688,90,226524,84.24098177761249,11
0.2,2689,86,226610,84.24163568773234,17
0.2,2690,95,226705,84.24563359345969,8
0.2,2691,91,226796,84.2481426448737,10
0.2,2692,95,226891,84.25213516524322,6
0.2,2693,94,226985,84.25575352635487,7
0.2,2694,93,227078,84.25899814471244,8
0.2,2695,94,227172,84.26261127596439,7
0.2,2696,92,227264,84.26548016314423,9
0.2,2697,95,227359,84.26945885841364,6
0.2,2698,94,227453,84.273064097814,7
0.2,2699,92,227545,84.27592592592593,10
0.2,2700,93,227638,84.27915586819697,8
0.2,2701,89,227727,84.28090303478905,12
0.2,2702,95,227822,84.2848686644469,8
0.2,2703,86,227908,84.28550295857988,15
0.2,2704,89,227997,84.28724584103512,15
0.2,2705,93,228090,84.29046563192905,8
0.2,2706,89,228179,84.29220539342445,12
0.2,2707,87,228266,84.29320531757755,14
0.2,2708,94,228360,84.296788482835,7
0.2,2709,93,228453,84.3,8
0.2,2710,94,228547,84.30357801549243,7
0.2,2711,86,228633,84.304203539823,15
0.2,2712,85,228718,84.30446000737192,16
0.2,2713,90,228808,84.30655858511422,11
0.2,2714,93,228901,84.3097605893186,8
0.2,2715,92,228993,84.31259204712813,9
0.2,2716,92,229085,84.31542142068457,12
0.2,2717,96,229181,84.31972038263429,7
0.2,2718,95,229276,84.3236484001471,6
0.2,2719,92,229368,84.3264705882353,9
0.2,2720,94,229462,84.3300257258361,7
0.2,2721,94,229556,84.33357825128581,7
0.2,2722,94,229650,84.33712816746235,7
0.2,2723,94,229744,84.34067547723936,7
0.2,2724,94,229838,84.34422018348624,7
0.2,2725,94,229932,84.34776228906823,7
0.2,2726,95,230027,84.35166850018335,6
0.2,2727,93,230120,84.35483870967742,8
0.2,2728,83,230203,84.35434224990838,18
0.2,2729,87,230290,84.35531135531136,14
0.2,2730,95,230385,84.35920908092274,6
0.2,2731,95,230480,84.36310395314787,6
0.2,2732,89,230569,84.36480058543725,12
0.2,2733,90,230659,84.36686174103878,12
0.2,2734,95,230754,84.3707495429616,6
0.2,2735,94,230848,84.37426900584795,7
0.2,2736,94,230942,84.37778589696748,9
0.2,2737,92,231034,84.38056975894814,10
0.2,2738,95,231129,84.38444687842278,6
0.2,2739,93,231222,84.3875912408759,8
0.2,2740,89,231311,84.38927398759577,13
0.2,2741,92,231403,84.39204959883297,10
0.2,2742,92,231495,84.39482318629238,9
0.2,2743,91,231586,84.3972303206997,10
0.2,2744,85,231671,84.39744990892532,17
0.2,2745,93,231764,84.40058266569555,8
0.2,2746,91,231855,84.40298507462687,13
0.2,2747,92,231947,84.40574963609897,9
0.2,2748,84,232031,84.4056020371044,18
0.2,2749,92,232123,84.40836363636363,9
0.2,2750,90,232213,84.41039621955653,13
0.2,2751,94,232307,84.41388081395348,7
0.2,2752,88,232395,84.41518343625137,14
0.2,2753,80,232475,84.41358024691358,21
0.2,2754,91,232566,84.41597096188748,11
0.2,2755,94,232660,84.41944847605225,8
0.2,2756,94,232754,84.42292346753717,8
0.2,2757,96,232850,84.42712110224801,6
0.2,2758,95,232945,84.43095324392895,6
0.2,2759,94,233039,84.43442028985507,8
0.2,2760,93,233132,84.43752263672583,8
0.2,2761,95,233227,84.44134685010862,6
0.2,2762,81,233308,84.44010133912414,20
0.2,2763,93,233401,84.44319826338639,8
0.2,2764,94,233495,84.44665461121157,7
0.2,2765,90,233585,84.44866232827188,12
0.2,2766,82,233667,84.44777737621973,19
0.2,2767,93,233760,84.45086705202313,8
0.2,2768,92,233852,84.4535933550018,10
0.2,2769,95,233947,84.45740072202166,6
0.2,2770,89,234036,84.45904005774089,13
0.2,2771,92,234128,84.46176046176046,9
0.2,2772,92,234220,84.4644789037144,9
0.2,2773,25,234245,84.44304253785148,7
0.2,2774,95,234340,84.44684684684685,6
0.2,2775,96,234436,84.45100864553314,6
0.2,2776,91,234527,84.45336694274397,10
0.2,2777,95,234622,84.45716342692585,6
0.2,2778,94,234716,84.46059733717165,8
0.2,2779,92,234808,84.46330935251798,9
0.2,2780,92,234900,84.46601941747574,9
0.2,2781,93,234993,84.46908698777858,9
0.2,2782,94,235087,84.47251167804528,7
0.2,2783,25,235112,84.45114942528735,7
0.2,2784,22,235134,84.42872531418313,10
0.2,2785,93,235227,84.43180186647524,8
0.2,2786,94,235321,84.43523501973448,10
0.2,2787,90,235411,84.43723098995696,11
0.2,2788,94,235505,84.44065973467193,9
0.2,2789,90,235595,84.44265232974911,11
0.2,2790,94,235689,84.44607667502687,9
0.2,2791,95,235784,84.44985673352436,6
0.2,2792,91,235875,84.45220193340494,10
0.2,2793,94,235969,84.45561918396564,7
0.2,2794,92,236061,84.45831842576028,9
0.2,2795,94,236155,84.46173104434907,9
0.2,2796,92,236247,84.4644261708974,9
0.2,2797,88,236335,84.46568977841315,16
0.2,2798,94,236429,84.46909610575206,7
0.2,2799,94,236523,84.4725,7
0.2,2800,95,236618,84.4762584791146,6
0.2,2801,24,236642,84.45467523197716,8
0.2,2802,91,236733,84.4570103460578,10
0.2,2803,89,236822,84.4586305278174,12
0.2,2804,93,236915,84.46167557932264,8
0.2,2805,95,237010,84.46543121881682,6
0.2,2806,92,237102,84.46811542572141,9
0.2,2807,91,237193,84.4704415954416,10
0.2,2808,90,237283,84.47241011035956,11
0.2,2809,93,237376,84.47544483985764,8
0.2,2810,95,237471,84.47918890074706,7
0.2,2811,94,237565,84.4825746799431,7
0.2,2812,80,237645,84.48098115890508,22
0.2,2813,93,237738,84.48400852878464,9
0.2,2814,16,237754,84.45968028419183,16
0.2,2815,96,237850,84.4637784090909,6
0.2,2816,92,237942,84.46645367412141,9
0.2,2817,92,238034,84.46912704045423,9
0.2,2818,88,238122,84.47037956722242,13
0.2,2819,21,238143,84.44787234042553,11
0.2,2820,93,238236,84.4509039347749,8
0.2,2821,93,238329,84.45393338058115,8
0.2,2822,91,238420,84.45625221395679,10
0.2,2823,94,238514,84.45963172804532,7
0.2,2824,94,238608,84.46300884955753,8
0.2,2825,93,238701,84.46602972399151,10
0.2,2826,25,238726,84.44499469402193,7
0.2,2827,96,238822,84.44908062234795,6
0.2,2828,95,238917,84.45281018027572,7
0.2,2829,94,239011,84.45618374558303,7
0.2,2830,91,239102,84.45849523136701,12
0.2,2831,87,239189,84.45939265536722,15
0.2,2832,96,239285,84.46346629015179,6
0.2,2833,95,239380,84.46718419195483,7
0.2,2834,92,239472,84.46984126984127,10
0.2,2835,86,239558,84.4703808180536,15
0.2,2836,90,239648,84.47232992597814,11
0.2,2837,95,239743,84.47603946441156,6
0.2,2838,90,239833,84.47798520605848,12
0.2,2839,93,239926,84.48098591549295,8
0.2,2840,92,240018,84.48363252375924,9
0.2,2841,93,240111,84.48662913441238,9
0.2,2842,91,240202,84.48892015476609,10
0.2,2843,93,240295,84.49191279887482,8
0.2,2844,90,240385,84.49384885764499,11
0.2,2845,90,240475,84.49578355586789,11
0.2,2846,84,240559,84.49560941341764,17
0.2,2847,91,240650,84.49789325842697,10
0.2,2848,24,240674,84.47665847665847,8
0.2,2849,90,240764,84.47859649122807,11
0.2,2850,94,240858,84.48193616274992,7
0.2,2851,96,240954,84.4859747545582,6
0.2,2852,91,241045,84.48825797406239,10
0.2,2853,91,241136,84.49053959355291,10
0.2,2854,89,241225,84.49211908931699,12
0.2,2855,93,241318,84.49509803921569,8
0.2,2856,90,241408,84.49702485124256,11
0.2,2857,87,241495,84.49790062981106,14
0.2,2858,95,241590,84.50157397691501,6
0.2,2859,94,241684,84.5048951048951,7
0.2,2860,26,241710,84.48444599790282,7
0.2,2861,95,241805,84.48812019566736,6
0.2,2862,93,241898,84.49109325881942,8
0.2,2863,92,241990,84.49371508379889,10
0.2,2864,94,242084,84.49703315881327,7
0.2,2865,91,242175,84.49930216329379,10
0.2,2866,89,242264,84.50087199162888,12
0.2,2867,95,242359,84.50453277545327,6
0.2,2868,94,242453,84.50784245381666,7
0.2,2869,91,242544,84.51010452961673,10
0.2,2870,84,242628,84.50992685475444,17
0.2,2871,94,242722,84.51323119777159,7
0.2,2872,92,242814,84.5158371040724,9
0.2,2873,92,242906,84.51844119693807,9
0.2,2874,93,242999,84.52139130434783,8
0.2,2875,94,243093,84.52468706536857,8
0.2,2876,94,243187,84.52798053527981,7
0.2,2877,91,243278,84.53022932592077,10
0.2,2878,92,243370,84.53282389718652,9
0.2,2879,90,243460,84.53472222222223,12
0.2,2880,87,243547,84.53557792433183,14
0.2,2881,92,243639,84.5381679389313,10
0.2,2882,94,243733,84.54144987859868,7
0.2,2883,95,243828,84.54507628294036,7
0.2,2884,93,243921,84.54800693240901,9
0.2,2885,92,244013,84.55058905058905,10
0.2,2886,89,244102,84.55213023900242,12
0.2,2887,89,244191,84.5536703601108,12
0.2,2888,94,244285,84.55694011768779,7
0.2,2889,94,244379,84.56020761245675,7
0.2,2890,94,244473,84.56347284676582,7
0.2,2891,92,244565,84.56604426002767,9
0.2,2892,96,244661,84.56999654338057,6
0.2,2893,90,244751,84.57187284035936,11
0.2,2894,96,244847,84.57582037996546,6
0.2,2895,89,244936,84.57734806629834,14
0.2,2896,93,245029,84.58025543665862,8
0.2,2897,87,245116,84.58109040717737,14
0.2,2898,27,245143,84.5612280096585,6
0.2,2899,17,245160,84.53793103448275,15
0.2,2900,95,245255,84.54153740089625,8
0.2,2901,95,245350,84.54514128187456,7
0.2,2902,88,245438,84.54633138132967,13
0.2,2903,85,245523,84.54648760330579,17
0.2,2904,92,245615,84.54905335628227,9
0.2,2905,91,245706,84.55127322780454,10
0.2,2906,91,245797,84.55349157206743,10
0.2,2907,89,245886,84.55502063273728,12
0.2,2908,93,245979,84.55792368511516,8
0.2,2909,92,246071,84.56048109965636,9
0.2,2910,91,246162,84.56269323256613,11
0.2,2911,92,246254,84.56524725274726,10
0.2,2912,90,246344,84.5671129419842,12
0.2,2913,93,246437,84.57000686341799,8
0.2,2914,96,246533,84.57392795883362,6
0.2,2915,94,246627,84.57716049382717,7
0.2,2916,92,246719,84.57970517655126,9
0.2,2917,93,246812,84.58259081562714,10
0.2,2918,84,246896,84.58239122987324,17
0.2,2919,93,246989,84.58527397260274,8
0.2,2920,93,247082,84.58815474152688,8
0.2,2921,91,247173,84.59034907597535,10
0.2,2922,87,247260,84.59117345193295,14
0.2,2923,94,247354,84.59439124487004,7
0.2,2924,-46,247308,84.54974358974358,9
0.2,2925,93,247401,84.55263157894737,8
0.2,2926,91,247492,84.55483430133242,10
0.2,2927,88,247580,84.55601092896175,15
0.2,2928,92,247672,84.55855240696484,9
0.2,2929,92,247764,84.56109215017065,9
0.2,2930,95,247859,84.56465370180825,6
0.2,2931,95,247954,84.56821282401091,6
0.2,2932,88,248042,84.56938288441869,13
0.2,2933,96,248138,84.57327880027266,6
0.2,2934,91,248229,84.57546848381601,10
0.2,2935,93,248322,84.5783378746594,8
0.2,2936,91,248413,84.58052434456928,10
0.2,2937,92,248505,84.58304969366917,9
0.2,2938,93,248598,84.58591357604628,8
0.2,2939,92,248690,84.58843537414965,10
0.2,2940,84,248774,84.58823529411765,18
0.2,2941,90,248864,84.59007477906187,11
0.2,2942,88,248952,84.59123343527013,13
0.2,2943,93,249045,84.59408967391305,11
0.2,2944,94,249139,84.59728353140916,7
0.2,2945,94,249233,84.60047522063816,7
0.2,2946,19,249252,84.57821513403461,14
0.2,2947,-51,249201,84.53222523744911,18
0.2,2948,95,249296,84.53577483892845,6
0.2,2949,96,249392,84.53966101694915,6
0.2,2950,93,249485,84.54252795662487,9
0.2,2951,94,249579,84.54573170731707,8
0.2,2952,90,249669,84.54757873349136,11
0.2,2953,96,249765,84.55145565335138,6
0.2,2954,93,249858,84.55431472081219,8
0.2,2955,92,249950,84.55683355886333,10
0.2,2956,92,250042,84.5593506932702,10
0.2,2957,91,250133,84.56152805949966,10
0.2,2958,94,250227,84.56471781007097,7
0.2,2959,84,250311,84.56452702702703,18
0.2,2960,93,250404,84.56737588652483,8
0.2,2961,93,250497,84.57022282241729,8
0.2,2962,89,250586,84.57171785352683,13
0.2,2963,95,250681,84.57523616734143,7
0.2,2964,88,250769,84.57639123102867,15
0.2,2965,90,250859,84.5782198246797,11
0.2,2966,92,250951,84.58072126727335,9
0.2,2967,90,251041,84.58254716981132,11
0.2,2968,88,251129,84.58369821488716,13
0.2,2969,91,251220,84.58585858585859,10
0.2,2970,86,251306,84.5863345674857,19
0.2,2971,-46,251260,84.54239569313593,10
0.2,2972,92,251352,84.54490413723512,9
0.2,2973,89,251441,84.54640215198386,13
0.2,2974,90,251531,84.54823529411765,11
0.2,2975,94,251625,84.55141129032258,7
0.2,2976,95,251720,84.55492106147128,8
0.2,2977,93,251813,84.55775688381465,8
0.2,2978,93,251906,84.56059080228265,8
0.2,2979,89,251995,84.56208053691275,12
0.2,2980,93,252088,84.56491110365648,8
0.2,2981,22,252110,84.5439302481556,10
0.2,2982,89,252199,84.54542406972845,12
0.2,2983,15,252214,84.52211796246648,19
0.2,2984,26,252240,84.50251256281408,6
0.2,2985,88,252328,84.50368385800402,13
0.2,2986,22,252350,84.48275862068965,12
0.2,2987,96,252446,84.48661311914324,6
0.2,2988,96,252542,84.49046503847441,6
0.2,2989,89,252631,84.49197324414716,13
0.2,2990,88,252719,84.4931461049816,13
0.2,2991,92,252811,84.49565508021391,9
0.2,2992,94,252905,84.4988306047444,8
0.2,2993,93,252998,84.50167000668003,8
0.2,2994,94,253092,84.50484140233723,7
0.2,2995,25,253117,84.48497997329773,10
0.2,2996,91,253208,84.48715382048715,10
0.2,2997,94,253302,84.49032688458972,7
0.2,2998,90,253392,84.49216405468489,12
0.2,2999,94,253486,84.49533333333333,7
0.2,3000,94,253580,84.49850049983338,7
0.2,3001,88,253668,84.49966688874083,13
0.2,3002,95,253763,84.5031635031635,6
0.2,3003,23,253786,84.48268974700399,10
0.2,3004,94,253880,84.48585690515807,9
0.2,3005,88,253968,84.48702594810379,14
0.2,3006,95,254063,84.49052211506485,6
0.2,3007,93,254156,84.49335106382979,9
0.2,3008,94,254250,84.49651046859422,7
0.2,3009,89,254339,84.49800664451827,13
0.2,3010,88,254427,84.49916971105945,13
0.2,3011,93,254520,84.5019920318725,8
0.2,3012,-46,254474,84.45867905741785,9
0.2,3013,92,254566,84.46118115461181,9
0.2,3014,89,254655,84.46268656716418,12
0.2,3015,90,254745,84.4645225464191,12
0.2,3016,94,254839,84.46768312893603,7
0.2,3017,94,254933,84.47084161696488,8
0.2,3018,90,255023,84.47267307055316,11
0.2,3019,26,255049,84.45331125827815,8
0.2,3020,91,255140,84.4554783184376,10
0.2,3021,93,255233,84.4583057577763,8
0.2,3022,23,255256,84.43797552100563,10
0.2,3023,25,255281,84.4183201058201,9
0.2,3024,96,255377,84.42214876033057,6
0.2,3025,87,255464,84.42300066093853,14
0.2,3026,88,255552,84.42418235877106,13
0.2,3027,94,255646,84.42734478203434,7
0.2,3028,92,255738,84.42984483327831,9
0.2,3029,76,255814,84.42706270627063,25
0.2,3030,93,255907,84.42989112504124,8
0.2,3031,87,255994,84.43073878627969,14
0.2,3032,90,256084,84.43257500824267,11
0.2,3033,95,256179,84.43605800922874,6
0.2,3034,92,256271,84.43855024711696,9
0.2,3035,91,256362,84.4407114624506,10
0.2,3036,95,256457,84.44418834376029,8
0.2,3037,93,256550,84.44700460829493,8
0.2,3038,91,256641,84.44916090819349,10
0.2,3039,87,256728,84.45,14
0.2,3040,25,256753,84.43045050970076,8
0.2,3041,94,256847,84.4335963182117,8
0.2,3042,89,256936,84.43509694380546,12
0.2,3043,92,257028,84.43758212877792,9
0.2,3044,91,257119,84.43973727422004,10
0.2,3045,95,257214,84.44320420223244,6
0.2,3046,96,257310,84.44699704627503,6
0.2,3047,-58,257252,84.4002624671916,21
0.2,3048,92,257344,84.40275500163987,9
0.2,3049,95,257439,84.40622950819672,9
0.2,3050,94,257533,84.40937397574565,7
0.2,3051,90,257623,84.41120576671035,11
0.2,3052,93,257716,84.41401899770717,8
0.2,3053,27,257743,84.39521938441388,6
0.2,3054,94,257837,84.39836333878887,9
0.2,3055,90,257927,84.40019633507853,12
0.2,3056,93,258020,84.4030094864246,8
0.2,3057,90,258110,84.404839764552,11
0.2,3058,20,258130,84.38378555083361,13
0.2,3059,89,258219,84.38529411764706,13
0.2,3060,92,258311,84.38778177066318,10
0.2,3061,93,258404,84.39059438275636,8
0.2,3062,91,258495,84.39275220372184,10
0.2,3063,96,258591,84.39654046997389,6
0.2,3064,82,258673,84.39575856443719,19
0.2,3065,93,258766,84.39856490541422,9
0.2,3066,-57,258709,84.35246168894686,20
0.2,3067,90,258799,84.35430247718384,11
0.2,3068,96,258895,84.35809710003258,6
0.2,3069,-48,258847,84.31498371335505,14
0.2,3070,94,258941,84.31813741452295,8
0.2,3071,91,259032,84.3203125,10
0.2,3072,93,259125,84.32313699967459,8
0.2,3073,93,259218,84.3259596616786,8
0.2,3074,94,259312,84.32910569105691,7
0.2,3075,94,259406,84.33224967490247,7
0.2,3076,94,259500,84.33539161520962,7
0.2,3077,95,259595,84.33885640025991,6
0.2,3078,91,259686,84.34101981162715,13
0.2,3079,91,259777,84.34318181818182,10
0.2,3080,94,259871,84.34631613112626,7
0.2,3081,93,259964,84.34912394548994,8
0.2,3082,92,260056,84.3516055789815,9
0.2,3083,94,260150,84.35473411154345,8
0.2,3084,93,260243,84.35753646677472,8
0.2,3085,95,260338,84.36098509397279,6
0.2,3086,90,260428,84.36281179138322,12
0.2,3087,94,260522,84.36593264248705,7
0.2,3088,95,260617,84.36937520233086,7
0.2,3089,92,260709,84.37184466019417,9
0.2,3090,93,260802,84.37463604011647,9
0.2,3091,96,260898,84.3783958602846,6
0.2,3092,88,260986,84.37956676365988,13
0.2,3093,94,261080,84.38267614738203,7
0.2,3094,92,261172,84.38513731825525,9
0.2,3095,94,261266,84.38824289405684,7
0.2,3096,91,261357,84.39037778495317,10
0.2,3097,95,261452,84.3938024531956,7
0.2,3098,95,261547,84.3972249112617,7
0.2,3099,93,261640,84.4,8
0.2,3100,88,261728,84.4011609158336,13
0.2,3101,94,261822,84.40425531914893,8
0.2,3102,95,261917,84.40766999677732,6
0.2,3103,92,262009,84.41011597938144,10
0.2,3104,92,262101,84.41256038647343,10
0.2,3105,91,262192,84.4146812620734,12
0.2,3106,94,262286,84.41776633408432,7
0.2,3107,93,262379,84.42052767052768,8
0.2,3108,94,262473,84.42360887745255,8
0.2,3109,86,262559,84.42411575562701,15
0.2,3110,91,262650,84.42622950819673,12
0.2,3111,92,262742,84.42866323907455,10
0.2,3112,94,262836,84.43173787343399,7
0.2,3113,82,262918,84.43095696852922,19
0.2,3114,93,263011,84.43370786516854,9
0.2,3115,92,263103,84.43613607188703,9
0.2,3116,84,263187,84.43599615014438,17
0.2,3117,92,263279,84.43842206542655,9
0.2,3118,26,263305,84.41968579672972,6
0.2,3119,84,263389,84.41955128205129,18
0.2,3120,94,263483,84.42262095482218,7
0.2,3121,89,263572,84.4240871236387,13
0.2,3122,95,263667,84.42747358309317,6
0.2,3123,91,263758,84.42957746478874,10
0.2,3124,92,263850,84.432,9
0.2,3125,94,263944,84.43506078055023,7
0.2,3126,93,264037,84.4377998081228,8
0.2,3127,27,264064,84.41943734015345,6
0.2,3128,91,264155,84.42154042825183,10
0.2,3129,95,264250,84.42492012779553,6
0.2,3130,92,264342,84.42733950814436,9
0.2,3131,92,264434,84.42975734355045,9
0.2,3132,91,264525,84.43185445260134,10
0.2,3133,88,264613,84.43299298021698,13
0.2,3134,23,264636,84.4133971291866,10
0.2,3135,87,264723,84.41422193877551,14
0.2,3136,96,264819,84.41791520561046,6
0.2,3137,96,264915,84.42160611854685,6
0.2,3138,95,265010,84.42497610704046,6
0.2,3139,25,265035,84.40605095541402,8
0.2,3140,94,265129,84.40910538045209,7
0.2,3141,87,265216,84.40992998090388,16
0.2,3142,90,265306,84.41170855870187,11
0.2,3143,96,265402,84.41539440203562,6
0.2,3144,94,265496,84.41844197138315,7
0.2,3145,89,265585,84.41989828353465,12
0.2,3146,88,265673,84.42103590721322,13
0.2,3147,93,265766,84.42376111817026,8
0.2,3148,92,265858,84.42616703715466,9
0.2,3149,14,265872,84.40380952380953,19
0.2,3150,96,265968,84.40748968581403,6
0.2,3151,21,265989,84.3873730964467,11
0.2,3152,94,266083,84.39042182048843,8
0.2,3153,87,266170,84.39124920735574,14
0.2,3154,21,266191,84.37115689381933,13
0.2,3155,89,266280,84.37262357414448,12
0.2,3156,94,266374,84.37567310738042,7
0.2,3157,91,266465,84.37777074097531,10
0.2,3158,91,266556,84.37986704653372,10
0.2,3159,21,266577,84.35981012658227,12
0.2,3160,96,266673,84.36349256564378,6
0.2,3161,89,266762,84.36495888678051,12
0.2,3162,90,266852,84.36674043629466,12
0.2,3163,91,266943,84.3688369152971,10
0.2,3164,92,267035,84.37124802527646,10
0.2,3165,92,267127,84.37365761212887,9
0.2,3166,93,267220,84.37638143353331,8
0.2,3167,92,267312,84.37878787878788,9
0.2,3168,90,267402,84.3805616913853,11
0.2,3169,88,267490,84.38170347003154,16
0.2,3170,27,267517,84.36360769473352,6
0.2,3171,92,267609,84.36601513240858,9
0.2,3172,96,267705,84.36968168925307,6
0.2,3173,24,267729,84.35066162570888,8
0.2,3174,93,267822,84.35338582677166,8
0.2,3175,92,267914,84.3557934508816,9
0.2,3176,91,268005,84.35788479697828,10
0.2,3177,94,268099,84.36091881686595,8
0.2,3178,90,268189,84.36269267065114,12
0.2,3179,96,268285,84.36635220125787,6
0.2,3180,91,268376,84.36843759823955,12
0.2,3181,95,268471,84.37177875549969,6
0.2,3182,91,268562,84.37386113729187,10
0.2,3183,96,268658,84.37751256281408,6
0.2,3184,94,268752,84.38053375196232,8
0.2,3185,92,268844,84.38292529817953,9
0.2,3186,93,268937,84.38562911829307,9
0.2,3187,95,269032,84.38895859473024,6
0.2,3188,92,269124,84.39134524929445,9
0.2,3189,94,269218,84.39435736677116,7
0.2,3190,94,269312,84.39736759636477,7
0.2,3191,94,269406,84.40037593984962,9
0.2,3192,90,269496,84.40212965862825,11
0.2,3193,92,269588,84.40450845335003,9
0.2,3194,92,269680,84.40688575899844,9
0.2,3195,92,269772,84.40926157697122,9
0.2,3196,92,269864,84.41163590866438,10
0.2,3197,93,269957,84.41432145090681,8
0.2,3198,94,270051,84.41731791184745,7
0.2,3199,88,270139,84.4184375,13
0.2,3200,93,270232,84.42111840049985,9
0.2,3201,94,270326,84.42410993129295,7
0.2,3202,95,270421,84.42741180143615,6
0.2,3203,94,270515,84.43039950062422,8
0.2,3204,96,270611,84.43400936037442,6
0.2,3205,93,270704,84.43668122270742,8
0.2,3206,95,270799,84.43997505456814,6
0.2,3207,92,270891,84.44233167082294,9
0.2,3208,89,270980,84.44375194764724,12
0.2,3209,93,271073,84.44641744548287,9
0.2,3210,92,271165,84.44876985362815,9
0.2,3211,96,271261,84.45236612702367,6
0.2,3212,91,271352,84.45440398381575,10
0.2,3213,89,271441,84.45581829495956,12
0.2,3214,92,271533,84.45816485225505,9
0.2,3215,92,271625,84.46050995024876,10
0.2,3216,87,271712,84.4612993472179,15
0.2,3217,95,271807,84.46457426973275,8
0.2,3218,94,271901,84.46753650201926,8
0.2,3219,94,271995,84.47049689440993,7
0.2,3220,89,272084,84.47190313567215,12
0.2,3221,95,272179,84.47517070142769,6
0.2,3222,95,272274,84.47843623952839,6
0.2,3223,93,272367,84.4810794044665,8
0.2,3224,92,272459,84.48341085271318,9
0.2,3225,91,272550,84.48543087414755,10
0.2,3226,94,272644,84.48837929965913,7
0.2,3227,86,272730,84.48884758364312,15
0.2,3228,94,272824,84.49179312480643,8
0.2,3229,96,272920,84.49535603715171,7
0.2,3230,85,273005,84.49551222531724,17
0.2,3231,89,273094,84.49690594059406,12
0.2,3232,95,273189,84.50015465511909,6
0.2,3233,96,273285,84.50371057513915,6
0.2,3234,93,273378,84.50633693972179,8
0.2,3235,86,273464,84.50679851668727,15
0.2,3236,92,273556,84.50911337658326,9
0.2,3237,92,273648,84.51142680667078,9
0.2,3238,90,273738,84.51312133374498,11
0.2,3239,96,273834,84.51666666666667,6
0.2,3240,96,273930,84.52020981178649,6
0.2,3241,93,274023,84.52282541640962,8
0.2,3242,96,274119,84.5263644773358,7
0.2,3243,93,274212,84.52897657213317,8
0.2,3244,91,274303,84.53097072419106,11
0.2,3245,-46,274257,84.49075785582255,10
0.2,3246,92,274349,84.49307052663997,9
0.2,3247,84,274433,84.49291871921183,17
0.2,3248,95,274528,84.49615266235764,6
0.2,3249,94,274622,84.49907692307693,8
0.2,3250,90,274712,84.50076899415565,11
0.2,3251,93,274805,84.50338253382535,8
0.2,3252,89,274894,84.50476483246234,15
0.2,3253,92,274986,84.50706822372464,10
0.2,3254,95,275081,84.51029185867895,6
0.2,3255,94,275175,84.51320638820638,7
0.2,3256,90,275265,84.51489100399141,11
0.2,3257,89,275354,84.51626764886433,12
0.2,3258,95,275449,84.51948450444922,6
0.2,3259,94,275543,84.5223926380368,8
0.2,3260,95,275638,84.52560564244096,6
0.2,3261,93,275731,84.52820355610055,8
0.2,3262,93,275824,84.53079987741343,8
0.2,3263,94,275918,84.53370098039215,7
0.2,3264,84,276002,84.53353751914241,17
0.2,3265,91,276093,84.53551745254134,10
0.2,3266,95,276188,84.53872053872054,6
0.2,3267,18,276206,84.51835985312117,15
0.2,3268,94,276300,84.52126032425818,7
0.2,3269,94,276394,84.52415902140673,7
0.2,3270,91,276485,84.52613879547539,10
0.2,3271,92,276577,84.52842298288509,9
0.2,3272,94,276671,84.53131683470822,7
0.2,3273,83,276754,84.53084911423335,18
0.2,3274,93,276847,84.53343511450382,8
0.2,3275,95,276942,84.53663003663004,6
0.2,3276,96,277038,84.54012816600549,6
0.2,3277,92,277130,84.54240390482,9
0.2,3278,90,277220,84.54406831351022,11
0.2,3279,92,277312,84.54634146341463,11
0.2,3280,91,277403,84.548308442548,10
0.2,3281,24,277427,84.52985984156003,9
0.2,3282,92,277519,84.53213524215657,9
0.2,3283,93,277612,84.5347137637028,10
0.2,3284,92,277704,84.53698630136986,11
0.2,3285,92,277796,84.5392574558734,9
0.2,3286,91,277887,84.54122299969578,10
0.2,3287,25,277912,84.52311435523114,8
0.2,3288,92,278004,84.52538765582244,9
0.2,3289,95,278099,84.52857142857142,8
0.2,3290,96,278195,84.53205712549376,6
0.2,3291,90,278285,84.53371810449575,12
0.2,3292,88,278373,84.53477072578197,13
0.2,3293,92,278465,84.53703703703704,9
0.2,3294,86,278551,84.53748103186646,15
0.2,3295,86,278637,84.53792475728156,17
0.2,3296,94,278731,84.54079466181378,7
0.2,3297,-48,278683,84.50060642813827,12
0.2,3298,94,278777,84.50348590481964,7
0.2,3299,93,278870,84.5060606060606,8
0.2,3300,93,278963,84.5086337473493,9
0.2,3301,94,279057,84.5115081768625,7
0.2,3302,95,279152,84.51468362095065,7
0.2,3303,21,279173,84.49546004842615,12
0.2,3304,94,279267,84.4983358547655,7
0.2,3305,96,279363,84.50181488203266,6
0.2,3306,91,279454,84.50377986090112,10
0.2,3307,95,279549,84.50695284159613,6
0.2,3308,92,279641,84.50921728618918,10
0.2,3309,25,279666,84.49123867069487,8
0.2,3310,94,279760,84.49411054062217,8
0.2,3311,90,279850,84.4957729468599,12
0.2,3312,95,279945,84.4989435556897,9
0.2,3313,93,280038,84.50150875075437,8
0.2,3314,87,280125,84.50226244343891,14
0.2,3315,91,280216,84.50422195416164,10
0.2,3316,-57,280159,84.46156165209527,21
0.2,3317,96,280255,84.46503918022906,7
0.2,3318,95,280350,84.46821331726423,7
0.2,3319,92,280442,84.47048192771085,9
0.2,3320,89,280531,84.4718458295694,13
0.2,3321,93,280624,84.47441300421433,8
0.2,3322,89,280713,84.4757749021968,12
0.2,3323,27,280740,84.45848375451264,6
0.2,3324,93,280833,84.46105263157895,8
0.2,3325,89,280922,84.46241731809982,12
0.2,3326,90,281012,84.46408175533513,11
0.2,3327,17,281029,84.44381009615384,17
0.2,3328,92,281121,84.44607990387503,9
0.2,3329,91,281212,84.44804804804805,12
0.2,3330,90,281302,84.44971480036025,12
0.2,3331,96,281398,84.453181272509,6
0.2,3332,91,281489,84.45514551455146,10
0.2,3333,93,281582,84.45770845830833,8
0.2,3334,92,281674,84.4599700149925,9
0.2,3335,88,281762,84.46103117505996,13
0.2,3336,89,281851,84.46239136949356,12
0.2,3337,83,281934,84.4619532654284,18
0.2,3338,93,282027,84.46451033243486,8
0.2,3339,93,282120,84.46706586826348,9
0.2,3340,94,282214,84.4699191858725,7
0.2,3341,95,282309,84.47307001795332,6
0.2,3342,93,282402,84.4756206999701,8
0.2,3343,94,282496,84.47846889952153,8
0.2,3344,92,282588,84.48071748878924,9
0.2,3345,93,282681,84.48326359832636,9
0.2,3346,93,282774,84.48580818643562,8
0.2,3347,25,282799,84.46804062126643,9
0.2,3348,94,282893,84.47088683189011,9
0.2,3349,94,282987,84.47373134328359,7
0.2,3350,95,283082,84.47687257535064,6
0.2,3351,96,283178,84.48031026252983,6
0.2,3352,80,283258,84.47897405308679,22
0.2,3353,92,283350,84.48121645796064,9
0.2,3354,93,283443,84.48375558867362,9
0.2,3355,95,283538,84.48688915375448,6
0.2,3356,96,283634,84.49031873696752,6
0.2,3357,91,283725,84.49225729600953,10
0.2,3358,87,283812,84.49300387019946,14
0.2,3359,92,283904,84.4952380952381,9
0.2,3360,90,283994,84.4968759297828,12
0.2,3361,90,284084,84.49851279000595,11
0.2,3362,91,284175,84.50044603033007,11
0.2,3363,25,284200,84.48275862068965,8
0.2,3364,-45,284155,84.44427934621099,9
0.2,3365,25,284180,84.42661913250149,9
0.2,3366,94,284274,84.42946242946243,7
0.2,3367,93,284367,84.43200712589073,8
0.2,3368,95,284462,84.43514395963194,6
0.2,3369,94,284556,84.43798219584569,7
0.2,3370,93,284649,84.44052210026699,8
0.2,3371,91,284740,84.44246737841044,10
0.2,3372,93,284833,84.44500444707975,8
0.2,3373,91,284924,84.44694724362775,10
0.2,3374,89,285013,84.44829629629629,12
0.2,3375,96,285109,84.45171800947867,6
0.2,3376,91,285200,84.45365709209358,10
0.2,3377,90,285290,84.45529899348728,11
0.2,3378,95,285385,84.45841965078425,8
0.2,3379,95,285480,84.46153846153847,6
0.2,3380,92,285572,84.46376811594203,9
0.2,3381,94,285666,84.46658781785925,7
0.2,3382,94,285760,84.46940585279337,7
0.2,3383,90,285850,84.47104018912529,11
0.2,3384,90,285940,84.47267355982275,11
0.2,3385,94,286034,84.47548730064973,7
0.2,3386,92,286126,84.47770888692058,9
0.2,3387,96,286222,84.48110979929162,6
0.2,3388,93,286315,84.4836234877545,8
0.2,3389,96,286411,84.48702064896756,6
0.2,3390,92,286503,84.48923621350635,9
0.2,3391,94,286597,84.49204009433963,7
0.2,3392,94,286691,84.49484232242852,7
0.2,3393,92,286783,84.49705362404242,9
0.2,3394,92,286875,84.49926362297496,9
0.2,3395,87,286962,84.5,14
0.2,3396,94,287056,84.50279658522226,8
0.2,3397,88,287144,84.50382577987051,13
0.2,3398,95,287239,84.50691379817593,7
0.2,3399,91,287330,84.50882352941177,10
0.2,3400,95,287425,84.5119082622758,7
0.2,3401,-61,287364,84.46913580246914,24
0.2,3402,94,287458,84.47193652659418,8
0.2,3403,95,287553,84.47502937720328,6
0.2,3404,78,287631,84.47312775330397,23
0.2,3405,93,287724,84.47563123899002,9
0.2,3406,95,287819,84.47872028177282,9
0.2,3407,95,287914,84.48180751173709,8
0.2,3408,89,288003,84.48313288354356,13
0.2,3409,91,288094,84.4850439882698,10
0.2,3410,93,288187,84.48754031075931,8
0.2,3411,27,288214,84.4706916764361,6
0.2,3412,92,288306,84.4728977439203,9
0.2,3413,94,288400,84.47568834212068,8
0.2,3414,93,288493,84.47818448023426,8
0.2,3415,94,288587,84.48097189695551,7
0.2,3416,94,288681,84.48375768217736,7
0.2,3417,93,288774,84.48624926857812,8
0.2,3418,94,288868,84.48903188066686,7
0.2,3419,93,288961,84.49152046783625,8
0.2,3420,92,289053,84.4937152879275,11
0.2,3421,90,289143,84.49532437171244,11
0.2,3422,94,289237,84.49810108092316,8
0.2,3423,84,289321,84.49795560747664,17
0.2,3424,-47,289274,84.45956204379561,11
0.2,3425,92,289366,84.46176298890835,9
0.2,3426,95,289461,84.46483805077327,6
0.2,3427,94,289555,84.46761960326721,7
0.2,3428,87,289642,84.46835812190143,14
0.2,3429,88,289730,84.46938775510205,13
0.2,3430,94,289824,84.4721655494025,8
0.2,3431,92,289916,84.47435897435898,10
0.2,3432,94,290010,84.47713370230119,7
0.2,3433,83,290093,84.47670355270822,18
0.2,3434,96,290189,84.48005822416303,6
0.2,3435,96,290285,84.48341094295692,6
0.2,3436,90,290375,84.48501600232761,11
0.2,3437,94,290469,84.48778359511344,7
0.2,3438,90,290559,84.48938644954929,11
0.2,3439,83,290642,84.48895348837209,18
0.2,3440,92,290734,84.49113629758791,9
0.2,3441,24,290758,84.47356188262638,8
0.2,3442,90,290848,84.47516700551844,11
0.2,3443,88,290936,84.47619047619048,13
0.2,3444,95,291031,84.47924528301887,6
0.2,3445,93,291124,84.48171793383634,8
0.2,3446,27,291151,84.46504206556426,6
0.2,3447,94,291245,84.46780742459397,8
0.2,3448,93,291338,84.4702812409394,9
0.2,3449,96,291434,84.4736231884058,6
0.2,3450,93,291527,84.4760938858302,8
0.2,3451,94,291621,84.47885283893395,8
0.2,3452,91,291712,84.4807413843035,10
0.2,3453,89,291801,84.48204979733642,17
0.2,3454,93,291894,84.48451519536903,11
0.2,3455,92,291986,84.48668981481481,9
0.2,3456,93,292079,84.48915244431588,8
0.2,3457,92,292171,84.49132446500867,9
0.2,3458,92,292263,84.49349522983522,9
0.2,3459,96,292359,84.49682080924856,6
0.2,3460,94,292453,84.49956659924877,7
0.2,3461,27,292480,84.48295782784517,6
0.2,3462,90,292570,84.48455096736933,11
0.2,3463,81,292651,84.48354503464203,20
0.2,3464,95,292746,84.48658008658009,6
0.2,3465,96,292842,84.48990190421235,6
0.2,3466,90,292932,84.49149120276897,11
0.2,3467,92,293024,84.49365628604383,10
0.2,3468,94,293118,84.49639665609686,7
0.2,3469,91,293209,84.49827089337175,11
0.2,3470,90,293299,84.49985594929416,12
0.2,3471,13,293312,84.47926267281106,21
0.2,3472,91,293403,84.4811402245897,10
0.2,3473,89,293492,84.48244099021301,12
0.2,3474,90,293582,84.48402877697842,11
0.2,3475,94,293676,84.4867663981588,7
0.2,3476,89,293765,84.48806442335346,12
0.2,3477,92,293857,84.49022426682001,9
0.2,3478,89,293946,84.49152055188273,12
0.2,3479,93,294039,84.49396551724138,8
0.2,3480,95,294134,84.496983625395,6
0.2,3481,88,294222,84.4979896611143,13
0.2,3482,92,294314,84.50014355440712,9
0.2,3483,94,294408,84.5028702640643,8
0.2,3484,94,294502,84.50559540889526,7
0.2,3485,92,294594,84.50774526678141,10
0.2,3486,25,294619,84.49067966733583,8
0.2,3487,95,294714,84.49369266055047,6
0.2,3488,93,294807,84.49613069647464,8
0.2,3489,95,294902,84.49914040114614,6
0.2,3490,92,294994,84.50128902893154,9
0.2,3491,96,295090,84.50458190148912,6
0.2,3492,95,295185,84.50758660177497,6
0.2,3493,94,295279,84.5103033772181,8
0.2,3494,93,295372,84.51273247496424,8
0.2,3495,92,295464,84.51487414187643,10
0.2,3496,92,295556,84.51701458392908,10
0.2,3497,93,295649,84.51943967981704,8
0.2,3498,92,295741,84.52157759359817,9
0.2,3499,94,295835,84.52428571428571,7
0.2,3500,91,295926,84.52613538988861,11
0.2,3501,88,296014,84.5271273557967,13
0.2,3502,95,296109,84.53011704253497,6
0.2,3503,92,296201,84.53224885844749,11
0.2,3504,82,296283,84.53152639087018,19
0.2,3505,89,296372,84.53280091272104,12
0.2,3506,94,296466,84.535500427716,7
0.2,3507,89,296555,84.53677309007982,12
0.2,3508,95,296650,84.53975491593046,7
0.2,3509,93,296743,84.54216524216524,8
0.2,3510,91,296834,84.54400455710623,10
0.2,3511,93,296927,84.54641230068337,8
0.2,3512,92,297019,84.5485340165101,9
0.2,3513,93,297112,84.5509391007399,8
0.2,3514,96,297208,84.55419630156472,6
0.2,3515,93,297301,84.556598407281,8
0.2,3516,96,297397,84.55985214671595,6
0.2,3517,96,297493,84.5631040363843,6
0.2,3518,94,297587,84.56578573458368,7
0.2,3519,86,297673,84.56619318181818,16
0.2,3520,93,297766,84.56858846918489,10
0.2,3521,95,297861,84.57155025553662,6
0.2,3522,87,297948,84.57223956854953,14
0.2,3523,93,298041,84.57463110102157,8
0.2,3524,94,298135,84.57730496453901,8
0.2,3525,95,298230,84.58026091888826,7
0.2,3526,27,298257,84.56393535582649,6
0.2,3527,94,298351,84.56660997732426,8
0.2,3528,91,298442,84.56843298384811,10
0.2,3529,94,298536,84.57110481586402,7
0.2,3530,95,298631,84.57405834041349,6
0.2,3531,94,298725,84.57672706681767,7
0.2,3532,94,298819,84.57939428247948,10
0.2,3533,94,298913,84.58205998868138,8
0.2,3534,91,299004,84.58387553041018,10
0.2,3535,91,299095,84.58569004524887,10
0.2,3536,92,299187,84.58778625954199,9
0.2,3537,94,299281,84.5904465799887,7
0.2,3538,94,299375,84.5931053970048,7
0.2,3539,94,299469,84.59576271186441,7
0.2,3540,93,299562,84.59813611974019,8
0.2,3541,93,299655,84.60050818746471,8
0.2,3542,91,299746,84.60231442280553,10
0.2,3543,93,299839,84.60468397291196,8
0.2,3544,93,299932,84.60705218617771,9
0.2,3545,95,300027,84.60998307952623,6
0.2,3546,92,300119,84.61206653510008,9
0.2,3547,94,300213,84.61471251409245,7
0.2,3548,94,300307,84.61735700197238,8
0.2,3549,89,300396,84.61859154929577,14
0.2,3550,93,300489,84.62095184455083,9
0.2,3551,95,300584,84.62387387387388,6
0.2,3552,92,300676,84.6259499014917,10
0.2,3553,91,300767,84.62774338773214,10
0.2,3554,93,300860,84.63009845288326,8
0.2,3555,88,300948,84.6310461192351,13
0.2,3556,91,301039,84.63283666010683,10
0.2,3557,86,301125,84.63322091062395,15
0.2,3558,93,301218,84.6355717898286,8
0.2,3559,95,301313,84.63848314606741,6
0.2,3560,23,301336,84.62117382757653,12
0.2,3561,93,301429,84.62352610892756,8
0.2,3562,25,301454,84.60679202918888,8
0.2,3563,94,301548,84.60942760942761,8
0.2,3564,94,301642,84.61206171107995,7
0.2,3565,94,301736,84.6146943353898,7
0.2,3566,94,301830,84.61732548359966,7
0.2,3567,95,301925,84.62023542600897,7
0.2,3568,93,302018,84.62258335668254,8
0.2,3569,93,302111,84.62492997198879,8
0.2,3570,95,302206,84.62783534024084,7
0.2,3571,90,302296,84.62933930571108,13
0.2,3572,92,302388,84.63140218303947,9
0.2,3573,93,302481,84.63374370453273,8
0.2,3574,93,302574,84.63608391608392,8
0.2,3575,21,302595,84.61828859060402,12
0.2,3576,91,302686,84.62007268660889,11
0.2,3577,92,302778,84.62213527110117,9
0.2,3578,92,302870,84.62419670298966,9
0.2,3579,94,302964,84.6268156424581,7
0.2,3580,94,303058,84.62943311924043,9
0.2,3581,95,303153,84.6323283082077,6
0.2,3582,93,303246,84.63466368964555,8
0.2,3583,86,303332,84.63504464285714,16
0.2,3584,95,303427,84.63793584379358,6
0.2,3585,92,303519,84.63998884551032,9
0.2,3586,95,303614,84.64287705603569,6
0.2,3587,89,303703,84.64409141583054,12
0.2,3588,91,303794,84.64586235720256,10
0.2,3589,94,303888,84.64846796657382,8
0.2,3590,95,303983,84.65135059871902,6
0.2,3591,87,304070,84.65200445434299,15
0.2,3592,92,304162,84.65404954077373,10
0.2,3593,87,304249,84.65470228158041,14
0.2,3594,94,304343,84.65730180806676,7
0.2,3595,94,304437,84.6598998887653,7
0.2,3596,92,304529,84.6619405059772,9
0.2,3597,93,304622,84.66425792106726,11
0.2,3598,94,304716,84.66685190330648,7
0.2,3599,93,304809,84.66916666666667,8
0.2,3600,93,304902,84.67148014440433,8
0.2,3601,94,304996,84.6740699611327,7
0.2,3602,25,305021,84.65750763252845,7
0.2,3603,91,305112,84.65926748057714,10
0.2,3604,86,305198,84.65963938973648,16
0.2,3605,96,305294,84.66278424847476,6
0.2,3606,89,305383,84.66398669254228,12
0.2,3607,92,305475,84.66601995565411,9
0.2,3608,92,305567,84.66805209199224,9
0.2,3609,90,305657,84.66952908587258,11
0.2,3610,92,305749,84.67155912489615,9
0.2,3611,94,305843,84.67414174972315,7
0.2,3612,81,305924,84.67312482701357,22
0.2,3613,95,306019,84.67598229109021,7
0.2,3614,93,306112,84.67828492392808,9
0.2,3615,92,306204,84.68030973451327,9
0.2,3616,93,306297,84.68260989770528,8
0.2,3617,94,306391,84.68518518518519,8
0.2,3618,93,306484,84.68748273003592,8
0.2,3619,92,306576,84.68950276243093,10
0.2,3620,92,306668,84.69152167909418,9
0.2,3621,24,306692,84.67476532302595,10
0.2,3622,90,306782,84.67623516422854,11
0.2,3623,27,306809,84.66032008830022,6
0.2,3624,90,306899,84.66179310344828,11
0.2,3625,92,306991,84.6638168781026,9
0.2,3626,94,307085,84.66639095671354,7
0.2,3627,92,307177,84.66841234840132,9
0.2,3628,90,307267,84.66988151005786,11
0.2,3629,96,307363,84.67300275482094,6
0.2,3630,91,307454,84.67474524924263,10
0.2,3631,96,307550,84.67786343612335,6
0.2,3632,92,307642,84.67987888797137,9
0.2,3633,88,307730,84.68079251513484,13
0.2,3634,89,307819,84.68198074277853,12
0.2,3635,94,307913,84.68454345434543,8
0.2,3636,88,308001,84.68545504536706,13
0.2,3637,95,308096,84.68829026937878,6
0.2,3638,90,308186,84.6897499312998,11
0.2,3639,91,308277,84.69148351648352,10
0.2,3640,94,308371,84.69404009887394,7
0.2,3641,25,308396,84.67764964305327,7
0.2,3642,91,308487,84.67938512215207,11
0.2,3643,95,308582,84.68221734357849,8
0.2,3644,93,308675,84.68449931412894,9
0.2,3645,95,308770,84.68732857926494,8
0.2,3646,94,308864,84.6898820948725,7
0.2,3647,94,308958,84.69243421052632,8
0.2,3648,84,309042,84.69224445053439,17
0.2,3649,86,309128,84.69260273972603,15
0.2,3650,93,309221,84.69487811558477,9
0.2,3651,92,309313,84.69687842278204,9
0.2,3652,93,309406,84.6991513824254,8
0.2,3653,93,309499,84.70142309797482,8
0.2,3654,94,309593,84.70396716826265,7
0.2,3655,85,309678,84.70404814004377,16
0.2,3656,91,309769,84.70576975663111,10
0.2,3657,18,309787,84.68753417167851,14
0.2,3658,90,309877,84.6889860617655,11
0.2,3659,95,309972,84.69180327868852,6
0.2,3660,93,310065,84.69407265774379,8
0.2,3661,88,310153,84.69497542326597,15
0.2,3662,93,310246,84.6972426972427,8
0.2,3663,96,310342,84.70032751091703,6
0.2,3664,24,310366,84.6837653478854,8
0.2,3665,-53,310313,84.64620840152755,17
0.2,3666,96,310409,84.64930460867194,6
0.2,3667,88,310497,84.65021810250818,13
0.2,3668,91,310588,84.65194875988007,10
0.2,3669,81,310669,84.65095367847411,20
0.2,3670,94,310763,84.65350040860801,7
0.2,3671,94,310857,84.65604575163398,7
0.2,3672,90,310947,84.65750068064253,13
0.2,3673,92,311039,84.65949918345127,9
0.2,3674,94,311133,84.66204081632652,7
0.2,3675,95,311228,84.66485310119695,6
0.2,3676,90,311318,84.66630405221647,11
0.2,3677,92,311410,84.66829798803698,9
0.2,3678,91,311501,84.67001902690949,10
0.2,3679,93,311594,84.67228260869565,8
0.2,3680,83,311677,84.67182830752513,20
0.2,3681,84,311761,84.67164584464965,17
0.2,3682,90,311851,84.67309258756448,11
0.2,3683,88,311939,84.67399565689468,13
0.2,3684,92,312031,84.67598371777476,10
0.2,3685,88,312119,84.67688551275094,13
0.2,3686,94,312213,84.67941415785191,7
0.2,3687,95,312308,84.6822125813449,6
0.2,3688,96,312404,84.68528056383843,6
0.2,3689,94,312498,84.68780487804878,7
0.2,3690,80,312578,84.68653481441343,21
0.2,3691,92,312670,84.68851570964247,9
0.2,3692,90,312760,84.68995396696452,12
0.2,3693,93,312853,84.6922035733622,8
0.2,3694,24,312877,84.67577807848444,10
0.2,3695,95,312972,84.67857142857143,6
0.2,3696,92,313064,84.68055179875574,9
0.2,3697,93,313157,84.68280151433207,8
0.2,3698,94,313251,84.6853203568532,8
0.2,3699,87,313338,84.68594594594595,14
0.2,3700,92,313430,84.68792218319373,10
0.2,3701,94,313524,84.6904376012966,8
0.2,3702,95,313619,84.69322171212531,6
0.2,3703,90,313709,84.69465442764579,11
0.2,3704,85,313794,84.69473684210526,16
0.2,3705,82,313876,84.69400971397734,19
0.2,3706,93,313969,84.6962503371999,8
0.2,3707,87,314056,84.69687162891046,15
0.2,3708,90,314146,84.6983014289566,12
0.2,3709,92,314238,84.70026954177898,10
0.2,3710,96,314334,84.70331447049313,6
0.2,3711,93,314427,84.70554956896552,8
0.2,3712,96,314523,84.7085914354969,6
0.2,3713,90,314613,84.71001615508885,11
0.2,3714,24,314637,84.69367429340511,8
0.2,3715,19,314656,84.67599569429494,13
0.2,3716,90,314746,84.67742803336024,11
0.2,3717,91,314837,84.67912856374394,10
0.2,3718,83,314920,84.67867706372681,18
0.2,3719,90,315010,84.68010752688173,11
0.2,3720,92,315102,84.68207471109916,10
0.2,3721,93,315195,84.68430951101558,9
0.2,3722,91,315286,84.686005909213,11
0.2,3723,89,315375,84.68716433941998,12
0.2,3724,94,315469,84.6896644295302,7
0.2,3725,95,315564,84.69243156199678,8
0.2,3726,91,315655,84.69412396028977,10
0.2,3727,84,315739,84.69393776824035,17
0.2,3728,90,315829,84.69536068651112,11
0.2,3729,94,315923,84.69785522788204,7
0.2,3730,95,316018,84.70061645671402,6
0.2,3731,93,316111,84.70284030010718,11
0.2,3732,16,316127,84.684436110367,18
0.2,3733,94,316221,84.6869309051955,7
0.2,3734,26,316247,84.67121820615796,7
0.2,3735,93,316340,84.67344753747324,8
0.2,3736,94,316434,84.67594327000268,7
0.2,3737,90,316524,84.67736757624398,11
0.2,3738,95,316619,84.68012837657128,6
0.2,3739,94,316713,84.68262032085562,7
0.2,3740,88,316801,84.68350708366746,13
0.2,3741,96,316897,84.6865312667023,6
0.2,3742,93,316990,84.68875233769704,9
0.2,3743,90,317080,84.69017094017094,11
0.2,3744,85,317165,84.69025367156209,16
0.2,3745,93,317258,84.69247197010144,10
0.2,3746,95,317353,84.69522284494262,6
0.2,3747,92,317445,84.69717182497332,10
0.2,3748,93,317538,84.69938650306749,9
0.2,3749,95,317633,84.70213333333334,6
0.2,3750,93,317726,84.70434550786457,8
0.2,3751,91,317817,84.70602345415779,10
0.2,3752,95,317912,84.7087663202771,6
0.2,3753,93,318005,84.71097496004262,8
0.2,3754,92,318097,84.71291611185086,9
0.2,3755,87,318184,84.71352502662407,14
0.2,3756,89,318273,84.7146659568805,12
0.2,3757,93,318366,84.71687067589143,9
0.2,3758,93,318459,84.71907422186752,8
0.2,3759,88,318547,84.71994680851064,14
0.2,3760,95,318642,84.7226801382611,8
0.2,3761,25,318667,84.70680489101542,8
0.2,3762,92,318759,84.70874302418284,9
0.2,3763,90,318849,84.71014877789585,11
0.2,3764,93,318942,84.71235059760956,8
0.2,3765,95,319037,84.71508231545407,9
0.2,3766,87,319124,84.71568887709053,14
0.2,3767,27,319151,84.70037154989384,6
0.2,3768,93,319244,84.70257362695675,9
0.2,3769,92,319336,84.70450928381963,9
0.2,3770,91,319427,84.70617873243171,12
0.2,3771,96,319523,84.70917285259809,6
0.2,3772,94,319617,84.71163530347204,7
0.2,3773,95,319712,84.71436142024378,6
0.2,3774,94,319806,84.71682119205298,8
0.2,3775,92,319898,84.71875,10
0.2,3776,94,319992,84.72120730738682,7
0.2,3777,91,320083,84.72286924298571,10
0.2,3778,89,320172,84.72400105848108,13
0.2,3779,95,320267,84.72671957671957,6
0.2,3780,89,320356,84.72784977519174,12
0.2,3781,90,320446,84.72924378635642,11
0.2,3782,89,320535,84.73037272006344,13
0.2,3783,94,320629,84.73282241014799,7
0.2,3784,86,320715,84.73315719947159,18
0.2,3785,91,320806,84.73481246698363,12
0.2,3786,89,320895,84.73593873778717,12
0.2,3787,93,320988,84.73812038014783,10
0.2,3788,95,321083,84.74082871470046,6
0.2,3789,91,321174,84.7424802110818,10
0.2,3790,88,321262,84.74333948826167,13
0.2,3791,88,321350,84.74419831223629,14
0.2,3792,93,321443,84.74637490113366,8
0.2,3793,15,321458,84.72799156562994,17
0.2,3794,91,321549,84.7296442687747,10
0.2,3795,91,321640,84.73129610115912,10
0.2,3796,89,321729,84.73242033184093,12
0.2,3797,93,321822,84.73459715639811,9
0.2,3798,25,321847,84.71887338773361,8
0.2,3799,92,321939,84.7207894736842,9
0.2,3800,92,322031,84.72270455143384,10
0.2,3801,95,322126,84.72540768016833,6
0.2,3802,95,322221,84.7281093873258,8
0.2,3803,96,322317,84.73107255520505,6
0.2,3804,93,322410,84.73324572930355,8
0.2,3805,93,322503,84.73541776142932,8
0.2,3806,95,322598,84.73811400052534,6
0.2,3807,95,322693,84.7408088235294,7
0.2,3808,90,322783,84.74218955106328,11
0.2,3809,89,322872,84.74330708661417,12
0.2,3810,94,322966,84.74573602728942,7
0.2,3811,89,323055,84.74685204616999,12
0.2,3812,24,323079,84.7309205350118,8
0.2,3813,90,323169,84.73230204509701,11
0.2,3814,25,323194,84.71664482306684,8
0.2,3815,88,323282,84.71750524109015,13
0.2,3816,91,323373,84.71915116583705,10
0.2,3817,66,323439,84.71424829753798,35
0.2,3818,94,323533,84.71667975909924,7
0.2,3819,22,323555,84.70026178010471,10
0.2,3820,90,323645,84.7016487830411,13
0.2,3821,96,323741,84.70460491889064,6
0.2,3822,92,323833,84.70651320952132,11
0.2,3823,94,323927,84.70894351464435,7
0.2,3824,94,324021,84.71137254901961,8
0.2,3825,95,324116,84.71406168322007,7
0.2,3826,90,324206,84.71544290567024,11
0.2,3827,94,324300,84.71786833855799,9
0.2,3828,92,324392,84.71977017498041,9
0.2,3829,93,324485,84.7219321148825,9
0.2,3830,94,324579,84.72435395458105,7
0.2,3831,86,324665,84.72468684759916,15
0.2,3832,92,324757,84.72658492042787,9
0.2,3833,27,324784,84.7115284298383,6
0.2,3834,90,324874,84.7129074315515,11
0.2,3835,95,324969,84.71558915537018,6
0.2,3836,95,325064,84.71826948136565,8
0.2,3837,94,325158,84.72068785825951,10
0.2,3838,94,325252,84.72310497525397,7
0.2,3839,88,325340,84.72395833333333,13
0.2,3840,92,325432,84.725852642541,9
0.2,3841,95,325527,84.72852680895367,7
0.2,3842,93,325620,84.73067915690866,8
0.2,3843,93,325713,84.7328303850156,8
0.2,3844,94,325807,84.73524057217165,7
0.2,3845,85,325892,84.7353094123765,17
0.2,3846,91,325983,84.7369378736678,10
0.2,3847,94,326077,84.73934511434511,7
0.2,3848,89,326166,84.74045206547154,12
0.2,3849,15,326181,84.72233766233767,18
0.2,3850,94,326275,84.72474681900805,7
0.2,3851,89,326364,84.72585669781931,12
0.2,3852,94,326458,84.72826369063068,8
0.2,3853,95,326553,84.73092890503374,6
0.2,3854,93,326646,84.7330739299611,8
0.2,3855,95,326741,84.73573651452283,7
0.2,3856,93,326834,84.7378791807104,11
0.2,3857,96,326930,84.74079834110938,6
0.2,3858,94,327024,84.74319771961648,7
0.2,3859,94,327118,84.74559585492229,7
0.2,3860,92,327210,84.74747474747475,9
0.2,3861,93,327303,84.74961160020715,8
0.2,3862,94,327397,84.75200621278799,7
0.2,3863,92,327489,84.75388198757764,10
0.2,3864,91,327580,84.75549805950841,10
0.2,3865,89,327669,84.75659596482151,12
0.2,3866,93,327762,84.75872769588828,8
0.2,3867,95,327857,84.76137538779732,6
0.2,3868,96,327953,84.76428017575601,6
0.2,3869,90,328043,84.7656330749354,12
0.2,3870,-48,327995,84.73133557220356,11
0.2,3871,94,328089,84.73372933884298,7
0.2,3872,89,328178,84.73483088045442,12
0.2,3873,96,328274,84.73773877129582,6
0.2,3874,92,328366,84.7396129032258,10
0.2,3875,96,328462,84.74251805985553,6
0.2,3876,90,328552,84.74387412948155,11
0.2,3877,91,328643,84.74548736462094,10
0.2,3878,90,328733,84.74684196957979,11
0.2,3879,93,328826,84.74896907216495,8
0.2,3880,94,328920,84.7513527441381,7
0.2,3881,90,329010,84.75270479134467,11
0.2,3882,94,329104,84.75508627349987,8
0.2,3883,94,329198,84.75746652935119,7
0.2,3884,93,329291,84.75958815958816,8
0.2,3885,95,329386,84.76222336592897,6
0.2,3886,25,329411,84.74684846925649,8
0.2,3887,93,329504,84.74897119341564,8
0.2,3888,93,329597,84.75109282591926,8
0.2,3889,92,329689,84.75295629820052,9
0.2,3890,91,329780,84.75456180930352,10
0.2,3891,94,329874,84.75693730729702,8
0.2,3892,92,329966,84.75879784228101,9
0.2,3893,93,330059,84.76091422701592,8
0.2,3894,90,330149,84.7622593068036,11
0.2,3895,25,330174,84.74691991786447,8
0.2,3896,96,330270,84.74980754426483,6
0.2,3897,91,330361,84.75141097998974,10
0.2,3898,96,330457,84.75429597332649,6
0.2,3899,89,330546,84.75538461538461,12
0.2,3900,93,330639,84.75749807741605,8
0.2,3901,91,330730,84.75909789851359,10
0.2,3902,92,330822,84.76095311299001,9
0.2,3903,83,330905,84.76050204918033,18
0.2,3904,94,330999,84.7628681177977,7
0.2,3905,27,331026,84.74807987711213,7
0.2,3906,94,331120,84.75044791400052,7
0.2,3907,94,331214,84.75281473899693,7
0.2,3908,90,331304,84.75415707342032,11
0.2,3909,92,331396,84.75601023017903,10
0.2,3910,23,331419,84.74021989261058,10
0.2,3911,87,331506,84.74079754601227,14
0.2,3912,94,331600,84.74316381293126,7
0.2,3913,91,331691,84.74476239141543,10
0.2,3914,92,331783,84.74661558109834,9
0.2,3915,90,331873,84.7479570990807,11
0.2,3916,90,331963,84.74929793209088,11
0.2,3917,23,331986,84.73353751914242,10
0.2,3918,88,332074,84.73437101301353,13
0.2,3919,21,332095,84.71811224489795,12
0.2,3920,96,332191,84.72098954348381,6
0.2,3921,94,332285,84.7233554309026,7
0.2,3922,88,332373,84.7241906704053,13
0.2,3923,93,332466,84.7262996941896,8
0.2,3924,92,332558,84.72815286624204,11
0.2,3925,96,332654,84.73102394294447,7
0.2,3926,94,332748,84.73338426279602,7
0.2,3927,95,332843,84.73599796334013,7
0.2,3928,86,332929,84.73631967421736,15
0.2,3929,89,333018,84.73740458015267,12
0.2,3930,93,333111,84.739506486899,8
0.2,3931,88,333199,84.74033570701933,13
0.2,3932,10,333209,84.72133231629799,22
0.2,3933,96,333305,84.72419928825623,6
0.2,3934,85,333390,84.72426937738247,16
0.2,3935,94,333484,84.72662601626017,7
0.2,3936,95,333579,84.72923545847091,7
0.2,3937,88,333667,84.73006602336211,13
0.2,3938,94,333761,84.73241939578573,7
0.2,3939,22,333783,84.71649746192894,12
0.2,3940,94,333877,84.71885308297387,7
0.2,3941,94,333971,84.72120750887875,8
0.2,3942,96,334067,84.72406796855186,6
0.2,3943,91,334158,84.72565922920893,10
0.2,3944,87,334245,84.72623574144487,15
0.2,3945,94,334339,84.72858590978205,7
0.2,3946,92,334431,84.73042817329618,9
0.2,3947,90,334521,84.73176291793312,11
0.2,3948,94,334615,84.73410990124081,7
0.2,3949,94,334709,84.73645569620253,8
0.2,3950,96,334805,84.73930650468236,6
0.2,3951,95,334900,84.7419028340081,7
0.2,3952,88,334988,84.74272704275234,15
0.2,3953,94,335082,84.74506828528072,7
0.2,3954,94,335176,84.74740834386851,7
0.2,3955,95,335271,84.75,6
0.2,3956,92,335363,84.75183219610817,9
0.2,3957,94,335457,84.75416877210712,7
0.2,3958,94,335551,84.75650416771911,7
0.2,3959,95,335646,84.75909090909092,6
0.2,3960,92,335738,84.76091895985863,9
0.2,3961,22,335760,84.74507824331145,11
0.2,3962,89,335849,84.74615190512239,12
0.2,3963,94,335943,84.74848637739657,7
0.2,3964,96,336039,84.75132408575031,6
0.2,3965,95,336134,84.75390821986889,7
0.2,3966,94,336228,84.756238971515,7
0.2,3967,93,336321,84.75831653225806,8
0.2,3968,96,336417,84.76114890400605,6
0.2,3969,89,336506,84.76221662468514,12
0.2,3970,94,336600,84.7645429362881,8
0.2,3971,93,336693,84.7666163141994,9
0.2,3972,88,336781,84.76743015353637,13
0.2,3973,92,336873,84.76925012581782,9
0.2,3974,88,336961,84.77006289308176,13
0.2,3975,94,337055,84.772384305835,7
0.2,3976,91,337146,84.77395021372894,12
0.2,3977,94,337240,84.77626948215183,9
0.2,3978,90,337330,84.77758230711234,11
0.2,3979,94,337424,84.77989949748743,7
0.2,3980,96,337520,84.78271791007285,6
0.2,3981,95,337615,84.78528377699648,7
0.2,3982,95,337710,84.78784835551092,7
0.2,3983,85,337795,84.7879016064257,17
0.2,3984,92,337887,84.78971141781682,9
0.2,3985,92,337979,84.79152032112394,9
0.2,3986,91,338070,84.79307750188111,10
0.2,3987,-46,338024,84.76028084252758,9
0.2,3988,88,338112,84.76109300576586,13
0.2,3989,94,338206,84.76340852130326,8
0.2,3990,95,338301,84.76597344024054,6
0.2,3991,88,338389,84.76678356713427,13
0.2,3992,93,338482,84.76884547958929,8
0.2,3993,90,338572,84.77015523284928,11
0.2,3994,94,338666,84.77246558197747,7
0.2,3995,24,338690,84.75725725725725,9
0.2,3996,92,338782,84.75906930197648,9
0.2,3997,93,338875,84.76113056528264,8
0.2,3998,91,338966,84.76269067266817,10
0.2,3999,96,339062,84.7655,6
0.2,4000,94,339156,84.767808047988,7
0.2,4001,94,339250,84.77011494252874,8
0.2,4002,90,339340,84.77142143392456,13
0.2,4003,90,339430,84.77272727272727,11
0.2,4004,92,339522,84.77453183520599,9
0.2,4005,19,339541,84.75811283075387,13
0.2,4006,89,339630,84.75917144996257,13
0.2,4007,87,339717,84.75973053892216,14
0.2,4008,96,339813,84.76253429782989,6
0.2,4009,90,339903,84.76384039900249,11
0.2,4010,24,339927,84.74869109947645,10
0.2,4011,92,340019,84.75049850448654,10
0.2,4012,93,340112,84.75255419885373,8
0.2,4013,92,340204,84.75435974090682,9
0.2,4014,26,340230,84.73972602739725,8
0.2,4015,94,340324,84.74203187250995,7
0.2,4016,87,340411,84.74259397560368,15
0.2,4017,86,340497,84.7429069188651,15
0.2,4018,22,340519,84.72729534710128,11
0.2,4019,91,340610,84.72885572139303,11
0.2,4020,93,340703,84.73091270828152,8
0.2,4021,94,340797,84.73321730482347,7
0.2,4022,92,340889,84.73502361421825,9
0.2,4023,91,340980,84.73658051689861,10
0.2,4024,94,341074,84.73888198757764,7
0.2,4025,83,341157,84.73845007451565,18
0.2,4026,94,341251,84.74074993791905,7
0.2,4027,95,341346,84.74329692154916,6
0.2,4028,93,341439,84.74534623976173,9
0.2,4029,91,341530,84.74689826302729,10
0.2,4030,94,341624,84.74919374844951,7
0.2,4031,94,341718,84.7514880952381,8
0.2,4032,95,341813,84.75402925861641,6
0.2,4033,93,341906,84.75607337630144,8
0.2,4034,96,342002,84.75885997521685,6
0.2,4035,90,342092,84.7601585728444,11
0.2,4036,93,342185,84.76219965320783,8
0.2,4037,88,342273,84.7630014858841,13
0.2,4038,94,342367,84.76528843773211,7
0.2,4039,90,342457,84.76658415841584,12
0.2,4040,94,342551,84.76886909180895,7
0.2,4041,92,342643,84.77065809005443,9
0.2,4042,92,342735,84.77244620331437,12
0.2,4043,93,342828,84.77448071216617,8
0.2,4044,95,342923,84.7770086526576,6
0.2,4045,89,343012,84.77805239742956,12
0.2,4046,96,343108,84.78082530269336,6
0.2,4047,95,343203,84.78334980237155,7
0.2,4048,95,343298,84.78587305507533,6
0.2,4049,94,343392,84.78814814814815,7
0.2,4050,95,343487,84.79066897062454,6
0.2,4051,89,343576,84.79170779861796,15
0.2,4052,89,343665,84.79274611398964,13
0.2,4053,92,343757,84.79452392698569,10
0.2,4054,93,343850,84.79654747225648,9
0.2,4055,95,343945,84.7990631163708,7
0.2,4056,94,344039,84.80133103278284,8
0.2,4057,23,344062,84.78610152784623,9
0.2,4058,91,344153,84.78763242177877,11
0.2,4059,94,344247,84.78990147783252,7
0.2,4060,90,344337,84.79118443733071,11
0.2,4061,88,344425,84.79197439684884,13
0.2,4062,93,344518,84.79399458528181,9
0.2,4063,94,344612,84.79625984251969,7
0.2,4064,92,344704,84.7980319803198,9
0.2,4065,92,344796,84.79980324643384,9
0.2,4066,87,344883,84.80034423407918,15
0.2,4067,93,344976,84.8023598820059,8
0.2,4068,94,345070,84.80462029982797,7
0.2,4069,92,345162,84.8063882063882,10
0.2,4070,92,345254,84.8081552444117,9
0.2,4071,96,345350,84.81090373280944,6
0.2,4072,93,345443,84.81291431377363,8
0.2,4073,92,345535,84.81467844869907,9
0.2,4074,93,345628,84.81668711656442,8
0.2,4075,96,345724,84.81943081452404,6
0.2,4076,93,345817,84.8214373313711,8
0.2,4077,25,345842,84.80676802354095,8
0.2,4078,93,345935,84.80877666094631,8
0.2,4079,94,346029,84.81102941176471,7
0.2,4080,95,346124,84.81352609654496,6
0.2,4081,93,346217,84.8155316021558,8
0.2,4082,92,346309,84.8172912074455,12
0.2,4083,93,346402,84.81929480901077,8
0.2,4084,93,346495,84.82129742962056,8
0.2,4085,93,346588,84.8232990699951,8
0.2,4086,92,346680,84.82505505260582,9
0.2,4087,94,346774,84.82729941291585,8
0.2,4088,90,346864,84.82856444118366,11
0.2,4089,94,346958,84.83080684596577,7
0.2,4090,17,346975,84.81422635052554,16
0.2,4091,94,347069,84.81647116324535,8
0.2,4092,93,347162,84.81847055949181,8
0.2,4093,94,347256,84.82071323888617,7
0.2,4094,93,347349,84.82271062271062,8
0.2,4095,94,347443,84.824951171875,7
0.2,4096,92,347535,84.82670246521845,9
0.2,4097,92,347627,84.82845290385553,9
0.2,4098,92,347719,84.83020248841181,9
0.2,4099,94,347813,84.83243902439024,7
0.2,4100,93,347906,84.83443062667642,8
0.2,4101,92,347998,84.83617747440273,11
0.2,4102,93,348091,84.83816719473556,8
0.2,4103,95,348186,84.8406432748538,6
0.2,4104,90,348276,84.84190012180268,11
0.2,4105,21,348297,84.82635168046761,11
0.2,4106,92,348389,84.8280983686389,9
0.2,4107,25,348414,84.81353456669912,9
0.2,4108,92,348506,84.81528352397177,9
0.2,4109,94,348600,84.81751824817518,7
0.2,4110,94,348694,84.81975188518608,8
0.2,4111,94,348788,84.82198443579766,7
0.2,4112,94,348882,84.82421590080233,7
0.2,4113,26,348908,84.8099173553719,8
0.2,4114,88,348996,84.81069258809235,13
0.2,4115,94,349090,84.81292517006803,9
0.2,4116,91,349181,84.81442798153995,11
0.2,4117,87,349268,84.81495871782418,14
0.2,4118,93,349361,84.81694586064579,8
0.2,4119,90,349451,84.81820388349514,11
0.2,4120,93,349544,84.82018927444796,8
0.2,4121,93,349637,84.82217370208636,8
0.2,4122,15,349652,84.80523890371089,18
0.2,4123,90,349742,84.80649854510185,12
0.2,4124,95,349837,84.8089696969697,6
0.2,4125,95,349932,84.8114396509937,6
0.2,4126,95,350027,84.81390840804458,6
0.2,4127,92,350119,84.81564922480621,9
0.2,4128,94,350213,84.81787357713732,8
0.2,4129,91,350304,84.81937046004843,10
0.2,4130,94,350398,84.82159283466473,7
0.2,4131,87,350485,84.82212003872216,16
0.2,4132,91,350576,84.82361480764578,10
0.2,4133,95,350671,84.82607643928398,8
0.2,4134,81,350752,84.82515114873036,20
0.2,4135,93,350845,84.82712765957447,9
0.2,4136,21,350866,84.81169929900895,12
0.2,4137,95,350961,84.81416143064283,6
0.2,4138,95,351056,84.81662237255375,7
0.2,4139,92,351148,84.81835748792271,9
0.2,4140,91,351239,84.8198502777107,10
0.2,4141,90,351329,84.8211009174312,11
0.2,4142,95,351424,84.82355780835144,6
0.2,4143,94,351518,84.8257722007722,7
0.2,4144,93,351611,84.82774427020506,10
0.2,4145,3,351614,84.80800771828268,29
0.2,4146,92,351706,84.80974198215577,9
0.2,4147,93,351799,84.81171648987464,8
0.2,4148,94,351893,84.81393106772717,8
0.2,4149,96,351989,84.8166265060241,6
0.2,4150,93,352082,84.81859792821007,8
0.2,4151,85,352167,84.81864161849711,16
0.2,4152,92,352259,84.82037081627739,9
0.2,4153,95,352354,84.82282137698604,6
0.2,4154,91,352445,84.82430806257521,11
0.2,4155,96,352541,84.82699711260828,6
0.2,4156,94,352635,84.82920375270628,7
0.2,4157,93,352728,84.83116883116882,8
0.2,4158,93,352821,84.83313296465496,8
0.2,4159,94,352915,84.83533653846153,7
0.2,4160,96,353011,84.83801970680125,6
0.2,4161,89,353100,84.83901970206631,12
0.2,4162,94,353194,84.84122027384097,7
0.2,4163,85,353279,84.84125840537945,18
0.2,4164,94,353373,84.84345738295318,7
0.2,4165,95,353468,84.84589534325492,7
0.2,4166,94,353562,84.84809215262779,7
0.2,4167,91,353653,84.84956813819578,10
0.2,4168,95,353748,84.8520028783881,6
0.2,4169,94,353842,84.85419664268585,7
0.2,4170,94,353936,84.85638935507073,7
0.2,4171,79,354015,84.85498561840843,22
0.2,4172,95,354110,84.85741672657561,7
0.2,4173,86,354196,84.85769046478198,15
0.2,4174,90,354286,84.85892215568862,11
0.2,4175,90,354376,84.86015325670498,11
0.2,4176,93,354469,84.86210198707207,8
0.2,4177,92,354561,84.86381043561512,9
0.2,4178,92,354653,84.8655180665231,9
0.2,4179,92,354745,84.86722488038278,9
0.2,4180,90,354835,84.86845252331977,12
0.2,4181,95,354930,84.87087517934003,9
0.2,4182,24,354954,84.85632321300503,9
0.2,4183,92,355046,84.85803059273422,9
0.2,4184,90,355136,84.85925925925926,11
0.2,4185,94,355230,84.86144290492116,7
0.2,4186,24,355254,84.84690709338429,8
0.2,4187,96,355350,84.84957020057307,6
0.2,4188,95,355445,84.85199331582717,6
0.2,4189,95,355540,84.85441527446301,8
0.2,4190,86,355626,84.85468861846815,15
0.2,4191,86,355712,84.85496183206106,16
0.2,4192,93,355805,84.85690436441689,9
0.2,4193,91,355896,84.85836909871244,10
0.2,4194,91,355987,84.85983313468415,10
0.2,4195,92,356079,84.8615347950429,9
0.2,4196,91,356170,84.8629973790803,10
0.2,4197,92,356262,84.86469747498809,9
0.2,4198,94,356356,84.86687306501548,7
0.2,4199,90,356446,84.86809523809524,11
0.2,4200,94,356540,84.87026898357534,7
0.2,4201,20,356560,84.8548310328415,13
0.2,4202,88,356648,84.8555793480847,14
0.2,4203,92,356740,84.85727878211227,9
0.2,4204,82,356822,84.85659928656362,19
0.2,4205,92,356914,84.85829766999524,11
0.2,4206,95,357009,84.86070834323746,6
0.2,4207,95,357104,84.86311787072243,6
0.2,4208,95,357199,84.86552625326681,6
0.2,4209,92,357291,84.86722090261283,9
0.2,4210,91,357382,84.8686772738067,12
0.2,4211,96,357478,84.8713200379867,6
0.2,4212,85,357563,84.87135058153335,16
0.2,4213,96,357659,84.87399145704794,6
0.2,4214,94,357753,84.87615658362989,7
0.2,4215,96,357849,84.87879506641366,6
0.2,4216,95,357944,84.88119516243775,6
0.2,4217,83,358027,84.88074917022286,18
0.2,4218,94,358121,84.8829106423323,7
0.2,4219,96,358217,84.88554502369668,6
0.2,4220,92,358309,84.88723051409619,9
0.2,4221,96,358405,84.88986262434865,6
0.2,4222,91,358496,84.89130949561923,10
0.2,4223,96,358592,84.89393939393939,6
0.2,4224,86,358678,84.89420118343195,15
0.2,4225,96,358774,84.89682915286323,6
0.2,4226,92,358866,84.89850958126331,9
0.2,4227,22,358888,84.88363292336803,10
0.2,4228,89,358977,84.88460628990305,14
0.2,4229,96,359073,84.88723404255319,6
0.2,4230,93,359166,84.88915150082723,8
0.2,4231,95,359261,84.89154064272212,6
0.2,4232,92,359353,84.89321993857784,9
0.2,4233,96,359449,84.89584317430327,6
0.2,4234,91,359540,84.89728453364818,10
0.2,4235,94,359634,84.89943342776203,7
0.2,4236,91,359725,84.90087325938164,10
0.2,4237,96,359821,84.90349221330817,6
0.2,4238,96,359917,84.90610993158764,6
0.2,4239,91,360008,84.90754716981132,11
0.2,4240,89,360097,84.90851214336242,13
0.2,4241,89,360186,84.90947666195191,12
0.2,4242,94,360280,84.91161913740278,7
0.2,4243,91,360371,84.91305372290292,10
0.2,4244,88,360459,84.91378091872791,13
0.2,4245,93,360552,84.91568535091851,11
0.2,4246,94,360646,84.9178243465976,7
0.2,4247,92,360738,84.91949152542372,9
0.2,4248,95,360833,84.92186396799246,6
0.2,4249,92,360925,84.9235294117647,9
0.2,4250,95,361020,84.92589978828511,6
0.2,4251,91,361111,84.92732831608654,10
0.2,4252,92,361203,84.92899130025864,9
0.2,4253,87,361290,84.92947813822285,15
0.2,4254,25,361315,84.9153936545241,9
0.2,4255,88,361403,84.91611842105263,14
0.2,4256,94,361497,84.91825229034531,7
0.2,4257,86,361583,84.91850634100517,15
0.2,4258,86,361669,84.91876027236441,15
0.2,4259,92,361761,84.92042253521127,10
0.2,4260,95,361856,84.92278807791598,7
0.2,4261,84,361940,84.92257156264664,17
0.2,4262,89,362029,84.92352803190242,12
0.2,4263,94,362123,84.92565666041276,7
0.2,4264,88,362211,84.9263774912075,13
0.2,4265,94,362305,84.9285044538209,7
0.2,4266,96,362401,84.93109913288025,6
0.2,4267,95,362496,84.93345829428304,6
0.2,4268,96,362592,84.93605059732958,6
0.2,4269,95,362687,84.9384074941452,6
0.2,4270,92,362779,84.94006087567314,9
0.2,4271,91,362870,84.94147940074906,10
0.2,4272,94,362964,84.94359934472267,7
0.2,4273,94,363058,84.94571829667758,7
0.2,4274,86,363144,84.9459649122807,15
0.2,4275,95,363239,84.94831618334892,6
0.2,4276,89,363328,84.949263502455,12
0.2,4277,92,363420,84.95091164095372,9
0.2,4278,94,363514,84.95302640803926,7
0.2,4279,95,363609,84.9553738317757,7
0.2,4280,24,363633,84.94113524877365,8
0.2,4281,93,363726,84.94301728164409,8
0.2,4282,95,363821,84.94536539808546,6
0.2,4283,96,363917,84.94794584500467,6
0.2,4284,89,364006,84.94889148191365,13
0.2,4285,91,364097,84.95030331311246,10
0.2,4286,93,364190,84.95218101236296,8
0.2,4287,92,364282,84.95382462686567,10
0.2,4288,89,364371,84.95476801119142,13
0.2,4289,95,364466,84.95710955710956,7
0.2,4290,88,364554,84.95781869028198,13
0.2,4291,83,364637,84.95736253494874,19
0.2,4292,91,364728,84.95877009084556,11
0.2,4293,93,364821,84.96064275733582,8
0.2,4294,92,364913,84.96228172293364,9
0.2,4295,88,365001,84.96298882681565,13
0.2,4296,95,365096,84.96532464510123,7
0.2,4297,91,365187,84.96672871102838,10
0.2,4298,90,365277,84.9678995115143,13
0.2,4299,-47,365230,84.93720930232558,10
0.2,4300,94,365324,84.93931643803766,7
0.2,4301,94,365418,84.94142259414225,7
0.2,4302,91,365509,84.94283058331396,10
0.2,4303,94,365603,84.94493494423791,8
0.2,4304,93,365696,84.94680603948896,8
0.2,4305,91,365787,84.94821179749187,10
0.2,4306,93,365880,84.95008126306014,8
0.2,4307,89,365969,84.95102135561746,12
0.2,4308,24,365993,84.93687630540728,10
0.2,4309,93,366086,84.93874709976798,8
0.2,4310,94,366180,84.94084899095337,8
0.2,4311,93,366273,84.94271799628943,8
0.2,4312,92,366365,84.9443542777649,9
0.2,4313,92,366457,84.94598980064904,9
0.2,4314,92,366549,84.9476245654693,9
0.2,4315,96,366645,84.95018535681186,6
0.2,4316,86,366731,84.95042853833681,19
0.2,4317,86,366817,84.95067160722557,16
0.2,4318,94,366911,84.95276684417689,7
0.2,4319,96,367007,84.95532407407407,7
0.2,4320,91,367098,84.95672298079148,10
0.2,4321,94,367192,84.95881536325776,7
0.2,4322,88,367280,84.95951885264863,13
0.2,4323,25,367305,84.94565217391305,8
0.2,4324,94,367399,84.94774566473988,8
0.2,4325,89,367488,84.9486823855756,12
0.2,4326,95,367583,84.95100531546106,6
0.2,4327,91,367674,84.95240295748614,10
0.2,4328,96,367770,84.95495495495496,6
0.2,4329,93,367863,84.9568129330254,8
0.2,4330,96,367959,84.95936273377973,6
0.2,4331,92,368051,84.96098799630656,9
0.2,4332,92,368143,84.96261250865452,9
0.2,4333,92,368235,84.96423627134287,9
0.2,4334,92,368327,84.96585928489043,9
0.2,4335,92,368419,84.9674815498155,10
0.2,4336,90,368509,84.96864191837676,11
0.2,4337,96,368605,84.97118487782389,6
0.2,4338,93,368698,84.973035261581,8
0.2,4339,91,368789,84.97442396313365,10
0.2,4340,93,368882,84.9762727482147,8
0.2,4341,24,368906,84.96222938737908,9
0.2,4342,22,368928,84.94773198250057,12
0.2,4343,21,368949,84.93301104972376,11
0.2,4344,91,369040,84.9344073647871,10
0.2,4345,95,369135,84.93672342383802,7
0.2,4346,94,369229,84.93880837359099,8
0.2,4347,88,369317,84.93951241950322,13
0.2,4348,96,369413,84.94205564497585,6
0.2,4349,93,369506,84.94390804597701,8
0.2,4350,96,369602,84.94644909216272,6
0.2,4351,94,369696,84.94852941176471,7
0.2,4352,94,369790,84.95060877555709,7
0.2,4353,92,369882,84.9522278364722,9
0.2,4354,89,369971,84.95315729047073,12
0.2,4355,95,370066,84.955463728191,6
0.2,4356,89,370155,84.95639201285287,14
0.2,4357,96,370251,84.95892611289582,6
0.2,4358,27,370278,84.94562973158982,6
0.2,4359,87,370365,84.9461009174312,14
0.2,4360,94,370459,84.94817702361844,8
0.2,4361,95,370554,84.95048143053646,6
0.2,4362,92,370646,84.95209718083888,9
0.2,4363,88,370734,84.95279560036664,14
0.2,4364,87,370821,84.953264604811,14
0.2,4365,92,370913,84.95487860742098,9
0.2,4366,95,371008,84.95717884130983,6
0.2,4367,95,371103,84.95947802197803,8
0.2,4368,95,371198,84.96177615014878,6
0.2,4369,96,371294,84.96430205949656,6
0.2,4370,93,371387,84.96614047128803,8
0.2,4371,84,371471,84.96591948764868,17
0.2,4372,86,371557,84.96615595700892,15
0.2,4373,95,371652,84.96844993141289,6
0.2,4374,92,371744,84.97005714285714,9
0.2,4375,87,371831,84.970521023766,14
0.2,4376,92,371923,84.9721270276445,9
0.2,4377,19,371942,84.95705801735953,15
0.2,4378,93,372035,84.95889472482303,8
0.2,4379,93,372128,84.96073059360731,8
0.2,4380,89,372217,84.96165259073271,12
0.2,4381,92,372309,84.96325878594249,10
0.2,4382,81,372390,84.96235455167694,20
0.2,4383,92,372482,84.9639598540146,9
0.2,4384,93,372575,84.96579247434435,8
0.2,4385,90,372665,84.96694026447788,11
0.2,4386,96,372761,84.96945520857078,6
0.2,4387,93,372854,84.97128532360985,8
0.2,4388,91,372945,84.97265892002734,10
0.2,4389,90,373035,84.9738041002278,11
0.2,4390,90,373125,84.97494875882487,11
0.2,4391,96,373221,84.97745901639344,6
0.2,4392,79,373300,84.97609833826542,23
0.2,4393,95,373395,84.97837960855712,6
0.2,4394,96,373491,84.98088737201365,6
0.2,4395,96,373587,84.98339399454049,6
0.2,4396,92,373679,84.98498976574938,10
0.2,4397,91,373770,84.98635743519782,12
0.2,4398,96,373866,84.98886110479654,6
0.2,4399,23,373889,84.97477272727272,10
0.2,4400,94,373983,84.97682344921608,7
0.2,4401,94,374077,84.97887323943662,7
0.2,4402,86,374163,84.97910515557574,15
0.2,4403,21,374184,84.96457765667574,12
0.2,4404,91,374275,84.96594778660612,11
0.2,4405,89,374364,84.96686336813437,13
0.2,4406,94,374458,84.9689130928069,9
0.2,4407,91,374549,84.97028130671507,10
0.2,4408,95,374644,84.97255613517804,6
0.2,4409,90,374734,84.97369614512472,11
0.2,4410,89,374823,84.97460893221492,12
0.2,4411,94,374917,84.97665457842248,7
0.2,4412,91,375008,84.97801948787672,10
0.2,4413,91,375099,84.97938377888536,10
0.2,4414,94,375193,84.98142695356738,7
0.2,4415,94,375287,84.98346920289855,7
0.2,4416,94,375381,84.98551052750736,7
0.2,4417,89,375470,84.98641919420552,12
0.2,4418,91,375561,84.9877800407332,11
0.2,4419,90,375651,84.98891402714932,12
0.2,4420,95,375746,84.99117846641032,9
0.2,4421,93,375839,84.99298959746721,9
0.2,4422,91,375930,84.99434772778658,10
0.2,4423,88,376018,84.99502712477396,13
0.2,4424,94,376112,84.99706214689266,7
0.2,4425,95,376207,84.99932218707637,6
0.2,4426,91,376298,85.00067765981477,11
0.2,4427,90,376388,85.00180668473351,11
0.2,4428,93,376481,85.00361255362384,9
0.2,4429,94,376575,85.00564334085779,8
0.2,4430,89,376664,85.00654479801399,12
0.2,4431,24,376688,84.9927797833935,8
0.2,4432,91,376779,84.99413489736071,10
0.2,4433,92,376871,84.9957149300857,9
0.2,4434,95,376966,84.99797068771139,7
0.2,4435,21,376987,84.98354373309287,13
0.2,4436,93,377080,84.98535046202389,8
0.2,4437,88,377168,84.98602974312753,13
0.2,4438,95,377263,84.98828564992115,6
0.2,4439,92,377355,84.98986486486487,9
0.2,4440,93,377448,84.99166854312092,8
0.2,4441,88,377536,84.9923457901846,13
0.2,4442,92,377628,84.99392302498312,10
0.2,4443,96,377724,84.996399639964,6
0.2,4444,96,377820,84.99887514060742,6
0.2,4445,92,377912,85.0004498425551,9
0.2,4446,89,378001,85.00134922419609,13
0.2,4447,92,378093,85.0029226618705,10
0.2,4448,27,378120,84.98988536749832,6
0.2,4449,94,378214,84.99191011235955,7
0.2,4450,91,378305,84.99325994158616,11
0.2,4451,89,378394,84.99415992812219,13
0.2,4452,92,378486,84.9957332135639,9
0.2,4453,96,378582,84.99820386169735,6
0.2,4454,94,378676,85.00022446689114,7
0.2,4455,90,378766,85.00134649910234,12
0.2,4456,94,378860,85.00336549248374,7
0.2,4457,91,378951,85.00471063257066,10
0.2,4458,93,379044,85.00650370038124,8
0.2,4459,94,379138,85.0085201793722,8
0.2,4460,27,379165,84.99551670029142,6
0.2,4461,93,379258,84.997310623039,8
0.2,4462,90,379348,84.99843154828591,11
0.2,4463,95,379443,85.00067204301075,6
0.2,4464,91,379534,85.0020156774916,11
0.2,4465,96,379630,85.00447828034035,6
0.2,4466,94,379724,85.00649205283187,7
0.2,4467,91,379815,85.00783348254252,11
0.2,4468,27,379842,84.99485343477288,6
0.2,4469,93,379935,84.99664429530202,8
0.2,4470,87,380022,84.9970923730709,14
0.2,4471,81,380103,84.99619856887298,22
0.2,4472,89,380192,84.99709367315,12
0.2,4473,91,380283,84.99843540455967,10
0.2,4474,94,380377,85.0004469273743,7
0.2,4475,94,380471,85.00245755138516,7
0.2,4476,93,380564,85.00424391333482,8
0.2,4477,92,380656,85.00580616346583,9
0.2,4478,95,380751,85.00803750837241,6
0.2,4479,96,380847,85.01049107142858,6
0.2,4480,93,380940,85.01227404597188,8
0.2,4481,85,381025,85.01227130745202,16
0.2,4482,91,381116,85.01360695962525,10
0.2,4483,93,381209,85.01538804638716,8
0.2,4484,92,381301,85.01694537346711,9
0.2,4485,25,381326,85.00356665180561,8
0.2,4486,91,381417,85.00490305326498,10
0.2,4487,92,381509,85.00646167557932,9
0.2,4488,21,381530,84.99220316328804,11
0.2,4489,90,381620,84.99331848552339,12
0.2,4490,93,381713,84.99510131373859,8
0.2,4491,89,381802,84.99599287622439,13
0.2,4492,92,381894,84.99755174716225,9
0.2,4493,94,381988,84.99955496217179,7
0.2,4494,91,382079,85.00088987764182,10
0.2,4495,93,382172,85.00266903914591,9
0.2,4496,95,382267,85.00489215032243,6
0.2,4497,83,382350,85.0044464206314,20
0.2,4498,93,382443,85.00622360524561,8
0.2,4499,96,382539,85.00866666666667,6
0.2,4500,87,382626,85.00910908686959,14
0.2,4501,23,382649,84.995335406486,10
0.2,4502,88,382737,84.99600266489007,13
0.2,4503,94,382831,84.99800177619893,7
0.2,4504,95,382926,85.00022197558269,6
0.2,4505,91,383017,85.00155348424323,10
0.2,4506,96,383113,85.00399378744176,6
0.2,4507,94,383207,85.00598935226265,7
0.2,4508,94,383301,85.00798403193613,7
0.2,4509,21,383322,84.99379157427938,11
0.2,4510,94,383416,84.99578807359786,7
0.2,4511,17,383433,84.98071808510639,15
0.2,4512,92,383525,84.98227343230667,9
0.2,4513,92,383617,84.98382809038547,9
0.2,4514,94,383711,84.9858250276855,7
0.2,4515,92,383803,84.98737821080603,9
0.2,4516,96,383899,84.98981624972326,6
0.2,4517,92,383991,84.99136786188579,9
0.2,4518,91,384082,84.99269749944678,10
0.2,4519,94,384176,84.99469026548672,7
0.2,4520,26,384202,84.98164122981642,8
0.2,4521,94,384296,84.98363555948696,7
0.2,4522,85,384381,84.98363917753703,17
0.2,4523,93,384474,84.98541114058355,9
0.2,4524,93,384567,84.98718232044199,8
0.2,4525,26,384593,84.97414935925762,6
0.2,4526,94,384687,84.97614314115309,7
0.2,4527,85,384772,84.976148409894,19
0.2,4528,95,384867,84.97836166924266,6
0.2,4529,96,384963,84.98079470198675,6
0.2,4530,92,385055,84.98234385345398,10
0.2,4531,92,385147,84.98389232127096,10
0.2,4532,94,385241,84.98588131480255,8
0.2,4533,26,385267,84.97287163652405,6
0.2,4534,93,385360,84.97464167585447,8
0.2,4535,89,385449,84.9755291005291,13
0.2,4536,92,385541,84.97707736389685,10
0.2,4537,92,385633,84.97862494490965,9
0.2,4538,94,385727,84.98061246970698,7
0.2,4539,92,385819,84.98215859030837,9
0.2,4540,92,385911,84.98370402994935,12
0.2,4541,92,386003,84.9852487890797,9
0.2,4542,90,386093,84.98635263042043,11
0.2,4543,92,386185,84.98789612676056,9
0.2,4544,88,386273,84.98855885588559,13
0.2,4545,95,386368,84.99076110866696,6
0.2,4546,90,386458,84.99186276665934,12
0.2,4547,91,386549,84.99318381706244,10
0.2,4548,88,386637,84.99384480105518,14
0.2,4549,93,386730,84.99560439560439,9
0.2,4550,94,386824,84.99758294880246,8
0.2,4551,94,386918,84.99956063268893,7
0.2,4552,94,387012,85.0015374478366,7
0.2,4553,95,387107,85.00373298199385,7
0.2,4554,85,387192,85.00373216245883,16
0.2,4555,92,387284,85.00526777875329,9
0.2,4556,96,387380,85.00768049155145,6
0.2,4557,90,387470,85.00877577885038,12
0.2,4558,94,387564,85.01074797104629,8
0.2,4559,93,387657,85.0125,8
0.2,4560,94,387751,85.01447051085289,7
0.2,4561,94,387845,85.01644015782551,8
0.2,4562,-45,387800,84.98794652640807,9
0.2,4563,88,387888,84.988606485539,13
0.2,4564,92,387980,84.99014238773275,9
0.2,4565,91,388071,84.99145860709592,12
0.2,4566,95,388166,84.99365009853295,6
0.2,4567,93,388259,84.99540280210158,8
0.2,4568,91,388350,84.99671700590939,10
0.2,4569,96,388446,84.99912472647702,6
0.2,4570,27,388473,84.98643622839641,6
0.2,4571,94,388567,84.98840769903762,7
0.2,4572,92,388659,84.98994095779575,9
0.2,4573,94,388753,84.9919108001749,7
0.2,4574,94,388847,84.99387978142076,7
0.2,4575,95,388942,84.99606643356644,6
0.2,4576,94,389036,84.99803364649334,8
0.2,4577,93,389129,84.99978156400175,8
0.2,4578,96,389225,85.00218388294387,7
0.2,4579,-54,389171,84.97183406113537,20
0.2,4580,94,389265,84.97380484610348,7
0.2,4581,93,389358,84.9755565255347,8
0.2,4582,86,389444,84.9757800567314,15
0.2,4583,27,389471,84.96313263525306,6
0.2,4584,94,389565,84.96510359869139,7
0.2,4585,95,389660,84.9672917575229,7
0.2,4586,95,389755,84.96947896228471,6
0.2,4587,94,389849,84.97144725370532,8
0.2,4588,93,389942,84.9731967748965,10
0.2,4589,94,390036,84.97516339869281,7
0.2,4590,93,390129,84.97691134829013,9
0.2,4591,96,390225,84.9793118466899,6
0.2,4592,90,390315,84.98040496407577,11
0.2,4593,93,390408,84.98215063125816,10
0.2,4594,94,390502,84.98411316648532,7
0.2,4595,17,390519,84.96932114882506,15
0.2,4596,91,390610,84.97063302153579,10
0.2,4597,95,390705,84.97281426707264,6
0.2,4598,96,390801,84.97521200260927,6
0.2,4599,94,390895,84.97717391304347,7
0.2,4600,83,390978,84.97674418604652,18
0.2,4601,93,391071,84.97848761408083,8
0.2,4602,91,391162,84.97979578535738,10
0.2,4603,91,391253,84.98110338835795,11
0.2,4604,96,391349,84.98349619978285,6
0.2,4605,95,391444,84.98567086409032,6
0.2,4606,94,391538,84.98762752333406,10
0.2,4607,18,391556,84.97309027777777,14
0.2,4608,91,391647,84.97439791711868,10
0.2,4609,94,391741,84.9763557483731,7
0.2,4610,92,391833,84.97787898503579,9
0.2,4611,95,391928,84.98005203816132,6
0.2,4612,94,392022,84.98200737047475,7
0.2,4613,94,392116,84.98396185522323,7
0.2,4614,92,392208,84.9854821235103,10
0.2,4615,91,392299,84.98678509532063,11
0.2,4616,27,392326,84.97422568767598,6
0.2,4617,94,392420,84.9761801645734,7
0.2,4618,89,392509,84.97705130980732,12
0.2,4619,89,392598,84.97792207792207,13
0.2,4620,95,392693,84.98009088941788,6
0.2,4621,90,392783,84.98117697966248,11
0.2,4622,93,392876,84.98291152930997,8
0.2,4623,90,392966,84.98399653979239,12
0.2,4624,95,393061,84.98616216216216,6
0.2,4625,95,393156,84.98832684824903,6
0.2,4626,93,393249,84.99005835314459,8
0.2,4627,93,393342,84.99178910976664,8
0.2,4628,90,393432,84.99287103046014,11
0.2,4629,91,393523,84.99416846652268,11
0.2,4630,90,393613,84.99524940617577,11
0.2,4631,93,393706,84.99697754749569,9
0.2,4632,90,393796,84.99805741420246,11
0.2,4633,93,393889,84.9997842037117,8
0.2,4634,93,393982,85.00151024811218,9
0.2,4635,96,394078,85.00388265746334,6
0.2,4636,89,394167,85.00474444684063,14
0.2,4637,86,394253,85.0049590340664,15
0.2,4638,95,394348,85.00711360206941,6
0.2,4639,92,394440,85.00862068965517,9
0.2,4640,94,394534,85.0105580693816,7
0.2,4641,94,394628,85.01249461439035,9
0.2,4642,92,394720,85.01399956924402,9
0.2,4643,91,394811,85.01528854435831,10
0.2,4644,84,394895,85.0150699677072,18
0.2,4645,96,394991,85.01743435213086,6
0.2,4646,94,395085,85.01936733376373,7
0.2,4647,19,395104,85.0051635111876,14
0.2,4648,94,395198,85.00709830070983,7
0.2,4649,-47,395151,84.97870967741936,12
0.2,4650,88,395239,84.97935927757472,13
0.2,4651,94,395333,84.98129836629407,7
0.2,4652,95,395428,84.98345153664303,6
0.2,4653,27,395455,84.97099269445638,6
0.2,4654,92,395547,84.97250268528464,10
0.2,4655,92,395639,84.97401202749141,9
0.2,4656,94,395733,84.97595018252093,7
0.2,4657,96,395829,84.97831687419493,6
0.2,4658,94,395923,84.9802532732346,7
0.2,4659,93,396016,84.98197424892705,8
0.2,4660,94,396110,84.98390903239648,7
0.2,4661,95,396205,84.98605748605749,7
0.2,4662,93,396298,84.98777610980056,8
0.2,4663,27,396325,84.97534305317325,6
0.2,4664,95,396420,84.97749196141478,6
0.2,4665,95,396515,84.97963994856408,7
0.2,4666,88,396603,84.9802871223484,13
0.2,4667,95,396698,84.98243359040274,6
0.2,4668,88,396786,84.98307988862712,13
0.2,4669,90,396876,84.98415417558887,12
0.2,4670,96,396972,84.98651252408477,6
0.2,4671,16,396988,84.97174657534246,16
0.2,4672,87,397075,84.97218061202653,15
0.2,4673,95,397170,84.97432605905007,6
0.2,4674,92,397262,84.97582887700534,9
0.2,4675,90,397352,84.97690333618478,11
0.2,4676,94,397446,84.97883258499037,7
0.2,4677,95,397541,84.9809747755451,6
0.2,4678,95,397636,84.98311605043813,6
0.2,4679,96,397732,84.98547008547008,6
0.2,4680,84,397816,84.9852595599231,21
0.2,4681,93,397909,84.98697137975225,8
0.2,4682,91,398000,84.98825539184284,10
0.2,4683,87,398087,84.98868488471392,14
0.2,4684,93,398180,84.99039487726787,9
0.2,4685,91,398271,84.99167733674776,12
0.2,4686,91,398362,84.99295924898657,10
0.2,4687,24,398386,84.97994880546075,10
0.2,4688,94,398480,84.98187246747707,7
0.2,4689,89,398569,84.98272921108742,12
0.2,4690,94,398663,84.98465146024301,7
0.2,4691,95,398758,84.98678601875532,8
0.2,4692,92,398850,84.9882804176433,9
0.2,4693,90,398940,84.9893481039625,12
0.2,4694,27,398967,84.97699680511182,6
0.2,4695,95,399062,84.97913117546848,6
0.2,4696,92,399154,84.9806259314456,9
0.2,4697,94,399248,84.98254576415496,7
0.2,4698,94,399342,84.98446477974036,7
0.2,4699,95,399437,84.98659574468086,7
0.2,4700,23,399460,84.97340991278452,11
0.2,4701,94,399554,84.97532964695874,7
0.2,4702,95,399649,84.97746119498193,6
0.2,4703,96,399745,84.9798044217687,6
0.2,4704,90,399835,84.98087141339,11
0.2,4705,16,399851,84.96621334466639,17
0.2,4706,90,399941,84.96728277034204,11
0.2,4707,93,400034,84.96898895497026,8
0.2,4708,93,400127,84.97069441495009,9
0.2,4709,94,400221,84.97261146496815,9
0.2,4710,95,400316,84.97473997028231,6
0.2,4711,89,400405,84.97559422750425,12
0.2,4712,92,400497,84.97708465945257,9
0.2,4713,91,400588,84.97836232498939,10
0.2,4714,92,400680,84.97985153764581,11
0.2,4715,93,400773,84.98155216284987,8
0.2,4716,92,400865,84.98304006783972,9
0.2,4717,25,400890,84.97032640949556,8
0.2,4718,92,400982,84.97181606272515,10
0.2,4719,89,401071,84.97266949152542,12
0.2,4720,92,401163,84.9741580173692,10
0.2,4721,91,401254,84.97543413807709,10
0.2,4722,89,401343,84.97628625873385,13
0.2,4723,92,401435,84.97777307366638,9
0.2,4724,91,401526,84.97904761904762,10
0.2,4725,91,401617,84.9803216250529,11
0.2,4726,93,401710,84.9820181933573,9
0.2,4727,92,401802,84.98350253807106,10
0.2,4728,94,401896,84.98540917741595,7
0.2,4729,91,401987,84.98668076109936,10
0.2,4730,91,402078,84.98795180722891,10
0.2,4731,85,402163,84.98795435333896,16
0.2,4732,92,402255,84.98943587576589,9
0.2,4733,92,402347,84.99091677228559,10
0.2,4734,93,402440,84.99260823653643,9
0.2,4735,93,402533,84.99429898648648,8
0.2,4736,94,402627,84.99620012666244,8
0.2,4737,91,402718,84.99746728577459,10
0.2,4738,95,402813,84.99957797003587,6
0.2,4739,93,402906,85.00126582278482,8
0.2,4740,96,403002,85.00358574140476,6
0.2,4741,93,403095,85.00527203711515,10
0.2,4742,21,403116,84.99177735610373,13
0.2,4743,95,403211,84.99388701517707,7
0.2,4744,94,403305,84.99578503688093,7
0.2,4745,88,403393,84.99641803624104,14
0.2,4746,16,403409,84.98188329471245,16
0.2,4747,94,403503,84.98378264532435,7
0.2,4748,89,403592,84.98462834280902,15
0.2,4749,90,403682,84.98568421052632,11
0.2,4750,95,403777,84.98779204378026,6
0.2,4751,86,403863,84.98800505050505,15
0.2,4752,90,403953,84.98905954134231,11
0.2,4753,92,404045,84.99053428691629,9
0.2,4754,94,404139,84.99242902208202,7
0.2,4755,93,404232,84.99411269974769,8
0.2,4756,22,404254,84.9808702964053,11
0.2,4757,92,404346,84.98234552332913,10
0.2,4758,95,404441,84.98445051481404,6
0.2,4759,92,404533,84.9859243697479,9
0.2,4760,94,404627,84.98781768536021,7
0.2,4761,95,404722,84.98992020159596,6
0.2,4762,94,404816,84.99181188326685,8
0.2,4763,91,404907,84.99307304785894,10
0.2,4764,94,405001,84.99496327387199,9
0.2,4765,89,405090,84.99580360889635,12
0.2,4766,94,405184,84.99769246905811,7
0.2,4767,90,405274,84.99874161073825,11
0.2,4768,87,405361,84.9991612497379,14
0.2,4769,92,405453,85.00062893081761,9
0.2,4770,94,405547,85.00251519597569,7
0.2,4771,96,405643,85.00481978206203,6
0.2,4772,91,405734,85.00607584328515,10
0.2,4773,90,405824,85.00712191034772,11
0.2,4774,-51,405773,84.97863874345549,14
0.2,4775,13,405786,84.96356783919597,22
0.2,4776,95,405881,84.9656688298095,6
0.2,4777,95,405976,84.96776894097948,7
0.2,4778,92,406068,84.96924042686754,9
0.2,4779,93,406161,84.97092050209206,8
0.2,4780,93,406254,84.97259987450325,9
0.2,4781,90,406344,84.97365119196989,13
0.2,4782,95,406439,84.97574743884591,6
0.2,4783,94,406533,84.97763377926421,7
0.2,4784,92,406625,84.9791013584117,10
0.2,4785,92,406717,84.98056832427915,9
0.2,4786,91,406808,84.98182577814916,10
0.2,4787,90,406898,84.9828738512949,12
0.2,4788,93,406991,84.984547922322,8
0.2,4789,95,407086,84.9866388308977,7
0.2,4790,90,407176,84.98768524316426,11
0.2,4791,91,407267,84.98893989983306,10
0.2,4792,21,407288,84.9755894012101,13
0.2,4793,92,407380,84.97705465164789,9
0.2,4794,87,407467,84.97747653806049,14
0.2,4795,90,407557,84.97852376980818,12
0.2,4796,96,407653,84.980821346675,6
0.2,4797,88,407741,84.98145060441851,13
0.2,4798,92,407833,84.98291310689727,9
0.2,4799,94,407927,84.98479166666667,8
0.2,4800,90,408017,84.98583628410748,11
0.2,4801,91,408108,84.98708871303623,10
0.2,4802,94,408202,84.98896523006454,7
0.2,4803,89,408291,84.9898001665279,12
0.2,4804,95,408386,84.99188345473465,6
0.2,4805,93,408479,84.99354972950479,8
0.2,4806,92,408571,84.99500728104847,9
0.2,4807,88,408659,84.9956322795341,13
0.2,4808,89,408748,84.99646496153046,12
0.2,4809,91,408839,84.9977130977131,10
0.2,4810,94,408933,84.99958428601123,7
0.2,4811,95,409028,85.00166251039069,6
0.2,4812,89,409117,85.00249324745481,13
0.2,4813,87,409204,85.00290818446199,14
0.2,4814,89,409293,85.00373831775701,12
0.2,4815,94,409387,85.00560631229236,8
0.2,4816,92,409479,85.00705833506332,9
0.2,4817,90,409569,85.00809464508094,11
0.2,4818,91,409660,85.00933803693712,10
0.2,4819,92,409752,85.01078838174274,10
0.2,4820,19,409771,84.99709603816636,15
0.2,4821,95,409866,84.9991704686852,6
0.2,4822,95,409961,85.00124403897989,8
0.2,4823,93,410054,85.00290215588723,8
0.2,4824,93,410147,85.00455958549223,8
0.2,4825,91,410238,85.00580190634065,10
0.2,4826,86,410324,85.0060078723845,15
0.2,4827,93,410417,85.00766362883182,8
0.2,4828,92,410509,85.00911161731207,9
0.2,4829,94,410603,85.01097308488613,8
0.2,4830,94,410697,85.0128337818257,8
0.2,4831,95,410792,85.01490066225166,6
0.2,4832,95,410887,85.01696668735775,6
0.2,4833,91,410978,85.01820438560199,10
0.2,4834,91,411069,85.01944157187177,10
0.2,4835,96,411165,85.02171215880894,6
0.2,4836,96,411261,85.02398180690511,6
0.2,4837,95,411356,85.02604381976023,6
0.2,4838,91,411447,85.02727836329821,11
0.2,4839,89,411536,85.02809917355371,12
0.2,4840,93,411629,85.0297459202644,8
0.2,4841,14,411643,85.01507641470467,20
0.2,4842,92,411735,85.0165186867644,9
0.2,4843,27,411762,85.00454170107349,6
0.2,4844,90,411852,85.00557275541796,11
0.2,4845,92,411944,85.00701609574907,9
0.2,4846,94,412038,85.00887146688673,7
0.2,4847,95,412133,85.01093234323433,6
0.2,4848,95,412228,85.01299236956073,6
0.2,4849,93,412321,85.01463917525773,8
0.2,4850,94,412415,85.01649144506287,7
0.2,4851,94,412509,85.01834295136027,7
0.2,4852,94,412603,85.02019369462188,7
0.2,4853,95,412698,85.02224969097651,6
0.2,4854,94,412792,85.02409886714727,7
0.2,4855,92,412884,85.02553542009885,9
0.2,4856,96,412980,85.02779493514515,6
0.2,4857,95,413075,85.0298476739399,7
0.2,4858,95,413170,85.0318995678123,8
0.2,4859,95,413265,85.03395061728395,6
0.2,4860,86,413351,85.03414935198519,15
0.2,4861,94,413445,85.03599341834637,8
0.2,4862,95,413540,85.03804236068271,6
0.2,4863,23,413563,85.02528782894737,12
0.2,4864,26,413589,85.0131551901336,7
0.2,4865,94,413683,85.01500205507604,7
0.2,4866,96,413779,85.01725909184303,6
0.2,4867,93,413872,85.01889893179951,8
0.2,4868,92,413964,85.02033271719039,9
0.2,4869,21,413985,85.00718685831622,12
0.2,4870,95,414080,85.0092383494149,6
0.2,4871,94,414174,85.01108374384236,7
0.2,4872,96,414270,85.01333880566386,6
0.2,4873,93,414363,85.01497743126795,9
0.2,4874,95,414458,85.01702564102564,8
0.2,4875,93,414551,85.01866283839213,8
0.2,4876,92,414643,85.02009432027886,9
0.2,4877,94,414737,85.02193521935219,8
0.2,4878,94,414831,85.02377536380406,10
0.2,4879,96,414927,85.02602459016393,6
0.2,4880,92,415019,85.02745339069862,10
0.2,4881,91,415110,85.02867677181483,10
0.2,4882,93,415203,85.03030923612533,8
0.2,4883,95,415298,85.03235053235053,6
0.2,4884,89,415387,85.0331627430911,12
0.2,4885,92,415479,85.0345886205485,9
0.2,4886,83,415562,85.0341722938408,18
0.2,4887,93,415655,85.03580196399345,8
0.2,4888,25,415680,85.02352219267743,8
0.2,4889,89,415769,85.0243353783231,12
0.2,4890,92,415861,85.02576160294419,10
0.2,4891,26,415887,85.0136958299264,7
0.2,4892,96,415983,85.01594114040466,6
0.2,4893,93,416076,85.01757253780139,8
0.2,4894,93,416169,85.01920326864148,8
0.2,4895,92,416261,85.02062908496733,9
0.2,4896,93,416354,85.02225852562793,8
0.2,4897,93,416447,85.02388730093917,8
0.2,4898,93,416540,85.02551541130843,11
0.2,4899,96,416636,85.02775510204081,7
0.2,4900,95,416731,85.02978983880841,6
0.2,4901,87,416818,85.03019175846593,14
0.2,4902,93,416911,85.031817254742,8
0.2,4903,92,417003,85.03323817292006,9
0.2,4904,92,417095,85.03465851172272,9
0.2,4905,93,417188,85.03628210354668,8
0.2,4906,85,417273,85.03627470959853,16
0.2,4907,94,417367,85.0381010594947,7
0.2,4908,93,417460,85.03972295783255,9
0.2,4909,95,417555,85.04175152749491,6
0.2,4910,92,417647,85.04316839747506,9
0.2,4911,94,417741,85.04499185667753,7
0.2,4912,93,417834,85.04661103195603,8
0.2,4913,93,417927,85.04822954822954,8
0.2,4914,95,418022,85.05025432349949,8
0.2,4915,92,418114,85.05166802278275,10
0.2,4916,93,418207,85.05328452308318,8
0.2,4917,93,418300,85.05490036600244,8
0.2,4918,-50,418250,85.0274446025615,14
0.2,4919,95,418345,85.02947154471545,6
0.2,4920,89,418434,85.03027839869945,13
0.2,4921,86,418520,85.03047541649735,16
0.2,4922,82,418602,85.02985984156003,19
0.2,4923,93,418695,85.03147847278635,8
0.2,4924,96,418791,85.03370558375634,6
0.2,4925,92,418883,85.035119772635,9
0.2,4926,96,418979,85.03734524051147,6
0.2,4927,87,419066,85.03774350649351,14
0.2,4928,95,419161,85.03976465814567,7
0.2,4929,88,419249,85.04036511156187,14
0.2,4930,95,419344,85.0423849117826,8
0.2,4931,93,419437,85.04399837793999,9
0.2,4932,14,419451,85.02959659436448,19
0.2,4933,94,419545,85.03141467369275,7
0.2,4934,92,419637,85.03282674772036,10
0.2,4935,94,419731,85.03464343598056,8
0.2,4936,94,419825,85.03645938829249,8
0.2,4937,85,419910,85.03645200486027,16
0.2,4938,90,420000,85.03745697509618,12
0.2,4939,92,420092,85.03886639676114,11
0.2,4940,89,420181,85.03966808338393,14
0.2,4941,94,420275,85.04148118170781,7
0.2,4942,21,420296,85.02852518713333,14
0.2,4943,96,420392,85.03074433656958,6
0.2,4944,93,420485,85.03235591506572,9
0.2,4945,91,420576,85.03356247472705,12
0.2,4946,21,420597,85.02061855670104,13
0.2,4947,95,420692,85.02263540824576,7
0.2,4948,90,420782,85.02364113962416,11
0.2,4949,85,420867,85.02363636363637,17
0.2,4950,96,420963,85.02585336295698,6
0.2,4951,93,421056,85.02746365105008,8
0.2,4952,91,421147,85.02866949323642,10
0.2,4953,96,421243,85.0308841340331,6
0.2,4954,90,421333,85.0318869828456,12
0.2,4955,15,421348,85.01775625504439,17
0.2,4956,95,421443,85.01977002219084,8
0.2,4957,89,421532,85.02057281161758,12
0.2,4958,91,421623,85.02177858439201,10
0.2,4959,25,421648,85.00967741935484,9
0.2,4960,92,421740,85.01108647450111,9
0.2,4961,95,421835,85.0130995566304,6
0.2,4962,93,421928,85.01470884545638,8
0.2,4963,93,422021,85.01631748589847,8
0.2,4964,93,422114,85.01792547834845,10
0.2,4965,95,422209,85.01993556182038,8
0.2,4966,93,422302,85.02154217837729,8
0.2,4967,88,422390,85.02214170692432,13
0.2,4968,93,422483,85.02374723284363,8
0.2,4969,91,422574,85.02494969818913,10
0.2,4970,27,422601,85.0132770066385,6
0.2,4971,94,422695,85.01508447304907,8
0.2,4972,94,422789,85.01689121254776,7
0.2,4973,96,422885,85.01909931644552,6
0.2,4974,24,422909,85.00683417085428,10
0.2,4975,94,423003,85.00864147909968,7
0.2,4976,93,423096,85.01024713682942,8
0.2,4977,95,423191,85.01225391723584,6
0.2,4978,94,423285,85.01405904800161,7
0.2,4979,87,423372,85.0144578313253,15
0.2,4980,91,423463,85.01565950612327,10
0.2,4981,93,423556,85.01726214371739,10
0.2,4982,96,423652,85.0194661850291,6
0.2,4983,92,423744,85.02086677367576,9
0.2,4984,93,423837,85.02246740220662,8
0.2,4985,93,423930,85.02406738868832,8
0.2,4986,94,424024,85.02586725486265,8
0.2,4987,95,424119,85.02786688051323,8
0.2,4988,93,424212,85.02946482260974,8
0.2,4989,95,424307,85.0314629258517,6
0.2,4990,93,424400,85.03305950711281,8
0.2,4991,90,424490,85.03405448717949,13
0.2,4992,91,424581,85.03524934908873,10
0.2,4993,92,424673,85.03664397276732,9
0.2,4994,95,424768,85.03863863863864,6
0.2,4995,92,424860,85.04003202562049,9
0.2,4996,87,424947,85.04042425455273,15
0.2,4997,96,425043,85.04261704681873,6
0.2,4998,92,425135,85.04400880176036,9
0.2,4999,93,425228,85.0456,8
0.2,5000,94,425322,85.04739052189562,7
0.2,5001,88,425410,85.04798080767694,13
0.2,5002,94,425504,85.04977013791725,7
0.2,5003,94,425598,85.05155875299761,7
0.2,5004,92,425690,85.05294705294705,9
0.2,5005,91,425781,85.05413503795445,10
0.2,5006,89,425870,85.05492310764929,12
0.2,5007,91,425961,85.05611022364218,10
0.2,5008,90,426051,85.057097224995,11
0.2,5009,93,426144,85.05868263473054,8
0.2,5010,96,426240,85.0608660945919,6
0.2,5011,91,426331,85.06205107741421,10
0.2,5012,25,426356,85.05006981847197,7
0.2,5013,92,426448,85.05145592341444,10
0.2,5014,93,426541,85.05304087736789,8
0.2,5015,95,426636,85.05502392344498,6
0.2,5016,95,426731,85.05700617899143,8
0.2,5017,92,426823,85.05838979673176,9
0.2,5018,95,426918,85.06037059175135,6
0.2,5019,90,427008,85.06135458167331,11
0.2,5020,88,427096,85.061939852619,13
0.2,5021,95,427191,85.06391875746715,6
0.2,5022,95,427286,85.06589687437786,6
0.2,5023,92,427378,85.0672770700637,9
0.2,5024,94,427472,85.06905472636817,7
0.2,5025,95,427567,85.07103064066852,6
0.2,5026,90,427657,85.07201113984483,11
0.2,5027,91,427748,85.07319013524264,10
0.2,5028,88,427836,85.07377212169418,13
0.2,5029,19,427855,85.06063618290258,13
0.2,5030,92,427947,85.06201550387597,9
0.2,5031,96,428043,85.0641891891892,6
0.2,5032,96,428139,85.0663620107292,6
0.2,5033,91,428230,85.06754072308304,10
0.2,5034,96,428326,85.06971201588878,6
0.2,5035,93,428419,85.07128673550437,8
0.2,5036,91,428510,85.07246376811594,10
0.2,5037,96,428606,85.07463279078999,6
0.2,5038,92,428698,85.07600714427466,10
0.2,5039,90,428788,85.07698412698413,11
0.2,5040,91,428879,85.07815909541758,10
0.2,5041,94,428973,85.079928599762,8
0.2,5042,94,429067,85.08169740233987,8
0.2,5043,95,429162,85.08366375892149,6
0.2,5044,90,429252,85.0846382556987,11
0.2,5045,90,429342,85.08561236623068,11
0.2,5046,93,429435,85.08718050326927,9
0.2,5047,93,429528,85.08874801901743,8
0.2,5048,94,429622,85.09051297286591,7
0.2,5049,88,429710,85.0910891089109,13
0.2,5050,21,429731,85.07840031676896,11
0.2,5051,94,429825,85.08016627078385,7
0.2,5052,92,429917,85.08153572135365,9
0.2,5053,85,430002,85.08151958844479,17
0.2,5054,92,430094,85.08288822947577,9
0.2,5055,89,430183,85.08366297468355,14
0.2,5056,94,430277,85.08542614198142,7
0.2,5057,96,430373,85.08758402530644,6
0.2,5058,96,430469,85.08974105554458,6
0.2,5059,90,430559,85.0907114624506,12
0.2,5060,95,430654,85.0926694329184,6
0.2,5061,96,430750,85.09482418016594,6
0.2,5062,85,430835,85.09480545131345,16
0.2,5063,93,430928,85.09636650868879,8
0.2,5064,93,431021,85.0979269496545,8
0.2,5065,91,431112,85.09909198578761,10
0.2,5066,89,431201,85.099861851194,13
0.2,5067,89,431290,85.10063141278611,12
0.2,5068,96,431386,85.10278161373051,6
0.2,5069,92,431478,85.10414201183431,9
0.2,5070,88,431566,85.10471307434432,13
0.2,5071,92,431658,85.10607255520505,9
0.2,5072,27,431685,85.09461856889415,6
0.2,5073,94,431779,85.0963736696886,7
0.2,5074,95,431874,85.0983251231527,7
0.2,5075,87,431961,85.09869976359339,15
0.2,5076,93,432054,85.10025605672641,8
0.2,5077,91,432145,85.10141788105554,10
0.2,5078,86,432231,85.1015948021264,15
0.2,5079,92,432323,85.1029527559055,9
0.2,5080,93,432416,85.10450698681362,8
0.2,5081,88,432504,85.10507674144037,13
0.2,5082,94,432598,85.10682667715916,7
0.2,5083,96,432694,85.1089693154996,6
0.2,5084,93,432787,85.11052114060963,8
0.2,5085,94,432881,85.11226897365317,7
0.2,5086,83,432964,85.11185374483979,18
0.2,5087,96,433060,85.11399371069183,6
0.2,5088,89,433149,85.11475731970917,13
0.2,5089,91,433240,85.11591355599214,10
0.2,5090,95,433335,85.11785503830289,6
0.2,5091,96,433431,85.11999214454046,6
0.2,5092,93,433524,85.12153936775967,8
0.2,5093,93,433617,85.12308598351001,8
0.2,5094,94,433711,85.12482826300294,7
0.2,5095,91,433802,85.12598116169545,10
0.2,5096,94,433896,85.12772218952325,7
0.2,5097,92,433988,85.1290702236171,11
0.2,5098,94,434082,85.13080996273779,7
0.2,5099,93,434175,85.13235294117646,8
0.2,5100,91,434266,85.13350323465987,12
0.2,5101,95,434361,85.13543708349667,6
0.2,5102,94,434455,85.13717421124828,7
0.2,5103,93,434548,85.13871473354232,8
0.2,5104,86,434634,85.13888344760039,16
0.2,5105,95,434729,85.14081472777124,6
0.2,5106,94,434823,85.14254944194244,7
0.2,5107,94,434917,85.14428347689898,7
0.2,5108,87,435004,85.14464670189861,14
0.2,5109,96,435100,85.14677103718199,6
0.2,5110,91,435191,85.14791625904911,10
0.2,5111,93,435284,85.14945226917058,10
0.2,5112,88,435372,85.15000977899471,13
0.2,5113,23,435395,85.13785686351193,10
0.2,5114,88,435483,85.13841642228739,13
0.2,5115,92,435575,85.13975762314308,10
0.2,5116,96,435671,85.14188000781708,6
0.2,5117,88,435759,85.14243845252052,13
0.2,5118,96,435855,85.14455948427427,6
0.2,5119,92,435947,85.1458984375,10
0.2,5120,95,436042,85.14782269088069,6
0.2,5121,95,436137,85.1497461928934,6
0.2,5122,94,436231,85.15147374585204,9
0.2,5123,96,436327,85.15359094457455,6
0.2,5124,91,436418,85.15473170731707,10
0.2,5125,93,436511,85.15626219274289,9
0.2,5126,92,436603,85.1575970353033,9
0.2,5127,95,436698,85.15951638065522,6
0.2,5128,95,436793,85.16143497757848,8
0.2,5129,95,436888,85.16335282651072,6
0.2,5130,94,436982,85.16507503410641,7
0.2,5131,96,437078,85.1671862821512,6
0.2,5132,94,437172,85.16890707188779,7
0.2,5133,92,437264,85.17023763147643,9
0.2,5134,92,437356,85.17156767283349,9
0.2,5135,88,437444,85.1721183800623,13
0.2,5136,92,437536,85.17344753747324,10
0.2,5137,94,437630,85.17516543402103,8
0.2,5138,95,437725,85.17707725238373,7
0.2,5139,93,437818,85.17859922178988,10
0.2,5140,94,437912,85.1803151137911,8
0.2,5141,94,438006,85.18203033838974,7
0.2,5142,91,438097,85.18316157884503,10
0.2,5143,95,438192,85.1850699844479,6
0.2,5144,17,438209,85.1718172983479,16
0.2,5145,92,438301,85.17314418966187,9
0.2,5146,96,438397,85.17524771711676,6
0.2,5147,96,438493,85.17735042735043,6
0.2,5148,96,438589,85.179452320839,6
0.2,5149,90,438679,85.18038834951456,12
0.2,5150,17,438696,85.16715200931858,16
0.2,5151,95,438791,85.16906055900621,6
0.2,5152,91,438882,85.1701921210945,10
0.2,5153,92,438974,85.17151726814124,9
0.2,5154,89,439063,85.17225994180407,13
0.2,5155,94,439157,85.17397207137316,7
0.2,5156,92,439249,85.17529571456274,9
0.2,5157,96,439345,85.17739433889105,6
0.2,5158,91,439436,85.17852296956775,11
0.2,5159,85,439521,85.17848837209303,17
0.2,5160,96,439617,85.18058515791513,6
0.2,5161,21,439638,85.16815187911662,11
0.2,5162,85,439723,85.1681193104784,16
0.2,5163,90,439813,85.16905499612703,11
0.2,5164,92,439905,85.1703775411423,9
0.2,5165,96,440001,85.17247386759581,6
0.2,5166,95,440096,85.17437584671957,6
0.2,5167,96,440192,85.17647058823529,6
0.2,5168,25,440217,85.16482878699942,8
0.2,5169,93,440310,85.16634429400386,8
0.2,5170,24,440334,85.15451556758848,9
0.2,5171,22,440356,85.14230471771074,10
0.2,5172,89,440445,85.14305045428185,12
0.2,5173,91,440536,85.14418245071512,10
0.2,5174,94,440630,85.14589371980676,7
0.2,5175,94,440724,85.14760432766616,7
0.2,5176,17,440741,85.1344407958277,17
0.2,5177,93,440834,85.13595983005021,8
0.2,5178,92,440926,85.13728519019115,9
0.2,5179,95,441021,85.1391891891892,8
0.2,5180,93,441114,85.14070642733063,8
0.2,5181,84,441198,85.14048629872636,18
0.2,5182,93,441291,85.14200270113834,9
0.2,5183,92,441383,85.14332561728395,9
0.2,5184,89,441472,85.14406943105111,12
0.2,5185,94,441566,85.14577709217123,7
0.2,5186,91,441657,85.14690572585309,12
0.2,5187,91,441748,85.14803392444102,10
0.2,5188,95,441843,85.14993254962421,6
0.2,5189,94,441937,85.15163776493256,8
0.2,5190,90,442027,85.15257175881334,11
0.2,5191,94,442121,85.15427580893683,7
0.2,5192,93,442214,85.15578663585596,8
0.2,5193,27,442241,85.14458991143627,6
0.2,5194,94,442335,85.14629451395572,7
0.2,5195,27,442362,85.135103926097,6
0.2,5196,90,442452,85.13604002309025,11
0.2,5197,94,442546,85.13774528664871,7
0.2,5198,22,442568,85.12560107713021,10
0.2,5199,95,442663,85.1275,6
0.2,5200,92,442755,85.12882138050375,9
0.2,5201,94,442849,85.13052672049211,7
0.2,5202,95,442944,85.13242360176821,7
0.2,5203,96,443040,85.13451191391238,6
0.2,5204,92,443132,85.13583093179635,9
0.2,5205,92,443224,85.13714944295045,9
0.2,5206,82,443306,85.13654695602074,20
0.2,5207,94,443400,85.13824884792626,7
0.2,5208,8,443408,85.12344019965444,24
0.2,5209,95,443503,85.1253358925144,6
0.2,5210,87,443590,85.12569564383035,16
0.2,5211,89,443679,85.12643898695319,12
0.2,5212,91,443770,85.12756570113179,10
0.2,5213,90,443860,85.12850019179133,11
0.2,5214,95,443955,85.13039309683604,6
0.2,5215,94,444049,85.13209355828221,8
0.2,5216,92,444141,85.13341000575043,11
0.2,5217,87,444228,85.1337677270985,16
0.2,5218,87,444315,85.13412531136233,15
0.2,5219,94,444409,85.13582375478927,8
0.2,5220,92,444501,85.13713847921854,10
0.2,5221,85,444586,85.13711221754117,16
0.2,5222,95,444681,85.13900057438254,6
0.2,5223,96,444777,85.14107963246555,6
0.2,5224,95,444872,85.14296650717704,6
0.2,5225,82,444954,85.14236509758898,20
0.2,5226,89,445043,85.14310311842357,12
0.2,5227,94,445137,85.14479724560061,7
0.2,5228,92,445229,85.14610824249378,9
0.2,5229,92,445321,85.14741873804971,9
0.2,5230,91,445412,85.14853756451922,10
0.2,5231,91,445503,85.14965596330275,11
0.2,5232,85,445588,85.14962736480031,16
0.2,5233,93,445681,85.15112724493694,8
0.2,5234,91,445772,85.15224450811843,10
0.2,5235,95,445867,85.15412528647823,6
0.2,5236,90,445957,85.1550506014894,11
0.2,5237,93,446050,85.1565483008782,8
0.2,5238,90,446140,85.1574728001527,11
0.2,5239,83,446223,85.15706106870229,18
0.2,5240,93,446316,85.15855752718947,10
0.2,5241,90,446406,85.1594811140786,11
0.2,5242,96,446502,85.16154873164218,6
0.2,5243,19,446521,85.14893211289092,13
0.2,5244,94,446615,85.15061963775024,7
0.2,5245,93,446708,85.15211589782692,8
0.2,5246,92,446800,85.1534210024776,9
0.2,5247,90,446890,85.15434451219512,11
0.2,5248,96,446986,85.1564107449038,6
0.2,5249,93,447079,85.15790476190476,8
0.2,5250,93,447172,85.15939820986479,8
0.2,5251,93,447265,85.16089108910892,8
0.2,5252,91,447356,85.16200266514373,10
0.2,5253,90,447446,85.16292348686714,12
0.2,5254,93,447539,85.16441484300665,9
0.2,5255,94,447633,85.16609589041096,7
0.2,5256,94,447727,85.16777629826898,8
0.2,5257,93,447820,85.16926588056295,9
0.2,5258,92,447912,85.17056474614945,9
0.2,5259,95,448007,85.17243346007605,8
0.2,5260,94,448101,85.17411138566813,7
0.2,5261,95,448196,85.17597871531737,6
0.2,5262,86,448282,85.17613528405852,15
0.2,5263,94,448376,85.17781155015197,7
0.2,5264,95,448471,85.17967711301044,8
0.2,5265,85,448556,85.1796429927839,16
0.2,5266,93,448649,85.18112777672299,8
0.2,5267,96,448745,85.1831814730448,6
0.2,5268,95,448840,85.18504460049346,7
0.2,5269,94,448934,85.18671726755218,8
0.2,5270,94,449028,85.18838929994308,8
0.2,5271,94,449122,85.19006069802731,7
0.2,5272,87,449209,85.19040394462355,15
0.2,5273,25,449234,85.17899127796738,8
0.2,5274,94,449328,85.180663507109,7
0.2,5275,94,449422,85.18233510235027,7
0.2,5276,23,449445,85.17055144968732,9
0.2,5277,93,449538,85.17203486169004,8
0.2,5278,92,449630,85.17332828187156,9
0.2,5279,20,449650,85.16098484848484,13
0.2,5280,90,449740,85.16190115508427,11
0.2,5281,93,449833,85.16338508140856,8
0.2,5282,92,449925,85.16467915956842,10
0.2,5283,87,450012,85.16502649507949,14
0.2,5284,91,450103,85.16613055818354,10
0.2,5285,-115,449988,85.1282633371169,10
0.2,5286,94,450082,85.12994136561377,7
0.2,5287,92,450174,85.13124054462935,9
0.2,5288,93,450267,85.13272830402722,8
0.2,5289,91,450358,85.13383742911154,10
0.2,5290,94,450452,85.13551313551314,7
0.2,5291,90,450542,85.13643235071807,11
0.2,5292,95,450637,85.13829586245986,6
0.2,5293,96,450733,85.14034756327918,6
0.2,5294,93,450826,85.14183191690273,8
0.2,5295,95,450921,85.14369335347432,6
0.2,5296,92,451013,85.14498772890315,9
0.2,5297,95,451108,85.14684786711967,6
0.2,5298,90,451198,85.14776372900548,11
0.2,5299,94,451292,85.14943396226415,7
0.2,5300,96,451388,85.15148085266931,6
0.2,5301,92,451480,85.15277253866465,10
0.2,5302,90,451570,85.15368659249481,11
0.2,5303,88,451658,85.15422322775264,13
0.2,5304,95,451753,85.15607917059378,8
0.2,5305,90,451843,85.15699208443272,12
0.2,5306,93,451936,85.1584699453552,8
0.2,5307,96,452032,85.1605124340618,6
0.2,5308,94,452126,85.16217743454511,8
0.2,5309,93,452219,85.16365348399246,8
0.2,5310,93,452312,85.16512897759367,8
0.2,5311,85,452397,85.16509789156626,16
0.2,5312,90,452487,85.16600790513834,11
0.2,5313,27,452514,85.15506210011291,6
0.2,5314,27,452541,85.14412041392286,6
0.2,5315,91,452632,85.14522197140707,10
0.2,5316,94,452726,85.14688734248637,7
0.2,5317,95,452821,85.14874012786763,7
0.2,5318,90,452911,85.14965219026132,11
0.2,5319,94,453005,85.15131578947368,7
0.2,5320,91,453096,85.15241495959405,10
0.2,5321,20,453116,85.14017286734311,12
0.2,5322,96,453212,85.14221303776065,6
0.2,5323,94,453306,85.14387678437265,7
0.2,5324,94,453400,85.14553990610328,8
0.2,5325,23,453423,85.13387157341344,10
0.2,5326,93,453516,85.1353482260184,8
0.2,5327,88,453604,85.13588588588588,13
0.2,5328,91,453695,85.13698630136986,10
0.2,5329,94,453789,85.13864915572232,9
0.2,5330,91,453880,85.13974864003,10
0.2,5331,93,453973,85.14122280570143,8
0.2,5332,92,454065,85.14250890680668,10
0.2,5333,94,454159,85.14416947881514,8
0.2,5334,91,454250,85.14526710403,10
0.2,5335,94,454344,85.14692653673164,7
0.2,5336,94,454438,85.14858534757354,7
0.2,5337,91,454529,85.14968152866243,10
0.2,5338,93,454622,85.15115190110508,8
0.2,5339,94,454716,85.15280898876405,7
0.2,5340,89,454805,85.15352930162891,12
0.2,5341,94,454899,85.15518532384874,7
0.2,5342,92,454991,85.15646640464159,9
0.2,5343,96,455087,85.15849550898204,6
0.2,5344,96,455183,85.16052385406923,6
0.2,5345,94,455277,85.162177328844,8
0.2,5346,93,455370,85.16364316439125,8
0.2,5347,90,455460,85.16454749439043,11
0.2,5348,73,455533,85.16227332211628,28
0.2,5349,93,455626,85.16373831775701,9
0.2,5350,93,455719,85.16520276583816,10
0.2,5351,79,455798,85.16405082212258,22
0.2,5352,86,455884,85.1642069867364,15
0.2,5353,92,455976,85.16548375046695,9
0.2,5354,92,456068,85.16676003734827,10
0.2,5355,23,456091,85.15515309932786,13
0.2,5356,94,456185,85.15680418144484,7
0.2,5357,88,456273,85.15733482642777,13
0.2,5358,94,456367,85.15898488523979,7
0.2,5359,88,456455,85.15951492537313,13
0.2,5360,24,456479,85.14810669651185,8
0.2,5361,96,456575,85.15013054830287,6
0.2,5362,94,456669,85.15178071974641,7
0.2,5363,92,456761,85.15305741983595,9
0.2,5364,94,456855,85.1547064305685,7
0.2,5365,96,456951,85.15672754379426,6
0.2,5366,91,457042,85.15781628470282,11
0.2,5367,93,457135,85.15927719821163,9
0.2,5368,92,457227,85.16055131309369,9
0.2,5369,94,457321,85.16219739292364,7
0.2,5370,92,457413,85.16347048966674,9
0.2,5371,87,457500,85.1638123603872,14
0.2,5372,92,457592,85.16508468267263,10
0.2,5373,96,457688,85.1671008559732,6
0.2,5374,96,457784,85.16911627906977,6
0.2,5375,95,457879,85.17094494047619,6
0.2,5376,96,457975,85.17295889901432,6
0.2,5377,96,458071,85.17497210859055,6
0.2,5378,88,458159,85.17549730433166,13
0.2,5379,95,458254,85.17732342007434,6
0.2,5380,92,458346,85.17859133989964,9
0.2,5381,91,458437,85.17967298402081,11
0.2,5382,92,458529,85.1809399962846,9
0.2,5383,13,458542,85.16753343239228,20
0.2,5384,96,458638,85.16954503249768,6
0.2,5385,84,458722,85.16932788711475,17
0.2,5386,92,458814,85.17059587896789,9
0.2,5387,95,458909,85.17242019302152,7
0.2,5388,93,459002,85.17387270365559,8
0.2,5389,84,459086,85.17365491651206,18
0.2,5390,90,459176,85.17455017621963,11
0.2,5391,95,459271,85.17637240356083,6
0.2,5392,92,459363,85.1776376784721,11
0.2,5393,26,459389,85.16666666666667,8
0.2,5394,95,459484,85.16848934198332,9
0.2,5395,95,459579,85.17031134173462,7
0.2,5396,89,459668,85.1710209375579,12
0.2,5397,88,459756,85.17154501667284,13
0.2,5398,88,459844,85.17206890164846,13
0.2,5399,93,459937,85.17351851851852,8
0.2,5400,85,460022,85.173486391409,16
0.2,5401,94,460116,85.17512032580525,7
0.2,5402,94,460210,85.17675365537664,7
0.2,5403,92,460302,85.1780162842339,9
0.2,5404,86,460388,85.17816836262719,15
0.2,5405,93,460481,85.17961524232335,9
0.2,5406,92,460573,85.1808766413908,9
0.2,5407,92,460665,85.1821375739645,9
0.2,5408,89,460754,85.18284340913293,12
0.2,5409,96,460850,85.18484288354898,6
0.2,5410,96,460946,85.18684161892442,7
0.2,5411,87,461033,85.18717664449372,14
0.2,5412,93,461126,85.18861998891558,8
0.2,5413,94,461220,85.19024750646471,7
0.2,5414,25,461245,85.17913204062789,7
0.2,5415,95,461340,85.18094534711965,7
0.2,5416,24,461364,85.16965109839394,8
0.2,5417,93,461457,85.17109634551495,8
0.2,5418,90,461547,85.17198745155933,12
0.2,5419,93,461640,85.17343173431735,8
0.2,5420,92,461732,85.17469101641764,9
0.2,5421,24,461756,85.16340833640723,9
0.2,5422,96,461852,85.16540660151207,8
0.2,5423,88,461940,85.16592920353982,13
0.2,5424,93,462033,85.1673732718894,8
0.2,5425,93,462126,85.16881680796166,8
0.2,5426,92,462218,85.170075548185,11
0.2,5427,-47,462171,85.14572586588062,11
0.2,5428,93,462264,85.1471725916375,8
0.2,5429,92,462356,85.14843462246778,9
0.2,5430,91,462447,85.14951206039403,10
0.2,5431,90,462537,85.15040500736377,11
0.2,5432,88,462625,85.1509295048776,13
0.2,5433,93,462718,85.15237394184763,8
0.2,5434,95,462813,85.1541858325667,8
0.2,5435,95,462908,85.1559970566593,6
0.2,5436,92,463000,85.15725583961743,10
0.2,5437,92,463092,85.15851415961751,10
0.2,5438,94,463186,85.16013973156831,7
0.2,5439,20,463206,85.14816176470588,13
0.2,5440,93,463299,85.14960485204925,8
0.2,5441,93,463392,85.1510474090408,8
0.2,5442,93,463485,85.15248943597281,8
0.2,5443,21,463506,85.14070536370316,11
0.2,5444,91,463597,85.14178145087236,10
0.2,5445,88,463685,85.14230627983841,13
0.2,5446,88,463773,85.1428309161006,13
0.2,5447,25,463798,85.13179148311306,7
0.2,5448,90,463888,85.13268489631125,11
0.2,5449,92,463980,85.13394495412844,9
0.2,5450,20,464000,85.1219959640433,12
0.2,5451,89,464089,85.12270726338959,12
0.2,5452,94,464183,85.12433522831469,8
0.2,5453,89,464272,85.12504583791713,12
0.2,5454,91,464363,85.12612282309807,10
0.2,5455,88,464451,85.1266495601173,13
0.2,5456,92,464543,85.12790910756826,9
0.2,5457,94,464637,85.1295346280689,8
0.2,5458,85,464722,85.12951089943213,17
0.2,5459,92,464814,85.13076923076923,10
0.2,5460,90,464904,85.1316608679729,12
0.2,5461,92,464996,85.1329183449286,10
0.2,5462,92,465088,85.13417536152298,9
0.2,5463,96,465184,85.13616398243046,6
0.2,5464,92,465276,85.13741994510522,10
0.2,5465,93,465369,85.13885839736554,8
0.2,5466,92,465461,85.14011340771904,9
0.2,5467,91,465552,85.14118507681053,10
0.2,5468,90,465642,85.14207350521119,11
0.2,5469,94,465736,85.1436928702011,8
0.2,5470,92,465828,85.14494607932737,10
0.2,5471,95,465923,85.14674707602339,6
0.2,5472,95,466018,85.14854741458066,6
0.2,5473,83,466101,85.14815491413957,18
0.2,5474,92,466193,85.14940639269406,9
0.2,5475,89,466282,85.15010956902849,12
0.2,5476,22,466304,85.13857951433266,11
0.2,5477,92,466396,85.13983205549471,9
0.2,5478,95,466491,85.14163168461398,6
0.2,5479,94,466585,85.14324817518248,7
0.2,5480,94,466679,85.14486407589855,7
0.2,5481,94,466773,85.14647938708501,7
0.2,5482,94,466867,85.14809410906437,7
0.2,5483,-51,466816,85.12326768781911,19
0.2,5484,85,466901,85.1232452142206,16
0.2,5485,95,466996,85.12504557054321,7
0.2,5486,90,467086,85.12593402587935,11
0.2,5487,91,467177,85.12700437317784,11
0.2,5488,93,467270,85.12843869557297,8
0.2,5489,96,467366,85.1304189435337,6
0.2,5490,96,467462,85.132398470224,6
0.2,5491,92,467554,85.13364894391843,9
0.2,5492,96,467650,85.13562716184235,6
0.2,5493,92,467742,85.13687659264653,10
0.2,5494,91,467833,85.13794358507734,10
0.2,5495,93,467926,85.13937409024746,8
0.2,5496,83,468009,85.13898490085501,18
0.2,5497,18,468027,85.12677337213532,15
0.2,5498,27,468054,85.11620294599018,6
0.2,5499,95,468149,85.118,6
0.2,5500,92,468241,85.11925104526449,9
0.2,5501,94,468335,85.1208651399491,8
0.2,5502,83,468418,85.12047973832455,18
0.2,5503,92,468510,85.1217296511628,9
0.2,5504,95,468605,85.12352406902815,8
0.2,5505,94,468699,85.12513621503814,7
0.2,5506,95,468794,85.12692936262938,7
0.2,5507,10,468804,85.11328976034858,24
0.2,5508,95,468899,85.11508440733346,7
0.2,5509,91,468990,85.11615245009074,10
0.2,5510,95,469085,85.11794592632916,8
0.2,5511,95,469180,85.11973875181422,7
0.2,5512,95,469275,85.12153092690005,8
0.2,5513,94,469369,85.12314109539355,8
0.2,5514,93,469462,85.124569356301,8
0.2,5515,92,469554,85.12581580855692,9
0.2,5516,93,469647,85.12724306688418,9
0.2,5517,95,469742,85.12903225806451,6
0.2,5518,89,469831,85.12973364739989,12
0.2,5519,91,469922,85.13079710144928,11
0.2,5520,93,470015,85.132222423474,9
0.2,5521,94,470109,85.13382832307136,8
0.2,5522,91,470200,85.13489045808437,10
0.2,5523,95,470295,85.13667632150616,8
0.2,5524,94,470389,85.13828054298642,8
0.2,5525,93,470482,85.13970322113644,11
0.2,5526,92,470574,85.14094445449611,9
0.2,5527,87,470661,85.14128075253257,14
0.2,5528,22,470683,85.12986073431,10
0.2,5529,91,470774,85.13092224231465,10
0.2,5530,93,470867,85.13234496474416,9
0.2,5531,94,470961,85.13394793926247,8
0.2,5532,24,470985,85.12289896981746,9
0.2,5533,18,471003,85.11076978677268,14
0.2,5534,26,471029,85.10009033423668,8
0.2,5535,17,471046,85.08778901734104,17
0.2,5536,85,471131,85.0877731623623,16
0.2,5537,93,471224,85.08920187793427,8
0.2,5538,93,471317,85.09063007763135,8
0.2,5539,92,471409,85.09187725631769,9
0.2,5540,91,471500,85.09294351200144,10
0.2,5541,90,471590,85.09382894262,13
0.2,5542,89,471679,85.09453364604005,15
0.2,5543,92,471771,85.09577922077922,9
0.2,5544,96,471867,85.09774571686204,6
0.2,5545,90,471957,85.09862964298594,12
0.2,5546,93,472050,85.10005408328827,8
0.2,5547,87,472137,85.10039653929344,14
0.2,5548,94,472231,85.10200036042531,8
0.2,5549,92,472323,85.10324324324324,9
0.2,5550,93,472416,85.1046658259773,9
0.2,5551,89,472505,85.1053674351585,13
0.2,5552,92,472597,85.10660904015847,9
0.2,5553,95,472692,85.1083903492978,6
0.2,5554,91,472783,85.10945094509451,10
0.2,5555,96,472879,85.11141108711303,6
0.2,5556,95,472974,85.11319057045168,6
0.2,5557,95,473069,85.11496941345808,6
0.2,5558,94,473163,85.11656772800863,8
0.2,5559,92,473255,85.11780575539568,9
0.2,5560,96,473351,85.11976263262004,6
0.2,5561,95,473446,85.1215390147429,6
0.2,5562,89,473535,85.12223620348733,12
0.2,5563,87,473622,85.12257368799425,16
0.2,5564,93,473715,85.12398921832884,10
0.2,5565,95,473810,85.12576356449874,6
0.2,5566,93,473903,85.12717801329262,8
0.2,5567,22,473925,85.11584051724138,11
0.2,5568,94,474019,85.11743580535105,7
0.2,5569,90,474109,85.11831238779175,11
0.2,5570,92,474201,85.11954765751211,9
0.2,5571,94,474295,85.12114142139268,7
0.2,5572,88,474383,85.12165799389916,13
0.2,5573,96,474479,85.12360961607463,6
0.2,5574,88,474567,85.12412556053812,13
0.2,5575,89,474656,85.1248206599713,12
0.2,5576,95,474751,85.12659135736058,6
0.2,5577,87,474838,85.12692721405521,15
0.2,5578,94,474932,85.12851765549381,8
0.2,5579,93,475025,85.12992831541219,9
0.2,5580,90,475115,85.13080093173267,11
0.2,5581,92,475207,85.1320315299176,9
0.2,5582,86,475293,85.13218699623859,15
0.2,5583,91,475384,85.13323782234957,11
0.2,5584,96,475480,85.13518352730529,6
0.2,5585,90,475570,85.1360544217687,12
0.2,5586,90,475660,85.13692500447468,13
0.2,5587,93,475753,85.13833214030065,8
0.2,5588,92,475845,85.13955984970478,9
0.2,5589,95,475940,85.14132379248659,6
0.2,5590,94,476034,85.14290824539438,7
0.2,5591,9,476043,85.12929184549357,25
0.2,5592,22,476065,85.11800464866798,10
0.2,5593,95,476160,85.11977118341079,6
0.2,5594,95,476255,85.12153708668454,7
0.2,5595,92,476347,85.12276626161544,9
0.2,5596,96,476443,85.12470966589244,6
0.2,5597,94,476537,85.12629510539479,7
0.2,5598,92,476629,85.12752277192355,9
0.2,5599,94,476723,85.12910714285714,8
0.2,5600,93,476816,85.13051240849848,8
0.2,5601,84,476900,85.13031060335594,17
0.2,5602,96,476996,85.1322505800464,6
0.2,5603,94,477090,85.13383297644539,8
0.2,5604,92,477182,85.13505798394291,11
0.2,5605,92,477274,85.136282554406,9
0.2,5606,86,477360,85.13643659711076,15
0.2,5607,92,477452,85.1376604850214,9
0.2,5608,88,477540,85.1381707969335,13
0.2,5609,93,477633,85.13957219251337,8
0.2,5610,93,477726,85.14097308857602,8
0.2,5611,93,477819,85.14237348538845,8
0.2,5612,96,477915,85.14430785676109,6
0.2,5613,93,478008,85.14570716066976,8
0.2,5614,85,478093,85.14568121104185,16
0.2,5615,91,478184,85.14672364672364,10
0.2,5616,92,478276,85.14794374221114,9
0.2,5617,92,478368,85.14916340334639,9
0.2,5618,95,478463,85.15091653319097,6
0.2,5619,94,478557,85.15249110320285,7
0.2,5620,96,478653,85.15442092154422,6
0.2,5621,94,478747,85.15599430807542,7
0.2,5622,91,478838,85.15703361195092,11
0.2,5623,94,478932,85.15860597439544,7
0.2,5624,26,478958,85.14808888888889,6
0.2,5625,93,479051,85.14948453608247,11
0.2,5626,94,479145,85.1510574018127,7
0.2,5627,91,479236,85.15209665955935,10
0.2,5628,86,479322,85.15224729081542,15
0.2,5629,84,479406,85.15204262877442,17
0.2,5630,94,479500,85.15361392292665,8
0.2,5631,94,479594,85.1551846590909,7
0.2,5632,87,479681,85.15551216048287,14
0.2,5633,91,479772,85.15654952076677,10
0.2,5634,25,479797,85.14587400177463,9
0.2,5635,26,479823,85.13537970191625,8
0.2,5636,92,479915,85.13659748092957,10
0.2,5637,90,480005,85.1374600922313,11
0.2,5638,88,480093,85.1379677247739,13
0.2,5639,91,480184,85.13900709219858,10
0.2,5640,22,480206,85.12781421733735,10
0.2,5641,91,480297,85.12885501595179,10
0.2,5642,93,480390,85.13024986709198,8
0.2,5643,89,480479,85.13093550673281,13
0.2,5644,92,480571,85.13215234720992,10
0.2,5645,94,480665,85.13372298972725,7
0.2,5646,93,480758,85.13511599079158,8
0.2,5647,93,480851,85.13650849858357,8
0.2,5648,94,480945,85.13807753584705,7
0.2,5649,25,480970,85.12743362831858,8
0.2,5650,95,481065,85.12918067598655,6
0.2,5651,94,481159,85.13075017692852,8
0.2,5652,92,481251,85.13196532814435,9
0.2,5653,94,481345,85.13353378139371,9
0.2,5654,94,481439,85.13510167992926,8
0.2,5655,94,481533,85.13666902404526,8
0.2,5656,93,481626,85.13805904189499,9
0.2,5657,90,481716,85.13891834570519,11
0.2,5658,94,481810,85.14048418448489,7
0.2,5659,84,481894,85.14028268551236,17
0.2,5660,93,481987,85.14167108284755,8
0.2,5661,96,482083,85.14358883786647,6
0.2,5662,94,482177,85.1451527458944,7
0.2,5663,94,482271,85.14671610169492,7
0.2,5664,92,482363,85.14792586054722,9
0.2,5665,96,482459,85.14984115778327,6
0.2,5666,94,482553,85.15140285865537,7
0.2,5667,93,482646,85.15278757939308,9
0.2,5668,92,482738,85.1539954136532,9
0.2,5669,95,482833,85.15573192239859,9
0.2,5670,27,482860,85.14547698818551,6
0.2,5671,27,482887,85.13522566995769,6
0.2,5672,93,482980,85.13661202185793,8
0.2,5673,92,483072,85.13782164258019,11
0.2,5674,94,483166,85.1393832599119,7
0.2,5675,94,483260,85.14094432699083,9
0.2,5676,93,483353,85.14232869473314,8
0.2,5677,94,483447,85.14388869320183,7
0.2,5678,91,483538,85.14491988026062,10
0.2,5679,96,483634,85.1468309859155,6
0.2,5680,96,483730,85.1487414187643,6
0.2,5681,89,483819,85.14941921858501,12
0.2,5682,92,483911,85.15062467006862,10
0.2,5683,87,483998,85.15095003518648,14
0.2,5684,94,484092,85.15250659630607,7
0.2,5685,93,484185,85.15388673935983,9
0.2,5686,92,484277,85.15509055741164,9
0.2,5687,93,484370,85.15646976090014,8
0.2,5688,83,484453,85.15609070135349,19
0.2,5689,94,484547,85.15764499121265,7
0.2,5690,93,484640,85.15902301880162,8
0.2,5691,83,484723,85.15864371047084,18
0.2,5692,84,484807,85.15844018970665,17
0.2,5693,96,484903,85.16034422198805,6
0.2,5694,87,484990,85.16066725197541,14
0.2,5695,93,485083,85.16204353932584,8
0.2,5696,93,485176,85.16341934351414,8
0.2,5697,93,485269,85.16479466479467,9
0.2,5698,92,485361,85.16599403404106,9
0.2,5699,27,485388,85.15578947368421,6
0.2,5700,90,485478,85.1566391861077,11
0.2,5701,96,485574,85.15854086285513,6
0.2,5702,85,485659,85.15851306330002,16
0.2,5703,90,485749,85.15936185133239,11
0.2,5704,94,485843,85.16091148115687,8
0.2,5705,93,485936,85.16228531370487,8
0.2,5706,93,486029,85.16365866479762,8
0.2,5707,94,486123,85.16520672740015,7
0.2,5708,91,486214,85.16622876160449,11
0.2,5709,89,486303,85.16690017513135,12
0.2,5710,96,486399,85.16879705830853,6
0.2,5711,95,486494,85.17051820728291,6
0.2,5712,92,486586,85.171713635568,10
0.2,5713,82,486668,85.1711585579279,19
0.2,5714,19,486687,85.15958005249344,13
0.2,5715,84,486771,85.15937718684394,17
0.2,5716,94,486865,85.16092356130838,7
0.2,5717,22,486887,85.14987757957327,10
0.2,5718,93,486980,85.15125021856969,8
0.2,5719,92,487072,85.15244755244755,10
0.2,5720,91,487163,85.15346967313407,10
0.2,5721,92,487255,85.15466620062915,9
0.2,5722,96,487351,85.15656124410275,6
0.2,5723,93,487444,85.15793151642208,8
0.2,5724,87,487531,85.15825327510917,14
0.2,5725,92,487623,85.15944813133078,9
0.2,5726,94,487717,85.16099179326,7
0.2,5727,90,487807,85.16183659217877,11
0.2,5728,91,487898,85.16285564670972,10
0.2,5729,25,487923,85.1523560209424,8
0.2,5730,89,488012,85.15302739487001,12
0.2,5731,94,488106,85.15457083042568,7
0.2,5732,92,488198,85.15576487005059,9
0.2,5733,90,488288,85.15660969654691,11
0.2,5734,-44,488244,85.13408892763732,8
0.2,5735,95,488339,85.1358089260809,6
0.2,5736,91,488430,85.13683109639184,10
0.2,5737,89,488519,85.13750435691878,12
0.2,5738,92,488611,85.13870012197246,10
0.2,5739,84,488695,85.13850174216027,17
0.2,5740,92,488787,85.13969691691344,9
0.2,5741,90,488877,85.14054336468129,11
0.2,5742,86,488963,85.14069301758663,16
0.2,5743,95,489058,85.14240947075209,6
0.2,5744,93,489151,85.1437771975631,8
0.2,5745,27,489178,85.13365819700661,6
0.2,5746,92,489270,85.13485296676527,9
0.2,5747,95,489365,85.1365692414753,7
0.2,5748,94,489459,85.13811097582189,7
0.2,5749,27,489486,85.128,6
0.2,5750,94,489580,85.12954268822813,8
0.2,5751,92,489672,85.1307371349096,9
0.2,5752,93,489765,85.13210498870154,8
0.2,5753,93,489858,85.13347236704901,8
0.2,5754,94,489952,85.13501303214596,7
0.2,5755,93,490045,85.13637943015983,8
0.2,5756,94,490139,85.1379190550634,7
0.2,5757,95,490234,85.13963181660299,6
0.2,5758,92,490326,85.14082305955895,9
0.2,5759,94,490420,85.14236111111111,7
0.2,5760,90,490510,85.1432043048082,11
0.2,5761,95,490605,85.1449149600833,8
0.2,5762,95,490700,85.1466250216901,6
0.2,5763,90,490790,85.14746703678001,12
0.2,5764,93,490883,85.14882914137034,8
0.2,5765,92,490975,85.15001734304543,9
0.2,5766,92,491067,85.1512051326513,9
0.2,5767,95,491162,85.15291262135922,7
0.2,5768,93,491255,85.15427283758017,9
0.2,5769,88,491343,85.15476603119583,13
0.2,5770,94,491437,85.15629873505458,7
0.2,5771,89,491526,85.15696465696466,12
0.2,5772,87,491613,85.15728390784687,14
0.2,5773,92,491705,85.15846899896086,9
0.2,5774,26,491731,85.1482251082251,7
0.2,5775,92,491823,85.14941135734072,10
0.2,5776,95,491918,85.15111649645145,8
0.2,5777,22,491940,85.14018691588785,10
0.2,5778,91,492031,85.14120089980966,10
0.2,5779,90,492121,85.14204152249135,12
0.2,5780,89,492210,85.14270887389725,14
0.2,5781,93,492303,85.14406779661017,8
0.2,5782,83,492386,85.14369704305723,20
0.2,5783,94,492480,85.14522821576763,7
0.2,5784,92,492572,85.14641313742437,9
0.2,5785,95,492667,85.14811614241272,6
0.2,5786,91,492758,85.14912735441507,10
0.2,5787,96,492854,85.15100207325501,6
0.2,5788,90,492944,85.15183969597513,11
0.2,5789,91,493035,85.15284974093264,10
0.2,5790,92,493127,85.15403211880505,10
0.2,5791,94,493221,85.15555939226519,7
0.2,5792,93,493314,85.1569135163128,9
0.2,5793,92,493406,85.15809458060062,9
0.2,5794,94,493500,85.15962036238136,7
0.2,5795,94,493594,85.16114561766736,7
0.2,5796,96,493690,85.16301535276867,6
0.2,5797,89,493779,85.16367713004485,13
0.2,5798,91,493870,85.1646835661321,10
0.2,5799,92,493962,85.16586206896552,10
0.2,5800,90,494052,85.16669539734528,11
0.2,5801,91,494143,85.16770079283006,10
0.2,5802,94,494237,85.16922281578493,8
0.2,5803,95,494332,85.17091660923501,8
0.2,5804,92,494424,85.17209302325581,9
0.2,5805,92,494516,85.17326903203582,9
0.2,5806,93,494609,85.17461684174272,8
0.2,5807,89,494698,85.17527548209367,12
0.2,5808,-46,494652,85.15269409536926,10
0.2,5809,91,494743,85.15370051635112,10
0.2,5810,94,494837,85.15522285320942,8
0.2,5811,93,494930,85.15657260839642,9
0.2,5812,94,495024,85.1580939274041,7
0.2,5813,93,495117,85.1594427244582,8
0.2,5814,93,495210,85.16079105760963,8
0.2,5815,23,495233,85.15010316368638,10
0.2,5816,92,495325,85.15128072889806,9
0.2,5817,93,495418,85.1526297696803,9
0.2,5818,95,495513,85.15432204846194,8
0.2,5819,92,495605,85.15549828178695,9
0.2,5820,89,495694,85.15615873561244,12
0.2,5821,92,495786,85.15733424939883,9
0.2,5822,96,495882,85.15919629057187,6
0.2,5823,89,495971,85.15985576923077,12
0.2,5824,92,496063,85.16103004291845,9
0.2,5825,93,496156,85.16237555784414,10
0.2,5826,94,496250,85.1638922258452,7
0.2,5827,90,496340,85.16472203157173,12
0.2,5828,95,496435,85.1664093326471,6
0.2,5829,86,496521,85.16655231560893,15
0.2,5830,94,496615,85.16806722689076,7
0.2,5831,86,496701,85.16820987654322,15
0.2,5832,92,496793,85.16938110749186,9
0.2,5833,94,496887,85.17089475488515,7
0.2,5834,94,496981,85.17240788346187,7
0.2,5835,82,497063,85.17186429061,19
0.2,5836,96,497159,85.17371937639199,6
0.2,5837,90,497249,85.17454607742377,11
0.2,5838,94,497343,85.17605754410002,8
0.2,5839,93,497436,85.17739726027398,9
0.2,5840,92,497528,85.17856531415853,9
0.2,5841,90,497618,85.1793906196508,11
0.2,5842,88,497706,85.17987335272976,13
0.2,5843,91,497797,85.18086926762491,10
0.2,5844,90,497887,85.18169375534644,11
0.2,5845,93,497980,85.18303113239823,8
0.2,5846,95,498075,85.18471010774756,6
0.2,5847,27,498102,85.17476060191518,6
0.2,5848,96,498198,85.1766113865618,6
0.2,5849,93,498291,85.17794871794872,8
0.2,5850,94,498385,85.17945650316186,7
0.2,5851,94,498479,85.18096377306904,7
0.2,5852,92,498571,85.1821288228259,10
0.2,5853,84,498655,85.18192688759822,17
0.2,5854,93,498748,85.18326216908625,8
0.2,5855,17,498765,85.17161885245902,15
0.2,5856,94,498859,85.17312617380912,7
0.2,5857,87,498946,85.17343803345852,14
0.2,5858,81,499027,85.17272572111281,20
0.2,5859,95,499122,85.17440273037543,6
0.2,5860,93,499215,85.17573792868112,9
0.2,5861,89,499304,85.17639031047425,12
0.2,5862,95,499399,85.17806583660243,6
0.2,5863,90,499489,85.17888813096862,11
0.2,5864,91,499580,85.17988064791133,10
0.2,5865,95,499675,85.18155472212752,6
0.2,5866,27,499702,85.17163797511505,6
0.2,5867,94,499796,85.17314246762099,8
0.2,5868,90,499886,85.17396490032374,11
0.2,5869,94,499980,85.17546848381602,7
0.2,5870,94,500074,85.17697155510135,7
0.2,5871,84,500158,85.17677111716621,17
0.2,5872,95,500253,85.17844372552358,6
0.2,5873,93,500346,85.17977528089888,8
0.2,5874,89,500435,85.18042553191489,12
0.2,5875,92,500527,85.18158611300204,9
0.2,5876,94,500621,85.18308660881402,7
0.2,5877,94,500715,85.18458659407962,8
0.2,5878,94,500809,85.18608606905936,7
0.2,5879,93,500902,85.18741496598639,8
0.2,5880,90,500992,85.18823329365755,11
0.2,5881,94,501086,85.18973138388303,8
0.2,5882,92,501178,85.19088900220976,9
0.2,5883,96,501274,85.19272603670971,6
0.2,5884,85,501359,85.1926932880204,16
0.2,5885,87,501446,85.19300033978934,15
0.2,5886,92,501538,85.19415661627315,9
0.2,5887,88,501626,85.1946331521739,13
0.2,5888,16,501642,85.18288334182374,18
0.2,5889,-48,501594,85.16027164685909,12
0.2,5890,90,501684,85.16109319300628,11
0.2,5891,95,501779,85.16276306856754,6
0.2,5892,88,501867,85.1632445274054,13
0.2,5893,84,501951,85.16304716661011,17
0.2,5894,95,502046,85.16471586089907,6
0.2,5895,88,502134,85.16519674355496,14
0.2,5896,91,502225,85.16618619637103,10
0.2,5897,94,502319,85.16768396066463,7
0.2,5898,94,502413,85.16918121715545,7
0.2,5899,92,502505,85.17033898305085,9
0.2,5900,23,502528,85.15980342314862,10
0.2,5901,93,502621,85.16113181972213,8
0.2,5902,94,502715,85.16262917160766,7
0.2,5903,22,502737,85.15193089430895,10
0.2,5904,93,502830,85.1532599491956,8
0.2,5905,93,502923,85.15458855401288,8
0.2,5906,93,503016,85.15591670898934,8
0.2,5907,92,503108,85.15707515233582,9
0.2,5908,27,503135,85.14723303435437,6
0.2,5909,87,503222,85.14754653130288,14
0.2,5910,94,503316,85.14904415496532,7
0.2,5911,96,503412,85.15087956698241,6
0.2,5912,96,503508,85.1527143581938,6
0.2,5913,92,503600,85.15387216773757,9
0.2,5914,93,503693,85.15519864750634,8
0.2,5915,20,503713,85.14418526031102,13
0.2,5916,17,503730,85.13266858205172,15
0.2,5917,87,503817,85.13298411625549,15
0.2,5918,96,503913,85.13482007095793,6
0.2,5919,93,504006,85.13614864864864,9
0.2,5920,19,504025,85.12497888870124,13
0.2,5921,93,504118,85.12630867950017,8
0.2,5922,90,504208,85.12713152118859,11
0.2,5923,25,504233,85.11698176907495,7
0.2,5924,95,504328,85.11864978902953,6
0.2,5925,90,504418,85.11947350658117,11
0.2,5926,93,504511,85.12080310443731,8
0.2,5927,94,504605,85.12230094466936,7
0.2,5928,21,504626,85.11148591668072,12
0.2,5929,92,504718,85.11264755480607,9
0.2,5930,93,504811,85.1139774068454,8
0.2,5931,84,504895,85.11378961564397,17
0.2,5932,86,504981,85.11393898533626,15
0.2,5933,94,505075,85.1154364678126,7
0.2,5934,94,505169,85.11693344566133,7
0.2,5935,91,505260,85.11792452830188,10
0.2,5936,-48,505212,85.0955027791814,12
0.2,5937,95,505307,85.0971707645672,6
0.2,5938,16,505323,85.08553628556996,17
0.2,5939,94,505417,85.08703703703704,7
0.2,5940,95,505512,85.08870560511698,6
0.2,5941,95,505607,85.0903736115786,6
0.2,5942,93,505700,85.0917045263335,8
0.2,5943,95,505795,85.09337146702558,6
0.2,5944,91,505886,85.09436501261564,10
0.2,5945,94,505980,85.09586276488396,7
0.2,5946,94,506074,85.09736001345216,7
0.2,5947,93,506167,85.09868863483524,8
0.2,5948,23,506190,85.08825012607161,10
0.2,5949,96,506286,85.09008403361345,6
0.2,5950,94,506380,85.09158124684927,7
0.2,5951,95,506475,85.09324596774194,6
0.2,5952,86,506561,85.09339828657819,15
0.2,5953,27,506588,85.08364124958011,6
0.2,5954,95,506683,85.08530646515533,6
0.2,5955,94,506777,85.08680322364003,7
0.2,5956,90,506867,85.08762800067147,11
0.2,5957,93,506960,85.08895602551192,8
0.2,5958,91,507051,85.08994797784864,10
0.2,5959,94,507145,85.09144295302013,7
0.2,5960,84,507229,85.09125985572891,17
0.2,5961,92,507321,85.09241865145924,9
0.2,5962,90,507411,85.09324165688412,12
0.2,5963,91,507502,85.0942320590208,10
0.2,5964,95,507597,85.09589270746018,6
0.2,5965,91,507688,85.09688233322159,10
0.2,5966,94,507782,85.09837439249203,8
0.2,5967,87,507869,85.09869302949062,14
0.2,5968,93,507962,85.10001675322499,8
0.2,5969,93,508055,85.10134003350083,8
0.2,5970,92,508147,85.10249539440629,9
0.2,5971,92,508239,85.1036503683858,9
0.2,5972,94,508333,85.10513979574753,7
0.2,5973,95,508428,85.10679611650485,6
0.2,5974,93,508521,85.10811715481172,9
0.2,5975,93,508614,85.10943775100401,8
0.2,5976,93,508707,85.11075790530366,9
0.2,5977,92,508799,85.11191033790566,10
0.2,5978,86,508885,85.11205887272119,15
0.2,5979,85,508970,85.11204013377926,16
0.2,5980,91,509061,85.11302457782979,10
0.2,5981,94,509155,85.11451019725844,7
0.2,5982,94,509249,85.11599532007354,8
0.2,5983,94,509343,85.11747994652407,7
0.2,5984,92,509435,85.11862990810359,9
0.2,5985,85,509520,85.1186100902105,16
0.2,5986,92,509612,85.11975947887089,9
0.2,5987,93,509705,85.12107548430194,9
0.2,5988,90,509795,85.1218901319085,11
0.2,5989,91,509886,85.1228714524207,10
0.2,5990,96,509982,85.12468703054581,6
0.2,5991,94,510076,85.12616822429906,7
0.2,5992,91,510167,85.12714833972969,14
0.2,5993,92,510259,85.1282949616283,10
0.2,5994,89,510348,85.12894078398665,13
0.2,5995,96,510444,85.13075383589059,6
0.2,5996,84,510528,85.13056528264131,17
0.2,5997,94,510622,85.13204401467156,7
0.2,5998,27,510649,85.12235372562094,6
0.2,5999,21,510670,85.11166666666666,11
0.2,6000,91,510761,85.112647892018,11
0.2,6001,90,510851,85.11346217927357,11
0.2,6002,92,510943,85.11460936198567,9
0.2,6003,95,511038,85.11625582944704,8
0.2,6004,93,511131,85.11756869275604,9
0.2,6005,93,511224,85.11888111888112,8
0.2,6006,92,511316,85.12002663559181,9
0.2,6007,96,511412,85.12183754993342,7
0.2,6008,19,511431,85.11083374937594,13
0.2,6009,25,511456,85.1008319467554,9
0.2,6010,94,511550,85.10231242721677,7
0.2,6011,94,511644,85.10379241516966,8
0.2,6012,92,511736,85.10493929818726,11
0.2,6013,23,511759,85.09461257066845,12
0.2,6014,83,511842,85.09426433915212,18
0.2,6015,90,511932,85.09507978723404,12
0.2,6016,90,512022,85.09589496426791,12
0.2,6017,96,512118,85.09770687936191,6
0.2,6018,90,512208,85.0985213490613,11
0.2,6019,86,512294,85.09867109634551,15
0.2,6020,92,512386,85.09981730609533,10
0.2,6021,95,512481,85.10146130853538,7
0.2,6022,92,512573,85.10260667441474,11
0.2,6023,96,512669,85.10441567065072,6
0.2,6024,94,512763,85.10589211618257,8
0.2,6025,94,512857,85.10736807168935,7
0.2,6026,94,512951,85.10884353741497,7
0.2,6027,82,513033,85.10832780358328,19
0.2,6028,94,513127,85.10980262066678,7
0.2,6029,86,513213,85.10995024875622,17
0.2,6030,90,513303,85.11076106781628,11
0.2,6031,93,513396,85.11206896551724,8
0.2,6032,92,513488,85.1132106746229,9
0.2,6033,83,513571,85.11286045740802,18
0.2,6034,91,513662,85.11383595691798,10
0.2,6035,94,513756,85.11530815109344,7
0.2,6036,94,513850,85.11677985754514,7
0.2,6037,95,513945,85.11841669426963,6
0.2,6038,91,514036,85.11939062758735,10
0.2,6039,93,514129,85.12069536423841,8
0.2,6040,94,514223,85.12216520443636,8
0.2,6041,93,514316,85.12346904998346,8
0.2,6042,92,514408,85.12460698328644,9
0.2,6043,95,514503,85.12624090006618,6
0.2,6044,-116,514387,85.0929693961952,11
0.2,6045,92,514479,85.0941118094608,9
0.2,6046,95,514574,85.09574995865718,6
0.2,6047,94,514668,85.09722222222223,7
0.2,6048,94,514762,85.0986939990081,7
0.2,6049,94,514856,85.1001652892562,7
0.2,6050,93,514949,85.10147083126756,8
0.2,6051,19,514968,85.09054857898215,14
0.2,6052,94,515062,85.09202048570957,8
0.2,6053,18,515080,85.08093822266271,15
0.2,6054,91,515171,85.08191577208919,10
0.2,6055,94,515265,85.08338837516513,8
0.2,6056,91,515356,85.08436519729239,10
0.2,6057,95,515451,85.08600198085176,6
0.2,6058,96,515547,85.08780326786598,6
0.2,6059,93,515640,85.08910891089108,8
0.2,6060,94,515734,85.0905791123577,7
0.2,6061,91,515825,85.09155394259321,11
0.2,6062,20,515845,85.08081807685964,12
0.2,6063,94,515939,85.0822889182058,8
0.2,6064,90,516029,85.0830997526793,11
0.2,6065,90,516119,85.08391031981536,11
0.2,6066,91,516210,85.08488544585462,10
0.2,6067,91,516301,85.08586025049439,10
0.2,6068,93,516394,85.0871642774757,8
0.2,6069,85,516479,85.08714991762768,17
0.2,6070,93,516572,85.08845330258606,8
0.2,6071,88,516660,85.08893280632411,13
0.2,6072,26,516686,85.07920302980405,6
0.2,6073,89,516775,85.07984853473823,14
0.2,6074,92,516867,85.08098765432099,9
0.2,6075,85,516952,85.08097432521396,16
0.2,6076,19,516971,85.07010037847623,14
0.2,6077,92,517063,85.0712405396512,9
0.2,6078,92,517155,85.07238032571146,9
0.2,6079,95,517250,85.07401315789474,6
0.2,6080,94,517344,85.07548100641341,7
0.2,6081,93,517437,85.07678395264716,8
0.2,6082,83,517520,85.07644254479698,18
0.2,6083,96,517616,85.07823800131493,6
0.2,6084,93,517709,85.07953985209532,8
0.2,6085,92,517801,85.08067696352283,9
0.2,6086,18,517819,85.06965664530968,14
0.2,6087,87,517906,85.06997371879106,14
0.2,6088,94,518000,85.07144030218427,7
0.2,6089,89,518089,85.0720853858785,12
0.2,6090,90,518179,85.07289443441142,12
0.2,6091,95,518274,85.07452396585686,6
0.2,6092,96,518370,85.07631708517971,7
0.2,6093,27,518397,85.0667870036101,6
0.2,6094,94,518491,85.06825266611978,7
0.2,6095,91,518582,85.06922572178478,11
0.2,6096,89,518671,85.06987042807938,13
0.2,6097,92,518763,85.0710068875041,9
0.2,6098,90,518853,85.07181505164782,11
0.2,6099,87,518940,85.07213114754099,14
0.2,6100,92,519032,85.07326667759384,9
0.2,6101,86,519118,85.07341855129465,15
0.2,6102,27,519145,85.06390299852532,6
0.2,6103,92,519237,85.06503931847969,9
0.2,6104,89,519326,85.06568386568387,12
0.2,6105,94,519420,85.06714706845726,7
0.2,6106,93,519513,85.06844604552153,8
0.2,6107,94,519607,85.06990831696136,7
0.2,6108,95,519702,85.07153380258634,6
0.2,6109,92,519794,85.07266775777414,9
0.2,6110,94,519888,85.07412862052037,7
0.2,6111,94,519982,85.0755890052356,7
0.2,6112,96,520078,85.07737608375594,6
0.2,6113,95,520173,85.07899901864573,6
0.2,6114,85,520258,85.0789860997547,17
0.2,6115,25,520283,85.06916285153696,8
0.2,6116,91,520374,85.0701324178519,10
0.2,6117,87,520461,85.07044785877738,14
0.2,6118,95,520556,85.07207059977121,6
0.2,6119,94,520650,85.07352941176471,9
0.2,6120,25,520675,85.06371507923542,8
0.2,6121,93,520768,85.06501143417184,8
0.2,6122,91,520859,85.06598072840112,10
0.2,6123,94,520953,85.06743958197256,8
0.2,6124,96,521049,85.06922448979591,6
0.2,6125,86,521135,85.06937642833823,15
0.2,6126,93,521228,85.07067080137098,8
0.2,6127,92,521320,85.07180156657964,9
0.2,6128,96,521416,85.07358459781368,6
0.2,6129,78,521494,85.07243066884176,23
0.2,6130,95,521589,85.07404991029196,6
0.2,6131,91,521680,85.07501630789302,10
0.2,6132,95,521775,85.07663459970651,6
0.2,6133,96,521871,85.07841538963156,6
0.2,6134,93,521964,85.079706601467,8
0.2,6135,94,522058,85.08116036505866,7
0.2,6136,88,522146,85.08163597849112,14
0.2,6137,89,522235,85.0822743564679,13
0.2,6138,85,522320,85.08226095455286,17
0.2,6139,94,522414,85.08371335504886,7
0.2,6140,92,522506,85.08483960267057,9
0.2,6141,91,522597,85.08580267014003,10
0.2,6142,88,522685,85.0862770633241,15
0.2,6143,91,522776,85.08723958333333,11
0.2,6144,92,522868,85.08836452400325,10
0.2,6145,93,522961,85.08965180605271,8
0.2,6146,91,523052,85.09061330730438,10
0.2,6147,90,523142,85.09141184124918,12
0.2,6148,91,523233,85.09237274353553,11
0.2,6149,91,523324,85.09333333333333,11
0.2,6150,91,523415,85.09429361079499,10
0.2,6151,94,523509,85.09574122236671,7
0.2,6152,90,523599,85.09653827401267,11
0.2,6153,91,523690,85.09749756256093,10
0.2,6154,91,523781,85.09845653939887,10
0.2,6155,93,523874,85.09974009096815,8
0.2,6156,94,523968,85.10118564235829,7
0.2,6157,96,524064,85.1029555050341,6
0.2,6158,94,524158,85.10440006494561,7
0.2,6159,92,524250,85.10551948051948,9
0.2,6160,26,524276,85.09592598604122,7
0.2,6161,94,524370,85.09737098344694,7
0.2,6162,94,524464,85.098815511926,7
0.2,6163,92,524556,85.09993510707334,9
0.2,6164,23,524579,85.08986212489862,10
0.2,6165,92,524671,85.09098280895232,9
0.2,6166,89,524760,85.09161666936922,12
0.2,6167,95,524855,85.09322308690012,8
0.2,6168,18,524873,85.08234721997083,15
0.2,6169,92,524965,85.0834683954619,9
0.2,6170,96,525061,85.08523740074543,6
0.2,6171,91,525152,85.08619572261827,10
0.2,6172,84,525236,85.08601976348615,17
0.2,6173,90,525326,85.08681567865241,11
0.2,6174,92,525418,85.08793522267206,9
0.2,6175,94,525512,85.08937823834196,7
0.2,6176,27,525539,85.07997409745832,6
0.2,6177,86,525625,85.08012301715766,16
0.2,6178,24,525649,85.07023790257323,10
0.2,6179,22,525671,85.06003236245955,10
0.2,6180,85,525756,85.06002265005662,16
0.2,6181,91,525847,85.06098350048528,11
0.2,6182,92,525939,85.06210577389616,9
0.2,6183,86,526025,85.0622574385511,15
0.2,6184,93,526118,85.06354082457558,9
0.2,6185,89,526207,85.06417717426447,12
0.2,6186,23,526230,85.05414578955875,9
0.2,6187,91,526321,85.05510665804783,12
0.2,6188,96,526417,85.05687510098562,6
0.2,6189,94,526511,85.05831987075929,7
0.2,6190,96,526607,85.06008722338879,7
0.2,6191,94,526701,85.06153100775194,7
0.2,6192,91,526792,85.0624899079606,10
0.2,6193,95,526887,85.06409428479174,6
0.2,6194,92,526979,85.06521388216304,9
0.2,6195,91,527070,85.0661717236927,10
0.2,6196,93,527163,85.06745199289979,8
0.2,6197,95,527258,85.06905453372056,8
0.2,6198,94,527352,85.07049524116793,8
0.2,6199,96,527448,85.07225806451613,6
0.2,6200,96,527544,85.07402031930334,6
0.2,6201,93,527637,85.07529829087392,8
0.2,6202,94,527731,85.07673706271159,7
0.2,6203,94,527825,85.07817537072856,7
0.2,6204,94,527919,85.07961321514907,7
0.2,6205,85,528004,85.07960038672253,16
0.2,6206,95,528099,85.08119864668922,6
0.2,6207,96,528195,85.0829574742268,6
0.2,6208,88,528283,85.08342728297633,13
0.2,6209,91,528374,85.08438003220611,10
0.2,6210,85,528459,85.08436644662696,16
0.2,6211,92,528551,85.0854797166774,9
0.2,6212,94,528645,85.08691453404153,8
0.2,6213,92,528737,85.08802703572579,9
0.2,6214,92,528829,85.08913917940467,9
0.2,6215,88,528917,85.08960746460747,13
0.2,6216,93,529010,85.09087984558468,8
0.2,6217,93,529103,85.0921518173046,8
0.2,6218,92,529195,85.09326258240874,9
0.2,6219,23,529218,85.08327974276527,10
0.2,6220,83,529301,85.08294486416975,18
0.2,6221,90,529391,85.08373513339762,12
0.2,6222,91,529482,85.08468584284107,10
0.2,6223,19,529501,85.07406812339332,14
0.2,6224,88,529589,85.07453815261044,13
0.2,6225,88,529677,85.07500803083842,13
0.2,6226,92,529769,85.07612012204915,9
0.2,6227,23,529792,85.06615285806038,9
0.2,6228,94,529886,85.06758709263124,7
0.2,6229,91,529977,85.06853932584269,10
0.2,6230,94,530071,85.06997271705985,7
0.2,6231,94,530165,85.071405648267,7
0.2,6232,94,530259,85.07283811968554,7
0.2,6233,94,530353,85.07427013153674,7
0.2,6234,92,530445,85.07538091419407,10
0.2,6235,94,530539,85.07681205901218,7
0.2,6236,24,530563,85.06701940035273,9
0.2,6237,93,530656,85.06829111894838,8
0.2,6238,96,530752,85.07004327616605,6
0.2,6239,27,530779,85.06073717948718,6
0.2,6240,95,530874,85.06232975484698,6
0.2,6241,93,530967,85.06360140980455,8
0.2,6242,90,531057,85.06439211917348,11
0.2,6243,94,531151,85.06582319026265,7
0.2,6244,95,531246,85.06741393114491,7
0.2,6245,93,531339,85.06868395773294,8
0.2,6246,94,531433,85.07011365455419,7
0.2,6247,90,531523,85.07090268886043,11
0.2,6248,90,531613,85.0716914706353,11
0.2,6249,89,531702,85.07232,13
0.2,6250,94,531796,85.07374820028795,7
0.2,6251,89,531885,85.07437619961613,12
0.2,6252,93,531978,85.0756436910283,8
0.2,6253,91,532069,85.07659098177167,10
0.2,6254,94,532163,85.07801758593125,7
0.2,6255,92,532255,85.07912404092072,9
0.2,6256,92,532347,85.0802301422407,10
0.2,6257,93,532440,85.08149568552253,10
0.2,6258,96,532536,85.08324013420675,6
0.2,6259,92,532628,85.08434504792332,10
0.2,6260,93,532721,85.08560932758346,10
0.2,6261,91,532812,85.086553816672,10
0.2,6262,93,532905,85.08781733993294,8
0.2,6263,95,533000,85.08939974457216,6
0.2,6264,93,533093,85.09066241021549,8
0.2,6265,92,533185,85.09176508139164,9
0.2,6266,94,533279,85.09318653263124,8
0.2,6267,95,533374,85.094767070836,6
0.2,6268,27,533401,85.08550007975754,6
0.2,6269,95,533496,85.08708133971292,6
0.2,6270,92,533588,85.08818370275873,9
0.2,6271,92,533680,85.08928571428571,10
0.2,6272,94,533774,85.09070620117966,7
0.2,6273,92,533866,85.09180745935608,9
0.2,6274,87,533953,85.09211155378486,14
0.2,6275,86,534039,85.09225621414915,16
0.2,6276,94,534133,85.09367532260634,7
0.2,6277,90,534223,85.09445683338643,13
0.2,6278,91,534314,85.09539735626691,10
0.2,6279,92,534406,85.09649681528663,9
0.2,6280,23,534429,85.08661041235472,9
0.2,6281,87,534516,85.08691499522445,16
0.2,6282,94,534610,85.08833359859939,7
0.2,6283,22,534632,85.07829408020369,10
0.2,6284,96,534728,85.08003182179793,6
0.2,6285,78,534806,85.07890550429526,24
0.2,6286,92,534898,85.08000636233497,9
0.2,6287,93,534991,85.0812659033079,8
0.2,6288,94,535085,85.08268405151853,8
0.2,6289,92,535177,85.08378378378379,9
0.2,6290,91,535268,85.08472420918773,10
0.2,6291,90,535358,85.08550540368722,11
0.2,6292,93,535451,85.08676307007786,10
0.2,6293,95,535546,85.08833809977756,6
0.2,6294,89,535635,85.08895949166005,12
0.2,6295,94,535729,85.090374841169,7
0.2,6296,96,535825,85.09210735270764,6
0.2,6297,96,535921,85.09383931406796,6
0.2,6298,90,536011,85.09461819336403,11
0.2,6299,90,536101,85.09539682539682,11
0.2,6300,-51,536050,85.07379780987145,15
0.2,6301,91,536141,85.07473817835607,11
0.2,6302,91,536232,85.07567824845312,10
0.2,6303,93,536325,85.07693527918782,8
0.2,6304,94,536419,85.07835051546392,8
0.2,6305,96,536515,85.08008246114811,6
0.2,6306,93,536608,85.08133819565562,8
0.2,6307,94,536702,85.08275206087508,7
0.2,6308,94,536796,85.08416547788873,7
0.2,6309,90,536886,85.08494453248811,12
0.2,6310,94,536980,85.08635715417525,7
0.2,6311,85,537065,85.08634347275031,17
0.2,6312,93,537158,85.08759702201806,8
0.2,6313,94,537252,85.08900855242318,7
0.2,6314,84,537336,85.08883610451306,19
0.2,6315,95,537431,85.09040531982268,6
0.2,6316,27,537458,85.08120943485832,6
0.2,6317,90,537548,85.08198797087687,11
0.2,6318,92,537640,85.08308276626049,9
0.2,6319,96,537736,85.08481012658228,6
0.2,6320,95,537831,85.08637873754152,6
0.2,6321,93,537924,85.08763049667827,8
0.2,6322,21,537945,85.07749486003479,11
0.2,6323,90,538035,85.07827324478178,11
0.2,6324,93,538128,85.0795256916996,8
0.2,6325,90,538218,85.08030350932658,11
0.2,6326,24,538242,85.07064959696538,9
0.2,6327,92,538334,85.07174462705436,9
0.2,6328,95,538429,85.07331331963975,6
0.2,6329,80,538509,85.07251184834124,21
0.2,6330,93,538602,85.07376401832254,8
0.2,6331,92,538694,85.07485786481365,9
0.2,6332,94,538788,85.07626717195642,7
0.2,6333,84,538872,85.07609725292075,17
0.2,6334,93,538965,85.07734806629834,8
0.2,6335,94,539059,85.07875631313131,8
0.2,6336,96,539155,85.08047972226606,6
0.2,6337,93,539248,85.08172925213,8
0.2,6338,21,539269,85.07162012935794,11
0.2,6339,93,539362,85.07287066246057,8
0.2,6340,91,539453,85.07380539347106,10
0.2,6341,92,539545,85.07489750867234,9
0.2,6342,93,539638,85.07614693362763,8
0.2,6343,93,539731,85.07739596469105,8
0.2,6344,87,539818,85.07769897557131,14
0.2,6345,95,539913,85.07926252757643,6
0.2,6346,91,540004,85.08019536789034,11
0.2,6347,94,540098,85.08160050409577,7
0.2,6348,26,540124,85.0722948495826,8
0.2,6349,92,540216,85.07338582677166,9
0.2,6350,94,540310,85.07479137143757,8
0.2,6351,90,540400,85.07556675062972,11
0.2,6352,93,540493,85.07681410357311,8
0.2,6353,94,540587,85.07821844507397,7
0.2,6354,91,540678,85.07915027537372,10
0.2,6355,94,540772,85.08055380742606,7
0.2,6356,94,540866,85.08195689790782,7
0.2,6357,95,540961,85.08351682919157,6
0.2,6358,93,541054,85.08476175499293,8
0.2,6359,91,541145,85.08569182389937,10
0.2,6360,96,541241,85.08740764030813,6
0.2,6361,95,541336,85.0889657340459,7
0.2,6362,94,541430,85.0903661794751,7
0.2,6363,92,541522,85.09145191703331,10
0.2,6364,88,541610,85.09190887666928,13
0.2,6365,94,541704,85.0933081998115,7
0.2,6366,92,541796,85.09439296371917,11
0.2,6367,93,541889,85.09563442211055,8
0.2,6368,96,541985,85.097346522217,6
0.2,6369,94,542079,85.09874411302982,7
0.2,6370,92,542171,85.09982734264636,9
0.2,6371,95,542266,85.101381042059,7
0.2,6372,87,542353,85.1016789581045,14
0.2,6373,92,542445,85.10276121744587,9
0.2,6374,93,542538,85.104,9
0.2,6375,95,542633,85.10555207026349,6
0.2,6376,92,542725,85.10663321310962,9
0.2,6377,94,542819,85.10802759485732,7
0.2,6378,90,542909,85.10879448189371,11
0.2,6379,94,543003,85.11018808777429,8
0.2,6380,12,543015,85.098730606488,20
0.2,6381,27,543042,85.08962707615167,6
0.2,6382,93,543135,85.09086636377879,8
0.2,6383,96,543231,85.09257518796993,6
0.2,6384,89,543320,85.09318715740015,12
0.2,6385,91,543411,85.09411212026308,10
0.2,6386,92,543503,85.09519336151558,10
0.2,6387,92,543595,85.09627426424547,9
0.2,6388,91,543686,85.09719830959462,10
0.2,6389,96,543782,85.09890453834116,6
0.2,6390,89,543871,85.09951494288843,13
0.2,6391,92,543963,85.10059449311639,9
0.2,6392,93,544056,85.10183012670107,9
0.2,6393,94,544150,85.10322177040976,8
0.2,6394,93,544243,85.104456606724,9
0.2,6395,92,544335,85.10553470919325,12
0.2,6396,90,544425,85.1062998280444,11
0.2,6397,93,544518,85.10753360425133,8
0.2,6398,93,544611,85.10876699484294,8
0.2,6399,95,544706,85.1103125,7
0.2,6400,93,544799,85.11154507108265,8
0.2,6401,96,544895,85.11324586066854,6
0.2,6402,87,544982,85.11354052787756,16
0.2,6403,93,545075,85.11477201748907,8
0.2,6404,94,545169,85.11615925058548,8
0.2,6405,93,545262,85.11738994692476,8
0.2,6406,94,545356,85.1187763383799,7
0.2,6407,95,545451,85.12031835205993,6
0.2,6408,94,545545,85.12170385395538,7
0.2,6409,95,545640,85.1232449297972,7
0.2,6410,95,545735,85.12478552487912,6
0.2,6411,27,545762,85.11572052401746,7
0.2,6412,87,545849,85.11601434585997,15
0.2,6413,89,545938,85.11661989398192,13
0.2,6414,87,546025,85.11691348402182,16
0.2,6415,90,546115,85.11767456359102,11
0.2,6416,75,546190,85.11609786504597,26
0.2,6417,89,546279,85.11670302274852,12
0.2,6418,89,546368,85.11730799189905,12
0.2,6419,86,546454,85.11744548286605,15
0.2,6420,88,546542,85.11789440897057,13
0.2,6421,92,546634,85.11896605418873,9
0.2,6422,88,546722,85.11941460376771,13
0.2,6423,96,546818,85.12110834371109,6
0.2,6424,93,546911,85.1223346303502,8
0.2,6425,27,546938,85.11328976034858,6
0.2,6426,81,547019,85.11264975882993,20
0.2,6427,24,547043,85.1031425015557,9
0.2,6428,93,547136,85.10437081972313,10
0.2,6429,92,547228,85.1054432348367,10
0.2,6430,91,547319,85.10635981962369,10
0.2,6431,95,547414,85.10789800995025,7
0.2,6432,94,547508,85.1092802735893,7
0.2,6433,91,547599,85.11019583462854,10
0.2,6434,91,547690,85.11111111111111,10
0.2,6435,92,547782,85.11218147917961,9
0.2,6436,91,547873,85.11309616280876,10
0.2,6437,94,547967,85.11447654551102,8
0.2,6438,91,548058,85.11539058860072,10
0.2,6439,89,548147,85.11599378881988,12
0.2,6440,95,548242,85.11752833410961,6
0.2,6441,90,548332,85.1182862465073,11
0.2,6442,94,548426,85.1196647524445,8
0.2,6443,90,548516,85.12042209807574,11
0.2,6444,95,548611,85.12195500387898,7
0.2,6445,92,548703,85.12302202916537,9
0.2,6446,93,548796,85.12424383434156,9
0.2,6447,94,548890,85.12562034739454,8
0.2,6448,93,548983,85.12684137075516,8
0.2,6449,92,549075,85.12790697674419,9
0.2,6450,92,549167,85.12897225236398,9
0.2,6451,94,549261,85.13034717916925,9
0.2,6452,94,549355,85.13172167983883,8
0.2,6453,95,549450,85.13325069724202,6
0.2,6454,92,549542,85.13431448489543,9
0.2,6455,92,549634,85.13537794299876,10
0.2,6456,94,549728,85.13675081307109,9
0.2,6457,92,549820,85.13781356457108,10
0.2,6458,27,549847,85.12881250967642,6
0.2,6459,81,549928,85.128173374613,21
0.2,6460,92,550020,85.12923696022287,10
0.2,6461,25,550045,85.1199319096255,8
0.2,6462,96,550141,85.12161534890917,6
0.2,6463,95,550236,85.12314356435644,7
0.2,6464,90,550326,85.12389791183294,11
0.2,6465,96,550422,85.12557995669657,6
0.2,6466,91,550513,85.12648832534406,10
0.2,6467,13,550526,85.11533704390847,20
0.2,6468,91,550617,85.1162467151028,11
0.2,6469,16,550633,85.10556414219475,16
0.2,6470,86,550719,85.10570236439499,16
0.2,6471,25,550744,85.0964153275649,8
0.2,6472,95,550839,85.09794531129306,6
0.2,6473,89,550928,85.09854803830707,12
0.2,6474,95,551023,85.10007722007722,6
0.2,6475,26,551049,85.0909512044472,8
0.2,6476,27,551076,85.08198239925892,6
0.2,6477,94,551170,85.08335906143871,7
0.2,6478,94,551264,85.0847352986572,8
0.2,6479,94,551358,85.08611111111111,7
0.2,6480,90,551448,85.08686931029162,11
0.2,6481,23,551471,85.07729095958038,10
0.2,6482,95,551566,85.07882153324078,7
0.2,6483,23,551589,85.06924737816163,10
0.2,6484,95,551684,85.07077872012336,6
0.2,6485,91,551775,85.07169287696577,10
0.2,6486,92,551867,85.07276090642824,9
0.2,6487,94,551961,85.07413686806412,8
0.2,6488,86,552047,85.0742795500077,15
0.2,6489,93,552140,85.07550077041603,8
0.2,6490,92,552232,85.07656755507625,9
0.2,6491,94,552326,85.07794208256315,7
0.2,6492,90,552416,85.07870013861081,13
0.2,6493,90,552506,85.07945796119495,12
0.2,6494,87,552593,85.07975365665897,14
0.2,6495,94,552687,85.08112684729063,7
0.2,6496,91,552778,85.08203786362937,10
0.2,6497,94,552872,85.08341028008618,8
0.2,6498,93,552965,85.08462840436991,8
0.2,6499,84,553049,85.08446153846154,17
0.2,6500,87,553136,85.08475619135518,14
0.2,6501,96,553232,85.08643494309443,6
0.2,6502,92,553324,85.08749807781024,9
0.2,6503,91,553415,85.08840713407135,10
0.2,6504,93,553508,85.08962336664105,8
0.2,6505,95,553603,85.09114663387642,8
0.2,6506,94,553697,85.09251575226679,7
0.2,6507,94,553791,85.0938844499078,8
0.2,6508,93,553884,85.09509909356277,8
0.2,6509,94,553978,85.09646697388632,7
0.2,6510,93,554071,85.09768084779604,8
0.2,6511,93,554164,85.09889434889435,8
0.2,6512,93,554257,85.10010747735299,10
0.2,6513,94,554351,85.10147374884863,7
0.2,6514,93,554444,85.10268610897928,8
0.2,6515,93,554537,85.10389809699203,8
0.2,6516,87,554624,85.10418904403866,14
0.2,6517,95,554719,85.10570727216938,6
0.2,6518,93,554812,85.10691823899371,8
0.2,6519,94,554906,85.10828220858896,8
0.2,6520,90,554996,85.10903235700046,11
0.2,6521,27,555023,85.1001226617602,6
0.2,6522,94,555117,85.1014870458378,7
0.2,6523,93,555210,85.10269773145309,8
0.2,6524,92,555302,85.10375478927203,9
0.2,6525,92,555394,85.10481152313821,9
0.2,6526,94,555488,85.10617435268883,7
0.2,6527,95,555583,85.10768995098039,6
0.2,6528,95,555678,85.10920508500536,8
0.2,6529,87,555765,85.1094946401225,14
0.2,6530,88,555853,85.10993722247741,14
0.2,6531,95,555948,85.11145131659522,7
0.2,6532,91,556039,85.11235267105465,10
0.2,6533,95,556134,85.11386593204774,6
0.2,6534,94,556228,85.11522570772762,7
0.2,6535,91,556319,85.11612607099143,10
0.2,6536,94,556413,85.11748508490133,7
0.2,6537,94,556507,85.11884368308351,7
0.2,6538,22,556529,85.10919100779935,11
0.2,6539,95,556624,85.11070336391437,6
0.2,6540,92,556716,85.11175661213882,9
0.2,6541,92,556808,85.11280953836747,9
0.2,6542,95,556903,85.11432064802078,6
0.2,6543,95,556998,85.11583129584352,6
0.2,6544,94,557092,85.11718869365929,8
0.2,6545,94,557186,85.11854567674916,7
0.2,6546,88,557274,85.11898579502062,13
0.2,6547,94,557368,85.12034208918753,7
0.2,6548,95,557463,85.12185066422354,6
0.2,6549,20,557483,85.11190839694656,13
0.2,6550,96,557579,85.11357044725996,6
0.2,6551,92,557671,85.11462148962148,9
0.2,6552,93,557764,85.11582481306272,8
0.2,6553,92,557856,85.11687519072322,9
0.2,6554,93,557949,85.11807780320366,8
0.2,6555,92,558041,85.11912751677852,9
0.2,6556,87,558128,85.11941436632607,14
0.2,6557,92,558220,85.12046355596219,11
0.2,6558,94,558314,85.12181735020583,7
0.2,6559,93,558407,85.12301829268293,8
0.2,6560,95,558502,85.12452370065539,6
0.2,6561,94,558596,85.12587625723864,8
0.2,6562,96,558692,85.12753314033216,6
0.2,6563,90,558782,85.12827544180378,11
0.2,6564,93,558875,85.12947448591012,9
0.2,6565,93,558968,85.1306731647883,8
0.2,6566,88,559056,85.13111009593422,14
0.2,6567,91,559147,85.13200365408039,10
0.2,6568,90,559237,85.13274471000152,11
0.2,6569,93,559330,85.13394216133942,8
0.2,6570,95,559425,85.135443615888,6
0.2,6571,94,559519,85.13679245283019,8
0.2,6572,96,559615,85.1384451544196,6
0.2,6573,90,559705,85.13918466686948,11
0.2,6574,96,559801,85.14083650190113,6
0.2,6575,92,559893,85.1418795620438,9
0.2,6576,95,559988,85.14337844001824,6
0.2,6577,92,560080,85.14442079659472,9
0.2,6578,94,560174,85.14576683386532,8
0.2,6579,86,560260,85.14589665653496,16
0.2,6580,96,560356,85.14754596565871,6
0.2,6581,94,560450,85.14889091461562,8
0.2,6582,95,560545,85.15038736138538,7
0.2,6583,92,560637,85.1514277035237,9
0.2,6584,96,560733,85.15307517084283,6
0.2,6585,90,560823,85.15381111448526,12
0.2,6586,94,560917,85.15515409139213,7
0.2,6587,92,561009,85.15619307832422,9
0.2,6588,94,561103,85.15753528608286,7
0.2,6589,93,561196,85.1587253414264,9
0.2,6590,90,561286,85.15945986951904,11
0.2,6591,89,561375,85.16004247572816,12
0.2,6592,95,561470,85.16153496132262,9
0.2,6593,95,561565,85.16302699423719,6
0.2,6594,94,561659,85.16436694465504,7
0.2,6595,80,561739,85.16358399029716,21
0.2,6596,94,561833,85.16492345005305,7
0.2,6597,88,561921,85.16535313731434,13
0.2,6598,93,562014,85.16654038490681,8
0.2,6599,87,562101,85.16681818181819,14
0.2,6600,13,562114,85.1558854718982,21
0.2,6601,94,562208,85.15722508330809,7
0.2,6602,91,562299,85.15810995002272,10
0.2,6603,91,562390,85.15899454875833,10
0.2,6604,95,562485,85.16048448145344,6
0.2,6605,94,562579,85.16182258552831,7
0.2,6606,94,562673,85.16316028454669,7
0.2,6607,17,562690,85.15284503631962,15
0.2,6608,96,562786,85.15448630655168,6
0.2,6609,93,562879,85.15567322239032,8
0.2,6610,93,562972,85.15685977915595,8
0.2,6611,96,563068,85.15849969751966,6
0.2,6612,88,563156,85.15892938152125,13
0.2,6613,89,563245,85.15951013002721,13
0.2,6614,90,563335,85.16024187452759,15
0.2,6615,92,563427,85.16127569528416,13
0.2,6616,93,563520,85.16246032945443,8
0.2,6617,95,563615,85.1639468117256,6
0.2,6618,89,563704,85.16452636349902,12
0.2,6619,94,563798,85.16586102719033,7
0.2,6620,92,563890,85.16689321854705,9
0.2,6621,93,563983,85.16807610993658,8
0.2,6622,25,564008,85.15899139362827,7
0.2,6623,91,564099,85.1598731884058,11
0.2,6624,93,564192,85.16105660377359,9
0.2,6625,94,564286,85.16239058255357,7
0.2,6626,92,564378,85.1634223630602,9
0.2,6627,86,564464,85.1635485817743,15
0.2,6628,96,564560,85.16518328556343,6
0.2,6629,23,564583,85.15580693815988,9
0.2,6630,94,564677,85.15714070275976,7
0.2,6631,93,564770,85.15832328106151,8
0.2,6632,96,564866,85.15995778682345,6
0.2,6633,95,564961,85.16144106119988,8
0.2,6634,92,565053,85.16247174076865,9
0.2,6635,94,565147,85.16380349608198,7
0.2,6636,87,565234,85.16408015669731,14
0.2,6637,93,565327,85.16526062066887,9
0.2,6638,96,565423,85.16689260430788,6
0.2,6639,93,565516,85.16807228915663,8
0.2,6640,94,565610,85.16940219846408,7
0.2,6641,91,565701,85.17028003613369,10
0.2,6642,90,565791,85.17100707511666,11
0.2,6643,94,565885,85.17233594220349,7
0.2,6644,94,565979,85.17366440933033,7
0.2,6645,94,566073,85.1749924766777,7
0.2,6646,95,566168,85.17647058823529,7
0.2,6647,95,566263,85.17794825511432,8
0.2,6648,92,566355,85.17897428184689,10
0.2,6649,91,566446,85.17984962406015,11
0.2,6650,94,566540,85.18117576304316,7
0.2,6651,26,566566,85.17227901383043,8
0.2,6652,90,566656,85.17300465955208,11
0.2,6653,92,566748,85.17403065825067,9
0.2,6654,89,566837,85.17460555972953,12
0.2,6655,18,566855,85.16451322115384,16
0.2,6656,93,566948,85.16569025086375,8
0.2,6657,90,567038,85.16641634124362,12
0.2,6658,90,567128,85.16714221354557,11
0.2,6659,22,567150,85.15765765765765,10
0.2,6660,94,567244,85.15898513736676,7
0.2,6661,95,567339,85.16046232362653,7
0.2,6662,96,567435,85.16208914903197,6
0.2,6663,96,567531,85.16371548619448,6
0.2,6664,91,567622,85.16459114778695,11
0.2,6665,88,567710,85.16501650165017,13
0.2,6666,96,567806,85.16664166791661,6
0.2,6667,95,567901,85.16811637672465,8
0.2,6668,86,567987,85.16824111560953,15
0.2,6669,91,568078,85.16911544227887,12
0.2,6670,93,568171,85.17028931194723,8
0.2,6671,91,568262,85.17116306954436,10
0.2,6672,89,568351,85.17173684999251,13
0.2,6673,17,568368,85.16152232544201,17
0.2,6674,23,568391,85.15220973782772,9
0.2,6675,90,568481,85.15293588975435,11
0.2,6676,93,568574,85.15411112775199,8
0.2,6677,92,568666,85.15513626834381,9
0.2,6678,96,568762,85.15675999401108,6
0.2,6679,91,568853,85.15763473053892,10
0.2,6680,92,568945,85.15865888340069,9
0.2,6681,89,569034,85.1592337623466,12
0.2,6682,91,569125,85.16010773604668,10
0.2,6683,95,569220,85.16157989228007,7
0.2,6684,94,569314,85.16290201944652,8
0.2,6685,25,569339,85.15390367932994,7
0.2,6686,93,569432,85.15507701510393,10
0.2,6687,91,569523,85.1559509569378,10
0.2,6688,95,569618,85.15742263417552,6
0.2,6689,95,569713,85.15889387144992,6
0.2,6690,91,569804,85.15976685099388,10
0.2,6691,95,569899,85.16123729826658,6
0.2,6692,91,569990,85.16210966681608,10
0.2,6693,94,570084,85.16342993725725,7
0.2,6694,91,570175,85.16430171769977,10
0.2,6695,95,570270,85.165770609319,6
0.2,6696,92,570362,85.16679110049276,10
0.2,6697,92,570454,85.16781128695133,10
0.2,6698,94,570548,85.16912972085386,8
0.2,6699,92,570640,85.17014925373134,9
0.2,6700,95,570735,85.17161617669005,6
0.2,6701,94,570829,85.17293345270069,7
0.2,6702,92,570921,85.17395196180814,9
0.2,6703,95,571016,85.17541766109785,6
0.2,6704,92,571108,85.17643549589859,9
0.2,6705,96,571204,85.17804950790337,6
0.2,6706,93,571297,85.1792157447443,8
0.2,6707,94,571391,85.18053070960048,7
0.2,6708,94,571485,85.18184528245641,8
0.2,6709,93,571578,85.18301043219076,8
0.2,6710,91,571669,85.18387721651021,10
0.2,6711,94,571763,85.18519070321811,7
0.2,6712,96,571859,85.18680172799047,6
0.2,6713,93,571952,85.1879654453381,8
0.2,6714,88,572040,85.18838421444528,13
0.2,6715,91,572131,85.18924955330554,11
0.2,6716,91,572222,85.19011463450946,10
0.2,6717,94,572316,85.1914260196487,7
0.2,6718,93,572409,85.19258818276529,8
0.2,6719,92,572501,85.19360119047619,9
0.2,6720,96,572597,85.19520904627288,6
0.2,6721,93,572690,85.19637012793811,8
0.2,6722,94,572784,85.19767960731816,7
0.2,6723,91,572875,85.19854253420583,10
0.2,6724,22,572897,85.18914498141264,13
0.2,6725,92,572989,85.19015759738329,10
0.2,6726,89,573078,85.19072394826817,13
0.2,6727,91,573169,85.1915873959572,10
0.2,6728,94,573263,85.19289641848715,7
0.2,6729,89,573352,85.19346210995542,12
0.2,6730,95,573447,85.1949190313475,9
0.2,6731,96,573543,85.19652406417113,6
0.2,6732,94,573637,85.19783157582059,7
0.2,6733,88,573725,85.1982476982477,13
0.2,6734,95,573820,85.19970304380104,6
0.2,6735,94,573914,85.20100950118764,7
0.2,6736,95,574009,85.20246400474988,8
0.2,6737,92,574101,85.20347284060553,9
0.2,6738,94,574195,85.20477815699658,7
0.2,6739,92,574287,85.20578635014837,9
0.2,6740,94,574381,85.2070909360629,7
0.2,6741,95,574476,85.20854345891426,7
0.2,6742,92,574568,85.20955064511345,9
0.2,6743,94,574662,85.21085409252669,7
0.2,6744,95,574757,85.21230541141587,6
0.2,6745,95,574852,85.21375630002964,8
0.2,6746,89,574941,85.21431747443309,12
0.2,6747,85,575026,85.21428571428571,16
0.2,6748,92,575118,85.21529115424508,9
0.2,6749,96,575214,85.21688888888889,6
0.2,6750,96,575310,85.21848615019996,6
0.2,6751,95,575405,85.21993483412322,6
0.2,6752,93,575498,85.22108692432992,8
0.2,6753,96,575594,85.22268285460468,6
0.2,6754,94,575688,85.2239822353812,7
0.2,6755,23,575711,85.2147720544701,9
0.2,6756,94,575805,85.21607222140003,7
0.2,6757,92,575897,85.21707605800533,9
0.2,6758,94,575991,85.21837549933421,7
0.2,6759,94,576085,85.21967455621302,7
0.2,6760,95,576180,85.22112113592664,6
0.2,6761,89,576269,85.22167997633836,12
0.2,6762,96,576365,85.22327369510572,7
0.2,6763,95,576460,85.2247191011236,6
0.2,6764,94,576554,85.2260162601626,7
0.2,6765,92,576646,85.22701744014189,9
0.2,6766,95,576741,85.22846165213537,7
0.2,6767,94,576835,85.22975768321513,9
0.2,6768,93,576928,85.23090559905451,8
0.2,6769,23,576951,85.22171344165436,10
0.2,6770,90,577041,85.22241914045193,12
0.2,6771,93,577134,85.2235676314235,10
0.2,6772,93,577227,85.22471578325705,8
0.2,6773,96,577323,85.22630646589903,6
0.2,6774,95,577418,85.22774907749077,6
0.2,6775,96,577514,85.22933884297521,6
0.2,6776,88,577602,85.22974767596281,13
0.2,6777,94,577696,85.23104160519327,7
0.2,6778,92,577788,85.23204012391209,9
0.2,6779,91,577879,85.23289085545723,10
0.2,6780,89,577968,85.23344639433712,12
0.2,6781,93,578061,85.23459156590977,8
0.2,6782,93,578154,85.23573639982308,8
0.2,6783,92,578246,85.23673349056604,9
0.2,6784,93,578339,85.23787767133382,8
0.2,6785,90,578429,85.2385794282346,12
0.2,6786,94,578523,85.23987034035656,7
0.2,6787,93,578616,85.24101355332941,8
0.2,6788,92,578708,85.2420091324201,9
0.2,6789,91,578799,85.24285714285715,10
0.2,6790,94,578893,85.24414666470328,7
0.2,6791,88,578981,85.24455241460542,14
0.2,6792,94,579075,85.24584130722803,7
0.2,6793,89,579164,85.24639387695025,13
0.2,6794,93,579257,85.24753495217071,8
0.2,6795,91,579348,85.24838140082402,10
0.2,6796,92,579440,85.24937472414301,9
0.2,6797,93,579533,85.25051485731098,9
0.2,6798,95,579628,85.25194881600235,6
0.2,6799,93,579721,85.25308823529411,9
0.2,6800,91,579812,85.25393324511101,10
0.2,6801,95,579907,85.2553660688033,8
0.2,6802,94,580001,85.25665147728944,10
0.2,6803,89,580090,85.25720164609054,14
0.2,6804,83,580173,85.25686994856723,18
0.2,6805,94,580267,85.2581545694975,7
0.2,6806,94,580361,85.25943881298663,7
0.2,6807,92,580453,85.26042890716803,9
0.2,6808,92,580545,85.26141871053018,9
0.2,6809,94,580639,85.26270190895741,9
0.2,6810,21,580660,85.25326677433563,14
0.2,6811,94,580754,85.25455079271873,7
0.2,6812,95,580849,85.25598121238808,6
0.2,6813,94,580943,85.25726445553272,7
0.2,6814,95,581038,85.2586940572267,9
0.2,6815,91,581129,85.25953638497653,10
0.2,6816,95,581224,85.26096523397389,6
0.2,6817,92,581316,85.26195365209739,9
0.2,6818,93,581409,85.26308842938847,9
0.2,6819,88,581497,85.26348973607038,15
0.2,6820,93,581590,85.26462395543176,8
0.2,6821,22,581612,85.25535033714453,11
0.2,6822,77,581689,85.2541404074454,25
0.2,6823,96,581785,85.25571512309496,6
0.2,6824,96,581881,85.25728937728938,6
0.2,6825,94,581975,85.25857017286845,7
0.2,6826,94,582069,85.25985059323276,7
0.2,6827,94,582163,85.26113063854716,7
0.2,6828,93,582256,85.26226387465222,8
0.2,6829,88,582344,85.26266471449487,13
0.2,6830,88,582432,85.26306543697848,13
0.2,6831,93,582525,85.26419789227167,9
0.2,6832,94,582619,85.26547636470072,7
0.2,6833,87,582706,85.26573017266608,14
0.2,6834,95,582801,85.26715435259693,6
0.2,6835,91,582892,85.26799297834991,10
0.2,6836,94,582986,85.2692701477256,7
0.2,6837,96,583082,85.27083942673296,6
0.2,6838,93,583175,85.27196958619682,8
0.2,6839,90,583265,85.27266081871345,11
0.2,6840,95,583360,85.27408273644204,6
0.2,6841,84,583444,85.27389652148494,17
0.2,6842,86,583530,85.27400263042526,15
0.2,6843,88,583618,85.27440093512566,13
0.2,6844,88,583706,85.27479912344778,14
0.2,6845,94,583800,85.2760736196319,7
0.2,6846,94,583894,85.27734774353732,7
0.2,6847,91,583985,85.27818341121495,10
0.2,6848,84,584069,85.27799678785225,17
0.2,6849,86,584155,85.27810218978102,15
0.2,6850,93,584248,85.27922930958984,8
0.2,6851,88,584336,85.27962638645651,13
0.2,6852,95,584431,85.28104479789873,6
0.2,6853,90,584521,85.28173329442662,11
0.2,6854,95,584616,85.28315098468272,6
0.2,6855,17,584633,85.27319136522753,15
0.2,6856,93,584726,85.27431821496282,9
0.2,6857,91,584817,85.27515310586176,11
0.2,6858,95,584912,85.2765709287068,6
0.2,6859,91,585003,85.2774052478134,10
0.2,6860,94,585097,85.27867657775835,8
0.2,6861,91,585188,85.27951034683765,11
0.2,6862,91,585279,85.28034387294186,11
0.2,6863,96,585375,85.2819055944056,6
0.2,6864,94,585469,85.28317552804079,7
0.2,6865,85,585554,85.28313428488202,17
0.2,6866,94,585648,85.28440366972477,7
0.2,6867,91,585739,85.28523587652883,10
0.2,6868,92,585831,85.28621342262338,9
0.2,6869,93,585924,85.28733624454148,8
0.2,6870,95,586019,85.28874981807597,6
0.2,6871,94,586113,85.29001746216531,7
0.2,6872,18,586131,85.28022697512003,16
0.2,6873,-46,586085,85.26112889147512,9
0.2,6874,94,586179,85.2624,7
0.2,6875,94,586273,85.26367073880162,7
0.2,6876,95,586368,85.26508652028501,6
0.2,6877,19,586387,85.25545216632742,14
0.2,6878,91,586478,85.25628725105393,10
0.2,6879,93,586571,85.25741279069767,8
0.2,6880,93,586664,85.25853800319722,8
0.2,6881,94,586758,85.25980819529207,7
0.2,6882,93,586851,85.26093273282,8
0.2,6883,84,586935,85.26074956420686,17
0.2,6884,89,587024,85.26129266521423,12
0.2,6885,94,587118,85.26256171943074,7
0.2,6886,88,587206,85.26295919848991,13
0.2,6887,91,587297,85.26379210220674,10
0.2,6888,94,587391,85.26506024096386,7
0.2,6889,24,587415,85.25616835994194,9
0.2,6890,93,587508,85.25729212015672,9
0.2,6891,95,587603,85.25870574579223,7
0.2,6892,-47,587556,85.23951835195126,12
0.2,6893,95,587651,85.24093414563389,6
0.2,6894,90,587741,85.24162436548224,11
0.2,6895,23,587764,85.23259860788863,10
0.2,6896,90,587854,85.23328983616065,11
0.2,6897,88,587942,85.23369092490577,13
0.2,6898,95,588037,85.2351065371793,6
0.2,6899,95,588132,85.23652173913044,6
0.2,6900,93,588225,85.23764671786698,8
0.2,6901,93,588318,85.23877137061721,8
0.2,6902,95,588413,85.2401854266261,6
0.2,6903,92,588505,85.24116454229433,9
0.2,6904,92,588597,85.2421433743664,9
0.2,6905,93,588690,85.24326672458731,8
0.2,6906,92,588782,85.24424496887215,10
0.2,6907,93,588875,85.2453676896352,8
0.2,6908,95,588970,85.24677956288899,6
0.2,6909,91,589061,85.24761215629522,12
0.2,6910,94,589155,85.24887859933439,8
0.2,6911,92,589247,85.24985532407408,9
0.2,6912,94,589341,85.25112107623319,7
0.2,6913,92,589433,85.25209719409892,11
0.2,6914,92,589525,85.25307302964569,9
0.2,6915,93,589618,85.2541931752458,8
0.2,6916,23,589641,85.24519300274686,10
0.2,6917,91,589732,85.24602486267707,12
0.2,6918,93,589825,85.2471455412632,9
0.2,6919,96,589921,85.24869942196531,6
0.2,6920,93,590014,85.24981939026152,8
0.2,6921,92,590106,85.25079456804391,13
0.2,6922,93,590199,85.25191391015456,9
0.2,6923,92,590291,85.25288850375506,10
0.2,6924,94,590385,85.25415162454874,7
0.2,6925,89,590474,85.25469246318221,12
0.2,6926,85,590559,85.25465569510611,16
0.2,6927,22,590581,85.24552540415705,10
0.2,6928,22,590603,85.23639774859286,10
0.2,6929,27,590630,85.22799422799423,6
0.2,6930,95,590725,85.22940412638869,7
0.2,6931,94,590819,85.23066935949221,7
0.2,6932,90,590909,85.23135727679215,12
0.2,6933,94,591003,85.23262186328238,7
0.2,6934,91,591094,85.23345349675559,10
0.2,6935,96,591190,85.2350057670127,6
0.2,6936,96,591286,85.2365575897362,6
0.2,6937,82,591368,85.23609109253387,21
0.2,6938,91,591459,85.23692174664937,11
0.2,6939,94,591553,85.23818443804035,8
0.2,6940,92,591645,85.23915862267685,9
0.2,6941,94,591739,85.24042062806107,7
0.2,6942,92,591831,85.24139420999568,10
0.2,6943,89,591920,85.24193548387096,13
0.2,6944,90,592010,85.24262059035277,11
0.2,6945,87,592097,85.24287359631442,14
0.2,6946,94,592191,85.24413415862962,7
0.2,6947,94,592285,85.24539435808866,8
0.2,6948,94,592379,85.24665419484818,7
0.2,6949,94,592473,85.24791366906474,8
0.2,6950,92,592565,85.24888505251043,9
0.2,6951,91,592656,85.24971231300346,10
0.2,6952,94,592750,85.25097080396951,7
0.2,6953,91,592841,85.2517975266034,10
0.2,6954,90,592931,85.25248023005032,12
0.2,6955,91,593022,85.25330649798735,11
0.2,6956,90,593112,85.2539887882708,11
0.2,6957,94,593206,85.25524576027594,7
0.2,6958,94,593300,85.25650237103032,8
0.2,6959,93,593393,85.25761494252873,9
0.2,6960,94,593487,85.2588708518891,7
0.2,6961,96,593583,85.26041367423154,6
0.2,6962,94,593677,85.26166882091053,7
0.2,6963,95,593772,85.26306720275704,6
0.2,6964,96,593868,85.2646087580761,6
0.2,6965,90,593958,85.26528854435831,11
0.2,6966,92,594050,85.26625520310033,9
0.2,6967,91,594141,85.26707807118255,11
0.2,6968,89,594230,85.26761371789352,12
0.2,6969,21,594251,85.2583931133429,11
0.2,6970,89,594340,85.25892985224502,12
0.2,6971,90,594430,85.2596098680436,11
0.2,6972,89,594519,85.2601462785028,12
0.2,6973,91,594610,85.26096931459708,10
0.2,6974,94,594704,85.26222222222222,7
0.2,6975,95,594799,85.26361811926606,8
0.2,6976,93,594892,85.26472696001147,9
0.2,6977,84,594976,85.26454571510462,17
0.2,6978,93,595069,85.26565410517266,8
0.2,6979,91,595160,85.26647564469914,10
0.2,6980,88,595248,85.26686721100128,13
0.2,6981,93,595341,85.26797479232312,8
0.2,6982,94,595435,85.26922526134899,8
0.2,6983,92,595527,85.27018900343643,9
0.2,6984,78,595605,85.26914817465999,24
0.2,6985,93,595698,85.2702547953049,11
0.2,6986,89,595787,85.27078860741376,12
0.2,6987,93,595880,85.27189467658843,8
0.2,6988,96,595976,85.27342967520389,7
0.2,6989,95,596071,85.27482117310443,6
0.2,6990,94,596165,85.27606923186954,7
0.2,6991,93,596258,85.27717391304348,8
0.2,6992,91,596349,85.27799227799228,10
0.2,6993,91,596440,85.27881040892193,12
0.2,6994,95,596535,85.28020014295926,8
0.2,6995,94,596629,85.28144654088051,7
0.2,6996,94,596723,85.28269258253538,8
0.2,6997,94,596817,85.2839382680766,7
0.2,6998,94,596911,85.28518359765681,8
0.2,6999,94,597005,85.28642857142857,7
0.2,7000,93,597098,85.28753035280674,8
0.2,7001,91,597189,85.28834618680376,11
0.2,7002,92,597281,85.28930458374982,10
0.2,7003,85,597366,85.28926327812678,19
0.2,7004,94,597460,85.2905067808708,7
0.2,7005,90,597550,85.29117898943763,12
0.2,7006,87,597637,85.29142286285143,14
0.2,7007,95,597732,85.29280821917808,6
0.2,7008,89,597821,85.29333713796547,13
0.2,7009,92,597913,85.29429386590584,10
0.2,7010,13,597926,85.28398231350735,20
0.2,7011,92,598018,85.28494010268112,10
0.2,7012,89,598107,85.28546984172252,13
0.2,7013,94,598201,85.2867122897063,7
0.2,7014,93,598294,85.28781183178903,8
0.2,7015,94,598388,85.28905359179019,7
0.2,7016,90,598478,85.28972495368392,11
0.2,7017,89,598567,85.29025363351383,12
0.2,7018,96,598663,85.29177945576293,6
0.2,7019,95,598758,85.29316239316239,6
0.2,7020,92,598850,85.29411764705883,9
0.2,7021,95,598945,85.29549985759043,8
0.2,7022,94,599039,85.29673928520575,7
0.2,7023,91,599130,85.29755125284738,10
0.2,7024,90,599220,85.2982206405694,11
0.2,7025,89,599309,85.29874750925136,12
0.2,7026,90,599399,85.29941653621745,11
0.2,7027,94,599493,85.30065452475812,8
0.2,7028,92,599585,85.30160762555128,9
0.2,7029,93,599678,85.3027027027027,8
0.2,7030,91,599769,85.30351301379605,10
0.2,7031,93,599862,85.30460750853243,8
0.2,7032,91,599953,85.30541731835632,10
0.2,7033,95,600048,85.30679556440148,8
0.2,7034,91,600139,85.30760483297797,10
0.2,7035,88,600227,85.30798749289369,13
0.2,7036,95,600322,85.30936478613046,6
0.2,7037,90,600412,85.31003125888036,11
0.2,7038,89,600501,85.3105554766302,12
0.2,7039,26,600527,85.30213068181818,6
0.2,7040,93,600620,85.30322397386735,8
0.2,7041,87,600707,85.30346492473728,15
0.2,7042,24,600731,85.29476075535993,10
0.2,7043,93,600824,85.29585462805224,9
0.2,7044,90,600914,85.29652235628105,11
0.2,7045,92,601006,85.29747374396821,10
0.2,7046,93,601099,85.29856676599971,8
0.2,7047,94,601193,85.29980136208853,7
0.2,7048,92,601285,85.30075187969925,9
0.2,7049,93,601378,85.3018439716312,8
0.2,7050,88,601466,85.30222663451993,13
0.2,7051,96,601562,85.30374361883153,6
0.2,7052,91,601653,85.3045512547852,10
0.2,7053,87,601740,85.30479160759853,14
0.2,7054,95,601835,85.3061658398299,6
0.2,7055,-47,601788,85.2874149659864,12
0.2,7056,94,601882,85.28864956780501,7
0.2,7057,94,601976,85.28988381977898,7
0.2,7058,93,602069,85.29097605893186,9
0.2,7059,93,602162,85.29206798866855,8
0.2,7060,91,602253,85.29287636312137,11
0.2,7061,93,602346,85.29396771452846,8
0.2,7062,95,602441,85.29534192269574,7
0.2,7063,90,602531,85.29600792751982,11
0.2,7064,91,602622,85.29681528662421,10
0.2,7065,95,602717,85.29818850834984,8
0.2,7066,92,602809,85.29913683316825,9
0.2,7067,91,602900,85.29994340690436,11
0.2,7068,92,602992,85.30089121516481,9
0.2,7069,94,603086,85.3021216407355,7
0.2,7070,95,603181,85.30349314099844,6
0.2,7071,89,603270,85.30401583710407,12
0.2,7072,89,603359,85.3045383854093,12
0.2,7073,24,603383,85.29587220808595,9
0.2,7074,95,603478,85.29724381625442,6
0.2,7075,91,603569,85.298049745619,10
0.2,7076,22,603591,85.28910555320051,11
0.2,7077,88,603679,85.2894885560893,14
0.2,7078,27,603706,85.28125441446532,6
0.2,7079,93,603799,85.28234463276836,9
0.2,7080,89,603888,85.28286965117921,14
0.2,7081,92,603980,85.28381813047162,9
0.2,7082,93,604073,85.28490752506,8
0.2,7083,94,604167,85.28613777526822,7
0.2,7084,95,604262,85.28750882145377,9
0.2,7085,94,604356,85.2887383573243,7
0.2,7086,27,604383,85.28051361648087,6
0.2,7087,89,604472,85.28103837471784,12
0.2,7088,19,604491,85.27168853152772,13
0.2,7089,94,604585,85.27291960507758,7
0.2,7090,86,604671,85.27302214074179,15
0.2,7091,89,604760,85.27354765933445,12
0.2,7092,90,604850,85.27421401381643,11
0.2,7093,87,604937,85.27445728784889,14
0.2,7094,94,605031,85.27568710359408,7
0.2,7095,91,605122,85.27649379932356,10
0.2,7096,94,605216,85.2777229815415,7
0.2,7097,87,605303,85.27796562411947,15
0.2,7098,89,605392,85.27848992815889,12
0.2,7099,25,605417,85.27,8
0.2,7100,88,605505,85.27038445289396,13
0.2,7101,95,605600,85.27175443537031,6
0.2,7102,88,605688,85.27213853301421,14
0.2,7103,90,605778,85.27280405405405,11
0.2,7104,96,605874,85.27431386347642,6
0.2,7105,89,605963,85.27483816493104,12
0.2,7106,95,606058,85.27620655691571,7
0.2,7107,82,606140,85.27574563871694,19
0.2,7108,20,606160,85.26656351104234,13
0.2,7109,88,606248,85.26694796061885,14
0.2,7110,85,606333,85.26691042047533,17
0.2,7111,91,606424,85.26771653543307,10
0.2,7112,85,606509,85.26767889779278,17
0.2,7113,92,606601,85.26862524599382,9
0.2,7114,94,606695,85.26985242445538,7
0.2,7115,93,606788,85.27093872962338,8
0.2,7116,87,606875,85.27118167767318,14
0.2,7117,93,606968,85.27226749086822,8
0.2,7118,93,607061,85.27335299901672,8
0.2,7119,94,607155,85.27457865168539,7
0.2,7120,94,607249,85.27580396011795,7
0.2,7121,91,607340,85.27660769446784,10
0.2,7122,91,607431,85.27741120314474,11
0.2,7123,-117,607314,85.24901740595172,12
0.2,7124,94,607408,85.2502456140351,7
0.2,7125,91,607499,85.25105248386191,11
0.2,7126,93,607592,85.25213975024555,9
0.2,7127,92,607684,85.25308641975309,11
0.2,7128,94,607778,85.25431336793379,7
0.2,7129,92,607870,85.25525946704067,10
0.2,7130,96,607966,85.25676623194502,6
0.2,7131,26,607992,85.24845765563657,8
0.2,7132,90,608082,85.24912379083135,12
0.2,7133,94,608176,85.25035043453883,7
0.2,7134,91,608267,85.25115627189909,11
0.2,7135,22,608289,85.24229260089686,11
0.2,7136,91,608380,85.24309934146,10
0.2,7137,25,608405,85.23465956850659,7
0.2,7138,94,608499,85.23588737918476,7
0.2,7139,96,608595,85.2373949579832,6
0.2,7140,91,608686,85.23820193250245,10
0.2,7141,92,608778,85.23914869784375,9
0.2,7142,92,608870,85.24009519809604,9
0.2,7143,92,608962,85.24104143337065,9
0.2,7144,89,609051,85.24156752974108,12
0.2,7145,94,609145,85.24279317100476,9
0.2,7146,90,609235,85.24345879389953,12
0.2,7147,94,609329,85.2446838276441,7
0.2,7148,91,609420,85.24548887956358,11
0.2,7149,88,609508,85.24587412587412,13
0.2,7150,92,609600,85.24681862676549,9
0.2,7151,95,609695,85.24818232662193,6
0.2,7152,96,609791,85.24968544666574,6
0.2,7153,80,609871,85.2489516354487,21
0.2,7154,91,609962,85.24975541579315,12
0.2,7155,94,610056,85.25097820011179,8
0.2,7156,88,610144,85.25136230264077,13
0.2,7157,87,610231,85.25160659402067,14
0.2,7158,95,610326,85.25296829166085,7
0.2,7159,94,610420,85.25418994413408,7
0.2,7160,92,610512,85.25513196480938,12
0.2,7161,-62,610450,85.23457134878525,26
0.2,7162,13,610463,85.22448694680999,20
0.2,7163,96,610559,85.22599106644333,6
0.2,7164,91,610650,85.2267969295185,10
0.2,7165,88,610738,85.22718392408596,13
0.2,7166,91,610829,85.22798939584206,10
0.2,7167,92,610921,85.22893415178571,9
0.2,7168,93,611014,85.2300181336309,8
0.2,7169,88,611102,85.23040446304044,13
0.2,7170,91,611193,85.23120903639659,10
0.2,7171,94,611287,85.2324316787507,7
0.2,7172,90,611377,85.23309633347274,11
0.2,7173,92,611469,85.23403958739894,9
0.2,7174,91,611560,85.23484320557492,10
0.2,7175,92,611652,85.23578595317726,9
0.2,7176,92,611744,85.23672843806604,9
0.2,7177,94,611838,85.23794928949569,7
0.2,7178,92,611930,85.238891210475,9
0.2,7179,94,612024,85.24011142061282,7
0.2,7180,92,612116,85.2410527781646,9
0.2,7181,95,612211,85.24241158451684,6
0.2,7182,92,612303,85.24335235973827,9
0.2,7183,95,612398,85.24471046770601,7
0.2,7184,90,612488,85.24537230340988,12
0.2,7185,92,612580,85.24631227386585,9
0.2,7186,91,612671,85.24711284263253,10
0.2,7187,88,612759,85.24749582637729,14
0.2,7188,94,612853,85.24871331200445,7
0.2,7189,90,612943,85.24937413073714,11
0.2,7190,94,613037,85.25059101654847,8
0.2,7191,94,613131,85.25180756395996,7
0.2,7192,95,613226,85.25316279716391,6
0.2,7193,92,613318,85.25410063942174,10
0.2,7194,23,613341,85.24544822793607,10
0.2,7195,94,613435,85.24666481378543,7
0.2,7196,95,613530,85.24802000833681,6
0.2,7197,89,613619,85.24854126146151,13
0.2,7198,92,613711,85.24947909431866,9
0.2,7199,92,613803,85.25041666666667,9
0.2,7200,95,613898,85.25177058741842,7
0.2,7201,87,613985,85.25201332963066,15
0.2,7202,93,614078,85.25308899069832,8
0.2,7203,83,614161,85.25277623542476,18
0.2,7204,89,614250,85.25329632199862,12
0.2,7205,95,614345,85.25464890369136,10
0.2,7206,92,614437,85.25558484806439,9
0.2,7207,96,614533,85.25707547169812,6
0.2,7208,-122,614411,85.22832570398114,18
0.2,7209,95,614506,85.22968099861303,6
0.2,7210,88,614594,85.23006517819998,13
0.2,7211,92,614686,85.2310038824182,11
0.2,7212,94,614780,85.23221960349369,8
0.2,7213,94,614874,85.23343498752426,7
0.2,7214,95,614969,85.23478863478863,6
0.2,7215,95,615064,85.23614190687361,8
0.2,7216,94,615158,85.2373562422059,7
0.2,7217,85,615243,85.23732335827098,16
0.2,7218,92,615335,85.23826014683475,10
0.2,7219,89,615424,85.23878116343491,12
0.2,7220,92,615516,85.23971749065227,9
0.2,7221,90,615606,85.24037662697313,11
0.2,7222,93,615699,85.24145092067008,8
0.2,7223,92,615791,85.24238648947951,9
0.2,7224,93,615884,85.24346020761246,9
0.2,7225,87,615971,85.24370329366178,14
0.2,7226,94,616065,85.24491490244915,7
0.2,7227,94,616159,85.2461261759823,8
0.2,7228,24,616183,85.2376538940379,8
0.2,7229,93,616276,85.2387275242047,8
0.2,7230,95,616371,85.24007744433688,7
0.2,7231,87,616458,85.24032079646018,14
0.2,7232,93,616551,85.24139361260887,8
0.2,7233,94,616645,85.24260436826098,7
0.2,7234,16,616661,85.23303386316518,16
0.2,7235,94,616755,85.23424543946932,9
0.2,7236,92,616847,85.2351803233384,10
0.2,7237,19,616866,85.22602928985907,14
0.2,7238,90,616956,85.22668876916701,11
0.2,7239,93,617049,85.22776243093922,8
0.2,7240,94,617143,85.22897389863279,8
0.2,7241,95,617238,85.23032311516155,6
0.2,7242,90,617328,85.23098163744305,11
0.2,7243,95,617423,85.23233020430702,7
0.2,7244,93,617516,85.23340234644583,10
0.2,7245,94,617610,85.23461219983439,8
0.2,7246,95,617705,85.23595970746516,6
0.2,7247,92,617797,85.23689293598234,10
0.2,7248,88,617885,85.23727410677334,13
0.2,7249,94,617979,85.23848275862069,7
0.2,7250,95,618074,85.23982898910495,6
0.2,7251,92,618166,85.2407611693326,9
0.2,7252,84,618250,85.240590100648,17
0.2,7253,21,618271,85.23173421560519,12
0.2,7254,92,618363,85.23266712611992,9
0.2,7255,92,618455,85.23359977949283,9
0.2,7256,93,618548,85.23466997381838,8
0.2,7257,90,618638,85.23532653623587,12
0.2,7258,96,618734,85.23680947788952,6
0.2,7259,90,618824,85.23746556473829,11
0.2,7260,94,618918,85.23867235917918,7
0.2,7261,93,619011,85.23974111814927,8
0.2,7262,89,619100,85.2402588462068,13
0.2,7263,94,619194,85.24146475770925,7
0.2,7264,90,619284,85.24211975223675,11
0.2,7265,94,619378,85.24332507569501,8
0.2,7266,94,619472,85.2445300674281,8
0.2,7267,93,619565,85.24559713813979,8
0.2,7268,94,619659,85.24680148576145,9
0.2,7269,95,619754,85.24814305364512,7
0.2,7270,93,619847,85.24920918718196,8
0.2,7271,92,619939,85.25013751375137,9
0.2,7272,95,620034,85.25147806957239,6
0.2,7273,88,620122,85.25185592521309,13
0.2,7274,93,620215,85.25292096219931,8
0.2,7275,95,620310,85.25426058273777,6
0.2,7276,91,620401,85.25505015803216,10
0.2,7277,95,620496,85.25638911788953,6
0.2,7278,92,620588,85.2573155653249,10
0.2,7279,92,620680,85.25824175824175,9
0.2,7280,94,620774,85.25944238428787,7
0.2,7281,90,620864,85.2600933809393,11
0.2,7282,91,620955,85.26088150487436,10
0.2,7283,94,621049,85.26208127402526,8
0.2,7284,91,621140,85.26286890871654,10
0.2,7285,95,621235,85.26420532528137,6
0.2,7286,19,621254,85.2551118430081,13
0.2,7287,93,621347,85.2561745334797,8
0.2,7288,91,621438,85.25696254630265,10
0.2,7289,95,621533,85.25829903978052,6
0.2,7290,92,621625,85.25922370045261,9
0.2,7291,92,621717,85.26014810751508,10
0.2,7292,91,621808,85.26093514328808,11
0.2,7293,91,621899,85.26172196325747,10
0.2,7294,92,621991,85.2626456477039,9
0.2,7295,-50,621941,85.24410635964912,13
0.2,7296,93,622034,85.24516924763601,8
0.2,7297,94,622128,85.24636886818307,7
0.2,7298,93,622221,85.24743115495274,9
0.2,7299,91,622312,85.2482191780822,10
0.2,7300,92,622404,85.24914395288317,9
0.2,7301,93,622497,85.25020542317174,8
0.2,7302,93,622590,85.25126660276598,8
0.2,7303,21,622611,85.24246987951807,12
0.2,7304,95,622706,85.24380561259412,6
0.2,7305,86,622792,85.24390911579523,15
0.2,7306,92,622884,85.24483372108936,9
0.2,7307,89,622973,85.24534756431308,12
0.2,7308,95,623068,85.24668217266384,6
0.2,7309,88,623156,85.24705882352941,13
0.2,7310,94,623250,85.2482560525236,7
0.2,7311,94,623344,85.24945295404814,8
0.2,7312,93,623437,85.25051278545057,8
0.2,7313,92,623529,85.25143560295324,9
0.2,7314,91,623620,85.25222146274778,11
0.2,7315,92,623712,85.25314379442318,9
0.2,7316,87,623799,85.25338253382535,15
0.2,7317,92,623891,85.25430445476906,9
0.2,7318,94,623985,85.25549938516191,8
0.2,7319,95,624080,85.2568306010929,6
0.2,7320,89,624169,85.25734189318399,12
0.2,7321,95,624264,85.25867249385414,8
0.2,7322,94,624358,85.25986617506486,7
0.2,7323,96,624454,85.2613326051338,6
0.2,7324,93,624547,85.26238907849829,8
0.2,7325,94,624641,85.26358176358177,7
0.2,7326,91,624732,85.26436467858605,10
0.2,7327,86,624818,85.26446506550218,15
0.2,7328,93,624911,85.26552053486151,8
0.2,7329,94,625005,85.26671214188268,7
0.2,7330,96,625101,85.26817623789387,6
0.2,7331,89,625190,85.26868521549373,13
0.2,7332,94,625284,85.26987590345016,7
0.2,7333,91,625375,85.27065721298064,10
0.2,7334,94,625469,85.27184730743014,8
0.2,7335,93,625562,85.27290076335878,8
0.2,7336,89,625651,85.27340875017038,12
0.2,7337,17,625668,85.26410466067048,15
0.2,7338,90,625758,85.26474996593541,12
0.2,7339,96,625854,85.26621253405995,6
0.2,7340,93,625947,85.26726604004904,8
0.2,7341,94,626041,85.26845546172704,7
0.2,7342,-50,625991,85.25003404603024,14
0.2,7343,96,626087,85.25149782135077,6
0.2,7344,91,626178,85.25228046289993,10
0.2,7345,94,626272,85.25347127688538,7
0.2,7346,88,626360,85.25384510684633,13
0.2,7347,95,626455,85.25517147523135,6
0.2,7348,85,626540,85.25513675329977,17
0.2,7349,94,626634,85.25632653061224,7
0.2,7350,96,626730,85.25778805604679,6
0.2,7351,92,626822,85.25870511425462,9
0.2,7352,93,626915,85.25975792193663,8
0.2,7353,94,627009,85.26094642371498,7
0.2,7354,90,627099,85.26159075458871,11
0.2,7355,85,627184,85.2615551930397,17
0.2,7356,92,627276,85.262471115944,9
0.2,7357,14,627290,85.25278608317477,19
0.2,7358,95,627385,85.254110612855,6
0.2,7359,93,627478,85.25516304347826,10
0.2,7360,95,627573,85.25648689036815,6
0.2,7361,92,627665,85.25740287965228,9
0.2,7362,91,627756,85.25818280592149,10
0.2,7363,89,627845,85.25869092884302,12
0.2,7364,90,627935,85.25933469110659,11
0.2,7365,93,628028,85.26038555525388,8
0.2,7366,96,628124,85.26184335550428,6
0.2,7367,94,628218,85.2630293159609,7
0.2,7368,91,628309,85.26380784366943,10
0.2,7369,92,628401,85.26472184531886,10
0.2,7370,95,628496,85.26604259937594,8
0.2,7371,25,628521,85.25786760716224,7
0.2,7372,90,628611,85.2585107825851,11
0.2,7373,-48,628563,85.24043938161107,12
0.2,7374,90,628653,85.2410847457627,11
0.2,7375,95,628748,85.24240780911063,6
0.2,7376,95,628843,85.24373051375898,6
0.2,7377,96,628939,85.24518839793983,6
0.2,7378,90,629029,85.24583276866784,11
0.2,7379,89,629118,85.24634146341464,13
0.2,7380,96,629214,85.24779840130064,6
0.2,7381,89,629303,85.2483066919534,12
0.2,7382,81,629384,85.24773127454964,20
0.2,7383,26,629410,85.23970747562296,7
0.2,7384,94,629504,85.24089370345294,7
0.2,7385,18,629522,85.2317898727322,15
0.2,7386,93,629615,85.23284147827265,8
0.2,7387,27,629642,85.22495939361126,7
0.2,7388,90,629732,85.22560562999053,12
0.2,7389,94,629826,85.22679296346413,9
0.2,7390,94,629920,85.22797997564605,8
0.2,7391,87,630007,85.2282196969697,14
0.2,7392,92,630099,85.22913566887597,9
0.2,7393,90,630189,85.22978090343521,11
0.2,7394,92,630281,85.23069641649764,9
0.2,7395,96,630377,85.23215251487291,6
0.2,7396,89,630466,85.23266188995538,12
0.2,7397,89,630555,85.23317112733172,12
0.2,7398,90,630645,85.23381538045682,12
0.2,7399,95,630740,85.23513513513514,6
0.2,7400,90,630830,85.23577894879071,12
0.2,7401,96,630926,85.23723318022157,6
0.2,7402,95,631021,85.23855193840335,6
0.2,7403,92,631113,85.23946515397083,9
0.2,7404,92,631205,85.24037812288994,9
0.2,7405,94,631299,85.24156089657035,8
0.2,7406,92,631391,85.24247333603348,10
0.2,7407,95,631486,85.24379049676025,6
0.2,7408,94,631580,85.24497233094884,7
0.2,7409,12,631592,85.23508771929825,23
0.2,7410,88,631680,85.23546080151127,15
0.2,7411,92,631772,85.23637344846195,9
0.2,7412,96,631868,85.23782544179144,6
0.2,7413,95,631963,85.23914216347451,6
0.2,7414,84,632047,85.23897505057316,18
0.2,7415,89,632136,85.23948220064725,12
0.2,7416,91,632227,85.24025886477013,10
0.2,7417,96,632323,85.24170935562147,6
0.2,7418,96,632419,85.24315945545221,6
0.2,7419,94,632513,85.2443396226415,7
0.2,7420,93,632606,85.24538471904056,8
0.2,7421,94,632700,85.24656426839127,7
0.2,7422,93,632793,85.24760878351071,8
0.2,7423,92,632885,85.24851831896552,9
0.2,7424,91,632976,85.24929292929293,10
0.2,7425,94,633070,85.25047131699435,7
0.2,7426,94,633164,85.2516493873704,7
0.2,7427,89,633253,85.25215401184707,12
0.2,7428,93,633346,85.25319693094629,8
0.2,7429,96,633442,85.25464333781964,6
0.2,7430,24,633466,85.24640021531422,8
0.2,7431,88,633554,85.24677072120559,13
0.2,7432,95,633649,85.24808287367146,6
0.2,7433,93,633742,85.24912563895614,8
0.2,7434,94,633836,85.25030262273033,7
0.2,7435,23,633859,85.2419311457773,9
0.2,7436,92,633951,85.24283985478016,9
0.2,7437,89,634040,85.24334498521108,13
0.2,7438,95,634135,85.2446565398575,7
0.2,7439,91,634226,85.24543010752689,10
0.2,7440,94,634320,85.24660663889262,9
0.2,7441,92,634412,85.24751410911045,9
0.2,7442,93,634505,85.24855568990998,8
0.2,7443,95,634600,85.2498656636217,7
0.2,7444,94,634694,85.25104096709201,7
0.2,7445,93,634787,85.25208165457964,9
0.2,7446,91,634878,85.2528534980529,12
0.2,7447,91,634969,85.25362513426423,11
0.2,7448,95,635064,85.25493354812727,9
0.2,7449,27,635091,85.24711409395974,7
0.2,7450,11,635102,85.2371493759227,22
0.2,7451,91,635193,85.237922705314,10
0.2,7452,85,635278,85.23789078223534,16
0.2,7453,95,635373,85.2392004292997,6
0.2,7454,96,635469,85.24064386317907,6
0.2,7455,92,635561,85.24155042918454,10
0.2,7456,94,635655,85.2427249564168,8
0.2,7457,95,635750,85.24403325288282,6
0.2,7458,94,635844,85.24520713232337,7
0.2,7459,91,635935,85.24597855227881,10
0.2,7460,90,636025,85.24661573515614,11
0.2,7461,25,636050,85.23854194585901,8
0.2,7462,92,636142,85.23944794318639,10
0.2,7463,91,636233,85.24021972132904,10
0.2,7464,94,636327,85.24139316811788,7
0.2,7465,92,636419,85.24229841950174,9
0.2,7466,92,636511,85.24320342841837,9
0.2,7467,96,636607,85.24464381360471,6
0.2,7468,88,636695,85.24501271923953,13
0.2,7469,25,636720,85.23694779116465,7
0.2,7470,93,636813,85.23798688261277,8
0.2,7471,89,636902,85.2384903640257,12
0.2,7472,95,636997,85.23979660109728,6
0.2,7473,90,637087,85.24043350280974,11
0.2,7474,92,637179,85.24133779264214,11
0.2,7475,89,637268,85.2418405564473,12
0.2,7476,94,637362,85.24301190316972,7
0.2,7477,92,637454,85.24391548542391,9
0.2,7478,93,637547,85.2449525337612,8
0.2,7479,90,637637,85.24558823529412,11
0.2,7480,90,637727,85.24622376687608,11
0.2,7481,89,637816,85.24672547447207,12
0.2,7482,93,637909,85.247761592944,8
0.2,7483,90,637999,85.24839657936933,11
0.2,7484,82,638081,85.24796259185037,19
0.2,7485,94,638175,85.24913171253006,8
0.2,7486,94,638269,85.2503005209029,7
0.2,7487,17,638286,85.2411858974359,16
0.2,7488,91,638377,85.24195486713847,10
0.2,7489,86,638463,85.24205607476635,15
0.2,7490,93,638556,85.24309171005206,8
0.2,7491,91,638647,85.24386011745862,10
0.2,7492,93,638740,85.24489523555319,8
0.2,7493,95,638835,85.24619695756606,6
0.2,7494,94,638929,85.24736490993996,7
0.2,7495,90,639019,85.24799893276415,11
0.2,7496,90,639109,85.24863278644791,11
0.2,7497,84,639193,85.24846625766871,17
0.2,7498,93,639286,85.24949993332444,8
0.2,7499,87,639373,85.24973333333334,14
0.2,7500,96,639469,85.25116651113184,6
0.2,7501,81,639550,85.25059984004265,20
0.2,7502,90,639640,85.25123284019726,11
0.2,7503,89,639729,85.25173240938166,12
0.2,7504,94,639823,85.2528980679547,7
0.2,7505,95,639918,85.25419664268586,6
0.2,7506,27,639945,85.24643665911816,6
0.2,7507,27,639972,85.23867874267448,6
0.2,7508,23,639995,85.23039019842855,10
0.2,7509,96,640091,85.23182423435419,6
0.2,7510,94,640185,85.23299161230196,7
0.2,7511,94,640279,85.23415867944622,8
0.2,7512,94,640373,85.2353254359111,7
0.2,7513,95,640468,85.23662496672877,6
0.2,7514,88,640556,85.23699268130406,15
0.2,7515,89,640645,85.23749334752527,12
0.2,7516,83,640728,85.23719568976985,18
0.2,7517,93,640821,85.23822825219473,8
0.2,7518,93,640914,85.23926053996541,8
0.2,7519,94,641008,85.2404255319149,7
0.2,7520,90,641098,85.24105836989762,11
0.2,7521,90,641188,85.24169103961712,13
0.2,7522,87,641275,85.24192476405689,14
0.2,7523,93,641368,85.24295587453483,8
0.2,7524,94,641462,85.2441196013289,7
0.2,7525,94,641556,85.24528301886792,7
0.2,7526,21,641577,85.2367477082503,12
0.2,7527,92,641669,85.23764612114772,9
0.2,7528,94,641763,85.23880993491832,7
0.2,7529,93,641856,85.2398406374502,8
0.2,7530,93,641949,85.24087106625946,8
0.2,7531,94,642043,85.24203398831652,7
0.2,7532,92,642135,85.24293110314616,9
0.2,7533,80,642215,85.24223520042474,23
0.2,7534,95,642310,85.2435301924353,6
0.2,7535,90,642400,85.24416135881104,11
0.2,7536,95,642495,85.24545575162531,6
0.2,7537,27,642522,85.23772884054125,6
0.2,7538,94,642616,85.23889109961533,8
0.2,7539,90,642706,85.2395225464191,11
0.2,7540,93,642799,85.24055165097467,8
0.2,7541,87,642886,85.2407849376823,14
0.2,7542,94,642980,85.24194617526183,7
0.2,7543,89,643069,85.24244432661717,13
0.2,7544,93,643162,85.24347249834328,10
0.2,7545,92,643254,85.24436787702093,10
0.2,7546,92,643346,85.24526301841792,9
0.2,7547,91,643437,85.24602543720191,10
0.2,7548,-115,643322,85.21949927142668,10
0.2,7549,93,643415,85.2205298013245,8
0.2,7550,94,643509,85.2216924910608,8
0.2,7551,93,643602,85.22272245762711,8
0.2,7552,96,643698,85.22414934463127,6
0.2,7553,95,643793,85.22544347365634,7
0.2,7554,93,643886,85.2264725347452,9
0.2,7555,92,643978,85.22736897829539,9
0.2,7556,90,644068,85.22800052931058,11
0.2,7557,90,644158,85.22863191320455,11
0.2,7558,93,644251,85.22966000793755,8
0.2,7559,93,644344,85.23068783068783,9
0.2,7560,90,644434,85.23131860864964,11
0.2,7561,92,644526,85.23221370007934,9
0.2,7562,91,644617,85.23297633214332,10
0.2,7563,93,644710,85.23400317292437,8
0.2,7564,87,644797,85.23423661599472,14
0.2,7565,96,644893,85.23565952947396,6
0.2,7566,95,644988,85.2369499141007,7
0.2,7567,74,645062,85.23546511627907,28
0.2,7568,92,645154,85.23635883207821,10
0.2,7569,92,645246,85.23725231175693,9
0.2,7570,94,645340,85.23840972130498,8
0.2,7571,91,645431,85.2391706286318,12
0.2,7572,92,645523,85.24006338307144,9
0.2,7573,89,645612,85.24055980987589,12
0.2,7574,93,645705,85.24158415841585,8
0.2,7575,92,645797,85.2424762407603,9
0.2,7576,93,645890,85.24350006598918,8
0.2,7577,92,645982,85.24439166006862,9
0.2,7578,92,646074,85.24528301886792,10
0.2,7579,92,646166,85.24617414248021,9
0.2,7580,96,646262,85.24759266587522,6
0.2,7581,93,646355,85.24861514112371,8
0.2,7582,87,646442,85.24884610312542,14
0.2,7583,93,646535,85.24986814345992,8
0.2,7584,91,646626,85.25062623599209,11
0.2,7585,95,646721,85.25191141576589,6
0.2,7586,94,646815,85.2530644523527,7
0.2,7587,93,646908,85.25408539799683,8
0.2,7588,92,647000,85.25497430491501,10
0.2,7589,93,647093,85.25599472990777,8
0.2,7590,93,647186,85.25701488604926,8
0.2,7591,93,647279,85.25803477344573,8
0.2,7592,94,647373,85.25918609245358,7
0.2,7593,94,647467,85.26033710824335,8
0.2,7594,90,647557,85.26096115865701,11
0.2,7595,91,647648,85.26171669299632,12
0.2,7596,93,647741,85.26273529024616,9
0.2,7597,92,647833,85.26362200579099,11
0.2,7598,92,647925,85.26450848795895,9
0.2,7599,94,648019,85.26565789473685,7
0.2,7600,88,648107,85.26601762925931,13
0.2,7601,93,648200,85.2670349907919,8
0.2,7602,92,648292,85.2679205576746,9
0.2,7603,91,648383,85.26867438190426,10
0.2,7604,87,648470,85.26890203813281,15
0.2,7605,93,648563,85.26991848540627,8
0.2,7606,93,648656,85.27093466543973,8
0.2,7607,89,648745,85.27142481598318,12
0.2,7608,95,648840,85.27270337757918,6
0.2,7609,27,648867,85.26504599211563,6
0.2,7610,92,648959,85.26593088950203,9
0.2,7611,93,649052,85.26694692590647,8
0.2,7612,91,649143,85.26769998686457,12
0.2,7613,96,649239,85.26910953506699,6
0.2,7614,90,649329,85.26973079448457,11
0.2,7615,90,649419,85.2703518907563,11
0.2,7616,95,649514,85.27162925036103,6
0.2,7617,92,649606,85.27251247046469,9
0.2,7618,94,649700,85.27365796036226,7
0.2,7619,91,649791,85.2744094488189,10
0.2,7620,95,649886,85.27568560556358,6
0.2,7621,25,649911,85.26777748622409,7
0.2,7622,92,650003,85.268660632297,9
0.2,7623,90,650093,85.26928121720881,11
0.2,7624,94,650187,85.2704262295082,8
0.2,7625,92,650279,85.27130868082874,9
0.2,7626,88,650367,85.27166644814474,13
0.2,7627,90,650457,85.27228631358155,12
0.2,7628,93,650550,85.27329925285096,8
0.2,7629,96,650646,85.27470511140235,6
0.2,7630,95,650741,85.27597955706985,6
0.2,7631,95,650836,85.27725366876311,6
0.2,7632,92,650928,85.27813441635006,9
0.2,7633,92,651020,85.27901493319361,9
0.2,7634,94,651114,85.28015717092337,8
0.2,7635,92,651206,85.28103719224725,9
0.2,7636,95,651301,85.28230980751604,6
0.2,7637,90,651391,85.28292746792354,12
0.2,7638,93,651484,85.28393768817908,8
0.2,7639,94,651578,85.28507853403141,7
0.2,7640,93,651671,85.2860882083497,8
0.2,7641,94,651765,85.28722847422141,7
0.2,7642,27,651792,85.27960225042523,6
0.2,7643,94,651886,85.28074306645735,7
0.2,7644,96,651982,85.28214519293655,6
0.2,7645,92,652074,85.28302380329585,9
0.2,7646,93,652167,85.28403295409964,8
0.2,7647,25,652192,85.27615062761507,8
0.2,7648,95,652287,85.27742188521376,7
0.2,7649,94,652381,85.27856209150326,7
0.2,7650,23,652404,85.27042216703698,10
0.2,7651,92,652496,85.27130162049137,9
0.2,7652,93,652589,85.27231151182542,8
0.2,7653,95,652684,85.27358244055395,6
0.2,7654,96,652780,85.2749836708034,6
0.2,7655,95,652875,85.2762539184953,6
0.2,7656,93,652968,85.27726263549692,8
0.2,7657,93,653061,85.2782710890572,8
0.2,7658,94,653155,85.27940984462724,7
0.2,7659,95,653250,85.28067885117494,6
0.2,7660,93,653343,85.2816864639081,8
0.2,7661,90,653433,85.28230227094754,12
0.2,7662,86,653519,85.28239592848753,15
0.2,7663,93,653612,85.28340292275574,8
0.2,7664,96,653708,85.28480104370516,6
0.2,7665,91,653799,85.2855465692669,10
0.2,7666,95,653894,85.28681361679926,6
0.2,7667,94,653988,85.28794992175274,7
0.2,7668,91,654079,85.28869474507759,11
0.2,7669,93,654172,85.2897001303781,9
0.2,7670,96,654268,85.29109633685309,6
0.2,7671,93,654361,85.29210114702815,8
0.2,7672,89,654450,85.2925843868109,12
0.2,7673,96,654546,85.29397967161846,7
0.2,7674,91,654637,85.29472312703584,10
0.2,7675,92,654729,85.29559666492965,9
0.2,7676,92,654821,85.29646997525074,9
0.2,7677,95,654916,85.2977337848398,6
0.2,7678,93,655009,85.2987368146894,8
0.2,7679,23,655032,85.290625,9
0.2,7680,96,655128,85.29201926832444,6
0.2,7681,92,655220,85.29289247591772,9
0.2,7682,96,655316,85.29428608616426,6
0.2,7683,90,655406,85.2948984903696,12
0.2,7684,25,655431,85.28705270006506,8
0.2,7685,94,655525,85.28818631277647,7
0.2,7686,94,655619,85.28931963054508,8
0.2,7687,94,655713,85.29045265348596,7
0.2,7688,90,655803,85.29106515801794,13
0.2,7689,87,655890,85.29128738621587,14
0.2,7690,95,655985,85.29254973345469,6
0.2,7691,96,656081,85.29394175767031,6
0.2,7692,95,656176,85.29520343169115,6
0.2,7693,95,656271,85.2964647777489,6
0.2,7694,94,656365,85.29759584145549,8
0.2,7695,85,656450,85.29755717255718,16
0.2,7696,88,656538,85.29790827595167,13
0.2,7697,94,656632,85.2990387113536,7
0.2,7698,95,656727,85.30029874009611,6
0.2,7699,94,656821,85.30142857142857,7
0.2,7700,93,656914,85.30242825607064,9
0.2,7701,-56,656858,85.28408205660867,21
0.2,7702,94,656952,85.2852135531611,7
0.2,7703,90,657042,85.28582554517133,12
0.2,7704,93,657135,85.28682673588578,8
0.2,7705,85,657220,85.2867895146639,16
0.2,7706,73,657293,85.28519527702089,29
0.2,7707,91,657384,85.28593668915413,10
0.2,7708,92,657476,85.28680762744844,10
0.2,7709,94,657570,85.28793774319067,7
0.2,7710,94,657664,85.28906756581507,8
0.2,7711,96,657760,85.29045643153528,6
0.2,7712,21,657781,85.28212109425645,12
0.2,7713,95,657876,85.283380865958,8
0.2,7714,94,657970,85.28451069345431,7
0.2,7715,89,658059,85.28499222395023,14
0.2,7716,95,658154,85.2862511338603,6
0.2,7717,95,658249,85.2875097175434,7
0.2,7718,89,658338,85.28799067236689,12
0.2,7719,94,658432,85.28911917098445,9
0.2,7720,91,658523,85.28985882657688,10
0.2,7721,90,658613,85.2904687904688,11
0.2,7722,81,658694,85.28991324614788,20
0.2,7723,92,658786,85.29078197824961,9
0.2,7724,93,658879,85.29177993527509,8
0.2,7725,90,658969,85.29238933471396,11
0.2,7726,93,659062,85.29338682541737,8
0.2,7727,96,659158,85.29477225672878,6
0.2,7728,93,659251,85.2957691810066,8
0.2,7729,96,659347,85.29715394566624,6
0.2,7730,95,659442,85.29840900271634,6
0.2,7731,93,659535,85.29940506983962,9
0.2,7732,93,659628,85.30040087934825,8
0.2,7733,95,659723,85.30165502973881,6
0.2,7734,86,659809,85.30174531351003,15
0.2,7735,93,659902,85.30274043433299,8
0.2,7736,92,659994,85.30360604885614,10
0.2,7737,20,660014,85.29516670974412,12
0.2,7738,94,660108,85.29629151053108,7
0.2,7739,90,660198,85.2968992248062,11
0.2,7740,95,660293,85.29815269345046,8
0.2,7741,90,660383,85.29876001033325,11
0.2,7742,23,660406,85.29071419346506,10
0.2,7743,22,660428,85.28254132231405,10
0.2,7744,94,660522,85.28366688185926,7
0.2,7745,90,660612,85.2842757552285,11
0.2,7746,92,660704,85.28514263585905,10
0.2,7747,25,660729,85.27736189984512,8
0.2,7748,94,660823,85.27848754678023,7
0.2,7749,95,660918,85.27974193548387,6
0.2,7750,94,661012,85.28086698490517,7
0.2,7751,87,661099,85.28108875128999,16
0.2,7752,90,661189,85.28169740745518,11
0.2,7753,95,661284,85.28295073510446,6
0.2,7754,96,661380,85.28433268858801,6
0.2,7755,-48,661332,85.26714801444044,12
0.2,7756,94,661426,85.26827381719737,7
0.2,7757,93,661519,85.26927043052333,8
0.2,7758,90,661609,85.26988013919319,11
0.2,7759,96,661705,85.27126288659794,6
0.2,7760,93,661798,85.27225872954516,9
0.2,7761,95,661893,85.27351198144808,6
0.2,7762,92,661985,85.27437846193482,9
0.2,7763,94,662079,85.27550231839258,7
0.2,7764,92,662171,85.27636831938185,10
0.2,7765,95,662266,85.27762039660057,6
0.2,7766,95,662361,85.27887215140981,7
0.2,7767,95,662456,85.28012358393408,6
0.2,7768,94,662550,85.28124597760329,7
0.2,7769,90,662640,85.28185328185329,11
0.2,7770,20,662660,85.27345258010553,12
0.2,7771,94,662754,85.27457539886773,7
0.2,7772,94,662848,85.27569792872765,7
0.2,7773,93,662941,85.27669153588886,8
0.2,7774,92,663033,85.27755627009647,12
0.2,7775,89,663122,85.27803497942386,12
0.2,7776,78,663200,85.27709913848528,23
0.2,7777,93,663293,85.27809205451273,8
0.2,7778,86,663379,85.27818485666538,15
0.2,7779,93,663472,85.27917737789203,8
0.2,7780,92,663564,85.28004112581931,9
0.2,7781,94,663658,85.28116165510151,7
0.2,7782,92,663750,85.28202492612104,10
0.2,7783,80,663830,85.28134635149024,22
0.2,7784,94,663924,85.2824662813102,7
0.2,7785,92,664016,85.28332905214488,9
0.2,7786,92,664108,85.28419160138692,9
0.2,7787,86,664194,85.28428351309707,15
0.2,7788,92,664286,85.2851457183207,10
0.2,7789,91,664377,85.28587933247753,10
0.2,7790,96,664473,85.28725452445128,6
0.2,7791,27,664500,85.27977412731006,6
0.2,7792,84,664584,85.27960990632619,17
0.2,7793,92,664676,85.28047215807031,9
0.2,7794,94,664770,85.28159076330981,8
0.2,7795,95,664865,85.28283735248846,7
0.2,7796,92,664957,85.28369885853533,9
0.2,7797,95,665052,85.28494485765582,6
0.2,7798,79,665131,85.28413899217848,22
0.2,7799,94,665225,85.28525641025641,7
0.2,7800,94,665319,85.2863735418536,7
0.2,7801,92,665411,85.2872340425532,9
0.2,7802,91,665502,85.2879661668589,12
0.2,7803,93,665595,85.28895438236802,8
0.2,7804,96,665691,85.2903267136451,6
0.2,7805,21,665712,85.28209069946195,12
0.2,7806,94,665806,85.2832073779941,7
0.2,7807,94,665900,85.28432377049181,7
0.2,7808,94,665994,85.28543987706493,7
0.2,7809,95,666089,85.28668373879641,7
0.2,7810,89,666178,85.28715913455383,12
0.2,7811,92,666270,85.28801843317973,9
0.2,7812,90,666360,85.2886215282222,11
0.2,7813,92,666452,85.2894804197594,9
0.2,7814,94,666546,85.29059500959693,7
0.2,7815,90,666636,85.29119754350052,11
0.2,7816,95,666731,85.29243955481643,6
0.2,7817,95,666826,85.29368124840113,6
0.2,7818,22,666848,85.28558639212176,11
0.2,7819,94,666942,85.28670076726343,8
0.2,7820,92,667034,85.2875591356604,9
0.2,7821,91,667125,85.28828944004091,10
0.2,7822,90,667215,85.28889172951553,11
0.2,7823,94,667309,85.29000511247443,8
0.2,7824,96,667405,85.29137380191693,6
0.2,7825,94,667499,85.29248658318426,7
0.2,7826,95,667594,85.29372684297942,6
0.2,7827,93,667687,85.2947112927951,8
0.2,7828,94,667781,85.2958232213565,7
0.2,7829,93,667874,85.29680715197956,8
0.2,7830,91,667965,85.29753543608734,10
0.2,7831,95,668060,85.29877425944842,8
0.2,7832,93,668153,85.29975743648666,8
0.2,7833,96,668249,85.30112330865458,6
0.2,7834,93,668342,85.30210593490747,8
0.2,7835,96,668438,85.30347115875446,6
0.2,7836,88,668526,85.30381523542172,13
0.2,7837,95,668621,85.30505230926256,8
0.2,7838,87,668708,85.30526852914913,14
0.2,7839,92,668800,85.3061224489796,9
0.2,7840,88,668888,85.30646601198826,13
0.2,7841,92,668980,85.3073195613364,10
0.2,7842,87,669067,85.30753538186919,14
0.2,7843,94,669161,85.30864354920959,8
0.2,7844,92,669253,85.30949649458253,9
0.2,7845,94,669347,85.31060412949273,8
0.2,7846,93,669440,85.31158404485791,8
0.2,7847,94,669534,85.31269113149847,7
0.2,7848,87,669621,85.31290610268825,14
0.2,7849,89,669710,85.31337579617835,12
0.2,7850,94,669804,85.31448223156286,7
0.2,7851,93,669897,85.3154610290372,8
0.2,7852,94,669991,85.31656691710174,7
0.2,7853,90,670081,85.31716322892794,11
0.2,7854,92,670173,85.31801400381923,10
0.2,7855,94,670267,85.31911914460285,8
0.2,7856,91,670358,85.3198421789487,10
0.2,7857,96,670454,85.32120132349198,6
0.2,7858,94,670548,85.32230563684948,7
0.2,7859,88,670636,85.32264631043257,13
0.2,7860,94,670730,85.32375015901285,7
0.2,7861,96,670826,85.32510811498346,6
0.2,7862,93,670919,85.3260841917843,8
0.2,7863,84,671003,85.32591556459816,17
0.2,7864,89,671092,85.3263827082009,12
0.2,7865,93,671185,85.3273582506992,8
0.2,7866,91,671276,85.32807931867293,11
0.2,7867,95,671371,85.3293085917641,7
0.2,7868,94,671465,85.33041047147033,8
0.2,7869,94,671559,85.33151207115628,7
0.2,7870,93,671652,85.33248634226909,10
0.2,7871,96,671748,85.33384146341463,6
0.2,7872,90,671838,85.33443414200431,11
0.2,7873,96,671934,85.33578867157735,6
0.2,7874,91,672025,85.33650793650794,10
0.2,7875,95,672120,85.33773489080751,6
0.2,7876,91,672211,85.33845372603783,10
0.2,7877,87,672298,85.33866463569434,14
0.2,7878,88,672386,85.33900241147354,13
0.2,7879,88,672474,85.33934010152284,13
0.2,7880,91,672565,85.34005836822739,10
0.2,7881,94,672659,85.34115706673433,7
0.2,7882,96,672755,85.34250919700622,6
0.2,7883,24,672779,85.33472856418062,9
0.2,7884,93,672872,85.33570069752695,8
0.2,7885,85,672957,85.33565812832869,16
0.2,7886,94,673051,85.33675668822113,7
0.2,7887,24,673075,85.32898073022312,8
0.2,7888,92,673167,85.32982634047407,10
0.2,7889,91,673258,85.33054499366287,11
0.2,7890,88,673346,85.33088328475479,13
0.2,7891,95,673441,85.33210846426762,6
0.2,7892,94,673535,85.33320663879387,8
0.2,7893,94,673629,85.33430453508994,8
0.2,7894,95,673724,85.33552881570614,6
0.2,7895,91,673815,85.3362462006079,10
0.2,7896,92,673907,85.3370900341902,10
0.2,7897,92,673999,85.33793365408964,9
0.2,7898,92,674091,85.33877706038739,9
0.2,7899,94,674185,85.33987341772152,7
0.2,7900,89,674274,85.34033666624478,12
0.2,7901,94,674368,85.34143254872184,7
0.2,7902,87,674455,85.34164241427307,14
0.2,7903,93,674548,85.34261133603239,9
0.2,7904,94,674642,85.34370651486401,7
0.2,7905,19,674661,85.33531495067038,13
0.2,7906,92,674753,85.33615783482989,10
0.2,7907,92,674845,85.33700050581689,9
0.2,7908,93,674938,85.33796940194715,9
0.2,7909,92,675030,85.33881163084703,9
0.2,7910,95,675125,85.34003286563014,6
0.2,7911,94,675219,85.34112740141558,8
0.2,7912,93,675312,85.34209528623784,8
0.2,7913,94,675406,85.34318928481173,7
0.2,7914,95,675501,85.3444093493367,6
0.2,7915,85,675586,85.34436584133401,16
0.2,7916,92,675678,85.34520651762031,11
0.2,7917,93,675771,85.34617327607982,8
0.2,7918,91,675862,85.34688723323652,12
0.2,7919,-50,675812,85.32979797979797,13
0.2,7920,92,675904,85.33064007069814,9
0.2,7921,90,675994,85.33122948750315,11
0.2,7922,92,676086,85.33207118515713,9
0.2,7923,92,676178,85.3329126703685,9
0.2,7924,94,676272,85.33400630914826,7
0.2,7925,90,676362,85.33459500378501,11
0.2,7926,96,676458,85.33594045666709,6
0.2,7927,96,676554,85.33728557013119,6
0.2,7928,94,676648,85.33837810568798,7
0.2,7929,94,676742,85.33947036569987,8
0.2,7930,91,676833,85.34018408775691,13
0.2,7931,90,676923,85.34077155824508,11
0.2,7932,96,677019,85.342115214925,6
0.2,7933,91,677110,85.34282833375346,12
0.2,7934,93,677203,85.34379332073094,8
0.2,7935,94,677297,85.34488407258064,8
0.2,7936,90,677387,85.34547058082399,12
0.2,7937,94,677481,85.34656084656085,7
0.2,7938,93,677574,85.34752487718856,8
0.2,7939,90,677664,85.34811083123425,12
0.2,7940,91,677755,85.3488225664274,10
0.2,7941,93,677848,85.3497859481239,8
0.2,7942,22,677870,85.34181039909355,10
0.2,7943,94,677964,85.3429003021148,7
0.2,7944,83,678047,85.34260541220894,18
0.2,7945,92,678139,85.34344324188271,9
0.2,7946,92,678231,85.34428086070216,9
0.2,7947,94,678325,85.34536990437846,8
0.2,7948,94,678419,85.34645867404706,7
0.2,7949,93,678512,85.3474213836478,8
0.2,7950,86,678598,85.34750345868444,15
0.2,7951,89,678687,85.34796277665995,12
0.2,7952,90,678777,85.34854771784232,11
0.2,7953,95,678872,85.34976112647725,7
0.2,7954,92,678964,85.35059710873665,10
0.2,7955,95,679059,85.35180995475113,6
0.2,7956,92,679151,85.35264546939801,9
0.2,7957,92,679243,85.35348077406384,9
0.2,7958,92,679335,85.35431586882774,9
0.2,7959,92,679427,85.35515075376884,9
0.2,7960,92,679519,85.3559854289662,9
0.2,7961,85,679604,85.35594071841246,17
0.2,7962,90,679694,85.35652392314455,11
0.2,7963,94,679788,85.35760924158714,7
0.2,7964,94,679882,85.35869428750784,7
0.2,7965,18,679900,85.35023851368315,16
0.2,7966,88,679988,85.35057110581147,13
0.2,7967,91,680079,85.35128012048193,10
0.2,7968,92,680171,85.35211444346844,9
0.2,7969,92,680263,85.35294855708908,10
0.2,7970,92,680355,85.35378246142265,10
0.2,7971,90,680445,85.35436527847466,11
0.2,7972,96,680541,85.35570048915089,6
0.2,7973,91,680632,85.35640832706295,10
0.2,7974,90,680722,85.35699059561128,11
0.2,7975,23,680745,85.34917251755266,9
0.2,7976,93,680838,85.35013162843174,8
0.2,7977,92,680930,85.35096515417398,9
0.2,7978,94,681024,85.35204912896353,8
0.2,7979,88,681112,85.35238095238095,14
0.2,7980,93,681205,85.35333918055382,8
0.2,7981,92,681297,85.35417188674518,9
0.2,7982,92,681389,85.35500438431667,10
0.2,7983,82,681471,85.35458416833667,20
0.2,7984,95,681566,85.35579211020664,6
0.2,7985,27,681593,85.34848484848484,6
0.2,7986,27,681620,85.3411794165519,6
0.2,7987,94,681714,85.34226339509264,7
0.2,7988,88,681802,85.3425960695957,13
0.2,7989,91,681893,85.34330413016271,10
0.2,7990,89,681982,85.34376173194845,12
0.2,7991,95,682077,85.34496996996997,7
0.2,7992,91,682168,85.34567746778431,10
0.2,7993,95,682263,85.3468851638729,6
0.2,7994,93,682356,85.34784240150094,8
0.2,7995,91,682447,85.34854927463732,10
0.2,7996,96,682543,85.34988120545205,6
0.2,7997,92,682635,85.35071267816954,9
0.2,7998,92,682727,85.35154394299288,9
0.2,7999,94,682821,85.352625,8
0.2,8000,92,682913,85.35345581802275,9
0.2,8001,91,683004,85.3541614596351,10
0.2,8002,27,683031,85.34686992377858,6
0.2,8003,90,683121,85.34745127436283,11
0.2,8004,91,683212,85.34815740162398,10
0.2,8005,89,683301,85.34861353984512,13
0.2,8006,95,683396,85.3498189084551,6
0.2,8007,23,683419,85.34203296703296,10
0.2,8008,86,683505,85.34211512048945,15
0.2,8009,93,683598,85.34307116104868,9
0.2,8010,93,683691,85.34402696292598,8
0.2,8011,94,683785,85.34510733899151,8
0.2,8012,92,683877,85.34593785099214,10
0.2,8013,26,683903,85.33853256800599,7
0.2,8014,27,683930,85.3312538989395,6
0.2,8015,84,684014,85.3310878243513,17
0.2,8016,91,684105,85.33179493576151,11
0.2,8017,93,684198,85.3327513095535,8
0.2,8018,26,684224,85.32535228831524,7
0.2,8019,88,684312,85.32568578553617,13
0.2,8020,91,684403,85.32639321780327,10
0.2,8021,92,684495,85.32722513089006,9
0.2,8022,96,684591,85.32855540321576,6
0.2,8023,96,684687,85.3298853439681,6
0.2,8024,88,684775,85.33021806853583,13
0.2,8025,96,684871,85.33154747072015,6
0.2,8026,94,684965,85.33262738258378,7
0.2,8027,94,685059,85.33370702541106,10
0.2,8028,94,685153,85.33478639930253,7
0.2,8029,90,685243,85.33536737235367,11
0.2,8030,93,685336,85.33632175320632,8
0.2,8031,26,685362,85.32893426294821,7
0.2,8032,93,685455,85.32988920702104,8
0.2,8033,92,685547,85.33071944236993,9
0.2,8034,95,685642,85.33192283758557,7
0.2,8035,95,685737,85.33312593330015,6
0.2,8036,88,685825,85.33345775786985,14
0.2,8037,92,685917,85.33428713610351,9
0.2,8038,92,686009,85.3351163079985,9
0.2,8039,91,686100,85.33582089552239,10
0.2,8040,91,686191,85.33652530779754,10
0.2,8041,94,686285,85.33760258642128,7
0.2,8042,96,686381,85.33892826059927,6
0.2,8043,92,686473,85.33975634012928,9
0.2,8044,95,686568,85.34095711622126,7
0.2,8045,85,686653,85.3409147402436,16
0.2,8046,92,686745,85.34174226419783,9
0.2,8047,93,686838,85.34269383697813,8
0.2,8048,87,686925,85.34289973909803,14
0.2,8049,92,687017,85.34372670807453,11
0.2,8050,90,687107,85.34430505527264,11
0.2,8051,94,687201,85.34538002980626,9
0.2,8052,94,687295,85.34645473736495,7
0.2,8053,89,687384,85.34690836851254,12
0.2,8054,94,687478,85.347982619491,8
0.2,8055,93,687571,85.34893247269116,8
0.2,8056,94,687665,85.35000620578379,7
0.2,8057,95,687760,85.3512037726483,6
0.2,8058,92,687852,85.35202878769078,9
0.2,8059,93,687945,85.3529776674938,8
0.2,8060,92,688037,85.3538022577844,9
0.2,8061,96,688133,85.35512279831308,6
0.2,8062,96,688229,85.35644301128612,6
0.2,8063,93,688322,85.35739087301587,8
0.2,8064,92,688414,85.35821450712957,9
0.2,8065,87,688501,85.3584180510786,14
0.2,8066,96,688597,85.3597372009421,6
0.2,8067,96,688693,85.36105602379772,6
0.2,8068,91,688784,85.36175486429545,10
0.2,8069,18,688802,85.35340768277571,14
0.2,8070,94,688896,85.3544789988849,8
0.2,8071,87,688983,85.35468285431119,16
0.2,8072,89,689072,85.35513439861266,12
0.2,8073,93,689165,85.35608124845182,10
0.2,8074,93,689258,85.35702786377709,8
0.2,8075,89,689347,85.35747894997523,12
0.2,8076,89,689436,85.3579299244769,14
0.2,8077,93,689529,85.35887595939589,9
0.2,8078,87,689616,85.35907909394727,14
0.2,8079,93,689709,85.36002475247524,8
0.2,8080,96,689805,85.36134141814132,6
0.2,8081,88,689893,85.36166790398416,13
0.2,8082,93,689986,85.36261289125325,8
0.2,8083,92,690078,85.36343394359228,10
0.2,8084,93,690171,85.3643784786642,8
0.2,8085,90,690261,85.36495176848875,11
0.2,8086,92,690353,85.36577222703104,9
0.2,8087,94,690447,85.36683976261128,7
0.2,8088,87,690534,85.36704166151564,15
0.2,8089,95,690629,85.36823238566132,6
0.2,8090,94,690723,85.36929922135707,7
0.2,8091,92,690815,85.37011863568956,10
0.2,8092,90,690905,85.37069072037563,11
0.2,8093,96,691001,85.37200395354584,7
0.2,8094,94,691095,85.37306979617047,7
0.2,8095,94,691189,85.37413537549408,7
0.2,8096,91,691280,85.37483018401878,11
0.2,8097,15,691295,85.36613978760188,18
0.2,8098,93,691388,85.3670823558464,8
0.2,8099,87,691475,85.36728395061728,14
0.2,8100,91,691566,85.36797926181953,10
0.2,8101,93,691659,85.36892125401135,8
0.2,8102,85,691744,85.36887572504011,16
0.2,8103,89,691833,85.36932379072063,12
0.2,8104,23,691856,85.36162862430598,11
0.2,8105,93,691949,85.3625709351098,8
0.2,8106,93,692042,85.36351301344517,8
0.2,8107,93,692135,85.36445485939812,8
0.2,8108,91,692226,85.36514983351832,10
0.2,8109,94,692320,85.36621454993835,7
0.2,8110,95,692415,85.3674022931821,6
0.2,8111,94,692509,85.36846646942801,8
0.2,8112,95,692604,85.36965364230248,7
0.2,8113,90,692694,85.37022430367267,11
0.2,8114,91,692785,85.37091805298829,11
0.2,8115,91,692876,85.37161163134549,10
0.2,8116,86,692962,85.37168904767772,15
0.2,8117,92,693054,85.37250554323725,9
0.2,8118,95,693149,85.37369134129818,6
0.2,8119,94,693243,85.37475369458129,7
0.2,8120,92,693335,85.37556951114395,11
0.2,8121,25,693360,85.36813592711155,9
0.2,8122,96,693456,85.36944478640896,6
0.2,8123,86,693542,85.36952240275727,15
0.2,8124,95,693637,85.37070769230769,7
0.2,8125,82,693719,85.3702928870293,19
0.2,8126,92,693811,85.37110865017841,9
0.2,8127,89,693900,85.37155511811024,12
0.2,8128,89,693989,85.37200147619633,13
0.2,8129,93,694082,85.37293972939729,8
0.2,8130,96,694178,85.37424671012175,6
0.2,8131,95,694273,85.37543039842598,6
0.2,8132,92,694365,85.37624492807082,9
0.2,8133,90,694455,85.37681337595279,11
0.2,8134,90,694545,85.37738168408113,11
0.2,8135,92,694637,85.37819567354965,9
0.2,8136,91,694728,85.37888656753103,11
0.2,8137,86,694814,85.378962890145,15
0.2,8138,92,694906,85.37977638530532,9
0.2,8139,95,695001,85.38095823095823,6
0.2,8140,85,695086,85.38091143594153,16
0.2,8141,92,695178,85.38172439204126,9
0.2,8142,95,695273,85.38290556306029,6
0.2,8143,93,695366,85.38384086444007,8
0.2,8144,93,695459,85.38477593615715,8
0.2,8145,89,695548,85.38521973974957,12
0.2,8146,90,695638,85.38578617896158,11
0.2,8147,91,695729,85.38647520864016,10
0.2,8148,94,695823,85.38753221254142,7
0.2,8149,94,695917,85.38858895705522,7
0.2,8150,92,696009,85.3894000736106,9
0.2,8151,27,696036,85.38223748773306,6
0.2,8152,93,696129,85.38317183858702,8
0.2,8153,93,696222,85.3841059602649,8
0.2,8154,95,696317,85.38528510116492,6
0.2,8155,95,696412,85.38646395291809,6
0.2,8156,89,696501,85.38690695108495,12
0.2,8157,25,696526,85.37950478058347,8
0.2,8158,93,696619,85.38043877926216,9
0.2,8159,94,696713,85.38149509803921,7
0.2,8160,93,696806,85.38242862394314,8
0.2,8161,92,696898,85.38323940210732,9
0.2,8162,93,696991,85.38417248560579,8
0.2,8163,21,697012,85.37628613424792,11
0.2,8164,94,697106,85.37734231475811,7
0.2,8165,92,697198,85.37815331863825,10
0.2,8166,92,697290,85.3789641239133,9
0.2,8167,93,697383,85.3798971596474,8
0.2,8168,95,697478,85.38107479495655,6
0.2,8169,89,697567,85.38151774785801,12
0.2,8170,94,697661,85.38257251254437,7
0.2,8171,92,697753,85.38338228095937,11
0.2,8172,88,697841,85.38370243484644,13
0.2,8173,91,697932,85.38438952777098,10
0.2,8174,95,698027,85.38556574923547,6
0.2,8175,93,698120,85.38649706457926,8
0.2,8176,94,698214,85.38755044637398,7
0.2,8177,90,698304,85.38811445341159,12
0.2,8178,96,698400,85.38941190854628,6
0.2,8179,93,698493,85.3903422982885,8
0.2,8180,93,698586,85.39127246057939,9
0.2,8181,91,698677,85.39195795648986,10
0.2,8182,92,698769,85.39276548942931,9
0.2,8183,94,698863,85.39381720430107,7
0.2,8184,95,698958,85.39499083689677,7
0.2,8185,96,699054,85.39628634253604,7
0.2,8186,95,699149,85.39745938683278,6
0.2,8187,94,699243,85.3985100146556,7
0.2,8188,92,699335,85.39931615581878,9
0.2,8189,90,699425,85.3998778998779,11
0.2,8190,91,699516,85.4005615919912,10
0.2,8191,85,699601,85.4005126953125,16
0.2,8192,94,699695,85.40156230928842,7
0.2,8193,91,699786,85.40224554552111,10
0.2,8194,91,699877,85.40292861500915,11
0.2,8195,92,699969,85.40373352855052,10
0.2,8196,93,700062,85.40466024155178,8
0.2,8197,96,700158,85.40595267138326,6
0.2,8198,94,700252,85.40700085376265,7
0.2,8199,94,700346,85.4080487804878,7
0.2,8200,94,700440,85.40909645165223,7
0.2,8201,95,700535,85.41026578883199,6
0.2,8202,94,700629,85.41131293429233,7
0.2,8203,93,700722,85.41223793271575,9
0.2,8204,94,700816,85.4132845825716,7
0.2,8205,92,700908,85.41408725322934,9
0.2,8206,92,701000,85.41488972828074,9
0.2,8207,92,701092,85.41569200779728,10
0.2,8208,92,701184,85.41649409185041,9
0.2,8209,21,701205,85.40864799025579,11
0.2,8210,94,701299,85.40969431250761,7
0.2,8211,96,701395,85.410983925962,6
0.2,8212,92,701487,85.41178619262145,9
0.2,8213,93,701580,85.4127100073046,8
0.2,8214,96,701676,85.41399878271454,6
0.2,8215,94,701770,85.41504381694256,7
0.2,8216,92,701862,85.41584519897773,9
0.2,8217,16,701878,85.40739839376977,17
0.2,8218,89,701967,85.40783550310256,12
0.2,8219,27,701994,85.4007299270073,6
0.2,8220,92,702086,85.40153266026032,9
0.2,8221,26,702112,85.39430795426904,8
0.2,8222,91,702203,85.39498966313997,11
0.2,8223,94,702297,85.3960359922179,8
0.2,8224,17,702314,85.38772036474164,16
0.2,8225,95,702409,85.38888888888889,7
0.2,8226,89,702498,85.38932782302176,12
0.2,8227,95,702593,85.39049586776859,6
0.2,8228,93,702686,85.39142058573339,8
0.2,8229,96,702782,85.39270959902795,6
0.2,8230,93,702875,85.39363382335075,8
0.2,8231,90,702965,85.39419339164237,12
0.2,8232,95,703060,85.3953601360379,6
0.2,8233,93,703153,85.39628370172456,8
0.2,8234,94,703247,85.397328476017,7
0.2,8235,94,703341,85.39837299660029,7
0.2,8236,82,703423,85.39796042248392,19
0.2,8237,95,703518,85.39912600145666,8
0.2,8238,94,703612,85.4001699235344,7
0.2,8239,95,703707,85.4013349514563,6
0.2,8240,94,703801,85.40237835214172,7
0.2,8241,96,703897,85.40366415918466,6
0.2,8242,94,703991,85.4047070241417,7
0.2,8243,91,704082,85.40538573508006,10
0.2,8244,92,704174,85.40618556701031,9
0.2,8245,94,704268,85.40722774678632,7
0.2,8246,93,704361,85.4081484176064,8
0.2,8247,93,704454,85.40906886517944,8
0.2,8248,96,704550,85.41035277003273,6
0.2,8249,94,704644,85.41139393939395,7
0.2,8250,92,704736,85.41219246151982,9
0.2,8251,95,704831,85.41335433834222,6
0.2,8252,94,704925,85.41439476553981,7
0.2,8253,90,705015,85.41495032711413,11
0.2,8254,92,705107,85.41574803149607,9
0.2,8255,93,705200,85.41666666666667,8
0.2,8256,91,705291,85.41734286060313,10
0.2,8257,90,705381,85.41789779607653,11
0.2,8258,87,705468,85.41808935706501,14
0.2,8259,27,705495,85.41101694915254,7
0.2,8260,92,705587,85.41181455029657,9
0.2,8261,93,705680,85.41273299443235,8
0.2,8262,94,705774,85.41377223768608,7
0.2,8263,87,705861,85.41396418199419,15
0.2,8264,92,705953,85.41476104053237,9
0.2,8265,93,706046,85.41567868376482,8
0.2,8266,96,706142,85.41695899358896,6
0.2,8267,93,706235,85.41787614900822,8
0.2,8268,89,706324,85.41830934816785,12
0.2,8269,94,706418,85.41934703748488,7
0.2,8270,94,706512,85.42038447587957,7
0.2,8271,91,706603,85.4210589941973,10
0.2,8272,94,706697,85.42209597485797,8
0.2,8273,92,706789,85.42289098380469,9
0.2,8274,91,706880,85.42356495468277,10
0.2,8275,93,706973,85.42448042532625,8
0.2,8276,92,707065,85.42527485804035,9
0.2,8277,90,707155,85.4258274945639,11
0.2,8278,94,707249,85.42686314772315,8
0.2,8279,96,707345,85.42814009661836,6
0.2,8280,96,707441,85.42941673710905,6
0.2,8281,92,707533,85.43021009418015,9
0.2,8282,80,707613,85.42955450923579,22
0.2,8283,93,707706,85.43046837276678,9
0.2,8284,93,707799,85.43138201569101,8
0.2,8285,95,707894,85.43253680907554,6
0.2,8286,93,707987,85.43344998189936,8
0.2,8287,93,708080,85.43436293436294,8
0.2,8288,94,708174,85.43539630836048,8
0.2,8289,96,708270,85.43667068757539,6
0.2,8290,95,708365,85.43782414666506,6
0.2,8291,93,708458,85.4387361312108,8
0.2,8292,96,708554,85.44000964668997,6
0.2,8293,93,708647,85.4409211478177,8
0.2,8294,95,708742,85.44207353827608,7
0.2,8295,92,708834,85.44286403085825,9
0.2,8296,91,708925,85.44353380740027,10
0.2,8297,95,709020,85.44468546637744,7
0.2,8298,92,709112,85.44547535847693,9
0.2,8299,90,709202,85.44602409638554,12
0.2,8300,92,709294,85.44681363691122,10
0.2,8301,96,709390,85.44808479884365,6
0.2,8302,93,709483,85.4489943393954,8
0.2,8303,94,709577,85.45002408477842,7
0.2,8304,96,709673,85.45129440096328,6
0.2,8305,90,709763,85.45184204189742,11
0.2,8306,96,709859,85.45311183339352,6
0.2,8307,95,709954,85.45426095329803,6
0.2,8308,86,710040,85.4543266337706,15
0.2,8309,94,710134,85.45535499398315,8
0.2,8310,89,710223,85.455781494405,12
0.2,8311,93,710316,85.45668912415785,8
0.2,8312,93,710409,85.45759653554673,9
0.2,8313,96,710505,85.45886456579264,6
0.2,8314,25,710530,85.45159350571257,10
0.2,8315,96,710626,85.45286195286195,6
0.2,8316,94,710720,85.45388962366238,7
0.2,8317,94,710814,85.45491704736716,7
0.2,8318,94,710908,85.45594422406539,7
0.2,8319,93,711001,85.45685096153846,9
0.2,8320,95,711096,85.45799783679846,6
0.2,8321,19,711115,85.45001201634223,13
0.2,8322,91,711206,85.45067884176379,10
0.2,8323,94,711300,85.45170591061989,8
0.2,8324,93,711393,85.45261261261261,8
0.2,8325,95,711488,85.45375930819121,6
0.2,8326,94,711582,85.45478563708419,7
0.2,8327,95,711677,85.45593179634966,8
0.2,8328,88,711765,85.45623724336654,13
0.2,8329,86,711851,85.4563025210084,15
0.2,8330,94,711945,85.45732805185452,7
0.2,8331,90,712035,85.45787325972155,11
0.2,8332,94,712129,85.45889835593424,8
0.2,8333,26,712155,85.45176385889128,7
0.2,8334,90,712245,85.45230953809238,12
0.2,8335,27,712272,85.44529750479846,6
0.2,8336,90,712362,85.44584382871537,11
0.2,8337,91,712453,85.44650995442552,10
0.2,8338,93,712546,85.44741575728504,9
0.2,8339,92,712638,85.44820143884893,9
0.2,8340,96,712734,85.44946649082844,7
0.2,8341,92,712826,85.45025173819228,9
0.2,8342,91,712917,85.45091693635383,10
0.2,8343,91,713008,85.4515819750719,10
0.2,8344,93,713101,85.45248651887357,8
0.2,8345,91,713192,85.45315121016056,10
0.2,8346,91,713283,85.45381574218283,11
0.2,8347,92,713375,85.45459990416866,9
0.2,8348,94,713469,85.45562342795544,8
0.2,8349,95,713564,85.45676646706586,6
0.2,8350,92,713656,85.4575499940127,9
0.2,8351,88,713744,85.45785440613027,16
0.2,8352,93,713837,85.45875733269484,8
0.2,8353,89,713926,85.45918123054824,12
0.2,8354,88,714014,85.45948533812088,13
0.2,8355,88,714102,85.4597893729057,13
0.2,8356,90,714192,85.46033265525907,11
0.2,8357,23,714215,85.45285953577411,9
0.2,8358,94,714309,85.45388204330662,7
0.2,8359,93,714402,85.45478468899522,8
0.2,8360,92,714494,85.45556751584739,10
0.2,8361,91,714585,85.45623056685004,10
0.2,8362,93,714678,85.45713260791582,8
0.2,8363,92,714770,85.45791487326638,9
0.2,8364,91,714861,85.45857740585774,10
0.2,8365,94,714955,85.45959837437246,7
0.2,8366,94,715049,85.46061909884068,7
0.2,8367,91,715140,85.4612810707457,10
0.2,8368,95,715235,85.46242083880989,9
0.2,8369,91,715326,85.46308243727599,10
0.2,8370,94,715420,85.46410225779476,7
0.2,8371,94,715514,85.46512183468705,7
0.2,8372,-45,715469,85.44954018870177,9
0.2,8373,89,715558,85.44996417482685,12
0.2,8374,91,715649,85.45062686567164,12
0.2,8375,88,715737,85.45093123209169,13
0.2,8376,93,715830,85.45183239823326,11
0.2,8377,93,715923,85.45273334924804,8
0.2,8378,95,716018,85.45387277718105,6
0.2,8379,93,716111,85.45477326968974,8
0.2,8380,88,716199,85.45507695979,14
0.2,8381,94,716293,85.45609639704128,10
0.2,8382,92,716385,85.45687701300251,9
0.2,8383,94,716479,85.45789599236642,7
0.2,8384,89,716568,85.45831842576028,13
0.2,8385,92,716660,85.45909849749583,9
0.2,8386,92,716752,85.45987838321211,9
0.2,8387,93,716845,85.46077730090606,8
0.2,8388,-128,716717,85.43533198235785,22
0.2,8389,95,716812,85.43647199046484,6
0.2,8390,91,716903,85.4371350256227,10
0.2,8391,93,716996,85.43803622497617,8
0.2,8392,88,717084,85.43834147503873,13
0.2,8393,91,717175,85.43900405051227,10
0.2,8394,90,717265,85.43954734961287,11
0.2,8395,89,717354,85.4399714149595,12
0.2,8396,94,717448,85.44099083005835,7
0.2,8397,96,717544,85.44224815432246,6
0.2,8398,92,717636,85.44302893201572,9
0.2,8399,92,717728,85.44380952380952,9
0.2,8400,96,717824,85.44506606356386,6
0.2,8401,95,717919,85.44620328493215,8
0.2,8402,95,718014,85.44734023563014,8
0.2,8403,88,718102,85.44764397905759,14
0.2,8404,90,718192,85.44818560380726,11
0.2,8405,94,718286,85.44920295027362,7
0.2,8406,91,718377,85.4498632092304,10
0.2,8407,93,718470,85.45076117982873,8
0.2,8408,94,718564,85.45177785705792,7
0.2,8409,94,718658,85.45279429250891,7
0.2,8410,93,718751,85.45369159434074,9
0.2,8411,88,718839,85.4539942938659,15
0.2,8412,93,718932,85.45489123974801,8
0.2,8413,91,719023,85.45555027335394,10
0.2,8414,93,719116,85.45644682115271,9
0.2,8415,92,719208,85.45722433460077,9
0.2,8416,87,719295,85.4574076274207,14
0.2,8417,91,719386,85.45806604894274,11
0.2,8418,93,719479,85.45896187195629,9
0.2,8419,95,719574,85.46009501187649,8
0.2,8420,95,719669,85.46122788267427,6
0.2,8421,95,719764,85.4623604844455,6
0.2,8422,92,719856,85.46313664964977,9
0.2,8423,94,719950,85.46415004748339,8
0.2,8424,26,719976,85.45709198813056,7
0.2,8425,90,720066,85.45763114170425,11
0.2,8426,89,720155,85.45805150112733,12
0.2,8427,95,720250,85.45918367346938,6
0.2,8428,93,720343,85.46007830110334,8
0.2,8429,92,720435,85.46085409252669,9
0.2,8430,94,720529,85.46186691970111,7
0.2,8431,91,720620,85.46252371916509,10
0.2,8432,88,720708,85.46282461757382,14
0.2,8433,90,720798,85.4633625800332,11
0.2,8434,90,720888,85.46390041493775,11
0.2,8435,92,720980,85.46467520151731,9
0.2,8436,86,721066,85.46473865117933,17
0.2,8437,88,721154,85.46503910879355,13
0.2,8438,95,721249,85.46616897736699,6
0.2,8439,91,721340,85.46682464454976,10
0.2,8440,95,721435,85.46795403388224,6
0.2,8441,96,721531,85.46920161099266,7
0.2,8442,95,721626,85.4703304512614,7
0.2,8443,93,721719,85.47122216958788,9
0.2,8444,94,721813,85.47223208999408,7
0.2,8445,91,721904,85.47288657352593,10
0.2,8446,91,721995,85.47354090209542,10
0.2,8447,90,722085,85.47407670454545,11
0.2,8448,90,722175,85.47461238016334,12
0.2,8449,95,722270,85.47573964497042,7
0.2,8450,94,722364,85.47674831380901,7
0.2,8451,96,722460,85.47799337434927,6
0.2,8452,93,722553,85.47888323672069,10
0.2,8453,92,722645,85.47965460137213,9
0.2,8454,94,722739,85.48066232998227,7
0.2,8455,94,722833,85.48166982024598,7
0.2,8456,94,722927,85.48267707224784,7
0.2,8457,92,723019,85.48344762355167,9
0.2,8458,79,723098,85.48268116798675,22
0.2,8459,93,723191,85.48356973995271,8
0.2,8460,93,723284,85.48445810187921,9
0.2,8461,95,723379,85.4855826045852,6
0.2,8462,90,723469,85.48611603450313,12
0.2,8463,88,723557,85.48641304347827,13
0.2,8464,96,723653,85.48765505020674,6
0.2,8465,24,723677,85.48039215686275,8
0.2,8466,93,723770,85.48128026455652,8
0.2,8467,94,723864,85.48228625413321,7
0.2,8468,94,723958,85.48329200614005,8
0.2,8469,94,724052,85.48429752066116,7
0.2,8470,94,724146,85.48530279778066,7
0.2,8471,92,724238,85.4860717658168,9
0.2,8472,95,724333,85.48719461819898,7
0.2,8473,92,724425,85.48796318149634,10
0.2,8474,95,724520,85.48908554572272,6
0.2,8475,89,724609,85.48949976403964,12
0.2,8476,-44,724565,85.47422437182966,8
0.2,8477,94,724659,85.47523000707714,7
0.2,8478,92,724751,85.47599952824625,9
0.2,8479,86,724837,85.47606132075472,16
0.2,8480,88,724925,85.47635891993869,13
0.2,8481,96,725021,85.4775996227305,6
0.2,8482,94,725115,85.47860426735825,7
0.2,8483,94,725209,85.47960867515323,7
0.2,8484,95,725304,85.48073070123748,7
0.2,8485,94,725398,85.48173462172991,7
0.2,8486,23,725421,85.47437256981266,11
0.2,8487,91,725512,85.47502356267672,10
0.2,8488,95,725607,85.47614560018847,6
0.2,8489,93,725700,85.47703180212014,8
0.2,8490,91,725791,85.47768225179603,10
0.2,8491,95,725886,85.47880357983985,7
0.2,8492,95,725981,85.47992464382433,6
0.2,8493,94,726075,85.48092771368025,7
0.2,8494,95,726170,85.48204826368452,6
0.2,8495,90,726260,85.48258003766479,11
0.2,8496,93,726353,85.4834647522655,8
0.2,8497,84,726437,85.4832901859261,17
0.2,8498,96,726533,85.48452759148135,6
0.2,8499,95,726628,85.48564705882353,6
0.2,8500,25,726653,85.47853193741912,8
0.2,8501,96,726749,85.479769466008,6
0.2,8502,91,726840,85.4804186757615,10
0.2,8503,88,726928,85.48071495766698,13
0.2,8504,94,727022,85.4817166372722,8
0.2,8505,86,727108,85.48177756877499,15
0.2,8506,94,727202,85.4827788879746,7
0.2,8507,94,727296,85.48377997179125,7
0.2,8508,90,727386,85.48431072981549,11
0.2,8509,92,727478,85.48507638072856,9
0.2,8510,26,727504,85.4780871812948,7
0.2,8511,94,727598,85.47908834586467,8
0.2,8512,93,727691,85.47997180782333,11
0.2,8513,90,727781,85.48050270143294,12
0.2,8514,94,727875,85.48150322959484,7
0.2,8515,25,727900,85.47440112728981,7
0.2,8516,92,727992,85.47516731243395,12
0.2,8517,94,728086,85.47616811458089,7
0.2,8518,94,728180,85.47716868177017,10
0.2,8519,90,728270,85.47769953051643,11
0.2,8520,94,728364,85.47869968313579,7
0.2,8521,23,728387,85.47136822342173,11
0.2,8522,93,728480,85.47225155461692,9
0.2,8523,86,728566,85.47231346785547,15
0.2,8524,92,728658,85.47307917888563,9
0.2,8525,92,728750,85.47384471029791,10
0.2,8526,22,728772,85.46640084437668,12
0.2,8527,94,728866,85.46740150093808,7
0.2,8528,93,728959,85.46828467581193,8
0.2,8529,95,729054,85.4694021101993,6
0.2,8530,93,729147,85.47028484351189,8
0.2,8531,93,729240,85.47116736990155,9
0.2,8532,94,729334,85.4721668815188,7
0.2,8533,95,729429,85.47328333723928,6
0.2,8534,94,729523,85.47428236672525,7
0.2,8535,93,729616,85.47516401124649,10
0.2,8536,25,729641,85.46808012182265,7
0.2,8537,94,729735,85.46907940969783,7
0.2,8538,26,729761,85.46211500175664,9
0.2,8539,95,729856,85.4632318501171,7
0.2,8540,93,729949,85.46411427233345,8
0.2,8541,88,730037,85.46441114493093,15
0.2,8542,92,730129,85.46517616762262,10
0.2,8543,90,730219,85.46570692883896,11
0.2,8544,92,730311,85.4664716208309,9
0.2,8545,92,730403,85.46723613386379,9
0.2,8546,91,730494,85.46788346788347,11
0.2,8547,95,730589,85.46899859616285,6
0.2,8548,93,730682,85.46987951807229,8
0.2,8549,94,730776,85.47087719298246,7
0.2,8550,91,730867,85.47152379838616,11
0.2,8551,92,730959,85.47228718428438,9
0.2,8552,91,731050,85.47293347363498,10
0.2,8553,96,731146,85.4741641337386,6
0.2,8554,95,731241,85.47527761542958,6
0.2,8555,91,731332,85.47592332865825,10
0.2,8556,89,731421,85.47633516419306,12
0.2,8557,95,731516,85.47744800186959,6
0.2,8558,93,731609,85.47832690734899,8
0.2,8559,94,731703,85.47932242990655,8
0.2,8560,95,731798,85.48043452867655,7
0.2,8561,25,731823,85.47337070777856,7
0.2,8562,91,731914,85.47401611584725,10
0.2,8563,89,732003,85.47442783745913,14
0.2,8564,94,732097,85.47542323409223,10
0.2,8565,95,732192,85.47653513892132,8
0.2,8566,91,732283,85.4771798762694,10
0.2,8567,21,732304,85.46965452847806,13
0.2,8568,92,732396,85.47041661804178,9
0.2,8569,96,732492,85.47164527421236,6
0.2,8570,92,732584,85.47240695368102,9
0.2,8571,90,732674,85.47293513765749,11
0.2,8572,91,732765,85.47357984369532,10
0.2,8573,87,732852,85.4737578726382,14
0.2,8574,88,732940,85.47405247813411,13
0.2,8575,94,733034,85.47504664179104,7
0.2,8576,94,733128,85.47604057362715,7
0.2,8577,92,733220,85.476801119142,9
0.2,8578,93,733313,85.4776780510549,8
0.2,8579,92,733405,85.47843822843822,9
0.2,8580,95,733500,85.47954783824729,6
0.2,8581,91,733591,85.48019109764624,11
0.2,8582,95,733686,85.4813002446697,6
0.2,8583,93,733779,85.4821761416589,8
0.2,8584,93,733872,85.48305183459523,8
0.2,8585,90,733962,85.48357791754019,11
0.2,8586,96,734058,85.48480260859439,6
0.2,8587,94,734152,85.48579413134607,7
0.2,8588,94,734246,85.48678542321574,7
0.2,8589,95,734341,85.48789289871944,6
0.2,8590,95,734436,85.48900011640089,7
0.2,8591,92,734528,85.48975791433892,9
0.2,8592,88,734616,85.49005004073082,14
0.2,8593,94,734710,85.49104026064697,8
0.2,8594,87,734797,85.491215823153,14
0.2,8595,90,734887,85.49174034434621,11
0.2,8596,85,734972,85.49168314528323,16
0.2,8597,92,735064,85.49244010234938,9
0.2,8598,27,735091,85.48563786486801,6
0.2,8599,94,735185,85.48662790697675,7
0.2,8600,91,735276,85.48726892221835,13
0.2,8601,90,735366,85.48779353638689,11
0.2,8602,91,735457,85.48843426711612,10
0.2,8603,91,735548,85.48907484890748,14
0.2,8604,94,735642,85.49006391632771,7
0.2,8605,-48,735594,85.47455263769463,12
0.2,8606,90,735684,85.47507842453817,11
0.2,8607,94,735778,85.4760687732342,7
0.2,8608,95,735873,85.47717504936695,7
0.2,8609,88,735961,85.47746806039488,13
0.2,8610,94,736055,85.47845778655208,7
0.2,8611,93,736148,85.47933116581514,10
0.2,8612,89,736237,85.47973992801579,12
0.2,8613,93,736330,85.48061295565358,8
0.2,8614,92,736422,85.48136970400465,9
0.2,8615,93,736515,85.48224233983287,8
0.2,8616,93,736608,85.48311477312289,8
0.2,8617,94,736702,85.48410304014853,7
0.2,8618,19,736721,85.47638937231697,14
0.2,8619,91,736812,85.47703016241299,10
0.2,8620,93,736905,85.47790279549936,8
0.2,8621,86,736991,85.47796334957087,15
0.2,8622,96,737087,85.47918357880089,6
0.2,8623,90,737177,85.47970779220779,11
0.2,8624,91,737268,85.48034782608696,10
0.2,8625,92,737360,85.48110364015766,9
0.2,8626,85,737445,85.48104787295699,16
0.2,8627,87,737532,85.48122392211404,14
0.2,8628,87,737619,85.48139993046703,14
0.2,8629,91,737710,85.48203939745075,10
0.2,8630,94,737804,85.48302630054455,7
0.2,8631,92,737896,85.483781278962,9
0.2,8632,89,737985,85.4841885787096,12
0.2,8633,96,738081,85.4854065323141,6
0.2,8634,92,738173,85.48616097278517,9
0.2,8635,89,738262,85.48656785548866,12
0.2,8636,96,738358,85.4877851105708,6
0.2,8637,95,738453,85.48888631627692,8
0.2,8638,87,738540,85.48906123393911,14
0.2,8639,88,738628,85.48935185185185,13
0.2,8640,95,738723,85.49045249392431,6
0.2,8641,-51,738672,85.47465864383244,17
0.2,8642,95,738767,85.47576073122758,6
0.2,8643,94,738861,85.47674687644609,7
0.2,8644,91,738952,85.47738577212262,10
0.2,8645,91,739043,85.47802452000926,10
0.2,8646,20,739063,85.4704521799468,12
0.2,8647,88,739151,85.47074468085107,14
0.2,8648,94,739245,85.47173083593479,7
0.2,8649,89,739334,85.4721387283237,13
0.2,8650,90,739424,85.47266211998613,11
0.2,8651,96,739520,85.47387887193713,6
0.2,8652,91,739611,85.4745175083786,10
0.2,8653,94,739705,85.47550265773053,8
0.2,8654,94,739799,85.47648757943385,8
0.2,8655,92,739891,85.47724121996303,9
0.2,8656,20,739911,85.46967771745409,12
0.2,8657,92,740003,85.47043197043197,9
0.2,8658,93,740096,85.47130153597413,9
0.2,8659,94,740190,85.47228637413394,7
0.2,8660,93,740283,85.4731555247662,8
0.2,8661,95,740378,85.47425536827522,7
0.2,8662,92,740470,85.47500865750895,9
0.2,8663,24,740494,85.46791320406278,9
0.2,8664,94,740588,85.46889786497404,7
0.2,8665,95,740683,85.46999769213016,7
0.2,8666,92,740775,85.47075112495673,9
0.2,8667,93,740868,85.47161975080756,8
0.2,8668,93,740961,85.47248817626024,8
0.2,8669,90,741051,85.47301038062284,11
0.2,8670,93,741144,85.47387844539269,8
0.2,8671,90,741234,85.47440036900369,11
0.2,8672,94,741328,85.47538337368846,7
0.2,8673,94,741422,85.47636615171778,7
0.2,8674,93,741515,85.47723342939481,9
0.2,8675,92,741607,85.47798524665744,9
0.2,8676,94,741701,85.47896738504092,8
0.2,8677,92,741793,85.47971882922333,10
0.2,8678,95,741888,85.48081576218458,6
0.2,8679,95,741983,85.48191244239631,6
0.2,8680,89,742072,85.48231770533349,12
0.2,8681,93,742165,85.48318359824925,8
0.2,8682,94,742259,85.48416445928827,7
0.2,8683,89,742348,85.48456932289268,12
0.2,8684,94,742442,85.48554979850317,7
0.2,8685,94,742536,85.48653004835367,8
0.2,8686,96,742632,85.4877403016001,6
0.2,8687,94,742726,85.48872007366482,8
0.2,8688,90,742816,85.48923926804005,13
0.2,8689,93,742909,85.49010356731876,8
0.2,8690,87,742996,85.49027729835461,14
0.2,8691,90,743086,85.49079613437644,11
0.2,8692,94,743180,85.49177499137237,7
0.2,8693,93,743273,85.49263860133425,8
0.2,8694,93,743366,85.49350201265095,8
0.2,8695,90,743456,85.49402023919043,12
0.2,8696,94,743550,85.49499827526733,7
0.2,8697,90,743640,85.49551621062314,11
0.2,8698,95,743735,85.49660880560984,6
0.2,8699,85,743820,85.49655172413793,16
0.2,8700,93,743913,85.49741409033444,8
0.2,8701,89,744002,85.49781659388647,13
0.2,8702,92,744094,85.49856371366195,9
0.2,8703,88,744182,85.49885110294117,13
0.2,8704,91,744273,85.4994830557151,10
0.2,8705,92,744365,85.50022972662532,9
0.2,8706,93,744458,85.50109107614563,8
0.2,8707,93,744551,85.50195222783647,8
0.2,8708,95,744646,85.5030428292571,6
0.2,8709,94,744740,85.50401836969002,7
0.2,8710,89,744829,85.50441969923085,13
0.2,8711,92,744921,85.5051652892562,9
0.2,8712,95,745016,85.50625502123265,6
0.2,8713,93,745109,85.50711498737664,9
0.2,8714,96,745205,85.5083189902467,6
0.2,8715,92,745297,85.5090637907297,10
0.2,8716,94,745391,85.51003785706092,7
0.2,8717,24,745415,85.50298233539803,11
0.2,8718,94,745509,85.5039568757885,7
0.2,8719,77,745586,85.50298165137615,24
0.2,8720,91,745677,85.50361197110423,10
0.2,8721,84,745761,85.50343957807843,17
0.2,8722,88,745849,85.5037257824143,13
0.2,8723,25,745874,85.49679046309032,9
0.2,8724,89,745963,85.49719197707736,14
0.2,8725,-49,745914,85.48177859271144,13
0.2,8726,89,746003,85.48218173484588,12
0.2,8727,96,746099,85.48338680109991,6
0.2,8728,92,746191,85.48413334860808,9
0.2,8729,93,746284,85.48499427262314,8
0.2,8730,95,746379,85.48608406826251,6
0.2,8731,95,746474,85.48717361429226,6
0.2,8732,88,746562,85.48746135348678,13
0.2,8733,92,746654,85.4882070070987,9
0.2,8734,93,746747,85.48906697195191,8
0.2,8735,92,746839,85.48981227106228,9
0.2,8736,93,746932,85.49067185532792,9
0.2,8737,96,747028,85.49187457084001,6
0.2,8738,93,747121,85.49273372239387,10
0.2,8739,95,747216,85.49382151029748,8
0.2,8740,94,747310,85.49479464592152,9
0.2,8741,92,747402,85.4955387783116,9
0.2,8742,95,747497,85.49662587212627,6
0.2,8743,88,747585,85.49691216834401,13
0.2,8744,96,747681,85.49811320754716,6
0.2,8745,91,747772,85.49874228218614,10
0.2,8746,92,747864,85.4994855378987,10
0.2,8747,91,747955,85.50011431184271,10
0.2,8748,94,748049,85.50108583838153,8
0.2,8749,87,748136,85.50125714285714,14
0.2,8750,92,748228,85.50199977145469,9
0.2,8751,93,748321,85.50285648994516,8
0.2,8752,93,748414,85.50371301268136,8
0.2,8753,95,748509,85.50479780671692,6
0.2,8754,94,748603,85.50576813249572,7
0.2,8755,21,748624,85.49840109639105,11
0.2,8756,91,748715,85.49902934795021,11
0.2,8757,94,748809,85.5,7
0.2,8758,94,748903,85.50097043041443,9
0.2,8759,96,748999,85.50216894977169,6
0.2,8760,94,749093,85.50313891108321,7
0.2,8761,92,749185,85.50388039260443,10
0.2,8762,91,749276,85.50450758872532,10
0.2,8763,89,749365,85.50490643541762,12
0.2,8764,94,749459,85.50587564175699,8
0.2,8765,92,749551,85.50661647273557,9
0.2,8766,91,749642,85.50724307060568,10
0.2,8767,82,749724,85.50684306569343,19
0.2,8768,93,749817,85.50769757098871,8
0.2,8769,95,749912,85.50877993158495,6
0.2,8770,87,749999,85.50894994869456,14
0.2,8771,90,750089,85.5094619243046,12
0.2,8772,94,750183,85.51042972757324,8
0.2,8773,90,750273,85.51094141782539,11
0.2,8774,89,750362,85.51133903133903,12
0.2,8775,83,750445,85.51105287146764,18
0.2,8776,95,750540,85.51213398655577,6
0.2,8777,92,750632,85.51287309182047,9
0.2,8778,94,750726,85.51383984508486,7
0.2,8779,90,750816,85.51435079726652,12
0.2,8780,94,750910,85.51531716205443,7
0.2,8781,94,751004,85.51628330676384,8
0.2,8782,94,751098,85.51724923146989,7
0.2,8783,93,751191,85.51810109289617,8
0.2,8784,94,751285,85.51906659077974,7
0.2,8785,91,751376,85.51969041657182,10
0.2,8786,95,751471,85.52076931831114,6
0.2,8787,95,751566,85.52184797451069,6
0.2,8788,90,751656,85.52235749231994,11
0.2,8789,93,751749,85.52320819112629,8
0.2,8790,95,751844,85.5242862017973,6
0.2,8791,96,751940,85.52547770700637,6
0.2,8792,96,752036,85.52666894120323,6
0.2,8793,95,752131,85.5277461905845,6
0.2,8794,94,752225,85.5287094940307,8
0.2,8795,86,752311,85.5287630741246,16
0.2,8796,95,752406,85.52983971808571,7
0.2,8797,23,752429,85.52273243919072,10
0.2,8798,94,752523,85.5236958745312,8
0.2,8799,-46,752477,85.50875,12
0.2,8800,96,752573,85.50994205203953,6
0.2,8801,94,752667,85.51090661213361,7
0.2,8802,91,752758,85.51153016017267,11
0.2,8803,95,752853,85.5126079054975,6
0.2,8804,95,752948,85.5136854060193,7
0.2,8805,93,753041,85.5145355439473,8
0.2,8806,92,753133,85.5152719427728,9
0.2,8807,96,753229,85.51646230699365,6
0.2,8808,89,753318,85.51685775911,12
0.2,8809,92,753410,85.51759364358684,9
0.2,8810,91,753501,85.51821586653047,10
0.2,8811,90,753591,85.5187244666364,12
0.2,8812,-48,753543,85.50357426528991,14
0.2,8813,94,753637,85.50453823462674,8
0.2,8814,95,753732,85.50561542824731,7
0.2,8815,90,753822,85.50612522686025,12
0.2,8816,94,753916,85.5070885788817,7
0.2,8817,91,754007,85.50771149920617,10
0.2,8818,94,754101,85.50867445288581,8
0.2,8819,91,754192,85.5092970521542,10
0.2,8820,91,754283,85.5099195102596,10
0.2,8821,96,754379,85.51110859215598,6
0.2,8822,92,754471,85.51184404397597,10
0.2,8823,91,754562,85.51246600181324,10
0.2,8824,94,754656,85.51342776203965,7
0.2,8825,25,754681,85.5065714933152,8
0.2,8826,95,754776,85.50764699218307,6
0.2,8827,96,754872,85.50883552333484,6
0.2,8828,90,754962,85.50934420659192,12
0.2,8829,93,755055,85.51019252548132,9
0.2,8830,94,755149,85.51115388970672,8
0.2,8831,94,755243,85.51211503623189,7
0.2,8832,89,755332,85.5125099060342,12
0.2,8833,96,755428,85.5136970794657,6
0.2,8834,93,755521,85.51454442558008,8
0.2,8835,19,755540,85.50701674966048,13
0.2,8836,94,755634,85.50797782052733,7
0.2,8837,93,755727,85.50882552613713,8
0.2,8838,96,755823,85.51001244484671,6
0.2,8839,84,755907,85.50984162895928,18
0.2,8840,92,755999,85.51057572672775,9
0.2,8841,96,756095,85.51176204478625,7
0.2,8842,92,756187,85.51249575935769,10
0.2,8843,93,756280,85.51334237901402,8
0.2,8844,95,756375,85.51441492368569,7
0.2,8845,93,756468,85.51526113497626,8
0.2,8846,94,756562,85.51622018763423,7
0.2,8847,86,756648,85.51627486437613,15
0.2,8848,94,756742,85.5172335857159,8
0.2,8849,92,756834,85.51796610169491,10
0.2,8850,93,756927,85.5188114337363,8
0.2,8851,96,757023,85.51999548124718,7
0.2,8852,-118,756905,85.49700666440755,12
0.2,8853,92,756997,85.49774113395075,9
0.2,8854,92,757089,85.49847543760588,9
0.2,8855,94,757183,85.49943541102078,7
0.2,8856,93,757276,85.50028226261713,8
0.2,8857,93,757369,85.50112892300746,8
0.2,8858,90,757459,85.50163675358392,11
0.2,8859,94,757553,85.50259593679458,7
0.2,8860,96,757649,85.50378061166911,6
0.2,8861,95,757744,85.50485217783796,6
0.2,8862,95,757839,85.50592350220016,6
0.2,8863,95,757934,85.50699458483754,6
0.2,8864,94,758028,85.50795262267343,7
0.2,8865,88,758116,85.50823370178209,13
0.2,8866,89,758205,85.50862749520695,12
0.2,8867,91,758296,85.50924672981506,10
0.2,8868,92,758388,85.50997857706619,9
0.2,8869,94,758482,85.51093573844419,8
0.2,8870,92,758574,85.51166723030099,9
0.2,8871,94,758668,85.51262398557259,7
0.2,8872,94,758762,85.51358052518877,7
0.2,8873,92,758854,85.51431147171512,9
0.2,8874,90,758944,85.51481690140845,11
0.2,8875,89,759033,85.51520955385308,12
0.2,8876,92,759125,85.51594006984341,9
0.2,8877,92,759217,85.51667042126606,9
0.2,8878,91,759308,85.51728798288096,11
0.2,8879,92,759400,85.51801801801801,9
0.2,8880,94,759494,85.51897308861615,7
0.2,8881,94,759588,85.51992794415672,7
0.2,8882,90,759678,85.52043228638973,11
0.2,8883,94,759772,85.5213867627195,7
0.2,8884,27,759799,85.51480022509848,6
0.2,8885,89,759888,85.5151924375422,13
0.2,8886,96,759984,85.51637222909868,6
0.2,8887,93,760077,85.51721422142214,8
0.2,8888,90,760167,85.51771852851839,11
0.2,8889,92,760259,85.51844769403824,9
0.2,8890,94,760353,85.51940164211,7
0.2,8891,94,760447,85.52035537561854,7
0.2,8892,18,760465,85.51276284718318,15
0.2,8893,90,760555,85.51326737126152,11
0.2,8894,91,760646,85.51388420460933,10
0.2,8895,91,760737,85.51450089928058,10
0.2,8896,95,760832,85.51556704507138,6
0.2,8897,91,760923,85.5161834120027,10
0.2,8898,92,761015,85.51691201258568,9
0.2,8899,94,761109,85.51786516853933,8
0.2,8900,94,761203,85.51881811032469,7
0.2,8901,91,761294,85.51943383509324,10
0.2,8902,93,761387,85.52027406492194,8
0.2,8903,22,761409,85.51314016172506,11
0.2,8904,89,761498,85.5135317237507,15
0.2,8905,87,761585,85.51369863013699,15
0.2,8906,92,761677,85.51442685528237,10
0.2,8907,86,761763,85.51448136506511,16
0.2,8908,86,761849,85.51453586261084,15
0.2,8909,91,761940,85.51515151515152,10
0.2,8910,-53,761887,85.49960722702278,16
0.2,8911,94,761981,85.50056104129264,7
0.2,8912,91,762072,85.5011780545271,10
0.2,8913,88,762160,85.50145838007629,16
0.2,8914,94,762254,85.50241166573191,7
0.2,8915,96,762350,85.50358905338717,6
0.2,8916,93,762443,85.50442974094426,8
0.2,8917,91,762534,85.50504597443373,12
0.2,8918,94,762628,85.5059984303173,7
0.2,8919,90,762718,85.50650224215246,11
0.2,8920,93,762811,85.50734222620783,10
0.2,8921,89,762900,85.50773369199732,12
0.2,8922,92,762992,85.50846127983861,9
0.2,8923,93,763085,85.50930076199013,9
0.2,8924,27,763112,85.50274509803921,6
0.2,8925,94,763206,85.50369706475465,7
0.2,8926,94,763300,85.504648818192,7
0.2,8927,92,763392,85.50537634408602,9
0.2,8928,83,763475,85.50509575540374,18
0.2,8929,93,763568,85.50593505039194,9
0.2,8930,90,763658,85.50643824879633,11
0.2,8931,95,763753,85.50750111957008,6
0.2,8932,95,763848,85.50856375237882,6
0.2,8933,93,763941,85.50940228341169,8
0.2,8934,91,764032,85.5100167879127,12
0.2,8935,85,764117,85.50995971351836,17
0.2,8936,96,764213,85.51113348998545,6
0.2,8937,94,764307,85.51208324009846,7
0.2,8938,86,764393,85.51213782302271,15
0.2,8939,93,764486,85.51297539149888,9
0.2,8940,94,764580,85.51392461693322,8
0.2,8941,92,764672,85.51464996645046,9
0.2,8942,91,764763,85.51526333445153,10
0.2,8943,92,764855,85.51598837209302,9
0.2,8944,93,764948,85.51682504192286,8
0.2,8945,93,765041,85.51766152470378,8
0.2,8946,92,765133,85.51838605119035,9
0.2,8947,91,765224,85.51899865891819,10
0.2,8948,94,765318,85.5199463627221,7
0.2,8949,96,765414,85.52111731843576,6
0.2,8950,87,765501,85.52128253826388,16
0.2,8951,95,765596,85.52234137622878,6
0.2,8952,95,765691,85.52339997766111,7
0.2,8953,94,765785,85.5243466607103,7
0.2,8954,92,765877,85.5250697934115,9
0.2,8955,95,765972,85.52612773559625,6
0.2,8956,93,766065,85.52696215250641,8
0.2,8957,21,766086,85.51975887474883,12
0.2,8958,25,766111,85.51300368344681,7
0.2,8959,93,766204,85.51383928571428,8
0.2,8960,91,766295,85.51445151210802,10
0.2,8961,92,766387,85.51517518411069,9
0.2,8962,89,766476,85.51556398527279,12
0.2,8963,96,766572,85.51673360107095,6
0.2,8964,93,766665,85.5175683212493,9
0.2,8965,93,766758,85.51840285523087,8
0.2,8966,94,766852,85.5193487230958,9
0.2,8967,89,766941,85.51973684210526,12
0.2,8968,92,767033,85.52045936001784,9
0.2,8969,89,767122,85.52084726867335,13
0.2,8970,92,767214,85.5215695017278,9
0.2,8971,94,767308,85.52251448952296,7
0.2,8972,95,767403,85.5235707121364,6
0.2,8973,93,767496,85.52440383329619,10
0.2,8974,95,767591,85.52545961002785,7
0.2,8975,90,767681,85.52595811051694,11
0.2,8976,95,767776,85.5270134788905,7
0.2,8977,94,767870,85.52795722878146,8
0.2,8978,89,767959,85.52834391357612,12
0.2,8979,94,768053,85.5292873051225,8
0.2,8980,95,768148,85.53034183275804,6
0.2,8981,90,768238,85.53083945669115,11
0.2,8982,95,768333,85.53189357675609,6
0.2,8983,95,768428,85.53294746215494,6
0.2,8984,96,768524,85.5341124095715,6
0.2,8985,93,768617,85.53494324504786,10
0.2,8986,15,768632,85.52709469233336,18
0.2,8987,93,768725,85.52792612372052,8
0.2,8988,95,768820,85.52897986427857,6
0.2,8989,90,768910,85.52947719688542,11
0.2,8990,23,768933,85.52252252252252,10
0.2,8991,85,769018,85.52246441281139,16
0.2,8992,90,769108,85.52296230401423,11
0.2,8993,21,769129,85.51578830331331,11
0.2,8994,94,769223,85.51673151750973,7
0.2,8995,93,769316,85.517563361494,8
0.2,8996,92,769408,85.51828387240191,14
0.2,8997,94,769502,85.51922649477662,7
0.2,8998,91,769593,85.51983553728192,10
0.2,8999,95,769688,85.52088888888889,6
0.2,9000,91,769779,85.52149761137652,10
0.2,9001,94,769873,85.52243945789824,7
0.2,9002,91,769964,85.52304787293124,11
0.2,9003,92,770056,85.52376721457131,10
0.2,9004,96,770152,85.52493059411438,6
0.2,9005,92,770244,85.52564956695537,9
0.2,9006,94,770338,85.52659042966582,7
0.2,9007,93,770431,85.52742007104796,11
0.2,9008,26,770457,85.52081252081253,6
0.2,9009,95,770552,85.52186459489457,7
0.2,9010,92,770644,85.5225835090445,9
0.2,9011,94,770738,85.52352418996892,7
0.2,9012,91,770829,85.52413180960835,10
0.2,9013,95,770924,85.52518304859107,7
0.2,9014,91,771015,85.52579034941763,10
0.2,9015,95,771110,85.5268411712511,6
0.2,9016,91,771201,85.52744815348785,11
0.2,9017,92,771293,85.52816589044134,9
0.2,9018,92,771385,85.52888346823373,12
0.2,9019,89,771474,85.52926829268293,12
0.2,9020,90,771564,85.52976388427004,11
0.2,9021,95,771659,85.53081356683663,8
0.2,9022,94,771753,85.53175218885072,7
0.2,9023,92,771845,85.5324689716312,9
0.2,9024,91,771936,85.53307479224377,11
0.2,9025,94,772030,85.53401285176157,8
0.2,9026,88,772118,85.5342860307965,14
0.2,9027,94,772212,85.5352237483385,8
0.2,9028,93,772305,85.53605050393178,8
0.2,9029,91,772396,85.53665559246954,11
0.2,9030,91,772487,85.53726054700476,10
0.2,9031,-46,772441,85.52269707705935,9
0.2,9032,93,772534,85.52352485331562,8
0.2,9033,86,772620,85.52357759574939,15
0.2,9034,94,772714,85.52451577199778,7
0.2,9035,91,772805,85.5251217352811,10
0.2,9036,26,772831,85.51853491202833,8
0.2,9037,95,772926,85.51958397875636,6
0.2,9038,94,773020,85.52052218165726,8
0.2,9039,94,773114,85.52146017699116,7
0.2,9040,93,773207,85.52228735759319,8
0.2,9041,96,773303,85.52344614023446,6
0.2,9042,91,773394,85.52405175273692,11
0.2,9043,93,773487,85.52487837240159,8
0.2,9044,86,773573,85.5249309010503,15
0.2,9045,91,773664,85.52553614857395,11
0.2,9046,91,773755,85.52614126229689,10
0.2,9047,94,773849,85.52707780725022,7
0.2,9048,94,773943,85.52801414520941,7
0.2,9049,91,774034,85.52861878453038,10
0.2,9050,92,774126,85.52933377527346,10
0.2,9051,91,774217,85.52993813521874,10
0.2,9052,94,774311,85.53087374351044,7
0.2,9053,87,774398,85.53103600618512,14
0.2,9054,88,774486,85.53130866924351,13
0.2,9055,89,774575,85.53169169611307,12
0.2,9056,89,774664,85.53207463840124,14
0.2,9057,88,774752,85.53234709648929,13
0.2,9058,94,774846,85.53328181918533,7
0.2,9059,94,774940,85.53421633554083,7
0.2,9060,91,775031,85.53481955634037,12
0.2,9061,93,775124,85.53564334583977,8
0.2,9062,92,775216,85.53635661480746,9
0.2,9063,88,775304,85.53662842012356,13
0.2,9064,19,775323,85.52928847214561,14
0.2,9065,27,775350,85.52283256121774,6
0.2,9066,96,775446,85.5239880886732,6
0.2,9067,94,775540,85.52492280546979,8
0.2,9068,95,775635,85.52596758187231,6
0.2,9069,88,775723,85.52624035281147,13
0.2,9070,91,775814,85.52684378789549,10
0.2,9071,90,775904,85.52733686067019,11
0.2,9072,92,775996,85.52805025901026,9
0.2,9073,95,776091,85.529094115054,6
0.2,9074,95,776186,85.53013774104683,8
0.2,9075,92,776278,85.53085059497576,9
0.2,9076,90,776368,85.53134295472073,11
0.2,9077,91,776459,85.53194536241463,10
0.2,9078,25,776484,85.52527811432977,8
0.2,9079,93,776577,85.5261013215859,8
0.2,9080,92,776669,85.52681422750798,9
0.2,9081,90,776759,85.52730676062541,11
0.2,9082,94,776853,85.52823956842452,8
0.2,9083,91,776944,85.52884191985909,12
0.2,9084,94,777038,85.52977435332967,7
0.2,9085,96,777134,85.53092670041822,6
0.2,9086,92,777226,85.53163860459998,9
0.2,9087,88,777314,85.5319102112676,13
0.2,9088,94,777408,85.53284189679833,8
0.2,9089,93,777501,85.53366336633664,8
0.2,9090,90,777591,85.53415465845342,12
0.2,9091,94,777685,85.53508578970524,7
0.2,9092,93,777778,85.53590674144947,8
0.2,9093,25,777803,85.5292500549813,8
0.2,9094,91,777894,85.52985156679495,10
0.2,9095,93,777987,85.53067282321899,8
0.2,9096,91,778078,85.53127404638892,10
0.2,9097,93,778171,85.53209496592658,10
0.2,9098,96,778267,85.53324541158369,6
0.2,9099,94,778361,85.53417582417582,8
0.2,9100,94,778455,85.53510603230414,7
0.2,9101,93,778548,85.53592617007251,8
0.2,9102,93,778641,85.53674612765022,8
0.2,9103,96,778737,85.53789543057997,6
0.2,9104,92,778829,85.5386051619989,9
0.2,9105,91,778920,85.53920491983308,10
0.2,9106,92,779012,85.53991435159767,9
0.2,9107,89,779101,85.54029424681599,12
0.2,9108,89,779190,85.54067405862334,12
0.2,9109,93,779283,85.54149286498354,10
0.2,9110,96,779379,85.54264076391175,7
0.2,9111,27,779406,85.53621597892888,6
0.2,9112,91,779497,85.53681553824207,10
0.2,9113,94,779591,85.53774412991002,7
0.2,9114,89,779680,85.53812397147558,12
0.2,9115,93,779773,85.53894251864853,8
0.2,9116,84,779857,85.53877371942525,17
0.2,9117,94,779951,85.53970168896687,7
0.2,9118,-56,779895,85.52418028292576,19
0.2,9119,96,779991,85.52532894736842,6
0.2,9120,92,780083,85.52603881153382,9
0.2,9121,25,780108,85.51940363955273,8
0.2,9122,94,780202,85.52033322372027,9
0.2,9123,-44,780158,85.50613765892153,8
0.2,9124,95,780253,85.50717808219179,6
0.2,9125,94,780347,85.50810870041639,7
0.2,9126,92,780439,85.5088199846609,9
0.2,9127,93,780532,85.50964066608239,8
0.2,9128,95,780627,85.51068024975353,7
0.2,9129,93,780720,85.51150054764513,8
0.2,9130,94,780814,85.51243018289344,7
0.2,9131,93,780907,85.51325010950504,8
0.2,9132,94,781001,85.5141793496113,7
0.2,9133,94,781095,85.51510838624918,7
0.2,9134,93,781188,85.51592775041051,8
0.2,9135,93,781281,85.5167469352014,8
0.2,9136,95,781376,85.5177848309073,6
0.2,9137,90,781466,85.51827533377107,11
0.2,9138,95,781561,85.51931283510231,8
0.2,9139,91,781652,85.5199124726477,10
0.2,9140,90,781742,85.52040258177442,11
0.2,9141,87,781829,85.52056442791512,15
0.2,9142,94,781923,85.52149185168982,8
0.2,9143,90,782013,85.52198162729658,11
0.2,9144,95,782108,85.52301804264626,7
0.2,9145,25,782133,85.51640061228953,8
0.2,9146,91,782224,85.51700010932547,10
0.2,9147,96,782320,85.5181460428509,6
0.2,9148,92,782412,85.51885451961964,9
0.2,9149,94,782506,85.51978142076503,8
0.2,9150,27,782533,85.51338651513495,6
0.2,9151,89,782622,85.51376748251748,12
0.2,9152,27,782649,85.50737463126843,6
0.2,9153,88,782737,85.5076469303037,14
0.2,9154,94,782831,85.50857454942654,7
0.2,9155,94,782925,85.50950196592399,7
0.2,9156,88,783013,85.50977394343126,13
0.2,9157,87,783100,85.50993666739463,14
0.2,9158,93,783193,85.51075444917568,8
0.2,9159,90,783283,85.51124454148471,12
0.2,9160,93,783376,85.51206200196485,8
0.2,9161,94,783470,85.5129884304737,8
0.2,9162,93,783563,85.51380552220888,8
0.2,9163,94,783657,85.51473155827149,8
0.2,9164,91,783748,85.51533006001091,11
0.2,9165,94,783842,85.51625572768928,7
0.2,9166,95,783937,85.51729028035344,7
0.2,9167,95,784032,85.51832460732984,6
0.2,9168,91,784123,85.51892245610209,12
0.2,9169,93,784216,85.51973827699018,8
0.2,9170,91,784307,85.52033584123869,12
0.2,9171,93,784400,85.5211513301352,8
0.2,9172,87,784487,85.52131254769432,14
0.2,9173,92,784579,85.52201874863745,9
0.2,9174,90,784669,85.5225068119891,11
0.2,9175,94,784763,85.52343068875327,7
0.2,9176,94,784857,85.5243543641713,8
0.2,9177,91,784948,85.52495096971018,10
0.2,9178,94,785042,85.52587427824382,7
0.2,9179,94,785136,85.52679738562091,7
0.2,9180,94,785230,85.5277202919072,7
0.2,9181,95,785325,85.52875190590285,6
0.2,9182,94,785419,85.52967439834477,8
0.2,9183,82,785501,85.52929006968641,19
0.2,9184,94,785595,85.5302123026674,8
0.2,9185,94,785689,85.5311343348574,7
0.2,9186,85,785774,85.53107652117122,16
0.2,9187,93,785867,85.53188942098389,8
0.2,9188,94,785961,85.53281096963761,7
0.2,9189,91,786052,85.53340587595213,13
0.2,9190,23,786075,85.52660211076052,13
0.2,9191,91,786166,85.52719756309834,10
0.2,9192,88,786254,85.52746655063635,13
0.2,9193,95,786349,85.52849684576898,6
0.2,9194,92,786441,85.52920065252854,9
0.2,9195,90,786531,85.52968682035667,11
0.2,9196,93,786624,85.53049907578558,8
0.2,9197,96,786720,85.53163731245922,6
0.2,9198,93,786813,85.53244917925862,8
0.2,9199,17,786830,85.525,16
0.2,9200,96,786926,85.52613846321051,6
0.2,9201,91,787017,85.52673331884372,10
0.2,9202,92,787109,85.52743670542215,9
0.2,9203,25,787134,85.52086049543676,7
0.2,9204,89,787223,85.52123845736013,15
0.2,9205,93,787316,85.52205083641104,8
0.2,9206,96,787412,85.52318887802758,7
0.2,9207,94,787506,85.52410947002606,7
0.2,9208,27,787533,85.51775437072429,6
0.2,9209,85,787618,85.51769815418024,18
0.2,9210,95,787713,85.51872760829443,6
0.2,9211,93,787806,85.51953973078594,8
0.2,9212,92,787898,85.52024313470096,9
0.2,9213,95,787993,85.52127197742566,6
0.2,9214,92,788085,85.52197504069451,10
0.2,9215,89,788174,85.52235243055556,14
0.2,9216,96,788270,85.5234892047304,6
0.2,9217,25,788295,85.51692341071816,8
0.2,9218,88,788383,85.51719275409481,13
0.2,9219,86,788469,85.51724511930585,15
0.2,9220,94,788563,85.51816505801973,8
0.2,9221,91,788654,85.51875948818044,10
0.2,9222,96,788750,85.51989591239293,6
0.2,9223,92,788842,85.52059843885516,11
0.2,9224,92,788934,85.52130081300812,10
0.2,9225,89,789023,85.5216778668979,13
0.2,9226,21,789044,85.51468516310827,11
0.2,9227,88,789132,85.5149544863459,13
0.2,9228,93,789225,85.515765521725,8
0.2,9229,94,789319,85.51668472372698,7
0.2,9230,95,789414,85.51771205719857,6
0.2,9231,94,789508,85.5186308492201,7
0.2,9232,91,789599,85.51922452074082,10
0.2,9233,90,789689,85.51970976824778,11
0.2,9234,92,789781,85.52041147807255,9
0.2,9235,96,789877,85.52154612386315,6
0.2,9236,91,789968,85.52213922269135,11
0.2,9237,92,790060,85.52284044165404,9
0.2,9238,87,790147,85.52300032471047,16
0.2,9239,24,790171,85.51634199134199,11
0.2,9240,93,790264,85.51715182339574,8
0.2,9241,90,790354,85.51763687513525,11
0.2,9242,94,790448,85.51855458184572,7
0.2,9243,94,790542,85.51947209000433,8
0.2,9244,88,790630,85.51974040021634,14
0.2,9245,95,790725,85.52076573653471,6
0.2,9246,92,790817,85.52146642154212,9
0.2,9247,95,790912,85.52249134948097,6
0.2,9248,85,790997,85.52243485782246,16
0.2,9249,22,791019,85.51556756756757,10
0.2,9250,87,791106,85.51572802940223,14
0.2,9251,92,791198,85.51642888024212,9
0.2,9252,93,791291,85.5172376526532,8
0.2,9253,90,791381,85.51772206613356,11
0.2,9254,93,791474,85.51853052404105,9
0.2,9255,96,791570,85.51966292134831,6
0.2,9256,84,791654,85.51949875769688,17
0.2,9257,94,791748,85.5204147764096,7
0.2,9258,93,791841,85.52122259423264,9
0.2,9259,91,791932,85.5218142548596,10
0.2,9260,96,792028,85.52294568621099,6
0.2,9261,91,792119,85.52353703303822,10
0.2,9262,94,792213,85.52445212134297,7
0.2,9263,92,792305,85.52515112262522,9
0.2,9264,95,792400,85.5261737722612,6
0.2,9265,21,792421,85.519210015109,11
0.2,9266,96,792517,85.52034099492823,6
0.2,9267,90,792607,85.52082434182132,11
0.2,9268,92,792699,85.52152335742798,9
0.2,9269,92,792791,85.52222222222223,9
0.2,9270,91,792882,85.5228130730234,10
0.2,9271,94,792976,85.5237273511648,7
0.2,9272,92,793068,85.52442575218376,9
0.2,9273,88,793156,85.52469268923873,13
0.2,9274,89,793245,85.52506738544474,12
0.2,9275,92,793337,85.52576541612764,9
0.2,9276,93,793430,85.52657108979196,8
0.2,9277,94,793524,85.52748437163181,7
0.2,9278,95,793619,85.52850522685634,6
0.2,9279,93,793712,85.52931034482759,8
0.2,9280,95,793807,85.53033078332076,6
0.2,9281,93,793900,85.53113553113553,8
0.2,9282,96,793996,85.53226327695788,6
0.2,9283,96,794092,85.53339077983628,6
0.2,9284,89,794181,85.53376413570274,13
0.2,9285,93,794274,85.53456816713332,9
0.2,9286,82,794356,85.53418757402821,19
0.2,9287,88,794444,85.53445305770887,13
0.2,9288,93,794537,85.53525675530197,8
0.2,9289,94,794631,85.53616792249731,8
0.2,9290,88,794719,85.53643310730814,13
0.2,9291,94,794813,85.53734395178648,7
0.2,9292,96,794909,85.53846981599052,6
0.2,9293,92,795001,85.53916505272218,9
0.2,9294,96,795097,85.54029047875201,6
0.2,9295,21,795118,85.53334767641996,11
0.2,9296,94,795212,85.53425836291277,7
0.2,9297,92,795304,85.53495375349537,9
0.2,9298,95,795399,85.53597160985052,7
0.2,9299,92,795491,85.53666666666666,9
0.2,9300,94,795585,85.53757660466617,7
0.2,9301,91,795676,85.53816383573425,10
0.2,9302,94,795770,85.53907341717725,7
0.2,9303,94,795864,85.53998280309544,7
0.2,9304,93,795957,85.54078452444922,8
0.2,9305,94,796051,85.54169353105523,8
0.2,9306,93,796144,85.54249489631461,10
0.2,9307,-44,796100,85.52857756768371,8
0.2,9308,95,796195,85.52959501557632,7
0.2,9309,91,796286,85.53018259935553,10
0.2,9310,92,796378,85.53087745677156,10
0.2,9311,92,796470,85.53157216494846,9
0.2,9312,96,796566,85.53269623107484,6
0.2,9313,-44,796522,85.51878891990552,8
0.2,9314,92,796614,85.5194847020934,10
0.2,9315,90,796704,85.51996565049377,11
0.2,9316,88,796792,85.52023183428142,13
0.2,9317,89,796881,85.52060528010303,13
0.2,9318,93,796974,85.52140787638159,8
0.2,9319,93,797067,85.52221030042918,8
0.2,9320,91,797158,85.52279798304903,10
0.2,9321,93,797251,85.5236000858185,8
0.2,9322,94,797345,85.52450927812936,7
0.2,9323,26,797371,85.51812526812527,9
0.2,9324,93,797464,85.51892761394102,8
0.2,9325,92,797556,85.51962256058331,10
0.2,9326,91,797647,85.52021014259677,11
0.2,9327,84,797731,85.52004716981132,17
0.2,9328,95,797826,85.52106335084146,6
0.2,9329,26,797852,85.51468381564844,6
0.2,9330,90,797942,85.51516450541207,11
0.2,9331,90,798032,85.51564509215602,11
0.2,9332,94,798126,85.51655416264866,7
0.2,9333,94,798220,85.5174630383544,7
0.2,9334,93,798313,85.51826459560793,8
0.2,9335,92,798405,85.5189588688946,9
0.2,9336,92,798497,85.51965299346685,10
0.2,9337,96,798593,85.5207753266224,6
0.2,9338,92,798685,85.52146910804154,9
0.2,9339,94,798779,85.52237687366167,7
0.2,9340,93,798872,85.52317739000107,8
0.2,9341,95,798967,85.52419182187968,6
0.2,9342,90,799057,85.5246708765921,11
0.2,9343,94,799151,85.5255779109589,7
0.2,9344,94,799245,85.52648475120385,9
0.2,9345,27,799272,85.52022255510379,6
0.2,9346,94,799366,85.52112977425912,7
0.2,9347,96,799462,85.52225074882328,6
0.2,9348,92,799554,85.5229436303348,10
0.2,9349,89,799643,85.52331550802138,12
0.2,9350,87,799730,85.5234734253021,14
0.2,9351,93,799823,85.52427288280582,9
0.2,9352,92,799915,85.52496525179087,9
0.2,9353,93,800008,85.52576437887535,8
0.2,9354,93,800101,85.52656333511491,8
0.2,9355,93,800194,85.52736212056435,8
0.2,9356,92,800286,85.52805386341777,9
0.2,9357,94,800380,85.52895917931181,7
0.2,9358,84,800464,85.52879581151832,17
0.2,9359,94,800558,85.52970085470085,7
0.2,9360,27,800585,85.5234483495353,6
0.2,9361,93,800678,85.52424695577868,8
0.2,9362,88,800766,85.52451137455944,13
0.2,9363,96,800862,85.52563007261854,6
0.2,9364,93,800955,85.52642819006941,8
0.2,9365,93,801048,85.5272261370916,8
0.2,9366,89,801137,85.52759688267321,12
0.2,9367,92,801229,85.5282877882152,9
0.2,9368,93,801322,85.52908528124667,8
0.2,9369,26,801348,85.52273212379936,7
0.2,9370,92,801440,85.52342332728631,9
0.2,9371,94,801534,85.52432778489117,7
0.2,9372,93,801627,85.52512536007681,9
0.2,9373,94,801721,85.5260294431406,8
0.2,9374,93,801814,85.52682666666666,8
0.2,9375,94,801908,85.52773037542661,7
0.2,9376,94,802002,85.5286338914365,7
0.2,9377,90,802092,85.52911068458093,11
0.2,9378,92,802184,85.52980061840282,9
0.2,9379,96,802280,85.53091684434968,6
0.2,9380,93,802373,85.53171303698966,8
0.2,9381,92,802465,85.5324024728203,10
0.2,9382,88,802553,85.53266545880848,14
0.2,9383,95,802648,85.53367433930094,6
0.2,9384,92,802740,85.53436334576452,9
0.2,9385,24,802764,85.52780737268272,9
0.2,9386,96,802860,85.5289229785874,6
0.2,9387,91,802951,85.52950575202387,10
0.2,9388,90,803041,85.5299818937054,11
0.2,9389,90,803131,85.53045793397231,11
0.2,9390,92,803223,85.53114684272175,9
0.2,9391,94,803317,85.53204855195911,8
0.2,9392,93,803410,85.53284360694134,8
0.2,9393,93,803503,85.53363849265489,8
0.2,9394,94,803597,85.53453964874933,7
0.2,9395,93,803690,85.53533418475948,8
0.2,9396,89,803779,85.53570288389912,13
0.2,9397,94,803873,85.53660353266652,7
0.2,9398,93,803966,85.53739759548888,8
0.2,9399,95,804061,85.53840425531915,6
0.2,9400,93,804154,85.53919795766407,8
0.2,9401,91,804245,85.53977877047437,10
0.2,9402,27,804272,85.53355312134426,6
0.2,9403,94,804366,85.53445342407487,7
0.2,9404,93,804459,85.53524720893142,8
0.2,9405,91,804550,85.5358281947693,10
0.2,9406,91,804641,85.53640905708515,10
0.2,9407,25,804666,85.52997448979592,9
0.2,9408,90,804756,85.53044956956106,11
0.2,9409,89,804845,85.5308182784272,12
0.2,9410,87,804932,85.53097439166932,16
0.2,9411,94,805026,85.53187420314492,7
0.2,9412,86,805112,85.53192393498354,15
0.2,9413,95,805207,85.53292967920119,6
0.2,9414,92,805299,85.5336165693043,9
0.2,9415,94,805393,85.53451571792694,7
0.2,9416,93,805486,85.53530848465542,8
0.2,9417,94,805580,85.53620726268846,7
0.2,9418,92,805672,85.53689351311179,9
0.2,9419,95,805767,85.53789808917197,6
0.2,9420,95,805862,85.53890245196901,7
0.2,9421,88,805950,85.53916365952027,13
0.2,9422,95,806045,85.54016767483816,6
0.2,9423,93,806138,85.54095925297113,8
0.2,9424,95,806233,85.54196286472148,6
0.2,9425,94,806327,85.54286017398684,7
0.2,9426,96,806423,85.5439694494537,6
0.2,9427,91,806514,85.5445481544336,10
0.2,9428,95,806609,85.54555095980486,7
0.2,9429,88,806697,85.54581124072111,13
0.2,9430,91,806788,85.54638956632382,10
0.2,9431,88,806876,85.54664970313826,17
0.2,9432,90,806966,85.54712180642426,11
0.2,9433,93,807059,85.54791180835277,8
0.2,9434,94,807153,85.54880763116057,8
0.2,9435,94,807247,85.54970326409496,7
0.2,9436,93,807340,85.5504927413373,8
0.2,9437,91,807431,85.55107014197924,10
0.2,9438,81,807512,85.55058798601547,20
0.2,9439,96,807608,85.55169491525423,6
0.2,9440,92,807700,85.55237792606715,9
0.2,9441,95,807795,85.55337852149968,7
0.2,9442,96,807891,85.5544848035582,6
0.2,9443,85,807976,85.55442609063957,16
0.2,9444,91,808067,85.55500264690312,10
0.2,9445,93,808160,85.55579081092526,9
0.2,9446,89,808249,85.55615539324653,15
0.2,9447,90,808339,85.55662574089754,11
0.2,9448,91,808430,85.55720182029845,10
0.2,9449,93,808523,85.55798941798942,8
0.2,9450,88,808611,85.55824780446514,14
0.2,9451,89,808700,85.55861193398222,12
0.2,9452,95,808795,85.55961070559611,6
0.2,9453,88,808883,85.55986883858684,13
0.2,9454,95,808978,85.56086726599683,6
0.2,9455,93,809071,85.56165397631133,9
0.2,9456,95,809166,85.5626520038067,6
0.2,9457,94,809260,85.56354408965954,7
0.2,9458,93,809353,85.56433026747014,9
0.2,9459,21,809374,85.55750528541226,12
0.2,9460,91,809465,85.558080541169,10
0.2,9461,90,809555,85.55854998943141,11
0.2,9462,94,809649,85.55944203740886,8
0.2,9463,88,809737,85.55969991546915,13
0.2,9464,94,809831,85.56059165346012,7
0.2,9465,91,809922,85.56116627931544,10
0.2,9466,89,810011,85.56152952360833,12
0.2,9467,94,810105,85.56242078580482,7
0.2,9468,94,810199,85.56331185975287,9
0.2,9469,94,810293,85.56420274551215,8
0.2,9470,92,810385,85.56488227219934,9
0.2,9471,93,810478,85.56566722972973,8
0.2,9472,94,810572,85.56655758471445,7
0.2,9473,85,810657,85.56649778340721,16
0.2,9474,92,810749,85.56717678100264,9
0.2,9475,91,810840,85.56775010552975,10
0.2,9476,94,810934,85.56863986493616,8
0.2,9477,93,811027,85.56942392909896,8
0.2,9478,88,811115,85.56968034602806,13
0.2,9479,93,811208,85.5704641350211,8
0.2,9480,-49,811159,85.55627043560806,12
0.2,9481,96,811255,85.55737186247627,7
0.2,9482,95,811350,85.55836760518824,6
0.2,9483,8,811358,85.55018979333614,25
0.2,9484,94,811452,85.55108065366367,7
0.2,9485,90,811542,85.55154965211891,11
0.2,9486,94,811636,85.55244018130072,7
0.2,9487,94,811730,85.55333052276559,8
0.2,9488,94,811824,85.55422067657287,7
0.2,9489,91,811915,85.55479452054794,10
0.2,9490,93,812008,85.5555789695501,9
0.2,9491,83,812091,85.55530973451327,18
0.2,9492,92,812183,85.55598862319604,10
0.2,9493,89,812272,85.55635137981884,12
0.2,9494,90,812362,85.55681937862033,11
0.2,9495,89,812451,85.55718197135636,13
0.2,9496,88,812539,85.55743919132358,13
0.2,9497,92,812631,85.55811749842071,9
0.2,9498,92,812723,85.55879566270134,9
0.2,9499,22,812745,85.5521052631579,10
0.2,9500,93,812838,85.5528891695611,8
0.2,9501,94,812932,85.553778151968,7
0.2,9502,94,813026,85.55466694727981,7
0.2,9503,94,813120,85.55555555555556,8
0.2,9504,92,813212,85.55623356128353,9
0.2,9505,90,813302,85.55670103092784,12
0.2,9506,96,813398,85.55779951614599,6
0.2,9507,95,813493,85.55879259570888,8
0.2,9508,90,813583,85.55925964875381,14
0.2,9509,96,813679,85.56035751840169,6
0.2,9510,94,813773,85.561244874356,7
0.2,9511,91,813864,85.56181665264928,10
0.2,9512,93,813957,85.56259854935351,8
0.2,9513,88,814045,85.56285474038259,13
0.2,9514,96,814141,85.56395165528113,6
0.2,9515,94,814235,85.56483816729718,9
0.2,9516,92,814327,85.56551434275507,9
0.2,9517,25,814352,85.55915108216011,8
0.2,9518,95,814447,85.56014287215044,6
0.2,9519,90,814537,85.56060924369748,11
0.2,9520,96,814633,85.56170570318244,6
0.2,9521,95,814728,85.56269691241336,6
0.2,9522,91,814819,85.5632678777696,11
0.2,9523,96,814915,85.56436371272575,6
0.2,9524,92,815007,85.56503937007874,9
0.2,9525,92,815099,85.56571488557631,11
0.2,9526,92,815191,85.56639025926314,9
0.2,9527,94,815285,85.56727539882452,7
0.2,9528,93,815378,85.56805540980166,9
0.2,9529,92,815470,85.56873032528856,9
0.2,9530,93,815563,85.56951001993495,8
0.2,9531,94,815657,85.57039446076374,7
0.2,9532,95,815752,85.57138361481171,6
0.2,9533,89,815841,85.57174323473883,12
0.2,9534,93,815934,85.57252228631359,8
0.2,9535,26,815960,85.56627516778524,8
0.2,9536,95,816055,85.56726433889064,6
0.2,9537,92,816147,85.56793877123087,9
0.2,9538,93,816240,85.56871789495754,8
0.2,9539,85,816325,85.56865828092243,17
0.2,9540,96,816421,85.56975159836495,6
0.2,9541,93,816514,85.57053028715154,8
0.2,9542,89,816603,85.57088965734046,12
0.2,9543,93,816696,85.57166806370495,8
0.2,9544,94,816790,85.57255107386067,9
0.2,9545,89,816879,85.57291011942175,13
0.2,9546,91,816970,85.57347857965853,10
0.2,9547,90,817060,85.57394218684541,11
0.2,9548,93,817153,85.57471986595455,8
0.2,9549,92,817245,85.57539267015707,9
0.2,9550,94,817339,85.57627473562978,7
0.2,9551,93,817432,85.57705192629815,10
0.2,9552,89,817521,85.57741023762169,12
0.2,9553,93,817614,85.57818714674482,9
0.2,9554,94,817708,85.57906855049713,7
0.2,9555,93,817801,85.57984512348263,11
0.2,9556,85,817886,85.5797844511876,16
0.2,9557,21,817907,85.57302783008998,11
0.2,9558,92,817999,85.57370017784287,9
0.2,9559,94,818093,85.57458158995816,7
0.2,9560,93,818186,85.57535822612698,8
0.2,9561,89,818275,85.57571637732691,12
0.2,9562,89,818364,85.57607445362333,12
0.2,9563,93,818457,85.57685069008782,8
0.2,9564,91,818548,85.57741766858338,10
0.2,9565,89,818637,85.57777545473552,12
0.2,9566,95,818732,85.57876032194,6
0.2,9567,25,818757,85.57242892976589,8
0.2,9568,96,818853,85.57351865398684,6
0.2,9569,93,818946,85.5742946708464,8
0.2,9570,94,819040,85.57517500783617,7
0.2,9571,96,819136,85.57626410363561,6
0.2,9572,91,819227,85.57683066959156,12
0.2,9573,95,819322,85.57781491539586,6
0.2,9574,95,819417,85.57879895561358,6
0.2,9575,88,819505,85.57905179615706,13
0.2,9576,92,819597,85.5797222512269,9
0.2,9577,92,819689,85.58039256629776,9
0.2,9578,95,819784,85.5813759265059,6
0.2,9579,94,819878,85.58225469728602,7
0.2,9580,92,819970,85.58292453814842,9
0.2,9581,89,820059,85.5832811521603,12
0.2,9582,92,820151,85.5839507461129,9
0.2,9583,93,820244,85.5847245409015,8
0.2,9584,92,820336,85.58539384454878,9
0.2,9585,90,820426,85.58585437095765,12
0.2,9586,94,820520,85.58673203296131,7
0.2,9587,22,820542,85.58010012515645,11
0.2,9588,95,820637,85.58108249035352,6
0.2,9589,94,820731,85.58196037539103,7
0.2,9590,94,820825,85.5828380773642,7
0.2,9591,94,820919,85.58371559633028,8
0.2,9592,94,821013,85.5845929323465,7
0.2,9593,92,821105,85.58526162184698,9
0.2,9594,92,821197,85.58593017196456,10
0.2,9595,93,821290,85.58670279283035,8
0.2,9596,92,821382,85.5873710534542,11
0.2,9597,86,821468,85.58741404459262,15
0.2,9598,94,821562,85.58829044692155,7
0.2,9599,90,821652,85.58875,11
0.2,9600,92,821744,85.5894177689824,9
0.2,9601,95,821839,85.59039783378462,7
0.2,9602,84,821923,85.5902322190982,17
0.2,9603,25,821948,85.58392336526447,8
0.2,9604,94,822042,85.58479958355024,7
0.2,9605,95,822137,85.5857797210077,7
0.2,9606,92,822229,85.5864473821172,9
0.2,9607,93,822322,85.58721898417986,8
0.2,9608,92,822414,85.58788635654075,11
0.2,9609,91,822505,85.58844953173778,11
0.2,9610,94,822599,85.58932473207783,7
0.2,9611,92,822691,85.58999167707033,9
0.2,9612,94,822785,85.59086653490066,7
0.2,9613,93,822878,85.59163719575619,8
0.2,9614,93,822971,85.59240769630786,8
0.2,9615,90,823061,85.59286605657238,12
0.2,9616,93,823154,85.5936362691068,8
0.2,9617,26,823180,85.58744021626117,8
0.2,9618,87,823267,85.5875870672627,14
0.2,9619,93,823360,85.58835758835758,8
0.2,9620,92,823452,85.58902400997817,9
0.2,9621,93,823545,85.58979422157556,9
0.2,9622,93,823638,85.59056427309571,8
0.2,9623,95,823733,85.59154197838737,8
0.2,9624,94,823827,85.59241558441559,8
0.2,9625,92,823919,85.5930812383129,11
0.2,9626,96,824015,85.59416225199958,6
0.2,9627,93,824108,85.59493144993768,8
0.2,9628,90,824198,85.59538892927614,12
0.2,9629,94,824292,85.596261682243,7
0.2,9630,93,824385,85.5970304225937,8
0.2,9631,87,824472,85.59717607973423,14
0.2,9632,93,824565,85.5979445655559,9
0.2,9633,92,824657,85.59860909279635,9
0.2,9634,92,824749,85.59927348209652,10
0.2,9635,95,824844,85.60024906600249,6
0.2,9636,95,824939,85.60122444744215,8
0.2,9637,94,825033,85.60209587051256,7
0.2,9638,90,825123,85.60255213196389,11
0.2,9639,-44,825079,85.58910788381743,8
0.2,9640,89,825168,85.58946167410019,12
0.2,9641,14,825182,85.58203692180045,18
0.2,9642,88,825270,85.5822876698123,14
0.2,9643,92,825362,85.5829531314807,10
0.2,9644,93,825455,85.58372213582167,8
0.2,9645,93,825548,85.58449098071739,10
0.2,9646,92,825640,85.58515600704882,9
0.2,9647,93,825733,85.58592454394693,8
0.2,9648,95,825828,85.5869001969116,6
0.2,9649,93,825921,85.58766839378238,10
0.2,9650,16,825937,85.58045798362863,17
0.2,9651,95,826032,85.58143389970991,6
0.2,9652,95,826127,85.58240961359164,6
0.2,9653,93,826220,85.58317795732339,8
0.2,9654,92,826312,85.5838425686173,9
0.2,9655,88,826400,85.58409279204639,14
0.2,9656,93,826493,85.58486072279176,8
0.2,9657,91,826584,85.58542141230069,10
0.2,9658,92,826676,85.58608551609898,11
0.2,9659,94,826770,85.58695652173913,7
0.2,9660,95,826865,85.58793085601904,6
0.2,9661,96,826961,85.58900848685572,6
0.2,9662,93,827054,85.58977543206043,8
0.2,9663,92,827146,85.59043874172185,9
0.2,9664,26,827172,85.5842731505432,6
0.2,9665,92,827264,85.58493689219947,9
0.2,9666,90,827354,85.585393607117,11
0.2,9667,93,827447,85.58616052958213,8
0.2,9668,87,827534,85.58630675354225,14
0.2,9669,93,827627,85.5870734229576,8
0.2,9670,90,827717,85.58752972805294,13
0.2,9671,87,827804,85.58767576509511,16
0.2,9672,95,827899,85.58864881629277,6
0.2,9673,90,827989,85.58910481703535,11
0.2,9674,93,828082,85.5898708010336,8
0.2,9675,87,828169,85.59001653575858,14
0.2,9676,92,828261,85.59067892942028,9
0.2,9677,90,828351,85.59113453192809,12
0.2,9678,95,828446,85.59210662258498,6
0.2,9679,95,828541,85.5930785123967,6
0.2,9680,89,828630,85.59343043074063,12
0.2,9681,94,828724,85.59429869861599,7
0.2,9682,95,828819,85.59527006093153,6
0.2,9683,91,828910,85.59582817017761,10
0.2,9684,26,828936,85.58967475477543,7
0.2,9685,92,829028,85.59033656824282,9
0.2,9686,93,829121,85.59110147620522,9
0.2,9687,91,829212,85.5916597853014,11
0.2,9688,92,829304,85.5923211889772,10
0.2,9689,25,829329,85.5860681114551,9
0.2,9690,92,829421,85.58672995562894,10
0.2,9691,96,829517,85.58780437474205,6
0.2,9692,91,829608,85.58836273599505,11
0.2,9693,93,829701,85.58912729523416,10
0.2,9694,95,829796,85.59009798865395,7
0.2,9695,86,829882,85.5901402640264,15
0.2,9696,92,829974,85.590801278746,9
0.2,9697,96,830070,85.59187461332233,6
0.2,9698,93,830163,85.59263841633158,8
0.2,9699,92,830255,85.59329896907217,10
0.2,9700,93,830348,85.59406246778683,8
0.2,9701,25,830373,85.5878169449598,8
0.2,9702,92,830465,85.58847779037411,10
0.2,9703,92,830557,85.5891384995878,9
0.2,9704,87,830644,85.5892838742916,14
0.2,9705,91,830735,85.58984133525654,10
0.2,9706,88,830823,85.59008962604307,13
0.2,9707,93,830916,85.59085290482076,8
0.2,9708,94,831010,85.59171902358636,7
0.2,9709,91,831101,85.59227600411947,11
0.2,9710,96,831197,85.59334774997426,6
0.2,9711,96,831293,85.59441927512356,6
0.2,9712,91,831384,85.59497580562133,10
0.2,9713,92,831476,85.59563516574016,9
0.2,9714,95,831571,85.59660319094185,8
0.2,9715,86,831657,85.5966447097571,15
0.2,9716,89,831746,85.59699495729134,12
0.2,9717,93,831839,85.59775674006997,8
0.2,9718,91,831930,85.59831258359914,10
0.2,9719,92,832022,85.59897119341564,9
0.2,9720,92,832114,85.59962966772966,9
0.2,9721,94,832208,85.60049372557087,8
0.2,9722,94,832302,85.60135760567726,7
0.2,9723,95,832397,85.60232414644179,7
0.2,9724,91,832488,85.60287917737789,10
0.2,9725,89,832577,85.60322845979847,12
0.2,9726,85,832662,85.603166443919,16
0.2,9727,85,832747,85.60310444078948,16
0.2,9728,95,832842,85.6040703052729,8
0.2,9729,95,832937,85.60503597122302,6
0.2,9730,91,833028,85.60559038125578,10
0.2,9731,95,833123,85.60655569256062,6
0.2,9732,93,833216,85.60731531901777,8
0.2,9733,93,833309,85.60807478939799,9
0.2,9734,92,833401,85.60873138161274,9
0.2,9735,94,833495,85.60959326211997,10
0.2,9736,93,833588,85.61035226455787,8
0.2,9737,96,833684,85.61141918258369,6
0.2,9738,91,833775,85.61197248177432,10
0.2,9739,91,833866,85.61252566735114,10
0.2,9740,90,833956,85.61297608048454,11
0.2,9741,24,833980,85.60665161157873,9
0.2,9742,94,834074,85.60751308631838,7
0.2,9743,92,834166,85.60816912972085,9
0.2,9744,94,834260,85.60903027193433,7
0.2,9745,92,834352,85.60968602503591,10
0.2,9746,93,834445,85.6104442392531,9
0.2,9747,94,834539,85.61130488305294,7
0.2,9748,91,834630,85.61185762642322,10
0.2,9749,92,834722,85.61251282051282,10
0.2,9750,94,834816,85.61337298738592,7
0.2,9751,93,834909,85.61413043478261,8
0.2,9752,94,835003,85.61499025940736,7
0.2,9753,96,835099,85.61605495181465,6
0.2,9754,95,835194,85.61701691440287,8
0.2,9755,92,835286,85.61767117671177,10
0.2,9756,87,835373,85.61781285231116,14
0.2,9757,94,835467,85.6186718589875,8
0.2,9758,22,835489,85.61215288451686,10
0.2,9759,87,835576,85.61229508196722,14
0.2,9760,92,835668,85.61294949287982,9
0.2,9761,94,835762,85.61380864576931,7
0.2,9762,92,835854,85.61446276759193,9
0.2,9763,93,835947,85.6152191724703,8
0.2,9764,93,836040,85.61597542242704,9
0.2,9765,89,836129,85.61632193323777,12
0.2,9766,96,836225,85.61738507218183,6
0.2,9767,91,836316,85.61793611793611,12
0.2,9768,94,836410,85.61879414474357,8
0.2,9769,-47,836363,85.60522006141248,12
0.2,9770,92,836455,85.60587452666053,10
0.2,9771,90,836545,85.60632419156775,11
0.2,9772,92,836637,85.60697840990484,9
0.2,9773,96,836733,85.60804174340086,6
0.2,9774,93,836826,85.6087979539642,9
0.2,9775,96,836922,85.60986088379705,6
0.2,9776,87,837009,85.6100030684259,16
0.2,9777,92,837101,85.61065657598691,9
0.2,9778,90,837191,85.61110543000306,13
0.2,9779,89,837280,85.61145194274029,12
0.2,9780,93,837373,85.61220734076271,8
0.2,9781,95,837468,85.61316704150481,6
0.2,9782,25,837493,85.60697127670448,8
0.2,9783,90,837583,85.60742027800491,11
0.2,9784,93,837676,85.60817577925395,8
0.2,9785,94,837770,85.60903331289597,7
0.2,9786,88,837858,85.60927761316032,15
0.2,9787,92,837950,85.60993052717613,9
0.2,9788,89,838039,85.61027684135254,12
0.2,9789,96,838135,85.61133810010215,6
0.2,9790,94,838229,85.61219487284241,7
0.2,9791,90,838319,85.61264297385621,11
0.2,9792,90,838409,85.61309098335546,11
0.2,9793,93,838502,85.61384521135389,9
0.2,9794,92,838594,85.61449719244513,9
0.2,9795,94,838688,85.61535320538995,7
0.2,9796,94,838782,85.61620904358477,7
0.2,9797,91,838873,85.61675852214738,11
0.2,9798,91,838964,85.61730788856006,10
0.2,9799,87,839051,85.61744897959184,14
0.2,9800,93,839144,85.61820222426283,8
0.2,9801,91,839235,85.61875127524995,10
0.2,9802,16,839251,85.61164949505253,17
0.2,9803,90,839341,85.61209710322318,11
0.2,9804,92,839433,85.61274859765426,9
0.2,9805,95,839528,85.6137058943504,6
0.2,9806,92,839620,85.61435709187315,11
0.2,9807,88,839708,85.61460032626428,13
0.2,9808,84,839792,85.61443572229585,17
0.2,9809,86,839878,85.6144750254842,15
0.2,9810,92,839970,85.61512587911528,10
0.2,9811,92,840062,85.61577660008153,10
0.2,9812,27,840089,85.60980332212371,6
0.2,9813,91,840180,85.61035255757082,10
0.2,9814,92,840272,85.61100356597045,10
0.2,9815,92,840364,85.6116544417278,9
0.2,9816,94,840458,85.6125089131099,7
0.2,9817,93,840551,85.6132613566918,9
0.2,9818,89,840640,85.61360627355128,12
0.2,9819,92,840732,85.6142566191446,9
0.2,9820,95,840827,85.6152123001731,8
0.2,9821,94,840921,85.61606597434331,7
0.2,9822,90,841011,85.61651226712817,11
0.2,9823,25,841036,85.61034201954398,7
0.2,9824,95,841131,85.61129770992366,6
0.2,9825,95,841226,85.61225320578058,6
0.2,9826,95,841321,85.61320850717411,6
0.2,9827,90,841411,85.61365486365486,11
0.2,9828,94,841505,85.6145080883101,7
0.2,9829,27,841532,85.6085452695829,6
0.2,9830,94,841626,85.6093988404028,9
0.2,9831,94,841720,85.61025223759154,7
0.2,9832,91,841811,85.6108003661141,11
0.2,9833,95,841906,85.61175513524506,6
0.2,9834,95,842001,85.61270971021861,6
0.2,9835,93,842094,85.61346075640505,8
0.2,9836,93,842187,85.61421164989326,9
0.2,9837,90,842277,85.61465745070136,11
0.2,9838,95,842372,85.61561134261612,7
0.2,9839,94,842466,85.61646341463414,7
0.2,9840,25,842491,85.61030383091149,8
0.2,9841,95,842586,85.61125787441577,6
0.2,9842,84,842670,85.61109417860409,17
0.2,9843,90,842760,85.61154002438033,11
0.2,9844,92,842852,85.61218892839004,9
0.2,9845,95,842947,85.6131423928499,6
0.2,9846,17,842964,85.60617446938154,16
0.2,9847,84,843048,85.60601137286758,17
0.2,9848,25,843073,85.5998578535892,8
0.2,9849,88,843161,85.60010152284264,13
0.2,9850,95,843256,85.6010557303827,7
0.2,9851,93,843349,85.60180673974827,8
0.2,9852,93,843442,85.60255759667106,8
0.2,9853,95,843537,85.60351126446113,6
0.2,9854,90,843627,85.60395738203957,11
0.2,9855,82,843709,85.60359172077922,19
0.2,9856,92,843801,85.60424064116872,9
0.2,9857,95,843896,85.605193751268,6
0.2,9858,90,843986,85.60563951719242,11
0.2,9859,94,844080,85.60649087221095,7
0.2,9860,89,844169,85.60683500659162,12
0.2,9861,91,844260,85.60738186980329,10
0.2,9862,95,844355,85.60833417824192,6
0.2,9863,90,844445,85.6087793998378,11
0.2,9864,87,844532,85.6089204257476,14
0.2,9865,95,844627,85.60987228866816,6
0.2,9866,93,844720,85.61062126279518,8
0.2,9867,88,844808,85.61086339683827,13
0.2,9868,95,844903,85.61181477353328,7
0.2,9869,93,844996,85.61256332320163,8
0.2,9870,93,845089,85.61331172120353,8
0.2,9871,92,845181,85.61395867098865,9
0.2,9872,91,845272,85.61450420338296,10
0.2,9873,94,845366,85.61535345351427,7
0.2,9874,96,845462,85.61640506329114,6
0.2,9875,93,845555,85.61715269339814,8
0.2,9876,95,845650,85.61810266275185,6
0.2,9877,91,845741,85.61864749949382,10
0.2,9878,90,845831,85.61909100111347,13
0.2,9879,88,845919,85.61933198380567,14
0.2,9880,94,846013,85.62018014371014,7
0.2,9881,94,846107,85.62102813195709,7
0.2,9882,92,846199,85.62167358089648,9
0.2,9883,96,846295,85.62272359368677,6
0.2,9884,93,846388,85.62346990389479,10
0.2,9885,94,846482,85.62431721626542,7
0.2,9886,94,846576,85.62516435723677,8
0.2,9887,92,846668,85.62580906148867,9
0.2,9888,91,846759,85.62635251289312,12
0.2,9889,95,846854,85.62730030333671,7
0.2,9890,93,846947,85.62804569810939,8
0.2,9891,-50,846897,85.61433481601294,13
0.2,9892,92,846989,85.6149802890933,9
0.2,9893,94,847083,85.61582777440873,7
0.2,9894,94,847177,85.6166750884285,7
0.2,9895,94,847271,85.61752223120453,7
0.2,9896,91,847362,85.6180660806305,10
0.2,9897,88,847450,85.61830672863205,17
0.2,9898,87,847537,85.61844630770786,14
0.2,9899,94,847631,85.61929292929293,7
0.2,9900,95,847726,85.62024037975962,6
0.2,9901,92,847818,85.62088466976368,9
0.2,9902,92,847910,85.62152882964759,10
0.2,9903,90,848000,85.62197092084007,11
0.2,9904,93,848093,85.62271580010096,8
0.2,9905,95,848188,85.62366242681203,6
0.2,9906,92,848280,85.62430604622993,9
0.2,9907,92,848372,85.6249495357287,9
0.2,9908,92,848464,85.62559289534767,9
0.2,9909,93,848557,85.62633703329969,8
0.2,9910,90,848647,85.6267783271113,11
0.2,9911,90,848737,85.62721953188056,11
0.2,9912,94,848831,85.62806415817613,7
0.2,9913,94,848925,85.6289086140811,9
0.2,9914,93,849018,85.62965204236006,9
0.2,9915,95,849113,85.63059701492537,6
0.2,9916,87,849200,85.63073510134113,16
0.2,9917,91,849291,85.63127646702964,10
0.2,9918,88,849379,85.63151527371711,13
0.2,9919,91,849470,85.6320564516129,10
0.2,9920,18,849488,85.6252393911904,14
0.2,9921,26,849514,85.61922999395283,7
0.2,9922,93,849607,85.61997379824649,8
0.2,9923,96,849703,85.62101975010077,6
0.2,9924,86,849789,85.62105793450881,17
0.2,9925,94,849883,85.62190207535765,7
0.2,9926,96,849979,85.62294751687317,6
0.2,9927,88,850067,85.62318694601129,14
0.2,9928,94,850161,85.62403061738343,7
0.2,9929,89,850250,85.62437059415912,13
0.2,9930,89,850339,85.62471050246702,12
0.2,9931,88,850427,85.62494965767218,15
0.2,9932,92,850519,85.62559146280077,9
0.2,9933,94,850613,85.62643446748541,8
0.2,9934,95,850708,85.62737795671868,6
0.2,9935,89,850797,85.62771739130434,12
0.2,9936,93,850890,85.62845929354935,8
0.2,9937,92,850982,85.62910042262024,9
0.2,9938,93,851075,85.62984203642218,8
0.2,9939,86,851161,85.62987927565392,15
0.2,9940,94,851255,85.6307212554069,7
0.2,9941,94,851349,85.63156306578153,7
0.2,9942,94,851443,85.63240470682892,7
0.2,9943,27,851470,85.62650844730491,6
0.2,9944,93,851563,85.6272498743087,8
0.2,9945,95,851658,85.62819223808566,6
0.2,9946,90,851748,85.6286317482658,12
0.2,9947,93,851841,85.62937273823884,8
0.2,9948,24,851865,85.62317820886521,9
0.2,9949,86,851951,85.62321608040202,16
0.2,9950,90,852041,85.6236559139785,11
0.2,9951,95,852136,85.62459807073955,6
0.2,9952,96,852232,85.62564051039888,6
0.2,9953,91,852323,85.6261804299779,10
0.2,9954,91,852414,85.62672024108488,10
0.2,9955,92,852506,85.62736038569707,10
0.2,9956,90,852596,85.62779953801346,12
0.2,9957,27,852623,85.62191203052822,6
0.2,9958,92,852715,85.62255246510693,10
0.2,9959,91,852806,85.62309236947792,10
0.2,9960,94,852900,85.6239333400261,7
0.2,9961,90,852990,85.62437261594057,11
0.2,9962,90,853080,85.6248118036736,11
0.2,9963,94,853174,85.62565234845444,7
0.2,9964,95,853269,85.62659307576517,6
0.2,9965,94,853363,85.62743327312863,7
0.2,9966,16,853379,85.62044747667302,16
0.2,9967,95,853474,85.62138844301765,6
0.2,9968,93,853567,85.62212859865583,8
0.2,9969,96,853663,85.62316950852558,6
0.2,9970,91,853754,85.62370875539064,10
0.2,9971,95,853849,85.6246490172483,7
0.2,9972,95,853944,85.62558909054447,6
0.2,9973,94,854038,85.6264287146581,7
0.2,9974,93,854131,85.6271679197995,8
0.2,9975,94,854225,85.62800721732157,8
0.2,9976,94,854319,85.62884634659717,8
0.2,9977,92,854411,85.62948486670676,9
0.2,9978,87,854498,85.62962220663393,15
0.2,9979,89,854587,85.62995991983968,12
0.2,9980,21,854608,85.62348462077948,11
0.2,9981,91,854699,85.6240232418353,10
0.2,9982,94,854793,85.62486226585195,7
0.2,9983,91,854884,85.62540064102564,10
0.2,9984,24,854908,85.61922884326489,9
0.2,9985,90,854998,85.61966753454837,11
0.2,9986,91,855089,85.62020626814859,12
0.2,9987,93,855182,85.62094513416099,9
0.2,9988,93,855275,85.62168385223747,8
0.2,9989,89,855364,85.62202202202202,13
0.2,9990,93,855457,85.62276048443599,8
0.2,9991,94,855551,85.62359887910328,7
0.2,9992,23,855574,85.61733213249275,9
0.2,9993,94,855668,85.61817090254152,7
0.2,9994,27,855695,85.61230615307653,6
0.2,9995,96,855791,85.61334533813526,6
0.2,9996,94,855885,85.61418425527658,9
0.2,9997,92,855977,85.61482296459292,10
0.2,9998,91,856068,85.61536153615361,10
0.2,9999,89,856157,85.6157,12
