0.2,0,-63,-63,-63.0,51
0.2,1,-79,-142,-71.0,103
0.2,2,80,-62,-20.666666666666668,37
0.2,3,-152,-214,-53.5,103
0.2,4,-228,-442,-88.4,360
0.2,5,11,-431,-71.83333333333333,63
0.2,6,82,-349,-49.857142857142854,43
0.2,7,19,-330,-41.25,26
0.2,8,24,-306,-34.0,17
0.2,9,90,-216,-21.6,16
0.2,10,20,-196,-17.818181818181817,16
0.2,11,11,-185,-15.416666666666666,49
0.2,12,16,-169,-13.0,59
0.2,13,-103,-272,-19.428571428571427,239
0.2,14,-62,-334,-22.266666666666666,66
0.2,15,9,-325,-20.3125,80
0.2,16,5,-320,-18.823529411764707,73
0.2,17,-3,-323,-17.944444444444443,107
0.2,18,27,-296,-15.578947368421053,6
0.2,19,23,-273,-13.65,33
0.2,20,-11,-284,-13.523809523809524,110
0.2,21,-10,-294,-13.363636363636363,132
0.2,22,24,-270,-11.73913043478261,11
0.2,23,3,-267,-11.125,76
0.2,24,78,-189,-7.56,72
0.2,25,20,-169,-6.5,67
0.2,26,75,-94,-3.4814814814814814,70
0.2,27,94,0,0.0,10
0.2,28,92,92,3.1724137931034484,17
0.2,29,25,117,3.9,11
0.2,30,20,137,4.419354838709677,20
0.2,31,94,231,7.21875,12
0.2,32,26,257,7.787878787878788,6
0.2,33,92,349,10.264705882352942,10
0.2,34,93,442,12.628571428571428,15
0.2,35,93,535,14.86111111111111,8
0.2,36,92,627,16.945945945945947,9
0.2,37,96,723,19.026315789473685,6
0.2,38,91,814,20.871794871794872,10
0.2,39,25,839,20.975,8
0.2,40,95,934,22.78048780487805,7
0.2,41,22,956,22.761904761904763,11
0.2,42,92,1048,24.372093023255815,9
0.2,43,93,1141,25.931818181818183,9
0.2,44,94,1235,27.444444444444443,8
0.2,45,95,1330,28.91304347826087,6
0.2,46,16,1346,28.638297872340427,18
0.2,47,91,1437,29.9375,12
0.2,48,91,1528,31.183673469387756,15
0.2,49,90,1618,32.36,11
0.2,50,95,1713,33.588235294117645,7
0.2,51,96,1809,34.78846153846154,6
0.2,52,94,1903,35.905660377358494,9
0.2,53,90,1993,36.907407407407405,12
0.2,54,24,2017,36.67272727272727,10
0.2,55,23,2040,36.42857142857143,11
0.2,56,89,2129,37.35087719298246,14
0.2,57,93,2222,38.310344827586206,10
0.2,58,25,2247,38.08474576271186,8
0.2,59,95,2342,39.03333333333333,7
0.2,60,84,2426,39.77049180327869,18
0.2,61,90,2516,40.58064516129032,12
0.2,62,94,2610,41.42857142857143,8
0.2,63,90,2700,42.1875,13
0.2,64,93,2793,42.96923076923077,9
0.2,65,95,2888,43.75757575757576,7
0.2,66,89,2977,44.43283582089552,12
0.2,67,96,3073,45.19117647058823,6
0.2,68,91,3164,45.85507246376812,14
0.2,69,92,3256,46.51428571428571,10
0.2,70,95,3351,47.19718309859155,8
0.2,71,96,3447,47.875,6
0.2,72,27,3474,47.58904109589041,6
0.2,73,94,3568,48.21621621621622,8
0.2,74,94,3662,48.82666666666667,7
0.2,75,95,3757,49.43421052631579,6
0.2,76,96,3853,50.03896103896104,7
0.2,77,92,3945,50.57692307692308,11
0.2,78,94,4039,51.12658227848101,7
0.2,79,90,4129,51.6125,12
0.2,80,95,4224,52.148148148148145,6
0.2,81,92,4316,52.63414634146341,9
0.2,82,90,4406,53.08433734939759,14
0.2,83,94,4500,53.57142857142857,8
0.2,84,91,4591,54.01176470588236,10
0.2,85,93,4684,54.46511627906977,8
0.2,86,94,4778,54.91954022988506,7
0.2,87,95,4873,55.375,6
0.2,88,93,4966,55.79775280898876,8
0.2,89,94,5060,56.22222222222222,7
0.2,90,94,5154,56.637362637362635,8
0.2,91,92,5246,57.02173913043478,10
0.2,92,94,5340,57.41935483870968,7
0.2,93,15,5355,56.96808510638298,17
0.2,94,94,5449,57.357894736842105,9
0.2,95,94,5543,57.739583333333336,8
0.2,96,86,5629,58.03092783505155,15
0.2,97,92,5721,58.37755102040816,10
0.2,98,88,5809,58.676767676767675,13
0.2,99,92,5901,59.01,9
0.2,100,96,5997,59.37623762376238,6
0.2,101,23,6020,59.01960784313726,11
0.2,102,95,6115,59.36893203883495,8
0.2,103,95,6210,59.71153846153846,6
0.2,104,95,6305,60.04761904761905,6
0.2,105,94,6399,60.367924528301884,7
0.2,106,26,6425,60.046728971962615,6
0.2,107,21,6446,59.68518518518518,11
0.2,108,16,6462,59.28440366972477,17
0.2,109,84,6546,59.50909090909091,18
0.2,110,94,6640,59.81981981981982,7
0.2,111,94,6734,60.125,7
0.2,112,20,6754,59.769911504424776,14
0.2,113,89,6843,60.026315789473685,13
0.2,114,94,6937,60.321739130434786,7
0.2,115,91,7028,60.58620689655172,10
0.2,116,94,7122,60.87179487179487,8
0.2,117,-49,7073,59.940677966101696,14
0.2,118,88,7161,60.1764705882353,13
0.2,119,23,7184,59.86666666666667,9
0.2,120,91,7275,60.12396694214876,10
0.2,121,90,7365,60.368852459016395,11
0.2,122,94,7459,60.642276422764226,8
0.2,123,23,7482,60.33870967741935,9
0.2,124,89,7571,60.568,12
0.2,125,91,7662,60.80952380952381,10
0.2,126,25,7687,60.52755905511811,7
0.2,127,92,7779,60.7734375,9
0.2,128,93,7872,61.02325581395349,8
0.2,129,96,7968,61.292307692307695,6
0.2,130,95,8063,61.54961832061068,6
0.2,131,91,8154,61.77272727272727,10
0.2,132,94,8248,62.015037593984964,7
0.2,133,94,8342,62.25373134328358,8
0.2,134,91,8433,62.46666666666667,11
0.2,135,91,8524,62.6764705882353,10
0.2,136,87,8611,62.85401459854015,16
0.2,137,96,8707,63.094202898550726,6
0.2,138,90,8797,63.28776978417266,12
0.2,139,20,8817,62.97857142857143,12
0.2,140,91,8908,63.177304964539005,12
0.2,141,95,9003,63.401408450704224,6
0.2,142,94,9097,63.61538461538461,8
0.2,143,23,9120,63.333333333333336,9
0.2,144,90,9210,63.51724137931034,12
0.2,145,95,9305,63.73287671232877,6
0.2,146,92,9397,63.925170068027214,9
0.2,147,94,9491,64.12837837837837,7
0.2,148,91,9582,64.30872483221476,11
0.2,149,95,9677,64.51333333333334,6
0.2,150,93,9770,64.70198675496688,8
0.2,151,94,9864,64.89473684210526,8
0.2,152,94,9958,65.08496732026144,7
0.2,153,25,9983,64.82467532467533,7
0.2,154,92,10075,65.0,9
0.2,155,94,10169,65.18589743589743,7
0.2,156,94,10263,65.36942675159236,7
0.2,157,91,10354,65.53164556962025,11
0.2,158,89,10443,65.67924528301887,13
0.2,159,96,10539,65.86875,6
0.2,160,92,10631,66.03105590062111,9
0.2,161,95,10726,66.20987654320987,7
0.2,162,88,10814,66.34355828220859,14
0.2,163,93,10907,66.5060975609756,8
0.2,164,92,10999,66.66060606060606,10
0.2,165,93,11092,66.81927710843374,9
0.2,166,95,11187,66.9880239520958,6
0.2,167,92,11279,67.13690476190476,12
0.2,168,92,11371,67.28402366863905,9
0.2,169,92,11463,67.42941176470588,10
0.2,170,94,11557,67.58479532163743,7
0.2,171,95,11652,67.74418604651163,6
0.2,172,21,11673,67.47398843930635,11
0.2,173,83,11756,67.5632183908046,19
0.2,174,93,11849,67.70857142857143,10
0.2,175,90,11939,67.83522727272727,11
0.2,176,87,12026,67.94350282485875,14
0.2,177,92,12118,68.07865168539325,9
0.2,178,94,12212,68.22346368715084,7
0.2,179,89,12301,68.33888888888889,13
0.2,180,95,12396,68.48618784530387,7
0.2,181,94,12490,68.62637362637362,7
0.2,182,95,12585,68.77049180327869,6
0.2,183,96,12681,68.91847826086956,7
0.2,184,96,12777,69.06486486486486,6
0.2,185,94,12871,69.1989247311828,7
0.2,186,88,12959,69.29946524064171,13
0.2,187,93,13052,69.42553191489361,8
0.2,188,93,13145,69.55026455026454,8
0.2,189,92,13237,69.66842105263157,9
0.2,190,92,13329,69.78534031413612,9
0.2,191,92,13421,69.90104166666667,9
0.2,192,22,13443,69.65284974093264,12
0.2,193,89,13532,69.75257731958763,12
0.2,194,90,13622,69.85641025641026,11
0.2,195,93,13715,69.97448979591837,8
0.2,196,94,13809,70.09644670050761,7
0.2,197,95,13904,70.22222222222223,6
0.2,198,94,13998,70.34170854271356,8
0.2,199,94,14092,70.46,7
0.2,200,-126,13966,69.48258706467662,23
0.2,201,94,14060,69.60396039603961,7
0.2,202,90,14150,69.70443349753694,12
0.2,203,87,14237,69.78921568627452,16
0.2,204,17,14254,69.53170731707317,15
0.2,205,93,14347,69.64563106796116,8
0.2,206,82,14429,69.70531400966183,19
0.2,207,20,14449,69.46634615384616,15
0.2,208,94,14543,69.58373205741627,7
0.2,209,95,14638,69.70476190476191,6
0.2,210,86,14724,69.78199052132702,15
0.2,211,24,14748,69.56603773584905,9
0.2,212,92,14840,69.67136150234742,9
0.2,213,92,14932,69.77570093457943,10
0.2,214,89,15021,69.86511627906977,12
0.2,215,92,15113,69.9675925925926,9
0.2,216,88,15201,70.05069124423963,13
0.2,217,92,15293,70.15137614678899,9
0.2,218,86,15379,70.22374429223744,15
0.2,219,92,15471,70.32272727272728,9
0.2,220,96,15567,70.43891402714932,6
0.2,221,93,15660,70.54054054054055,8
0.2,222,22,15682,70.32286995515695,10
0.2,223,84,15766,70.38392857142857,20
0.2,224,89,15855,70.46666666666667,12
0.2,225,93,15948,70.56637168141593,9
0.2,226,88,16036,70.6431718061674,15
0.2,227,91,16127,70.73245614035088,10
0.2,228,89,16216,70.8122270742358,12
0.2,229,95,16311,70.91739130434783,6
0.2,230,93,16404,71.01298701298701,8
0.2,231,96,16500,71.12068965517241,6
0.2,232,94,16594,71.21888412017168,10
0.2,233,93,16687,71.3119658119658,8
0.2,234,96,16783,71.41702127659575,6
0.2,235,95,16878,71.51694915254237,6
0.2,236,95,16973,71.61603375527426,6
0.2,237,94,17067,71.71008403361344,8
0.2,238,93,17160,71.79916317991632,10
0.2,239,94,17254,71.89166666666667,7
0.2,240,93,17347,71.97925311203319,8
0.2,241,93,17440,72.06611570247934,8
0.2,242,93,17533,72.1522633744856,8
0.2,243,18,17551,71.93032786885246,15
0.2,244,86,17637,71.98775510204082,15
0.2,245,95,17732,72.08130081300813,7
0.2,246,93,17825,72.16599190283401,8
0.2,247,93,17918,72.25,8
0.2,248,94,18012,72.33734939759036,7
0.2,249,95,18107,72.428,8
0.2,250,-55,18052,71.9203187250996,18
0.2,251,93,18145,72.00396825396825,8
0.2,252,95,18240,72.09486166007905,7
0.2,253,14,18254,71.86614173228347,18
0.2,254,93,18347,71.94901960784314,9
0.2,255,94,18441,72.03515625,8
0.2,256,-46,18395,71.57587548638132,9
0.2,257,94,18489,71.66279069767442,8
0.2,258,25,18514,71.48262548262548,8
0.2,259,17,18531,71.27307692307693,17
0.2,260,95,18626,71.3639846743295,6
0.2,261,95,18721,71.45419847328245,6
0.2,262,90,18811,71.52471482889734,12
0.2,263,92,18903,71.60227272727273,9
0.2,264,94,18997,71.68679245283019,7
0.2,265,90,19087,71.75563909774436,13
0.2,266,94,19181,71.83895131086142,7
0.2,267,21,19202,71.64925373134328,13
0.2,268,92,19294,71.72490706319702,9
0.2,269,91,19385,71.79629629629629,10
0.2,270,26,19411,71.62730627306273,6
0.2,271,95,19506,71.71323529411765,6
0.2,272,88,19594,71.77289377289377,13
0.2,273,92,19686,71.84671532846716,11
0.2,274,95,19781,71.9309090909091,6
0.2,275,93,19874,72.0072463768116,9
0.2,276,93,19967,72.08303249097473,8
0.2,277,93,20060,72.15827338129496,8
0.2,278,17,20077,71.9605734767025,15
0.2,279,94,20171,72.03928571428571,8
0.2,280,90,20261,72.1032028469751,11
0.2,281,88,20349,72.15957446808511,13
0.2,282,86,20435,72.20848056537102,15
0.2,283,26,20461,72.04577464788733,6
0.2,284,24,20485,71.87719298245614,8
0.2,285,92,20577,71.94755244755245,9
0.2,286,92,20669,72.01742160278745,11
0.2,287,91,20760,72.08333333333333,10
0.2,288,94,20854,72.159169550173,7
0.2,289,90,20944,72.22068965517241,16
0.2,290,26,20970,72.0618556701031,6
0.2,291,96,21066,72.14383561643835,6
0.2,292,93,21159,72.21501706484642,8
0.2,293,94,21253,72.28911564625851,7
0.2,294,12,21265,72.08474576271186,23
0.2,295,92,21357,72.15202702702703,9
0.2,296,87,21444,72.20202020202021,14
0.2,297,91,21535,72.26510067114094,10
0.2,298,86,21621,72.31103678929766,16
0.2,299,93,21714,72.38,9
0.2,300,18,21732,72.19933554817275,14
0.2,301,96,21828,72.27814569536424,6
0.2,302,95,21923,72.35313531353135,7
0.2,303,94,22017,72.42434210526316,7
0.2,304,93,22110,72.49180327868852,8
0.2,305,25,22135,72.33660130718954,7
0.2,306,88,22223,72.38762214983713,13
0.2,307,89,22312,72.44155844155844,13
0.2,308,91,22403,72.50161812297735,10
0.2,309,26,22429,72.35161290322581,6
0.2,310,94,22523,72.42122186495178,7
0.2,311,95,22618,72.49358974358974,6
0.2,312,93,22711,72.5591054313099,8
0.2,313,95,22806,72.63057324840764,6
0.2,314,87,22893,72.67619047619047,15
0.2,315,93,22986,72.74050632911393,9
0.2,316,94,23080,72.80757097791798,7
0.2,317,94,23174,72.87421383647799,8
0.2,318,25,23199,72.72413793103448,7
0.2,319,95,23294,72.79375,8
0.2,320,93,23387,72.85669781931465,8
0.2,321,95,23482,72.92546583850931,7
0.2,322,86,23568,72.96594427244582,15
0.2,323,91,23659,73.02160493827161,11
0.2,324,93,23752,73.08307692307692,8
0.2,325,92,23844,73.14110429447852,11
0.2,326,94,23938,73.20489296636086,7
0.2,327,95,24033,73.27134146341463,7
0.2,328,94,24127,73.33434650455926,7
0.2,329,93,24220,73.39393939393939,8
0.2,330,92,24312,73.45015105740181,9
0.2,331,94,24406,73.51204819277109,7
0.2,332,87,24493,73.55255255255256,14
0.2,333,93,24586,73.61077844311377,8
0.2,334,94,24680,73.67164179104478,8
0.2,335,92,24772,73.72619047619048,9
0.2,336,89,24861,73.77151335311572,13
0.2,337,92,24953,73.82544378698225,9
0.2,338,21,24974,73.66961651917404,13
0.2,339,94,25068,73.72941176470589,7
0.2,340,93,25161,73.78592375366568,8
0.2,341,93,25254,73.84210526315789,8
0.2,342,94,25348,73.90087463556851,7
0.2,343,91,25439,73.95058139534883,10
0.2,344,15,25454,73.77971014492753,17
0.2,345,95,25549,73.84104046242774,8
0.2,346,92,25641,73.89337175792507,9
0.2,347,86,25727,73.92816091954023,15
0.2,348,89,25816,73.97134670487107,12
0.2,349,94,25910,74.02857142857142,8
0.2,350,95,26005,74.08831908831908,6
0.2,351,95,26100,74.14772727272727,7
0.2,352,94,26194,74.20396600566572,7
0.2,353,93,26287,74.25706214689265,8
0.2,354,93,26380,74.30985915492958,10
0.2,355,93,26473,74.36235955056179,8
0.2,356,88,26561,74.40056022408963,13
0.2,357,95,26656,74.45810055865921,6
0.2,358,22,26678,74.31197771587743,11
0.2,359,85,26763,74.34166666666667,16
0.2,360,88,26851,74.37950138504155,13
0.2,361,96,26947,74.43922651933701,6
0.2,362,91,27038,74.48484848484848,11
0.2,363,92,27130,74.53296703296704,9
0.2,364,95,27225,74.58904109589041,8
0.2,365,95,27320,74.64480874316939,6
0.2,366,27,27347,74.5149863760218,6
0.2,367,96,27443,74.57336956521739,6
0.2,368,87,27530,74.60704607046071,16
0.2,369,92,27622,74.65405405405406,9
0.2,370,90,27712,74.69541778975741,11
0.2,371,92,27804,74.74193548387096,9
0.2,372,96,27900,74.79892761394102,6
0.2,373,96,27996,74.85561497326204,6
0.2,374,95,28091,74.90933333333334,8
0.2,375,90,28181,74.94946808510639,11
0.2,376,85,28266,74.9761273209549,16
0.2,377,93,28359,75.02380952380952,9
0.2,378,89,28448,75.06068601583114,12
0.2,379,92,28540,75.10526315789474,10
0.2,380,89,28629,75.14173228346456,12
0.2,381,-48,28581,74.81937172774869,11
0.2,382,23,28604,74.68407310704961,9
0.2,383,93,28697,74.73177083333333,8
0.2,384,95,28792,74.78441558441558,8
0.2,385,89,28881,74.82124352331606,13
0.2,386,86,28967,74.85012919896641,16
0.2,387,96,29063,74.90463917525773,6
0.2,388,91,29154,74.94601542416453,10
0.2,389,91,29245,74.98717948717949,10
0.2,390,91,29336,75.02813299232737,11
0.2,391,25,29361,74.90051020408163,9
0.2,392,95,29456,74.95165394402035,6
0.2,393,94,29550,75.0,7
0.2,394,92,29642,75.04303797468354,9
0.2,395,92,29734,75.08585858585859,10
0.2,396,94,29828,75.13350125944585,7
0.2,397,94,29922,75.18090452261306,7
0.2,398,88,30010,75.21303258145363,13
0.2,399,94,30104,75.26,7
0.2,400,88,30192,75.29177057356608,13
0.2,401,90,30282,75.32835820895522,11
0.2,402,94,30376,75.37468982630273,8
0.2,403,95,30471,75.42326732673267,6
0.2,404,90,30561,75.45925925925926,14
0.2,405,94,30655,75.50492610837438,8
0.2,406,87,30742,75.53316953316953,15
0.2,407,95,30837,75.58088235294117,7
0.2,408,91,30928,75.61858190709046,10
0.2,409,94,31022,75.66341463414633,7
0.2,410,25,31047,75.54014598540147,7
0.2,411,25,31072,75.41747572815534,8
0.2,412,94,31166,75.46246973365618,7
0.2,413,93,31259,75.5048309178744,9
0.2,414,95,31354,75.55180722891566,8
0.2,415,95,31449,75.5985576923077,6
0.2,416,92,31541,75.6378896882494,9
0.2,417,18,31559,75.5,15
0.2,418,93,31652,75.5417661097852,8
0.2,419,96,31748,75.5904761904762,6
0.2,420,18,31766,75.45368171021377,14
0.2,421,81,31847,75.46682464454976,25
0.2,422,92,31939,75.50591016548464,9
0.2,423,95,32034,75.55188679245283,7
0.2,424,95,32129,75.59764705882353,6
0.2,425,92,32221,75.63615023474179,9
0.2,426,95,32316,75.68149882903981,8
0.2,427,21,32337,75.55373831775701,12
0.2,428,87,32424,75.58041958041959,14
0.2,429,27,32451,75.46744186046512,6
0.2,430,96,32547,75.51508120649652,6
0.2,431,89,32636,75.54629629629629,14
0.2,432,95,32731,75.59122401847576,8
0.2,433,95,32826,75.63594470046083,7
0.2,434,86,32912,75.65977011494253,15
0.2,435,96,33008,75.70642201834862,6
0.2,436,94,33102,75.74828375286042,7
0.2,437,92,33194,75.78538812785388,9
0.2,438,96,33290,75.83143507972665,6
0.2,439,93,33383,75.87045454545455,8
0.2,440,94,33477,75.91156462585035,7
0.2,441,94,33571,75.9524886877828,7
0.2,442,95,33666,75.99548532731377,7
0.2,443,95,33761,76.03828828828829,6
0.2,444,92,33853,76.07415730337078,10
0.2,445,92,33945,76.10986547085201,9
0.2,446,95,34040,76.15212527964206,6
0.2,447,93,34133,76.18973214285714,8
0.2,448,93,34226,76.2271714922049,8
0.2,449,89,34315,76.25555555555556,12
0.2,450,94,34409,76.29490022172949,7
0.2,451,90,34499,76.32522123893806,11
0.2,452,93,34592,76.36203090507726,8
0.2,453,89,34681,76.3898678414097,13
0.2,454,94,34775,76.42857142857143,7
0.2,455,19,34794,76.30263157894737,14
0.2,456,95,34889,76.34354485776805,8
0.2,457,23,34912,76.22707423580786,9
0.2,458,89,35001,76.25490196078431,12
0.2,459,89,35090,76.28260869565217,14
0.2,460,90,35180,76.31236442516268,11
0.2,461,91,35271,76.34415584415585,10
0.2,462,95,35366,76.38444924406048,7
0.2,463,94,35460,76.42241379310344,7
0.2,464,94,35554,76.46021505376343,7
0.2,465,91,35645,76.49141630901288,10
0.2,466,95,35740,76.53104925053533,6
0.2,467,93,35833,76.56623931623932,8
0.2,468,95,35928,76.60554371002132,8
0.2,469,91,36019,76.63617021276596,11
0.2,470,93,36112,76.67091295116772,9
0.2,471,96,36208,76.71186440677967,6
0.2,472,96,36304,76.75264270613108,6
0.2,473,92,36396,76.78481012658227,10
0.2,474,27,36423,76.68,6
0.2,475,92,36515,76.71218487394958,10
0.2,476,90,36605,76.74004192872117,13
0.2,477,90,36695,76.76778242677824,13
0.2,478,95,36790,76.80584551148226,7
0.2,479,93,36883,76.83958333333334,8
0.2,480,89,36972,76.86486486486487,12
0.2,481,94,37066,76.90041493775934,7
0.2,482,93,37159,76.93374741200829,8
0.2,483,91,37250,76.96280991735537,12
0.2,484,92,37342,76.9938144329897,11
0.2,485,92,37434,77.0246913580247,9
0.2,486,94,37528,77.05954825462013,7
0.2,487,10,37538,76.92213114754098,24
0.2,488,93,37631,76.95501022494888,9
0.2,489,16,37647,76.83061224489796,17
0.2,490,94,37741,76.86558044806517,7
0.2,491,93,37834,76.89837398373983,8
0.2,492,93,37927,76.93103448275862,8
0.2,493,92,38019,76.96153846153847,10
0.2,494,94,38113,76.99595959595959,8
0.2,495,95,38208,77.03225806451613,6
0.2,496,88,38296,77.05432595573441,14
0.2,497,93,38389,77.0863453815261,9
0.2,498,92,38481,77.11623246492987,9
0.2,499,93,38574,77.148,9
0.2,500,85,38659,77.16367265469061,17
0.2,501,88,38747,77.18525896414343,13
0.2,502,92,38839,77.21471172962227,9
0.2,503,94,38933,77.24801587301587,7
0.2,504,92,39025,77.27722772277228,10
0.2,505,24,39049,77.17193675889328,8
0.2,506,92,39141,77.20118343195266,9
0.2,507,94,39235,77.23425196850394,7
0.2,508,92,39327,77.26326129666012,10
0.2,509,90,39417,77.28823529411764,11
0.2,510,22,39439,77.18003913894324,13
0.2,511,88,39527,77.201171875,15
0.2,512,87,39614,77.22027290448344,14
0.2,513,92,39706,77.24902723735408,9
0.2,514,92,39798,77.27766990291262,9
0.2,515,95,39893,77.31201550387597,6
0.2,516,87,39980,77.33075435203095,15
0.2,517,25,40005,77.22972972972973,7
0.2,518,94,40099,77.26204238921002,7
0.2,519,92,40191,77.29038461538461,9
0.2,520,24,40215,77.18809980806142,8
0.2,521,96,40311,77.22413793103448,6
0.2,522,90,40401,77.24856596558317,11
0.2,523,91,40492,77.27480916030534,11
0.2,524,92,40584,77.30285714285715,9
0.2,525,95,40679,77.33650190114068,6
0.2,526,89,40768,77.35863377609108,12
0.2,527,91,40859,77.3844696969697,11
0.2,528,95,40954,77.41776937618147,6
0.2,529,91,41045,77.44339622641509,11
0.2,530,95,41140,77.47645951035781,6
0.2,531,94,41234,77.50751879699249,9
0.2,532,26,41260,77.4108818011257,6
0.2,533,91,41351,77.43632958801498,10
0.2,534,22,41373,77.33271028037383,11
0.2,535,90,41463,77.35634328358209,11
0.2,536,96,41559,77.39106145251397,7
0.2,537,27,41586,77.29739776951673,7
0.2,538,95,41681,77.33024118738405,6
0.2,539,95,41776,77.36296296296297,6
0.2,540,92,41868,77.39001848428836,9
0.2,541,96,41964,77.42435424354244,6
0.2,542,87,42051,77.44198895027624,14
0.2,543,94,42145,77.47242647058823,8
0.2,544,88,42233,77.49174311926606,14
0.2,545,86,42319,77.50732600732601,17
0.2,546,92,42411,77.53382084095064,9
0.2,547,89,42500,77.55474452554745,16
0.2,548,91,42591,77.5792349726776,10
0.2,549,87,42678,77.59636363636363,14
0.2,550,93,42771,77.62431941923775,8
0.2,551,96,42867,77.65760869565217,6
0.2,552,95,42962,77.68896925858951,6
0.2,553,93,43055,77.71660649819495,8
0.2,554,91,43146,77.74054054054054,10
0.2,555,94,43240,77.76978417266187,7
0.2,556,93,43333,77.79712746858169,8
0.2,557,94,43427,77.82616487455198,7
0.2,558,24,43451,77.72987477638641,8
0.2,559,92,43543,77.75535714285714,9
0.2,560,93,43636,77.7825311942959,8
0.2,561,91,43727,77.80604982206405,10
0.2,562,94,43821,77.8348134991119,11
0.2,563,96,43917,77.86702127659575,6
0.2,564,92,44009,77.89203539823009,9
0.2,565,94,44103,77.92049469964664,7
0.2,566,91,44194,77.94356261022928,10
0.2,567,26,44220,77.85211267605634,6
0.2,568,91,44311,77.87521968365553,10
0.2,569,94,44405,77.90350877192982,7
0.2,570,92,44497,77.92819614711033,10
0.2,571,95,44592,77.95804195804196,8
0.2,572,94,44686,77.98603839441536,8
0.2,573,94,44780,78.01393728222996,7
0.2,574,90,44870,78.03478260869565,11
0.2,575,94,44964,78.0625,8
0.2,576,25,44989,77.97053726169844,7
0.2,577,91,45080,77.99307958477509,10
0.2,578,92,45172,78.01727115716753,9
0.2,579,86,45258,78.03103448275863,15
0.2,580,90,45348,78.05163511187608,11
0.2,581,93,45441,78.07731958762886,8
0.2,582,94,45535,78.10463121783876,7
0.2,583,24,45559,78.01198630136986,8
0.2,584,25,45584,77.92136752136751,8
0.2,585,93,45677,77.94709897610922,8
0.2,586,25,45702,77.85689948892674,8
0.2,587,94,45796,77.8843537414966,7
0.2,588,93,45889,77.91001697792869,8
0.2,589,92,45981,77.93389830508474,9
0.2,590,88,46069,77.95093062605753,15
0.2,591,95,46164,77.97972972972973,7
0.2,592,91,46255,78.00168634064082,10
0.2,593,93,46348,78.02693602693603,8
0.2,594,93,46441,78.05210084033614,8
0.2,595,95,46536,78.08053691275168,6
0.2,596,17,46553,77.9782244556114,16
0.2,597,91,46644,78.0,11
0.2,598,94,46738,78.02671118530886,8
0.2,599,87,46825,78.04166666666667,14
0.2,600,93,46918,78.06655574043262,9
0.2,601,84,47002,78.07641196013289,17
0.2,602,93,47095,78.10116086235489,8
0.2,603,93,47188,78.12582781456953,9
0.2,604,96,47284,78.15537190082645,6
0.2,605,25,47309,78.06765676567657,7
0.2,606,94,47403,78.09390444810543,7
0.2,607,94,47497,78.12006578947368,7
0.2,608,91,47588,78.14121510673235,11
0.2,609,93,47681,78.1655737704918,8
0.2,610,86,47767,78.17839607201309,17
0.2,611,95,47862,78.20588235294117,6
0.2,612,90,47952,78.22512234910278,11
0.2,613,89,48041,78.24267100977198,12
0.2,614,87,48128,78.25691056910568,14
0.2,615,24,48152,78.16883116883118,10
0.2,616,93,48245,78.19286871961103,8
0.2,617,20,48265,78.09870550161813,12
0.2,618,95,48360,78.1260096930533,6
0.2,619,93,48453,78.15,8
0.2,620,96,48549,78.17874396135265,6
0.2,621,95,48644,78.20578778135048,6
0.2,622,24,48668,78.11878009630819,8
0.2,623,94,48762,78.14423076923077,7
0.2,624,96,48858,78.1728,6
0.2,625,22,48880,78.08306709265176,10
0.2,626,89,48969,78.10047846889952,13
0.2,627,93,49062,78.12420382165605,10
0.2,628,91,49153,78.14467408585055,10
0.2,629,95,49248,78.17142857142858,6
0.2,630,96,49344,78.19968304278922,6
0.2,631,92,49436,78.22151898734177,9
0.2,632,93,49529,78.24486571879937,8
0.2,633,20,49549,78.15299684542586,16
0.2,634,92,49641,78.1748031496063,9
0.2,635,92,49733,78.19654088050315,9
0.2,636,94,49827,78.22135007849293,7
0.2,637,23,49850,78.13479623824452,10
0.2,638,90,49940,78.15336463223787,11
0.2,639,91,50031,78.1734375,11
0.2,640,96,50127,78.201248049922,6
0.2,641,93,50220,78.22429906542057,8
0.2,642,92,50312,78.2457231726283,9
0.2,643,95,50407,78.27173913043478,6
0.2,644,87,50494,78.28527131782946,14
0.2,645,94,50588,78.30959752321981,8
0.2,646,-48,50540,78.11437403400309,12
0.2,647,93,50633,78.13734567901234,8
0.2,648,94,50727,78.16178736517719,7
0.2,649,94,50821,78.18615384615384,7
0.2,650,94,50915,78.21044546850999,8
0.2,651,91,51006,78.23006134969326,11
0.2,652,94,51100,78.25421133231241,7
0.2,653,96,51196,78.28134556574923,6
0.2,654,94,51290,78.30534351145039,7
0.2,655,88,51378,78.3201219512195,14
0.2,656,92,51470,78.34094368340944,10
0.2,657,92,51562,78.36170212765957,9
0.2,658,24,51586,78.27921092564492,10
0.2,659,93,51679,78.30151515151515,9
0.2,660,88,51767,78.31618759455371,14
0.2,661,19,51786,78.22658610271904,14
0.2,662,94,51880,78.25037707390649,7
0.2,663,93,51973,78.27259036144578,8
0.2,664,94,52067,78.29624060150375,7
0.2,665,91,52158,78.31531531531532,10
0.2,666,91,52249,78.3343328335832,12
0.2,667,94,52343,78.35778443113773,7
0.2,668,90,52433,78.37518684603886,12
0.2,669,96,52529,78.40149253731343,6
0.2,670,24,52553,78.3204172876304,10
0.2,671,91,52644,78.33928571428571,11
0.2,672,96,52740,78.36552748885588,6
0.2,673,94,52834,78.3887240356083,8
0.2,674,92,52926,78.4088888888889,9
0.2,675,92,53018,78.42899408284023,9
0.2,676,93,53111,78.45051698670606,8
0.2,677,94,53205,78.47345132743362,7
0.2,678,93,53298,78.49484536082474,8
0.2,679,86,53384,78.50588235294117,15
0.2,680,18,53402,78.41703377386197,14
0.2,681,94,53496,78.43988269794721,7
0.2,682,20,53516,78.35431918008784,12
0.2,683,92,53608,78.37426900584795,9
0.2,684,87,53695,78.38686131386861,14
0.2,685,90,53785,78.40379008746356,14
0.2,686,21,53806,78.32023289665212,11
0.2,687,94,53900,78.34302325581395,7
0.2,688,17,53917,78.25399129172715,15
0.2,689,94,54011,78.2768115942029,7
0.2,690,93,54104,78.29811866859623,8
0.2,691,94,54198,78.32080924855491,9
0.2,692,88,54286,78.33477633477634,14
0.2,693,93,54379,78.35590778097983,9
0.2,694,91,54470,78.37410071942446,10
0.2,695,94,54564,78.39655172413794,8
0.2,696,91,54655,78.41463414634147,10
0.2,697,-52,54603,78.22779369627507,15
0.2,698,93,54696,78.2489270386266,9
0.2,699,86,54782,78.26,15
0.2,700,89,54871,78.2753209700428,12
0.2,701,91,54962,78.29344729344729,12
0.2,702,92,55054,78.31294452347083,9
0.2,703,96,55150,78.33806818181819,6
0.2,704,95,55245,78.36170212765957,6
0.2,705,90,55335,78.37818696883852,11
0.2,706,86,55421,78.3889674681754,18
0.2,707,92,55513,78.40819209039547,9
0.2,708,91,55604,78.425952045134,10
0.2,709,90,55694,78.44225352112676,11
0.2,710,88,55782,78.45569620253164,13
0.2,711,94,55876,78.47752808988764,7
0.2,712,93,55969,78.49789621318374,8
0.2,713,93,56062,78.51820728291317,8
0.2,714,-54,56008,78.33286713286714,17
0.2,715,77,56085,78.33100558659218,25
0.2,716,89,56174,78.34588563458857,13
0.2,717,21,56195,78.26601671309193,12
0.2,718,95,56290,78.28929068150208,7
0.2,719,92,56382,78.30833333333334,9
0.2,720,93,56475,78.32871012482663,8
0.2,721,93,56568,78.34903047091413,9
0.2,722,94,56662,78.37067773167358,7
0.2,723,96,56758,78.39502762430939,6
0.2,724,19,56777,78.31310344827587,13
0.2,725,93,56870,78.33333333333333,9
0.2,726,92,56962,78.35213204951857,9
0.2,727,88,57050,78.36538461538461,14
0.2,728,93,57143,78.38545953360769,8
0.2,729,92,57235,78.4041095890411,13
0.2,730,94,57329,78.42544459644323,7
0.2,731,93,57422,78.44535519125684,9
0.2,732,94,57516,78.46657571623466,9
0.2,733,94,57610,78.48773841961852,7
0.2,734,24,57634,78.41360544217687,8
0.2,735,90,57724,78.42934782608695,12
0.2,736,94,57818,78.4504748982361,7
0.2,737,96,57914,78.47425474254743,6
0.2,738,89,58003,78.48849797023004,12
0.2,739,23,58026,78.41351351351351,11
0.2,740,93,58119,78.43319838056681,9
0.2,741,95,58214,78.455525606469,6
0.2,742,-46,58168,78.28802153432032,9
0.2,743,95,58263,78.31048387096774,7
0.2,744,91,58354,78.32751677852349,10
0.2,745,92,58446,78.34584450402144,10
0.2,746,96,58542,78.36947791164658,6
0.2,747,92,58634,78.38770053475936,10
0.2,748,92,58726,78.40587449933244,9
0.2,749,93,58819,78.42533333333333,8
0.2,750,90,58909,78.44074567243675,11
0.2,751,96,59005,78.46409574468085,6
0.2,752,26,59031,78.39442231075697,6
0.2,753,94,59125,78.41511936339522,7
0.2,754,-49,59076,78.24635761589404,14
0.2,755,-51,59025,78.07539682539682,14
0.2,756,95,59120,78.09775429326288,6
0.2,757,94,59214,78.11873350923483,7
0.2,758,93,59307,78.13833992094861,8
0.2,759,92,59399,78.15657894736842,9
0.2,760,95,59494,78.17871222076215,6
0.2,761,87,59581,78.19028871391076,14
0.2,762,93,59674,78.20969855832242,8
0.2,763,84,59758,78.217277486911,18
0.2,764,-50,59708,78.04967320261439,14
0.2,765,96,59804,78.07310704960835,6
0.2,766,94,59898,78.09387222946545,8
0.2,767,92,59990,78.11197916666667,11
0.2,768,94,60084,78.13263979193758,8
0.2,769,15,60099,78.05064935064935,17
0.2,770,95,60194,78.07263294422827,7
0.2,771,93,60287,78.09196891191709,9
0.2,772,92,60379,78.10996119016818,9
0.2,773,95,60474,78.13178294573643,6
0.2,774,93,60567,78.15096774193549,8
0.2,775,94,60661,78.17139175257732,7
0.2,776,92,60753,78.1891891891892,9
0.2,777,25,60778,78.12082262210797,7
0.2,778,92,60870,78.13863928112966,10
0.2,779,94,60964,78.15897435897436,8
0.2,780,95,61059,78.18053777208706,7
0.2,781,96,61155,78.20332480818415,7
0.2,782,94,61249,78.2234993614304,7
0.2,783,91,61340,78.23979591836735,10
0.2,784,21,61361,78.16687898089172,11
0.2,785,94,61455,78.18702290076335,7
0.2,786,94,61549,78.20711562897077,8
0.2,787,92,61641,78.2246192893401,9
0.2,788,96,61737,78.24714828897338,6
0.2,789,92,61829,78.26455696202531,9
0.2,790,90,61919,78.27939317319849,11
0.2,791,94,62013,78.29924242424242,8
0.2,792,92,62105,78.31651954602775,9
0.2,793,93,62198,78.33501259445843,9
0.2,794,95,62293,78.3559748427673,6
0.2,795,88,62381,78.36809045226131,13
0.2,796,95,62476,78.38895859473024,6
0.2,797,93,62569,78.40726817042606,8
0.2,798,92,62661,78.42428035043805,9
0.2,799,93,62754,78.4425,8
0.2,800,94,62848,78.46192259675406,7
0.2,801,90,62938,78.47630922693267,11
0.2,802,92,63030,78.4931506849315,10
0.2,803,94,63124,78.51243781094527,7
0.2,804,90,63214,78.52670807453416,11
0.2,805,93,63307,78.54466501240695,8
0.2,806,89,63396,78.55762081784387,12
0.2,807,95,63491,78.57797029702971,6
0.2,808,89,63580,78.59085290482076,12
0.2,809,92,63672,78.60740740740741,9
0.2,810,96,63768,78.6288532675709,6
0.2,811,94,63862,78.64778325123153,8
0.2,812,21,63883,78.57687576875769,11
0.2,813,94,63977,78.59582309582309,8
0.2,814,93,64070,78.61349693251533,9
0.2,815,91,64161,78.62867647058823,10
0.2,816,90,64251,78.64259485924113,12
0.2,817,94,64345,78.66136919315403,7
0.2,818,91,64436,78.67643467643468,10
0.2,819,92,64528,78.69268292682926,9
0.2,820,95,64623,78.71254567600488,6
0.2,821,90,64713,78.72627737226277,11
0.2,822,95,64808,78.7460510328068,8
0.2,823,96,64904,78.76699029126213,6
0.2,824,94,64998,78.78545454545454,7
0.2,825,91,65089,78.8002421307506,10
0.2,826,93,65182,78.8174123337364,8
0.2,827,95,65277,78.83695652173913,6
0.2,828,95,65372,78.85645355850423,6
0.2,829,22,65394,78.78795180722892,10
0.2,830,24,65418,78.72202166064982,8
0.2,831,95,65513,78.74158653846153,7
0.2,832,94,65607,78.75990396158464,7
0.2,833,25,65632,78.69544364508393,7
0.2,834,93,65725,78.7125748502994,8
0.2,835,85,65810,78.72009569377991,19
0.2,836,92,65902,78.73596176821984,9
0.2,837,94,65996,78.75417661097852,7
0.2,838,94,66090,78.77234803337306,8
0.2,839,93,66183,78.78928571428571,8
0.2,840,92,66275,78.80499405469679,9
0.2,841,90,66365,78.81828978622327,11
0.2,842,96,66461,78.83867141162514,6
0.2,843,95,66556,78.85781990521328,8
0.2,844,21,66577,78.78934911242604,11
0.2,845,87,66664,78.79905437352245,14
0.2,846,93,66757,78.81582054309327,8
0.2,847,89,66846,78.82783018867924,13
0.2,848,94,66940,78.84570082449942,7
0.2,849,89,67029,78.85764705882353,12
0.2,850,94,67123,78.87544065804936,7
0.2,851,94,67217,78.89319248826291,7
0.2,852,94,67311,78.91090269636577,7
0.2,853,81,67392,78.91334894613583,20
0.2,854,25,67417,78.85029239766082,7
0.2,855,91,67508,78.8644859813084,10
0.2,856,94,67602,78.88214702450408,7
0.2,857,89,67691,78.89393939393939,15
0.2,858,92,67783,78.90919674039581,9
0.2,859,88,67871,78.91976744186047,13
0.2,860,94,67965,78.93728222996516,7
0.2,861,96,68061,78.9570765661253,6
0.2,862,87,68148,78.96639629200463,14
0.2,863,78,68226,78.96527777777777,23
0.2,864,92,68318,78.98034682080925,10
0.2,865,92,68410,78.99538106235566,9
0.2,866,89,68499,79.00692041522491,13
0.2,867,93,68592,79.02304147465438,8
0.2,868,89,68681,79.03452243958573,12
0.2,869,95,68776,79.05287356321838,8
0.2,870,95,68871,79.07118254879448,6
0.2,871,94,68965,79.08830275229357,7
0.2,872,95,69060,79.106529209622,6
0.2,873,96,69156,79.1258581235698,6
0.2,874,92,69248,79.14057142857143,9
0.2,875,95,69343,79.15867579908675,6
0.2,876,96,69439,79.17787913340935,6
0.2,877,80,69519,79.17881548974943,21
0.2,878,95,69614,79.19681456200227,6
0.2,879,89,69703,79.20795454545454,12
0.2,880,87,69790,79.21679909194097,14
0.2,881,92,69882,79.2312925170068,9
0.2,882,96,69978,79.25028312570781,6
0.2,883,95,70073,79.26809954751131,6
0.2,884,96,70169,79.28700564971751,6
0.2,885,27,70196,79.22799097065463,6
0.2,886,93,70289,79.24351747463359,8
0.2,887,91,70380,79.25675675675676,10
0.2,888,85,70465,79.26321709786276,17
0.2,889,96,70561,79.28202247191011,6
0.2,890,96,70657,79.30078563411897,6
0.2,891,94,70751,79.31726457399103,7
0.2,892,91,70842,79.33034714445688,10
0.2,893,86,70928,79.33780760626398,16
0.2,894,91,71019,79.35083798882681,10
0.2,895,92,71111,79.36495535714286,10
0.2,896,89,71200,79.37569676700112,14
0.2,897,92,71292,79.38975501113586,9
0.2,898,89,71381,79.40044493882091,12
0.2,899,26,71407,79.3411111111111,6
0.2,900,96,71503,79.35960044395117,6
0.2,901,87,71590,79.36807095343681,14
0.2,902,93,71683,79.38316722037652,8
0.2,903,91,71774,79.39601769911505,10
0.2,904,96,71870,79.41436464088397,6
0.2,905,95,71965,79.43156732891832,6
0.2,906,92,72057,79.44542447629549,9
0.2,907,88,72145,79.45484581497797,14
0.2,908,89,72234,79.46534653465346,13
0.2,909,94,72328,79.48131868131868,8
0.2,910,87,72415,79.48957189901208,14
0.2,911,94,72509,79.50548245614036,8
0.2,912,26,72535,79.44687842278204,7
0.2,913,92,72627,79.46061269146608,9
0.2,914,89,72716,79.47103825136612,12
0.2,915,-48,72668,79.33187772925764,11
0.2,916,21,72689,79.26826608505998,11
0.2,917,95,72784,79.28540305010893,6
0.2,918,94,72878,79.30141458106638,8
0.2,919,94,72972,79.31739130434782,7
0.2,920,95,73067,79.33441910966341,6
0.2,921,94,73161,79.35032537960954,7
0.2,922,90,73251,79.36186348862405,11
0.2,923,95,73346,79.37878787878788,7
0.2,924,96,73442,79.39675675675676,6
0.2,925,87,73529,79.4049676025918,14
0.2,926,24,73553,79.34519956850053,9
0.2,927,94,73647,79.36099137931035,7
0.2,928,86,73733,79.36813778256189,15
0.2,929,93,73826,79.38279569892472,10
0.2,930,92,73918,79.39634801288936,10
0.2,931,95,74013,79.41309012875537,6
0.2,932,93,74106,79.42765273311898,8
0.2,933,93,74199,79.44218415417559,8
0.2,934,24,74223,79.38288770053477,9
0.2,935,96,74319,79.40064102564102,6
0.2,936,96,74415,79.41835645677695,6
0.2,937,93,74508,79.43283582089552,8
0.2,938,91,74599,79.44515441959531,11
0.2,939,16,74615,79.37765957446808,16
0.2,940,81,74696,79.37938363443146,20
0.2,941,84,74780,79.38428874734608,18
0.2,942,90,74870,79.39554612937434,11
0.2,943,90,74960,79.40677966101696,11
0.2,944,93,75053,79.42116402116402,9
0.2,945,90,75143,79.4323467230444,12
0.2,946,26,75169,79.37592397043295,6
0.2,947,95,75264,79.39240506329114,7
0.2,948,20,75284,79.32982086406744,12
0.2,949,94,75378,79.34526315789473,9
0.2,950,95,75473,79.36172450052577,6
0.2,951,92,75565,79.375,10
0.2,952,94,75659,79.3903462749213,7
0.2,953,92,75751,79.4035639412998,10
0.2,954,93,75844,79.41780104712042,9
0.2,955,91,75935,79.42991631799163,11
0.2,956,88,76023,79.43887147335423,13
0.2,957,95,76118,79.45511482254697,6
0.2,958,-47,76071,79.32325338894682,10
0.2,959,88,76159,79.33229166666666,13
0.2,960,23,76182,79.27367325702393,9
0.2,961,92,76274,79.28690228690229,10
0.2,962,92,76366,79.30010384215991,9
0.2,963,94,76460,79.31535269709543,7
0.2,964,95,76555,79.33160621761658,6
0.2,965,87,76642,79.33954451345755,17
0.2,966,94,76736,79.35470527404344,7
0.2,967,90,76826,79.36570247933884,12
0.2,968,91,76917,79.37770897832817,10
0.2,969,95,77012,79.39381443298969,8
0.2,970,91,77103,79.40576725025747,10
0.2,971,94,77197,79.42078189300412,8
0.2,972,92,77289,79.43371017471736,9
0.2,973,96,77385,79.45071868583162,6
0.2,974,24,77409,79.39384615384616,9
0.2,975,93,77502,79.4077868852459,9
0.2,976,22,77524,79.34902763561924,10
0.2,977,94,77618,79.3640081799591,7
0.2,978,94,77712,79.37895812053115,8
0.2,979,93,77805,79.39285714285714,8
0.2,980,95,77900,79.40876656472987,6
0.2,981,92,77992,79.42158859470469,9
0.2,982,95,78087,79.43743641912512,6
0.2,983,24,78111,79.3810975609756,8
0.2,984,20,78131,79.32081218274112,15
0.2,985,85,78216,79.32657200811359,16
0.2,986,16,78232,79.26241134751773,16
0.2,987,22,78254,79.20445344129554,10
0.2,988,90,78344,79.21536905965621,12
0.2,989,95,78439,79.23131313131313,7
0.2,990,8,78447,79.15943491422806,25
0.2,991,91,78538,79.17137096774194,10
0.2,992,95,78633,79.18731117824774,6
0.2,993,96,78729,79.20422535211267,6
0.2,994,94,78823,79.21909547738693,7
0.2,995,83,78906,79.22289156626506,18
0.2,996,93,78999,79.23671013039117,9
0.2,997,87,79086,79.24448897795591,14
0.2,998,91,79177,79.25625625625625,10
0.2,999,93,79270,79.27,9
0.2,1000,93,79363,79.28371628371629,10
0.2,1001,91,79454,79.29540918163673,10
0.2,1002,90,79544,79.30608175473579,13
0.2,1003,92,79636,79.3187250996016,9
0.2,1004,88,79724,79.3273631840796,13
0.2,1005,94,79818,79.34194831013916,9
0.2,1006,18,79836,79.28103277060576,15
0.2,1007,96,79932,79.29761904761905,6
0.2,1008,94,80026,79.31219028741329,7
0.2,1009,92,80118,79.32475247524752,9
0.2,1010,24,80142,79.2700296735905,8
0.2,1011,21,80163,79.21245059288538,11
0.2,1012,92,80255,79.22507403751234,9
0.2,1013,93,80348,79.23865877712032,8
0.2,1014,88,80436,79.24729064039408,13
0.2,1015,88,80524,79.25590551181102,13
0.2,1016,20,80544,79.1976401179941,13
0.2,1017,93,80637,79.21119842829077,9
0.2,1018,91,80728,79.22276741903828,11
0.2,1019,93,80821,79.23627450980392,8
0.2,1020,92,80913,79.24877571008815,11
0.2,1021,94,81007,79.26320939334639,7
0.2,1022,89,81096,79.27272727272727,12
0.2,1023,93,81189,79.2861328125,9
0.2,1024,88,81277,79.29463414634147,13
0.2,1025,96,81373,79.31091617933723,6
0.2,1026,91,81464,79.32229795520935,10
0.2,1027,87,81551,79.32976653696498,15
0.2,1028,89,81640,79.33916423712343,12
0.2,1029,90,81730,79.3495145631068,11
0.2,1030,92,81822,79.36178467507274,9
0.2,1031,95,81917,79.37693798449612,6
0.2,1032,92,82009,79.3891577928364,10
0.2,1033,92,82101,79.40135396518376,9
0.2,1034,95,82196,79.41642512077294,7
0.2,1035,91,82287,79.42760617760618,10
0.2,1036,95,82382,79.44262295081967,6
0.2,1037,93,82475,79.45568400770713,8
0.2,1038,92,82567,79.46775745909528,10
0.2,1039,95,82662,79.4826923076923,6
0.2,1040,93,82755,79.49567723342939,9
0.2,1041,91,82846,79.50671785028791,10
0.2,1042,94,82940,79.52061361457335,7
0.2,1043,93,83033,79.53352490421456,9
0.2,1044,95,83128,79.54832535885167,6
0.2,1045,96,83224,79.56405353728489,6
0.2,1046,95,83319,79.57879656160459,7
0.2,1047,96,83415,79.59446564885496,6
0.2,1048,93,83508,79.60724499523356,8
0.2,1049,90,83598,79.61714285714285,11
0.2,1050,94,83692,79.63082778306375,7
0.2,1051,95,83787,79.64543726235742,6
0.2,1052,96,83883,79.66096866096866,6
0.2,1053,93,83976,79.67362428842505,8
0.2,1054,95,84071,79.68815165876778,6
0.2,1055,95,84166,79.70265151515152,6
0.2,1056,82,84248,79.70482497634815,20
0.2,1057,15,84263,79.64366729678639,17
0.2,1058,24,84287,79.59112370160528,8
0.2,1059,96,84383,79.60660377358491,6
0.2,1060,18,84401,79.54853911404335,15
0.2,1061,88,84489,79.55649717514125,13
0.2,1062,94,84583,79.5700846660395,8
0.2,1063,96,84679,79.58552631578948,6
0.2,1064,92,84771,79.59718309859154,9
0.2,1065,94,84865,79.61069418386492,8
0.2,1066,94,84959,79.62417994376757,9
0.2,1067,93,85052,79.6367041198502,8
0.2,1068,93,85145,79.64920486435922,8
0.2,1069,93,85238,79.66168224299065,8
0.2,1070,96,85334,79.67693744164332,6
0.2,1071,88,85422,79.68470149253731,15
0.2,1072,92,85514,79.69617893755824,9
0.2,1073,92,85606,79.70763500931099,10
0.2,1074,91,85697,79.71813953488372,10
0.2,1075,92,85789,79.72955390334573,10
0.2,1076,94,85883,79.74280408542246,7
0.2,1077,94,85977,79.75602968460112,8
0.2,1078,18,85995,79.6987951807229,14
0.2,1079,96,86091,79.71388888888889,6
0.2,1080,94,86185,79.72710453283996,8
0.2,1081,90,86275,79.7365988909427,11
0.2,1082,93,86368,79.7488457987073,10
0.2,1083,96,86464,79.76383763837639,6
0.2,1084,92,86556,79.77511520737328,10
0.2,1085,96,86652,79.79005524861878,6
0.2,1086,23,86675,79.7378104875805,9
0.2,1087,96,86771,79.75275735294117,6
0.2,1088,91,86862,79.76308539944904,10
0.2,1089,93,86955,79.77522935779817,8
0.2,1090,94,87049,79.78826764436297,7
0.2,1091,23,87072,79.73626373626374,9
0.2,1092,86,87158,79.7419945105215,15
0.2,1093,94,87252,79.75502742230347,7
0.2,1094,24,87276,79.7041095890411,9
0.2,1095,24,87300,79.65328467153284,9
0.2,1096,26,87326,79.60437556973564,6
0.2,1097,96,87422,79.61930783242259,6
0.2,1098,26,87448,79.5705186533212,7
0.2,1099,91,87539,79.58090909090909,10
0.2,1100,89,87628,79.58946412352407,12
0.2,1101,94,87722,79.60254083484574,7
0.2,1102,89,87811,79.61106074342702,12
0.2,1103,96,87907,79.62590579710145,6
0.2,1104,96,88003,79.64072398190045,6
0.2,1105,92,88095,79.65189873417721,10
0.2,1106,90,88185,79.66124661246613,11
0.2,1107,91,88276,79.67148014440433,11
0.2,1108,90,88366,79.68079350766456,11
0.2,1109,90,88456,79.6900900900901,12
0.2,1110,26,88482,79.64176417641764,6
0.2,1111,94,88576,79.65467625899281,9
0.2,1112,91,88667,79.6648697214735,11
0.2,1113,-44,88623,79.55385996409336,8
0.2,1114,94,88717,79.56681614349776,8
0.2,1115,93,88810,79.57885304659499,9
0.2,1116,85,88895,79.58370635631155,16
0.2,1117,96,88991,79.59838998211092,6
0.2,1118,-49,88942,79.4834673815907,14
0.2,1119,-46,88896,79.37142857142857,9
0.2,1120,20,88916,79.31846565566458,13
0.2,1121,93,89009,79.33065953654189,8
0.2,1122,84,89093,79.33481745325022,23
0.2,1123,91,89184,79.34519572953737,11
0.2,1124,92,89276,79.35644444444445,9
0.2,1125,26,89302,79.30905861456483,6
0.2,1126,95,89397,79.32298136645963,6
0.2,1127,94,89491,79.33599290780141,8
0.2,1128,92,89583,79.34720992028343,10
0.2,1129,93,89676,79.35929203539823,8
0.2,1130,89,89765,79.36781609195403,13
0.2,1131,94,89859,79.38074204946996,8
0.2,1132,94,89953,79.3936451897617,7
0.2,1133,92,90045,79.4047619047619,10
0.2,1134,94,90139,79.41762114537445,8
0.2,1135,93,90232,79.42957746478874,8
0.2,1136,86,90318,79.4353562005277,17
0.2,1137,92,90410,79.4463971880492,9
0.2,1138,89,90499,79.45478489903424,12
0.2,1139,-46,90453,79.34473684210526,9
0.2,1140,94,90547,79.35758106923751,7
0.2,1141,92,90639,79.36865148861646,11
0.2,1142,90,90729,79.37795275590551,12
0.2,1143,96,90825,79.39248251748252,6
0.2,1144,92,90917,79.40349344978166,9
0.2,1145,25,90942,79.35602094240838,8
0.2,1146,94,91036,79.36878814298169,8
0.2,1147,94,91130,79.38153310104529,7
0.2,1148,93,91223,79.39338555265448,8
0.2,1149,93,91316,79.40521739130435,10
0.2,1150,93,91409,79.41702867072111,8
0.2,1151,96,91505,79.43142361111111,6
0.2,1152,23,91528,79.3824804856895,9
0.2,1153,21,91549,79.3318890814558,11
0.2,1154,96,91645,79.34632034632034,7
0.2,1155,91,91736,79.35640138408304,12
0.2,1156,96,91832,79.37078651685393,6
0.2,1157,26,91858,79.32469775474956,6
0.2,1158,90,91948,79.33390854184641,12
0.2,1159,92,92040,79.34482758620689,9
0.2,1160,81,92121,79.34625322997417,22
0.2,1161,95,92216,79.35972461273666,6
0.2,1162,96,92312,79.37403267411865,6
0.2,1163,22,92334,79.32474226804123,10
0.2,1164,96,92430,79.33905579399142,6
0.2,1165,83,92513,79.34219554030875,19
0.2,1166,94,92607,79.3547557840617,9
0.2,1167,23,92630,79.30650684931507,10
0.2,1168,95,92725,79.31993156544054,8
0.2,1169,85,92810,79.32478632478633,16
0.2,1170,94,92904,79.33731853116994,8
0.2,1171,93,92997,79.34897610921502,8
0.2,1172,95,93092,79.3623188405797,8
0.2,1173,95,93187,79.3756388415673,8
0.2,1174,95,93282,79.38893617021277,7
0.2,1175,84,93366,79.39285714285714,19
0.2,1176,84,93450,79.39677145284622,17
0.2,1177,92,93542,79.4074702886248,9
0.2,1178,88,93630,79.4147582697201,13
0.2,1179,96,93726,79.42881355932204,6
0.2,1180,94,93820,79.44115156646909,8
0.2,1181,93,93913,79.45262267343486,8
0.2,1182,92,94005,79.4632290786137,9
0.2,1183,-55,93950,79.34966216216216,19
0.2,1184,93,94043,79.36118143459916,8
0.2,1185,91,94134,79.37099494097808,10
0.2,1186,88,94222,79.37826453243471,13
0.2,1187,88,94310,79.38552188552188,13
0.2,1188,23,94333,79.3380992430614,9
0.2,1189,27,94360,79.29411764705883,6
0.2,1190,93,94453,79.3056255247691,8
0.2,1191,89,94542,79.31375838926175,12
0.2,1192,89,94631,79.32187761944677,12
0.2,1193,94,94725,79.33417085427136,7
0.2,1194,94,94819,79.34644351464435,7
0.2,1195,20,94839,79.29682274247492,12
0.2,1196,22,94861,79.24895572263993,10
0.2,1197,91,94952,79.25876460767947,10
0.2,1198,26,94978,79.21434528773979,6
0.2,1199,96,95074,79.22833333333334,7
0.2,1200,93,95167,79.2398001665279,8
0.2,1201,95,95262,79.25291181364393,6
0.2,1202,92,95354,79.26350789692435,11
0.2,1203,93,95447,79.27491694352159,8
0.2,1204,92,95539,79.28547717842324,9
0.2,1205,92,95631,79.29601990049751,9
0.2,1206,94,95725,79.30820215410108,7
0.2,1207,21,95746,79.25993377483444,12
0.2,1208,96,95842,79.2737799834574,6
0.2,1209,93,95935,79.28512396694215,8
0.2,1210,92,96027,79.29562345169282,11
0.2,1211,86,96113,79.30115511551155,15
0.2,1212,93,96206,79.31244847485573,8
0.2,1213,27,96233,79.26935749588138,6
0.2,1214,94,96327,79.28148148148148,7
0.2,1215,93,96420,79.29276315789474,8
0.2,1216,95,96515,79.30566967953985,7
0.2,1217,19,96534,79.25615763546799,14
0.2,1218,95,96629,79.26907301066448,7
0.2,1219,94,96723,79.28114754098361,8
0.2,1220,95,96818,79.29402129402129,6
0.2,1221,91,96909,79.30360065466448,10
0.2,1222,17,96926,79.25265739983647,16
0.2,1223,89,97015,79.26062091503267,12
0.2,1224,90,97105,79.26938775510204,11
0.2,1225,93,97198,79.2805872756933,9
0.2,1226,92,97290,79.29095354523227,9
0.2,1227,96,97386,79.30456026058631,6
0.2,1228,86,97472,79.3100081366965,15
0.2,1229,24,97496,79.2650406504065,8
0.2,1230,95,97591,79.27782290820471,6
0.2,1231,24,97615,79.23295454545455,9
0.2,1232,95,97710,79.24574209245742,6
0.2,1233,88,97798,79.25283630470017,13
0.2,1234,93,97891,79.26396761133603,8
0.2,1235,93,97984,79.27508090614887,8
0.2,1236,90,98074,79.28375101050929,11
0.2,1237,92,98166,79.2940226171244,9
0.2,1238,94,98260,79.30589184826474,7
0.2,1239,93,98353,79.31693548387096,8
0.2,1240,89,98442,79.32473811442385,12
0.2,1241,89,98531,79.33252818035427,12
0.2,1242,25,98556,79.28881737731295,8
0.2,1243,92,98648,79.29903536977491,10
0.2,1244,90,98738,79.30763052208836,11
0.2,1245,94,98832,79.31942215088283,7
0.2,1246,94,98926,79.33119486768244,9
0.2,1247,96,99022,79.34455128205128,6
0.2,1248,93,99115,79.35548438751,8
0.2,1249,91,99206,79.3648,10
0.2,1250,89,99295,79.37250199840128,12
0.2,1251,90,99385,79.38099041533546,11
0.2,1252,96,99481,79.39425379090184,6
0.2,1253,86,99567,79.39952153110048,16
0.2,1254,95,99662,79.41195219123506,6
0.2,1255,89,99751,79.41958598726114,12
0.2,1256,93,99844,79.43038981702466,8
0.2,1257,89,99933,79.43799682034977,12
0.2,1258,91,100024,79.44718030182685,10
0.2,1259,92,100116,79.45714285714286,9
0.2,1260,82,100198,79.45915939730372,19
0.2,1261,95,100293,79.47147385103011,6
0.2,1262,92,100385,79.48139350752177,9
0.2,1263,89,100474,79.48892405063292,12
0.2,1264,-50,100424,79.38656126482213,15
0.2,1265,94,100518,79.39810426540285,8
0.2,1266,94,100612,79.40962904498816,7
0.2,1267,92,100704,79.41955835962145,9
0.2,1268,16,100720,79.36958234830576,17
0.2,1269,95,100815,79.38188976377953,6
0.2,1270,93,100908,79.39260424862313,8
0.2,1271,92,101000,79.40251572327044,9
0.2,1272,96,101096,79.41555380989787,6
0.2,1273,92,101188,79.42543171114599,9
0.2,1274,94,101282,79.43686274509804,7
0.2,1275,94,101376,79.44827586206897,8
0.2,1276,89,101465,79.45575567736883,12
0.2,1277,91,101556,79.46478873239437,10
0.2,1278,94,101650,79.47615324472244,7
0.2,1279,25,101675,79.43359375,8
0.2,1280,91,101766,79.44262295081967,11
0.2,1281,92,101858,79.45241809672387,10
0.2,1282,81,101939,79.45362431800467,20
0.2,1283,95,102034,79.46573208722741,6
0.2,1284,92,102126,79.47548638132295,9
0.2,1285,84,102210,79.47900466562986,19
0.2,1286,95,102305,79.49106449106449,7
0.2,1287,91,102396,79.5,10
0.2,1288,87,102483,79.50581846392552,16
0.2,1289,91,102574,79.51472868217054,10
0.2,1290,89,102663,79.52207591014717,12
0.2,1291,95,102758,79.53405572755418,6
0.2,1292,90,102848,79.54215003866976,14
0.2,1293,90,102938,79.55023183925812,11
0.2,1294,93,103031,79.56061776061776,8
0.2,1295,89,103120,79.5679012345679,14
0.2,1296,86,103206,79.57286044718582,16
0.2,1297,96,103302,79.58551617873651,6
0.2,1298,94,103396,79.59661277906082,8
0.2,1299,92,103488,79.60615384615384,9
0.2,1300,92,103580,79.61568024596464,9
0.2,1301,95,103675,79.62749615975423,6
0.2,1302,92,103767,79.6369915579432,9
0.2,1303,91,103858,79.6457055214724,10
0.2,1304,81,103939,79.64674329501916,20
0.2,1305,92,104031,79.65620214395099,9
0.2,1306,96,104127,79.66870696250956,6
0.2,1307,92,104219,79.67813455657492,9
0.2,1308,92,104311,79.68754774637128,9
0.2,1309,92,104403,79.6969465648855,9
0.2,1310,93,104496,79.7070938215103,8
0.2,1311,94,104590,79.71798780487805,8
0.2,1312,91,104681,79.72658035034273,10
0.2,1313,85,104766,79.73059360730593,16
0.2,1314,96,104862,79.74296577946768,6
0.2,1315,89,104951,79.75,14
0.2,1316,-45,104906,79.65527714502657,10
0.2,1317,93,104999,79.66540212443095,8
0.2,1318,95,105094,79.6770280515542,8
0.2,1319,17,105111,79.62954545454545,15
0.2,1320,93,105204,79.63966691900076,8
0.2,1321,93,105297,79.64977307110439,8
0.2,1322,90,105387,79.6575963718821,12
0.2,1323,94,105481,79.66842900302115,7
0.2,1324,95,105576,79.68,6
0.2,1325,21,105597,79.63574660633485,12
0.2,1326,94,105691,79.646571213263,7
0.2,1327,93,105784,79.6566265060241,8
0.2,1328,91,105875,79.66516177577125,10
0.2,1329,91,105966,79.67368421052632,10
0.2,1330,96,106062,79.68595041322314,6
0.2,1331,93,106155,79.69594594594595,9
0.2,1332,90,106245,79.70367591897974,11
0.2,1333,94,106339,79.7143928035982,7
0.2,1334,85,106424,79.7183520599251,17
0.2,1335,92,106516,79.72754491017965,10
0.2,1336,88,106604,79.73373223635004,13
0.2,1337,92,106696,79.74289985052317,9
0.2,1338,94,106790,79.75354742345034,7
0.2,1339,91,106881,79.76194029850747,11
0.2,1340,94,106975,79.77255779269203,7
0.2,1341,95,107070,79.78390461997019,7
0.2,1342,90,107160,79.79151154132539,12
0.2,1343,90,107250,79.79910714285714,11
0.2,1344,95,107345,79.81040892193309,7
0.2,1345,96,107441,79.82243684992571,6
0.2,1346,25,107466,79.78173719376392,7
0.2,1347,90,107556,79.7893175074184,11
0.2,1348,94,107650,79.79985174203114,8
0.2,1349,96,107746,79.81185185185186,6
0.2,1350,96,107842,79.8238341968912,6
0.2,1351,24,107866,79.78254437869822,8
0.2,1352,-50,107816,79.68662232076866,14
0.2,1353,91,107907,79.69497784342688,10
0.2,1354,93,108000,79.70479704797047,8
0.2,1355,90,108090,79.71238938053098,12
0.2,1356,91,108181,79.72070744288872,10
0.2,1357,92,108273,79.72974963181149,9
0.2,1358,90,108363,79.7373068432671,11
0.2,1359,93,108456,79.74705882352941,9
0.2,1360,88,108544,79.75312270389419,15
0.2,1361,94,108638,79.76358296622614,7
0.2,1362,-125,108513,79.61335289801907,21
0.2,1363,90,108603,79.62096774193549,11
0.2,1364,93,108696,79.63076923076923,8
0.2,1365,92,108788,79.6398243045388,9
0.2,1366,94,108882,79.65032918800293,7
0.2,1367,94,108976,79.6608187134503,7
0.2,1368,22,108998,79.61869978086195,10
0.2,1369,90,109088,79.62627737226278,11
0.2,1370,94,109182,79.63676148796499,7
0.2,1371,21,109203,79.59402332361516,11
0.2,1372,90,109293,79.60160233066279,11
0.2,1373,90,109383,79.60917030567686,11
0.2,1374,93,109476,79.61890909090909,8
0.2,1375,85,109561,79.62281976744185,17
0.2,1376,96,109657,79.63471314451706,6
0.2,1377,91,109748,79.64296081277213,13
0.2,1378,91,109839,79.65119651921682,11
0.2,1379,93,109932,79.6608695652174,10
0.2,1380,95,110027,79.67197682838523,6
0.2,1381,88,110115,79.67800289435601,14
0.2,1382,94,110209,79.6883586406363,7
0.2,1383,25,110234,79.64884393063583,7
0.2,1384,94,110328,79.65920577617328,7
0.2,1385,88,110416,79.66522366522366,13
0.2,1386,90,110506,79.67267483777938,11
0.2,1387,90,110596,79.68011527377521,11
0.2,1388,93,110689,79.68970482361411,8
0.2,1389,93,110782,79.69928057553958,8
0.2,1390,94,110876,79.70956146657082,8
0.2,1391,88,110964,79.71551724137932,13
0.2,1392,94,111058,79.72577171572146,8
0.2,1393,94,111152,79.73601147776183,8
0.2,1394,94,111246,79.74623655913979,7
0.2,1395,95,111341,79.75716332378224,6
0.2,1396,93,111434,79.76664280601288,8
0.2,1397,89,111523,79.77324749642347,13
0.2,1398,90,111613,79.78055754110079,11
0.2,1399,96,111709,79.79214285714286,6
0.2,1400,91,111800,79.80014275517487,10
0.2,1401,96,111896,79.811697574893,6
0.2,1402,89,111985,79.81824661439772,13
0.2,1403,92,112077,79.82692307692308,9
0.2,1404,24,112101,79.78718861209964,8
0.2,1405,96,112197,79.79871977240398,6
0.2,1406,95,112292,79.80952380952381,8
0.2,1407,26,112318,79.77130681818181,7
0.2,1408,94,112412,79.78140525195174,8
0.2,1409,94,112506,79.79148936170213,7
0.2,1410,94,112600,79.80155917788802,8
0.2,1411,84,112684,79.80453257790369,17
0.2,1412,92,112776,79.8131634819533,9
0.2,1413,96,112872,79.82461103253182,6
0.2,1414,94,112966,79.83462897526502,8
0.2,1415,94,113060,79.84463276836158,7
0.2,1416,93,113153,79.85391672547635,8
0.2,1417,95,113248,79.86459802538786,6
0.2,1418,90,113338,79.87174066243834,11
0.2,1419,93,113431,79.88098591549296,9
0.2,1420,94,113525,79.89092188599578,7
0.2,1421,95,113620,79.90154711673699,6
0.2,1422,86,113706,79.90583274771609,15
0.2,1423,91,113797,79.91362359550561,12
0.2,1424,95,113892,79.92421052631579,7
0.2,1425,91,113983,79.93197755960729,10
0.2,1426,91,114074,79.93973370707779,11
0.2,1427,93,114167,79.94887955182072,8
0.2,1428,96,114263,79.96011196641008,6
0.2,1429,90,114353,79.96713286713286,11
0.2,1430,94,114447,79.97693920335429,7
0.2,1431,22,114469,79.93645251396649,10
0.2,1432,26,114495,79.89881367759943,6
0.2,1433,92,114587,79.90725244072524,9
0.2,1434,90,114677,79.91428571428571,12
0.2,1435,93,114770,79.92339832869081,8
0.2,1436,95,114865,79.9338900487126,8
0.2,1437,91,114956,79.94158553546592,10
0.2,1438,93,115049,79.95066018068103,8
0.2,1439,90,115139,79.9576388888889,11
0.2,1440,94,115233,79.96738376127689,7
0.2,1441,93,115326,79.97642163661581,9
0.2,1442,89,115415,79.98267498267498,12
0.2,1443,93,115508,79.99168975069252,9
0.2,1444,92,115600,80.0,10
0.2,1445,95,115695,80.0103734439834,7
0.2,1446,91,115786,80.01796821008985,10
0.2,1447,17,115803,79.97444751381215,15
0.2,1448,92,115895,79.98274672187716,9
0.2,1449,91,115986,79.99034482758621,10
0.2,1450,94,116080,80.0,7
0.2,1451,93,116173,80.00895316804407,8
0.2,1452,96,116269,80.01995870612525,6
0.2,1453,22,116291,79.98005502063273,10
0.2,1454,19,116310,79.9381443298969,13
0.2,1455,94,116404,79.9478021978022,7
0.2,1456,92,116496,79.95607412491421,9
0.2,1457,96,116592,79.96707818930041,6
0.2,1458,93,116685,79.97601096641536,8
0.2,1459,95,116780,79.98630136986301,6
0.2,1460,93,116873,79.99520876112251,8
0.2,1461,92,116965,80.00341997264022,9
0.2,1462,25,116990,79.96582365003418,7
0.2,1463,93,117083,79.97472677595628,8
0.2,1464,84,117167,79.97747440273038,17
0.2,1465,93,117260,79.98635743519782,8
0.2,1466,92,117352,79.9945466939332,9
0.2,1467,95,117447,80.00476839237058,6
0.2,1468,95,117542,80.01497617426821,6
0.2,1469,79,117621,80.01428571428572,22
0.2,1470,95,117716,80.02447314751869,6
0.2,1471,90,117806,80.03125,12
0.2,1472,23,117829,79.99253224711474,9
0.2,1473,94,117923,80.00203527815468,7
0.2,1474,92,118015,80.01016949152542,9
0.2,1475,24,118039,79.97222222222223,8
0.2,1476,94,118133,79.98171970209884,7
0.2,1477,96,118229,79.99255751014886,6
0.2,1478,94,118323,80.00202839756592,7
0.2,1479,92,118415,80.01013513513513,9
0.2,1480,27,118442,79.97434166103984,6
0.2,1481,93,118535,79.98313090418354,8
0.2,1482,94,118629,79.9925826028321,7
0.2,1483,96,118725,80.0033692722372,6
0.2,1484,95,118820,80.01346801346801,6
0.2,1485,91,118911,80.02086137281292,11
0.2,1486,27,118938,79.98520511096167,6
0.2,1487,96,119034,79.99596774193549,6
0.2,1488,92,119126,80.00402955003358,9
0.2,1489,94,119220,80.01342281879195,7
0.2,1490,-54,119166,79.9235412474849,18
0.2,1491,23,119189,79.88538873994638,11
0.2,1492,93,119282,79.89417280643,8
0.2,1493,90,119372,79.90093708165998,11
0.2,1494,92,119464,79.90903010033445,10
0.2,1495,94,119558,79.91844919786097,8
0.2,1496,27,119585,79.88309953239813,6
0.2,1497,23,119608,79.84512683578104,9
0.2,1498,92,119700,79.85323549032688,9
0.2,1499,26,119726,79.81733333333334,7
0.2,1500,27,119753,79.782145236509,6
0.2,1501,96,119849,79.79294274300932,6
0.2,1502,96,119945,79.80372588157019,6
0.2,1503,94,120039,79.81316489361703,7
0.2,1504,94,120133,79.82259136212625,7
0.2,1505,-52,120081,79.73505976095618,15
0.2,1506,94,120175,79.74452554744525,7
0.2,1507,94,120269,79.75397877984085,7
0.2,1508,93,120362,79.76275679257786,8
0.2,1509,90,120452,79.76953642384106,11
0.2,1510,89,120541,79.77564526803441,12
0.2,1511,92,120633,79.78373015873017,10
0.2,1512,27,120660,79.74884335756775,6
0.2,1513,12,120672,79.70409511228533,21
0.2,1514,-45,120627,79.62178217821783,8
0.2,1515,92,120719,79.62994722955145,9
0.2,1516,93,120812,79.63876071193144,8
0.2,1517,94,120906,79.64822134387352,7
0.2,1518,91,120997,79.65569453587887,12
0.2,1519,25,121022,79.61973684210527,7
0.2,1520,94,121116,79.62919132149901,7
0.2,1521,94,121210,79.63863337713535,7
0.2,1522,90,121300,79.64543663821405,11
0.2,1523,91,121391,79.6528871391076,11
0.2,1524,94,121485,79.66229508196722,8
0.2,1525,86,121571,79.66644823066841,15
0.2,1526,27,121598,79.63195808775376,6
0.2,1527,22,121620,79.59424083769633,10
0.2,1528,94,121714,79.60366252452583,7
0.2,1529,92,121806,79.61176470588235,9
0.2,1530,93,121899,79.62050947093402,8
0.2,1531,92,121991,79.62859007832898,10
0.2,1532,94,122085,79.63796477495107,7
0.2,1533,94,122179,79.64732724902217,7
0.2,1534,96,122275,79.65798045602605,6
0.2,1535,90,122365,79.66471354166667,11
0.2,1536,94,122459,79.6740403383214,8
0.2,1537,91,122550,79.68140442132639,10
0.2,1538,83,122633,79.68356075373619,18
0.2,1539,93,122726,79.6922077922078,9
0.2,1540,96,122822,79.70279039584685,6
0.2,1541,-47,122775,79.62062256809338,10
0.2,1542,93,122868,79.62929358392742,8
0.2,1543,95,122963,79.63924870466322,6
0.2,1544,18,122981,79.59935275080906,14
0.2,1545,25,123006,79.5640362225097,8
0.2,1546,25,123031,79.52876535229477,8
0.2,1547,24,123055,79.49289405684755,9
0.2,1548,-50,123005,79.40929632020658,14
0.2,1549,95,123100,79.41935483870968,6
0.2,1550,93,123193,79.428110896196,11
0.2,1551,95,123288,79.4381443298969,6
0.2,1552,92,123380,79.44623309723117,9
0.2,1553,17,123397,79.40604890604891,15
0.2,1554,93,123490,79.41479099678456,8
0.2,1555,96,123586,79.42544987146529,7
0.2,1556,94,123680,79.43481053307643,7
0.2,1557,89,123769,79.44094993581514,12
0.2,1558,94,123863,79.45028864656831,7
0.2,1559,93,123956,79.45897435897436,8
0.2,1560,89,124045,79.4650864830237,12
0.2,1561,95,124140,79.47503201024328,7
0.2,1562,95,124235,79.4849648112604,6
0.2,1563,96,124331,79.49552429667519,6
0.2,1564,86,124417,79.4996805111821,16
0.2,1565,25,124442,79.46487867177522,8
0.2,1566,95,124537,79.47479259731972,7
0.2,1567,89,124626,79.48086734693878,12
0.2,1568,86,124712,79.48502230720204,15
0.2,1569,95,124807,79.49490445859873,7
0.2,1570,88,124895,79.50031826861871,13
0.2,1571,95,124990,79.51017811704834,6
0.2,1572,96,125086,79.52066115702479,6
0.2,1573,94,125180,79.52986022871664,7
0.2,1574,22,125202,79.49333333333334,11
0.2,1575,92,125294,79.501269035533,10
0.2,1576,93,125387,79.50982878883957,8
0.2,1577,93,125480,79.51837769328263,8
0.2,1578,95,125575,79.5281823939202,6
0.2,1579,94,125669,79.5373417721519,8
0.2,1580,92,125761,79.54522454142948,9
0.2,1581,88,125849,79.55056890012642,13
0.2,1582,-56,125793,79.46493998736577,21
0.2,1583,87,125880,79.46969696969697,14
0.2,1584,22,125902,79.43343848580442,11
0.2,1585,91,125993,79.44073139974779,10
0.2,1586,91,126084,79.44801512287334,11
0.2,1587,93,126177,79.45654911838791,10
0.2,1588,90,126267,79.46318439269982,11
0.2,1589,94,126361,79.47232704402516,7
0.2,1590,93,126454,79.48082966687618,10
0.2,1591,89,126543,79.48680904522612,14
0.2,1592,90,126633,79.4934086629002,11
0.2,1593,92,126725,79.50125470514429,10
0.2,1594,25,126750,79.46708463949844,8
0.2,1595,94,126844,79.47619047619048,7
0.2,1596,88,126932,79.4815278647464,13
0.2,1597,94,127026,79.49061326658322,9
0.2,1598,96,127122,79.50093808630395,6
0.2,1599,94,127216,79.51,7
0.2,1600,93,127309,79.51842598376015,10
0.2,1601,26,127335,79.48501872659176,6
0.2,1602,90,127425,79.49157829070492,12
0.2,1603,88,127513,79.49688279301746,13
0.2,1604,90,127603,79.50342679127726,11
0.2,1605,94,127697,79.51245330012453,7
0.2,1606,91,127788,79.5196017423771,10
0.2,1607,95,127883,79.5292288557214,6
0.2,1608,95,127978,79.53884400248602,7
0.2,1609,91,128069,79.54596273291925,10
0.2,1610,94,128163,79.55493482309124,7
0.2,1611,94,128257,79.56389578163771,7
0.2,1612,92,128349,79.57160570365778,9
0.2,1613,26,128375,79.53841387856258,7
0.2,1614,92,128467,79.54613003095976,9
0.2,1615,93,128560,79.55445544554455,8
0.2,1616,96,128656,79.56462585034014,6
0.2,1617,93,128749,79.57292954264524,8
0.2,1618,95,128844,79.58245830759728,6
0.2,1619,86,128930,79.58641975308642,15
0.2,1620,92,129022,79.59407772979642,10
0.2,1621,95,129117,79.6035758323058,7
0.2,1622,92,129209,79.61121380160198,11
0.2,1623,92,129301,79.61884236453201,9
0.2,1624,94,129395,79.62769230769231,7
0.2,1625,91,129486,79.63468634686348,13
0.2,1626,94,129580,79.64351567301783,7
0.2,1627,19,129599,79.60626535626535,13
0.2,1628,95,129694,79.6157151626765,6
0.2,1629,95,129789,79.62515337423312,6
0.2,1630,94,129883,79.63396689147763,7
0.2,1631,95,129978,79.64338235294117,7
0.2,1632,92,130070,79.65094917330067,9
0.2,1633,96,130166,79.6609547123623,6
0.2,1634,94,130260,79.6697247706422,8
0.2,1635,96,130356,79.67970660146699,6
0.2,1636,94,130450,79.68845448992059,8
0.2,1637,96,130546,79.6984126984127,6
0.2,1638,88,130634,79.70347773032337,14
0.2,1639,89,130723,79.70914634146341,12
0.2,1640,18,130741,79.67154174283974,14
0.2,1641,92,130833,79.67904993909866,9
0.2,1642,-46,130787,79.60255629945222,10
0.2,1643,94,130881,79.61131386861314,7
0.2,1644,94,130975,79.62006079027356,7
0.2,1645,95,131070,79.62940461725395,7
0.2,1646,93,131163,79.63752276867031,8
0.2,1647,26,131189,79.60497572815534,6
0.2,1648,94,131283,79.6137052759248,8
0.2,1649,95,131378,79.6230303030303,7
0.2,1650,92,131470,79.6305269533616,10
0.2,1651,96,131566,79.64043583535108,6
0.2,1652,93,131659,79.64851784633998,8
0.2,1653,95,131754,79.6577992744861,6
0.2,1654,94,131848,79.66646525679758,7
0.2,1655,90,131938,79.67270531400966,11
0.2,1656,20,131958,79.6366928183464,14
0.2,1657,94,132052,79.64535585042219,8
0.2,1658,92,132144,79.65280289330923,9
0.2,1659,95,132239,79.66204819277108,6
0.2,1660,92,132331,79.6694762191451,9
0.2,1661,94,132425,79.67809867629362,7
0.2,1662,93,132518,79.6861094407697,9
0.2,1663,90,132608,79.6923076923077,12
0.2,1664,95,132703,79.7015015015015,6
0.2,1665,23,132726,79.66746698679472,10
0.2,1666,26,132752,79.63527294541092,6
0.2,1667,92,132844,79.64268585131894,13
0.2,1668,91,132935,79.6494907130018,11
0.2,1669,89,133024,79.65508982035928,14
0.2,1670,92,133116,79.6624775583483,9
0.2,1671,92,133208,79.66985645933015,11
0.2,1672,22,133230,79.63538553496713,13
0.2,1673,94,133324,79.64396654719235,7
0.2,1674,94,133418,79.65253731343283,10
0.2,1675,95,133513,79.66169451073986,6
0.2,1676,94,133607,79.67024448419797,7
0.2,1677,86,133693,79.67401668653159,16
0.2,1678,25,133718,79.64145324597975,7
0.2,1679,24,133742,79.60833333333333,8
0.2,1680,94,133836,79.61689470553242,8
0.2,1681,22,133858,79.58263971462544,12
0.2,1682,80,133938,79.58288770053476,22
0.2,1683,93,134031,79.59085510688836,8
0.2,1684,94,134125,79.59940652818992,7
0.2,1685,95,134220,79.60854092526691,6
0.2,1686,96,134316,79.61825726141079,6
0.2,1687,91,134407,79.625,10
0.2,1688,92,134499,79.63232682060391,9
0.2,1689,96,134595,79.64201183431953,6
0.2,1690,25,134620,79.60969840331165,7
0.2,1691,27,134647,79.57860520094563,6
0.2,1692,27,134674,79.54754873006497,7
0.2,1693,90,134764,79.55371900826447,13
0.2,1694,90,134854,79.55988200589971,14
0.2,1695,94,134948,79.56839622641509,7
0.2,1696,94,135042,79.57690041249263,7
0.2,1697,90,135132,79.58303886925795,11
0.2,1698,90,135222,79.58917010005885,12
0.2,1699,91,135313,79.59588235294117,11
0.2,1700,92,135405,79.60317460317461,9
0.2,1701,93,135498,79.61104582843713,8
0.2,1702,92,135590,79.61832061068702,9
0.2,1703,95,135685,79.62734741784037,7
0.2,1704,-118,135567,79.51143695014663,12
0.2,1705,96,135663,79.521101992966,6
0.2,1706,92,135755,79.52841241944932,9
0.2,1707,93,135848,79.53629976580797,9
0.2,1708,90,135938,79.54242246928028,14
0.2,1709,93,136031,79.55029239766081,9
0.2,1710,88,136119,79.5552308591467,13
0.2,1711,95,136214,79.5642523364486,6
0.2,1712,93,136307,79.57209573847052,8
0.2,1713,90,136397,79.5781796966161,11
0.2,1714,96,136493,79.58775510204082,6
0.2,1715,92,136585,79.59498834498835,9
0.2,1716,91,136676,79.60163075131042,10
0.2,1717,92,136768,79.60884749708964,9
0.2,1718,96,136864,79.61838278068645,7
0.2,1719,87,136951,79.62267441860465,14
0.2,1720,95,137046,79.63160952934341,6
0.2,1721,94,137140,79.63995354239256,7
0.2,1722,94,137234,79.64828786999419,7
0.2,1723,91,137325,79.65487238979118,11
0.2,1724,88,137413,79.65971014492753,13
0.2,1725,90,137503,79.66570104287369,11
0.2,1726,93,137596,79.673422119282,10
0.2,1727,92,137688,79.68055555555556,9
0.2,1728,88,137776,79.68536726431464,13
0.2,1729,92,137868,79.69248554913295,9
0.2,1730,94,137962,79.70075101097632,7
0.2,1731,95,138057,79.709584295612,6
0.2,1732,93,138150,79.71725331794576,11
0.2,1733,90,138240,79.72318339100346,11
0.2,1734,94,138334,79.7314121037464,7
0.2,1735,93,138427,79.73905529953917,8
0.2,1736,91,138518,79.74553828439839,10
0.2,1737,24,138542,79.71346375143844,9
0.2,1738,94,138636,79.72167912593444,8
0.2,1739,85,138721,79.72471264367816,16
0.2,1740,92,138813,79.73176335439403,9
0.2,1741,95,138908,79.74052812858783,6
0.2,1742,92,139000,79.74756167527252,9
0.2,1743,93,139093,79.75516055045871,9
0.2,1744,92,139185,79.7621776504298,9
0.2,1745,93,139278,79.76975945017182,8
0.2,1746,91,139369,79.7761877504293,13
0.2,1747,93,139462,79.7837528604119,8
0.2,1748,92,139554,79.79073756432247,9
0.2,1749,94,139648,79.79885714285714,7
0.2,1750,86,139734,79.80239862935466,19
0.2,1751,90,139824,79.8082191780822,11
0.2,1752,93,139917,79.81574443810611,11
0.2,1753,91,140008,79.82212086659065,11
0.2,1754,92,140100,79.82905982905983,9
0.2,1755,93,140193,79.83656036446469,8
0.2,1756,90,140283,79.84234490608992,13
0.2,1757,-47,140236,79.77019340159272,10
0.2,1758,96,140332,79.77942012507107,6
0.2,1759,96,140428,79.78863636363636,6
0.2,1760,92,140520,79.79557069846678,9
0.2,1761,92,140612,79.80249716231555,10
0.2,1762,92,140704,79.80941576857629,9
0.2,1763,94,140798,79.81746031746032,7
0.2,1764,86,140884,79.82096317280454,15
0.2,1765,25,140909,79.78992072480182,8
0.2,1766,86,140995,79.79343520090549,15
0.2,1767,26,141021,79.76300904977376,6
0.2,1768,20,141041,79.72922555115885,12
0.2,1769,90,141131,79.73502824858757,11
0.2,1770,88,141219,79.73969508752117,13
0.2,1771,80,141299,79.73984198645599,21
0.2,1772,93,141392,79.7473209249859,8
0.2,1773,95,141487,79.75591882750845,6
0.2,1774,92,141579,79.76281690140846,9
0.2,1775,94,141673,79.77083333333333,7
0.2,1776,89,141762,79.77602701181767,13
0.2,1777,94,141856,79.78402699662543,7
0.2,1778,23,141879,79.75210792580101,12
0.2,1779,94,141973,79.76011235955056,7
0.2,1780,95,142068,79.76866928691746,6
0.2,1781,96,142164,79.77777777777777,6
0.2,1782,26,142190,79.74761637689288,7
0.2,1783,25,142215,79.71692825112108,7
0.2,1784,94,142309,79.7249299719888,7
0.2,1785,95,142404,79.73348264277716,8
0.2,1786,95,142499,79.74202574146615,7
0.2,1787,86,142585,79.74552572706935,16
0.2,1788,94,142679,79.75349357182783,8
0.2,1789,83,142762,79.75530726256983,18
0.2,1790,94,142856,79.76326074818537,7
0.2,1791,93,142949,79.77064732142857,8
0.2,1792,94,143043,79.77858337981037,7
0.2,1793,91,143134,79.78483835005574,10
0.2,1794,94,143228,79.79275766016713,7
0.2,1795,91,143319,79.79899777282851,10
0.2,1796,92,143411,79.80578742348358,9
0.2,1797,92,143503,79.81256952169076,9
0.2,1798,-46,143457,79.7426347971095,9
0.2,1799,95,143552,79.75111111111111,7
0.2,1800,25,143577,79.72071071626874,7
0.2,1801,20,143597,79.68756936736959,12
0.2,1802,94,143691,79.6955074875208,7
0.2,1803,92,143783,79.70232815964523,11
0.2,1804,94,143877,79.71024930747923,7
0.2,1805,88,143965,79.71483942414174,15
0.2,1806,95,144060,79.72329828444937,7
0.2,1807,94,144154,79.73119469026548,8
0.2,1808,25,144179,79.70093974571587,7
0.2,1809,93,144272,79.70828729281767,8
0.2,1810,26,144298,79.67863059083379,6
0.2,1811,96,144394,79.68763796909492,6
0.2,1812,94,144488,79.69553226696084,7
0.2,1813,95,144583,79.70396912899669,6
0.2,1814,96,144679,79.7129476584022,6
0.2,1815,91,144770,79.71916299559471,10
0.2,1816,16,144786,79.68409466153,18
0.2,1817,85,144871,79.68701870187019,16
0.2,1818,89,144960,79.69213853765805,13
0.2,1819,26,144986,79.66263736263737,6
0.2,1820,25,145011,79.63261943986821,8
0.2,1821,92,145103,79.63940724478594,9
0.2,1822,96,145199,79.6483817882611,7
0.2,1823,93,145292,79.65570175438596,8
0.2,1824,86,145378,79.65917808219179,16
0.2,1825,23,145401,79.62814895947426,10
0.2,1826,92,145493,79.63492063492063,10
0.2,1827,96,145589,79.64387308533917,6
0.2,1828,89,145678,79.64898851831602,12
0.2,1829,86,145764,79.65245901639344,17
0.2,1830,95,145859,79.6608410704533,7
0.2,1831,94,145953,79.66866812227074,8
0.2,1832,92,146045,79.67539552645935,9
0.2,1833,94,146139,79.68320610687023,7
0.2,1834,92,146231,79.6899182561308,11
0.2,1835,93,146324,79.69716775599129,8
0.2,1836,94,146418,79.70495372890582,7
0.2,1837,93,146511,79.71218715995647,8
0.2,1838,21,146532,79.68026101141925,12
0.2,1839,96,146628,79.68913043478261,6
0.2,1840,95,146723,79.69744703965236,6
0.2,1841,92,146815,79.70412595005429,9
0.2,1842,85,146900,79.7069994574064,17
0.2,1843,19,146919,79.6740780911063,14
0.2,1844,94,147013,79.68184281842818,7
0.2,1845,91,147104,79.68797399783315,12
0.2,1846,21,147125,79.65619924201408,13
0.2,1847,94,147219,79.66396103896103,7
0.2,1848,24,147243,79.63385613845321,9
0.2,1849,92,147335,79.64054054054054,10
0.2,1850,89,147424,79.64559697460832,12
0.2,1851,95,147519,79.65388768898488,6
0.2,1852,93,147612,79.66109012412305,10
0.2,1853,93,147705,79.66828478964402,8
0.2,1854,96,147801,79.67708894878706,6
0.2,1855,91,147892,79.68318965517241,11
0.2,1856,95,147987,79.69143780290791,8
0.2,1857,92,148079,79.69806243272336,9
0.2,1858,94,148173,79.70575578267886,7
0.2,1859,95,148268,79.71397849462366,6
0.2,1860,96,148364,79.72272971520688,6
0.2,1861,86,148450,79.72610096670248,16
0.2,1862,93,148543,79.73322597960279,9
0.2,1863,93,148636,79.74034334763948,8
0.2,1864,93,148729,79.74745308310992,8
0.2,1865,18,148747,79.71436227224008,19
0.2,1866,92,148839,79.72094268880556,9
0.2,1867,92,148931,79.72751605995717,11
0.2,1868,92,149023,79.73408239700375,9
0.2,1869,88,149111,79.73850267379679,13
0.2,1870,25,149136,79.70924639230358,8
0.2,1871,94,149230,79.71688034188034,7
0.2,1872,88,149318,79.72130272290443,13
0.2,1873,91,149409,79.72732123799359,10
0.2,1874,88,149497,79.73173333333334,13
0.2,1875,94,149591,79.73933901918977,8
0.2,1876,86,149677,79.74267448055407,15
0.2,1877,27,149704,79.71458998935037,6
0.2,1878,88,149792,79.71899946780202,13
0.2,1879,94,149886,79.72659574468085,7
0.2,1880,96,149982,79.73524720893143,6
0.2,1881,93,150075,79.7422954303932,8
0.2,1882,90,150165,79.74774296335634,11
0.2,1883,94,150259,79.75530785562633,8
0.2,1884,92,150351,79.76180371352785,11
0.2,1885,96,150447,79.77041357370095,6
0.2,1886,90,150537,79.7758346581876,11
0.2,1887,94,150631,79.78336864406779,7
0.2,1888,16,150647,79.7496029645315,16
0.2,1889,92,150739,79.75608465608465,10
0.2,1890,89,150828,79.76097303014278,12
0.2,1891,93,150921,79.76797040169133,9
0.2,1892,92,151013,79.7744321183307,9
0.2,1893,95,151108,79.78247096092925,6
0.2,1894,96,151204,79.7910290237467,6
0.2,1895,95,151299,79.79905063291139,7
0.2,1896,90,151389,79.80442804428044,15
0.2,1897,93,151482,79.8113804004215,8
0.2,1898,20,151502,79.7798841495524,13
0.2,1899,25,151527,79.75105263157894,8
0.2,1900,89,151616,79.7559179379274,14
0.2,1901,93,151709,79.76288117770767,8
0.2,1902,92,151801,79.76931161324225,9
0.2,1903,93,151894,79.77626050420169,8
0.2,1904,91,151985,79.78215223097114,11
0.2,1905,88,152073,79.78646379853096,14
0.2,1906,84,152157,79.78867330886209,17
0.2,1907,95,152252,79.79664570230608,8
0.2,1908,94,152346,79.8040859088528,7
0.2,1909,-117,152229,79.70104712041885,12
0.2,1910,93,152322,79.70800627943485,10
0.2,1911,-119,152203,79.60407949790795,14
0.2,1912,92,152295,79.61055933089388,9
0.2,1913,95,152390,79.61859979101358,6
0.2,1914,91,152481,79.62454308093994,11
0.2,1915,94,152575,79.63204592901879,7
0.2,1916,93,152668,79.63901930099114,8
0.2,1917,27,152695,79.61157455683004,6
0.2,1918,94,152789,79.61907243355914,7
0.2,1919,93,152882,79.62604166666667,8
0.2,1920,94,152976,79.63352420614264,7
0.2,1921,95,153071,79.64151925078043,6
0.2,1922,19,153090,79.60998439937597,13
0.2,1923,22,153112,79.58004158004158,11
0.2,1924,95,153207,79.58805194805194,6
0.2,1925,26,153233,79.56022845275182,6
0.2,1926,87,153320,79.56408925791385,16
0.2,1927,93,153413,79.5710580912863,9
0.2,1928,94,153507,79.57853810264386,8
0.2,1929,93,153600,79.58549222797927,8
0.2,1930,93,153693,79.59243915069912,9
0.2,1931,90,153783,79.59782608695652,11
0.2,1932,95,153878,79.60579410243146,6
0.2,1933,91,153969,79.61168562564633,10
0.2,1934,17,153986,79.57932816537468,19
0.2,1935,92,154078,79.5857438016529,10
0.2,1936,94,154172,79.59318533815178,7
0.2,1937,93,154265,79.60010319917441,12
0.2,1938,23,154288,79.57091284167096,11
0.2,1939,92,154380,79.57731958762886,9
0.2,1940,94,154474,79.58475012879958,7
0.2,1941,93,154567,79.59165808444902,9
0.2,1942,92,154659,79.59804426145136,10
0.2,1943,92,154751,79.60442386831275,9
0.2,1944,96,154847,79.61285347043702,7
0.2,1945,93,154940,79.61973278520041,8
0.2,1946,93,155033,79.62660503338469,8
0.2,1947,92,155125,79.63295687885011,11
0.2,1948,92,155217,79.63930220625961,10
0.2,1949,90,155307,79.64461538461538,11
0.2,1950,92,155399,79.65094823167607,9
0.2,1951,94,155493,79.65829918032787,9
0.2,1952,92,155585,79.66461853558627,9
0.2,1953,90,155675,79.6699078812692,11
0.2,1954,25,155700,79.64194373401534,8
0.2,1955,90,155790,79.64723926380368,12
0.2,1956,92,155882,79.65355135411343,9
0.2,1957,96,155978,79.66189989785495,6
0.2,1958,90,156068,79.66717713118938,11
0.2,1959,91,156159,79.67295918367347,10
0.2,1960,96,156255,79.68128505864355,6
0.2,1961,96,156351,79.68960244648318,7
0.2,1962,95,156446,79.69740193581254,7
0.2,1963,89,156535,79.7021384928717,12
0.2,1964,94,156629,79.70941475826972,8
0.2,1965,92,156721,79.71566632756867,9
0.2,1966,17,156738,79.68378240976105,15
0.2,1967,90,156828,79.6890243902439,13
0.2,1968,20,156848,79.65871000507872,12
0.2,1969,95,156943,79.66649746192894,8
0.2,1970,92,157035,79.67275494672755,10
0.2,1971,95,157130,79.68052738336714,7
0.2,1972,95,157225,79.68829194120629,6
0.2,1973,88,157313,79.69250253292806,13
0.2,1974,88,157401,79.6967088607595,14
0.2,1975,86,157487,79.6998987854251,16
0.2,1976,92,157579,79.70612038442084,10
0.2,1977,90,157669,79.711324570273,12
0.2,1978,92,157761,79.71753410813542,9
0.2,1979,89,157850,79.72222222222223,12
0.2,1980,25,157875,79.69459868753155,7
0.2,1981,94,157969,79.70181634712412,9
0.2,1982,23,157992,79.6732223903177,9
0.2,1983,88,158080,79.6774193548387,13
0.2,1984,89,158169,79.68211586901764,12
0.2,1985,90,158259,79.68731117824774,11
0.2,1986,94,158353,79.694514343231,7
0.2,1987,92,158445,79.70070422535211,9
0.2,1988,23,158468,79.67219708396179,10
0.2,1989,91,158559,79.67788944723618,11
0.2,1990,26,158585,79.65092918131592,6
0.2,1991,96,158681,79.65913654618474,6
0.2,1992,90,158771,79.66432513798294,11
0.2,1993,90,158861,79.66950852557673,11
0.2,1994,92,158953,79.67568922305765,9
0.2,1995,24,158977,79.64779559118236,9
0.2,1996,92,159069,79.65398097145719,9
0.2,1997,95,159164,79.66166166166167,6
0.2,1998,92,159256,79.66783391695849,10
0.2,1999,90,159346,79.673,11
0.2,2000,89,159435,79.67766116941529,12
0.2,2001,88,159523,79.68181818181819,13
0.2,2002,91,159614,79.6874687968048,10
0.2,2003,90,159704,79.69261477045909,11
0.2,2004,92,159796,79.69875311720698,9
0.2,2005,96,159892,79.70687936191426,6
0.2,2006,91,159983,79.71250622820129,11
0.2,2007,96,160079,79.72061752988049,6
0.2,2008,95,160174,79.72822299651568,8
0.2,2009,95,160269,79.7358208955224,7
0.2,2010,26,160295,79.7090999502735,6
0.2,2011,92,160387,79.71520874751491,9
0.2,2012,94,160481,79.72230501738699,8
0.2,2013,91,160572,79.7279046673287,10
0.2,2014,96,160668,79.73598014888337,6
0.2,2015,95,160763,79.74355158730158,6
0.2,2016,91,160854,79.74913237481408,10
0.2,2017,92,160946,79.75520317145688,9
0.2,2018,94,161040,79.76225854383358,7
0.2,2019,85,161125,79.76485148514851,16
0.2,2020,96,161221,79.77288471053933,6
0.2,2021,95,161316,79.78041543026706,6
0.2,2022,20,161336,79.75086505190312,13
0.2,2023,84,161420,79.75296442687747,18
0.2,2024,94,161514,79.76,7
0.2,2025,90,161604,79.76505429417571,12
0.2,2026,95,161699,79.77257030093735,6
0.2,2027,92,161791,79.77859960552269,9
0.2,2028,27,161818,79.75258748151799,6
0.2,2029,95,161913,79.76009852216748,6
0.2,2030,26,161939,79.73362875430823,6
0.2,2031,90,162029,79.73868110236221,13
0.2,2032,83,162112,79.74028529267093,18
0.2,2033,96,162208,79.74827925270404,6
0.2,2034,93,162301,79.75479115479115,9
0.2,2035,93,162394,79.76129666011788,9
0.2,2036,94,162488,79.76828669612175,8
0.2,2037,94,162582,79.77526987242395,7
0.2,2038,93,162675,79.78175576262873,8
0.2,2039,91,162766,79.78725490196078,12
0.2,2040,94,162860,79.79421852033317,7
0.2,2041,88,162948,79.79823702252693,13
0.2,2042,25,162973,79.77141458639257,7
0.2,2043,88,163061,79.77544031311155,13
0.2,2044,92,163153,79.78141809290953,11
0.2,2045,19,163172,79.75171065493646,13
0.2,2046,85,163257,79.7542745481192,18
0.2,2047,95,163352,79.76171875,8
0.2,2048,89,163441,79.76622742801366,15
0.2,2049,90,163531,79.77121951219512,11
0.2,2050,95,163626,79.7786445636275,7
0.2,2051,94,163720,79.78557504873294,7
0.2,2052,93,163813,79.79201169020945,9
0.2,2053,88,163901,79.79600778967868,14
0.2,2054,-46,163855,79.73479318734793,9
0.2,2055,92,163947,79.74075875486382,9
0.2,2056,94,164041,79.74769081186193,8
0.2,2057,93,164134,79.75413022351798,8
0.2,2058,94,164228,79.76104905293832,7
0.2,2059,91,164319,79.76650485436893,11
0.2,2060,85,164404,79.76904415332363,16
0.2,2061,96,164500,79.77691561590689,6
0.2,2062,95,164595,79.78429471643238,6
0.2,2063,90,164685,79.78924418604652,11
0.2,2064,93,164778,79.7956416464891,10
0.2,2065,92,164870,79.80154888673766,9
0.2,2066,95,164965,79.80890179003387,7
0.2,2067,88,165053,79.81286266924565,13
0.2,2068,82,165135,79.81391976800387,19
0.2,2069,27,165162,79.78840579710145,6
0.2,2070,-47,165115,79.7271849348141,12
0.2,2071,18,165133,79.69739382239382,15
0.2,2072,96,165229,79.70525808007719,6
0.2,2073,94,165323,79.71215043394407,7
0.2,2074,94,165417,79.71903614457831,7
0.2,2075,23,165440,79.69171483622351,9
0.2,2076,95,165535,79.69908521906596,6
0.2,2077,94,165629,79.70596727622714,8
0.2,2078,91,165720,79.71139971139971,10
0.2,2079,-53,165667,79.64759615384615,17
0.2,2080,94,165761,79.65449303219606,7
0.2,2081,94,165855,79.66138328530259,7
0.2,2082,95,165950,79.66874699951993,6
0.2,2083,94,166044,79.67562380038387,7
0.2,2084,93,166137,79.68201438848921,8
0.2,2085,90,166227,79.6869606903164,11
0.2,2086,95,166322,79.69429803545759,7
0.2,2087,94,166416,79.70114942528735,7
0.2,2088,89,166505,79.70560076591671,12
0.2,2089,94,166599,79.71244019138756,7
0.2,2090,92,166691,79.71831659493066,9
0.2,2091,93,166784,79.72466539196941,8
0.2,2092,94,166878,79.73148590539896,9
0.2,2093,93,166971,79.7378223495702,8
0.2,2094,96,167067,79.74558472553699,6
0.2,2095,94,167161,79.75238549618321,7
0.2,2096,96,167257,79.76013352408202,6
0.2,2097,93,167350,79.76644423260248,9
0.2,2098,95,167445,79.77370176274417,6
0.2,2099,94,167539,79.7804761904762,7
0.2,2100,93,167632,79.78676820561637,8
0.2,2101,19,167651,79.75784966698383,14
0.2,2102,91,167742,79.76319543509273,10
0.2,2103,94,167836,79.76996197718631,8
0.2,2104,93,167929,79.77624703087886,9
0.2,2105,93,168022,79.78252611585945,8
0.2,2106,90,168112,79.7873754152824,12
0.2,2107,93,168205,79.79364326375712,8
0.2,2108,91,168296,79.79895685158843,10
0.2,2109,92,168388,79.80473933649289,10
0.2,2110,92,168480,79.81051634296541,9
0.2,2111,92,168572,79.81628787878788,9
0.2,2112,90,168662,79.82110743019403,12
0.2,2113,95,168757,79.8282876064333,6
0.2,2114,95,168852,79.8354609929078,6
0.2,2115,93,168945,79.84168241965973,9
0.2,2116,93,169038,79.8478979688238,13
0.2,2117,94,169132,79.85457979225684,7
0.2,2118,90,169222,79.8593676262388,11
0.2,2119,88,169310,79.86320754716981,13
0.2,2120,24,169334,79.83686940122584,8
0.2,2121,95,169429,79.8440150801131,7
0.2,2122,95,169524,79.85115402731984,6
0.2,2123,88,169612,79.85499058380414,14
0.2,2124,95,169707,79.86211764705882,6
0.2,2125,90,169797,79.86688617121355,11
0.2,2126,94,169891,79.87353079454631,7
0.2,2127,17,169908,79.84398496240601,15
0.2,2128,95,170003,79.8511038046031,6
0.2,2129,96,170099,79.85868544600939,6
0.2,2130,93,170192,79.86485218207415,8
0.2,2131,92,170284,79.87054409005628,9
0.2,2132,95,170379,79.87763713080169,7
0.2,2133,94,170473,79.8842549203374,7
0.2,2134,94,170567,79.89086651053864,7
0.2,2135,96,170663,79.89840823970037,6
0.2,2136,94,170757,79.90500701918577,7
0.2,2137,93,170850,79.911131898971,8
0.2,2138,92,170942,79.91678354371201,9
0.2,2139,27,170969,79.89205607476636,6
0.2,2140,96,171065,79.89957963568426,6
0.2,2141,22,171087,79.87254901960785,11
0.2,2142,89,171176,79.87680821278582,12
0.2,2143,90,171266,79.88152985074628,11
0.2,2144,94,171360,79.8881118881119,7
0.2,2145,96,171456,79.89561975768872,6
0.2,2146,85,171541,79.89799720540289,20
0.2,2147,94,171635,79.90456238361266,7
0.2,2148,23,171658,79.87808282922289,10
0.2,2149,93,171751,79.88418604651163,8
0.2,2150,91,171842,79.88935378893538,12
0.2,2151,90,171932,79.89405204460967,12
0.2,2152,22,171954,79.8671620993962,10
0.2,2153,94,172048,79.87372330547818,7
0.2,2154,93,172141,79.87981438515081,8
0.2,2155,91,172232,79.88497217068645,10
0.2,2156,93,172325,79.89105238757534,8
0.2,2157,95,172420,79.89805375347544,6
0.2,2158,87,172507,79.90134321445113,14
0.2,2159,15,172522,79.8712962962963,19
0.2,2160,96,172618,79.87875983341046,6
0.2,2161,90,172708,79.88344125809435,11
0.2,2162,95,172803,79.89042995839112,6
0.2,2163,24,172827,79.86460258780036,8
0.2,2164,96,172923,79.87205542725174,6
0.2,2165,90,173013,79.87673130193906,11
0.2,2166,91,173104,79.88186432856483,10
0.2,2167,93,173197,79.8879151291513,10
0.2,2168,93,173290,79.89396035039188,8
0.2,2169,96,173386,79.90138248847926,6
0.2,2170,92,173478,79.90695532012897,11
0.2,2171,92,173570,79.91252302025782,9
0.2,2172,94,173664,79.91900598251266,7
0.2,2173,91,173755,79.92410303587856,10
0.2,2174,86,173841,79.92689655172414,16
0.2,2175,93,173934,79.93290441176471,8
0.2,2176,92,174026,79.93844740468535,9
0.2,2177,92,174118,79.94398530762167,9
0.2,2178,82,174200,79.9449288664525,19
0.2,2179,26,174226,79.92018348623853,6
0.2,2180,92,174318,79.92572214580467,9
0.2,2181,94,174412,79.93217231897341,7
0.2,2182,86,174498,79.9349519010536,16
0.2,2183,85,174583,79.93727106227107,18
0.2,2184,95,174678,79.9441647597254,7
0.2,2185,90,174768,79.9487648673376,11
0.2,2186,94,174862,79.9551897576589,7
0.2,2187,94,174956,79.96160877513711,8
0.2,2188,90,175046,79.96619460941069,13
0.2,2189,86,175132,79.9689497716895,16
0.2,2190,91,175223,79.9739844819717,11
0.2,2191,92,175315,79.9794708029197,9
0.2,2192,94,175409,79.98586411308709,7
0.2,2193,90,175499,79.99042844120328,12
0.2,2194,26,175525,79.96583143507972,6
0.2,2195,91,175616,79.97085610200364,11
0.2,2196,90,175706,79.97542102867547,11
0.2,2197,93,175799,79.98134667879891,8
0.2,2198,26,175825,79.95679854479309,7
0.2,2199,94,175919,79.96318181818182,10
0.2,2200,94,176013,79.96955929123126,7
0.2,2201,95,176108,79.9763851044505,6
0.2,2202,21,176129,79.94961416250567,11
0.2,2203,93,176222,79.95553539019964,8
0.2,2204,94,176316,79.96190476190476,8
0.2,2205,92,176408,79.96736174070716,9
0.2,2206,-191,176217,79.8445854100589,16
0.2,2207,25,176242,79.8197463768116,9
0.2,2208,-51,176191,79.76052512449073,15
0.2,2209,95,176286,79.76742081447964,6
0.2,2210,92,176378,79.77295341474446,9
0.2,2211,-48,176330,79.71518987341773,12
0.2,2212,89,176419,79.7193854496159,12
0.2,2213,92,176511,79.72493224932249,14
0.2,2214,90,176601,79.72957110609481,12
0.2,2215,90,176691,79.73420577617328,11
0.2,2216,96,176787,79.74154262516915,6
0.2,2217,92,176879,79.74706943192065,10
0.2,2218,93,176972,79.75304191077062,8
0.2,2219,95,177067,79.75990990990991,6
0.2,2220,95,177162,79.76677172444845,6
0.2,2221,96,177258,79.77407740774078,8
0.2,2222,96,177354,79.78137651821862,6
0.2,2223,93,177447,79.7873201438849,8
0.2,2224,94,177541,79.79370786516854,7
0.2,2225,93,177634,79.79964061096136,8
0.2,2226,92,177726,79.80511899416256,9
0.2,2227,90,177816,79.8096947935368,11
0.2,2228,93,177909,79.81561238223419,8
0.2,2229,94,178003,79.8219730941704,7
0.2,2230,95,178098,79.82877633348275,8
0.2,2231,89,178187,79.8328853046595,13
0.2,2232,89,178276,79.83699059561128,13
0.2,2233,93,178369,79.84288272157565,8
0.2,2234,90,178459,79.84742729306488,11
0.2,2235,96,178555,79.8546511627907,6
0.2,2236,95,178650,79.86142154671435,7
0.2,2237,92,178742,79.8668453976765,9
0.2,2238,93,178835,79.87271103171058,8
0.2,2239,93,178928,79.87857142857143,8
0.2,2240,92,179020,79.88398036590807,10
0.2,2241,90,179110,79.88849241748439,11
0.2,2242,94,179204,79.89478377173428,7
0.2,2243,93,179297,79.90062388591801,8
0.2,2244,96,179393,79.90779510022271,6
0.2,2245,90,179483,79.91228851291184,11
0.2,2246,92,179575,79.91766800178016,9
0.2,2247,93,179668,79.92348754448399,8
0.2,2248,95,179763,79.93019119608715,6
0.2,2249,87,179850,79.93333333333334,15
0.2,2250,96,179946,79.94047090182141,6
0.2,2251,92,180038,79.94582593250443,9
0.2,2252,95,180133,79.95250776742121,8
0.2,2253,86,180219,79.95519077196096,15
0.2,2254,93,180312,79.9609756097561,8
0.2,2255,-50,180262,79.90336879432624,13
0.2,2256,23,180285,79.87815684536996,9
0.2,2257,94,180379,79.88441098317095,7
0.2,2258,96,180475,79.89154493138557,6
0.2,2259,92,180567,79.89690265486726,9
0.2,2260,91,180658,79.90181335692172,10
0.2,2261,88,180746,79.9053934571176,15
0.2,2262,94,180840,79.9116217410517,7
0.2,2263,94,180934,79.9178445229682,7
0.2,2264,94,181028,79.92406181015453,7
0.2,2265,92,181120,79.92939099735216,9
0.2,2266,92,181212,79.9347154830172,9
0.2,2267,95,181307,79.94135802469135,6
0.2,2268,89,181396,79.94535037461436,13
0.2,2269,90,181486,79.94977973568282,11
0.2,2270,86,181572,79.95244385733157,16
0.2,2271,93,181665,79.9581866197183,8
0.2,2272,89,181754,79.96216454025517,14
0.2,2273,95,181849,79.96877748460862,6
0.2,2274,22,181871,79.94329670329671,12
0.2,2275,93,181964,79.94903339191565,9
0.2,2276,94,182058,79.95520421607378,8
0.2,2277,92,182150,79.96049165935031,9
0.2,2278,27,182177,79.93725318121983,6
0.2,2279,92,182269,79.94254385964912,9
0.2,2280,93,182362,79.94826830337571,8
0.2,2281,95,182457,79.95486415425066,6
0.2,2282,92,182549,79.96014016644766,10
0.2,2283,93,182642,79.96584938704028,8
0.2,2284,27,182669,79.94266958424508,6
0.2,2285,89,182758,79.94663167104112,13
0.2,2286,95,182853,79.9532138172278,6
0.2,2287,94,182947,79.95935314685315,7
0.2,2288,91,183038,79.96417649628658,11
0.2,2289,96,183134,79.9711790393013,6
0.2,2290,88,183222,79.9746835443038,13
0.2,2291,91,183313,79.97949389179756,11
0.2,2292,-45,183268,79.9249890972525,8
0.2,2293,94,183362,79.93112467306015,8
0.2,2294,85,183447,79.93333333333334,18
0.2,2295,95,183542,79.93989547038328,8
0.2,2296,90,183632,79.9442751414889,11
0.2,2297,93,183725,79.94995648389904,8
0.2,2298,92,183817,79.95519791213572,9
0.2,2299,22,183839,79.93,10
0.2,2300,92,183931,79.93524554541504,9
0.2,2301,92,184023,79.94048653344917,9
0.2,2302,95,184118,79.94702561875815,7
0.2,2303,94,184212,79.953125,8
0.2,2304,94,184306,79.95921908893709,7
0.2,2305,94,184400,79.96530789245446,7
0.2,2306,-50,184350,79.90897269180755,14
0.2,2307,93,184443,79.91464471403813,8
0.2,2308,91,184534,79.91944564746643,10
0.2,2309,92,184626,79.92467532467532,9
0.2,2310,84,184710,79.92643877109477,19
0.2,2311,92,184802,79.93166089965398,11
0.2,2312,91,184893,79.93644617380026,10
0.2,2313,91,184984,79.94122731201382,10
0.2,2314,96,185080,79.94816414686825,7
0.2,2315,91,185171,79.95293609671847,10
0.2,2316,95,185266,79.95943029779887,7
0.2,2317,91,185357,79.96419327006039,10
0.2,2318,89,185446,79.96808969383355,13
0.2,2319,95,185541,79.97456896551724,6
0.2,2320,89,185630,79.97845756139596,13
0.2,2321,89,185719,79.9823428079242,12
0.2,2322,92,185811,79.98751614291864,9
0.2,2323,94,185905,79.99354561101549,8
0.2,2324,26,185931,79.97032258064516,7
0.2,2325,96,186027,79.97721410146174,6
0.2,2326,94,186121,79.98324022346368,7
0.2,2327,89,186210,79.98711340206185,12
0.2,2328,84,186294,79.9888364104766,17
0.2,2329,95,186389,79.99527896995708,7
0.2,2330,93,186482,80.000858000858,8
0.2,2331,89,186571,80.00471698113208,12
0.2,2332,93,186664,80.0102871838834,8
0.2,2333,91,186755,80.01499571550985,11
0.2,2334,90,186845,80.01927194860814,11
0.2,2335,93,186938,80.02482876712328,8
0.2,2336,87,187025,80.02781343602909,14
0.2,2337,19,187044,80.00171086398632,13
0.2,2338,83,187127,80.00299273193673,18
0.2,2339,18,187145,79.97649572649573,14
0.2,2340,91,187236,79.98120461341307,11
0.2,2341,25,187261,79.95772843723313,7
0.2,2342,24,187285,79.93384549722578,8
0.2,2343,23,187308,79.90955631399318,9
0.2,2344,90,187398,79.9138592750533,12
0.2,2345,89,187487,79.91773231031543,14
0.2,2346,91,187578,79.92245419684704,12
0.2,2347,91,187669,79.92717206132879,10
0.2,2348,92,187761,79.93231162196679,9
0.2,2349,95,187856,79.93872340425531,6
0.2,2350,26,187882,79.91578051892812,6
0.2,2351,94,187976,79.921768707483,8
0.2,2352,91,188067,79.92647683807905,10
0.2,2353,96,188163,79.93330501274427,6
0.2,2354,95,188258,79.93970276008493,6
0.2,2355,94,188352,79.94567062818336,7
0.2,2356,93,188445,79.95120916419177,8
0.2,2357,94,188539,79.95716709075488,7
0.2,2358,90,188629,79.96142433234421,12
0.2,2359,25,188654,79.93813559322034,9
0.2,2360,93,188747,79.9436679373147,8
0.2,2361,93,188840,79.94919559695174,8
0.2,2362,89,188929,79.9530258146424,12
0.2,2363,92,189021,79.95812182741116,9
0.2,2364,93,189114,79.96363636363637,8
0.2,2365,94,189208,79.96956889264581,7
0.2,2366,92,189300,79.97465145754119,10
0.2,2367,91,189391,79.97930743243244,10
0.2,2368,89,189480,79.98311523849726,12
0.2,2369,93,189573,79.98860759493671,9
0.2,2370,91,189664,79.99325179249261,10
0.2,2371,16,189680,79.96627318718382,16
0.2,2372,25,189705,79.94310998735777,7
0.2,2373,92,189797,79.94818871103622,9
0.2,2374,93,189890,79.95368421052632,8
0.2,2375,95,189985,79.96001683501683,6
0.2,2376,93,190078,79.96550273453934,8
0.2,2377,95,190173,79.97182506307821,6
0.2,2378,24,190197,79.9482976040353,10
0.2,2379,93,190290,79.95378151260505,8
0.2,2380,92,190382,79.95884082318354,10
0.2,2381,87,190469,79.96179680940386,14
0.2,2382,95,190564,79.96810742761225,8
0.2,2383,89,190653,79.97189597315436,12
0.2,2384,94,190747,79.97777777777777,7
0.2,2385,-46,190701,79.92497904442581,10
0.2,2386,91,190792,79.92961876832844,10
0.2,2387,94,190886,79.9355108877722,8
0.2,2388,91,190977,79.9401423189619,11
0.2,2389,88,191065,79.94351464435147,13
0.2,2390,92,191157,79.94855708908406,9
0.2,2391,24,191181,79.92516722408027,12
0.2,2392,95,191276,79.9314667781028,6
0.2,2393,90,191366,79.93567251461988,11
0.2,2394,10,191376,79.90647181628393,22
0.2,2395,-50,191326,79.85225375626044,13
0.2,2396,75,191401,79.85022945348352,27
0.2,2397,25,191426,79.82735613010843,8
0.2,2398,94,191520,79.83326385994164,7
0.2,2399,94,191614,79.83916666666667,7
0.2,2400,90,191704,79.84339858392336,11
0.2,2401,91,191795,79.84804329725229,10
0.2,2402,93,191888,79.8535164377861,10
0.2,2403,91,191979,79.85815307820299,10
0.2,2404,25,192004,79.83534303534303,7
0.2,2405,94,192098,79.8412302576891,7
0.2,2406,94,192192,79.84711258828418,7
0.2,2407,21,192213,79.82267441860465,12
0.2,2408,90,192303,79.82689912826899,12
0.2,2409,94,192397,79.83278008298755,7
0.2,2410,89,192486,79.83658233098299,13
0.2,2411,96,192582,79.84328358208955,6
0.2,2412,96,192678,79.84997927890592,6
0.2,2413,92,192770,79.85501242750621,10
0.2,2414,90,192860,79.8592132505176,11
0.2,2415,93,192953,79.8646523178808,9
0.2,2416,93,193046,79.87008688456764,10
0.2,2417,93,193139,79.87551695616212,8
0.2,2418,95,193234,79.88176932616784,6
0.2,2419,95,193329,79.88801652892562,6
0.2,2420,25,193354,79.86534489880215,8
0.2,2421,94,193448,79.8711808422791,7
0.2,2422,92,193540,79.87618654560463,11
0.2,2423,96,193636,79.88283828382838,6
0.2,2424,92,193728,79.88783505154639,9
0.2,2425,91,193819,79.8924154987634,10
0.2,2426,90,193909,79.89658014009065,11
0.2,2427,91,194000,79.9011532125206,10
0.2,2428,95,194095,79.90736928777275,6
0.2,2429,93,194188,79.91275720164609,8
0.2,2430,92,194280,79.91772932949404,9
0.2,2431,92,194372,79.92269736842105,9
0.2,2432,84,194456,79.92437320180846,17
0.2,2433,92,194548,79.92933442892358,9
0.2,2434,87,194635,79.93223819301848,15
0.2,2435,86,194721,79.9347290640394,16
0.2,2436,94,194815,79.94050061551087,8
0.2,2437,92,194907,79.94544708777687,9
0.2,2438,93,195000,79.95079950799509,9
0.2,2439,90,195090,79.95491803278688,11
0.2,2440,94,195184,79.9606718557968,7
0.2,2441,17,195201,79.93488943488944,15
0.2,2442,91,195292,79.93941874744166,11
0.2,2443,92,195384,79.9443535188216,9
0.2,2444,-53,195331,79.88997955010225,19
0.2,2445,90,195421,79.89411283728536,11
0.2,2446,25,195446,79.87167960768288,9
0.2,2447,22,195468,79.84803921568627,10
0.2,2448,91,195559,79.8525928950592,10
0.2,2449,92,195651,79.85755102040817,10
0.2,2450,89,195740,79.86128110975112,12
0.2,2451,93,195833,79.86663947797716,8
0.2,2452,95,195928,79.87280880554424,6
0.2,2453,95,196023,79.87897310513448,7
0.2,2454,91,196114,79.88350305498982,10
0.2,2455,92,196206,79.88843648208469,10
0.2,2456,89,196295,79.8921448921449,13
0.2,2457,94,196389,79.89788445890969,9
0.2,2458,95,196484,79.90402602684019,6
0.2,2459,26,196510,79.8821138211382,6
0.2,2460,95,196605,79.88825680617636,6
0.2,2461,95,196700,79.89439480097482,7
0.2,2462,95,196795,79.90052781161185,6
0.2,2463,92,196887,79.90543831168831,9
0.2,2464,95,196982,79.91156186612577,6
0.2,2465,92,197074,79.91646390916463,11
0.2,2466,94,197168,79.92217267936765,7
0.2,2467,91,197259,79.92666126418152,11
0.2,2468,96,197355,79.93317132442284,6
0.2,2469,95,197450,79.93927125506073,6
0.2,2470,94,197544,79.9449615540267,7
0.2,2471,96,197640,79.95145631067962,6
0.2,2472,92,197732,79.95632834613829,9
0.2,2473,92,197824,79.96119644300728,9
0.2,2474,95,197919,79.96727272727273,7
0.2,2475,83,198002,79.96849757673667,18
0.2,2476,92,198094,79.97335486475575,9
0.2,2477,94,198188,79.97901533494753,7
0.2,2478,88,198276,79.98225090762404,13
0.2,2479,96,198372,79.98870967741935,6
0.2,2480,85,198457,79.9907295445385,18
0.2,2481,96,198553,79.99717969379533,6
0.2,2482,92,198645,80.00201369311317,9
0.2,2483,93,198738,80.0072463768116,8
0.2,2484,91,198829,80.01167002012072,10
0.2,2485,94,198923,80.0172968624296,8
0.2,2486,89,199012,80.02090872537194,13
0.2,2487,92,199104,80.02572347266882,9
0.2,2488,96,199200,80.03214142225794,6
0.2,2489,95,199295,80.03815261044177,6
0.2,2490,93,199388,80.04335608189483,8
0.2,2491,94,199482,80.04895666131621,7
0.2,2492,90,199572,80.05294825511432,12
0.2,2493,92,199664,80.05773857257418,9
0.2,2494,90,199754,80.0617234468938,11
0.2,2495,75,199829,80.05969551282051,26
0.2,2496,88,199917,80.06287545054064,14
0.2,2497,94,200011,80.06845476381105,7
0.2,2498,94,200105,80.07402961184474,8
0.2,2499,94,200199,80.0796,7
0.2,2500,-46,200153,80.02918832467013,10
0.2,2501,93,200246,80.0343725019984,10
0.2,2502,93,200339,80.03955253695565,9
0.2,2503,27,200366,80.01837060702876,6
0.2,2504,92,200458,80.02315369261477,9
0.2,2505,96,200554,80.0295291300878,6
0.2,2506,95,200649,80.03550059832469,7
0.2,2507,91,200740,80.03987240829346,10
0.2,2508,90,200830,80.0438421681945,11
0.2,2509,92,200922,80.04860557768924,10
0.2,2510,94,201016,80.05416168857029,7
0.2,2511,93,201109,80.0593152866242,8
0.2,2512,89,201198,80.06287306008754,12
0.2,2513,92,201290,80.06762132060462,9
0.2,2514,89,201379,80.07117296222664,12
0.2,2515,91,201470,80.07551669316375,10
0.2,2516,88,201558,80.07866507747318,13
0.2,2517,95,201653,80.0845909451946,6
0.2,2518,92,201745,80.08932115919015,11
0.2,2519,88,201833,80.09246031746032,13
0.2,2520,94,201927,80.09797699325665,7
0.2,2521,91,202018,80.10229976209358,10
0.2,2522,91,202109,80.10661910424098,11
0.2,2523,90,202199,80.11053882725832,12
0.2,2524,95,202294,80.11643564356436,6
0.2,2525,91,202385,80.12074425969912,10
0.2,2526,26,202411,80.09932726553225,7
0.2,2527,94,202505,80.10482594936708,7
0.2,2528,91,202596,80.1091340450771,10
0.2,2529,90,202686,80.11304347826086,11
0.2,2530,91,202777,80.11734492295535,12
0.2,2531,93,202870,80.12243285939968,10
0.2,2532,91,202961,80.1267272009475,11
0.2,2533,93,203054,80.13180741910024,9
0.2,2534,88,203142,80.13491124260355,14
0.2,2535,94,203236,80.1403785488959,7
0.2,2536,89,203325,80.14387071344107,14
0.2,2537,93,203418,80.14893617021276,8
0.2,2538,16,203434,80.12367073651043,16
0.2,2539,93,203527,80.12874015748031,8
0.2,2540,95,203622,80.13459268004722,6
0.2,2541,89,203711,80.13808025177026,13
0.2,2542,92,203803,80.14274478961856,9
0.2,2543,91,203894,80.14701257861635,12
0.2,2544,96,203990,80.15324165029469,6
0.2,2545,17,204007,80.12843676355067,15
0.2,2546,94,204101,80.13388299960738,7
0.2,2547,92,204193,80.13854003139717,10
0.2,2548,94,204287,80.14397803060024,7
0.2,2549,85,204372,80.14588235294117,17
0.2,2550,22,204394,80.12308898471188,10
0.2,2551,96,204490,80.12931034482759,6
0.2,2552,18,204508,80.10497453975715,14
0.2,2553,93,204601,80.11002349256069,8
0.2,2554,92,204693,80.1146771037182,9
0.2,2555,27,204720,80.09389671361502,6
0.2,2556,88,204808,80.09698865858428,14
0.2,2557,92,204900,80.10164190774042,9
0.2,2558,91,204991,80.10590074247753,11
0.2,2559,96,205087,80.112109375,6
0.2,2560,91,205178,80.11636079656384,10
0.2,2561,89,205267,80.11982825917252,12
0.2,2562,93,205360,80.12485368708545,8
0.2,2563,93,205453,80.1298751950078,8
0.2,2564,92,205545,80.13450292397661,10
0.2,2565,23,205568,80.11223694466095,9
0.2,2566,96,205664,80.11842617841839,6
0.2,2567,22,205686,80.09579439252336,12
0.2,2568,92,205778,80.10042818217205,10
0.2,2569,92,205870,80.10505836575875,9
0.2,2570,85,205955,80.10696227148969,17
0.2,2571,92,206047,80.1115863141524,9
0.2,2572,93,206140,80.11659541391371,9
0.2,2573,96,206236,80.12276612276612,6
0.2,2574,91,206327,80.12699029126213,10
0.2,2575,85,206412,80.12888198757764,20
0.2,2576,91,206503,80.13310050446255,10
0.2,2577,27,206530,80.11249030256012,6
0.2,2578,92,206622,80.11709965102753,9
0.2,2579,-115,206507,80.04147286821706,10
0.2,2580,91,206598,80.04571871367686,11
0.2,2581,88,206686,80.04879938032533,14
0.2,2582,91,206777,80.05303910181959,10
0.2,2583,94,206871,80.05843653250774,7
0.2,2584,24,206895,80.03675048355899,10
0.2,2585,90,206985,80.04060324825986,12
0.2,2586,92,207077,80.04522613065326,9
0.2,2587,91,207168,80.04945904173107,10
0.2,2588,93,207261,80.05446118192353,8
0.2,2589,94,207355,80.05984555984556,7
0.2,2590,92,207447,80.06445387881126,9
0.2,2591,94,207541,80.06983024691358,7
0.2,2592,86,207627,80.07211723871963,19
0.2,2593,92,207719,80.07671549730146,11
0.2,2594,96,207815,80.08285163776493,6
0.2,2595,91,207906,80.08705701078583,10
0.2,2596,88,207994,80.09010396611475,15
0.2,2597,21,208015,80.06735950731331,12
0.2,2598,92,208107,80.07195075028858,9
0.2,2599,95,208202,80.0776923076923,6
0.2,2600,94,208296,80.08304498269896,7
0.2,2601,91,208387,80.08724058416603,10
0.2,2602,93,208480,80.09220130618517,8
0.2,2603,93,208573,80.09715821812595,10
0.2,2604,93,208666,80.1021113243762,10
0.2,2605,92,208758,80.10667689946278,9
0.2,2606,86,208844,80.10893747602609,16
0.2,2607,94,208938,80.11426380368098,7
0.2,2608,93,209031,80.11920275967803,8
0.2,2609,94,209125,80.12452107279694,7
0.2,2610,92,209217,80.12906932209881,10
0.2,2611,92,209309,80.13361408882082,9
0.2,2612,89,209398,80.13700727133563,12
0.2,2613,94,209492,80.14231063504208,7
0.2,2614,95,209587,80.14799235181644,6
0.2,2615,85,209672,80.14984709480122,16
0.2,2616,27,209699,80.12953763851739,6
0.2,2617,92,209791,80.1340718105424,9
0.2,2618,91,209882,80.13822069492173,10
0.2,2619,22,209904,80.11603053435114,10
0.2,2620,95,209999,80.1217092712705,6
0.2,2621,89,210088,80.12509534706331,12
0.2,2622,96,210184,80.1311475409836,6
0.2,2623,93,210277,80.1360518292683,10
0.2,2624,20,210297,80.11314285714286,12
0.2,2625,91,210388,80.11728865194212,10
0.2,2626,93,210481,80.12219261515037,8
0.2,2627,94,210575,80.12747336377474,7
0.2,2628,93,210668,80.13236972232788,8
0.2,2629,94,210762,80.13764258555133,8
0.2,2630,88,210850,80.14063093880654,13
0.2,2631,23,210873,80.11892097264437,9
0.2,2632,95,210968,80.1245727307254,8
0.2,2633,-267,210701,79.99278663629461,24
0.2,2634,93,210794,79.9977229601518,8
0.2,2635,24,210818,79.97647951441579,9
0.2,2636,94,210912,79.98179749715585,7
0.2,2637,95,211007,79.98749052312358,6
0.2,2638,93,211100,79.99242137173172,8
0.2,2639,89,211189,79.99583333333334,12
0.2,2640,87,211276,79.99848542218857,14
0.2,2641,94,211370,80.00378501135503,7
0.2,2642,90,211460,80.00756715853197,11
0.2,2643,95,211555,80.01323751891074,9
0.2,2644,90,211645,80.01701323251417,11
0.2,2645,27,211672,79.99697656840515,6
0.2,2646,94,211766,80.00226671703815,7
0.2,2647,88,211854,80.00528700906344,13
0.2,2648,-49,211805,79.95658739146847,13
0.2,2649,92,211897,79.9611320754717,9
0.2,2650,25,211922,79.94039984911355,9
0.2,2651,23,211945,79.91892911010558,11
0.2,2652,86,212031,79.92122125895213,15
0.2,2653,91,212122,79.92539562923888,12
0.2,2654,95,212217,79.93107344632769,6
0.2,2655,92,212309,79.93561746987952,11
0.2,2656,93,212402,79.94053443733534,8
0.2,2657,91,212493,79.94469525959369,10
0.2,2658,95,212588,79.95035727717188,6
0.2,2659,90,212678,79.95413533834586,12
0.2,2660,95,212773,79.9597895527997,6
0.2,2661,94,212867,79.96506386175808,7
0.2,2662,94,212961,79.97033420953811,7
0.2,2663,94,213055,79.9756006006006,8
0.2,2664,19,213074,79.95272045028143,13
0.2,2665,93,213167,79.9576144036009,8
0.2,2666,94,213261,79.96287964004499,7
0.2,2667,90,213351,79.96664167916042,11
0.2,2668,94,213445,79.97189958786062,7
0.2,2669,90,213535,79.97565543071161,11
0.2,2670,-47,213488,79.92811681018345,10
0.2,2671,92,213580,79.93263473053892,10
0.2,2672,94,213674,79.93789749345305,7
0.2,2673,94,213768,79.94315632011967,7
0.2,2674,96,213864,79.94915887850468,6
0.2,2675,96,213960,79.95515695067265,6
0.2,2676,26,213986,79.93500186776242,6
0.2,2677,23,214009,79.91374159820762,9
0.2,2678,89,214098,79.91713325867862,12
0.2,2679,95,214193,79.92276119402985,6
0.2,2680,-48,214145,79.87504662439389,13
0.2,2681,87,214232,79.87770320656227,15
0.2,2682,93,214325,79.8825941110697,10
0.2,2683,89,214414,79.8859910581222,12
0.2,2684,91,214505,79.89013035381751,10
0.2,2685,91,214596,79.89426656738645,11
0.2,2686,87,214683,79.8969110532192,14
0.2,2687,94,214777,79.90215773809524,7
0.2,2688,92,214869,79.90665674972108,10
0.2,2689,94,214963,79.91189591078067,7
0.2,2690,91,215054,79.91601635079896,10
0.2,2691,94,215148,79.92124814264487,7
0.2,2692,19,215167,79.89862606758263,13
0.2,2693,93,215260,79.90348923533779,8
0.2,2694,89,215349,79.90686456400742,13
0.2,2695,90,215439,79.91060830860535,13
0.2,2696,94,215533,79.91583240637746,7
0.2,2697,85,215618,79.91771682727946,18
0.2,2698,92,215710,79.9221934049648,9
0.2,2699,90,215800,79.92592592592592,11
0.2,2700,25,215825,79.90559052202887,8
0.2,2701,90,215915,79.90932642487047,11
0.2,2702,94,216009,79.91453940066593,8
0.2,2703,90,216099,79.91826923076923,11
0.2,2704,93,216192,79.92310536044363,9
0.2,2705,94,216286,79.92830746489282,9
0.2,2706,17,216303,79.9050609530846,15
0.2,2707,20,216323,79.88293943870015,12
0.2,2708,95,216418,79.88851974898486,8
0.2,2709,88,216506,79.89151291512916,14
0.2,2710,88,216594,79.89450387310956,16
0.2,2711,87,216681,79.89712389380531,14
0.2,2712,93,216774,79.90195355694803,8
0.2,2713,94,216868,79.90714812085483,7
0.2,2714,25,216893,79.88692449355433,7
0.2,2715,94,216987,79.8921207658321,7
0.2,2716,95,217082,79.89768126610232,6
0.2,2717,92,217174,79.90213392200147,9
0.2,2718,24,217198,79.88157410812799,8
0.2,2719,25,217223,79.86139705882353,7
0.2,2720,94,217317,79.86659316427784,8
0.2,2721,93,217410,79.8714180749449,10
0.2,2722,95,217505,79.87697392581711,7
0.2,2723,93,217598,79.88179148311306,10
0.2,2724,88,217686,79.88477064220183,16
0.2,2725,-51,217635,79.83675715333823,14
0.2,2726,92,217727,79.84121745507885,10
0.2,2727,90,217817,79.8449413489736,11
0.2,2728,93,217910,79.84976181751557,9
0.2,2729,96,218006,79.85567765567765,6
0.2,2730,93,218099,79.8604906627609,8
0.2,2731,95,218194,79.86603221083455,6
0.2,2732,89,218283,79.86937431394072,12
0.2,2733,12,218295,79.84455010972934,20
0.2,2734,96,218391,79.85045703839123,6
0.2,2735,95,218486,79.85599415204679,6
0.2,2736,92,218578,79.86043112897333,10
0.2,2737,90,218668,79.86413440467494,11
0.2,2738,91,218759,79.86820007301935,10
0.2,2739,87,218846,79.87080291970803,16
0.2,2740,94,218940,79.87595767967895,7
0.2,2741,90,219030,79.87964989059081,12
0.2,2742,91,219121,79.88370397375137,11
0.2,2743,93,219214,79.88848396501457,8
0.2,2744,94,219308,79.8936247723133,7
0.2,2745,95,219403,79.89912600145666,6
0.2,2746,21,219424,79.87768474699672,11
0.2,2747,23,219447,79.85698689956332,9
0.2,2748,92,219539,79.86140414696253,11
0.2,2749,92,219631,79.86581818181818,11
0.2,2750,94,219725,79.87095601599418,7
0.2,2751,94,219819,79.87609011627907,7
0.2,2752,89,219908,79.8794042862332,13
0.2,2753,94,220002,79.88453159041394,7
0.2,2754,90,220092,79.88820326678766,11
0.2,2755,94,220186,79.8933236574746,7
0.2,2756,93,220279,79.89807762060211,8
0.2,2757,95,220374,79.90355329949239,6
0.2,2758,94,220468,79.90866255889816,7
0.2,2759,95,220563,79.9141304347826,6
0.2,2760,89,220652,79.91742122419413,13
0.2,2761,87,220739,79.91998551774077,14
0.2,2762,95,220834,79.92544335866812,7
0.2,2763,95,220929,79.9308972503618,7
0.2,2764,89,221018,79.93417721518988,13
0.2,2765,25,221043,79.91431670281996,7
0.2,2766,91,221134,79.91832309360318,10
0.2,2767,95,221229,79.92377167630057,6
0.2,2768,95,221324,79.92921632358252,6
0.2,2769,89,221413,79.93249097472925,12
0.2,2770,93,221506,79.9372067845543,8
0.2,2771,92,221598,79.94155844155844,9
0.2,2772,-46,221552,79.89614136314461,9
0.2,2773,24,221576,79.8759913482336,9
0.2,2774,91,221667,79.88,10
0.2,2775,88,221755,79.8829250720461,13
0.2,2776,93,221848,79.88764854159164,8
0.2,2777,92,221940,79.89200863930886,9
0.2,2778,87,222027,79.89456639078806,15
0.2,2779,96,222123,79.90035971223021,6
0.2,2780,21,222144,79.87918015102481,11
0.2,2781,93,222237,79.88389647735443,8
0.2,2782,23,222260,79.86345670140136,10
0.2,2783,93,222353,79.86817528735632,8
0.2,2784,94,222447,79.87324955116696,7
0.2,2785,27,222474,79.85427135678393,6
0.2,2786,26,222500,79.83494797273053,6
0.2,2787,20,222520,79.81348637015782,12
0.2,2788,95,222615,79.81893151667265,6
0.2,2789,95,222710,79.82437275985663,6
0.2,2790,93,222803,79.82909351486923,9
0.2,2791,94,222897,79.83416905444126,7
0.2,2792,92,222989,79.83852488363766,10
0.2,2793,95,223084,79.84395132426629,6
0.2,2794,95,223179,79.84937388193202,6
0.2,2795,96,223275,79.85515021459227,6
0.2,2796,25,223300,79.83553807651055,9
0.2,2797,93,223393,79.84024303073625,9
0.2,2798,87,223480,79.84280100035727,15
0.2,2799,95,223575,79.84821428571429,6
0.2,2800,94,223669,79.85326669046769,7
0.2,2801,94,223763,79.85831548893647,8
0.2,2802,92,223855,79.86264716375312,9
0.2,2803,-56,223799,79.8141940085592,19
0.2,2804,87,223886,79.81675579322638,15
0.2,2805,95,223981,79.82216678545973,7
0.2,2806,92,224073,79.82650516565728,9
0.2,2807,94,224167,79.83155270655271,7
0.2,2808,21,224188,79.81060875756496,11
0.2,2809,90,224278,79.81423487544484,11
0.2,2810,93,224371,79.81892564923515,8
0.2,2811,22,224393,79.79836415362732,11
0.2,2812,94,224487,79.80341272662638,10
0.2,2813,96,224583,79.8091684434968,6
0.2,2814,25,224608,79.78969804618117,7
0.2,2815,88,224696,79.79261363636364,13
0.2,2816,96,224792,79.798367057153,6
0.2,2817,93,224885,79.80305180979418,8
0.2,2818,93,224978,79.80773323873714,10
0.2,2819,95,225073,79.81312056737589,7
0.2,2820,22,225095,79.7926267281106,10
0.2,2821,94,225189,79.79766123316797,7
0.2,2822,84,225273,79.7991498405951,18
0.2,2823,76,225349,79.7978045325779,25
0.2,2824,95,225444,79.80318584070797,6
0.2,2825,88,225532,79.80608634111819,15
0.2,2826,94,225626,79.81110718075699,7
0.2,2827,88,225714,79.81400282885431,14
0.2,2828,93,225807,79.8186638388123,8
0.2,2829,96,225903,79.8243816254417,6
0.2,2830,96,225999,79.83009537265984,6
0.2,2831,93,226092,79.83474576271186,8
0.2,2832,92,226184,79.83903988704553,9
0.2,2833,95,226279,79.84438955539873,6
0.2,2834,91,226370,79.84832451499118,10
0.2,2835,94,226464,79.85331452750353,7
0.2,2836,94,226558,79.85830102220656,7
0.2,2837,90,226648,79.86187455954898,11
0.2,2838,96,226744,79.86755899964777,6
0.2,2839,95,226839,79.87288732394366,8
0.2,2840,24,226863,79.8532206969377,8
0.2,2841,96,226959,79.85890218156229,6
0.2,2842,92,227051,79.8631727048892,9
0.2,2843,96,227147,79.86884669479606,6
0.2,2844,94,227241,79.8738137082601,7
0.2,2845,88,227329,79.87666900913563,15
0.2,2846,84,227413,79.87811731647348,18
0.2,2847,90,227503,79.88167134831461,12
0.2,2848,89,227592,79.88487188487188,12
0.2,2849,92,227684,79.88912280701754,9
0.2,2850,88,227772,79.89196773062083,13
0.2,2851,92,227864,79.89621318373071,9
0.2,2852,94,227958,79.90115667718192,7
0.2,2853,94,228052,79.90609670637701,7
0.2,2854,95,228147,79.91138353765324,6
0.2,2855,92,228239,79.9156162464986,9
0.2,2856,94,228333,79.92054602730137,8
0.2,2857,20,228353,79.89958012596222,13
0.2,2858,92,228445,79.90381252186079,9
0.2,2859,90,228535,79.90734265734265,12
0.2,2860,93,228628,79.9119189094722,8
0.2,2861,92,228720,79.916142557652,9
0.2,2862,88,228808,79.91896611945512,14
0.2,2863,-52,228756,79.87290502793296,15
0.2,2864,94,228850,79.87783595113439,7
0.2,2865,83,228933,79.87892533147243,19
0.2,2866,85,229018,79.88071154516916,16
0.2,2867,93,229111,79.88528591352859,8
0.2,2868,92,229203,79.88950853956082,9
0.2,2869,90,229293,79.89303135888501,11
0.2,2870,94,229387,79.89794496691049,7
0.2,2871,25,229412,79.87883008356546,8
0.2,2872,94,229506,79.88374521406196,7
0.2,2873,94,229600,79.88865692414753,8
0.2,2874,94,229694,79.8935652173913,7
0.2,2875,92,229786,79.89777468706536,9
0.2,2876,94,229880,79.90267639902676,7
0.2,2877,-48,229832,79.85823488533704,11
0.2,2878,93,229925,79.8627995831886,10
0.2,2879,22,229947,79.84270833333333,10
0.2,2880,94,230041,79.84762235334954,8
0.2,2881,94,230135,79.85253296321999,7
0.2,2882,96,230231,79.85813388831079,6
0.2,2883,90,230321,79.8616504854369,13
0.2,2884,93,230414,79.86620450606586,8
0.2,2885,94,230508,79.87110187110187,8
0.2,2886,94,230602,79.87599584343609,7
0.2,2887,25,230627,79.8569944598338,7
0.2,2888,27,230654,79.83869851159571,6
0.2,2889,95,230749,79.8439446366782,6
0.2,2890,24,230773,79.82462815634729,8
0.2,2891,94,230867,79.82952973720609,7
0.2,2892,90,230957,79.83304528171449,11
0.2,2893,90,231047,79.83655839668279,13
0.2,2894,87,231134,79.83903281519862,14
0.2,2895,93,231227,79.8435773480663,12
0.2,2896,94,231321,79.84846392820158,7
0.2,2897,92,231413,79.85265700483092,10
0.2,2898,92,231505,79.85684718868575,10
0.2,2899,25,231530,79.83793103448276,7
0.2,2900,93,231623,79.84246811444329,8
0.2,2901,94,231717,79.8473466574776,7
0.2,2902,92,231809,79.8515328970031,10
0.2,2903,94,231903,79.85640495867769,7
0.2,2904,93,231996,79.86092943201378,8
0.2,2905,92,232088,79.86510667584308,10
0.2,2906,93,232181,79.86962504299966,8
0.2,2907,95,232276,79.8748280605227,8
0.2,2908,-48,232228,79.83086971467858,12
0.2,2909,91,232319,79.83470790378007,10
0.2,2910,94,232413,79.83957402954312,8
0.2,2911,91,232504,79.8434065934066,11
0.2,2912,96,232600,79.84895296944731,6
0.2,2913,93,232693,79.853466026081,9
0.2,2914,83,232776,79.85454545454546,18
0.2,2915,96,232872,79.86008230452676,6
0.2,2916,89,232961,79.86321563249915,12
0.2,2917,26,232987,79.84475668265935,7
0.2,2918,95,233082,79.84994861253854,6
0.2,2919,90,233172,79.85342465753425,12
0.2,2920,23,233195,79.83396097226976,9
0.2,2921,93,233288,79.8384668035592,8
0.2,2922,95,233383,79.84365378036264,6
0.2,2923,79,233462,79.84336525307798,22
0.2,2924,90,233552,79.84683760683761,11
0.2,2925,95,233647,79.85201640464798,6
0.2,2926,96,233743,79.85753331055689,6
0.2,2927,95,233838,79.86270491803279,6
0.2,2928,95,233933,79.86787299419598,6
0.2,2929,92,234025,79.87201365187714,11
0.2,2930,85,234110,79.87376322074377,16
0.2,2931,92,234202,79.87789904502047,9
0.2,2932,91,234293,79.88169110126151,10
0.2,2933,23,234316,79.86230402181323,11
0.2,2934,91,234407,79.86609880749575,10
0.2,2935,96,234503,79.8715940054496,6
0.2,2936,92,234595,79.87572352740892,11
0.2,2937,25,234620,79.857045609258,8
0.2,2938,95,234715,79.86219802653964,6
0.2,2939,91,234806,79.86598639455782,10
0.2,2940,-60,234746,79.81842910574635,26
0.2,2941,24,234770,79.79945615227736,8
0.2,2942,93,234863,79.80394155623513,8
0.2,2943,26,234889,79.78566576086956,7
0.2,2944,-48,234841,79.74227504244482,12
0.2,2945,92,234933,79.74643584521385,9
0.2,2946,93,235026,79.75093315235833,9
0.2,2947,95,235121,79.75610583446404,6
0.2,2948,92,235213,79.76025771447948,9
0.2,2949,88,235301,79.76305084745762,13
0.2,2950,91,235392,79.76685869196882,10
0.2,2951,92,235484,79.7710027100271,11
0.2,2952,91,235575,79.7748052827633,10
0.2,2953,88,235663,79.77758970886933,13
0.2,2954,94,235757,79.7824027072758,7
0.2,2955,89,235846,79.78552097428958,12
0.2,2956,86,235932,79.78762259046331,15
0.2,2957,92,236024,79.79175118323191,10
0.2,2958,20,236044,79.77154444068942,13
0.2,2959,95,236139,79.77668918918918,7
0.2,2960,92,236231,79.78081729145559,9
0.2,2961,94,236325,79.78561782579338,7
0.2,2962,21,236346,79.7657779277759,11
0.2,2963,94,236440,79.77058029689609,7
0.2,2964,84,236524,79.77200674536256,17
0.2,2965,92,236616,79.77612946729602,9
0.2,2966,91,236707,79.7799123693967,10
0.2,2967,94,236801,79.78470350404312,8
0.2,2968,25,236826,79.76625126305153,7
0.2,2969,93,236919,79.77070707070708,8
0.2,2970,92,237011,79.77482329182094,9
0.2,2971,95,237106,79.77994616419919,6
0.2,2972,94,237200,79.78472922973428,7
0.2,2973,95,237295,79.78984532616005,7
0.2,2974,91,237386,79.79361344537816,10
0.2,2975,85,237471,79.79536290322581,16
0.2,2976,92,237563,79.79946254618744,9
0.2,2977,94,237657,79.80423102753525,7
0.2,2978,95,237752,79.80933199060087,6
0.2,2979,90,237842,79.81275167785235,11
0.2,2980,81,237923,79.81314994968132,20
0.2,2981,96,238019,79.81857813547954,6
0.2,2982,90,238109,79.82199128394234,12
0.2,2983,95,238204,79.82707774798928,6
0.2,2984,92,238296,79.83115577889447,9
0.2,2985,23,238319,79.81212324179505,11
0.2,2986,24,238343,79.79343823234014,10
0.2,2987,96,238439,79.79886211512718,6
0.2,2988,85,238524,79.80060220809635,16
0.2,2989,94,238618,79.80535117056856,7
0.2,2990,95,238713,79.81043129388165,6
0.2,2991,88,238801,79.81316844919786,14
0.2,2992,87,238888,79.81556966254594,14
0.2,2993,88,238976,79.81830327321309,13
0.2,2994,93,239069,79.82270450751253,9
0.2,2995,25,239094,79.80440587449934,7
0.2,2996,96,239190,79.8098098098098,6
0.2,2997,91,239281,79.81354236157438,12
0.2,2998,92,239373,79.81760586862288,9
0.2,2999,91,239464,79.82133333333333,12
0.2,3000,89,239553,79.82439186937687,12
0.2,3001,88,239641,79.82711525649567,13
0.2,3002,86,239727,79.82917082917083,15
0.2,3003,93,239820,79.83355525965379,8
0.2,3004,85,239905,79.83527454242929,16
0.2,3005,96,240001,79.84065202927478,6
0.2,3006,94,240095,79.84536082474227,8
0.2,3007,90,240185,79.84873670212765,11
0.2,3008,95,240280,79.85377201728149,6
0.2,3009,92,240372,79.8578073089701,10
0.2,3010,88,240460,79.86051145798739,13
0.2,3011,94,240554,79.8652058432935,7
0.2,3012,87,240641,79.86757384666446,14
0.2,3013,94,240735,79.87226277372262,7
0.2,3014,94,240829,79.87694859038143,9
0.2,3015,92,240921,79.88096816976127,9
0.2,3016,92,241013,79.88498508452105,10
0.2,3017,88,241101,79.88767395626243,13
0.2,3018,90,241191,79.8910235177211,11
0.2,3019,93,241284,79.8953642384106,9
0.2,3020,90,241374,79.8987090367428,11
0.2,3021,95,241469,79.90370615486432,6
0.2,3022,95,241564,79.90869996692028,6
0.2,3023,92,241656,79.91269841269842,14
0.2,3024,93,241749,79.91702479338844,8
0.2,3025,88,241837,79.91969596827495,14
0.2,3026,93,241930,79.92401717872481,8
0.2,3027,94,242024,79.92866578599735,7
0.2,3028,94,242118,79.93331132386926,7
0.2,3029,96,242214,79.93861386138614,6
0.2,3030,23,242237,79.91982843945893,9
0.2,3031,92,242329,79.92381266490766,10
0.2,3032,94,242423,79.92845367622816,8
0.2,3033,95,242518,79.93342122610416,6
0.2,3034,95,242613,79.93838550247116,6
0.2,3035,91,242704,79.94202898550725,10
0.2,3036,-47,242657,79.90023049061574,10
0.2,3037,96,242753,79.90552995391705,6
0.2,3038,94,242847,79.9101678183613,7
0.2,3039,93,242940,79.91447368421052,8
0.2,3040,85,243025,79.91614600460375,17
0.2,3041,87,243112,79.91847468770546,14
0.2,3042,84,243196,79.91981597108116,17
0.2,3043,88,243284,79.92247043363994,14
0.2,3044,92,243376,79.9264367816092,9
0.2,3045,88,243464,79.9290873276428,14
0.2,3046,95,243559,79.93403347554973,8
0.2,3047,95,243654,79.93897637795276,6
0.2,3048,19,243673,79.91898983273204,13
0.2,3049,92,243765,79.92295081967212,10
0.2,3050,23,243788,79.90429367420518,9
0.2,3051,91,243879,79.90792922673657,10
0.2,3052,90,243969,79.91123485096627,11
0.2,3053,94,244063,79.9158480681074,7
0.2,3054,93,244156,79.9201309328969,9
0.2,3055,93,244249,79.9244109947644,9
0.2,3056,94,244343,79.92901537455022,7
0.2,3057,95,244438,79.93394375408764,6
0.2,3058,89,244527,79.93690748610658,12
0.2,3059,87,244614,79.93921568627451,14
0.2,3060,90,244704,79.94250245017967,11
0.2,3061,94,244798,79.94709340300457,7
0.2,3062,90,244888,79.9503754489063,12
0.2,3063,91,244979,79.9539817232376,10
0.2,3064,94,245073,79.95856443719413,9
0.2,3065,90,245163,79.96183953033268,11
0.2,3066,94,245257,79.96641669383763,7
0.2,3067,93,245350,79.97066492829205,8
0.2,3068,95,245445,79.97556207233626,6
0.2,3069,21,245466,79.95635179153095,12
0.2,3070,94,245560,79.96092478020189,7
0.2,3071,92,245652,79.96484375,9
0.2,3072,90,245742,79.96810933940775,11
0.2,3073,93,245835,79.97234873129473,8
0.2,3074,96,245931,79.97756097560976,6
0.2,3075,88,246019,79.98016905071522,14
0.2,3076,90,246109,79.98342541436465,12
0.2,3077,94,246203,79.98797920727745,7
0.2,3078,93,246296,79.99220526144852,8
0.2,3079,93,246389,79.99642857142857,8
0.2,3080,95,246484,80.00129827977929,6
0.2,3081,90,246574,80.00454250486698,11
0.2,3082,93,246667,80.00875770353552,8
0.2,3083,92,246759,80.01264591439688,9
0.2,3084,94,246853,80.01717990275527,7
0.2,3085,93,246946,80.02138690861958,8
0.2,3086,94,247040,80.02591512795594,7
0.2,3087,25,247065,80.00809585492227,8
0.2,3088,88,247153,80.01068306895435,14
0.2,3089,91,247244,80.01423948220065,10
0.2,3090,23,247267,79.99579424134585,10
0.2,3091,94,247361,80.0003234152652,7
0.2,3092,96,247457,80.00549628192694,6
0.2,3093,94,247551,80.01001939237233,9
0.2,3094,92,247643,80.01389337641358,9
0.2,3095,96,247739,80.01905684754522,7
0.2,3096,94,247833,80.02357119793348,7
0.2,3097,96,247929,80.02872821174951,6
0.2,3098,15,247944,80.00774443368829,19
0.2,3099,94,248038,80.01225806451613,7
0.2,3100,94,248132,80.01676878426314,8
0.2,3101,95,248227,80.02159896840747,6
0.2,3102,95,248322,80.02642603931679,7
0.2,3103,95,248417,80.03125,6
0.2,3104,92,248509,80.03510466988728,10
0.2,3105,89,248598,80.03799098518995,13
0.2,3106,94,248692,80.04248471194077,7
0.2,3107,90,248782,80.04568854568855,12
0.2,3108,94,248876,80.05017690575748,7
0.2,3109,23,248899,80.03183279742765,9
0.2,3110,80,248979,80.03182256509162,21
0.2,3111,24,249003,80.0138174807198,10
0.2,3112,20,249023,79.99453902987472,18
0.2,3113,91,249114,79.9980732177264,10
0.2,3114,84,249198,79.99935794542536,20
0.2,3115,96,249294,80.00449293966624,6
0.2,3116,94,249388,80.00898299647096,7
0.2,3117,90,249478,80.01218729955099,11
0.2,3118,90,249568,80.01538954793203,11
0.2,3119,94,249662,80.01987179487179,7
0.2,3120,84,249746,80.02114706824736,20
0.2,3121,94,249840,80.02562459961563,7
0.2,3122,88,249928,80.02817803394173,13
0.2,3123,95,250023,80.03297055057618,8
0.2,3124,92,250115,80.0368,9
0.2,3125,88,250203,80.03934740882917,13
0.2,3126,91,250294,80.04285257435241,11
0.2,3127,96,250390,80.04795396419438,6
0.2,3128,93,250483,80.0520933205497,8
0.2,3129,96,250579,80.05718849840255,6
0.2,3130,92,250671,80.06100287448099,9
0.2,3131,90,250761,80.06417624521073,11
0.2,3132,90,250851,80.06734759016916,11
0.2,3133,95,250946,80.0721123165284,6
0.2,3134,92,251038,80.07591706539075,9
0.2,3135,96,251134,80.08099489795919,6
0.2,3136,89,251223,80.08383806184253,14
0.2,3137,93,251316,80.08795411089866,8
0.2,3138,83,251399,80.08888180949347,19
0.2,3139,94,251493,80.09331210191083,7
0.2,3140,23,251516,80.075135307227,9
0.2,3141,92,251608,80.07893061744112,9
0.2,3142,92,251700,80.08272351256761,9
0.2,3143,93,251793,80.0868320610687,9
0.2,3144,94,251887,80.0912559618442,7
0.2,3145,95,251982,80.09599491417673,6
0.2,3146,95,252077,80.10073085478233,6
0.2,3147,94,252171,80.1051461245235,7
0.2,3148,92,252263,80.10892346776754,9
0.2,3149,93,252356,80.11301587301587,8
0.2,3150,94,252450,80.11742304030467,7
0.2,3151,95,252545,80.12214467005076,6
0.2,3152,92,252637,80.12591183000318,11
0.2,3153,89,252726,80.1287254280279,12
0.2,3154,95,252821,80.13343898573693,6
0.2,3155,93,252914,80.13751584283904,8
0.2,3156,86,253000,80.13937282229965,15
0.2,3157,96,253096,80.14439518682711,6
0.2,3158,92,253188,80.14814814814815,9
0.2,3159,95,253283,80.15284810126582,7
0.2,3160,96,253379,80.15786143625435,6
0.2,3161,89,253468,80.1606578115117,13
0.2,3162,96,253564,80.16566550742965,6
0.2,3163,92,253656,80.16940581542352,10
0.2,3164,23,253679,80.15134281200632,9
0.2,3165,94,253773,80.15571699305117,7
0.2,3166,95,253868,80.16040416798232,6
0.2,3167,92,253960,80.16414141414141,9
0.2,3168,22,253982,80.14578731461029,10
0.2,3169,93,254075,80.14984227129338,8
0.2,3170,92,254167,80.15357931251971,9
0.2,3171,93,254260,80.15762925598992,8
0.2,3172,94,254354,80.16199180586196,7
0.2,3173,23,254377,80.14398235664777,9
0.2,3174,91,254468,80.14740157480315,11
0.2,3175,95,254563,80.15207808564232,7
0.2,3176,91,254654,80.15549260308467,10
0.2,3177,93,254747,80.15953429830081,8
0.2,3178,91,254838,80.16294432211387,10
0.2,3179,92,254930,80.16666666666667,9
0.2,3180,93,255023,80.17070103740961,8
0.2,3181,92,255115,80.17441860465117,10
0.2,3182,96,255211,80.17939051209551,6
0.2,3183,88,255299,80.18184673366834,13
0.2,3184,21,255320,80.16326530612245,11
0.2,3185,94,255414,80.16760828625236,9
0.2,3186,91,255505,80.17100721681832,12
0.2,3187,20,255525,80.1521329987453,12
0.2,3188,93,255618,80.15616180620884,8
0.2,3189,93,255711,80.1601880877743,9
0.2,3190,95,255806,80.16483860858665,7
0.2,3191,20,255826,80.14598997493734,12
0.2,3192,93,255919,80.15001565925462,8
0.2,3193,95,256014,80.15466499686913,6
0.2,3194,92,256106,80.158372456964,9
0.2,3195,92,256198,80.16207759699624,10
0.2,3196,91,256289,80.16546762589928,10
0.2,3197,93,256382,80.16948092557848,8
0.2,3198,94,256476,80.17380431384808,7
0.2,3199,-48,256428,80.13375,13
0.2,3200,89,256517,80.13651983755076,13
0.2,3201,22,256539,80.11836352279825,10
0.2,3202,92,256631,80.12207305650952,9
0.2,3203,91,256722,80.12546816479401,10
0.2,3204,90,256812,80.12854914196568,12
0.2,3205,87,256899,80.13069245165315,14
0.2,3206,94,256993,80.1350171499844,9
0.2,3207,88,257081,80.13746882793018,13
0.2,3208,93,257174,80.14147709566844,8
0.2,3209,93,257267,80.14548286604361,8
0.2,3210,95,257362,80.15010900031143,8
0.2,3211,85,257447,80.1516189290162,16
0.2,3212,94,257541,80.15592903828198,7
0.2,3213,92,257633,80.15961418792782,9
0.2,3214,94,257727,80.16391912908243,7
0.2,3215,93,257820,80.16791044776119,8
0.2,3216,94,257914,80.1722101336649,7
0.2,3217,93,258007,80.17619639527656,9
0.2,3218,93,258100,80.18018018018019,8
0.2,3219,96,258196,80.18509316770187,6
0.2,3220,94,258290,80.18938217944738,7
0.2,3221,93,258383,80.19335816263191,8
0.2,3222,94,258477,80.19764194849519,11
0.2,3223,92,258569,80.20130272952854,9
0.2,3224,24,258593,80.18387596899225,8
0.2,3225,96,258689,80.1887786732796,6
0.2,3226,87,258776,80.19088937093275,14
0.2,3227,94,258870,80.19516728624535,7
0.2,3228,-47,258823,80.15577578197585,10
0.2,3229,94,258917,80.16006191950464,8
0.2,3230,95,259012,80.16465490560198,6
0.2,3231,95,259107,80.16924504950495,6
0.2,3232,95,259202,80.17383235385091,6
0.2,3233,92,259294,80.17748917748918,9
0.2,3234,95,259389,80.18207109737249,7
0.2,3235,96,259485,80.18695920889988,6
0.2,3236,93,259578,80.19091751621872,9
0.2,3237,91,259669,80.19425571340334,10
0.2,3238,87,259756,80.19635690027786,17
0.2,3239,88,259844,80.19876543209877,14
0.2,3240,21,259865,80.18049984572663,11
0.2,3241,92,259957,80.1841455891425,9
0.2,3242,24,259981,80.1668208448967,8
0.2,3243,20,260001,80.14827373612823,12
0.2,3244,91,260092,80.15161787365177,10
0.2,3245,93,260185,80.15557609365372,9
0.2,3246,94,260279,80.15983985217123,7
0.2,3247,92,260371,80.16348522167488,9
0.2,3248,92,260463,80.16712834718375,10
0.2,3249,93,260556,80.17107692307692,8
0.2,3250,94,260650,80.17533066748693,7
0.2,3251,85,260735,80.17681426814268,16
0.2,3252,92,260827,80.1804488164771,9
0.2,3253,12,260839,80.15949600491703,23
0.2,3254,96,260935,80.16436251920123,6
0.2,3255,89,261024,80.16707616707616,12
0.2,3256,91,261115,80.17040221062328,12
0.2,3257,96,261211,80.17526089625537,7
0.2,3258,96,261307,80.1801166001841,6
0.2,3259,21,261328,80.16196319018405,12
0.2,3260,89,261417,80.16467341306348,12
0.2,3261,24,261441,80.1474555487431,10
0.2,3262,27,261468,80.13116763714373,6
0.2,3263,94,261562,80.13541666666667,7
0.2,3264,93,261655,80.13935681470137,8
0.2,3265,92,261747,80.14298836497244,9
0.2,3266,-120,261627,80.08172635445362,14
0.2,3267,89,261716,80.0844553243574,12
0.2,3268,93,261809,80.0884062404405,8
0.2,3269,85,261894,80.08990825688073,17
0.2,3270,94,261988,80.09416080709263,7
0.2,3271,25,262013,80.07732273838631,8
0.2,3272,13,262026,80.05682859761687,19
0.2,3273,24,262050,80.03970678069639,10
0.2,3274,95,262145,80.0442748091603,6
0.2,3275,26,262171,80.02777777777777,6
0.2,3276,87,262258,80.02990540128167,14
0.2,3277,87,262345,80.0320317266626,14
0.2,3278,84,262429,80.033241842025,18
0.2,3279,91,262520,80.03658536585365,10
0.2,3280,93,262613,80.04053642182261,10
0.2,3281,96,262709,80.04539914686167,6
0.2,3282,95,262804,80.04995431008224,6
0.2,3283,94,262898,80.05420219244823,7
0.2,3284,96,262994,80.05905631659056,6
0.2,3285,93,263087,80.06299452221546,8
0.2,3286,94,263181,80.06723456038941,8
0.2,3287,96,263277,80.0720802919708,6
0.2,3288,93,263370,80.07601094557616,8
0.2,3289,91,263461,80.07933130699088,13
0.2,3290,-118,263343,80.01914311759343,12
0.2,3291,94,263437,80.023390036452,7
0.2,3292,92,263529,80.02702702702703,9
0.2,3293,87,263616,80.02914389799636,14
0.2,3294,94,263710,80.03338391502277,7
0.2,3295,89,263799,80.03610436893204,14
0.2,3296,85,263884,80.03760994843798,16
0.2,3297,23,263907,80.0203153426319,9
0.2,3298,87,263994,80.022431039709,15
0.2,3299,94,264088,80.02666666666667,7
0.2,3300,90,264178,80.02968797334141,11
0.2,3301,93,264271,80.0336159903089,8
0.2,3302,92,264363,80.03723887375114,9
0.2,3303,94,264457,80.04146489104116,7
0.2,3304,94,264551,80.04568835098335,7
0.2,3305,93,264644,80.04960677555958,8
0.2,3306,87,264731,80.05170849712731,14
0.2,3307,87,264818,80.05380894800484,14
0.2,3308,92,264910,80.05741915986702,9
0.2,3309,89,264999,80.06012084592145,12
0.2,3310,14,265013,80.04016913319239,18
0.2,3311,93,265106,80.04408212560386,9
0.2,3312,94,265200,80.04829459704196,7
0.2,3313,93,265293,80.05220277610138,9
0.2,3314,93,265386,80.05610859728507,8
0.2,3315,94,265480,80.06031363088059,8
0.2,3316,93,265573,80.06421465179379,8
0.2,3317,91,265664,80.0675105485232,11
0.2,3318,90,265754,80.07050316360349,12
0.2,3319,85,265839,80.07198795180723,17
0.2,3320,90,265929,80.07497741644083,12
0.2,3321,91,266020,80.07826610475617,10
0.2,3322,-47,265973,80.04002407463136,11
0.2,3323,93,266066,80.0439229843562,8
0.2,3324,88,266154,80.04631578947368,13
0.2,3325,90,266244,80.04930847865303,12
0.2,3326,93,266337,80.0532010820559,9
0.2,3327,27,266364,80.03725961538461,7
0.2,3328,89,266453,80.03995193751878,12
0.2,3329,94,266547,80.04414414414414,7
0.2,3330,90,266637,80.04713299309516,11
0.2,3331,96,266733,80.05192076830733,6
0.2,3332,95,266828,80.05640564056405,9
0.2,3333,91,266919,80.05968806238752,11
0.2,3334,91,267010,80.06296851574213,11
0.2,3335,72,267082,80.06055155875299,32
0.2,3336,25,267107,80.04405154330237,8
0.2,3337,25,267132,80.02756141402037,7
0.2,3338,88,267220,80.02994908655286,14
0.2,3339,94,267314,80.03413173652694,7
0.2,3340,86,267400,80.035917390003,15
0.2,3341,92,267492,80.0394973070018,9
0.2,3342,18,267510,80.02093927609931,14
0.2,3343,91,267601,80.02422248803828,10
0.2,3344,87,267688,80.02630792227205,17
0.2,3345,96,267784,80.03108188882247,7
0.2,3346,95,267879,80.03555422766657,6
0.2,3347,94,267973,80.03972520908005,7
0.2,3348,27,268000,80.0238877276799,6
0.2,3349,6,268006,80.00179104477611,27
0.2,3350,91,268097,80.00507311250374,11
0.2,3351,83,268180,80.00596658711217,21
0.2,3352,95,268275,80.01043841336117,8
0.2,3353,91,268366,80.01371496720334,12
0.2,3354,96,268462,80.01847988077496,6
0.2,3355,91,268553,80.02175208581644,10
0.2,3356,94,268647,80.02591599642538,8
0.2,3357,91,268738,80.02918403811793,11
0.2,3358,93,268831,80.03304554927061,9
0.2,3359,91,268922,80.03630952380952,10
0.2,3360,85,269007,80.03778637310324,16
0.2,3361,89,269096,80.04045211183819,12
0.2,3362,90,269186,80.04341361879274,11
0.2,3363,93,269279,80.04726516052318,8
0.2,3364,94,269373,80.05141158989599,7
0.2,3365,93,269466,80.05525846702318,8
0.2,3366,23,269489,80.03831303831304,10
0.2,3367,93,269582,80.04216152019002,8
0.2,3368,90,269672,80.04511724547343,12
0.2,3369,95,269767,80.04955489614244,6
0.2,3370,90,269857,80.05250667457727,11
0.2,3371,92,269949,80.05604982206405,9
0.2,3372,94,270043,80.0601838126297,7
0.2,3373,83,270126,80.06105512744517,19
0.2,3374,86,270212,80.06281481481481,16
0.2,3375,88,270300,80.06516587677726,13
0.2,3376,91,270391,80.06840390879479,10
0.2,3377,87,270478,80.0704558910598,14
0.2,3378,86,270564,80.07221071322877,16
0.2,3379,86,270650,80.07396449704142,16
0.2,3380,93,270743,80.07778763679384,8
0.2,3381,94,270837,80.081904198699,7
0.2,3382,90,270927,80.08483594442802,14
0.2,3383,84,271011,80.08599290780141,17
0.2,3384,95,271106,80.0903988183161,7
0.2,3385,96,271202,80.09509746012995,6
0.2,3386,86,271288,80.09684086211988,15
0.2,3387,87,271375,80.09887839433294,14
0.2,3388,93,271468,80.10268515786368,8
0.2,3389,93,271561,80.10648967551623,8
0.2,3390,93,271654,80.1102919492775,8
0.2,3391,94,271748,80.11438679245283,7
0.2,3392,95,271843,80.11877394636015,6
0.2,3393,96,271939,80.12345315262228,6
0.2,3394,93,272032,80.12724594992636,9
0.2,3395,92,272124,80.13074204946996,11
0.2,3396,94,272218,80.13482484545187,7
0.2,3397,13,272231,80.11506768687464,22
0.2,3398,-46,272185,80.07796410709032,9
0.2,3399,96,272281,80.08264705882353,6
0.2,3400,91,272372,80.08585710085269,10
0.2,3401,94,272466,80.08994708994709,7
0.2,3402,93,272559,80.09374081692624,8
0.2,3403,25,272584,80.07755581668626,8
0.2,3404,94,272678,80.08164464023496,8
0.2,3405,95,272773,80.08602466236054,6
0.2,3406,84,272857,80.08717346639273,17
0.2,3407,88,272945,80.08949530516432,13
0.2,3408,95,273040,80.09386916984452,6
0.2,3409,94,273134,80.09794721407624,8
0.2,3410,93,273227,80.10172969803577,8
0.2,3411,90,273317,80.1046307151231,12
0.2,3412,90,273407,80.1075300322297,12
0.2,3413,-46,273361,80.07059168131224,10
0.2,3414,-55,273306,80.03103953147877,18
0.2,3415,92,273398,80.03454332552693,9
0.2,3416,93,273491,80.03833772314896,9
0.2,3417,93,273584,80.04212990052662,8
0.2,3418,91,273675,80.04533489324363,10
0.2,3419,93,273768,80.04912280701754,8
0.2,3420,95,273863,80.05349313066355,7
0.2,3421,92,273955,80.05698421975453,9
0.2,3422,94,274049,80.0610575518551,8
0.2,3423,86,274135,80.06279205607477,16
0.2,3424,96,274231,80.06744525547445,6
0.2,3425,95,274326,80.07180385288967,7
0.2,3426,93,274419,80.07557630580683,8
0.2,3427,93,274512,80.07934655775962,9
0.2,3428,-46,274466,80.04257801108194,10
0.2,3429,91,274557,80.0457725947522,10
0.2,3430,87,274644,80.0477994753716,14
0.2,3431,93,274737,80.05157342657343,12
0.2,3432,86,274823,80.05330614622778,15
0.2,3433,89,274912,80.05591147350029,12
0.2,3434,25,274937,80.03988355167394,7
0.2,3435,96,275033,80.04452852153668,6
0.2,3436,92,275125,80.04800698283387,9
0.2,3437,92,275217,80.05148342059337,9
0.2,3438,94,275311,80.05553940098866,8
0.2,3439,92,275403,80.05901162790698,9
0.2,3440,20,275423,80.04155768671897,12
0.2,3441,89,275512,80.04416037187681,12
0.2,3442,95,275607,80.04850421144351,7
0.2,3443,-46,275561,80.01190476190476,10
0.2,3444,93,275654,80.01567489114659,8
0.2,3445,94,275748,80.01973302379571,7
0.2,3446,94,275842,80.02378880185668,7
0.2,3447,88,275930,80.02610208816705,14
0.2,3448,94,276024,80.03015366772978,7
0.2,3449,86,276110,80.03188405797101,15
0.2,3450,94,276204,80.03593161402492,8
0.2,3451,95,276299,80.04026651216687,6
0.2,3452,93,276392,80.04401969302056,9
0.2,3453,96,276488,80.04863925883033,6
0.2,3454,95,276583,80.05296671490593,6
0.2,3455,92,276675,80.05642361111111,9
0.2,3456,92,276767,80.05987850737634,9
0.2,3457,84,276851,80.06101792943898,18
0.2,3458,93,276944,80.06475860075166,8
0.2,3459,91,277035,80.0679190751445,10
0.2,3460,26,277061,80.05229702398151,6
0.2,3461,95,277156,80.05661467359907,6
0.2,3462,92,277248,80.06006352873231,9
0.2,3463,94,277342,80.06408775981524,8
0.2,3464,91,277433,80.06724386724386,11
0.2,3465,83,277516,80.06809001731102,22
0.2,3466,93,277609,80.07182001730602,8
0.2,3467,96,277705,80.07641291810842,6
0.2,3468,92,277797,80.07985010089362,9
0.2,3469,96,277893,80.08443804034582,6
0.2,3470,82,277975,80.0849899164506,20
0.2,3471,91,278066,80.088133640553,11
0.2,3472,23,278089,80.07169594010942,10
0.2,3473,87,278176,80.07369027058147,14
0.2,3474,94,278270,80.07769784172662,7
0.2,3475,90,278360,80.08055235903338,11
0.2,3476,93,278453,80.0842680471671,9
0.2,3477,19,278472,80.06670500287521,13
0.2,3478,94,278566,80.0707099741305,8
0.2,3479,85,278651,80.07212643678162,16
0.2,3480,96,278747,80.07670209709853,6
0.2,3481,93,278840,80.08041355542791,8
0.2,3482,88,278928,80.08268733850129,13
0.2,3483,-49,278879,80.04563719862227,15
0.2,3484,94,278973,80.04964131994261,7
0.2,3485,92,279065,80.0530694205393,10
0.2,3486,94,279159,80.05706911385145,7
0.2,3487,94,279253,80.06106651376147,8
0.2,3488,85,279338,80.06248208655775,16
0.2,3489,94,279432,80.06647564469914,8
0.2,3490,94,279526,80.0704669149241,7
0.2,3491,89,279615,80.07302405498282,12
0.2,3492,86,279701,80.07472087031205,16
0.2,3493,92,279793,80.07813394390384,9
0.2,3494,96,279889,80.0826895565093,6
0.2,3495,94,279983,80.0866704805492,8
0.2,3496,92,280075,80.09007720903632,9
0.2,3497,95,280170,80.09433962264151,6
0.2,3498,91,280261,80.09745641611889,10
0.2,3499,24,280285,80.08142857142857,10
0.2,3500,93,280378,80.0851185375607,8
0.2,3501,85,280463,80.08652198743575,16
0.2,3502,93,280556,80.09020839280616,9
0.2,3503,22,280578,80.0736301369863,11
0.2,3504,94,280672,80.07760342368046,7
0.2,3505,18,280690,80.05989731888192,15
0.2,3506,91,280781,80.06301682349587,10
0.2,3507,92,280873,80.0664196123147,9
0.2,3508,-48,280825,80.02992305500142,11
0.2,3509,91,280916,80.03304843304844,12
0.2,3510,94,281010,80.03702648818,8
0.2,3511,89,281099,80.03957858769931,12
0.2,3512,94,281193,80.04355251921434,7
0.2,3513,89,281282,80.04610130904952,13
0.2,3514,96,281378,80.05064011379801,6
0.2,3515,90,281468,80.05346985210467,11
0.2,3516,95,281563,80.05771964742678,6
0.2,3517,90,281653,80.060545764639,11
0.2,3518,95,281748,80.06479113384484,6
0.2,3519,94,281842,80.06875,7
0.2,3520,88,281930,80.07100255609203,13
0.2,3521,25,281955,80.05536626916525,7
0.2,3522,94,282049,80.05932443939824,7
0.2,3523,96,282145,80.0638479001135,6
0.2,3524,96,282241,80.06836879432625,6
0.2,3525,93,282334,80.07203630175836,8
0.2,3526,89,282423,80.07456762120782,12
0.2,3527,92,282515,80.07794784580499,10
0.2,3528,91,282606,80.0810427883253,10
0.2,3529,17,282623,80.06317280453258,17
0.2,3530,88,282711,80.06542056074767,14
0.2,3531,95,282806,80.0696489241223,6
0.2,3532,94,282900,80.07359184828758,8
0.2,3533,90,282990,80.07640067911714,11
0.2,3534,95,283085,80.08062234794907,6
0.2,3535,91,283176,80.08371040723982,10
0.2,3536,94,283270,80.0876448968052,7
0.2,3537,92,283362,80.09101187111362,9
0.2,3538,22,283384,80.07459734388246,10
0.2,3539,94,283478,80.07853107344633,7
0.2,3540,91,283569,80.08161536289184,11
0.2,3541,95,283664,80.085827216262,6
0.2,3542,89,283753,80.08834321196726,12
0.2,3543,90,283843,80.09113995485328,11
0.2,3544,94,283937,80.0950634696756,7
0.2,3545,87,284024,80.09701071630006,14
0.2,3546,93,284117,80.10064843529743,8
0.2,3547,92,284209,80.10400225479142,10
0.2,3548,91,284300,80.10707241476472,10
0.2,3549,92,284392,80.11042253521127,9
0.2,3550,93,284485,80.11405237961138,9
0.2,3551,90,284575,80.11683558558559,14
0.2,3552,94,284669,80.12074303405572,8
0.2,3553,89,284758,80.12324141812043,12
0.2,3554,90,284848,80.12601969057665,11
0.2,3555,94,284942,80.12992125984252,7
0.2,3556,89,285031,80.13241495642396,12
0.2,3557,95,285126,80.13659359190557,6
0.2,3558,90,285216,80.13936499016577,12
0.2,3559,94,285310,80.1432584269663,7
0.2,3560,90,285400,80.14602639707947,11
0.2,3561,91,285491,80.14907355418305,10
0.2,3562,92,285583,80.15239966320516,9
0.2,3563,25,285608,80.13692480359147,7
0.2,3564,92,285700,80.14025245441795,9
0.2,3565,96,285796,80.14469994391474,6
0.2,3566,-53,285743,80.10737314269694,17
0.2,3567,-48,285695,80.07146860986548,11
0.2,3568,94,285789,80.07537125245166,7
0.2,3569,92,285881,80.07871148459384,10
0.2,3570,20,285901,80.06188742649118,12
0.2,3571,25,285926,80.0464725643897,7
0.2,3572,85,286011,80.04785894206549,16
0.2,3573,93,286104,80.05148293228875,8
0.2,3574,93,286197,80.05510489510489,8
0.2,3575,87,286284,80.05704697986577,15
0.2,3576,89,286373,80.05954710651383,13
0.2,3577,17,286390,80.04192286193404,15
0.2,3578,23,286413,80.02598491198658,9
0.2,3579,92,286505,80.02932960893855,9
0.2,3580,26,286531,80.01424183189053,6
0.2,3581,92,286623,80.01758793969849,9
0.2,3582,92,286715,80.02093217973766,9
0.2,3583,91,286806,80.02399553571429,10
0.2,3584,21,286827,80.00753138075314,12
0.2,3585,26,286853,79.99247071946458,7
0.2,3586,89,286942,79.99498187900753,16
0.2,3587,88,287030,79.99721293199553,14
0.2,3588,23,287053,79.98133184731122,9
0.2,3589,94,287147,79.98523676880222,7
0.2,3590,94,287241,79.9891395154553,7
0.2,3591,23,287264,79.97327394209354,9
0.2,3592,94,287358,79.9771778458113,8
0.2,3593,94,287452,79.9810795770729,7
0.2,3594,95,287547,79.98525730180806,6
0.2,3595,88,287635,79.98748609566185,14
0.2,3596,90,287725,79.99026966916875,11
0.2,3597,95,287820,79.99444135630905,8
0.2,3598,90,287910,79.99722145040289,11
0.2,3599,88,287998,79.99944444444445,13
0.2,3600,94,288092,80.00333240766454,7
0.2,3601,88,288180,80.00555247084952,13
0.2,3602,23,288203,79.98973077990563,9
0.2,3603,93,288296,79.99334073251943,8
0.2,3604,88,288384,79.99556171983356,13
0.2,3605,91,288475,79.99861342207431,10
0.2,3606,90,288565,80.00138619351262,11
0.2,3607,25,288590,79.98614190687361,8
0.2,3608,96,288686,79.99057910778609,6
0.2,3609,93,288779,79.99418282548477,9
0.2,3610,94,288873,79.99806147881473,7
0.2,3611,90,288963,80.00083056478405,12
0.2,3612,89,289052,80.00332133960697,12
0.2,3613,95,289147,80.00747094631987,6
0.2,3614,93,289240,80.01106500691563,8
0.2,3615,94,289334,80.01493362831859,8
0.2,3616,93,289427,80.01852363837435,9
0.2,3617,26,289453,80.00359314538419,6
0.2,3618,94,289547,80.00746062448191,7
0.2,3619,93,289640,80.01104972375691,8
0.2,3620,93,289733,80.01463684065175,10
0.2,3621,96,289829,80.0190502484815,6
0.2,3622,93,289922,80.0226331769252,9
0.2,3623,95,290017,80.02676600441501,8
0.2,3624,92,290109,80.03006896551724,9
0.2,3625,95,290204,80.03419746276889,6
0.2,3626,89,290293,80.0366694237662,12
0.2,3627,-57,290236,79.99889746416758,20
0.2,3628,94,290330,80.0027555800496,7
0.2,3629,92,290422,80.0060606060606,9
0.2,3630,90,290512,80.00881299917378,11
0.2,3631,92,290604,80.01211453744493,10
0.2,3632,91,290695,80.01513900357831,11
0.2,3633,89,290784,80.01761144744084,12
0.2,3634,88,290872,80.01980742778542,13
0.2,3635,91,290963,80.02282728272827,11
0.2,3636,92,291055,80.02612042892494,9
0.2,3637,94,291149,80.0299615173172,7
0.2,3638,92,291241,80.0332508931025,10
0.2,3639,95,291336,80.03736263736263,8
0.2,3640,95,291431,80.04147212304312,6
0.2,3641,91,291522,80.04448105436573,10
0.2,3642,93,291615,80.04803733186934,9
0.2,3643,91,291706,80.05104281009879,10
0.2,3644,94,291800,80.05486968449931,8
0.2,3645,93,291893,80.05842018650576,10
0.2,3646,-44,291849,80.02440361941322,8
0.2,3647,94,291943,80.02823464912281,7
0.2,3648,93,292036,80.03178953137846,9
0.2,3649,24,292060,80.01643835616439,8
0.2,3650,94,292154,80.02026841961107,7
0.2,3651,20,292174,80.00383351588171,13
0.2,3652,93,292267,80.00739118532712,8
0.2,3653,91,292358,80.0103995621237,11
0.2,3654,90,292448,80.01313269493843,12
0.2,3655,93,292541,80.01668490153173,9
0.2,3656,22,292563,80.0008203445447,11
0.2,3657,22,292585,79.98496446145435,10
0.2,3658,92,292677,79.98824815523368,9
0.2,3659,95,292772,79.99234972677596,6
0.2,3660,96,292868,79.99672220704726,6
0.2,3661,91,292959,79.9997269251775,11
0.2,3662,96,293055,80.004095004095,6
0.2,3663,-45,293010,79.96997816593887,9
0.2,3664,93,293103,79.97353342428377,9
0.2,3665,96,293199,79.97790507364975,6
0.2,3666,92,293291,79.98118352877012,9
0.2,3667,96,293387,79.98555070883314,6
0.2,3668,25,293412,79.97056418642681,8
0.2,3669,93,293505,79.97411444141689,8
0.2,3670,88,293593,79.97630073549442,13
0.2,3671,85,293678,79.9776688453159,16
0.2,3672,27,293705,79.96324530356657,6
0.2,3673,92,293797,79.96652150244965,10
0.2,3674,90,293887,79.96925170068027,13
0.2,3675,23,293910,79.9537540805223,9
0.2,3676,93,294003,79.95730214849061,8
0.2,3677,91,294094,79.96030451332246,10
0.2,3678,96,294190,79.96466431095406,6
0.2,3679,96,294286,79.96902173913044,6
0.2,3680,94,294380,79.97283346916599,7
0.2,3681,94,294474,79.97664312873438,7
0.2,3682,94,294568,79.98045071952212,8
0.2,3683,94,294662,79.98425624321389,7
0.2,3684,95,294757,79.98833107191317,6
0.2,3685,92,294849,79.99158979924037,9
0.2,3686,90,294939,79.99430431244915,11
0.2,3687,93,295032,79.99783080260303,8
0.2,3688,95,295127,80.00189753320683,6
0.2,3689,-120,295007,79.94769647696477,14
0.2,3690,88,295095,79.94987808182064,14
0.2,3691,95,295190,79.95395449620801,6
0.2,3692,94,295284,79.95775792038992,8
0.2,3693,94,295378,79.96155928532755,8
0.2,3694,88,295466,79.9637347767253,13
0.2,3695,95,295561,79.96780303030303,8
0.2,3696,92,295653,79.97105761428185,9
0.2,3697,19,295672,79.9545700378583,14
0.2,3698,92,295764,79.95782643957827,9
0.2,3699,24,295788,79.9427027027027,8
0.2,3700,24,295812,79.92758713861119,8
0.2,3701,96,295908,79.9319286871961,6
0.2,3702,96,296004,79.93626789089927,6
0.2,3703,23,296027,79.92089632829374,10
0.2,3704,24,296051,79.90580296896087,8
0.2,3705,87,296138,79.9077172153265,14
0.2,3706,92,296230,79.91097922848665,10
0.2,3707,92,296322,79.91423948220064,9
0.2,3708,96,296418,79.91857643569695,6
0.2,3709,89,296507,79.92102425876011,12
0.2,3710,81,296588,79.92131500943142,20
0.2,3711,93,296681,79.92483836206897,8
0.2,3712,87,296768,79.92674387287907,19
0.2,3713,93,296861,79.93026386645127,9
0.2,3714,94,296955,79.93405114401077,8
0.2,3715,88,297043,79.93622174381055,13
0.2,3716,86,297129,79.93785310734464,18
0.2,3717,26,297155,79.92334588488434,7
0.2,3718,96,297251,79.92766872815272,6
0.2,3719,96,297347,79.93198924731183,6
0.2,3720,96,297443,79.93630744423542,6
0.2,3721,92,297535,79.93954862976894,9
0.2,3722,91,297626,79.94251947354284,10
0.2,3723,95,297721,79.94656283566059,6
0.2,3724,89,297810,79.9489932885906,14
0.2,3725,95,297905,79.95303274288781,7
0.2,3726,96,298001,79.9573383418299,6
0.2,3727,91,298092,79.96030042918454,10
0.2,3728,25,298117,79.94556181281845,7
0.2,3729,96,298213,79.94986595174262,6
0.2,3730,94,298307,79.95363173411954,8
0.2,3731,94,298401,79.95739549839229,7
0.2,3732,93,298494,79.96088936512189,8
0.2,3733,96,298590,79.96518478843063,7
0.2,3734,18,298608,79.94859437751003,15
0.2,3735,87,298695,79.9504817987152,15
0.2,3736,22,298717,79.93497457853894,10
0.2,3737,17,298734,79.91813804173354,15
0.2,3738,93,298827,79.92163680128377,8
0.2,3739,93,298920,79.92513368983957,8
0.2,3740,90,299010,79.92782678428227,13
0.2,3741,93,299103,79.93132014965259,9
0.2,3742,93,299196,79.93481164841036,8
0.2,3743,95,299291,79.93883547008546,6
0.2,3744,94,299385,79.94259012016022,8
0.2,3745,93,299478,79.94607581420182,9
0.2,3746,90,299568,79.94875900720577,11
0.2,3747,94,299662,79.95250800426895,9
0.2,3748,87,299749,79.95438783675647,14
0.2,3749,89,299838,79.9568,12
0.2,3750,94,299932,79.960543854972,7
0.2,3751,91,300023,79.96348614072495,10
0.2,3752,92,300115,79.96669331201706,10
0.2,3753,92,300207,79.96989877464038,10
0.2,3754,94,300301,79.97363515312917,8
0.2,3755,94,300395,79.97736954206603,7
0.2,3756,25,300420,79.962736225712,8
0.2,3757,89,300509,79.96514103246408,13
0.2,3758,90,300599,79.96781058792232,11
0.2,3759,88,300687,79.96994680851064,13
0.2,3760,88,300775,79.97208189311354,13
0.2,3761,19,300794,79.9558745348219,13
0.2,3762,16,300810,79.93887855434494,16
0.2,3763,89,300899,79.94128586609989,12
0.2,3764,93,300992,79.94475431606905,9
0.2,3765,94,301086,79.94848645778013,7
0.2,3766,96,301182,79.9527475444651,6
0.2,3767,92,301274,79.95594479830149,9
0.2,3768,94,301368,79.95967100026532,7
0.2,3769,90,301458,79.96233421750664,11
0.2,3770,93,301551,79.96579156722355,8
0.2,3771,88,301639,79.96792152704136,14
0.2,3772,87,301726,79.9697853167241,14
0.2,3773,96,301822,79.9740328563858,6
0.2,3774,90,301912,79.97668874172186,11
0.2,3775,95,302007,79.98066737288136,7
0.2,3776,93,302100,79.98411437648927,8
0.2,3777,96,302196,79.98835362625728,6
0.2,3778,89,302285,79.99073829055305,14
0.2,3779,89,302374,79.9931216931217,12
0.2,3780,92,302466,79.99629727585295,10
0.2,3781,94,302560,80.0,7
0.2,3782,95,302655,80.0039651070579,7
0.2,3783,94,302749,80.00766384778012,7
0.2,3784,95,302844,80.01162483487451,6
0.2,3785,88,302932,80.01373481246698,13
0.2,3786,96,303028,80.01795616583047,7
0.2,3787,94,303122,80.02164730728617,7
0.2,3788,90,303212,80.02428081287938,11
0.2,3789,95,303307,80.02823218997362,6
0.2,3790,96,303403,80.03244526510156,6
0.2,3791,94,303497,80.03612869198312,8
0.2,3792,93,303590,80.03954653308726,9
0.2,3793,91,303681,80.04243542435424,11
0.2,3794,22,303703,80.02714097496707,12
0.2,3795,90,303793,80.02976817702844,11
0.2,3796,96,303889,80.03397419015012,6
0.2,3797,95,303984,80.03791469194313,7
0.2,3798,92,304076,80.04106343774677,9
0.2,3799,96,304172,80.04526315789474,6
0.2,3800,95,304267,80.04919757958432,8
0.2,3801,88,304355,80.05128879537085,14
0.2,3802,92,304447,80.05443071259532,10
0.2,3803,94,304541,80.0580967402734,8
0.2,3804,24,304565,80.04336399474376,8
0.2,3805,94,304659,80.0470310036784,9
0.2,3806,93,304752,80.05043341213553,8
0.2,3807,96,304848,80.0546218487395,6
0.2,3808,90,304938,80.05723286951955,11
0.2,3809,93,305031,80.06062992125985,8
0.2,3810,88,305119,80.06271319863554,13
0.2,3811,91,305210,80.06558237145855,10
0.2,3812,20,305230,80.04982953055337,13
0.2,3813,95,305325,80.05374934452018,6
0.2,3814,92,305417,80.05688073394495,9
0.2,3815,91,305508,80.05974842767296,11
0.2,3816,93,305601,80.06313859051612,9
0.2,3817,95,305696,80.06705081194343,6
0.2,3818,95,305791,80.07096098455094,7
0.2,3819,89,305880,80.07329842931937,13
0.2,3820,95,305975,80.07720492017796,6
0.2,3821,94,306069,80.08084772370486,8
0.2,3822,90,306159,80.08344232278316,11
0.2,3823,23,306182,80.06851464435147,9
0.2,3824,95,306277,80.0724183006536,6
0.2,3825,91,306368,80.07527443805542,11
0.2,3826,94,306462,80.07891298667363,8
0.2,3827,94,306556,80.08254963427378,7
0.2,3828,91,306647,80.0854008879603,13
0.2,3829,93,306740,80.088772845953,8
0.2,3830,94,306834,80.09240407204385,7
0.2,3831,94,306928,80.09603340292276,7
0.2,3832,94,307022,80.09966084007306,7
0.2,3833,23,307045,80.08476786645801,9
0.2,3834,94,307139,80.0883963494133,8
0.2,3835,92,307231,80.0915015641293,9
0.2,3836,23,307254,80.0766223612197,9
0.2,3837,20,307274,80.06096925482022,12
0.2,3838,90,307364,80.06355821828602,11
0.2,3839,89,307453,80.06588541666666,13
0.2,3840,92,307545,80.06899244988284,9
0.2,3841,22,307567,80.05387818844352,10
0.2,3842,91,307658,80.05672651574291,10
0.2,3843,94,307752,80.06035379812695,7
0.2,3844,89,307841,80.06267880364109,12
0.2,3845,95,307936,80.0665626625065,8
0.2,3846,93,308029,80.06992461658434,8
0.2,3847,95,308124,80.07380457380458,7
0.2,3848,91,308215,80.07664328396986,10
0.2,3849,88,308303,80.0787012987013,13
0.2,3850,96,308399,80.08283562710984,6
0.2,3851,93,308492,80.08618899273105,10
0.2,3852,92,308584,80.08928107967817,10
0.2,3853,91,308675,80.09211209133368,10
0.2,3854,23,308698,80.07730220492867,9
0.2,3855,90,308788,80.0798755186722,11
0.2,3856,24,308812,80.06533575317604,8
0.2,3857,84,308896,80.06635562467599,18
0.2,3858,88,308984,80.06841150557139,13
0.2,3859,95,309079,80.07227979274612,6
0.2,3860,89,309168,80.07459207459208,14
0.2,3861,96,309264,80.07871569135163,6
0.2,3862,90,309354,80.08128397618431,11
0.2,3863,92,309446,80.0843685300207,10
0.2,3864,95,309541,80.0882276843467,6
0.2,3865,90,309631,80.09079151577858,11
0.2,3866,93,309724,80.09412981639514,8
0.2,3867,95,309819,80.09798345398139,6
0.2,3868,89,309908,80.10028431119152,12
0.2,3869,93,310001,80.10361757105943,9
0.2,3870,95,310096,80.10746577111857,7
0.2,3871,92,310188,80.11053719008264,9
0.2,3872,96,310284,80.1146398140976,6
0.2,3873,94,310378,80.11822405782138,8
0.2,3874,19,310397,80.10245161290322,15
0.2,3875,16,310413,80.08591331269349,18
0.2,3876,94,310507,80.08950219241682,7
0.2,3877,94,310601,80.09308922124806,7
0.2,3878,93,310694,80.09641660221706,8
0.2,3879,93,310787,80.09974226804124,8
0.2,3880,92,310879,80.10280855449626,10
0.2,3881,94,310973,80.10638845955692,7
0.2,3882,93,311066,80.10970898789596,8
0.2,3883,94,311160,80.11328527291452,7
0.2,3884,91,311251,80.11608751608752,11
0.2,3885,94,311345,80.11966031909418,8
0.2,3886,92,311437,80.1227167481348,10
0.2,3887,92,311529,80.12577160493827,9
0.2,3888,18,311547,80.10979686294678,14
0.2,3889,-47,311500,80.0771208226221,10
0.2,3890,93,311593,80.0804420457466,8
0.2,3891,95,311688,80.08427543679342,7
0.2,3892,87,311775,80.0860518880041,14
0.2,3893,93,311868,80.08936825885978,8
0.2,3894,88,311956,80.09139922978177,13
0.2,3895,88,312044,80.09342915811088,14
0.2,3896,93,312137,80.09674108288426,8
0.2,3897,91,312228,80.09953822473064,10
0.2,3898,92,312320,80.10259040779687,9
0.2,3899,94,312414,80.10615384615384,7
0.2,3900,94,312508,80.10971545757498,7
0.2,3901,94,312602,80.11327524346488,7
0.2,3902,92,312694,80.11632077888804,9
0.2,3903,95,312789,80.12013319672131,6
0.2,3904,96,312885,80.12419974391806,6
0.2,3905,94,312979,80.12775217613927,7
0.2,3906,24,313003,80.11338622984387,8
0.2,3907,84,313087,80.11438075742068,17
0.2,3908,90,313177,80.11690969557432,12
0.2,3909,92,313269,80.11994884910486,9
0.2,3910,89,313358,80.12221938123243,12
0.2,3911,92,313450,80.12525562372188,9
0.2,3912,92,313542,80.12829031433682,9
0.2,3913,94,313636,80.1318344404701,7
0.2,3914,92,313728,80.13486590038315,9
0.2,3915,94,313822,80.13840653728295,7
0.2,3916,94,313916,80.1419453663518,7
0.2,3917,91,314007,80.14471669218989,12
0.2,3918,95,314102,80.14850727226333,6
0.2,3919,21,314123,80.13341836734693,11
0.2,3920,90,314213,80.13593471053302,12
0.2,3921,89,314302,80.13819479857216,12
0.2,3922,94,314396,80.14172826918175,7
0.2,3923,93,314489,80.14500509683995,9
0.2,3924,95,314584,80.1487898089172,6
0.2,3925,94,314678,80.1523178807947,7
0.2,3926,93,314771,80.15558950853068,9
0.2,3927,87,314858,80.15733197556008,14
0.2,3928,90,314948,80.15983710867906,11
0.2,3929,94,315042,80.16335877862595,7
0.2,3930,89,315131,80.16560671584838,12
0.2,3931,92,315223,80.16861648016277,9
0.2,3932,95,315318,80.1723874904653,7
0.2,3933,92,315410,80.17539400101678,9
0.2,3934,-50,315360,80.1423125794155,13
0.2,3935,90,315450,80.14481707317073,11
0.2,3936,93,315543,80.14808229616459,8
0.2,3937,-49,315494,80.11528694768919,12
0.2,3938,88,315582,80.11728865194212,13
0.2,3939,94,315676,80.12081218274112,8
0.2,3940,84,315760,80.12179649835068,17
0.2,3941,90,315850,80.12430238457635,11
0.2,3942,88,315938,80.1262997717474,13
0.2,3943,93,316031,80.12956389452333,8
0.2,3944,92,316123,80.13257287705957,9
0.2,3945,90,316213,80.13507349214395,11
0.2,3946,95,316308,80.13883962503166,7
0.2,3947,94,316402,80.14235055724417,7
0.2,3948,94,316496,80.14585971131932,9
0.2,3949,88,316584,80.14784810126582,13
0.2,3950,89,316673,80.1500885851683,12
0.2,3951,-47,316626,80.11791497975709,13
0.2,3952,93,316719,80.12117379205667,9
0.2,3953,93,316812,80.12443095599393,8
0.2,3954,92,316904,80.12743362831858,9
0.2,3955,92,316996,80.1304347826087,9
0.2,3956,91,317087,80.13318170331058,10
0.2,3957,93,317180,80.13643254168773,8
0.2,3958,23,317203,80.12200050517808,9
0.2,3959,21,317224,80.1070707070707,13
0.2,3960,94,317318,80.11057813683414,8
0.2,3961,91,317409,80.11332660272589,10
0.2,3962,95,317504,80.11708301791572,6
0.2,3963,93,317597,80.12033299697275,9
0.2,3964,94,317691,80.12383354350567,7
0.2,3965,92,317783,80.12682803832577,9
0.2,3966,92,317875,80.12982102344341,9
0.2,3967,25,317900,80.11592741935483,7
0.2,3968,21,317921,80.10103300579492,13
0.2,3969,91,318012,80.10377833753148,10
0.2,3970,90,318102,80.1062704608411,11
0.2,3971,95,318197,80.1100201409869,6
0.2,3972,93,318290,80.1132645356154,8
0.2,3973,88,318378,80.11524911927529,15
0.2,3974,94,318472,80.11874213836478,7
0.2,3975,92,318564,80.12173038229376,9
0.2,3976,89,318653,80.12396278601962,12
0.2,3977,93,318746,80.12719959778784,8
0.2,3978,89,318835,80.12942950490073,14
0.2,3979,25,318860,80.11557788944724,7
0.2,3980,92,318952,80.11856317508163,10
0.2,3981,90,319042,80.1210447011552,11
0.2,3982,92,319134,80.12402711523977,9
0.2,3983,93,319227,80.12725903614458,8
0.2,3984,93,319320,80.13048933500627,9
0.2,3985,86,319406,80.13196186653286,15
0.2,3986,90,319496,80.13443691998997,11
0.2,3987,94,319590,80.13791374122367,7
0.2,3988,95,319685,80.14163950864878,6
0.2,3989,-48,319637,80.10952380952381,11
0.2,3990,22,319659,80.09496366825357,12
0.2,3991,95,319754,80.09869739478958,6
0.2,3992,96,319850,80.10267968945655,6
0.2,3993,91,319941,80.10540811216825,10
0.2,3994,90,320031,80.10788485607009,11
0.2,3995,88,320119,80.10985985985985,13
0.2,3996,93,320212,80.11308481361021,9
0.2,3997,91,320303,80.11580790395197,11
0.2,3998,94,320397,80.11927981995498,7
0.2,3999,96,320493,80.12325,6
0.2,4000,89,320582,80.12546863284179,12
0.2,4001,96,320678,80.12943528235883,6
0.2,4002,96,320774,80.13339995003747,7
0.2,4003,90,320864,80.13586413586414,11
0.2,4004,87,320951,80.13757802746566,14
0.2,4005,92,321043,80.14053919121318,10
0.2,4006,92,321135,80.14349887696531,9
0.2,4007,92,321227,80.14645708582835,9
0.2,4008,93,321320,80.14966325767024,8
0.2,4009,25,321345,80.1359102244389,7
0.2,4010,96,321441,80.13986537023186,6
0.2,4011,89,321530,80.14207377866401,12
0.2,4012,94,321624,80.14552703712933,7
0.2,4013,24,321648,80.13153961136024,8
0.2,4014,94,321742,80.13499377334993,7
0.2,4015,91,321833,80.13769920318725,10
0.2,4016,94,321927,80.1411501120239,8
0.2,4017,94,322021,80.14459930313589,7
0.2,4018,94,322115,80.14804677780542,8
0.2,4019,84,322199,80.14900497512438,17
0.2,4020,94,322293,80.15244963939318,7
0.2,4021,95,322388,80.156141223272,8
0.2,4022,96,322484,80.16007954262987,6
0.2,4023,93,322577,80.1632703777336,8
0.2,4024,87,322664,80.16496894409939,14
0.2,4025,93,322757,80.16815697963239,9
0.2,4026,93,322850,80.17134343183511,8
0.2,4027,92,322942,80.17428003972195,9
0.2,4028,25,322967,80.16058575328866,7
0.2,4029,96,323063,80.16451612903226,6
0.2,4030,25,323088,80.1508310592905,7
0.2,4031,95,323183,80.15451388888889,6
0.2,4032,96,323279,80.15844284651624,6
0.2,4033,94,323373,80.16187407040158,7
0.2,4034,94,323467,80.16530359355639,7
0.2,4035,96,323563,80.16922695738354,6
0.2,4036,84,323647,80.17017587317315,17
0.2,4037,90,323737,80.17261020307083,13
0.2,4038,89,323826,80.17479574152019,12
0.2,4039,95,323921,80.17846534653465,6
0.2,4040,93,324014,80.18163820836426,9
0.2,4041,92,324106,80.1845620979713,10
0.2,4042,94,324200,80.187979223349,7
0.2,4043,90,324290,80.19040553907023,12
0.2,4044,25,324315,80.17676143386898,7
0.2,4045,91,324406,80.17943648047455,11
0.2,4046,88,324494,80.18136891524586,13
0.2,4047,93,324587,80.18453557312253,8
0.2,4048,85,324672,80.18572487033836,16
0.2,4049,92,324764,80.18864197530864,9
0.2,4050,16,324780,80.17279684028635,16
0.2,4051,89,324869,80.17497532082922,13
0.2,4052,90,324959,80.17739945719221,15
0.2,4053,92,325051,80.18031573754317,10
0.2,4054,92,325143,80.18323057953144,9
0.2,4055,94,325237,80.18663708086785,7
0.2,4056,91,325328,80.18930244022677,10
0.2,4057,91,325419,80.19196648595367,10
0.2,4058,89,325508,80.19413648681942,14
0.2,4059,95,325603,80.19778325123153,6
0.2,4060,88,325691,80.19970450627925,13
0.2,4061,25,325716,80.1861152141802,7
0.2,4062,25,325741,80.17253261137091,7
0.2,4063,93,325834,80.17568897637796,10
0.2,4064,94,325928,80.1790897908979,7
0.2,4065,95,326023,80.1827348745696,6
0.2,4066,91,326114,80.18539463978362,11
0.2,4067,92,326206,80.18829891838742,9
0.2,4068,90,326296,80.19071024821824,11
0.2,4069,93,326389,80.1938574938575,8
0.2,4070,91,326480,80.19651191353476,10
0.2,4071,93,326573,80.1996561886051,10
0.2,4072,95,326668,80.20328995826172,7
0.2,4073,94,326762,80.206676485027,7
0.2,4074,94,326856,80.21006134969325,7
0.2,4075,23,326879,80.19602551521099,9
0.2,4076,92,326971,80.19892077507971,11
0.2,4077,90,327061,80.20132417851889,11
0.2,4078,90,327151,80.20372640353028,11
0.2,4079,90,327241,80.20612745098039,11
0.2,4080,92,327333,80.20901739769664,11
0.2,4081,25,327358,80.1954924056835,7
0.2,4082,94,327452,80.19887337741856,8
0.2,4083,23,327475,80.18486777668952,9
0.2,4084,96,327571,80.18873929008568,6
0.2,4085,92,327663,80.19162995594714,9
0.2,4086,92,327755,80.19451920724248,9
0.2,4087,93,327848,80.19765166340508,8
0.2,4088,92,327940,80.2005380288579,9
0.2,4089,11,327951,80.18361858190708,22
0.2,4090,92,328043,80.18650696651186,9
0.2,4091,92,328135,80.18939393939394,9
0.2,4092,95,328230,80.19301246029806,7
0.2,4093,27,328257,80.1800195407914,7
0.2,4094,94,328351,80.18339438339439,7
0.2,4095,91,328442,80.18603515625,14
0.2,4096,94,328536,80.18940688308518,7
0.2,4097,23,328559,80.1754514397267,9
0.2,4098,93,328652,80.17858014149793,8
0.2,4099,95,328747,80.18219512195122,7
0.2,4100,91,328838,80.18483296756888,10
0.2,4101,94,328932,80.18820087762067,7
0.2,4102,88,329020,80.19010480136485,15
0.2,4103,95,329115,80.19371345029239,6
0.2,4104,90,329205,80.19610231425091,12
0.2,4105,82,329287,80.19654164637116,21
0.2,4106,92,329379,80.19941563184807,9
0.2,4107,92,329471,80.20228821811101,9
0.2,4108,95,329566,80.20588951082989,6
0.2,4109,93,329659,80.20900243309002,9
0.2,4110,95,329754,80.21260034054974,6
0.2,4111,92,329846,80.21546692607004,10
0.2,4112,94,329940,80.21881838074398,8
0.2,4113,92,330032,80.22168206125426,10
0.2,4114,93,330125,80.22478736330498,8
0.2,4115,93,330218,80.22789115646259,8
0.2,4116,15,330233,80.21204760748118,18
0.2,4117,93,330326,80.21515298688684,8
0.2,4118,93,330419,80.21825685846079,8
0.2,4119,23,330442,80.20436893203883,10
0.2,4120,95,330537,80.20795923319582,6
0.2,4121,93,330630,80.21106259097526,8
0.2,4122,92,330722,80.21392190152801,10
0.2,4123,96,330818,80.21774975751697,6
0.2,4124,25,330843,80.20436363636364,7
0.2,4125,96,330939,80.20819195346583,6
0.2,4126,81,331020,80.20838381390841,21
0.2,4127,95,331115,80.21196705426357,7
0.2,4128,24,331139,80.19835311213369,9
0.2,4129,96,331235,80.20217917675545,6
0.2,4130,96,331331,80.20600338900992,6
0.2,4131,91,331422,80.20861568247823,11
0.2,4132,95,331517,80.21219453181708,7
0.2,4133,88,331605,80.21407837445574,13
0.2,4134,93,331698,80.21717049576783,8
0.2,4135,95,331793,80.22074468085107,8
0.2,4136,96,331889,80.22455885907662,6
0.2,4137,19,331908,80.20976317061383,16
0.2,4138,93,332001,80.21285334621889,10
0.2,4139,94,332095,80.21618357487922,7
0.2,4140,93,332188,80.21927070755856,9
0.2,4141,84,332272,80.22018348623853,17
0.2,4142,82,332354,80.22061308230751,19
0.2,4143,92,332446,80.2234555984556,9
0.2,4144,94,332540,80.22677925211097,7
0.2,4145,95,332635,80.23034249879402,8
0.2,4146,92,332727,80.23318061249095,11
0.2,4147,96,332823,80.23698167791707,6
0.2,4148,90,332913,80.23933477946493,12
0.2,4149,95,333008,80.24289156626506,6
0.2,4150,94,333102,80.24620573355818,8
0.2,4151,25,333127,80.23289980732177,7
0.2,4152,96,333223,80.23669636407416,6
0.2,4153,85,333308,80.23784304285026,16
0.2,4154,24,333332,80.2243080625752,8
0.2,4155,94,333426,80.22762271414823,7
0.2,4156,94,333520,80.2309357709887,8
0.2,4157,90,333610,80.23328523328523,11
0.2,4158,92,333702,80.23611445058908,9
0.2,4159,95,333797,80.23966346153846,6
0.2,4160,91,333888,80.2422494592646,12
0.2,4161,85,333973,80.24339259971168,16
0.2,4162,94,334067,80.24669709344222,8
0.2,4163,95,334162,80.25024015369837,8
0.2,4164,93,334255,80.25330132052821,9
0.2,4165,88,334343,80.25516082573212,13
0.2,4166,15,334358,80.2395008399328,17
0.2,4167,84,334442,80.24040307101727,18
0.2,4168,91,334533,80.24298392899976,10
0.2,4169,92,334625,80.24580335731414,9
0.2,4170,90,334715,80.24814193239031,14
0.2,4171,94,334809,80.25143815915628,9
0.2,4172,92,334901,80.25425353462737,9
0.2,4173,91,334992,80.25682798275037,10
0.2,4174,95,335087,80.26035928143713,6
0.2,4175,90,335177,80.26269157088123,12
0.2,4176,87,335264,80.26430452477855,16
0.2,4177,92,335356,80.26711345141216,9
0.2,4178,92,335448,80.26992103374013,10
0.2,4179,92,335540,80.27272727272727,9
0.2,4180,95,335635,80.27624970102846,6
0.2,4181,21,335656,80.2620755619321,12
0.2,4182,91,335747,80.26464260100407,10
0.2,4183,93,335840,80.26768642447419,9
0.2,4184,91,335931,80.27025089605735,10
0.2,4185,92,336023,80.2730530339226,9
0.2,4186,93,336116,80.27609266778123,8
0.2,4187,25,336141,80.26289398280802,7
0.2,4188,88,336229,80.26474098830269,13
0.2,4189,22,336251,80.2508353221957,10
0.2,4190,93,336344,80.25387735623956,8
0.2,4191,85,336429,80.25500954198473,16
0.2,4192,94,336523,80.25828762222753,8
0.2,4193,96,336619,80.26204101096805,6
0.2,4194,91,336710,80.26460071513706,10
0.2,4195,94,336804,80.26787416587226,8
0.2,4196,92,336896,80.2706695258518,9
0.2,4197,91,336987,80.27322534540258,10
0.2,4198,27,337014,80.26053822338652,6
0.2,4199,91,337105,80.26309523809523,10
0.2,4200,91,337196,80.26565103546774,11
0.2,4201,92,337288,80.26844359828652,12
0.2,4202,94,337382,80.27171068284558,7
0.2,4203,26,337408,80.25880114176974,6
0.2,4204,90,337498,80.26111771700357,11
0.2,4205,25,337523,80.24797907750832,8
0.2,4206,94,337617,80.25124792013311,7
0.2,4207,91,337708,80.25380228136882,10
0.2,4208,21,337729,80.23972440009503,11
0.2,4209,88,337817,80.24156769596199,14
0.2,4210,90,337907,80.24388506293042,11
0.2,4211,95,338002,80.24738841405508,6
0.2,4212,88,338090,80.2492285782103,15
0.2,4213,92,338182,80.25201708590413,9
0.2,4214,90,338272,80.25432977461448,11
0.2,4215,95,338367,80.25782732447819,6
0.2,4216,92,338459,80.26061180934313,10
0.2,4217,93,338552,80.26363205310574,8
0.2,4218,88,338640,80.26546575017777,13
0.2,4219,93,338733,80.26848341232227,9
0.2,4220,93,338826,80.27149964463398,8
0.2,4221,88,338914,80.27333017527238,13
0.2,4222,90,339004,80.275633435946,11
0.2,4223,95,339099,80.27911931818181,6
0.2,4224,96,339195,80.2828402366864,6
0.2,4225,19,339214,80.26833885470894,14
0.2,4226,89,339303,80.27040454222853,13
0.2,4227,88,339391,80.27223273415326,14
0.2,4228,94,339485,80.27547883660439,7
0.2,4229,95,339580,80.27895981087471,7
0.2,4230,94,339674,80.28220278893879,7
0.2,4231,-48,339626,80.25189035916824,11
0.2,4232,92,339718,80.25466572171037,9
0.2,4233,93,339811,80.25767595654227,8
0.2,4234,92,339903,80.26044864226682,9
0.2,4235,95,339998,80.2639282341832,7
0.2,4236,94,340092,80.2671701675714,7
0.2,4237,95,340187,80.27064653138272,8
0.2,4238,88,340275,80.27246992215144,16
0.2,4239,96,340371,80.27617924528302,7
0.2,4240,92,340463,80.27894364536665,9
0.2,4241,92,340555,80.28170674210278,9
0.2,4242,-47,340508,80.25170869667689,10
0.2,4243,91,340599,80.25424128180961,10
0.2,4244,95,340694,80.25771495877503,7
0.2,4245,95,340789,80.26118699952897,7
0.2,4246,94,340883,80.26442194490228,7
0.2,4247,90,340973,80.26671374764595,12
0.2,4248,92,341065,80.26947517062838,9
0.2,4249,95,341160,80.27294117647058,6
0.2,4250,23,341183,80.2594683603858,9
0.2,4251,88,341271,80.26128880526811,13
0.2,4252,95,341366,80.26475429108865,6
0.2,4253,94,341460,80.26798307475318,8
0.2,4254,90,341550,80.27027027027027,11
0.2,4255,86,341636,80.27161654135338,15
0.2,4256,89,341725,80.27366690157388,12
0.2,4257,93,341818,80.27665570690465,9
0.2,4258,94,341912,80.27987790561164,7
0.2,4259,93,342005,80.28286384976526,8
0.2,4260,90,342095,80.28514433231636,12
0.2,4261,22,342117,80.27146879399344,11
0.2,4262,92,342209,80.27422003284072,10
0.2,4263,88,342297,80.27603189493433,13
0.2,4264,94,342391,80.27924970691676,7
0.2,4265,93,342484,80.28223159868729,8
0.2,4266,93,342577,80.28521209280525,8
0.2,4267,94,342671,80.28842549203374,7
0.2,4268,92,342763,80.29116889201218,9
0.2,4269,93,342856,80.29414519906324,8
0.2,4270,91,342947,80.29665183797705,10
0.2,4271,95,343042,80.3000936329588,6
0.2,4272,96,343138,80.30376784460566,6
0.2,4273,94,343232,80.30697239120262,7
0.2,4274,22,343254,80.29333333333334,11
0.2,4275,88,343342,80.29513564078579,13
0.2,4276,90,343432,80.29740472293663,11
0.2,4277,25,343457,80.28447872837775,8
0.2,4278,93,343550,80.28745033886422,8
0.2,4279,91,343641,80.28995327102804,10
0.2,4280,94,343735,80.29315580471852,7
0.2,4281,95,343830,80.29659037832788,7
0.2,4282,92,343922,80.29932290450618,9
0.2,4283,23,343945,80.2859477124183,10
0.2,4284,91,344036,80.28844807467911,10
0.2,4285,91,344127,80.29094727018199,10
0.2,4286,95,344222,80.29437835316072,7
0.2,4287,95,344317,80.29780783582089,6
0.2,4288,95,344412,80.30123571928188,8
0.2,4289,93,344505,80.3041958041958,10
0.2,4290,85,344590,80.305290142158,17
0.2,4291,94,344684,80.30848089468779,7
0.2,4292,94,344778,80.31167016072676,8
0.2,4293,96,344874,80.31532370749883,6
0.2,4294,94,344968,80.31850989522701,7
0.2,4295,94,345062,80.32169459962756,10
0.2,4296,88,345150,80.32348149872004,13
0.2,4297,95,345245,80.32689623080502,6
0.2,4298,95,345340,80.33030937427309,6
0.2,4299,93,345433,80.33325581395349,8
0.2,4300,93,345526,80.33620088351546,9
0.2,4301,93,345619,80.33914458391446,8
0.2,4302,91,345710,80.34162212409946,11
0.2,4303,93,345803,80.34456319702602,8
0.2,4304,95,345898,80.3479674796748,6
0.2,4305,86,345984,80.3492800743149,17
0.2,4306,92,346076,80.351985140469,10
0.2,4307,23,346099,80.33867223769731,11
0.2,4308,85,346184,80.33975400324901,18
0.2,4309,94,346278,80.34292343387472,7
0.2,4310,92,346370,80.34562746462538,9
0.2,4311,93,346463,80.34856215213358,8
0.2,4312,89,346552,80.35056805008115,12
0.2,4313,96,346648,80.3541956420955,6
0.2,4314,94,346742,80.35735805330243,7
0.2,4315,95,346837,80.36075069508804,6
0.2,4316,81,346918,80.36089877229557,21
0.2,4317,92,347010,80.36359425660028,9
0.2,4318,95,347105,80.36698309793934,7
0.2,4319,93,347198,80.36990740740741,8
0.2,4320,79,347277,80.36959037259894,22
0.2,4321,92,347369,80.37228135122628,9
0.2,4322,95,347464,80.37566504742077,6
0.2,4323,87,347551,80.37719703977798,15
0.2,4324,91,347642,80.37965317919075,10
0.2,4325,91,347733,80.38210818307905,10
0.2,4326,95,347828,80.38548648024035,6
0.2,4327,93,347921,80.3884011090573,8
0.2,4328,94,348015,80.39154539154539,8
0.2,4329,94,348109,80.394688221709,7
0.2,4330,-121,347988,80.34818748556916,16
0.2,4331,-46,347942,80.31902123730379,9
0.2,4332,26,347968,80.30648511423956,6
0.2,4333,94,348062,80.30964467005076,9
0.2,4334,-47,348015,80.280276816609,11
0.2,4335,90,348105,80.2825184501845,11
0.2,4336,93,348198,80.28545077242333,9
0.2,4337,89,348287,80.28745965882895,12
0.2,4338,94,348381,80.29061995851579,8
0.2,4339,86,348467,80.29193548387097,15
0.2,4340,95,348562,80.29532365814329,6
0.2,4341,93,348655,80.29824965453707,9
0.2,4342,86,348741,80.29956251439097,15
0.2,4343,25,348766,80.28683241252303,7
0.2,4344,93,348859,80.2897583429229,8
0.2,4345,91,348950,80.29222273354809,10
0.2,4346,93,349043,80.29514607775478,8
0.2,4347,92,349135,80.29783808647655,9
0.2,4348,92,349227,80.30052885720855,9
0.2,4349,27,349254,80.28827586206897,6
0.2,4350,87,349341,80.28981843254424,14
0.2,4351,92,349433,80.29250919117646,10
0.2,4352,87,349520,80.29405008040432,15
0.2,4353,93,349613,80.29696830500689,8
0.2,4354,96,349709,80.30057405281286,6
0.2,4355,86,349795,80.30188246097337,15
0.2,4356,89,349884,80.30387881569888,12
0.2,4357,84,349968,80.30472693896283,17
0.2,4358,88,350056,80.3064923147511,13
0.2,4359,92,350148,80.30917431192661,9
0.2,4360,92,350240,80.3118550791103,9
0.2,4361,95,350335,80.31522237505732,7
0.2,4362,96,350431,80.31881732752693,7
0.2,4363,92,350523,80.32149404216315,9
0.2,4364,93,350616,80.32439862542955,8
0.2,4365,92,350708,80.32707283554741,9
0.2,4366,95,350803,80.33043279138997,6
0.2,4367,94,350897,80.33356227106228,7
0.2,4368,95,350992,80.33691920347906,6
0.2,4369,93,351085,80.33981693363845,8
0.2,4370,90,351175,80.34202699611073,11
0.2,4371,94,351269,80.34515096065874,7
0.2,4372,90,351359,80.3473587925909,11
0.2,4373,91,351450,80.34979423868313,10
0.2,4374,95,351545,80.35314285714286,7
0.2,4375,94,351639,80.35626142595979,7
0.2,4376,93,351732,80.35915010281015,8
0.2,4377,87,351819,80.36066697121973,15
0.2,4378,89,351908,80.36263987211692,12
0.2,4379,86,351994,80.36392694063927,15
0.2,4380,88,352082,80.36566993837023,14
0.2,4381,90,352172,80.36786855317207,11
0.2,4382,93,352265,80.37075062742414,8
0.2,4383,93,352358,80.37363138686132,8
0.2,4384,11,352369,80.35781071835804,22
0.2,4385,90,352459,80.36000911992704,12
0.2,4386,91,352550,80.36243446546615,10
0.2,4387,94,352644,80.36554238833182,9
0.2,4388,93,352737,80.36842105263158,9
0.2,4389,95,352832,80.37175398633258,8
0.2,4390,90,352922,80.37394670917786,11
0.2,4391,94,353016,80.37704918032787,7
0.2,4392,94,353110,80.38015023901661,7
0.2,4393,94,353204,80.38324988620846,8
0.2,4394,93,353297,80.38612059158135,9
0.2,4395,89,353386,80.38808007279344,12
0.2,4396,90,353476,80.39026609051626,11
0.2,4397,91,353567,80.39267849022283,10
0.2,4398,95,353662,80.39599909070243,6
0.2,4399,91,353753,80.39840909090908,10
0.2,4400,94,353847,80.40149965916837,7
0.2,4401,94,353941,80.40458882326216,10
0.2,4402,24,353965,80.3917783329548,9
0.2,4403,27,353992,80.37965485921889,6
0.2,4404,94,354086,80.38274687854711,7
0.2,4405,94,354180,80.38583749432591,7
0.2,4406,91,354271,80.38824597231677,11
0.2,4407,95,354366,80.3915607985481,6
0.2,4408,25,354391,80.3789975051032,8
0.2,4409,91,354482,80.38140589569161,10
0.2,4410,95,354577,80.38472001813648,6
0.2,4411,21,354598,80.37126019945603,14
0.2,4412,83,354681,80.37185588035351,19
0.2,4413,94,354775,80.37494336202991,7
0.2,4414,20,354795,80.36126840317101,12
0.2,4415,86,354881,80.36254528985508,15
0.2,4416,85,354966,80.36359520036224,16
0.2,4417,79,355045,80.36328655500226,22
0.2,4418,93,355138,80.36614618692012,8
0.2,4419,96,355234,80.36968325791855,6
0.2,4420,92,355326,80.37231395611853,9
0.2,4421,91,355417,80.37471732247852,12
0.2,4422,25,355442,80.36219760343658,7
0.2,4423,25,355467,80.3496835443038,7
0.2,4424,93,355560,80.35254237288136,9
0.2,4425,93,355653,80.35539990962495,9
0.2,4426,23,355676,80.34244409306528,12
0.2,4427,95,355771,80.34575429087624,6
0.2,4428,96,355867,80.34928877850531,6
0.2,4429,93,355960,80.35214446952595,13
0.2,4430,88,356048,80.35387045813586,13
0.2,4431,92,356140,80.35649819494584,9
0.2,4432,90,356230,80.35867358448003,11
0.2,4433,91,356321,80.36107352277853,10
0.2,4434,94,356415,80.3641488162345,7
0.2,4435,22,356437,80.35099188458071,10
0.2,4436,94,356531,80.35406806400721,7
0.2,4437,95,356626,80.35736818386661,6
0.2,4438,89,356715,80.35931516107232,12
0.2,4439,91,356806,80.3617117117117,10
0.2,4440,92,356898,80.36433235757713,9
0.2,4441,85,356983,80.36537595677623,16
0.2,4442,95,357078,80.36866981769074,7
0.2,4443,94,357172,80.37173717371738,8
0.2,4444,22,357194,80.3586051743532,12
0.2,4445,93,357287,80.36144849302744,8
0.2,4446,93,357380,80.36429053294356,8
0.2,4447,90,357470,80.36645683453237,11
0.2,4448,94,357564,80.36952124072825,7
0.2,4449,90,357654,80.37168539325843,11
0.2,4450,94,357748,80.37474724780948,7
0.2,4451,91,357839,80.37713387241689,10
0.2,4452,91,357930,80.37951942510666,10
0.2,4453,95,358025,80.38280197575213,6
0.2,4454,91,358116,80.38518518518518,10
0.2,4455,87,358203,80.38666965888689,14
0.2,4456,93,358296,80.38949966345075,8
0.2,4457,90,358386,80.39165545087484,11
0.2,4458,86,358472,80.39291320923974,15
0.2,4459,91,358563,80.39529147982063,10
0.2,4460,90,358653,80.3974445191661,11
0.2,4461,25,358678,80.38502913491708,7
0.2,4462,90,358768,80.38718350885055,11
0.2,4463,13,358781,80.37208781362007,19
0.2,4464,92,358873,80.37469204927211,9
0.2,4465,93,358966,80.37751903269145,8
0.2,4466,93,359059,80.38034475039176,8
0.2,4467,82,359141,80.38070725156669,19
0.2,4468,92,359233,80.38330722756768,9
0.2,4469,93,359326,80.38612975391499,8
0.2,4470,95,359421,80.38939834488929,7
0.2,4471,96,359517,80.39288908765653,6
0.2,4472,25,359542,80.38050525374469,7
0.2,4473,94,359636,80.38354939651319,7
0.2,4474,95,359731,80.3868156424581,6
0.2,4475,88,359819,80.38851653261841,13
0.2,4476,95,359914,80.39178020996202,6
0.2,4477,76,359990,80.39079946404645,25
0.2,4478,88,360078,80.39249832551909,13
0.2,4479,23,360101,80.3796875,10
0.2,4480,93,360194,80.38250390537826,8
0.2,4481,93,360287,80.38531905399375,8
0.2,4482,94,360381,80.38835601159937,7
0.2,4483,23,360404,80.37555753791258,9
0.2,4484,93,360497,80.3783723522854,8
0.2,4485,25,360522,80.3660276415515,10
0.2,4486,94,360616,80.36906619121908,7
0.2,4487,94,360710,80.37210338680927,8
0.2,4488,88,360798,80.37380262864781,13
0.2,4489,27,360825,80.36191536748329,6
0.2,4490,18,360843,80.34802939211757,14
0.2,4491,89,360932,80.3499554764025,13
0.2,4492,88,361020,80.35165813487647,14
0.2,4493,91,361111,80.35402759234535,10
0.2,4494,92,361203,80.35661846496107,9
0.2,4495,89,361292,80.35854092526691,12
0.2,4496,-45,361247,80.33066488770291,8
0.2,4497,26,361273,80.31858603823922,6
0.2,4498,86,361359,80.31984885530117,15
0.2,4499,96,361455,80.32333333333334,6
0.2,4500,95,361550,80.32659409020218,6
0.2,4501,95,361645,80.32985339848956,8
0.2,4502,87,361732,80.33133466577837,14
0.2,4503,21,361753,80.31816163410302,12
0.2,4504,92,361845,80.32075471698113,9
0.2,4505,88,361933,80.32245894363072,13
0.2,4506,25,361958,80.31018415797648,7
0.2,4507,25,361983,80.29791481810115,7
0.2,4508,88,362071,80.29962297626969,13
0.2,4509,93,362164,80.30243902439024,8
0.2,4510,21,362185,80.28929283972512,11
0.2,4511,93,362278,80.29210992907801,8
0.2,4512,10,362288,80.27653445601595,24
0.2,4513,94,362382,80.27957465662384,7
0.2,4514,89,362471,80.28150609080842,13
0.2,4515,94,362565,80.28454384410983,7
0.2,4516,91,362656,80.28691609475315,10
0.2,4517,88,362744,80.28862328463921,13
0.2,4518,94,362838,80.29165744633768,7
0.2,4519,95,362933,80.29491150442477,6
0.2,4520,94,363027,80.29794293297942,7
0.2,4521,95,363122,80.30119416187527,8
0.2,4522,92,363214,80.30378067654212,9
0.2,4523,94,363308,80.30680813439434,10
0.2,4524,89,363397,80.30872928176795,12
0.2,4525,94,363491,80.31175430844013,7
0.2,4526,96,363587,80.31521979235697,6
0.2,4527,23,363610,80.30256183745583,9
0.2,4528,95,363705,80.30580702141754,6
0.2,4529,92,363797,80.3083885209713,10
0.2,4530,84,363881,80.30920326638712,18
0.2,4531,92,363973,80.31178287731686,10
0.2,4532,92,364065,80.31436135009928,10
0.2,4533,89,364154,80.31627701808557,12
0.2,4534,91,364245,80.3186328555678,10
0.2,4535,92,364337,80.32120811287479,9
0.2,4536,91,364428,80.32356182499448,11
0.2,4537,13,364441,80.30872631115028,19
0.2,4538,91,364532,80.31108173606522,10
0.2,4539,23,364555,80.29845814977973,9
0.2,4540,91,364646,80.30081479850253,11
0.2,4541,91,364737,80.30317040951122,10
0.2,4542,94,364831,80.30618534008364,7
0.2,4543,94,364925,80.30919894366197,7
0.2,4544,91,365016,80.31155115511551,12
0.2,4545,-46,364970,80.28376594808623,10
0.2,4546,94,365064,80.28678249395206,8
0.2,4547,94,365158,80.28979771328056,7
0.2,4548,94,365252,80.29281160694659,8
0.2,4549,21,365273,80.27978021978022,12
0.2,4550,92,365365,80.28235552625796,9
0.2,4551,95,365460,80.28558875219683,6
0.2,4552,93,365553,80.28838128706347,8
0.2,4553,94,365647,80.29139218269653,7
0.2,4554,91,365738,80.29374313940724,10
0.2,4555,95,365833,80.29697102721686,6
0.2,4556,26,365859,80.28505595786702,6
0.2,4557,90,365949,80.28718736287846,11
0.2,4558,93,366042,80.28997587190173,8
0.2,4559,11,366053,80.27478070175438,22
0.2,4560,23,366076,80.26222319666739,9
0.2,4561,21,366097,80.24923279263481,11
0.2,4562,86,366183,80.25049309664695,15
0.2,4563,89,366272,80.25241016652059,13
0.2,4564,91,366363,80.25476451259584,10
0.2,4565,92,366455,80.25733683749452,9
0.2,4566,92,366547,80.25990803590979,9
0.2,4567,90,366637,80.26204028021016,12
0.2,4568,91,366728,80.26439045743051,10
0.2,4569,-48,366680,80.23632385120351,11
0.2,4570,94,366774,80.2393349376504,8
0.2,4571,85,366859,80.24037620297463,18
0.2,4572,21,366880,80.22742182374809,11
0.2,4573,25,366905,80.21534761696546,7
0.2,4574,25,366930,80.20327868852459,7
0.2,4575,94,367024,80.2062937062937,7
0.2,4576,93,367117,80.20908892287524,8
0.2,4577,95,367212,80.21231979030144,8
0.2,4578,92,367304,80.21489408167722,9
0.2,4579,93,367397,80.21768558951965,8
0.2,4580,25,367422,80.20563195808775,8
0.2,4581,96,367518,80.2090790048014,6
0.2,4582,94,367612,80.21208815186559,7
0.2,4583,92,367704,80.21465968586388,9
0.2,4584,88,367792,80.21635768811342,15
0.2,4585,94,367886,80.21936327954644,7
0.2,4586,94,367980,80.22236756049706,7
0.2,4587,89,368069,80.22428073234525,12
0.2,4588,85,368154,80.22532142078884,16
0.2,4589,94,368248,80.22832244008714,7
0.2,4590,23,368271,80.21585711174036,9
0.2,4591,86,368357,80.21711672473867,15
0.2,4592,93,368450,80.21989984759416,8
0.2,4593,92,368542,80.22246408358728,9
0.2,4594,95,368637,80.22568008705115,6
0.2,4595,92,368729,80.22824194952132,9
0.2,4596,91,368820,80.23058516423755,10
0.2,4597,91,368911,80.23292735972161,10
0.2,4598,94,369005,80.23592085235921,7
0.2,4599,95,369100,80.23913043478261,6
0.2,4600,92,369192,80.24168658987176,9
0.2,4601,88,369280,80.24337244676228,14
0.2,4602,93,369373,80.24614381924832,9
0.2,4603,93,369466,80.24891398783666,8
0.2,4604,25,369491,80.23691639522258,7
0.2,4605,94,369585,80.23990447242727,8
0.2,4606,26,369611,80.22813110484046,6
0.2,4607,93,369704,80.23090277777777,9
0.2,4608,93,369797,80.23367324799305,8
0.2,4609,94,369891,80.23665943600868,8
0.2,4610,94,369985,80.23964432877901,7
0.2,4611,95,370080,80.24284475281874,6
0.2,4612,94,370174,80.24582701062215,7
0.2,4613,96,370270,80.2492414390984,6
0.2,4614,90,370360,80.2513542795233,11
0.2,4615,93,370453,80.25411611785096,8
0.2,4616,92,370545,80.25666016894087,10
0.2,4617,23,370568,80.24426158510178,10
0.2,4618,93,370661,80.24702316518727,8
0.2,4619,96,370757,80.2504329004329,6
0.2,4620,93,370850,80.25319194979441,8
0.2,4621,94,370944,80.2561661618347,8
0.2,4622,21,370965,80.24334847501622,11
0.2,4623,94,371059,80.24632352941177,7
0.2,4624,91,371150,80.24864864864865,12
0.2,4625,94,371244,80.25162127107653,7
0.2,4626,24,371268,80.23946401556084,8
0.2,4627,92,371360,80.2420051858254,9
0.2,4628,91,371451,80.24432922877511,10
0.2,4629,92,371543,80.24686825053996,10
0.2,4630,23,371566,80.23450658605053,9
0.2,4631,94,371660,80.23747841105354,8
0.2,4632,93,371753,80.2402331102957,8
0.2,4633,90,371843,80.24233923176521,11
0.2,4634,92,371935,80.24487594390507,10
0.2,4635,94,372029,80.24784296807593,7
0.2,4636,94,372123,80.25080871252965,7
0.2,4637,92,372215,80.2533419577404,9
0.2,4638,84,372299,80.25414960120716,17
0.2,4639,25,372324,80.24224137931034,8
0.2,4640,92,372416,80.24477483301013,9
0.2,4641,85,372501,80.24579922447221,17
0.2,4642,94,372595,80.24876157656688,7
0.2,4643,92,372687,80.25129198966408,9
0.2,4644,90,372777,80.25339074273413,11
0.2,4645,95,372872,80.25656478691347,6
0.2,4646,91,372963,80.2588766946417,10
0.2,4647,86,373049,80.26011187607573,15
0.2,4648,96,373145,80.26349752634975,6
0.2,4649,92,373237,80.26602150537634,9
0.2,4650,27,373264,80.25456890991185,6
0.2,4651,95,373359,80.25773860705073,6
0.2,4652,19,373378,80.24457339350957,13
0.2,4653,21,373399,80.23184357541899,13
0.2,4654,96,373495,80.23523093447905,6
0.2,4655,-58,373437,80.20554123711341,21
0.2,4656,95,373532,80.20871805883615,8
0.2,4657,95,373627,80.2118935165307,6
0.2,4658,90,373717,80.2139944194033,11
0.2,4659,94,373811,80.21695278969958,7
0.2,4660,94,373905,80.21990989058142,7
0.2,4661,92,373997,80.22243672243673,9
0.2,4662,94,374091,80.2253913789406,7
0.2,4663,90,374181,80.22748713550601,12
0.2,4664,93,374274,80.23022508038585,10
0.2,4665,94,374368,80.233176168024,7
0.2,4666,93,374461,80.23591172059139,9
0.2,4667,93,374554,80.23864610111397,10
0.2,4668,-46,374508,80.21160848147355,10
0.2,4669,96,374604,80.21498929336188,6
0.2,4670,27,374631,80.20359666024406,7
0.2,4671,95,374726,80.20676369863014,7
0.2,4672,95,374821,80.20992938155361,8
0.2,4673,86,374907,80.21116816431322,15
0.2,4674,21,374928,80.1985026737968,11
0.2,4675,-119,374809,80.15590248075279,13
0.2,4676,21,374830,80.1432542227924,11
0.2,4677,86,374916,80.14450619923043,15
0.2,4678,-51,374865,80.11647787988886,14
0.2,4679,93,374958,80.11923076923077,8
0.2,4680,94,375052,80.12219611194189,7
0.2,4681,94,375146,80.12516018795387,7
0.2,4682,24,375170,80.11317531496904,9
0.2,4683,21,375191,80.10055508112724,11
0.2,4684,-47,375144,80.0734258271078,10
0.2,4685,90,375234,80.07554417413573,11
0.2,4686,92,375326,80.0780883294218,11
0.2,4687,84,375410,80.07892491467577,17
0.2,4688,94,375504,80.08189379398593,7
0.2,4689,88,375592,80.08358208955224,15
0.2,4690,90,375682,80.08569601364314,11
0.2,4691,25,375707,80.0739556692242,8
0.2,4692,95,375802,80.07713616023865,6
0.2,4693,93,375895,80.07988922028122,9
0.2,4694,24,375919,80.06794462193824,8
0.2,4695,90,376009,80.07005962521295,12
0.2,4696,89,376098,80.07196082605918,12
0.2,4697,88,376186,80.07364836100469,13
0.2,4698,96,376282,80.07703766758885,6
0.2,4699,96,376378,80.0804255319149,6
0.2,4700,91,376469,80.0827483514146,10
0.2,4701,95,376564,80.0859208847299,6
0.2,4702,94,376658,80.08887943865618,7
0.2,4703,94,376752,80.09183673469387,7
0.2,4704,93,376845,80.09458023379383,8
0.2,4705,88,376933,80.09626009349766,14
0.2,4706,96,377029,80.0996388357765,6
0.2,4707,88,377117,80.10131690739168,15
0.2,4708,96,377213,80.10469314079423,6
0.2,4709,87,377300,80.10615711252655,14
0.2,4710,90,377390,80.10825727021864,12
0.2,4711,92,377482,80.11078098471987,9
0.2,4712,-59,377423,80.0812645873117,24
0.2,4713,95,377518,80.08442935935511,6
0.2,4714,23,377541,80.07232237539766,9
0.2,4715,94,377635,80.07527565733673,7
0.2,4716,92,377727,80.07780368878524,11
0.2,4717,91,377818,80.08011869436201,10
0.2,4718,90,377908,80.08222080949353,12
0.2,4719,20,377928,80.06949152542373,13
0.2,4720,94,378022,80.07244227917813,7
0.2,4721,93,378115,80.07518000847098,8
0.2,4722,91,378206,80.07749311878044,10
0.2,4723,94,378300,80.08044030482642,7
0.2,4724,94,378394,80.08338624338624,7
0.2,4725,91,378485,80.08569614896318,10
0.2,4726,22,378507,80.07340808123546,11
0.2,4727,16,378523,80.05985617597293,16
0.2,4728,95,378618,80.06301543666737,8
0.2,4729,94,378712,80.06596194503172,7
0.2,4730,92,378804,80.06848446417249,9
0.2,4731,94,378898,80.07142857142857,8
0.2,4732,93,378991,80.07416015212338,8
0.2,4733,95,379086,80.07731305449937,7
0.2,4734,93,379179,80.08004223864836,9
0.2,4735,91,379270,80.08234797297297,10
0.2,4736,20,379290,80.06966434452185,14
0.2,4737,94,379384,80.0726044744618,7
0.2,4738,92,379476,80.07512133361469,9
0.2,4739,93,379569,80.07784810126583,8
0.2,4740,22,379591,80.06559797511073,10
0.2,4741,92,379683,80.06811471952763,10
0.2,4742,92,379775,80.07063040269871,11
0.2,4743,92,379867,80.0731450252951,9
0.2,4744,94,379961,80.07608008429926,7
0.2,4745,93,380054,80.078803202697,9
0.2,4746,96,380150,80.0821571518854,6
0.2,4747,93,380243,80.08487784330244,8
0.2,4748,92,380335,80.08738681827754,9
0.2,4749,96,380431,80.09073684210526,6
0.2,4750,84,380515,80.09155967164807,17
0.2,4751,92,380607,80.09406565656566,9
0.2,4752,96,380703,80.09741216074059,6
0.2,4753,96,380799,80.1007572570467,6
0.2,4754,26,380825,80.08937960042061,6
0.2,4755,94,380919,80.09230445752733,7
0.2,4756,25,380944,80.08072314483918,9
0.2,4757,-52,380892,80.05296343001261,15
0.2,4758,93,380985,80.05568396722,8
0.2,4759,23,381008,80.0436974789916,10
0.2,4760,86,381094,80.04494854022265,15
0.2,4761,93,381187,80.04766904661906,8
0.2,4762,18,381205,80.03464203233257,15
0.2,4763,94,381299,80.03757346767422,7
0.2,4764,96,381395,80.04092339979013,6
0.2,4765,94,381489,80.04385228703315,8
0.2,4766,89,381578,80.0457310677575,12
0.2,4767,93,381671,80.04844798657719,8
0.2,4768,94,381765,80.0513734535542,7
0.2,4769,86,381851,80.05262054507338,15
0.2,4770,88,381939,80.0542863131419,13
0.2,4771,95,382034,80.0574182732607,6
0.2,4772,88,382122,80.05908233815211,13
0.2,4773,94,382216,80.06200251361541,7
0.2,4774,95,382311,80.06513089005236,7
0.2,4775,93,382404,80.0678391959799,8
0.2,4776,93,382497,80.0705463680134,9
0.2,4777,24,382521,80.05881121808288,8
0.2,4778,93,382614,80.06151914626491,8
0.2,4779,93,382707,80.06422594142259,8
0.2,4780,95,382802,80.06734992679355,6
0.2,4781,85,382887,80.06838143036387,16
0.2,4782,82,382969,80.06878528120427,19
0.2,4783,18,382987,80.0558110367893,17
0.2,4784,25,383012,80.0443051201672,7
0.2,4785,96,383108,80.04763894692854,6
0.2,4786,96,383204,80.05097138082306,6
0.2,4787,93,383297,80.05367585630744,9
0.2,4788,94,383391,80.0565880141992,8
0.2,4789,93,383484,80.05929018789143,8
0.2,4790,-264,383220,79.98747651847214,21
0.2,4791,92,383312,79.98998330550918,9
0.2,4792,27,383339,79.97892760275401,6
0.2,4793,95,383434,79.98206090947018,7
0.2,4794,22,383456,79.96996871741398,12
0.2,4795,-49,383407,79.94307756463719,12
0.2,4796,89,383496,79.94496560350218,14
0.2,4797,93,383589,79.9476865360567,8
0.2,4798,91,383680,79.94998958116274,11
0.2,4799,95,383775,79.953125,6
0.2,4800,92,383867,79.95563424286607,11
0.2,4801,87,383954,79.95710120783006,15
0.2,4802,95,384049,79.96023318759109,8
0.2,4803,22,384071,79.94816819317235,10
0.2,4804,93,384164,79.95088449531738,9
0.2,4805,88,384252,79.9525593008739,13
0.2,4806,95,384347,79.95568961930518,8
0.2,4807,93,384440,79.95840266222962,8
0.2,4808,91,384531,79.96069868995633,10
0.2,4809,94,384625,79.96361746361747,8
0.2,4810,87,384712,79.96508002494284,14
0.2,4811,95,384807,79.96820448877806,6
0.2,4812,95,384902,79.97132765426969,6
0.2,4813,95,384997,79.97444952222683,6
0.2,4814,95,385092,79.97757009345794,6
0.2,4815,94,385186,79.98048172757476,7
0.2,4816,88,385274,79.98214656425161,14
0.2,4817,92,385366,79.9846409298464,10
0.2,4818,94,385460,79.98754928408384,7
0.2,4819,16,385476,79.97427385892117,17
0.2,4820,91,385567,79.97656087948559,10
0.2,4821,91,385658,79.97884695147242,10
0.2,4822,25,385683,79.96744764669293,7
0.2,4823,27,385710,79.95646766169155,6
0.2,4824,94,385804,79.95937823834197,8
0.2,4825,91,385895,79.96166597596353,10
0.2,4826,95,385990,79.96478143774601,6
0.2,4827,94,386084,79.96768848384424,7
0.2,4828,92,386176,79.97018016152413,9
0.2,4829,93,386269,79.9728778467909,8
0.2,4830,94,386363,79.975781411716,8
0.2,4831,92,386455,79.97826986754967,9
0.2,4832,94,386549,79.98117111524932,8
0.2,4833,94,386643,79.98407116259827,7
0.2,4834,91,386734,79.98634953464322,11
0.2,4835,95,386829,79.98945409429281,6
0.2,4836,-120,386709,79.9481083316105,14
0.2,4837,89,386798,79.94997933030177,15
0.2,4838,94,386892,79.95288282703038,8
0.2,4839,95,386987,79.9559917355372,6
0.2,4840,96,387083,79.95930592852716,6
0.2,4841,91,387174,79.96158612143742,10
0.2,4842,90,387264,79.96365888911832,11
0.2,4843,95,387359,79.96676300578035,6
0.2,4844,19,387378,79.95417956656347,14
0.2,4845,20,387398,79.94180767643417,12
0.2,4846,89,387487,79.9436765009284,12
0.2,4847,94,387581,79.94657590759076,7
0.2,4848,92,387673,79.94906166219839,9
0.2,4849,25,387698,79.93773195876288,8
0.2,4850,88,387786,79.93939393939394,14
0.2,4851,94,387880,79.94229183841715,8
0.2,4852,91,387971,79.94457036884401,10
0.2,4853,92,388063,79.94705397610218,9
0.2,4854,96,388159,79.95036045314109,6
0.2,4855,22,388181,79.93842668863262,10
0.2,4856,94,388275,79.94132180358245,7
0.2,4857,91,388366,79.94359818855496,10
0.2,4858,92,388458,79.94607944021404,10
0.2,4859,87,388545,79.94753086419753,14
0.2,4860,91,388636,79.94980456696153,13
0.2,4861,96,388732,79.9531057178116,6
0.2,4862,89,388821,79.95496607032696,12
0.2,4863,96,388917,79.95826480263158,6
0.2,4864,94,389011,79.96115107913668,8
0.2,4865,95,389106,79.96424167694205,7
0.2,4866,23,389129,79.95253749743168,10
0.2,4867,93,389222,79.95521774856203,8
0.2,4868,25,389247,79.94393099199014,8
0.2,4869,94,389341,79.94681724845996,9
0.2,4870,94,389435,79.9497023198522,8
0.2,4871,88,389523,79.95135467980296,14
0.2,4872,94,389617,79.9542376359532,8
0.2,4873,88,389705,79.95588838736151,13
0.2,4874,93,389798,79.9585641025641,9
0.2,4875,23,389821,79.9468826907301,9
0.2,4876,94,389915,79.94976419930285,8
0.2,4877,96,390011,79.9530545305453,6
0.2,4878,93,390104,79.95572863291657,8
0.2,4879,93,390197,79.95840163934426,8
0.2,4880,96,390293,79.96168817865191,6
0.2,4881,-45,390248,79.9360917656698,8
0.2,4882,93,390341,79.9387671513414,9
0.2,4883,94,390435,79.94164619164619,8
0.2,4884,90,390525,79.94370522006142,11
0.2,4885,93,390618,79.94637740483013,8
0.2,4886,94,390712,79.94925312052384,7
0.2,4887,21,390733,79.93719312602292,13
0.2,4888,25,390758,79.92595622826754,8
0.2,4889,93,390851,79.92862985685072,8
0.2,4890,90,390941,79.93068902065018,11
0.2,4891,94,391035,79.93356500408831,7
0.2,4892,87,391122,79.93500919681178,14
0.2,4893,92,391214,79.93747445852064,9
0.2,4894,93,391307,79.94014300306435,8
0.2,4895,93,391400,79.94281045751634,8
0.2,4896,92,391492,79.94527261588728,9
0.2,4897,93,391585,79.94793793385055,8
0.2,4898,21,391606,79.93590528679323,11
0.2,4899,96,391702,79.93918367346939,6
0.2,4900,96,391798,79.94246072230158,6
0.2,4901,93,391891,79.94512443900449,9
0.2,4902,96,391987,79.94839893942485,6
0.2,4903,90,392077,79.95044861337684,13
0.2,4904,88,392165,79.95208970438328,13
0.2,4905,-53,392112,79.92498980839788,18
0.2,4906,82,392194,79.92541267576931,20
0.2,4907,96,392290,79.92868785656071,6
0.2,4908,87,392377,79.93012833570992,15
0.2,4909,88,392465,79.93177189409369,13
0.2,4910,94,392559,79.93463653023824,7
0.2,4911,92,392651,79.93709283387622,9
0.2,4912,94,392745,79.93995522084266,7
0.2,4913,89,392834,79.94179894179894,12
0.2,4914,94,392928,79.94465920651068,7
0.2,4915,91,393019,79.94690805532953,11
0.2,4916,93,393112,79.94956274150906,8
0.2,4917,93,393205,79.95221634810899,10
0.2,4918,93,393298,79.95486887578777,8
0.2,4919,96,393394,79.95813008130081,6
0.2,4920,92,393486,79.96057711847186,9
0.2,4921,89,393575,79.9624136529866,12
0.2,4922,79,393654,79.96221815965875,22
0.2,4923,18,393672,79.94963444354184,16
0.2,4924,95,393767,79.95269035532995,6
0.2,4925,94,393861,79.95554202192449,7
0.2,4926,94,393955,79.9583925309519,8
0.2,4927,94,394049,79.96124188311688,8
0.2,4928,95,394144,79.96429296003247,7
0.2,4929,95,394239,79.96734279918864,6
0.2,4930,90,394329,79.96937740823363,11
0.2,4931,95,394424,79.97242497972425,7
0.2,4932,94,394518,79.97526859922968,7
0.2,4933,95,394613,79.9783137413863,6
0.2,4934,79,394692,79.97811550151975,23
0.2,4935,91,394783,79.98034846029174,10
0.2,4936,93,394876,79.98298561879685,9
0.2,4937,94,394970,79.98582422033212,7
0.2,4938,96,395066,79.98906661267463,6
0.2,4939,94,395160,79.9919028340081,7
0.2,4940,86,395246,79.99311880186197,15
0.2,4941,95,395341,79.99615540267098,6
0.2,4942,95,395436,79.9991907748331,8
0.2,4943,93,395529,80.00182038834951,8
0.2,4944,24,395553,79.99049544994945,9
0.2,4945,92,395645,79.99292357460574,9
0.2,4946,23,395668,79.98140287042652,10
0.2,4947,-47,395621,79.95573969280517,11
0.2,4948,93,395714,79.95837542937967,10
0.2,4949,92,395806,79.96080808080808,9
0.2,4950,92,395898,79.96323974954555,9
0.2,4951,92,395990,79.9656704361874,9
0.2,4952,87,396077,79.96709065213003,14
0.2,4953,93,396170,79.96972143722245,8
0.2,4954,94,396264,79.97255297679112,7
0.2,4955,94,396358,79.97538337368846,8
0.2,4956,87,396445,79.9768004841638,14
0.2,4957,87,396532,79.97821702299315,14
0.2,4958,91,396623,79.98043960475903,10
0.2,4959,17,396640,79.96774193548387,15
0.2,4960,25,396665,79.95666196331385,8
0.2,4961,93,396758,79.95929060862555,8
0.2,4962,92,396850,79.96171670360668,9
0.2,4963,94,396944,79.9645447219984,7
0.2,4964,92,397036,79.96696878147029,10
0.2,4965,25,397061,79.95590012082158,7
0.2,4966,23,397084,79.94443325951278,9
0.2,4967,95,397179,79.94746376811594,6
0.2,4968,23,397202,79.93600321996378,9
0.2,4969,94,397296,79.93883299798793,7
0.2,4970,91,397387,79.94105813719574,10
0.2,4971,27,397414,79.93041029766694,6
0.2,4972,93,397507,79.93303840739996,9
0.2,4973,91,397598,79.93526336952151,10
0.2,4974,93,397691,79.93788944723619,9
0.2,4975,92,397783,79.94031350482315,9
0.2,4976,24,397807,79.92907373920032,8
0.2,4977,20,397827,79.9170349537967,12
0.2,4978,94,397921,79.91986342639085,7
0.2,4979,92,398013,79.9222891566265,9
0.2,4980,93,398106,79.92491467576792,8
0.2,4981,88,398194,79.92653552790044,14
0.2,4982,92,398286,79.92895845875978,9
0.2,4983,87,398373,79.9303772070626,14
0.2,4984,-192,398181,79.87582748244735,17
0.2,4985,24,398205,79.86462093862816,8
0.2,4986,89,398294,79.86645277722077,12
0.2,4987,94,398388,79.86928628708901,7
0.2,4988,26,398414,79.85848867508518,6
0.2,4989,92,398506,79.86092184368738,9
0.2,4990,26,398532,79.85013023442195,6
0.2,4991,93,398625,79.85276442307692,8
0.2,4992,93,398718,79.8553975565792,8
0.2,4993,91,398809,79.85762915498599,10
0.2,4994,87,398896,79.85905905905906,14
0.2,4995,85,398981,79.86008807045637,16
0.2,4996,93,399074,79.86271763057835,8
0.2,4997,89,399163,79.86454581832733,12
0.2,4998,92,399255,79.86697339467894,9
0.2,4999,88,399343,79.8686,13
0.2,5000,89,399432,79.87042591481703,15
0.2,5001,95,399527,79.8734506197521,6
0.2,5002,92,399619,79.87587447531482,9
0.2,5003,93,399712,79.87849720223821,8
0.2,5004,91,399803,79.88071928071928,10
0.2,5005,91,399894,79.88294047143428,10
0.2,5006,95,399989,79.88595965648092,6
0.2,5007,91,400080,79.88817891373802,10
0.2,5008,94,400174,79.89099620682771,7
0.2,5009,94,400268,79.8938123752495,7
0.2,5010,95,400363,79.89682698064259,8
0.2,5011,93,400456,79.89944134078212,10
0.2,5012,92,400548,79.90185517654099,9
0.2,5013,87,400635,79.9032708416434,15
0.2,5014,85,400720,79.90428713858425,16
0.2,5015,94,400814,79.90709728867624,7
0.2,5016,95,400909,79.91010564082121,7
0.2,5017,88,400997,79.9117178158629,13
0.2,5018,89,401086,79.91352859135286,12
0.2,5019,94,401180,79.91633466135458,9
0.2,5020,3,401183,79.90101573391755,30
0.2,5021,96,401279,79.9042214257268,6
0.2,5022,94,401373,79.90702767270555,7
0.2,5023,95,401468,79.91003184713375,6
0.2,5024,92,401560,79.91243781094528,9
0.2,5025,92,401652,79.91484281734978,9
0.2,5026,93,401745,79.91744579271932,10
0.2,5027,86,401831,79.9186555290374,15
0.2,5028,90,401921,79.92066017100815,11
0.2,5029,94,402015,79.92345924453281,7
0.2,5030,85,402100,79.92446829656132,16
0.2,5031,93,402193,79.92706677265501,8
0.2,5032,93,402286,79.92966421617325,10
0.2,5033,95,402381,79.93265792610251,6
0.2,5034,90,402471,79.93465739821251,13
0.2,5035,23,402494,79.92335186656076,9
0.2,5036,94,402588,79.9261465157832,7
0.2,5037,87,402675,79.92755061532354,14
0.2,5038,91,402766,79.92974796586624,10
0.2,5039,95,402861,79.9327380952381,6
0.2,5040,92,402953,79.93513191827019,9
0.2,5041,91,403044,79.93732645775486,10
0.2,5042,21,403065,79.92563950029744,11
0.2,5043,23,403088,79.91435368754956,10
0.2,5044,93,403181,79.91694747274529,8
0.2,5045,95,403276,79.91993658343242,6
0.2,5046,96,403372,79.9231226471171,6
0.2,5047,23,403395,79.91184627575278,9
0.2,5048,91,403486,79.91404238463062,10
0.2,5049,95,403581,79.9170297029703,6
0.2,5050,93,403674,79.91961987725203,8
0.2,5051,90,403764,79.92161520190024,15
0.2,5052,95,403859,79.9245992479715,6
0.2,5053,78,403937,79.92421844083894,24
0.2,5054,89,404026,79.92601384767556,12
0.2,5055,96,404122,79.92919303797468,6
0.2,5056,88,404210,79.93078900533914,14
0.2,5057,96,404306,79.93396599446422,6
0.2,5058,93,404399,79.93654872504447,9
0.2,5059,91,404490,79.93873517786561,10
0.2,5060,94,404584,79.94151353487453,7
0.2,5061,93,404677,79.94409324377716,8
0.2,5062,92,404769,79.94647442227928,9
0.2,5063,94,404863,79.94924960505529,7
0.2,5064,86,404949,79.95044422507404,15
0.2,5065,23,404972,79.93920252664824,9
0.2,5066,92,405064,79.94158279060588,10
0.2,5067,91,405155,79.94376479873718,10
0.2,5068,93,405248,79.94634050108503,8
0.2,5069,94,405342,79.9491124260355,7
0.2,5070,95,405437,79.95208045750346,6
0.2,5071,93,405530,79.95465299684543,8
0.2,5072,90,405620,79.95663315592351,11
0.2,5073,91,405711,79.95880961765866,10
0.2,5074,-119,405592,79.91960591133005,13
0.2,5075,91,405683,79.92178881008668,10
0.2,5076,27,405710,79.91136497931849,6
0.2,5077,92,405802,79.9137455691217,9
0.2,5078,96,405898,79.91691277810592,6
0.2,5079,92,405990,79.91929133858268,9
0.2,5080,92,406082,79.9216689628026,10
0.2,5081,20,406102,79.90987800078709,12
0.2,5082,94,406196,79.91265000983671,7
0.2,5083,93,406289,79.9152242328875,8
0.2,5084,92,406381,79.91760078662733,9
0.2,5085,94,406475,79.92036964215494,7
0.2,5086,96,406571,79.9235305681148,6
0.2,5087,95,406666,79.92649371069183,6
0.2,5088,94,406760,79.92925918648065,8
0.2,5089,94,406854,79.93202357563851,7
0.2,5090,93,406947,79.9345904537419,8
0.2,5091,91,407038,79.93676355066772,10
0.2,5092,92,407130,79.9391321421559,10
0.2,5093,96,407226,79.94228504122498,6
0.2,5094,96,407322,79.94543670264966,6
0.2,5095,95,407417,79.94839089481947,8
0.2,5096,95,407512,79.95134392780066,6
0.2,5097,96,407608,79.95449195763044,6
0.2,5098,95,407703,79.95744263581095,6
0.2,5099,92,407795,79.95980392156862,9
0.2,5100,-46,407749,79.93511076259557,9
0.2,5101,94,407843,79.93786750294002,7
0.2,5102,22,407865,79.9265138154027,11
0.2,5103,90,407955,79.92848746081505,14
0.2,5104,93,408048,79.93104799216455,8
0.2,5105,93,408141,79.93360752056404,8
0.2,5106,88,408229,79.93518699823771,16
0.2,5107,96,408325,79.93833202819107,6
0.2,5108,89,408414,79.94010569583088,12
0.2,5109,96,408510,79.94324853228963,6
0.2,5110,93,408603,79.94580316963412,10
0.2,5111,21,408624,79.93427230046949,12
0.2,5112,94,408718,79.93702327400743,7
0.2,5113,91,408809,79.93918654673445,10
0.2,5114,90,408899,79.94115347018572,12
0.2,5115,92,408991,79.9435105551212,9
0.2,5116,90,409081,79.9454758647645,11
0.2,5117,92,409173,79.94783118405627,9
0.2,5118,96,409269,79.9509669857394,6
0.2,5119,94,409363,79.9537109375,7
0.2,5120,89,409452,79.95547744581137,12
0.2,5121,91,409543,79.95763373682155,12
0.2,5122,92,409635,79.9599843841499,11
0.2,5123,84,409719,79.96077283372365,17
0.2,5124,93,409812,79.96331707317073,12
0.2,5125,92,409904,79.9656652360515,11
0.2,5126,88,409992,79.9672322995904,13
0.2,5127,91,410083,79.96938377535102,10
0.2,5128,94,410177,79.97211932150516,9
0.2,5129,96,410273,79.97524366471735,6
0.2,5130,6,410279,79.96082634963945,26
0.2,5131,94,410373,79.96356196414654,7
0.2,5132,93,410466,79.96610169491525,9
0.2,5133,91,410557,79.96825087650954,10
0.2,5134,91,410648,79.97039922103214,10
0.2,5135,-51,410597,79.94489875389408,16
0.2,5136,87,410684,79.94627214327429,14
0.2,5137,94,410778,79.94900739587388,7
0.2,5138,96,410874,79.95213076474022,6
0.2,5139,93,410967,79.95466926070038,8
0.2,5140,94,411061,79.95740128379693,7
0.2,5141,23,411084,79.9463243873979,9
0.2,5142,96,411180,79.94944584872643,6
0.2,5143,94,411274,79.95217729393468,9
0.2,5144,94,411368,79.95490767735666,7
0.2,5145,95,411463,79.9578313253012,6
0.2,5146,95,411558,79.96075383718672,7
0.2,5147,92,411650,79.96309246309247,9
0.2,5148,85,411735,79.96407069333851,16
0.2,5149,96,411831,79.96718446601942,6
0.2,5150,92,411923,79.96952048145991,9
0.2,5151,90,412013,79.97146739130434,11
0.2,5152,88,412101,79.97302542208422,13
0.2,5153,96,412197,79.97613504074505,6
0.2,5154,90,412287,79.9780795344326,11
0.2,5155,91,412378,79.98021722265322,10
0.2,5156,88,412466,79.9817723482645,13
0.2,5157,25,412491,79.97111283443195,7
0.2,5158,91,412582,79.97325062996705,10
0.2,5159,91,412673,79.97538759689922,10
0.2,5160,24,412697,79.96454175547375,9
0.2,5161,92,412789,79.96687330492057,9
0.2,5162,90,412879,79.96881657950804,11
0.2,5163,92,412971,79.97114639814097,11
0.2,5164,94,413065,79.97386253630204,7
0.2,5165,95,413160,79.9767711962834,6
0.2,5166,93,413253,79.97929165860268,9
0.2,5167,95,413348,79.98219814241486,6
0.2,5168,-47,413301,79.95763203714452,11
0.2,5169,92,413393,79.95996131528047,9
0.2,5170,93,413486,79.96248307870817,8
0.2,5171,92,413578,79.96481051817479,9
0.2,5172,92,413670,79.96713705780012,9
0.2,5173,93,413763,79.96965597216854,8
0.2,5174,93,413856,79.97217391304348,9
0.2,5175,22,413878,79.96097372488408,10
0.2,5176,94,413972,79.96368553216148,7
0.2,5177,94,414066,79.96639629200463,7
0.2,5178,90,414156,79.96833365514578,11
0.2,5179,94,414250,79.97104247104247,7
0.2,5180,94,414344,79.97375024126616,7
0.2,5181,84,414428,79.97452720957159,17
0.2,5182,96,414524,79.97761913949451,6
0.2,5183,95,414619,79.98051697530865,6
0.2,5184,95,414714,79.9834136933462,6
0.2,5185,94,414808,79.98611646741226,7
0.2,5186,26,414834,79.97570850202429,7
0.2,5187,85,414919,79.97667694680031,16
0.2,5188,91,415010,79.97880131046445,10
0.2,5189,87,415097,79.98015414258188,15
0.2,5190,26,415123,79.96975534579079,7
0.2,5191,91,415214,79.97187981510015,11
0.2,5192,92,415306,79.97419603312152,11
0.2,5193,93,415399,79.97670388910281,8
0.2,5194,90,415489,79.97863330125121,11
0.2,5195,89,415578,79.98036951501155,12
0.2,5196,18,415596,79.96844333269193,15
0.2,5197,95,415691,79.97133512889573,6
0.2,5198,94,415785,79.9740334679746,7
0.2,5199,21,415806,79.96269230769231,11
0.2,5200,20,415826,79.95116323783888,12
0.2,5201,22,415848,79.94002306805075,10
0.2,5202,93,415941,79.94253315394964,8
0.2,5203,95,416036,79.94542659492699,8
0.2,5204,94,416130,79.94812680115274,8
0.2,5205,93,416223,79.95063388398002,8
0.2,5206,88,416311,79.95217975801805,15
0.2,5207,91,416402,79.95430107526882,11
0.2,5208,95,416497,79.95718947974659,7
0.2,5209,94,416591,79.95988483685221,7
0.2,5210,94,416685,79.96257915947035,9
0.2,5211,90,416775,79.9645049884881,11
0.2,5212,89,416864,79.96623825052752,12
0.2,5213,90,416954,79.96816263904871,11
0.2,5214,92,417046,79.97046979865772,12
0.2,5215,20,417066,79.95897239263803,13
0.2,5216,94,417160,79.96166379145103,7
0.2,5217,94,417254,79.96435415868149,7
0.2,5218,94,417348,79.9670434949224,9
0.2,5219,89,417437,79.96877394636016,12
0.2,5220,26,417463,79.95843708101896,6
0.2,5221,93,417556,79.96093450785139,9
0.2,5222,90,417646,79.96285659582615,14
0.2,5223,95,417741,79.96573506891271,7
0.2,5224,-48,417693,79.94124401913875,11
0.2,5225,92,417785,79.94355147340222,9
0.2,5226,87,417872,79.94490147312034,14
0.2,5227,89,417961,79.94663351185922,12
0.2,5228,94,418055,79.94932109389941,7
0.2,5229,93,418148,79.95181644359465,8
0.2,5230,93,418241,79.95431083922769,8
0.2,5231,91,418332,79.95642201834862,12
0.2,5232,93,418425,79.95891458054653,8
0.2,5233,19,418444,79.94726786396637,13
0.2,5234,95,418539,79.95014326647565,6
0.2,5235,95,418634,79.95301757066463,6
0.2,5236,95,418729,79.9558907771625,7
0.2,5237,88,418817,79.95742649866361,13
0.2,5238,89,418906,79.959152510021,15
0.2,5239,91,418997,79.96125954198473,10
0.2,5240,92,419089,79.96355657317307,9
0.2,5241,95,419184,79.96642502861503,6
0.2,5242,24,419208,79.95575052450887,10
0.2,5243,94,419302,79.95842868039665,8
0.2,5244,87,419389,79.95977121067683,15
0.2,5245,91,419480,79.96187571483034,10
0.2,5246,96,419576,79.96493234229084,6
0.2,5247,94,419670,79.96760670731707,7
0.2,5248,90,419760,79.96951800342923,11
0.2,5249,92,419852,79.97180952380953,10
0.2,5250,86,419938,79.97295753189869,16
0.2,5251,93,420031,79.97543792840823,8
0.2,5252,22,420053,79.96440129449839,11
0.2,5253,93,420146,79.96688237533309,9
0.2,5254,92,420238,79.96917221693626,9
0.2,5255,95,420333,79.97203196347031,11
0.2,5256,84,420417,79.97279817386342,17
0.2,5257,92,420509,79.9750855838722,9
0.2,5258,85,420594,79.97604107244723,16
0.2,5259,92,420686,79.97832699619772,9
0.2,5260,90,420776,79.98023189507698,12
0.2,5261,87,420863,79.98156594450779,14
0.2,5262,93,420956,79.98403952118564,9
0.2,5263,95,421051,79.98689209726444,7
0.2,5264,95,421146,79.98974358974358,8
0.2,5265,93,421239,79.99221420432966,8
0.2,5266,-127,421112,79.95291437250808,22
0.2,5267,94,421206,79.95558086560365,7
0.2,5268,92,421298,79.95786676788765,9
0.2,5269,94,421392,79.9605313092979,8
0.2,5270,92,421484,79.96281540504648,9
0.2,5271,91,421575,79.96490895295904,10
0.2,5272,94,421669,79.96757064289778,7
0.2,5273,92,421761,79.9698521046644,9
0.2,5274,88,421849,79.97137440758294,13
0.2,5275,92,421941,79.97365428354814,9
0.2,5276,94,422035,79.97631229865453,10
0.2,5277,88,422123,79.97783251231527,13
0.2,5278,91,422214,79.97992043947717,11
0.2,5279,23,422237,79.96912878787879,9
0.2,5280,87,422324,79.97046014012497,14
0.2,5281,96,422420,79.97349488829988,6
0.2,5282,95,422515,79.97633920121143,6
0.2,5283,94,422609,79.97899318697957,7
0.2,5284,94,422703,79.98164616840114,7
0.2,5285,80,422783,79.98164964055997,21
0.2,5286,92,422875,79.983922829582,10
0.2,5287,93,422968,79.98638426626324,8
0.2,5288,94,423062,79.98903384382682,7
0.2,5289,96,423158,79.99206049149339,6
0.2,5290,89,423247,79.993762993763,13
0.2,5291,93,423340,79.99622071050642,8
0.2,5292,87,423427,79.99754392593992,14
0.2,5293,94,423521,80.00018889308652,10
0.2,5294,91,423612,80.00226628895184,10
0.2,5295,96,423708,80.00528700906344,6
0.2,5296,90,423798,80.00717387200302,11
0.2,5297,91,423889,80.00924877312194,12
0.2,5298,90,423979,80.01113417625967,11
0.2,5299,95,424074,80.01396226415095,6
0.2,5300,93,424167,80.01641199773627,9
0.2,5301,91,424258,80.0184835910977,11
0.2,5302,92,424350,80.02074297567415,9
0.2,5303,22,424372,80.00980392156863,12
0.2,5304,90,424462,80.01168708765316,11
0.2,5305,92,424554,80.0139464756879,9
0.2,5306,93,424647,80.01639344262296,9
0.2,5307,92,424739,80.01865109269028,9
0.2,5308,93,424832,80.02109625164815,8
0.2,5309,92,424924,80.02335216572504,11
0.2,5310,92,425016,80.02560723027679,9
0.2,5311,26,425042,80.01543674698796,6
0.2,5312,93,425135,80.01788067005458,8
0.2,5313,92,425227,80.02013549115544,9
0.2,5314,90,425317,80.02201317027281,11
0.2,5315,95,425412,80.02483069977427,7
0.2,5316,89,425501,80.02651871356028,12
0.2,5317,88,425589,80.02801805189921,13
0.2,5318,23,425612,80.01729648430155,9
0.2,5319,94,425706,80.01992481203007,8
0.2,5320,93,425799,80.0223642172524,8
0.2,5321,96,425895,80.02536640360766,6
0.2,5322,92,425987,80.02761600601164,10
0.2,5323,92,426079,80.02986476333584,9
0.2,5324,90,426169,80.03173708920188,13
0.2,5325,92,426261,80.03398422831393,9
0.2,5326,93,426354,80.03641824666792,11
0.2,5327,92,426446,80.03866366366367,9
0.2,5328,92,426538,80.04090823794333,10
0.2,5329,96,426634,80.0439024390244,6
0.2,5330,91,426725,80.04595760645282,11
0.2,5331,87,426812,80.04726181545387,15
0.2,5332,95,426907,80.05006562910182,6
0.2,5333,95,427002,80.05286839145107,7
0.2,5334,94,427096,80.05548266166822,8
0.2,5335,92,427188,80.05772113943029,10
0.2,5336,96,427284,80.06070826306915,6
0.2,5337,92,427376,80.0629449231922,10
0.2,5338,93,427469,80.06536804645064,8
0.2,5339,93,427562,80.06779026217228,8
0.2,5340,92,427654,80.07002434001123,9
0.2,5341,12,427666,80.05728191688506,21
0.2,5342,94,427760,80.05989144675276,7
0.2,5343,94,427854,80.0625,7
0.2,5344,-56,427798,80.03704396632367,22
0.2,5345,19,427817,80.02562663673775,15
0.2,5346,14,427831,80.0132784739106,19
0.2,5347,91,427922,80.01533283470457,10
0.2,5348,90,428012,80.01719947653767,11
0.2,5349,90,428102,80.01906542056075,13
0.2,5350,95,428197,80.02186507194916,6
0.2,5351,84,428281,80.02260837070254,17
0.2,5352,95,428376,80.02540631421633,7
0.2,5353,92,428468,80.02764288382518,11
0.2,5354,92,428560,80.02987861811391,9
0.2,5355,92,428652,80.03211351755041,9
0.2,5356,96,428748,80.0350942691805,6
0.2,5357,92,428840,80.03732736095559,10
0.2,5358,94,428934,80.03993282328793,7
0.2,5359,22,428956,80.02910447761194,11
0.2,5360,94,429050,80.03171050177205,10
0.2,5361,90,429140,80.03356956359568,11
0.2,5362,87,429227,80.03486854372552,14
0.2,5363,96,429323,80.03784489187174,6
0.2,5364,92,429415,80.04007455731593,9
0.2,5365,84,429499,80.04081252329482,17
0.2,5366,95,429594,80.0435997764114,7
0.2,5367,95,429689,80.04638599105812,6
0.2,5368,93,429782,80.04879865896815,8
0.2,5369,90,429872,80.05065176908752,11
0.2,5370,92,429964,80.05287655929995,9
0.2,5371,92,430056,80.05510052122115,9
0.2,5372,91,430147,80.0571375395496,10
0.2,5373,94,430241,80.05973204317083,7
0.2,5374,19,430260,80.04837209302326,13
0.2,5375,95,430355,80.05115327380952,6
0.2,5376,92,430447,80.05337548819044,9
0.2,5377,86,430533,80.05448121978431,15
0.2,5378,93,430626,80.0568878973787,8
0.2,5379,95,430721,80.05966542750929,7
0.2,5380,93,430814,80.06207024716595,8
0.2,5381,94,430908,80.06465997770346,7
0.2,5382,92,431000,80.06687720601894,10
0.2,5383,92,431092,80.06909361069836,10
0.2,5384,95,431187,80.07186629526463,6
0.2,5385,93,431280,80.07426661715559,8
0.2,5386,93,431373,80.07666604789307,10
0.2,5387,94,431467,80.07925018559763,7
0.2,5388,94,431561,80.08183336426053,7
0.2,5389,19,431580,80.07050092764378,14
0.2,5390,19,431599,80.05917269523279,14
0.2,5391,90,431689,80.06101632047478,11
0.2,5392,92,431781,80.06323011310958,10
0.2,5393,94,431875,80.06581386725992,7
0.2,5394,85,431960,80.06672845227062,16
0.2,5395,96,432056,80.06968124536694,6
0.2,5396,17,432073,80.0579951825088,17
0.2,5397,94,432167,80.06057799184883,7
0.2,5398,92,432259,80.06278940544546,10
0.2,5399,92,432351,80.065,9
0.2,5400,90,432441,80.06683947417145,11
0.2,5401,83,432524,80.0673824509441,18
0.2,5402,94,432618,80.06996113270405,7
0.2,5403,92,432710,80.07216876387861,9
0.2,5404,94,432804,80.07474560592044,7
0.2,5405,89,432893,80.0763965963744,14
0.2,5406,94,432987,80.0789717033475,8
0.2,5407,94,433081,80.08154585798816,7
0.2,5408,94,433175,80.08411906082455,7
0.2,5409,94,433269,80.08669131238447,7
0.2,5410,95,433364,80.08944742191831,6
0.2,5411,90,433454,80.09127864005913,12
0.2,5412,90,433544,80.09310918159986,12
0.2,5413,21,433565,80.08219431104544,13
0.2,5414,90,433655,80.08402585410896,11
0.2,5415,92,433747,80.08622599704579,9
0.2,5416,93,433840,80.08860993169651,8
0.2,5417,92,433932,80.0908084163898,12
0.2,5418,87,434019,80.09208341022328,17
0.2,5419,94,434113,80.09464944649447,8
0.2,5420,95,434208,80.09739900387382,8
0.2,5421,93,434301,80.09977867945408,8
0.2,5422,92,434393,80.10197307763231,10
0.2,5423,89,434482,80.10361356932154,12
0.2,5424,93,434575,80.10599078341014,8
0.2,5425,94,434669,80.10855141909326,7
0.2,5426,96,434765,80.11147963884282,6
0.2,5427,91,434856,80.11348563006632,10
0.2,5428,94,434950,80.11604347025235,7
0.2,5429,89,435039,80.11767955801105,12
0.2,5430,94,435133,80.12023568403609,9
0.2,5431,94,435227,80.1227908689249,7
0.2,5432,96,435323,80.12571323394073,6
0.2,5433,95,435418,80.12845049687155,6
0.2,5434,93,435511,80.13081876724931,8
0.2,5435,90,435601,80.13263428991905,11
0.2,5436,93,435694,80.13500091962479,8
0.2,5437,93,435787,80.13736667892607,8
0.2,5438,92,435879,80.13954771097629,9
0.2,5439,83,435962,80.14007352941177,18
0.2,5440,92,436054,80.14225326226797,9
0.2,5441,94,436148,80.14479970599045,7
0.2,5442,92,436240,80.14697776961235,9
0.2,5443,23,436263,80.13648052902278,10
0.2,5444,92,436355,80.1386593204775,9
0.2,5445,90,436445,80.14047006977599,12
0.2,5446,86,436531,80.14154580503029,17
0.2,5447,92,436623,80.14372246696036,9
0.2,5448,90,436713,80.14553129014499,14
0.2,5449,17,436730,80.13394495412844,16
0.2,5450,92,436822,80.13612181251146,9
0.2,5451,93,436915,80.13848129126926,8
0.2,5452,94,437009,80.14102328993215,7
0.2,5453,89,437098,80.14264759809315,13
0.2,5454,93,437191,80.14500458295142,8
0.2,5455,79,437270,80.14479472140762,22
0.2,5456,90,437360,80.1466006963533,11
0.2,5457,92,437452,80.14877244411872,10
0.2,5458,94,437546,80.15130976369298,9
0.2,5459,90,437636,80.15311355311356,12
0.2,5460,94,437730,80.15564914850759,8
0.2,5461,96,437826,80.15854998169169,6
0.2,5462,92,437918,80.16071755445726,9
0.2,5463,92,438010,80.16288433382138,10
0.2,5464,93,438103,80.16523330283623,9
0.2,5465,94,438197,80.1677643615075,8
0.2,5466,91,438288,80.16974574721054,10
0.2,5467,95,438383,80.17245793708851,9
0.2,5468,27,438410,80.16273541780947,6
0.2,5469,92,438502,80.16489945155394,9
0.2,5470,93,438595,80.16724547614696,8
0.2,5471,95,438690,80.16995614035088,6
0.2,5472,87,438777,80.1712040928193,14
0.2,5473,94,438871,80.1737303617099,7
0.2,5474,86,438957,80.17479452054795,15
0.2,5475,90,439047,80.17658875091307,12
0.2,5476,96,439143,80.1794778163228,6
0.2,5477,94,439237,80.18200073019351,7
0.2,5478,94,439331,80.18452272312466,8
0.2,5479,26,439357,80.17463503649635,6
0.2,5480,25,439382,80.16456850939609,8
0.2,5481,93,439475,80.16690988690259,8
0.2,5482,94,439569,80.169432792267,7
0.2,5483,93,439662,80.17177242888403,8
0.2,5484,95,439757,80.17447584320875,8
0.2,5485,94,439851,80.1769959897922,7
0.2,5486,91,439942,80.1789684709313,10
0.2,5487,91,440033,80.18094023323616,10
0.2,5488,92,440125,80.18309345964657,10
0.2,5489,93,440218,80.18542805100182,8
0.2,5490,22,440240,80.17483154252413,10
0.2,5491,90,440330,80.17662053896576,11
0.2,5492,94,440424,80.17913708356089,7
0.2,5493,94,440518,80.18165271204951,10
0.2,5494,19,440537,80.1705186533212,15
0.2,5495,95,440632,80.17321688500728,6
0.2,5496,26,440658,80.16336183372749,7
0.2,5497,93,440751,80.16569661695162,8
0.2,5498,92,440843,80.1678486997636,10
0.2,5499,93,440936,80.17018181818182,8
0.2,5500,92,441028,80.1723323032176,9
0.2,5501,80,441108,80.17230098146129,23
0.2,5502,94,441202,80.17481373796112,8
0.2,5503,92,441294,80.17696220930233,9
0.2,5504,90,441384,80.17874659400545,11
0.2,5505,93,441477,80.18107519070105,8
0.2,5506,94,441571,80.18358452878155,8
0.2,5507,94,441665,80.1860929557008,8
0.2,5508,94,441759,80.18860047195498,7
0.2,5509,95,441854,80.19128856624319,6
0.2,5510,95,441949,80.19397568499365,6
0.2,5511,93,442042,80.19629898403484,8
0.2,5512,91,442133,80.1982586613459,12
0.2,5513,91,442224,80.20021762785636,13
0.2,5514,92,442316,80.20235720761559,10
0.2,5515,93,442409,80.20467730239304,9
0.2,5516,90,442499,80.20645278230923,13
0.2,5517,92,442591,80.20859006886553,9
0.2,5518,92,442683,80.21072658090233,9
0.2,5519,94,442777,80.21322463768117,8
0.2,5520,96,442873,80.21608404274588,6
0.2,5521,93,442966,80.21839913074973,8
0.2,5522,94,443060,80.22089444142676,8
0.2,5523,90,443150,80.22266473569877,12
0.2,5524,90,443240,80.22443438914027,11
0.2,5525,86,443326,80.22547955121244,15
0.2,5526,92,443418,80.22760991496291,9
0.2,5527,95,443513,80.23028219971056,8
0.2,5528,90,443603,80.23204919515283,12
0.2,5529,26,443629,80.22224231464737,6
0.2,5530,95,443724,80.22491412041222,8
0.2,5531,-46,443678,80.20209689081706,10
0.2,5532,90,443768,80.20386770287367,12
0.2,5533,89,443857,80.20545717383447,14
0.2,5534,91,443948,80.2074074074074,10
0.2,5535,89,444037,80.20899566473989,12
0.2,5536,94,444131,80.21148636445729,7
0.2,5537,92,444223,80.21361502347418,10
0.2,5538,89,444312,80.21520129987363,12
0.2,5539,21,444333,80.20451263537906,14
0.2,5540,91,444424,80.20646092763039,10
0.2,5541,22,444446,80.19595813785637,10
0.2,5542,94,444540,80.19844849359552,7
0.2,5543,82,444622,80.19877344877345,23
0.2,5544,95,444717,80.2014427412083,7
0.2,5545,93,444810,80.20375045077533,8
0.2,5546,94,444904,80.2062376059131,7
0.2,5547,94,444998,80.20872386445566,7
0.2,5548,95,445093,80.21138943953865,6
0.2,5549,26,445119,80.20162162162163,7
0.2,5550,89,445208,80.20320662943614,12
0.2,5551,91,445299,80.20515129682997,10
0.2,5552,96,445395,80.20799567801188,6
0.2,5553,91,445486,80.2099387828592,10
0.2,5554,94,445580,80.21242124212421,7
0.2,5555,92,445672,80.21454283657307,9
0.2,5556,87,445759,80.21576390138564,15
0.2,5557,94,445853,80.21824397265203,7
0.2,5558,89,445942,80.21982370930023,12
0.2,5559,25,445967,80.20989208633094,7
0.2,5560,95,446062,80.21255169933465,6
0.2,5561,95,446157,80.21521035598705,6
0.2,5562,91,446248,80.21714902031277,10
0.2,5563,92,446340,80.21926671459381,9
0.2,5564,93,446433,80.22156334231806,8
0.2,5565,25,446458,80.21164211282789,7
0.2,5566,93,446551,80.21393928507275,9
0.2,5567,93,446644,80.21623563218391,8
0.2,5568,94,446738,80.21871072005746,7
0.2,5569,90,446828,80.22046678635547,12
0.2,5570,92,446920,80.22258122419673,9
0.2,5571,90,447010,80.224335965542,11
0.2,5572,95,447105,80.22698726000358,8
0.2,5573,95,447200,80.22963760315751,6
0.2,5574,25,447225,80.21973094170404,7
0.2,5575,86,447311,80.22076757532281,15
0.2,5576,93,447404,80.22305899228977,8
0.2,5577,94,447498,80.2255288633919,8
0.2,5578,93,447591,80.22781860548486,9
0.2,5579,88,447679,80.22921146953405,13
0.2,5580,92,447771,80.23132055187243,9
0.2,5581,91,447862,80.23324973127912,11
0.2,5582,-119,447743,80.19756403367366,14
0.2,5583,92,447835,80.1996776504298,10
0.2,5584,87,447922,80.20089525514771,16
0.2,5585,93,448015,80.203186537773,8
0.2,5586,27,448042,80.19366386253803,6
0.2,5587,90,448132,80.19541875447388,11
0.2,5588,22,448154,80.18500626230094,14
0.2,5589,90,448244,80.18676207513417,11
0.2,5590,88,448332,80.18815954212127,13
0.2,5591,93,448425,80.19045064377683,8
0.2,5592,96,448521,80.19327731092437,6
0.2,5593,93,448614,80.1955666785842,10
0.2,5594,95,448709,80.1982126899017,6
0.2,5595,89,448798,80.19978556111508,14
0.2,5596,88,448886,80.20117920314455,13
0.2,5597,96,448982,80.20400142908181,6
0.2,5598,94,449076,80.20646544025719,8
0.2,5599,93,449169,80.20875,9
0.2,5600,95,449264,80.2113908230673,6
0.2,5601,94,449358,80.2138521956444,7
0.2,5602,90,449448,80.21559878636445,11
0.2,5603,89,449537,80.21716630977873,13
0.2,5604,84,449621,80.2178412132025,18
0.2,5605,91,449712,80.219764537995,10
0.2,5606,90,449802,80.2215088282504,11
0.2,5607,89,449891,80.22307417974322,13
0.2,5608,89,449980,80.22463897307898,14
0.2,5609,93,450073,80.22691622103387,8
0.2,5610,93,450166,80.22919265728034,8
0.2,5611,93,450259,80.23146828225232,8
0.2,5612,92,450351,80.23356493853554,9
0.2,5613,95,450446,80.23619522622016,8
0.2,5614,94,450540,80.2386464826358,8
0.2,5615,94,450634,80.24109686609687,7
0.2,5616,86,450720,80.24212212925049,17
0.2,5617,88,450808,80.24350302598789,14
0.2,5618,94,450902,80.24595123687489,8
0.2,5619,93,450995,80.2482206405694,8
0.2,5620,94,451089,80.2506671410781,7
0.2,5621,95,451184,80.25329064389896,6
0.2,5622,15,451199,80.2416859327761,17
0.2,5623,89,451288,80.24324324324324,12
0.2,5624,91,451379,80.24515555555556,10
0.2,5625,91,451470,80.24706718805545,11
0.2,5626,92,451562,80.24915585569575,9
0.2,5627,91,451653,80.25106609808103,10
0.2,5628,92,451745,80.2531533131995,9
0.2,5629,24,451769,80.24316163410302,8
0.2,5630,12,451781,80.23104244361569,21
0.2,5631,95,451876,80.23366477272727,6
0.2,5632,92,451968,80.23575359488727,9
0.2,5633,96,452064,80.23855165069223,6
0.2,5634,87,452151,80.23975155279503,14
0.2,5635,95,452246,80.24237047551455,6
0.2,5636,90,452336,80.2441014724144,12
0.2,5637,94,452430,80.2465413267116,9
0.2,5638,87,452517,80.24773896080866,15
0.2,5639,94,452611,80.25017730496454,7
0.2,5640,91,452702,80.25208296401347,10
0.2,5641,94,452796,80.25451967387451,7
0.2,5642,95,452891,80.25713273081693,6
0.2,5643,92,452983,80.25921332388377,9
0.2,5644,21,453004,80.2487156775908,11
0.2,5645,87,453091,80.24991144172866,14
0.2,5646,94,453185,80.25234637860811,7
0.2,5647,96,453281,80.25513456090651,6
0.2,5648,96,453377,80.25792175606303,6
0.2,5649,22,453399,80.24761061946903,11
0.2,5650,22,453421,80.237303132189,10
0.2,5651,94,453515,80.2397381457891,7
0.2,5652,27,453542,80.2303201839731,6
0.2,5653,94,453636,80.23275557127697,8
0.2,5654,92,453728,80.23483642793988,9
0.2,5655,95,453823,80.23744695898161,6
0.2,5656,91,453914,80.23934947852219,11
0.2,5657,94,454008,80.24178154825026,7
0.2,5658,89,454097,80.24332921010779,12
0.2,5659,20,454117,80.2326855123675,15
0.2,5660,17,454134,80.22151563328033,15
0.2,5661,91,454225,80.22341928647121,11
0.2,5662,94,454319,80.22585202189651,8
0.2,5663,94,454413,80.22828389830508,8
0.2,5664,93,454506,80.23053839364519,10
0.2,5665,92,454598,80.2326156018355,9
0.2,5666,94,454692,80.2350449973531,8
0.2,5667,93,454785,80.23729710656316,8
0.2,5668,80,454865,80.23725524783913,24
0.2,5669,96,454961,80.2400352733686,6
0.2,5670,25,454986,80.23029448069124,7
0.2,5671,16,455002,80.21897038081805,17
0.2,5672,94,455096,80.22139961219813,8
0.2,5673,94,455190,80.22382798731054,7
0.2,5674,93,455283,80.22607929515418,8
0.2,5675,96,455379,80.22885835095137,6
0.2,5676,94,455473,80.23128412894134,7
0.2,5677,94,455567,80.23370905248326,7
0.2,5678,-47,455520,80.21130480718436,10
0.2,5679,95,455615,80.21390845070422,6
0.2,5680,93,455708,80.21615912691428,9
0.2,5681,93,455801,80.21840901091166,8
0.2,5682,95,455896,80.22101002991378,6
0.2,5683,92,455988,80.22308233638283,10
0.2,5684,94,456082,80.2255057167986,7
0.2,5685,24,456106,80.21561730566303,9
0.2,5686,95,456201,80.21821698610867,6
0.2,5687,94,456295,80.2206399437412,7
0.2,5688,96,456391,80.22341360520302,6
0.2,5689,92,456483,80.22548330404219,9
0.2,5690,91,456574,80.22737655947988,10
0.2,5691,94,456668,80.22979620520029,7
0.2,5692,95,456763,80.23239065519058,6
0.2,5693,96,456859,80.2351598173516,6
0.2,5694,94,456953,80.23757682177349,8
0.2,5695,92,457045,80.23964185393258,9
0.2,5696,95,457140,80.2422327540811,6
0.2,5697,91,457231,80.24412074412075,11
0.2,5698,94,457325,80.24653447973328,7
0.2,5699,93,457418,80.24877192982456,8
0.2,5700,26,457444,80.23925627082969,6
0.2,5701,94,457538,80.24166958961767,7
0.2,5702,89,457627,80.24320533052779,12
0.2,5703,95,457722,80.24579242636746,6
0.2,5704,22,457744,80.23558282208589,10
0.2,5705,95,457839,80.23817034700315,6
0.2,5706,94,457933,80.24058174172069,7
0.2,5707,90,458023,80.24229152067274,13
0.2,5708,22,458045,80.23208968295674,12
0.2,5709,91,458136,80.23397548161121,10
0.2,5710,23,458159,80.22395377341972,9
0.2,5711,84,458243,80.22461484593838,20
0.2,5712,91,458334,80.22650096271661,11
0.2,5713,-46,458288,80.20441022051102,10
0.2,5714,95,458383,80.20699912510936,6
0.2,5715,94,458477,80.2094121763471,7
0.2,5716,95,458572,80.21199930033234,6
0.2,5717,95,458667,80.21458551941238,6
0.2,5718,91,458758,80.21647141108585,10
0.2,5719,93,458851,80.21870629370629,8
0.2,5720,21,458872,80.20835518266037,11
0.2,5721,95,458967,80.21094023068856,6
0.2,5722,96,459063,80.21369910885899,6
0.2,5723,86,459149,80.21470999301188,15
0.2,5724,93,459242,80.21694323144105,9
0.2,5725,-126,459116,80.18092909535453,20
0.2,5726,94,459210,80.1833420639078,7
0.2,5727,89,459299,80.1848812849162,13
0.2,5728,18,459317,80.17402688078198,14
0.2,5729,90,459407,80.17574171029669,11
0.2,5730,93,459500,80.17797941022509,8
0.2,5731,90,459590,80.17969295184926,12
0.2,5732,88,459678,80.1810570381999,13
0.2,5733,91,459769,80.1829438437391,10
0.2,5734,23,459792,80.17297297297297,10
0.2,5735,94,459886,80.17538354253836,7
0.2,5736,89,459975,80.176921736099,12
0.2,5737,92,460067,80.17898222377134,10
0.2,5738,94,460161,80.18139048614741,7
0.2,5739,95,460256,80.18397212543555,6
0.2,5740,93,460349,80.18620449399059,8
0.2,5741,95,460444,80.18878439568094,7
0.2,5742,91,460535,80.19066689883336,10
0.2,5743,92,460627,80.19272284122563,9
0.2,5744,90,460717,80.19442993907745,11
0.2,5745,91,460808,80.19631047685347,12
0.2,5746,87,460895,80.1974943448756,15
0.2,5747,92,460987,80.19954766875435,9
0.2,5748,86,461073,80.20055661854235,18
0.2,5749,24,461097,80.19078260869566,8
0.2,5750,94,461191,80.19318379412276,8
0.2,5751,26,461217,80.18376216968011,7
0.2,5752,91,461308,80.18564227359639,10
0.2,5753,92,461400,80.18769551616266,10
0.2,5754,91,461491,80.18957428323198,10
0.2,5755,89,461580,80.19110493398193,12
0.2,5756,90,461670,80.19280875455966,11
0.2,5757,86,461756,80.19381729767281,15
0.2,5758,88,461844,80.19517277305087,13
0.2,5759,95,461939,80.19774305555555,6
0.2,5760,90,462029,80.19944454087832,11
0.2,5761,87,462116,80.20062478306144,14
0.2,5762,96,462212,80.20336630227312,6
0.2,5763,89,462301,80.20489243580846,13
0.2,5764,94,462395,80.20728534258456,7
0.2,5765,88,462483,80.20863683662851,13
0.2,5766,95,462578,80.21120166464367,6
0.2,5767,94,462672,80.2135922330097,7
0.2,5768,-54,462618,80.19032761310453,19
0.2,5769,90,462708,80.19202772963605,13
0.2,5770,86,462794,80.19303413619824,16
0.2,5771,94,462888,80.1954261954262,7
0.2,5772,92,462980,80.19747098562273,9
0.2,5773,92,463072,80.19951506754417,11
0.2,5774,93,463165,80.2017316017316,8
0.2,5775,93,463258,80.20394736842105,8
0.2,5776,94,463352,80.2063354682361,7
0.2,5777,94,463446,80.20872274143302,7
0.2,5778,94,463540,80.2111091884409,8
0.2,5779,95,463635,80.2136678200692,6
0.2,5780,90,463725,80.21536066424494,11
0.2,5781,86,463811,80.21636112071947,16
0.2,5782,89,463900,80.21787999308317,13
0.2,5783,85,463985,80.21870677731674,16
0.2,5784,96,464081,80.22143474503025,6
0.2,5785,92,464173,80.2234704459039,9
0.2,5786,95,464268,80.22602384655262,7
0.2,5787,95,464363,80.22857636489289,9
0.2,5788,86,464449,80.2295733287269,15
0.2,5789,94,464543,80.23195164075993,7
0.2,5790,92,464635,80.23398376791573,14
0.2,5791,19,464654,80.22341160220995,13
0.2,5792,92,464746,80.22544450198515,9
0.2,5793,93,464839,80.22764929237142,8
0.2,5794,90,464929,80.22933563416738,13
0.2,5795,86,465015,80.23033126293996,16
0.2,5796,91,465106,80.23218906330861,10
0.2,5797,91,465197,80.23404622283546,11
0.2,5798,96,465293,80.23676495947578,6
0.2,5799,93,465386,80.23896551724138,8
0.2,5800,86,465472,80.23995862782279,15
0.2,5801,87,465559,80.24112375043089,14
0.2,5802,93,465652,80.24332241943821,8
0.2,5803,92,465744,80.24534803583735,9
0.2,5804,93,465837,80.24754521963824,8
0.2,5805,91,465928,80.24939717533586,10
0.2,5806,91,466019,80.25124849319786,10
0.2,5807,92,466111,80.25327134986226,9
0.2,5808,94,466205,80.2556378034085,7
0.2,5809,93,466298,80.25783132530121,8
0.2,5810,93,466391,80.26002409223885,8
0.2,5811,89,466480,80.26152787336545,12
0.2,5812,90,466570,80.26320316531911,11
0.2,5813,92,466662,80.26522187822498,10
0.2,5814,92,466754,80.26723989681857,10
0.2,5815,96,466850,80.26994497936727,6
0.2,5816,90,466940,80.27161767233969,13
0.2,5817,92,467032,80.27363355104848,9
0.2,5818,93,467125,80.27582058772985,9
0.2,5819,23,467148,80.2659793814433,10
0.2,5820,91,467239,80.26782339804157,10
0.2,5821,92,467331,80.26983854345586,9
0.2,5822,92,467423,80.27185299673708,9
0.2,5823,94,467517,80.27421016483517,7
0.2,5824,89,467606,80.27570815450643,12
0.2,5825,93,467699,80.27789220734638,8
0.2,5826,95,467794,80.28041874034666,6
0.2,5827,91,467885,80.28225806451613,11
0.2,5828,88,467973,80.28358208955224,13
0.2,5829,93,468066,80.28576329331047,8
0.2,5830,94,468160,80.28811524609844,7
0.2,5831,90,468250,80.289780521262,12
0.2,5832,90,468340,80.29144522544145,11
0.2,5833,95,468435,80.29396640383956,7
0.2,5834,93,468528,80.2961439588689,8
0.2,5835,23,468551,80.28632625085675,9
0.2,5836,93,468644,80.28850436868254,8
0.2,5837,90,468734,80.29016786570743,11
0.2,5838,27,468761,80.28104127419078,6
0.2,5839,92,468853,80.28304794520548,9
0.2,5840,89,468942,80.28454031843863,13
0.2,5841,93,469035,80.28671687778159,8
0.2,5842,86,469121,80.28769467739176,16
0.2,5843,96,469217,80.2903832991102,6
0.2,5844,93,469310,80.29255774165954,8
0.2,5845,94,469404,80.29490249743414,8
0.2,5846,90,469494,80.29656233966136,11
0.2,5847,90,469584,80.29822161422709,11
0.2,5848,94,469678,80.30056419900838,7
0.2,5849,95,469773,80.30307692307693,6
0.2,5850,92,469865,80.30507605537515,10
0.2,5851,91,469956,80.3069036226931,10
0.2,5852,93,470049,80.30907227063045,8
0.2,5853,94,470143,80.31141100102494,7
0.2,5854,24,470167,80.30179333902647,8
0.2,5855,83,470250,80.30225409836065,19
0.2,5856,94,470344,80.30459279494622,8
0.2,5857,87,470431,80.30573574598839,14
0.2,5858,94,470525,80.30807305000853,7
0.2,5859,94,470619,80.310409556314,7
0.2,5860,90,470709,80.31206278792015,11
0.2,5861,94,470803,80.3143978164449,7
0.2,5862,89,470892,80.3158792427085,13
0.2,5863,94,470986,80.31821282401091,7
0.2,5864,96,471082,80.32088661551578,6
0.2,5865,95,471177,80.32338902147971,7
0.2,5866,96,471273,80.32606101926027,6
0.2,5867,86,471359,80.32702794819359,19
0.2,5868,96,471455,80.32969841540296,6
0.2,5869,94,471549,80.3320272572402,7
0.2,5870,92,471641,80.33401464827116,11
0.2,5871,96,471737,80.3366825613079,7
0.2,5872,19,471756,80.3262387195641,13
0.2,5873,95,471851,80.3287368062649,6
0.2,5874,93,471944,80.33089361702127,10
0.2,5875,89,472033,80.33236895847516,13
0.2,5876,93,472126,80.33452441721967,8
0.2,5877,88,472214,80.3358285130997,14
0.2,5878,86,472300,80.33679197142371,15
0.2,5879,90,472390,80.33843537414965,11
0.2,5880,95,472485,80.34092841353511,6
0.2,5881,95,472580,80.34342060523632,6
0.2,5882,94,472674,80.34574196838348,8
0.2,5883,92,472766,80.34772263766145,9
0.2,5884,89,472855,80.34919286321156,12
0.2,5885,95,472950,80.35168195718654,7
0.2,5886,93,473043,80.3538304739256,9
0.2,5887,21,473064,80.34375,11
0.2,5888,84,473148,80.34437086092716,17
0.2,5889,92,473240,80.34634974533107,9
0.2,5890,94,473334,80.34866745883551,7
0.2,5891,94,473428,80.3509843856076,8
0.2,5892,95,473523,80.35347021890378,6
0.2,5893,95,473618,80.3559552086868,8
0.2,5894,93,473711,80.35810008481764,8
0.2,5895,23,473734,80.34837177747626,10
0.2,5896,94,473828,80.35068678989316,7
0.2,5897,92,473920,80.35266191929468,9
0.2,5898,96,474016,80.35531446007798,6
0.2,5899,91,474107,80.3571186440678,10
0.2,5900,95,474202,80.35960006778512,6
0.2,5901,92,474294,80.36157234835649,9
0.2,5902,24,474318,80.35202439437575,8
0.2,5903,23,474341,80.34231029810299,10
0.2,5904,94,474435,80.34462320067739,7
0.2,5905,93,474528,80.34676600067728,8
0.2,5906,92,474620,80.34873878449298,10
0.2,5907,-48,474572,80.32701421800948,11
0.2,5908,-56,474516,80.30394313758673,21
0.2,5909,95,474611,80.30642978003384,6
0.2,5910,94,474705,80.30874640500761,7
0.2,5911,88,474793,80.31004736129906,15
0.2,5912,91,474884,80.31185523422967,10
0.2,5913,90,474974,80.31349340547852,11
0.2,5914,96,475070,80.31614539306847,6
0.2,5915,93,475163,80.3182893847194,8
0.2,5916,91,475254,80.32009464255535,10
0.2,5917,92,475346,80.32206826630619,9
0.2,5918,95,475441,80.32454806555161,6
0.2,5919,26,475467,80.31537162162162,6
0.2,5920,93,475560,80.31751393345719,10
0.2,5921,89,475649,80.31898007429922,12
0.2,5922,96,475745,80.32162755360459,6
0.2,5923,26,475771,80.3124577987846,8
0.2,5924,95,475866,80.31493670886076,6
0.2,5925,94,475960,80.31724603442457,8
0.2,5926,92,476052,80.31921714189303,9
0.2,5927,88,476140,80.32051282051282,13
0.2,5928,74,476214,80.31944678697926,28
0.2,5929,83,476297,80.31989881956156,23
0.2,5930,92,476389,80.32186815039623,9
0.2,5931,94,476483,80.32417397167903,8
0.2,5932,92,476575,80.32614191808528,9
0.2,5933,92,476667,80.32810920121335,10
0.2,5934,93,476760,80.33024431339511,9
0.2,5935,96,476856,80.33288409703503,6
0.2,5936,96,476952,80.3355229914098,7
0.2,5937,94,477046,80.33782418322667,7
0.2,5938,89,477135,80.33928270752652,12
0.2,5939,25,477160,80.32996632996633,7
0.2,5940,93,477253,80.33209897323682,9
0.2,5941,94,477347,80.33439919219119,7
0.2,5942,93,477440,80.33653037186606,9
0.2,5943,95,477535,80.33899730820995,6
0.2,5944,93,477628,80.34112699747688,8
0.2,5945,92,477720,80.343087790111,9
0.2,5946,93,477813,80.3452160753321,9
0.2,5947,94,477907,80.34751176866173,7
0.2,5948,91,477998,80.34930240376534,12
0.2,5949,94,478092,80.35159663865547,7
0.2,5950,90,478182,80.3532179465636,11
0.2,5951,20,478202,80.34307795698925,15
0.2,5952,93,478295,80.34520409877372,8
0.2,5953,92,478387,80.3471615720524,10
0.2,5954,90,478477,80.3487825356843,11
0.2,5955,93,478570,80.35090664875756,8
0.2,5956,89,478659,80.35235856974987,12
0.2,5957,95,478754,80.35481705270224,6
0.2,5958,90,478844,80.35643564356435,11
0.2,5959,87,478931,80.35755033557047,15
0.2,5960,92,479023,80.3595034390203,9
0.2,5961,92,479115,80.36145588728614,9
0.2,5962,87,479202,80.36256917658896,14
0.2,5963,-51,479151,80.34054325955735,14
0.2,5964,22,479173,80.33076278290025,10
0.2,5965,87,479260,80.33188065705666,15
0.2,5966,91,479351,80.3336685101391,10
0.2,5967,91,479442,80.33545576407506,12
0.2,5968,92,479534,80.33740995141565,9
0.2,5969,93,479627,80.3395309882747,8
0.2,5970,95,479722,80.34198626695697,7
0.2,5971,90,479812,80.3436034829203,11
0.2,5972,93,479905,80.34572241754562,8
0.2,5973,23,479928,80.33612320053565,9
0.2,5974,95,480023,80.33857740585773,7
0.2,5975,91,480114,80.34036144578313,10
0.2,5976,96,480210,80.34298142881045,6
0.2,5977,90,480300,80.34459685513549,11
0.2,5978,17,480317,80.33400234152869,16
0.2,5979,91,480408,80.33578595317725,11
0.2,5980,92,480500,80.33773616452099,10
0.2,5981,92,480592,80.33968572383819,9
0.2,5982,25,480617,80.330436236002,8
0.2,5983,89,480706,80.33188502673796,13
0.2,5984,96,480802,80.33450292397661,6
0.2,5985,-123,480679,80.30053458068828,17
0.2,5986,94,480773,80.30282278269584,7
0.2,5987,94,480867,80.30511022044088,7
0.2,5988,15,480882,80.29420604441476,17
0.2,5989,25,480907,80.28497495826377,7
0.2,5990,94,481001,80.28726422967785,7
0.2,5991,-46,480955,80.26618825100134,10
0.2,5992,96,481051,80.2688136158852,6
0.2,5993,95,481146,80.27127127127127,6
0.2,5994,25,481171,80.26205170975813,7
0.2,5995,96,481267,80.26467645096731,6
0.2,5996,86,481353,80.2656328164082,16
0.2,5997,95,481448,80.26808936312104,6
0.2,5998,90,481538,80.2697116186031,11
0.2,5999,91,481629,80.2715,11
0.2,6000,93,481722,80.27362106315614,8
0.2,6001,23,481745,80.26407864045318,9
0.2,6002,93,481838,80.26620023321672,8
0.2,6003,-192,481646,80.22085276482345,18
0.2,6004,21,481667,80.21099084096586,11
0.2,6005,91,481758,80.21278721278722,12
0.2,6006,94,481852,80.21508240386216,8
0.2,6007,91,481943,80.2168774966711,10
0.2,6008,27,481970,80.20802130138127,6
0.2,6009,93,482063,80.21014975041598,8
0.2,6010,89,482152,80.21161204458492,12
0.2,6011,27,482179,80.20276114437792,6
0.2,6012,94,482273,80.20505571262265,8
0.2,6013,96,482369,80.20768207515796,6
0.2,6014,93,482462,80.20980881130507,9
0.2,6015,94,482556,80.21210106382979,8
0.2,6016,94,482650,80.21439255442911,7
0.2,6017,92,482742,80.21635094715853,9
0.2,6018,92,482834,80.21830868915102,9
0.2,6019,96,482930,80.22093023255815,6
0.2,6020,87,483017,80.22205613685435,15
0.2,6021,95,483112,80.22451012952507,6
0.2,6022,95,483207,80.22696330732194,6
0.2,6023,-49,483158,80.20551128818062,13
0.2,6024,94,483252,80.20780082987552,7
0.2,6025,93,483345,80.20992366412214,8
0.2,6026,90,483435,80.21154803384769,11
0.2,6027,89,483524,80.21300597213006,13
0.2,6028,92,483616,80.21496102172831,10
0.2,6029,93,483709,80.21708126036484,10
0.2,6030,92,483801,80.21903498590615,9
0.2,6031,88,483889,80.220324933687,14
0.2,6032,92,483981,80.22227747389358,9
0.2,6033,94,484075,80.22456082200861,7
0.2,6034,90,484165,80.2261806130903,11
0.2,6035,85,484250,80.22697150430749,17
0.2,6036,88,484338,80.22825906907404,13
0.2,6037,93,484431,80.23037429612454,8
0.2,6038,93,484524,80.23248882265275,8
0.2,6039,95,484619,80.23493377483443,8
0.2,6040,95,484714,80.23737791756332,7
0.2,6041,94,484808,80.23965574313141,8
0.2,6042,92,484900,80.24160185338408,9
0.2,6043,94,484994,80.24387822634017,7
0.2,6044,85,485079,80.24466501240695,16
0.2,6045,93,485172,80.24677472709229,9
0.2,6046,95,485267,80.24921448652225,7
0.2,6047,92,485359,80.2511574074074,9
0.2,6048,89,485448,80.25260373615474,13
0.2,6049,89,485537,80.25404958677686,13
0.2,6050,91,485628,80.25582548339118,11
0.2,6051,83,485711,80.25627891606081,18
0.2,6052,89,485800,80.25772344292086,12
0.2,6053,23,485823,80.24826560951438,9
0.2,6054,90,485913,80.24987613542527,12
0.2,6055,90,486003,80.25148612945839,11
0.2,6056,92,486095,80.25342578834406,9
0.2,6057,96,486191,80.25602509078904,6
0.2,6058,94,486285,80.25829344776366,8
0.2,6059,22,486307,80.2486798679868,10
0.2,6060,95,486402,80.25111367761096,6
0.2,6061,96,486498,80.25371164632135,6
0.2,6062,93,486591,80.25581395348837,8
0.2,6063,94,486685,80.25808047493403,7
0.2,6064,96,486781,80.26067600989283,6
0.2,6065,91,486872,80.26244642268381,11
0.2,6066,89,486961,80.26388659963739,14
0.2,6067,94,487055,80.2661502966381,7
0.2,6068,93,487148,80.26824847586093,8
0.2,6069,26,487174,80.25930807248764,6
0.2,6070,91,487265,80.26107725251194,10
0.2,6071,24,487289,80.2518115942029,10
0.2,6072,93,487382,80.25391075251112,9
0.2,6073,94,487476,80.25617385577873,7
0.2,6074,94,487570,80.25843621399177,8
0.2,6075,95,487665,80.26086240947993,8
0.2,6076,88,487753,80.2621359223301,13
0.2,6077,90,487843,80.26373807173412,11
0.2,6078,93,487936,80.26583319624939,10
0.2,6079,93,488029,80.26792763157894,8
0.2,6080,91,488120,80.26969248478869,13
0.2,6081,22,488142,80.2601118053272,12
0.2,6082,21,488163,80.25036988328128,13
0.2,6083,94,488257,80.2526298487837,8
0.2,6084,89,488346,80.25406737880033,12
0.2,6085,89,488435,80.25550443641144,12
0.2,6086,90,488525,80.25710530639067,11
0.2,6087,93,488618,80.25919842312746,11
0.2,6088,93,488711,80.26129085235671,8
0.2,6089,94,488805,80.26354679802955,7
0.2,6090,92,488897,80.26547364964702,9
0.2,6091,89,488986,80.26690741956665,13
0.2,6092,91,489077,80.26866896438536,10
0.2,6093,92,489169,80.27059402691172,9
0.2,6094,95,489264,80.27301066447909,6
0.2,6095,92,489356,80.2749343832021,9
0.2,6096,90,489446,80.27652944070854,11
0.2,6097,92,489538,80.2784519514595,9
0.2,6098,92,489630,80.2803738317757,10
0.2,6099,95,489725,80.2827868852459,6
0.2,6100,96,489821,80.28536305523684,6
0.2,6101,96,489917,80.28793838085873,6
0.2,6102,95,490012,80.29034900868426,7
0.2,6103,94,490106,80.29259501965925,7
0.2,6104,21,490127,80.28288288288289,11
0.2,6105,95,490222,80.28529315427448,7
0.2,6106,93,490315,80.28737514327821,10
0.2,6107,95,490410,80.28978388998036,6
0.2,6108,92,490502,80.29170076935668,10
0.2,6109,87,490589,80.29279869067103,14
0.2,6110,90,490679,80.29438717067583,11
0.2,6111,94,490773,80.29662958115183,8
0.2,6112,-44,490729,80.27629641747096,8
0.2,6113,94,490823,80.27854105332025,8
0.2,6114,96,490919,80.28111201962388,6
0.2,6115,92,491011,80.28302812295618,9
0.2,6116,96,491107,80.2855975151218,6
0.2,6117,95,491202,80.28800261523374,6
0.2,6118,92,491294,80.28991665304788,9
0.2,6119,96,491390,80.29248366013071,6
0.2,6120,91,491481,80.2942329684692,11
0.2,6121,90,491571,80.29581836001307,11
0.2,6122,82,491653,80.29609668463172,19
0.2,6123,91,491744,80.29784454604834,10
0.2,6124,90,491834,80.29942857142858,11
0.2,6125,94,491928,80.30166503428012,7
0.2,6126,94,492022,80.30390076709647,8
0.2,6127,93,492115,80.30597258485639,8
0.2,6128,94,492209,80.3082068852994,7
0.2,6129,94,492303,80.31044045676998,7
0.2,6130,88,492391,80.3116946664492,13
0.2,6131,93,492484,80.31376386170906,9
0.2,6132,92,492576,80.31566932985488,9
0.2,6133,86,492662,80.31659602217151,15
0.2,6134,96,492758,80.31915240423798,6
0.2,6135,95,492853,80.32154498044329,6
0.2,6136,93,492946,80.32361088479713,9
0.2,6137,93,493039,80.3256761159987,10
0.2,6138,92,493131,80.32757778139762,9
0.2,6139,92,493223,80.32947882736157,9
0.2,6140,91,493314,80.33121641426477,10
0.2,6141,96,493410,80.3337675024422,6
0.2,6142,93,493503,80.3358293993163,8
0.2,6143,21,493524,80.326171875,11
0.2,6144,86,493610,80.32709519934906,15
0.2,6145,18,493628,80.31695411649854,15
0.2,6146,93,493721,80.31901740686514,8
0.2,6147,94,493815,80.32124268054652,7
0.2,6148,95,493910,80.32362985851358,6
0.2,6149,94,494004,80.32585365853659,7
0.2,6150,-50,493954,80.30466590798244,15
0.2,6151,92,494046,80.30656697009103,9
0.2,6152,91,494137,80.30830489192265,10
0.2,6153,95,494232,80.31069223269418,6
0.2,6154,87,494319,80.31177904142973,14
0.2,6155,94,494413,80.31400259909032,8
0.2,6156,23,494436,80.30469384440474,10
0.2,6157,21,494457,80.29506333225073,11
0.2,6158,88,494545,80.29631433674298,15
0.2,6159,80,494625,80.29626623376623,22
0.2,6160,92,494717,80.29816588216198,9
0.2,6161,94,494811,80.30038948393378,7
0.2,6162,91,494902,80.30212558818756,10
0.2,6163,91,494993,80.30386112913692,10
0.2,6164,94,495087,80.30608272506083,7
0.2,6165,22,495109,80.29662666234188,10
0.2,6166,22,495131,80.28717366628831,11
0.2,6167,94,495225,80.28939688715953,8
0.2,6168,96,495321,80.2919435889123,6
0.2,6169,23,495344,80.28265802269044,9
0.2,6170,25,495369,80.27369956246962,7
0.2,6171,27,495396,80.2650680492547,6
0.2,6172,95,495491,80.2674550461688,7
0.2,6173,91,495582,80.26919339164237,11
0.2,6174,95,495677,80.27157894736843,6
0.2,6175,90,495767,80.27315414507773,11
0.2,6176,94,495861,80.27537639630889,7
0.2,6177,23,495884,80.2661055357721,9
0.2,6178,92,495976,80.26800453147759,10
0.2,6179,96,496072,80.2705501618123,6
0.2,6180,89,496161,80.27196246562045,14
0.2,6181,93,496254,80.27402135231317,8
0.2,6182,95,496349,80.27640304059518,6
0.2,6183,95,496444,80.27878395860284,6
0.2,6184,88,496532,80.2800323362975,15
0.2,6185,27,496559,80.27141933397995,6
0.2,6186,-47,496512,80.25084855341846,10
0.2,6187,92,496604,80.25274725274726,10
0.2,6188,92,496696,80.25464533850379,9
0.2,6189,94,496790,80.25686591276252,8
0.2,6190,93,496883,80.2589242448716,8
0.2,6191,93,496976,80.2609819121447,8
0.2,6192,94,497070,80.26320038753431,7
0.2,6193,96,497166,80.26574103971585,6
0.2,6194,95,497261,80.26811945117029,6
0.2,6195,96,497357,80.27065848934797,6
0.2,6196,96,497453,80.27319670808455,6
0.2,6197,94,497547,80.27541142303969,8
0.2,6198,95,497642,80.27778673979674,6
0.2,6199,94,497736,80.28,7
0.2,6200,95,497831,80.2823738106757,7
0.2,6201,95,497926,80.28474685585294,7
0.2,6202,91,498017,80.2864742866355,10
0.2,6203,89,498106,80.28787878787878,13
0.2,6204,94,498200,80.290088638195,7
0.2,6205,92,498292,80.29197550757331,9
0.2,6206,94,498386,80.29418398582246,8
0.2,6207,95,498481,80.29655283505154,6
0.2,6208,18,498499,80.28651956836849,16
0.2,6209,-50,498449,80.26553945249597,13
0.2,6210,92,498541,80.26742875543391,9
0.2,6211,89,498630,80.26883451384417,15
0.2,6212,91,498721,80.27056172541445,11
0.2,6213,91,498812,80.27228838107499,10
0.2,6214,93,498905,80.27433628318585,9
0.2,6215,95,499000,80.27670527670527,6
0.2,6216,83,499083,80.27714331671224,18
0.2,6217,92,499175,80.27902862656804,9
0.2,6218,23,499198,80.26981829876186,9
0.2,6219,90,499288,80.27138263665594,11
0.2,6220,91,499379,80.27310721748916,11
0.2,6221,92,499471,80.27499196399872,9
0.2,6222,92,499563,80.27687610477261,9
0.2,6223,88,499651,80.27811696658098,15
0.2,6224,96,499747,80.28064257028113,6
0.2,6225,26,499773,80.27192418888532,6
0.2,6226,94,499867,80.27412879396178,8
0.2,6227,92,499959,80.27601156069365,9
0.2,6228,93,500052,80.2780542623214,8
0.2,6229,23,500075,80.26886035313002,10
0.2,6230,90,500165,80.27042208313273,11
0.2,6231,94,500259,80.27262516046213,8
0.2,6232,22,500281,80.26327611102198,10
0.2,6233,88,500369,80.26451716393969,14
0.2,6234,94,500463,80.26672012830794,7
0.2,6235,87,500550,80.26779987171264,15
0.2,6236,92,500642,80.2696809363476,9
0.2,6237,92,500734,80.27156139788394,9
0.2,6238,91,500825,80.27328097451515,10
0.2,6239,95,500920,80.27564102564102,6
0.2,6240,90,501010,80.27719916680019,11
0.2,6241,95,501105,80.27955783402756,7
0.2,6242,89,501194,80.28095466922954,12
0.2,6243,93,501287,80.28299167200512,8
0.2,6244,91,501378,80.28470776621297,10
0.2,6245,89,501467,80.28610310598783,13
0.2,6246,94,501561,80.28829838322395,8
0.2,6247,94,501655,80.29049295774648,7
0.2,6248,96,501751,80.29300688110098,6
0.2,6249,92,501843,80.29488,11
0.2,6250,95,501938,80.29723244280915,6
0.2,6251,92,502030,80.29910428662828,9
0.2,6252,92,502122,80.30097553174477,10
0.2,6253,93,502215,80.30300607611129,8
0.2,6254,94,502309,80.30519584332534,7
0.2,6255,94,502403,80.30738491048594,7
0.2,6256,-60,502343,80.28496084385488,24
0.2,6257,94,502437,80.28715244487057,7
0.2,6258,95,502532,80.28950311551365,6
0.2,6259,93,502625,80.29153354632588,10
0.2,6260,92,502717,80.29340360964702,9
0.2,6261,84,502801,80.29399552858511,17
0.2,6262,87,502888,80.29506626217467,14
0.2,6263,23,502911,80.28591954022988,9
0.2,6264,92,503003,80.2877893056664,9
0.2,6265,94,503097,80.28997765719757,8
0.2,6266,24,503121,80.28099569171853,10
0.2,6267,27,503148,80.2724952137843,6
0.2,6268,96,503244,80.27500398787686,6
0.2,6269,92,503336,80.27687400318979,10
0.2,6270,25,503361,80.26805932068251,8
0.2,6271,94,503455,80.27024872448979,7
0.2,6272,88,503543,80.27148095010362,14
0.2,6273,92,503635,80.27335033471469,9
0.2,6274,90,503725,80.27490039840637,11
0.2,6275,24,503749,80.2659337157425,9
0.2,6276,92,503841,80.2678030906484,9
0.2,6277,92,503933,80.2696718700223,9
0.2,6278,90,504023,80.2712215320911,11
0.2,6279,92,504115,80.27308917197452,11
0.2,6280,92,504207,80.27495621716287,9
0.2,6281,91,504298,80.27666348296721,10
0.2,6282,94,504392,80.27884768422727,7
0.2,6283,95,504487,80.281190324634,7
0.2,6284,96,504583,80.28369132856007,6
0.2,6285,88,504671,80.28491886732421,14
0.2,6286,92,504763,80.28678224908542,9
0.2,6287,93,504856,80.28880407124682,9
0.2,6288,91,504947,80.2905072348545,10
0.2,6289,93,505040,80.29252782193959,9
0.2,6290,96,505136,80.29502463837228,6
0.2,6291,86,505222,80.29593134138588,15
0.2,6292,93,505315,80.29795010328937,8
0.2,6293,92,505407,80.2998093422307,9
0.2,6294,93,505500,80.30182684670373,8
0.2,6295,93,505593,80.30384371029226,9
0.2,6296,94,505687,80.3060187390821,8
0.2,6297,21,505708,80.29660209590347,12
0.2,6298,92,505800,80.29846007302747,9
0.2,6299,93,505893,80.30047619047619,8
0.2,6300,94,505987,80.30265037295668,7
0.2,6301,93,506080,80.30466518565535,9
0.2,6302,14,506094,80.29414564493098,19
0.2,6303,92,506186,80.29600253807106,14
0.2,6304,93,506279,80.29801744647105,8
0.2,6305,13,506292,80.2873453853473,19
0.2,6306,95,506387,80.28967813540511,7
0.2,6307,94,506481,80.2918516169943,11
0.2,6308,92,506573,80.29370740212396,9
0.2,6309,94,506667,80.2958795562599,7
0.2,6310,27,506694,80.28743463793377,6
0.2,6311,90,506784,80.28897338403041,12
0.2,6312,92,506876,80.29082844923174,9
0.2,6313,90,506966,80.29236617041495,11
0.2,6314,15,506981,80.28202692003167,17
0.2,6315,93,507074,80.28404053198227,8
0.2,6316,87,507161,80.28510368845971,16
0.2,6317,95,507256,80.28743273187717,6
0.2,6318,95,507351,80.28976103813895,6
0.2,6319,92,507443,80.29161392405064,11
0.2,6320,23,507466,80.28255022939409,9
0.2,6321,94,507560,80.28472002530845,7
0.2,6322,91,507651,80.28641467657758,10
0.2,6323,94,507745,80.28858317520556,8
0.2,6324,96,507841,80.29106719367589,6
0.2,6325,93,507934,80.2930761934872,8
0.2,6326,88,508022,80.29429429429429,13
0.2,6327,94,508116,80.29646017699115,7
0.2,6328,94,508210,80.29862537525675,7
0.2,6329,93,508303,80.30063191153239,8
0.2,6330,94,508397,80.30279576686148,8
0.2,6331,93,508490,80.3048010107391,9
0.2,6332,93,508583,80.30680562134849,9
0.2,6333,95,508678,80.30912535522576,8
0.2,6334,92,508770,80.31097079715865,9
0.2,6335,95,508865,80.31328914141415,6
0.2,6336,93,508958,80.31529114723055,8
0.2,6337,96,509054,80.31776585673714,6
0.2,6338,89,509143,80.31913551033286,12
0.2,6339,92,509235,80.32097791798107,9
0.2,6340,91,509326,80.32266204068759,10
0.2,6341,92,509418,80.32450331125828,9
0.2,6342,96,509514,80.32697461768879,6
0.2,6343,90,509604,80.32849936948297,11
0.2,6344,23,509627,80.31946414499606,10
0.2,6345,25,509652,80.31074692719824,7
0.2,6346,25,509677,80.30203245627855,7
0.2,6347,92,509769,80.3038752362949,10
0.2,6348,95,509864,80.30618995117341,6
0.2,6349,94,509958,80.30834645669292,7
0.2,6350,88,510046,80.30955754999212,13
0.2,6351,95,510141,80.31187027707809,6
0.2,6352,89,510230,80.31323784039037,12
0.2,6353,22,510252,80.30406043437205,11
0.2,6354,22,510274,80.2948859166011,12
0.2,6355,96,510370,80.29735682819383,6
0.2,6356,93,510463,80.29935504168633,8
0.2,6357,94,510557,80.30150990877634,7
0.2,6358,27,510584,80.29312785029093,7
0.2,6359,96,510680,80.29559748427673,6
0.2,6360,96,510776,80.29806634177017,6
0.2,6361,92,510868,80.29990569003458,10
0.2,6362,94,510962,80.3020587773063,7
0.2,6363,94,511056,80.30421118793211,7
0.2,6364,91,511147,80.30589159465829,11
0.2,6365,26,511173,80.29736098020736,7
0.2,6366,87,511260,80.29841369561802,14
0.2,6367,22,511282,80.28925879396985,10
0.2,6368,95,511377,80.29156853509186,6
0.2,6369,90,511467,80.29309262166404,11
0.2,6370,93,511560,80.29508711348296,8
0.2,6371,23,511583,80.28609541745135,9
0.2,6372,95,511678,80.28840420524087,6
0.2,6373,95,511773,80.29071226859115,6
0.2,6374,92,511865,80.29254901960785,10
0.2,6375,94,511959,80.29469887076537,7
0.2,6376,94,512053,80.29684804767132,7
0.2,6377,20,512073,80.28739416745061,12
0.2,6378,86,512159,80.28828970058002,15
0.2,6379,94,512253,80.29043887147336,8
0.2,6380,94,512347,80.29258736875099,7
0.2,6381,93,512440,80.29457850203698,8
0.2,6382,95,512535,80.29688234372551,6
0.2,6383,95,512630,80.29918546365914,6
0.2,6384,94,512724,80.30133124510571,8
0.2,6385,24,512748,80.29251487629189,8
0.2,6386,96,512844,80.29497416627525,6
0.2,6387,93,512937,80.29696305572949,9
0.2,6388,24,512961,80.28815151040851,10
0.2,6389,91,513052,80.28982785602504,10
0.2,6390,93,513145,80.29181661711782,9
0.2,6391,91,513236,80.29349186483104,10
0.2,6392,90,513326,80.29501016737056,11
0.2,6393,94,513420,80.29715358148265,7
0.2,6394,22,513442,80.28803752931978,10
0.2,6395,-49,513393,80.26782363977486,13
0.2,6396,91,513484,80.26950132874785,10
0.2,6397,92,513576,80.27133479212254,10
0.2,6398,27,513603,80.26300984528832,6
0.2,6399,94,513697,80.26515625,7
0.2,6400,94,513791,80.26730198406499,7
0.2,6401,96,513887,80.26975945017182,6
0.2,6402,89,513976,80.27112291113541,12
0.2,6403,89,514065,80.27248594628357,12
0.2,6404,93,514158,80.2744730679157,9
0.2,6405,93,514251,80.27645956915391,8
0.2,6406,89,514340,80.27782113313563,12
0.2,6407,95,514435,80.28011860174782,7
0.2,6408,92,514527,80.28194726166329,9
0.2,6409,94,514621,80.28408736349454,7
0.2,6410,-52,514569,80.26345343940103,15
0.2,6411,24,514593,80.25467872738615,10
0.2,6412,16,514609,80.24465928582566,16
0.2,6413,96,514705,80.24711568444029,6
0.2,6414,-128,514577,80.21465315666407,22
0.2,6415,88,514665,80.21586658354114,14
0.2,6416,95,514760,80.21817048465014,6
0.2,6417,94,514854,80.22031785602992,10
0.2,6418,-47,514807,80.2004985200187,10
0.2,6419,17,514824,80.19065420560747,15
0.2,6420,93,514917,80.19264912007475,8
0.2,6421,17,514934,80.18280909374027,19
0.2,6422,92,515026,80.18464891795111,9
0.2,6423,94,515120,80.186799501868,7
0.2,6424,91,515211,80.18848249027238,12
0.2,6425,87,515298,80.18954248366013,16
0.2,6426,90,515388,80.19106892796017,11
0.2,6427,93,515481,80.19306160547605,8
0.2,6428,94,515575,80.195209208275,7
0.2,6429,86,515661,80.19611197511664,16
0.2,6430,95,515756,80.19841393251438,6
0.2,6431,94,515850,80.20055970149254,8
0.2,6432,91,515941,80.20223845795118,10
0.2,6433,91,516032,80.20391669257071,12
0.2,6434,96,516128,80.2063714063714,6
0.2,6435,94,516222,80.20851460534493,8
0.2,6436,95,516317,80.21081249029051,6
0.2,6437,93,516410,80.21279900590245,8
0.2,6438,92,516502,80.2146296008697,10
0.2,6439,93,516595,80.2166149068323,8
0.2,6440,26,516621,80.2081974848626,6
0.2,6441,95,516716,80.21049363551693,7
0.2,6442,93,516809,80.21247865900978,9
0.2,6443,90,516899,80.21399751707014,11
0.2,6444,94,516993,80.21613653995345,7
0.2,6445,92,517085,80.21796462922742,10
0.2,6446,95,517180,80.22025748410113,6
0.2,6447,93,517273,80.2222394540943,8
0.2,6448,86,517359,80.22313536982477,15
0.2,6449,92,517451,80.22496124031008,9
0.2,6450,24,517475,80.21624554332662,8
0.2,6451,92,517567,80.21807191568506,10
0.2,6452,90,517657,80.21958778862545,11
0.2,6453,90,517747,80.22110319181903,11
0.2,6454,91,517838,80.22277304415182,10
0.2,6455,92,517930,80.22459727385377,9
0.2,6456,88,518018,80.22580145578442,15
0.2,6457,96,518114,80.22824403840198,6
0.2,6458,95,518209,80.23053104195697,6
0.2,6459,95,518304,80.2328173374613,7
0.2,6460,80,518384,80.23278130320384,21
0.2,6461,92,518476,80.2346022903126,9
0.2,6462,93,518569,80.23657744081696,8
0.2,6463,94,518663,80.23870668316832,7
0.2,6464,84,518747,80.23928847641145,17
0.2,6465,25,518772,80.23074543767399,8
0.2,6466,91,518863,80.23241070047936,11
0.2,6467,95,518958,80.23469387755102,6
0.2,6468,88,519046,80.23589426495595,13
0.2,6469,93,519139,80.23786707882535,8
0.2,6470,92,519231,80.23968474733427,9
0.2,6471,96,519327,80.24211990111249,6
0.2,6472,21,519348,80.23296771203461,13
0.2,6473,95,519443,80.23524868705591,6
0.2,6474,91,519534,80.2369111969112,10
0.2,6475,85,519619,80.23764669549104,16
0.2,6476,95,519714,80.2399258916165,8
0.2,6477,94,519808,80.24205001543686,8
0.2,6478,93,519901,80.24401913875599,8
0.2,6479,-118,519783,80.21342592592593,13
0.2,6480,85,519868,80.21416448079,17
0.2,6481,92,519960,80.21598272138229,10
0.2,6482,96,520056,80.21841739935215,6
0.2,6483,91,520147,80.220080197409,10
0.2,6484,92,520239,80.2218966846569,9
0.2,6485,89,520328,80.22325007708912,12
0.2,6486,89,520417,80.22460305225836,12
0.2,6487,95,520512,80.2268803945746,7
0.2,6488,93,520605,80.22884882108183,8
0.2,6489,14,520619,80.2186440677966,19
0.2,6490,95,520714,80.22092127561238,6
0.2,6491,94,520808,80.2230437461491,7
0.2,6492,90,520898,80.22454951486216,11
0.2,6493,94,520992,80.22667077302125,8
0.2,6494,93,521085,80.22863741339492,8
0.2,6495,95,521180,80.23091133004927,6
0.2,6496,92,521272,80.23272279513621,10
0.2,6497,26,521298,80.22437673130194,6
0.2,6498,92,521390,80.22618864440683,11
0.2,6499,96,521486,80.22861538461538,6
0.2,6500,92,521578,80.23042608829411,9
0.2,6501,85,521663,80.23115964318671,16
0.2,6502,94,521757,80.23327694910041,7
0.2,6503,27,521784,80.22509225092251,6
0.2,6504,95,521879,80.22736356648731,8
0.2,6505,93,521972,80.22932677528435,8
0.2,6506,92,522064,80.23113570001537,9
0.2,6507,94,522158,80.23325138291334,7
0.2,6508,88,522246,80.23444461514826,14
0.2,6509,95,522341,80.23671274961598,9
0.2,6510,94,522435,80.23882660113654,8
0.2,6511,25,522460,80.23034398034397,8
0.2,6512,90,522550,80.23184400429909,12
0.2,6513,94,522644,80.2339576297206,7
0.2,6514,23,522667,80.22517267843438,12
0.2,6515,22,522689,80.21623695518723,10
0.2,6516,93,522782,80.21819855761854,8
0.2,6517,-50,522732,80.19822031297944,13
0.2,6518,91,522823,80.19987728179169,12
0.2,6519,94,522917,80.20199386503067,7
0.2,6520,93,523010,80.20395644839749,8
0.2,6521,94,523104,80.20607175712972,7
0.2,6522,86,523190,80.2069599877357,16
0.2,6523,90,523280,80.20846106683017,11
0.2,6524,91,523371,80.21011494252873,10
0.2,6525,90,523461,80.21161507814894,11
0.2,6526,90,523551,80.21311475409836,11
0.2,6527,94,523645,80.21522671568627,7
0.2,6528,94,523739,80.21733803032623,8
0.2,6529,92,523831,80.21914241960184,9
0.2,6530,93,523924,80.22109937222477,8
0.2,6531,90,524014,80.22259644825475,12
0.2,6532,92,524106,80.22439920404102,10
0.2,6533,91,524197,80.226048362412,11
0.2,6534,93,524290,80.22800306044377,8
0.2,6535,93,524383,80.22995716034272,8
0.2,6536,16,524399,80.22013155881903,16
0.2,6537,94,524493,80.2222392168859,7
0.2,6538,24,524517,80.2136412295458,9
0.2,6539,24,524541,80.20504587155963,8
0.2,6540,94,524635,80.20715486928604,8
0.2,6541,92,524727,80.20895750535004,9
0.2,6542,93,524820,80.2109124254929,9
0.2,6543,91,524911,80.21256112469437,11
0.2,6544,92,525003,80.21436210847976,10
0.2,6545,96,525099,80.21677360219982,6
0.2,6546,93,525192,80.21872613410723,8
0.2,6547,25,525217,80.21029321930361,7
0.2,6548,91,525308,80.21194075431363,12
0.2,6549,94,525402,80.21404580152672,8
0.2,6550,96,525498,80.21645550297664,6
0.2,6551,94,525592,80.21855921855922,7
0.2,6552,91,525683,80.22020448649474,10
0.2,6553,-54,525629,80.19972535855966,19
0.2,6554,92,525721,80.20152555301297,9
0.2,6555,93,525814,80.20347773032337,8
0.2,6556,94,525908,80.2055818209547,8
0.2,6557,26,525934,80.19731625495578,6
0.2,6558,90,526024,80.19881079432841,11
0.2,6559,20,526044,80.18963414634146,12
0.2,6560,95,526139,80.19189147995732,6
0.2,6561,91,526230,80.1935385553185,10
0.2,6562,87,526317,80.19457565137894,14
0.2,6563,96,526413,80.19698354661791,6
0.2,6564,93,526506,80.1989337395278,8
0.2,6565,92,526598,80.20073103868413,10
0.2,6566,91,526689,80.2023755139333,10
0.2,6567,95,526784,80.20462850182705,6
0.2,6568,95,526879,80.2068808037753,6
0.2,6569,93,526972,80.20882800608828,8
0.2,6570,95,527067,80.21107898341197,7
0.2,6571,24,527091,80.20252586731588,8
0.2,6572,94,527185,80.20462498098281,8
0.2,6573,85,527270,80.20535442652874,16
0.2,6574,92,527362,80.20714828897339,9
0.2,6575,93,527455,80.20909367396594,10
0.2,6576,95,527550,80.21134255739699,6
0.2,6577,88,527638,80.21252660383095,13
0.2,6578,95,527733,80.21477428180575,6
0.2,6579,90,527823,80.21626139817629,11
0.2,6580,90,527913,80.21774806260447,11
0.2,6581,-50,527863,80.19796414463688,13
0.2,6582,95,527958,80.2002126689959,6
0.2,6583,20,527978,80.19106925880924,12
0.2,6584,91,528069,80.19271070615034,11
0.2,6585,88,528157,80.19389614333434,13
0.2,6586,93,528250,80.19584029148322,9
0.2,6587,92,528342,80.1976320582878,9
0.2,6588,93,528435,80.19957504932464,8
0.2,6589,91,528526,80.20121396054628,12
0.2,6590,91,528617,80.20285237445,11
0.2,6591,95,528712,80.20509708737865,6
0.2,6592,95,528807,80.20734111936903,6
0.2,6593,89,528896,80.20867455262359,12
0.2,6594,24,528920,80.20015163002275,9
0.2,6595,96,529016,80.20254699818072,6
0.2,6596,90,529106,80.20403213581932,11
0.2,6597,23,529129,80.19536223097909,10
0.2,6598,92,529221,80.1971510834975,10
0.2,6599,94,529315,80.19924242424243,7
0.2,6600,90,529405,80.20072716255113,12
0.2,6601,94,529499,80.2028173280824,8
0.2,6602,92,529591,80.20460396789338,9
0.2,6603,93,529684,80.20654149000606,8
0.2,6604,91,529775,80.20817562452687,11
0.2,6605,22,529797,80.1993642143506,12
0.2,6606,94,529891,80.20145300438928,8
0.2,6607,95,529986,80.20369249394673,7
0.2,6608,91,530077,80.20532607050991,11
0.2,6609,91,530168,80.20695915279879,10
0.2,6610,92,530260,80.2087430040841,9
0.2,6611,91,530351,80.21037507562008,11
0.2,6612,94,530445,80.21246030545895,8
0.2,6613,94,530539,80.2145449047475,7
0.2,6614,94,530633,80.21662887377173,7
0.2,6615,96,530729,80.21901451027811,6
0.2,6616,95,530824,80.22124829983376,6
0.2,6617,91,530915,80.22287700211544,10
0.2,6618,91,531006,80.22450521226772,11
0.2,6619,91,531097,80.2261329305136,12
0.2,6620,96,531193,80.22851533001057,6
0.2,6621,26,531219,80.22032618544246,8
0.2,6622,82,531301,80.22059489657255,19
0.2,6623,94,531395,80.22267512077295,7
0.2,6624,94,531489,80.22475471698114,8
0.2,6625,95,531584,80.22698460609719,7
0.2,6626,18,531602,80.21759468839596,14
0.2,6627,15,531617,80.20775497887749,18
0.2,6628,90,531707,80.20923216171369,11
0.2,6629,94,531801,80.21131221719457,7
0.2,6630,89,531890,80.21263761122003,12
0.2,6631,96,531986,80.21501809408926,6
0.2,6632,87,532073,80.21604100708578,14
0.2,6633,90,532163,80.21751582755502,12
0.2,6634,92,532255,80.21929163526752,9
0.2,6635,21,532276,80.21036769138036,12
0.2,6636,94,532370,80.21244538194968,7
0.2,6637,89,532459,80.21376920759265,14
0.2,6638,90,532549,80.21524325952704,12
0.2,6639,27,532576,80.20722891566265,6
0.2,6640,92,532668,80.2090046679717,10
0.2,6641,96,532764,80.21138211382114,6
0.2,6642,91,532855,80.21300617191028,12
0.2,6643,92,532947,80.21478025285973,10
0.2,6644,95,533042,80.21700526711814,7
0.2,6645,92,533134,80.21877821245862,11
0.2,6646,83,533217,80.21919663005868,21
0.2,6647,94,533311,80.2212695547533,8
0.2,6648,93,533404,80.223191457362,8
0.2,6649,88,533492,80.22436090225564,13
0.2,6650,95,533587,80.22658246880168,6
0.2,6651,90,533677,80.2280517137703,11
0.2,6652,94,533771,80.23012174958666,8
0.2,6653,89,533860,80.23143973549745,13
0.2,6654,17,533877,80.22193839218633,16
0.2,6655,96,533973,80.22430889423077,6
0.2,6656,89,534062,80.2256271593811,13
0.2,6657,92,534154,80.22739561429859,10
0.2,6658,20,534174,80.21835110376934,13
0.2,6659,90,534264,80.21981981981982,11
0.2,6660,95,534359,80.22203873292298,6
0.2,6661,88,534447,80.22320624437106,14
0.2,6662,19,534466,80.21401770974036,14
0.2,6663,96,534562,80.21638655462185,6
0.2,6664,94,534656,80.2184546136534,7
0.2,6665,94,534750,80.22052205220523,7
0.2,6666,90,534840,80.22198890055498,12
0.2,6667,88,534928,80.22315536892621,13
0.2,6668,92,535020,80.22492127755285,10
0.2,6669,85,535105,80.2256371814093,16
0.2,6670,91,535196,80.22725228601409,11
0.2,6671,93,535289,80.22916666666667,9
0.2,6672,95,535384,80.23138018882062,6
0.2,6673,95,535479,80.23359304764759,6
0.2,6674,96,535575,80.23595505617978,6
0.2,6675,95,535670,80.23816656680647,6
0.2,6676,95,535765,80.24037741500673,6
0.2,6677,93,535858,80.24228811021264,9
0.2,6678,91,535949,80.2438987872436,12
0.2,6679,89,536038,80.24520958083832,12
0.2,6680,91,536129,80.2468193384224,10
0.2,6681,87,536216,80.24782999102065,16
0.2,6682,25,536241,80.23956307047733,7
0.2,6683,92,536333,80.24132256134051,9
0.2,6684,91,536424,80.24293193717277,11
0.2,6685,93,536517,80.2448399641041,8
0.2,6686,94,536611,80.24689696425901,7
0.2,6687,94,536705,80.2489533492823,8
0.2,6688,15,536720,80.23919868440724,19
0.2,6689,94,536814,80.24125560538117,7
0.2,6690,94,536908,80.24331191152294,8
0.2,6691,-116,536792,80.21398684997011,11
0.2,6692,94,536886,80.21604661586733,7
0.2,6693,93,536979,80.21795637884672,8
0.2,6694,95,537074,80.2201643017177,8
0.2,6695,94,537168,80.22222222222223,7
0.2,6696,91,537259,80.22383156637301,10
0.2,6697,94,537353,80.2258883248731,8
0.2,6698,96,537449,80.22824302134647,8
0.2,6699,90,537539,80.22970149253732,11
0.2,6700,96,537635,80.23205491717654,6
0.2,6701,94,537729,80.23410922112802,7
0.2,6702,94,537823,80.2361629121289,7
0.2,6703,92,537915,80.23791766109785,9
0.2,6704,94,538009,80.23997017151379,7
0.2,6705,23,538032,80.23143453623621,10
0.2,6706,96,538128,80.23378559713731,6
0.2,6707,95,538223,80.23598688133572,6
0.2,6708,95,538318,80.23818750931585,6
0.2,6709,95,538413,80.24038748137109,6
0.2,6710,94,538507,80.24243778870512,8
0.2,6711,91,538598,80.24404052443386,10
0.2,6712,90,538688,80.24549381796514,11
0.2,6713,25,538713,80.2372654155496,8
0.2,6714,86,538799,80.23812360387193,16
0.2,6715,14,538813,80.22826086956522,18
0.2,6716,95,538908,80.23046002679767,6
0.2,6717,88,538996,80.2316165525454,13
0.2,6718,94,539090,80.23366572406609,8
0.2,6719,95,539185,80.2358630952381,6
0.2,6720,94,539279,80.23791102514507,7
0.2,6721,93,539372,80.239809580482,8
0.2,6722,25,539397,80.23159303882196,9
0.2,6723,94,539491,80.23364069006544,7
0.2,6724,95,539586,80.23583643122677,7
0.2,6725,93,539679,80.23773416592329,8
0.2,6726,90,539769,80.23918537237996,12
0.2,6727,92,539861,80.24093341260404,9
0.2,6728,92,539953,80.24268093327389,9
0.2,6729,91,540044,80.244279346211,11
0.2,6730,93,540137,80.24617441687714,9
0.2,6731,25,540162,80.2379679144385,7
0.2,6732,93,540255,80.23986335957225,8
0.2,6733,94,540349,80.24190674190675,7
0.2,6734,91,540440,80.24350408314774,11
0.2,6735,96,540536,80.2458432304038,6
0.2,6736,94,540630,80.24788481519964,7
0.2,6737,92,540722,80.24962897002078,10
0.2,6738,93,540815,80.25152099718059,8
0.2,6739,94,540909,80.25356083086054,7
0.2,6740,93,541002,80.25545171339564,9
0.2,6741,93,541095,80.25734203500446,8
0.2,6742,94,541189,80.25938009787929,7
0.2,6743,91,541280,80.26097271648874,11
0.2,6744,94,541374,80.26300963676798,8
0.2,6745,21,541395,80.25422472576342,13
0.2,6746,91,541486,80.25581740032607,10
0.2,6747,89,541575,80.25711321873148,13
0.2,6748,94,541669,80.25914950363017,8
0.2,6749,96,541765,80.26148148148148,6
0.2,6750,25,541790,80.25329580802844,7
0.2,6751,96,541886,80.25562796208531,6
0.2,6752,95,541981,80.25781134310677,6
0.2,6753,90,542071,80.25925377554042,11
0.2,6754,95,542166,80.26143597335307,6
0.2,6755,88,542254,80.26258140911781,14
0.2,6756,92,542346,80.26431848453456,10
0.2,6757,94,542440,80.26635099141758,8
0.2,6758,96,542536,80.26867879863885,6
0.2,6759,93,542629,80.27056213017751,10
0.2,6760,95,542724,80.27274071882857,7
0.2,6761,95,542819,80.27491866311742,6
0.2,6762,90,542909,80.27635664645867,11
0.2,6763,92,543001,80.27808988764045,9
0.2,6764,20,543021,80.26917960088691,12
0.2,6765,21,543042,80.26041974578776,11
0.2,6766,27,543069,80.25254913551056,6
0.2,6767,86,543155,80.25339834515367,15
0.2,6768,89,543244,80.25469050081253,12
0.2,6769,92,543336,80.25642540620385,9
0.2,6770,27,543363,80.24856003544528,6
0.2,6771,90,543453,80.25,12
0.2,6772,92,543545,80.25173482946995,9
0.2,6773,-57,543488,80.23147328018896,20
0.2,6774,91,543579,80.23306273062731,10
0.2,6775,95,543674,80.23524203069658,6
0.2,6776,90,543764,80.23668289803749,11
0.2,6777,95,543859,80.23886102095014,6
0.2,6778,77,543936,80.23838324236613,24
0.2,6779,19,543955,80.22935103244838,13
0.2,6780,93,544048,80.23123433121958,8
0.2,6781,94,544142,80.23326452373931,9
0.2,6782,84,544226,80.23381984372696,17
0.2,6783,23,544249,80.22538325471699,9
0.2,6784,94,544343,80.2274134119381,8
0.2,6785,94,544437,80.22944297082228,7
0.2,6786,91,544528,80.23102991012229,10
0.2,6787,93,544621,80.23291101944608,8
0.2,6788,25,544646,80.22477537192518,8
0.2,6789,90,544736,80.22621502209131,12
0.2,6790,94,544830,80.22824326314239,7
0.2,6791,91,544921,80.22982921083627,10
0.2,6792,18,544939,80.22066833505079,14
0.2,6793,96,545035,80.22299087430085,6
0.2,6794,94,545129,80.22501839587932,8
0.2,6795,93,545222,80.2268981753973,8
0.2,6796,91,545313,80.22848315433279,10
0.2,6797,96,545409,80.23080317740512,6
0.2,6798,94,545503,80.23282835711134,8
0.2,6799,94,545597,80.23485294117647,7
0.2,6800,86,545683,80.23570063225996,16
0.2,6801,22,545705,80.22713907674213,13
0.2,6802,90,545795,80.22857562839924,11
0.2,6803,95,545890,80.23074661963551,8
0.2,6804,90,545980,80.23218221895665,11
0.2,6805,94,546074,80.23420511313547,7
0.2,6806,91,546165,80.23578669017188,11
0.2,6807,96,546261,80.23810223266744,6
0.2,6808,94,546355,80.24012336613306,7
0.2,6809,94,546449,80.24214390602056,7
0.2,6810,94,546543,80.2441638525914,7
0.2,6811,-118,546425,80.21506165590135,13
0.2,6812,87,546512,80.2160575370615,14
0.2,6813,94,546606,80.21808042265923,7
0.2,6814,95,546701,80.2202494497432,8
0.2,6815,92,546793,80.22197769953051,9
0.2,6816,96,546889,80.22429221064985,6
0.2,6817,95,546984,80.22645937224992,6
0.2,6818,87,547071,80.22745270567532,15
0.2,6819,21,547092,80.21876832844575,13
0.2,6820,27,547119,80.21096613399794,6
0.2,6821,95,547214,80.21313397830548,6
0.2,6822,96,547310,80.21544775025649,6
0.2,6823,89,547399,80.21673505275498,12
0.2,6824,90,547489,80.2181684981685,11
0.2,6825,27,547516,80.21037210665104,6
0.2,6826,94,547610,80.21239197304818,8
0.2,6827,88,547698,80.21353251318102,15
0.2,6828,92,547790,80.21525845658222,10
0.2,6829,84,547874,80.21581259150805,20
0.2,6830,94,547968,80.21783047870004,8
0.2,6831,93,548061,80.21970140515222,8
0.2,6832,22,548083,80.21118103322114,11
0.2,6833,95,548178,80.21334503950834,7
0.2,6834,18,548196,80.20424286759327,15
0.2,6835,92,548288,80.2059684025746,10
0.2,6836,96,548384,80.20827848471552,6
0.2,6837,91,548475,80.20985668324072,11
0.2,6838,87,548562,80.21084953940634,14
0.2,6839,94,548656,80.21286549707602,7
0.2,6840,95,548751,80.21502704283,7
0.2,6841,92,548843,80.21674948845367,10
0.2,6842,95,548938,80.21890983486774,6
0.2,6843,93,549031,80.22077732320281,8
0.2,6844,96,549127,80.22308254200146,6
0.2,6845,93,549220,80.22494887525562,8
0.2,6846,86,549306,80.22579231780341,16
0.2,6847,24,549330,80.21758177570094,8
0.2,6848,87,549417,80.21857205431449,14
0.2,6849,91,549508,80.22014598540146,10
0.2,6850,25,549533,80.21208582688658,7
0.2,6851,95,549628,80.21424401634559,6
0.2,6852,92,549720,80.21596381146944,10
0.2,6853,25,549745,80.20790779107091,7
0.2,6854,96,549841,80.21021152443473,6
0.2,6855,95,549936,80.21236872812135,6
0.2,6856,96,550032,80.21467113898206,6
0.2,6857,91,550123,80.21624380285797,10
0.2,6858,87,550210,80.21723283277446,14
0.2,6859,88,550298,80.21836734693878,13
0.2,6860,89,550387,80.21964728173735,12
0.2,6861,94,550481,80.22165549402507,7
0.2,6862,89,550570,80.22293457671572,12
0.2,6863,85,550655,80.22363053613054,17
0.2,6864,94,550749,80.22563729060451,7
0.2,6865,95,550844,80.22778910573842,6
0.2,6866,92,550936,80.22950342216397,10
0.2,6867,94,551030,80.23150844496215,7
0.2,6868,95,551125,80.23365846556995,8
0.2,6869,94,551219,80.23566229985444,7
0.2,6870,92,551311,80.23737447242031,9
0.2,6871,94,551405,80.23937718277067,7
0.2,6872,93,551498,80.24123381347302,8
0.2,6873,87,551585,80.2422170497527,14
0.2,6874,91,551676,80.24378181818182,10
0.2,6875,89,551765,80.24505526468877,12
0.2,6876,96,551861,80.24734622655228,6
0.2,6877,94,551955,80.24934574004071,7
0.2,6878,25,551980,80.24131414449775,8
0.2,6879,92,552072,80.24302325581395,9
0.2,6880,96,552168,80.24531318122366,6
0.2,6881,88,552256,80.24643998837547,14
0.2,6882,93,552349,80.24829289553973,8
0.2,6883,94,552443,80.25029052876235,7
0.2,6884,90,552533,80.25170660856935,14
0.2,6885,87,552620,80.25268661051409,14
0.2,6886,91,552711,80.25424713227821,10
0.2,6887,96,552807,80.25653310104529,6
0.2,6888,92,552899,80.25823777035855,10
0.2,6889,90,552989,80.25965166908563,12
0.2,6890,94,553083,80.2616456247279,7
0.2,6891,90,553173,80.26305861868833,11
0.2,6892,95,553268,80.26519657623676,7
0.2,6893,93,553361,80.26704380620829,8
0.2,6894,91,553452,80.2686004350979,10
0.2,6895,92,553544,80.27030162412993,9
0.2,6896,89,553633,80.27156734812237,12
0.2,6897,95,553728,80.27370252247029,7
0.2,6898,93,553821,80.27554718075083,8
0.2,6899,94,553915,80.27753623188406,7
0.2,6900,88,554003,80.27865526735256,13
0.2,6901,93,554096,80.28049840625906,8
0.2,6902,88,554184,80.28161668839635,14
0.2,6903,89,554273,80.28287949015063,12
0.2,6904,86,554359,80.28370745836351,15
0.2,6905,24,554383,80.27555748624384,8
0.2,6906,94,554477,80.27754452005212,7
0.2,6907,94,554571,80.27953097857556,7
0.2,6908,93,554664,80.28137212331741,8
0.2,6909,90,554754,80.28277858176556,11
0.2,6910,93,554847,80.28461872377369,9
0.2,6911,95,554942,80.28674768518519,6
0.2,6912,88,555030,80.28786344568205,14
0.2,6913,92,555122,80.28955741972808,9
0.2,6914,24,555146,80.28141720896602,9
0.2,6915,95,555241,80.28354540196645,8
0.2,6916,22,555263,80.27511927136041,10
0.2,6917,26,555289,80.26727377854871,7
0.2,6918,94,555383,80.26925856337621,9
0.2,6919,81,555464,80.26936416184971,20
0.2,6920,22,555486,80.26094495015171,10
0.2,6921,93,555579,80.26278532216122,8
0.2,6922,93,555672,80.2646251625018,8
0.2,6923,84,555756,80.26516464471403,17
0.2,6924,95,555851,80.26729241877257,6
0.2,6925,96,555947,80.26956396188277,6
0.2,6926,94,556041,80.27154612386315,8
0.2,6927,93,556134,80.27338337182448,9
0.2,6928,94,556228,80.27536441044884,7
0.2,6929,96,556324,80.27763347763347,6
0.2,6930,96,556420,80.27990189005915,6
0.2,6931,92,556512,80.28159261396422,10
0.2,6932,90,556602,80.28299437472955,12
0.2,6933,92,556694,80.28468416498414,9
0.2,6934,27,556721,80.27700072098054,6
0.2,6935,94,556815,80.27897923875433,7
0.2,6936,85,556900,80.27965979530056,16
0.2,6937,27,556927,80.27198039780917,6
0.2,6938,88,557015,80.27309410577892,13
0.2,6939,90,557105,80.27449567723343,11
0.2,6940,94,557199,80.27647313067281,7
0.2,6941,93,557292,80.27830596369922,8
0.2,6942,94,557386,80.28028229871813,8
0.2,6943,85,557471,80.28096198156682,17
0.2,6944,25,557496,80.27300215982721,8
0.2,6945,94,557590,80.27497840483731,7
0.2,6946,96,557686,80.27724197495321,6
0.2,6947,90,557776,80.27864133563615,13
0.2,6948,94,557870,80.28061591595913,7
0.2,6949,21,557891,80.27208633093525,12
0.2,6950,89,557980,80.27334196518487,12
0.2,6951,95,558075,80.27546029919448,7
0.2,6952,91,558166,80.27700273263339,11
0.2,6953,95,558261,80.27911993097497,6
0.2,6954,95,558356,80.28123652048886,6
0.2,6955,96,558452,80.28349626221967,6
0.2,6956,86,558538,80.28431795314071,18
0.2,6957,95,558633,80.28643288301237,7
0.2,6958,89,558722,80.2876850122144,13
0.2,6959,92,558814,80.28936781609195,9
0.2,6960,89,558903,80.29061916391323,13
0.2,6961,24,558927,80.2825337546682,10
0.2,6962,92,559019,80.2842165733161,9
0.2,6963,94,559113,80.28618609994257,8
0.2,6964,26,559139,80.278391959799,7
0.2,6965,87,559226,80.2793568762561,14
0.2,6966,85,559311,80.28003444811253,19
0.2,6967,95,559406,80.2821469575201,6
0.2,6968,93,559499,80.28397187544842,8
0.2,6969,95,559594,80.28608321377331,6
0.2,6970,96,559690,80.28833739779085,6
0.2,6971,89,559779,80.28958691910499,12
0.2,6972,90,559869,80.29097949232755,11
0.2,6973,16,559885,80.28176082592486,17
0.2,6974,91,559976,80.28329749103942,11
0.2,6975,96,560072,80.28555045871559,6
0.2,6976,88,560160,80.28665615594095,13
0.2,6977,90,560250,80.28804815133276,12
0.2,6978,93,560343,80.28986960882648,8
0.2,6979,90,560433,80.29126074498568,11
0.2,6980,95,560528,80.29336771236213,8
0.2,6981,84,560612,80.29389859639072,18
0.2,6982,-47,560565,80.27566948303021,11
0.2,6983,94,560659,80.27763459335624,7
0.2,6984,92,560751,80.27931281317107,9
0.2,6985,94,560845,80.28127683939307,8
0.2,6986,96,560941,80.28352654930585,6
0.2,6987,24,560965,80.27547223812249,9
0.2,6988,95,561060,80.27757905279725,6
0.2,6989,19,561079,80.26881258941344,14
0.2,6990,94,561173,80.2707767129166,10
0.2,6991,91,561264,80.27231121281464,10
0.2,6992,91,561355,80.27384527384527,10
0.2,6993,91,561446,80.27537889619674,11
0.2,6994,92,561538,80.2770550393138,9
0.2,6995,91,561629,80.27858776443682,11
0.2,6996,87,561716,80.27954837787624,14
0.2,6997,94,561810,80.28150900257216,11
0.2,6998,95,561905,80.2836119445635,6
0.2,6999,21,561926,80.27514285714285,12
0.2,7000,26,561952,80.26739037280389,6
0.2,7001,91,562043,80.26892316481005,10
0.2,7002,94,562137,80.27088390689704,7
0.2,7003,94,562231,80.27284408909195,8
0.2,7004,92,562323,80.27451820128479,9
0.2,7005,92,562415,80.2761918355695,9
0.2,7006,92,562507,80.27786499215071,9
0.2,7007,91,562598,80.27939497716895,10
0.2,7008,94,562692,80.28135254672564,7
0.2,7009,92,562784,80.2830242510699,9
0.2,7010,24,562808,80.27499643417487,10
0.2,7011,87,562895,80.27595550484882,14
0.2,7012,94,562989,80.27791244831027,7
0.2,7013,94,563083,80.27986883376104,7
0.2,7014,13,563096,80.27027797576622,20
0.2,7015,24,563120,80.26225769669327,8
0.2,7016,26,563146,80.25452472566624,7
0.2,7017,96,563242,80.25676831005984,6
0.2,7018,93,563335,80.2585838438524,9
0.2,7019,22,563357,80.2502849002849,10
0.2,7020,94,563451,80.25224327018942,7
0.2,7021,18,563469,80.24337795499858,14
0.2,7022,90,563559,80.24476719350704,11
0.2,7023,94,563653,80.24672551252847,7
0.2,7024,95,563748,80.2488256227758,6
0.2,7025,92,563840,80.25049814972958,9
0.2,7026,93,563933,80.25231250889426,9
0.2,7027,92,564025,80.25398406374502,9
0.2,7028,92,564117,80.25565514297908,9
0.2,7029,86,564203,80.25647226173542,15
0.2,7030,94,564297,80.25842696629213,8
0.2,7031,90,564387,80.25981228668942,13
0.2,7032,86,564473,80.26062846580406,15
0.2,7033,91,564564,80.26215524594825,10
0.2,7034,96,564660,80.26439232409382,6
0.2,7035,95,564755,80.26648664013643,6
0.2,7036,94,564849,80.26843825493819,7
0.2,7037,96,564945,80.27067348678602,6
0.2,7038,93,565038,80.27248188663162,9
0.2,7039,92,565130,80.27414772727273,9
0.2,7040,89,565219,80.27538701888936,12
0.2,7041,95,565314,80.27747798920761,7
0.2,7042,94,565408,80.27942638080364,7
0.2,7043,92,565500,80.28109028960817,10
0.2,7044,96,565596,80.2833215046132,6
0.2,7045,92,565688,80.28498438830542,9
0.2,7046,25,565713,80.2771392081737,8
0.2,7047,93,565806,80.27894438138479,10
0.2,7048,87,565893,80.27989785785218,14
0.2,7049,90,565983,80.28127659574469,11
0.2,7050,92,566075,80.28293859027089,9
0.2,7051,20,566095,80.27439024390245,12
0.2,7052,19,566114,80.26570253792713,15
0.2,7053,94,566208,80.26764956053303,7
0.2,7054,21,566229,80.25924875974486,11
0.2,7055,91,566320,80.26077097505669,10
0.2,7056,90,566410,80.26215105568939,11
0.2,7057,95,566505,80.26423916123548,6
0.2,7058,96,566601,80.26646833829155,6
0.2,7059,95,566696,80.2685552407932,7
0.2,7060,93,566789,80.27035830618892,8
0.2,7061,91,566880,80.27187765505522,12
0.2,7062,91,566971,80.2733965736939,10
0.2,7063,89,567060,80.27463193657984,14
0.2,7064,89,567149,80.2758669497523,12
0.2,7065,26,567175,80.26818567789414,8
0.2,7066,95,567270,80.27027027027027,6
0.2,7067,92,567362,80.2719298245614,9
0.2,7068,89,567451,80.27316452114867,12
0.2,7069,94,567545,80.27510608203677,8
0.2,7070,92,567637,80.27676424833828,9
0.2,7071,94,567731,80.27870475113122,8
0.2,7072,-46,567685,80.26085112399265,11
0.2,7073,94,567779,80.26279332767882,8
0.2,7074,23,567802,80.2546996466431,10
0.2,7075,95,567897,80.25678349349916,8
0.2,7076,92,567989,80.25844284301257,11
0.2,7077,93,568082,80.26024300649901,9
0.2,7078,94,568176,80.2621839242831,7
0.2,7079,25,568201,80.25437853107344,8
0.2,7080,92,568293,80.25603728286966,10
0.2,7081,27,568320,80.24851736797515,6
0.2,7082,94,568414,80.25045884512213,7
0.2,7083,88,568502,80.25155279503106,13
0.2,7084,-44,568458,80.23401552575865,8
0.2,7085,94,568552,80.23595822749083,8
0.2,7086,96,568648,80.23818258783689,6
0.2,7087,95,568743,80.24026523702031,6
0.2,7088,92,568835,80.2419241077726,10
0.2,7089,95,568930,80.24400564174894,6
0.2,7090,96,569026,80.24622761246651,6
0.2,7091,93,569119,80.24802594472645,8
0.2,7092,19,569138,80.23939094882279,14
0.2,7093,96,569234,80.24161263039188,6
0.2,7094,92,569326,80.24326990838618,10
0.2,7095,94,569420,80.24520856820745,7
0.2,7096,25,569445,80.23742426377342,8
0.2,7097,91,569536,80.23894054663286,10
0.2,7098,93,569629,80.24073813213128,8
0.2,7099,93,569722,80.24253521126761,8
0.2,7100,96,569818,80.24475425996339,6
0.2,7101,93,569911,80.24655026753027,8
0.2,7102,92,570003,80.24820498380966,9
0.2,7103,18,570021,80.23944256756756,14
0.2,7104,92,570113,80.24109781843772,9
0.2,7105,93,570206,80.24289332958064,8
0.2,7106,87,570293,80.2438440973688,14
0.2,7107,88,570381,80.24493528418684,13
0.2,7108,93,570474,80.24672949781967,9
0.2,7109,92,570566,80.24838255977497,9
0.2,7110,95,570661,80.25045703839122,6
0.2,7111,20,570681,80.2419853768279,12
0.2,7112,89,570770,80.24321664557851,13
0.2,7113,94,570864,80.24515040764689,8
0.2,7114,93,570957,80.24694307800422,8
0.2,7115,92,571049,80.24859471613266,9
0.2,7116,92,571141,80.25024589012224,9
0.2,7117,87,571228,80.25119415566171,14
0.2,7118,94,571322,80.25312543896615,7
0.2,7119,93,571415,80.25491573033707,8
0.2,7120,94,571509,80.25684594860273,7
0.2,7121,26,571535,80.24922774501545,7
0.2,7122,92,571627,80.2508774392812,9
0.2,7123,88,571715,80.25196518809658,13
0.2,7124,-54,571661,80.23312280701754,18
0.2,7125,94,571755,80.23505472916082,7
0.2,7126,94,571849,80.23698610916234,7
0.2,7127,89,571938,80.23821548821549,12
0.2,7128,27,571965,80.23074765044186,6
0.2,7129,94,572059,80.23267882187939,7
0.2,7130,95,572154,80.23474968447623,6
0.2,7131,24,572178,80.22686483454851,8
0.2,7132,94,572272,80.2287957381186,8
0.2,7133,88,572360,80.22988505747126,14
0.2,7134,92,572452,80.23153468815697,9
0.2,7135,93,572545,80.23332399103138,8
0.2,7136,94,572639,80.23525290738405,7
0.2,7137,86,572725,80.23606052115439,16
0.2,7138,82,572807,80.2363076061073,21
0.2,7139,96,572903,80.23851540616246,6
0.2,7140,87,572990,80.23946226018765,18
0.2,7141,26,573016,80.2318678241389,6
0.2,7142,91,573107,80.23337533249335,10
0.2,7143,93,573200,80.23516237402016,9
0.2,7144,96,573296,80.23736878936319,6
0.2,7145,94,573390,80.23929471032746,7
0.2,7146,95,573485,80.2413600111935,6
0.2,7147,25,573510,80.23363178511472,7
0.2,7148,94,573604,80.23555742061826,8
0.2,7149,94,573698,80.23748251748252,8
0.2,7150,94,573792,80.23940707593344,7
0.2,7151,90,573882,80.24077181208054,11
0.2,7152,90,573972,80.24213616664336,11
0.2,7153,89,574061,80.24336035784177,12
0.2,7154,94,574155,80.24528301886792,7
0.2,7155,93,574248,80.24706539966462,8
0.2,7156,92,574340,80.24870755903311,9
0.2,7157,93,574433,80.2504889633976,9
0.2,7158,94,574527,80.25240955440704,7
0.2,7159,90,574617,80.25377094972067,11
0.2,7160,27,574644,80.24633431085044,7
0.2,7161,18,574662,80.23764311644791,16
0.2,7162,96,574758,80.23984364093258,6
0.2,7163,96,574854,80.24204355108878,6
0.2,7164,94,574948,80.24396371249128,9
0.2,7165,94,575042,80.24588333798494,7
0.2,7166,94,575136,80.24780242779406,7
0.2,7167,92,575228,80.24944196428571,11
0.2,7168,95,575323,80.25149951178686,6
0.2,7169,96,575419,80.2536959553696,6
0.2,7170,92,575511,80.25533398410263,9
0.2,7171,94,575605,80.25725041829337,8
0.2,7172,92,575697,80.25888749477207,9
0.2,7173,87,575784,80.25982715361026,14
0.2,7174,86,575870,80.26062717770034,15
0.2,7175,86,575956,80.26142697881828,15
0.2,7176,95,576051,80.2634805629093,6
0.2,7177,91,576142,80.2649763165227,10
0.2,7178,91,576233,80.26647165343363,10
0.2,7179,93,576326,80.26824512534819,8
0.2,7180,93,576419,80.27001810332823,9
0.2,7181,25,576444,80.2623224728488,7
0.2,7182,94,576538,80.26423499930391,8
0.2,7183,27,576565,80.25682071269487,6
0.2,7184,92,576657,80.25845511482255,9
0.2,7185,96,576753,80.26064569997217,6
0.2,7186,-50,576703,80.2425212188674,13
0.2,7187,-55,576648,80.2237061769616,19
0.2,7188,89,576737,80.22492697176241,12
0.2,7189,94,576831,80.22684283727399,7
0.2,7190,96,576927,80.22903629536921,6
0.2,7191,26,576953,80.22149610678532,6
0.2,7192,96,577049,80.22368969831781,7
0.2,7193,93,577142,80.22546566583264,8
0.2,7194,12,577154,80.21598332175121,20
0.2,7195,91,577245,80.217481934408,10
0.2,7196,93,577338,80.21925802417674,10
0.2,7197,89,577427,80.2204779105307,12
0.2,7198,22,577449,80.21239060980692,11
0.2,7199,96,577545,80.21458333333334,6
0.2,7200,96,577641,80.21677544785446,7
0.2,7201,93,577734,80.21855040266593,8
0.2,7202,94,577828,80.22046369568235,8
0.2,7203,96,577924,80.22265408106607,6
0.2,7204,83,578007,80.22303955586398,19
0.2,7205,94,578101,80.22495142936442,7
0.2,7206,96,578197,80.22714028028305,6
0.2,7207,92,578289,80.22877358490567,9
0.2,7208,90,578379,80.2301290054099,11
0.2,7209,92,578471,80.23176144244106,9
0.2,7210,91,578562,80.23325474968797,10
0.2,7211,93,578655,80.23502495840266,8
0.2,7212,91,578746,80.23651739914044,10
0.2,7213,96,578842,80.23870252287219,6
0.2,7214,18,578860,80.23007623007624,14
0.2,7215,91,578951,80.23156873614191,10
0.2,7216,92,579043,80.2331993903284,13
0.2,7217,94,579137,80.23510667775007,7
0.2,7218,94,579231,80.2370134367641,8
0.2,7219,95,579326,80.23905817174516,6
0.2,7220,15,579341,80.23002354244565,17
0.2,7221,94,579435,80.23193021323733,7
0.2,7222,95,579530,80.23397480271355,6
0.2,7223,92,579622,80.23560354374308,9
0.2,7224,94,579716,80.23750865051903,8
0.2,7225,18,579734,80.22889565458068,15
0.2,7226,96,579830,80.23107790231077,6
0.2,7227,95,579925,80.23312119535142,7
0.2,7228,87,580012,80.23405726933186,14
0.2,7229,24,580036,80.22627939142463,8
0.2,7230,88,580124,80.2273544461347,14
0.2,7231,94,580218,80.22925884955752,7
0.2,7232,96,580314,80.23143923683119,6
0.2,7233,26,580340,80.22394249377938,7
0.2,7234,92,580432,80.22557014512785,9
0.2,7235,89,580521,80.22678275290215,12
0.2,7236,94,580615,80.22868591957993,7
0.2,7237,90,580705,80.23003592152529,11
0.2,7238,94,580799,80.23193811299903,7
0.2,7239,94,580893,80.23383977900552,7
0.2,7240,91,580984,80.23532661234636,10
0.2,7241,90,581074,80.2366749516708,11
0.2,7242,92,581166,80.23829904735607,9
0.2,7243,93,581259,80.2400607399227,8
0.2,7244,93,581352,80.24182194616978,8
0.2,7245,23,581375,80.23392216395253,9
0.2,7246,93,581468,80.23568373119912,8
0.2,7247,95,581563,80.23772075055187,6
0.2,7248,94,581657,80.23961925782866,7
0.2,7249,92,581749,80.24124137931034,10
0.2,7250,90,581839,80.24258722934768,11
0.2,7251,22,581861,80.23455598455598,11
0.2,7252,95,581956,80.2365917551358,6
0.2,7253,95,582051,80.23862696443342,7
0.2,7254,94,582145,80.24052377670571,7
0.2,7255,85,582230,80.24117971334068,17
0.2,7256,94,582324,80.2430756510955,8
0.2,7257,91,582415,80.24455772940203,10
0.2,7258,93,582508,80.24631491941038,8
0.2,7259,94,582602,80.24820936639118,8
0.2,7260,94,582696,80.25010329155764,7
0.2,7261,86,582782,80.25089507022858,15
0.2,7262,-194,582588,80.21313506815366,20
0.2,7263,90,582678,80.21448237885463,11
0.2,7264,93,582771,80.21624225739849,8
0.2,7265,96,582867,80.21841453344344,6
0.2,7266,96,582963,80.22058621164167,7
0.2,7267,94,583057,80.22248211337369,7
0.2,7268,95,583152,80.22451506397029,6
0.2,7269,91,583243,80.22599724896837,12
0.2,7270,94,583337,80.22789162426076,7
0.2,7271,94,583431,80.22978547854785,8
0.2,7272,96,583527,80.23195380173243,6
0.2,7273,22,583549,80.22394830904592,10
0.2,7274,82,583631,80.22419243986255,21
0.2,7275,95,583726,80.2262231995602,6
0.2,7276,25,583751,80.21863405249415,7
0.2,7277,-50,583701,80.20074196207749,13
0.2,7278,92,583793,80.20236296194533,10
0.2,7279,94,583887,80.20425824175824,7
0.2,7280,92,583979,80.20587831341848,9
0.2,7281,91,584070,80.2073606152156,10
0.2,7282,85,584155,80.20801867362351,19
0.2,7283,27,584182,80.20071389346514,6
0.2,7284,93,584275,80.20247083047357,9
0.2,7285,93,584368,80.2042272852045,8
0.2,7286,90,584458,80.20557156580212,13
0.2,7287,93,584551,80.20732711306258,8
0.2,7288,92,584643,80.20894498559473,9
0.2,7289,90,584733,80.21028806584363,11
0.2,7290,91,584824,80.21176793306816,12
0.2,7291,96,584920,80.21393307734503,6
0.2,7292,93,585013,80.2156862745098,8
0.2,7293,88,585101,80.21675349602413,13
0.2,7294,91,585192,80.21823166552433,11
0.2,7295,95,585287,80.2202576754386,6
0.2,7296,93,585380,80.22200904481294,8
0.2,7297,96,585476,80.224171005755,6
0.2,7298,90,585566,80.22551034388272,11
0.2,7299,95,585661,80.22753424657535,6
0.2,7300,88,585749,80.22859882207916,13
0.2,7301,88,585837,80.22966310599836,13
0.2,7302,91,585928,80.23113788853895,10
0.2,7303,94,586022,80.23302300109529,8
0.2,7304,82,586104,80.23326488706365,21
0.2,7305,96,586200,80.23542294004928,6
0.2,7306,94,586294,80.23730669221294,8
0.2,7307,-46,586248,80.2200328407225,9
0.2,7308,19,586267,80.21165686140375,14
0.2,7309,96,586363,80.21381668946648,6
0.2,7310,92,586455,80.2154288059089,9
0.2,7311,21,586476,80.20733041575492,11
0.2,7312,92,586568,80.2089429782579,9
0.2,7313,93,586661,80.21069182389937,9
0.2,7314,89,586750,80.2118933697881,12
0.2,7315,83,586833,80.21227446692181,18
0.2,7316,-44,586789,80.19529861965286,8
0.2,7317,93,586882,80.19704837387265,8
0.2,7318,94,586976,80.19893428063943,7
0.2,7319,90,587066,80.20027322404371,12
0.2,7320,92,587158,80.20188498838957,9
0.2,7321,-46,587112,80.18464900300464,10
0.2,7322,95,587207,80.18667212890892,6
0.2,7323,27,587234,80.17941015838339,6
0.2,7324,91,587325,80.18088737201366,11
0.2,7325,91,587416,80.18236418236418,10
0.2,7326,92,587508,80.18397707110687,9
0.2,7327,84,587592,80.18449781659389,18
0.2,7328,96,587688,80.18665575112567,6
0.2,7329,93,587781,80.18840381991815,8
0.2,7330,91,587872,80.18987859773564,10
0.2,7331,94,587966,80.19176213857065,7
0.2,7332,94,588060,80.19364516568935,7
0.2,7333,22,588082,80.18571038996456,10
0.2,7334,86,588168,80.18650306748467,16
0.2,7335,21,588189,80.17843511450381,11
0.2,7336,90,588279,80.17977374948889,11
0.2,7337,90,588369,80.18111201962388,11
0.2,7338,94,588463,80.1829949584412,7
0.2,7339,89,588552,80.1841961852861,12
0.2,7340,96,588648,80.18635063342869,6
0.2,7341,88,588736,80.18741487333152,13
0.2,7342,87,588823,80.18834263924826,14
0.2,7343,94,588917,80.19022331154684,8
0.2,7344,94,589011,80.19210347174949,7
0.2,7345,93,589104,80.19384699156004,8
0.2,7346,25,589129,80.18633455832313,7
0.2,7347,94,589223,80.18821448013065,7
0.2,7348,20,589243,80.18002449312831,12
0.2,7349,94,589337,80.18190476190476,7
0.2,7350,94,589431,80.18378451911305,7
0.2,7351,92,589523,80.18539173014146,9
0.2,7352,93,589616,80.18713450292398,8
0.2,7353,86,589702,80.1879249388088,15
0.2,7354,96,589798,80.19007477906186,6
0.2,7355,-50,589748,80.17237629146275,15
0.2,7356,25,589773,80.16487698790267,7
0.2,7357,94,589867,80.16675727099755,7
0.2,7358,93,589960,80.16850115504825,8
0.2,7359,90,590050,80.16983695652173,12
0.2,7360,94,590144,80.17171579948376,8
0.2,7361,26,590170,80.16435751154577,7
0.2,7362,90,590260,80.16569333152248,12
0.2,7363,-48,590212,80.14828897338403,13
0.2,7364,91,590303,80.14976238968093,11
0.2,7365,86,590389,80.15055661145806,16
0.2,7366,94,590483,80.15243654133297,7
0.2,7367,27,590510,80.14522258414766,6
0.2,7368,96,590606,80.1473741348894,6
0.2,7369,90,590696,80.14871099050204,11
0.2,7370,91,590787,80.15018315018315,10
0.2,7371,92,590879,80.15179055887141,11
0.2,7372,94,590973,80.15366879153669,7
0.2,7373,25,590998,80.14618931380527,7
0.2,7374,95,591093,80.14820338983051,7
0.2,7375,26,591119,80.14086225596529,6
0.2,7376,94,591213,80.14274095160634,8
0.2,7377,82,591295,80.14299268094335,19
0.2,7378,26,591321,80.1356552378371,6
0.2,7379,93,591414,80.13739837398374,8
0.2,7380,94,591508,80.13927652079664,8
0.2,7381,92,591600,80.14088322947711,10
0.2,7382,92,591692,80.1424895029121,9
0.2,7383,96,591788,80.14463705308776,6
0.2,7384,87,591875,80.1455653351388,15
0.2,7385,91,591966,80.14703493095044,10
0.2,7386,94,592060,80.1489102477325,7
0.2,7387,93,592153,80.15064970221981,8
0.2,7388,95,592248,80.15265935850589,7
0.2,7389,91,592339,80.15412719891745,10
0.2,7390,93,592432,80.15586524150994,8
0.2,7391,22,592454,80.14799783549783,10
0.2,7392,90,592544,80.14933044772081,12
0.2,7393,18,592562,80.14092507438464,14
0.2,7394,94,592656,80.14279918864098,9
0.2,7395,26,592682,80.13547863710113,6
0.2,7396,90,592772,80.13681222117074,12
0.2,7397,94,592866,80.13868613138686,8
0.2,7398,92,592958,80.14028922827409,10
0.2,7399,94,593052,80.14216216216217,8
0.2,7400,94,593146,80.14403458992028,8
0.2,7401,87,593233,80.14496082139962,14
0.2,7402,93,593326,80.14669728488451,8
0.2,7403,94,593420,80.14856834143706,7
0.2,7404,93,593513,80.15030384875084,8
0.2,7405,-49,593464,80.13286524439644,12
0.2,7406,91,593555,80.13433238828135,10
0.2,7407,91,593646,80.13579913606911,10
0.2,7408,92,593738,80.13740045890134,9
0.2,7409,94,593832,80.13927125506073,7
0.2,7410,88,593920,80.14033193900958,14
0.2,7411,92,594012,80.14193200215867,9
0.2,7412,95,594107,80.1439363280723,6
0.2,7413,94,594201,80.14580523334233,7
0.2,7414,96,594297,80.14794335805799,6
0.2,7415,90,594387,80.14927184466019,12
0.2,7416,23,594410,80.14156667116085,11
0.2,7417,89,594499,80.14276085198166,12
0.2,7418,94,594593,80.14462865615312,7
0.2,7419,21,594614,80.1366576819407,12
0.2,7420,87,594701,80.13758253604635,18
0.2,7421,25,594726,80.1301535974131,7
0.2,7422,91,594817,80.1316179442274,12
0.2,7423,89,594906,80.1328125,13
0.2,7424,92,594998,80.13441077441077,9
0.2,7425,96,595094,80.13654726636143,6
0.2,7426,25,595119,80.12912346842602,7
0.2,7427,86,595205,80.12991383952611,17
0.2,7428,95,595300,80.13191546641539,6
0.2,7429,22,595322,80.12409152086137,12
0.2,7430,94,595416,80.12595882115463,8
0.2,7431,94,595510,80.1278256189451,9
0.2,7432,95,595605,80.12982644961657,6
0.2,7433,91,595696,80.13128867366156,11
0.2,7434,94,595790,80.13315400134499,8
0.2,7435,95,595885,80.13515330823023,7
0.2,7436,25,595910,80.12773967997849,8
0.2,7437,91,596001,80.12920139822533,10
0.2,7438,96,596097,80.1313348568356,6
0.2,7439,90,596187,80.13266129032257,11
0.2,7440,93,596280,80.13439053890606,8
0.2,7441,94,596374,80.13625369524321,10
0.2,7442,94,596468,80.13811635093376,7
0.2,7443,21,596489,80.13017195056422,11
0.2,7444,93,596582,80.1319006044325,8
0.2,7445,-51,596531,80.11428955143701,14
0.2,7446,89,596620,80.11548274472942,14
0.2,7447,92,596712,80.11707841031149,9
0.2,7448,92,596804,80.11867364746946,9
0.2,7449,23,596827,80.1110067114094,9
0.2,7450,93,596920,80.11273654543014,9
0.2,7451,93,597013,80.11446591519055,8
0.2,7452,91,597104,80.11592647256138,10
0.2,7453,27,597131,80.10880064394956,6
0.2,7454,92,597223,80.1103957075788,10
0.2,7455,94,597317,80.11225858369099,9
0.2,7456,92,597409,80.11385275579993,9
0.2,7457,91,597500,80.11531241619737,10
0.2,7458,26,597526,80.1080573803459,7
0.2,7459,21,597547,80.10013404825737,12
0.2,7460,25,597572,80.09274896126524,7
0.2,7461,24,597596,80.0852318413294,8
0.2,7462,92,597688,80.08682835320917,9
0.2,7463,25,597713,80.07944801714898,7
0.2,7464,95,597808,80.08144675150703,6
0.2,7465,93,597901,80.0831770693812,8
0.2,7466,95,597996,80.08517476898352,7
0.2,7467,96,598092,80.08730583824317,6
0.2,7468,92,598184,80.08890078993171,9
0.2,7469,89,598273,80.090093708166,16
0.2,7470,94,598367,80.09195556150448,8
0.2,7471,96,598463,80.09408458244111,6
0.2,7472,92,598555,80.09567777331728,9
0.2,7473,95,598650,80.0976719293551,6
0.2,7474,93,598743,80.09939799331104,8
0.2,7475,93,598836,80.10112359550561,8
0.2,7476,93,598929,80.10284873612412,9
0.2,7477,25,598954,80.09548007488634,7
0.2,7478,92,599046,80.09707180104292,9
0.2,7479,92,599138,80.09866310160427,9
0.2,7480,92,599230,80.10025397674107,9
0.2,7481,87,599317,80.101176156108,15
0.2,7482,93,599410,80.10289990645462,8
0.2,7483,95,599505,80.10489043292357,6
0.2,7484,90,599595,80.1062124248497,11
0.2,7485,86,599681,80.10699973283462,16
0.2,7486,94,599775,80.10885534927208,7
0.2,7487,90,599865,80.11017628205128,11
0.2,7488,90,599955,80.11149686206436,14
0.2,7489,90,600045,80.1128170894526,12
0.2,7490,92,600137,80.11440395140836,9
0.2,7491,93,600230,80.11612386545649,8
0.2,7492,87,600317,80.11704257306819,15
0.2,7493,90,600407,80.11836135575126,11
0.2,7494,95,600502,80.12034689793195,6
0.2,7495,12,600514,80.11125933831377,20
0.2,7496,92,600606,80.11284513805522,9
0.2,7497,90,600696,80.1141637770072,12
0.2,7498,27,600723,80.10708094412588,6
0.2,7499,88,600811,80.10813333333333,13
0.2,7500,92,600903,80.10971870417278,11
0.2,7501,-46,600857,80.09290855771795,11
0.2,7502,95,600952,80.09489537518326,7
0.2,7503,24,600976,80.08742004264393,9
0.2,7504,94,601070,80.08927381745502,7
0.2,7505,95,601165,80.09126032507328,6
0.2,7506,93,601258,80.09297988544026,8
0.2,7507,90,601348,80.09429941395844,12
0.2,7508,88,601436,80.09535224397389,13
0.2,7509,94,601530,80.09720372836219,7
0.2,7510,91,601621,80.09865530555186,10
0.2,7511,92,601713,80.10023961661342,9
0.2,7512,95,601808,80.10222281378942,8
0.2,7513,86,601894,80.10300771892467,16
0.2,7514,90,601984,80.1043246839654,11
0.2,7515,91,602075,80.10577434805748,10
0.2,7516,96,602171,80.10788878541972,6
0.2,7517,95,602266,80.10986964618249,6
0.2,7518,93,602359,80.11158398723235,8
0.2,7519,17,602376,80.1031914893617,15
0.2,7520,96,602472,80.10530514559234,6
0.2,7521,92,602564,80.10688646636532,9
0.2,7522,95,602659,80.10886614382561,6
0.2,7523,20,602679,80.10087719298245,13
0.2,7524,22,602701,80.0931561461794,10
0.2,7525,96,602797,80.09526973159713,6
0.2,7526,92,602889,80.0968513351933,9
0.2,7527,94,602983,80.09869819341127,7
0.2,7528,22,603005,80.09098153805286,10
0.2,7529,95,603100,80.0929614873838,6
0.2,7530,91,603191,80.09440977293852,10
0.2,7531,25,603216,80.08709506107276,7
0.2,7532,95,603311,80.08907473782025,7
0.2,7533,22,603333,80.08136448101938,11
0.2,7534,92,603425,80.08294625082947,9
0.2,7535,92,603517,80.08452760084926,10
0.2,7536,27,603544,80.0774844102428,6
0.2,7537,92,603636,80.0790660652693,9
0.2,7538,90,603726,80.08038201352964,12
0.2,7539,95,603821,80.08236074270557,6
0.2,7540,92,603913,80.08394112186713,9
0.2,7541,95,604008,80.08591885441527,6
0.2,7542,92,604100,80.08749834283442,9
0.2,7543,87,604187,80.08841463414635,14
0.2,7544,93,604280,80.09012591119946,8
0.2,7545,92,604372,80.0917042141532,9
0.2,7546,27,604399,80.08466940506162,6
0.2,7547,90,604489,80.08598304186539,11
0.2,7548,94,604583,80.08782620214598,7
0.2,7549,94,604677,80.08966887417219,7
0.2,7550,89,604766,80.0908488941862,12
0.2,7551,26,604792,80.08368644067797,6
0.2,7552,90,604882,80.08499933801139,12
0.2,7553,17,604899,80.07664813343924,16
0.2,7554,89,604988,80.07782925215089,14
0.2,7555,95,605083,80.07980412916888,6
0.2,7556,94,605177,80.08164615588197,7
0.2,7557,94,605271,80.08348769515744,7
0.2,7558,95,605366,80.08546103982009,6
0.2,7559,92,605458,80.08703703703704,9
0.2,7560,93,605551,80.08874487501653,8
0.2,7561,96,605647,80.09084898175087,6
0.2,7562,90,605737,80.09215919608621,11
0.2,7563,92,605829,80.09373347435219,10
0.2,7564,96,605925,80.09583608724388,6
0.2,7565,94,606019,80.09767380385937,7
0.2,7566,92,606111,80.09924672921898,9
0.2,7567,93,606204,80.10095137420718,9
0.2,7568,91,606295,80.1023913330691,10
0.2,7569,95,606390,80.10435931307794,6
0.2,7570,94,606484,80.10619469026548,9
0.2,7571,26,606510,80.09904912836767,6
0.2,7572,96,606606,80.10114881816982,6
0.2,7573,95,606701,80.1031159228941,6
0.2,7574,25,606726,80.09584158415842,8
0.2,7575,93,606819,80.09754487856388,8
0.2,7576,-193,606626,80.06150191368616,20
0.2,7577,93,606719,80.06320929005014,8
0.2,7578,94,606813,80.06504815938779,7
0.2,7579,89,606902,80.06622691292876,12
0.2,7580,87,606989,80.06714153805567,14
0.2,7581,93,607082,80.06884726984964,9
0.2,7582,93,607175,80.07055255176051,11
0.2,7583,94,607269,80.07238924050633,7
0.2,7584,95,607364,80.07435728411338,6
0.2,7585,92,607456,80.07592934352755,9
0.2,7586,94,607550,80.07776459733755,8
0.2,7587,25,607575,80.07050606220348,7
0.2,7588,90,607665,80.0718144683094,13
0.2,7589,22,607687,80.06416337285903,10
0.2,7590,96,607783,80.06626267948887,7
0.2,7591,93,607876,80.06796628029505,10
0.2,7592,94,607970,80.06980113262215,7
0.2,7593,91,608061,80.0712404529892,10
0.2,7594,94,608155,80.07307439104675,7
0.2,7595,21,608176,80.06529752501316,13
0.2,7596,96,608272,80.06739502435171,6
0.2,7597,21,608293,80.05962095288234,11
0.2,7598,95,608388,80.06158705092776,6
0.2,7599,81,608469,80.06171052631579,20
0.2,7600,22,608491,80.0540718326536,10
0.2,7601,92,608583,80.05564325177585,9
0.2,7602,92,608675,80.05721425752992,9
0.2,7603,96,608771,80.05931088900579,6
0.2,7604,25,608796,80.05207100591716,9
0.2,7605,92,608888,80.05364186168813,10
0.2,7606,19,608907,80.04561588011042,14
0.2,7607,25,608932,80.03838065194532,7
0.2,7608,93,609025,80.04008411092127,8
0.2,7609,93,609118,80.04178712220762,8
0.2,7610,91,609209,80.04322690842201,10
0.2,7611,92,609301,80.04479768786128,9
0.2,7612,95,609396,80.04676211743072,6
0.2,7613,90,609486,80.04806934594168,13
0.2,7614,91,609577,80.0495075508864,10
0.2,7615,93,609670,80.05120798319328,8
0.2,7616,92,609762,80.05277668373375,9
0.2,7617,94,609856,80.05460750853243,7
0.2,7618,95,609951,80.0565691035569,8
0.2,7619,15,609966,80.04803149606299,17
0.2,7620,94,610060,80.0498622228054,7
0.2,7621,91,610151,80.05129887168722,10
0.2,7622,95,610246,80.0532598714417,8
0.2,7623,92,610338,80.05482686253934,9
0.2,7624,95,610433,80.0567868852459,6
0.2,7625,-49,610384,80.0398636244427,12
0.2,7626,25,610409,80.03264717451161,8
0.2,7627,87,610496,80.03356056633456,16
0.2,7628,-53,610443,80.01612268973653,16
0.2,7629,94,610537,80.01795543905635,8
0.2,7630,94,610631,80.01978770803302,7
0.2,7631,94,610725,80.02161949685535,8
0.2,7632,92,610817,80.02318878553649,9
0.2,7633,25,610842,80.0159811370186,7
0.2,7634,94,610936,80.01781270464964,7
0.2,7635,96,611032,80.01990570979571,6
0.2,7636,26,611058,80.012832263978,6
0.2,7637,95,611153,80.01479444880859,6
0.2,7638,25,611178,80.00759261683467,8
0.2,7639,26,611204,80.00052356020943,6
0.2,7640,24,611228,79.9931946080356,8
0.2,7641,93,611321,79.99489662392044,9
0.2,7642,25,611346,79.98770116446421,7
0.2,7643,91,611437,79.98914181057039,10
0.2,7644,25,611462,79.98194898626554,7
0.2,7645,92,611554,79.98352079518702,9
0.2,7646,94,611648,79.98535373349026,7
0.2,7647,94,611742,79.98718619246861,7
0.2,7648,90,611832,79.9884952281344,11
0.2,7649,25,611857,79.98130718954248,8
0.2,7650,92,611949,79.98287805515619,9
0.2,7651,92,612041,79.98444851019342,9
0.2,7652,94,612135,79.98627989023912,7
0.2,7653,22,612157,79.97870394564933,12
0.2,7654,96,612253,79.98079686479426,6
0.2,7655,92,612345,79.98236677115987,9
0.2,7656,87,612432,79.98328327021026,14
0.2,7657,95,612527,79.98524418908332,6
0.2,7658,93,612620,79.98694346520433,8
0.2,7659,94,612714,79.98877284595301,7
0.2,7660,26,612740,79.98172562328678,6
0.2,7661,93,612833,79.98342469329157,8
0.2,7662,24,612857,79.9761190134412,8
0.2,7663,94,612951,79.97794885177453,7
0.2,7664,93,613044,79.97964774951076,9
0.2,7665,94,613138,79.98147665014349,7
0.2,7666,94,613232,79.98330507369245,8
0.2,7667,94,613326,79.98513302034429,7
0.2,7668,93,613419,79.98683009518842,10
0.2,7669,24,613443,79.97953063885268,8
0.2,7670,78,613521,79.97927258506061,23
0.2,7671,96,613617,79.98136079249218,6
0.2,7672,87,613704,79.98227551153396,14
0.2,7673,92,613796,79.98384154287204,9
0.2,7674,26,613822,79.97680781758957,6
0.2,7675,94,613916,79.97863470557581,7
0.2,7676,95,614011,79.98059137683991,6
0.2,7677,92,614103,79.98215681166971,11
0.2,7678,25,614128,79.97499674436776,8
0.2,7679,94,614222,79.97682291666666,8
0.2,7680,88,614310,79.9778674651738,13
0.2,7681,92,614402,79.9794324394689,9
0.2,7682,93,614495,79.98112716386828,11
0.2,7683,94,614589,79.98295158771474,7
0.2,7684,94,614683,79.98477553675993,9
0.2,7685,95,614778,79.98672911787666,6
0.2,7686,96,614874,79.98881228047352,7
0.2,7687,86,614960,79.98959417273673,15
0.2,7688,95,615055,79.99154636493692,6
0.2,7689,91,615146,79.992977893368,10
0.2,7690,94,615240,79.99479911584969,7
0.2,7691,90,615330,79.99609984399376,11
0.2,7692,90,615420,79.99740023397894,11
0.2,7693,91,615511,79.99883025734339,10
0.2,7694,93,615604,80.00051981806368,8
0.2,7695,96,615700,80.00259875259876,6
0.2,7696,94,615794,80.00441730544368,7
0.2,7697,-54,615740,79.98700961288647,18
0.2,7698,90,615830,79.98831017015196,11
0.2,7699,92,615922,79.98987012987013,9
0.2,7700,26,615948,79.98285936891313,6
0.2,7701,92,616040,79.9844196312646,10
0.2,7702,91,616131,79.98584966896014,10
0.2,7703,89,616220,79.98701973001039,14
0.2,7704,90,616310,79.98831927319922,11
0.2,7705,96,616406,79.99039709317415,6
0.2,7706,96,616502,79.99247437394577,6
0.2,7707,94,616596,79.99429164504411,8
0.2,7708,94,616690,79.99610844467506,7
0.2,7709,91,616781,79.99753566796369,10
0.2,7710,93,616874,79.99922189080534,8
0.2,7711,93,616967,80.00090767634855,8
0.2,7712,20,616987,79.99312848437702,13
0.2,7713,92,617079,79.9946849883329,11
0.2,7714,85,617164,79.99533376539209,20
0.2,7715,90,617254,79.99663037843442,11
0.2,7716,91,617345,79.9980562394713,10
0.2,7717,91,617436,79.99948173101839,10
0.2,7718,92,617528,80.00103640367924,9
0.2,7719,83,617611,80.00142487046632,18
0.2,7720,23,617634,79.99404222251003,9
0.2,7721,94,617728,79.99585599585599,7
0.2,7722,94,617822,79.99766929949502,7
0.2,7723,94,617916,79.99948213360953,7
0.2,7724,91,618007,80.00090614886732,11
0.2,7725,88,618095,80.00194149624645,15
0.2,7726,92,618187,80.00349424097321,9
0.2,7727,92,618279,80.00504658385093,9
0.2,7728,7,618286,79.99560098330961,29
0.2,7729,89,618375,79.996765847348,12
0.2,7730,91,618466,79.99818910878282,10
0.2,7731,27,618493,79.99133471288152,6
0.2,7732,95,618588,79.99327557222294,7
0.2,7733,94,618682,79.9950866304629,8
0.2,7734,94,618776,79.99689722042663,7
0.2,7735,94,618870,79.99870734229576,7
0.2,7736,23,618893,79.99134031278274,10
0.2,7737,92,618985,79.99289222021194,10
0.2,7738,95,619080,79.99483137356248,8
0.2,7739,93,619173,79.99651162790698,8
0.2,7740,91,619264,79.99793308358093,11
0.2,7741,94,619358,79.99974166881942,7
0.2,7742,94,619452,80.0015497869043,8
0.2,7743,94,619546,80.00335743801652,7
0.2,7744,90,619636,80.00464816010329,11
0.2,7745,95,619731,80.00658404337723,6
0.2,7746,92,619823,80.00813218019879,9
0.2,7747,88,619911,80.0091636551368,16
0.2,7748,90,620001,80.01045296167247,11
0.2,7749,96,620097,80.01251612903226,6
0.2,7750,92,620189,80.0140627015869,9
0.2,7751,94,620283,80.01586687306502,7
0.2,7752,94,620377,80.01767057913067,7
0.2,7753,92,620469,80.01921588857364,9
0.2,7754,-46,620423,80.00296582849775,12
0.2,7755,92,620515,80.00451263537906,9
0.2,7756,95,620610,80.00644579089854,7
0.2,7757,94,620704,80.0082495488528,8
0.2,7758,93,620797,80.0099239592731,8
0.2,7759,83,620880,80.01030927835052,18
0.2,7760,93,620973,80.01198299188249,9
0.2,7761,88,621061,80.01301211028085,13
0.2,7762,-51,621010,79.99613551462063,15
0.2,7763,95,621105,79.99806800618238,6
0.2,7764,25,621130,79.99098518995493,8
0.2,7765,92,621222,79.99253154777234,10
0.2,7766,90,621312,79.99382000772499,11
0.2,7767,95,621407,79.9957518022657,6
0.2,7768,26,621433,79.9888016475737,7
0.2,7769,92,621525,79.99034749034749,9
0.2,7770,94,621619,79.99215030240639,8
0.2,7771,88,621707,79.99318064848173,13
0.2,7772,94,621801,79.99498263218834,7
0.2,7773,-49,621752,79.97838950347311,12
0.2,7774,85,621837,79.97903536977492,18
0.2,7775,20,621857,79.9713220164609,12
0.2,7776,94,621951,79.97312588401698,7
0.2,7777,96,622047,79.97518642324505,6
0.2,7778,93,622140,79.97686077902044,8
0.2,7779,96,622236,79.9789203084833,6
0.2,7780,92,622328,79.98046523583086,10
0.2,7781,95,622423,79.98239527113853,6
0.2,7782,91,622514,79.98381086984453,10
0.2,7783,88,622602,79.98484069886948,13
0.2,7784,94,622696,79.98664097623636,8
0.2,7785,93,622789,79.98831235550989,8
0.2,7786,25,622814,79.98125080261975,8
0.2,7787,90,622904,79.98253723677452,11
0.2,7788,88,622992,79.98356656823725,13
0.2,7789,-45,622947,79.96752246469833,10
0.2,7790,23,622970,79.96021049929406,9
0.2,7791,96,623066,79.96226899383984,6
0.2,7792,24,623090,79.9550878993969,8
0.2,7793,91,623181,79.95650500384912,10
0.2,7794,91,623272,79.95792174470814,10
0.2,7795,95,623367,79.95985120574653,6
0.2,7796,91,623458,79.9612671540336,11
0.2,7797,92,623550,79.96281097717363,10
0.2,7798,91,623641,79.96422618284396,10
0.2,7799,88,623729,79.96525641025642,13
0.2,7800,94,623823,79.9670555057044,7
0.2,7801,89,623912,79.9682132786465,12
0.2,7802,90,624002,79.96949891067538,11
0.2,7803,92,624094,79.97104049205535,9
0.2,7804,94,624188,79.97283792440743,9
0.2,7805,90,624278,79.97412246989495,11
0.2,7806,94,624372,79.9759190470091,7
0.2,7807,91,624463,79.97733094262296,10
0.2,7808,-52,624411,79.9604302727622,16
0.2,7809,90,624501,79.9617157490397,13
0.2,7810,94,624595,79.96351299449495,7
0.2,7811,93,624688,79.96518177163338,10
0.2,7812,95,624783,79.96710610520927,6
0.2,7813,90,624873,79.96839006910673,11
0.2,7814,92,624965,79.9699296225208,9
0.2,7815,89,625054,79.97108495394063,16
0.2,7816,85,625139,79.97172828450812,17
0.2,7817,25,625164,79.96469685341519,8
0.2,7818,84,625248,79.96521294283157,17
0.2,7819,91,625339,79.96662404092072,12
0.2,7820,25,625364,79.95959595959596,8
0.2,7821,94,625458,79.96139094860649,7
0.2,7822,94,625552,79.96318547871661,7
0.2,7823,91,625643,79.96459611451942,11
0.2,7824,24,625667,79.95744408945687,8
0.2,7825,90,625757,79.95872731919243,11
0.2,7826,87,625844,79.95962693241344,14
0.2,7827,95,625939,79.96154828819621,6
0.2,7828,93,626032,79.96321369268105,8
0.2,7829,91,626123,79.96462324393359,11
0.2,7830,-44,626079,79.94879325756608,8
0.2,7831,23,626102,79.94152196118488,9
0.2,7832,90,626192,79.94280607685434,11
0.2,7833,86,626278,79.94357926984938,16
0.2,7834,94,626372,79.9453733248245,7
0.2,7835,92,626464,79.94691168963757,10
0.2,7836,85,626549,79.94755646293224,16
0.2,7837,94,626643,79.9493493238071,7
0.2,7838,91,626734,79.95075902538589,11
0.2,7839,92,626826,79.95229591836734,9
0.2,7840,94,626920,79.95408748884071,8
0.2,7841,94,627014,79.95587860239735,7
0.2,7842,95,627109,79.95779676144332,8
0.2,7843,94,627203,79.959586945436,8
0.2,7844,93,627296,79.96124920331421,9
0.2,7845,91,627387,79.96265613051236,11
0.2,7846,94,627481,79.96444501083216,7
0.2,7847,92,627573,79.96597859327217,9
0.2,7848,26,627599,79.95910307045483,7
0.2,7849,96,627695,79.96114649681529,6
0.2,7850,96,627791,79.96318940262387,6
0.2,7851,94,627885,79.96497707590423,8
0.2,7852,94,627979,79.96676429390043,7
0.2,7853,91,628070,79.96816908581614,12
0.2,7854,96,628166,79.97021005728836,6
0.2,7855,94,628260,79.97199592668025,8
0.2,7856,89,628349,79.97314496627212,13
0.2,7857,93,628442,79.97480274879103,8
0.2,7858,90,628532,79.97607838147347,11
0.2,7859,90,628622,79.97735368956744,11
0.2,7860,96,628718,79.97939193486833,6
0.2,7861,80,628798,79.9793945560926,21
0.2,7862,88,628886,79.98041460002544,13
0.2,7863,13,628899,79.97189725330621,20
0.2,7864,-48,628851,79.95562619198982,11
0.2,7865,92,628943,79.95715738621917,9
0.2,7866,89,629032,79.9583068514046,13
0.2,7867,94,629126,79.96009150991357,7
0.2,7868,24,629150,79.95298004829075,8
0.2,7869,93,629243,79.95463786531131,10
0.2,7870,92,629335,79.95616821242535,9
0.2,7871,24,629359,79.9490599593496,8
0.2,7872,94,629453,79.950844658961,7
0.2,7873,27,629480,79.94411988823978,6
0.2,7874,91,629571,79.9455238095238,10
0.2,7875,93,629664,79.9471813103098,8
0.2,7876,94,629758,79.94896534213532,7
0.2,7877,25,629783,79.94199035288145,8
0.2,7878,93,629876,79.94364767102424,9
0.2,7879,23,629899,79.93642131979695,10
0.2,7880,23,629922,79.92919680243624,9
0.2,7881,95,630017,79.9311088556204,6
0.2,7882,90,630107,79.93238614740581,11
0.2,7883,93,630200,79.93404363267376,9
0.2,7884,93,630293,79.93570069752695,8
0.2,7885,25,630318,79.92873446614253,7
0.2,7886,83,630401,79.92912387473056,18
0.2,7887,91,630492,79.93052738336714,10
0.2,7888,89,630581,79.93167701863354,12
0.2,7889,91,630672,79.93307984790874,12
0.2,7890,95,630767,79.9349892282347,6
0.2,7891,24,630791,79.92790167257982,10
0.2,7892,92,630883,79.9294311415178,9
0.2,7893,94,630977,79.93121357993412,7
0.2,7894,95,631072,79.93312222925903,6
0.2,7895,89,631161,79.93427051671732,12
0.2,7896,89,631250,79.93541851335951,12
0.2,7897,21,631271,79.92795644466953,13
0.2,7898,93,631364,79.929611343208,8
0.2,7899,94,631458,79.93139240506329,7
0.2,7900,95,631553,79.93329958233134,6
0.2,7901,89,631642,79.93444697544925,12
0.2,7902,91,631733,79.93584714665317,10
0.2,7903,22,631755,79.92851720647774,10
0.2,7904,94,631849,79.93029728020241,7
0.2,7905,92,631941,79.9318239311915,10
0.2,7906,94,632035,79.93360313646136,7
0.2,7907,94,632129,79.93538189175518,7
0.2,7908,26,632155,79.92856239726893,6
0.2,7909,94,632249,79.93034134007586,7
0.2,7910,89,632338,79.93148780179497,12
0.2,7911,91,632429,79.93288675429727,10
0.2,7912,96,632525,79.93491722481991,6
0.2,7913,93,632618,79.93656810715188,10
0.2,7914,22,632640,79.92924826279217,11
0.2,7915,94,632734,79.9310257705912,8
0.2,7916,95,632829,79.93292913982569,6
0.2,7917,96,632925,79.9349583228088,6
0.2,7918,92,633017,79.93648187902512,9
0.2,7919,17,633034,79.92853535353535,15
0.2,7920,92,633126,79.93005933594243,9
0.2,7921,94,633220,79.93183539510224,9
0.2,7922,95,633315,79.93373722074972,6
0.2,7923,90,633405,79.93500757193337,11
0.2,7924,90,633495,79.93627760252366,13
0.2,7925,94,633589,79.9380519808226,8
0.2,7926,94,633683,79.9398259114419,8
0.2,7927,95,633778,79.94172552976791,8
0.2,7928,92,633870,79.94324631101021,9
0.2,7929,90,633960,79.94451450189155,11
0.2,7930,88,634048,79.94553019795738,13
0.2,7931,95,634143,79.94742813918306,6
0.2,7932,95,634238,79.94932560191604,6
0.2,7933,91,634329,79.95071842702293,10
0.2,7934,93,634422,79.9523629489603,9
0.2,7935,91,634513,79.95375504032258,12
0.2,7936,94,634607,79.95552475746504,7
0.2,7937,96,634703,79.95754598135551,6
0.2,7938,95,634798,79.95944073560902,6
0.2,7939,91,634889,79.96083123425693,12
0.2,7940,92,634981,79.96234731142174,9
0.2,7941,24,635005,79.95530093175523,8
0.2,7942,83,635088,79.95568425028327,18
0.2,7943,87,635175,79.95657099697885,15
0.2,7944,92,635267,79.95808684707363,9
0.2,7945,95,635362,79.95997986408256,9
0.2,7946,96,635458,79.96199823832893,6
0.2,7947,86,635544,79.9627579265224,17
0.2,7948,25,635569,79.95584350232734,7
0.2,7949,93,635662,79.95748427672956,8
0.2,7950,93,635755,79.95912463841026,9
0.2,7951,96,635851,79.96114185110665,6
0.2,7952,24,635875,79.95410536904313,9
0.2,7953,92,635967,79.9556198139301,10
0.2,7954,96,636063,79.95763670647392,6
0.2,7955,94,636157,79.9594017094017,7
0.2,7956,94,636251,79.96116626869423,7
0.2,7957,95,636346,79.96305604423222,6
0.2,7958,90,636436,79.96431712526699,11
0.2,7959,92,636528,79.96582914572865,9
0.2,7960,95,636623,79.96771762341415,6
0.2,7961,95,636718,79.96960562672696,6
0.2,7962,25,636743,79.96270249905814,7
0.2,7963,92,636835,79.96421396283274,9
0.2,7964,90,636925,79.9654739485248,11
0.2,7965,94,637019,79.96723575194576,7
0.2,7966,94,637113,79.9689971130915,7
0.2,7967,93,637206,79.97063253012048,9
0.2,7968,95,637301,79.97251850922324,6
0.2,7969,81,637382,79.97264742785445,24
0.2,7970,90,637472,79.97390540710074,12
0.2,7971,93,637565,79.9755393878575,9
0.2,7972,95,637660,79.97742380534304,6
0.2,7973,24,637684,79.97040381239027,8
0.2,7974,26,637710,79.96363636363637,6
0.2,7975,93,637803,79.96527081243731,8
0.2,7976,91,637894,79.96665413062554,10
0.2,7977,-45,637849,79.95099022311356,9
0.2,7978,83,637932,79.95137235242511,18
0.2,7979,95,638027,79.9532581453634,8
0.2,7980,94,638121,79.95501816814935,7
0.2,7981,95,638216,79.9569030318216,6
0.2,7982,94,638310,79.95866215708381,8
0.2,7983,91,638401,79.96004509018036,10
0.2,7984,92,638493,79.96155291170946,9
0.2,7985,82,638575,79.9618081642875,19
0.2,7986,92,638667,79.9633153875047,9
0.2,7987,94,638761,79.96507260891337,7
0.2,7988,90,638851,79.9663287019652,11
0.2,7989,95,638946,79.96821026282853,6
0.2,7990,95,639041,79.97009135277187,8
0.2,7991,87,639128,79.97097097097097,16
0.2,7992,78,639206,79.97072438383586,24
0.2,7993,95,639301,79.97260445334001,6
0.2,7994,95,639396,79.97448405253283,7
0.2,7995,93,639489,79.97611305652826,8
0.2,7996,94,639583,79.9778667000125,9
0.2,7997,94,639677,79.97961990497625,7
0.2,7998,90,639767,79.98087260907613,11
0.2,7999,94,639861,79.982625,7
0.2,8000,92,639953,79.98412698412699,9
0.2,8001,93,640046,79.9857535616096,8
0.2,8002,93,640139,79.98737973260027,8
0.2,8003,94,640233,79.98913043478261,7
0.2,8004,24,640257,79.98213616489694,8
0.2,8005,91,640348,79.9835123657257,12
0.2,8006,94,640442,79.98526289496691,7
0.2,8007,84,640526,79.98576423576424,17
0.2,8008,91,640617,79.98713946809839,10
0.2,8009,95,640712,79.98901373283395,8
0.2,8010,88,640800,79.99001373111972,14
0.2,8011,96,640896,79.99201198202697,6
0.2,8012,-46,640850,79.9762885311369,9
0.2,8013,95,640945,79.97816321437485,6
0.2,8014,94,641039,79.97991266375546,7
0.2,8015,94,641133,79.98166167664671,7
0.2,8016,96,641229,79.98365972308844,7
0.2,8017,84,641313,79.98416063856324,19
0.2,8018,95,641408,79.98603317121835,6
0.2,8019,25,641433,79.97917705735661,7
0.2,8020,18,641451,79.97144994389727,14
0.2,8021,93,641544,79.97307404637247,8
0.2,8022,22,641566,79.96584818646392,10
0.2,8023,96,641662,79.96784646061815,6
0.2,8024,93,641755,79.96947040498442,8
0.2,8025,94,641849,79.97121853974582,7
0.2,8026,95,641944,79.9730908184876,7
0.2,8027,91,642035,79.9744643746886,10
0.2,8028,92,642127,79.97596213725247,11
0.2,8029,93,642220,79.97758405977584,8
0.2,8030,96,642316,79.97957913086789,6
0.2,8031,96,642412,79.98157370517929,6
0.2,8032,96,642508,79.98356778289556,6
0.2,8033,94,642602,79.98531242220562,8
0.2,8034,93,642695,79.9869321717486,8
0.2,8035,94,642789,79.98867595818815,7
0.2,8036,94,642883,79.99041931068807,7
0.2,8037,94,642977,79.9921622294103,7
0.2,8038,92,643069,79.99365592735415,9
0.2,8039,86,643155,79.99440298507463,15
0.2,8040,93,643248,79.9960203954732,8
0.2,8041,91,643339,79.9973887092763,11
0.2,8042,92,643431,79.99888101454681,9
0.2,8043,25,643456,79.99204375932372,8
0.2,8044,24,643480,79.98508390304536,8
0.2,8045,23,643503,79.97800149142431,11
0.2,8046,93,643596,79.97961973406238,8
0.2,8047,87,643683,79.98049204771372,14
0.2,8048,19,643702,79.97291589017269,13
0.2,8049,93,643795,79.97453416149068,8
0.2,8050,18,643813,79.96683641783629,14
0.2,8051,95,643908,79.96870342771982,7
0.2,8052,24,643932,79.96175338383212,10
0.2,8053,93,644025,79.96337223739756,8
0.2,8054,96,644121,79.96536312849162,6
0.2,8055,88,644209,79.96636047666335,13
0.2,8056,91,644300,79.96772992428944,10
0.2,8057,91,644391,79.96909903201787,10
0.2,8058,91,644482,79.97046779997518,11
0.2,8059,95,644577,79.97233250620347,6
0.2,8060,93,644670,79.97394864160773,9
0.2,8061,-54,644616,79.9573306871744,18
0.2,8062,25,644641,79.950514696763,8
0.2,8063,89,644730,79.9516369047619,12
0.2,8064,93,644823,79.95325480471172,8
0.2,8065,96,644919,79.95524423506075,6
0.2,8066,95,645014,79.95710921036321,6
0.2,8067,86,645100,79.95785820525533,16
0.2,8068,94,645194,79.95959846325444,8
0.2,8069,86,645280,79.96034696406444,15
0.2,8070,24,645304,79.95341345558171,8
0.2,8071,92,645396,79.95490584737364,10
0.2,8072,87,645483,79.9557785209959,15
0.2,8073,91,645574,79.95714639583849,10
0.2,8074,93,645667,79.95876160990711,10
0.2,8075,90,645757,79.960004952947,11
0.2,8076,92,645849,79.96149560480376,10
0.2,8077,93,645942,79.96310968061401,8
0.2,8078,93,646035,79.9647233568511,9
0.2,8079,88,646123,79.96571782178218,13
0.2,8080,92,646215,79.96720702883306,10
0.2,8081,93,646308,79.96881959910912,8
0.2,8082,86,646394,79.96956575528888,15
0.2,8083,21,646415,79.9622711528946,13
0.2,8084,93,646508,79.96388373531231,9
0.2,8085,94,646602,79.9656195894138,7
0.2,8086,94,646696,79.96735501422036,7
0.2,8087,89,646785,79.96847181008901,12
0.2,8088,92,646877,79.96995920385709,11
0.2,8089,87,646964,79.9708281829419,14
0.2,8090,91,647055,79.972191323693,10
0.2,8091,27,647082,79.96564508156203,6
0.2,8092,94,647176,79.96737921660694,7
0.2,8093,22,647198,79.960217445021,10
0.2,8094,86,647284,79.9609635577517,15
0.2,8095,96,647380,79.96294466403162,6
0.2,8096,92,647472,79.96443127084105,10
0.2,8097,94,647566,79.96616448505804,7
0.2,8098,94,647660,79.96789727126806,9
0.2,8099,94,647754,79.96962962962964,7
0.2,8100,95,647849,79.97148500185162,6
0.2,8101,90,647939,79.97272278449765,11
0.2,8102,93,648032,79.97433049487844,8
0.2,8103,94,648126,79.97606120434354,7
0.2,8104,93,648219,79.97766810610734,9
0.2,8105,89,648308,79.97878114976561,12
0.2,8106,91,648399,79.98014061921796,10
0.2,8107,92,648491,79.98162308830784,10
0.2,8108,89,648580,79.98273523245776,13
0.2,8109,92,648672,79.98421701602959,9
0.2,8110,95,648767,79.98606830230551,6
0.2,8111,25,648792,79.97928994082841,7
0.2,8112,-51,648741,79.96314556884013,15
0.2,8113,91,648832,79.96450579245749,10
0.2,8114,83,648915,79.96487985212569,18
0.2,8115,23,648938,79.95786101527847,9
0.2,8116,-48,648890,79.94209683380559,11
0.2,8117,92,648982,79.94358216309436,10
0.2,8118,96,649078,79.94555979800468,6
0.2,8119,26,649104,79.93891625615764,7
0.2,8120,94,649198,79.9406477034848,7
0.2,8121,94,649292,79.94237872445211,7
0.2,8122,94,649386,79.94410931921703,8
0.2,8123,96,649482,79.94608567208272,6
0.2,8124,92,649574,79.94756923076923,9
0.2,8125,90,649664,79.94880630076298,11
0.2,8126,94,649758,79.95053525286083,8
0.2,8127,91,649849,79.95189468503936,10
0.2,8128,91,649940,79.95325378275311,12
0.2,8129,26,649966,79.94661746617466,7
0.2,8130,89,650055,79.94773090640757,12
0.2,8131,25,650080,79.94097393015248,7
0.2,8132,21,650101,79.93372679208164,11
0.2,8133,92,650193,79.93521022866977,9
0.2,8134,94,650287,79.93693915181315,7
0.2,8135,87,650374,79.93780727630285,14
0.2,8136,94,650468,79.93953545532752,7
0.2,8137,92,650560,79.94101744900468,10
0.2,8138,91,650651,79.94237621329401,11
0.2,8139,96,650747,79.94434889434889,6
0.2,8140,90,650837,79.94558408057978,11
0.2,8141,23,650860,79.93859002702038,10
0.2,8142,95,650955,79.9404396414098,7
0.2,8143,93,651048,79.94204322200393,8
0.2,8144,95,651143,79.9438919582566,7
0.2,8145,78,651221,79.94365332678615,23
0.2,8146,92,651313,79.94513317785687,9
0.2,8147,93,651406,79.94673539518901,8
0.2,8148,91,651497,79.94809179040374,10
0.2,8149,91,651588,79.94944785276074,11
0.2,8150,95,651683,79.95129431971537,7
0.2,8151,91,651774,79.952649656526,10
0.2,8152,96,651870,79.95461793204956,6
0.2,8153,-54,651816,79.93818984547461,19
0.2,8154,96,651912,79.94015941140405,6
0.2,8155,89,652001,79.94127023050515,13
0.2,8156,92,652093,79.94274855951943,10
0.2,8157,94,652187,79.94447168423633,7
0.2,8158,96,652283,79.9464395146464,6
0.2,8159,89,652372,79.94754901960785,12
0.2,8160,93,652465,79.94914838867786,11
0.2,8161,93,652558,79.9507473658417,8
0.2,8162,95,652653,79.95259095920618,6
0.2,8163,94,652747,79.95431161195492,7
0.2,8164,94,652841,79.95603184323332,7
0.2,8165,23,652864,79.94905706588293,9
0.2,8166,25,652889,79.94232888453533,7
0.2,8167,93,652982,79.94392752203721,8
0.2,8168,23,653005,79.93695678785653,11
0.2,8169,94,653099,79.93867809057528,8
0.2,8170,94,653193,79.94039897197405,7
0.2,8171,93,653286,79.94199706314244,8
0.2,8172,94,653380,79.94371711733757,8
0.2,8173,87,653467,79.9445803768045,15
0.2,8174,94,653561,79.9462996941896,7
0.2,8175,95,653656,79.9481409001957,8
0.2,8176,13,653669,79.93995352818882,20
0.2,8177,95,653764,79.94179505991686,6
0.2,8178,94,653858,79.94351387700208,7
0.2,8179,91,653949,79.94486552567237,12
0.2,8180,96,654045,79.94682801613494,6
0.2,8181,21,654066,79.9396235639208,11
0.2,8182,94,654160,79.94134180618354,8
0.2,8183,94,654254,79.9430596285435,7
0.2,8184,-49,654205,79.92730604764813,13
0.2,8185,94,654299,79.92902516491571,7
0.2,8186,93,654392,79.93062171735679,8
0.2,8187,22,654414,79.92354665363948,11
0.2,8188,95,654509,79.92538771522774,6
0.2,8189,19,654528,79.91794871794872,16
0.2,8190,87,654615,79.91881333170554,14
0.2,8191,94,654709,79.9205322265625,7
0.2,8192,93,654802,79.92212864640547,8
0.2,8193,94,654896,79.92384671711008,8
0.2,8194,96,654992,79.92580841976815,6
0.2,8195,92,655084,79.92728160078087,9
0.2,8196,92,655176,79.92875442234964,9
0.2,8197,19,655195,79.9213222737253,13
0.2,8198,92,655287,79.92279546286133,9
0.2,8199,90,655377,79.9240243902439,13
0.2,8200,92,655469,79.9254968906231,9
0.2,8201,92,655561,79.92696903194343,9
0.2,8202,88,655649,79.9279531878581,14
0.2,8203,95,655744,79.9297903461726,7
0.2,8204,95,655839,79.93162705667277,6
0.2,8205,95,655934,79.9334633195223,7
0.2,8206,90,656024,79.93468989886682,11
0.2,8207,92,656116,79.93615984405459,10
0.2,8208,95,656211,79.93799488366427,6
0.2,8209,24,656235,79.9311814859927,9
0.2,8210,90,656325,79.93240774570698,11
0.2,8211,94,656419,79.93412079883097,8
0.2,8212,27,656446,79.92767563618654,6
0.2,8213,94,656540,79.92938884830777,7
0.2,8214,94,656634,79.93110164333537,8
0.2,8215,94,656728,79.93281402142162,7
0.2,8216,92,656820,79.934282584885,11
0.2,8217,95,656915,79.93611584327087,7
0.2,8218,89,657004,79.9372186397372,13
0.2,8219,94,657098,79.93892944038929,7
0.2,8220,93,657191,79.94051818513563,9
0.2,8221,93,657284,79.9421065434201,8
0.2,8222,89,657373,79.94320807491184,15
0.2,8223,94,657467,79.9449173151751,7
0.2,8224,94,657561,79.94662613981762,7
0.2,8225,90,657651,79.94784828592269,14
0.2,8226,92,657743,79.94931323690288,9
0.2,8227,92,657835,79.95077783179387,9
0.2,8228,92,657927,79.95224207072549,10
0.2,8229,95,658022,79.95407047387606,6
0.2,8230,94,658116,79.95577694083343,7
0.2,8231,88,658204,79.95675413022352,13
0.2,8232,92,658296,79.9582169318596,10
0.2,8233,93,658389,79.95980082584406,8
0.2,8234,88,658477,79.96077717061324,13
0.2,8235,94,658571,79.96248178727538,8
0.2,8236,89,658660,79.96357897292704,13
0.2,8237,93,658753,79.96516144695315,8
0.2,8238,24,658777,79.95836873406967,8
0.2,8239,90,658867,79.95958737864078,12
0.2,8240,92,658959,79.96104841645432,10
0.2,8241,94,659053,79.96275175928173,7
0.2,8242,96,659149,79.96469731893728,6
0.2,8243,94,659243,79.96639980591945,7
0.2,8244,88,659331,79.9673741661613,13
0.2,8245,21,659352,79.96022313849139,11
0.2,8246,91,659443,79.96156178004122,10
0.2,8247,18,659461,79.95404946653734,14
0.2,8248,22,659483,79.94702388168263,11
0.2,8249,95,659578,79.94884848484848,6
0.2,8250,93,659671,79.95043025087868,8
0.2,8251,-124,659547,79.9257149781871,19
0.2,8252,92,659639,79.92717799588029,9
0.2,8253,93,659732,79.92876181245457,8
0.2,8254,21,659753,79.92162325863113,11
0.2,8255,89,659842,79.92272286821705,13
0.2,8256,93,659935,79.92430664890396,8
0.2,8257,94,660029,79.92601114071203,7
0.2,8258,96,660125,79.92795737982807,6
0.2,8259,93,660218,79.92953995157384,8
0.2,8260,94,660312,79.93124319089699,7
0.2,8261,94,660406,79.93294601791334,7
0.2,8262,94,660500,79.9346484327726,9
0.2,8263,95,660595,79.93647144240077,7
0.2,8264,87,660682,79.93732607380521,15
0.2,8265,91,660773,79.93866440842004,10
0.2,8266,25,660798,79.93201887020685,7
0.2,8267,94,660892,79.93372036768262,9
0.2,8268,94,660986,79.93542145362196,7
0.2,8269,90,661076,79.936638452237,14
0.2,8270,86,661162,79.93737153911256,15
0.2,8271,93,661255,79.93895067698259,8
0.2,8272,94,661349,79.9406503082316,7
0.2,8273,92,661441,79.94210780759005,9
0.2,8274,89,661530,79.94320241691842,12
0.2,8275,89,661619,79.94429676172064,12
0.2,8276,94,661713,79.94599492569772,7
0.2,8277,92,661805,79.94745107513893,10
0.2,8278,93,661898,79.94902766034545,8
0.2,8279,81,661979,79.94915458937199,21
0.2,8280,92,662071,79.95060982973071,10
0.2,8281,88,662159,79.9515817435402,14
0.2,8282,94,662253,79.95327779789932,7
0.2,8283,92,662345,79.95473201352004,10
0.2,8284,-119,662226,79.93071816535908,13
0.2,8285,25,662251,79.9240888245233,7
0.2,8286,90,662341,79.9253046940992,11
0.2,8287,95,662436,79.92712355212355,6
0.2,8288,88,662524,79.92809747858608,13
0.2,8289,25,662549,79.92147165259348,7
0.2,8290,94,662643,79.9231697020866,7
0.2,8291,25,662668,79.91654606849976,8
0.2,8292,87,662755,79.91740021705053,15
0.2,8293,93,662848,79.91897757414999,8
0.2,8294,91,662939,79.92031344183243,11
0.2,8295,93,663032,79.92189006750242,8
0.2,8296,96,663128,79.92382788959866,6
0.2,8297,93,663221,79.92540371173777,8
0.2,8298,96,663317,79.92734064345102,6
0.2,8299,94,663411,79.92903614457832,8
0.2,8300,26,663437,79.92253945307795,6
0.2,8301,96,663533,79.92447602987232,6
0.2,8302,91,663624,79.9258099482115,11
0.2,8303,23,663647,79.91895472061657,9
0.2,8304,27,663674,79.91258278145695,6
0.2,8305,94,663768,79.91427883457742,9
0.2,8306,89,663857,79.91537257734441,12
0.2,8307,92,663949,79.91682715454984,9
0.2,8308,95,664044,79.91864243591287,7
0.2,8309,-48,663996,79.90324909747292,13
0.2,8310,24,664020,79.8965226807845,10
0.2,8311,-48,663972,79.88113570741098,12
0.2,8312,25,663997,79.8745338626248,7
0.2,8313,96,664093,79.87647341833053,6
0.2,8314,92,664185,79.87793144918821,9
0.2,8315,94,664279,79.87962962962963,7
0.2,8316,96,664375,79.88156787303114,6
0.2,8317,94,664469,79.88326520798269,7
0.2,8318,88,664557,79.88424089433826,14
0.2,8319,87,664644,79.88509615384615,14
0.2,8320,25,664669,79.8785001802668,8
0.2,8321,93,664762,79.88007690459024,8
0.2,8322,-49,664713,79.86459209419681,13
0.2,8323,94,664807,79.86629024507448,7
0.2,8324,96,664903,79.86822822822823,6
0.2,8325,90,664993,79.8694451116983,13
0.2,8326,89,665082,79.87054161162483,13
0.2,8327,90,665172,79.87175792507205,12
0.2,8328,93,665265,79.87333413374955,10
0.2,8329,95,665360,79.87515006002401,6
0.2,8330,93,665453,79.87672548313527,9
0.2,8331,92,665545,79.87818050888143,9
0.2,8332,94,665639,79.8798751950078,7
0.2,8333,93,665732,79.88144948404128,8
0.2,8334,89,665821,79.88254349130175,13
0.2,8335,94,665915,79.88423704414588,8
0.2,8336,92,666007,79.88569029626964,10
0.2,8337,89,666096,79.88678340129528,12
0.2,8338,89,666185,79.88787624415397,12
0.2,8339,91,666276,79.88920863309353,12
0.2,8340,92,666368,79.89066059225513,9
0.2,8341,96,666464,79.8925917046272,6
0.2,8342,93,666557,79.89416277118542,9
0.2,8343,92,666649,79.89561361457335,9
0.2,8344,22,666671,79.88867585380467,10
0.2,8345,22,666693,79.88173975557153,10
0.2,8346,93,666786,79.88331136935426,8
0.2,8347,12,666798,79.87517968375658,20
0.2,8348,91,666889,79.87651215714457,10
0.2,8349,94,666983,79.87820359281437,7
0.2,8350,96,667079,79.88013411567476,6
0.2,8351,92,667171,79.88158524904215,10
0.2,8352,94,667265,79.88327546989106,7
0.2,8353,93,667358,79.88484558295427,8
0.2,8354,16,667374,79.87719928186715,19
0.2,8355,92,667466,79.87865007180469,11
0.2,8356,94,667560,79.88033983486898,7
0.2,8357,91,667651,79.88167025604211,10
0.2,8358,94,667745,79.88335925349922,7
0.2,8359,14,667759,79.87547846889952,19
0.2,8360,91,667850,79.87680899413945,10
0.2,8361,92,667942,79.87825878976321,12
0.2,8362,94,668036,79.87994738730121,8
0.2,8363,91,668127,79.8812769010043,10
0.2,8364,94,668221,79.88296473401076,8
0.2,8365,89,668310,79.88405450633516,12
0.2,8366,94,668404,79.88574160392017,7
0.2,8367,92,668496,79.88718929254303,9
0.2,8368,94,668590,79.88887561237902,7
0.2,8369,94,668684,79.89056152927121,7
0.2,8370,94,668778,79.892247043364,7
0.2,8371,91,668869,79.89357381748687,11
0.2,8372,94,668963,79.89525856921055,8
0.2,8373,23,668986,79.88846429424409,10
0.2,8374,95,669081,79.89026865671642,6
0.2,8375,93,669174,79.89183381088826,8
0.2,8376,95,669269,79.89363734033664,6
0.2,8377,93,669362,79.8952017187873,8
0.2,8378,93,669455,79.8967657238334,8
0.2,8379,94,669549,79.89844868735084,7
0.2,8380,87,669636,79.89929602672711,14
0.2,8381,91,669727,79.90062037699833,10
0.2,8382,95,669822,79.90242156745795,7
0.2,8383,94,669916,79.90410305343511,9
0.2,8384,24,669940,79.8974358974359,8
0.2,8385,94,670034,79.89911757691391,7
0.2,8386,91,670125,79.90044115893645,10
0.2,8387,95,670220,79.90224129709108,7
0.2,8388,91,670311,79.90356419120276,10
0.2,8389,94,670405,79.9052443384982,8
0.2,8390,91,670496,79.90656655940889,10
0.2,8391,93,670589,79.90812678741659,8
0.2,8392,96,670685,79.91004408435602,7
0.2,8393,94,670779,79.91172265904217,7
0.2,8394,95,670874,79.91351995235259,6
0.2,8395,23,670897,79.90674130538352,10
0.2,8396,94,670991,79.90841967369299,7
0.2,8397,92,671083,79.90985949035485,9
0.2,8398,96,671179,79.91177521133469,6
0.2,8399,27,671206,79.9054761904762,6
0.2,8400,94,671300,79.90715391024878,8
0.2,8401,92,671392,79.90859319209711,9
0.2,8402,90,671482,79.90979412114721,11
0.2,8403,93,671575,79.91135173726796,8
0.2,8404,94,671669,79.91302795954789,8
0.2,8405,92,671761,79.91446585772067,9
0.2,8406,91,671852,79.91578446532651,10
0.2,8407,18,671870,79.90842055185537,14
0.2,8408,90,671960,79.9096206445475,12
0.2,8409,93,672053,79.91117717003567,8
0.2,8410,90,672143,79.91237664962549,12
0.2,8411,92,672235,79.91381359961959,9
0.2,8412,90,672325,79.91501248068465,12
0.2,8413,95,672420,79.91680532445923,7
0.2,8414,88,672508,79.91776589423648,14
0.2,8415,93,672601,79.91932034220532,8
0.2,8416,94,672695,79.92099322799098,7
0.2,8417,95,672790,79.92278450938466,6
0.2,8418,95,672885,79.92457536524527,6
0.2,8419,93,672978,79.92612826603326,10
0.2,8420,94,673072,79.92779954874717,7
0.2,8421,91,673163,79.92911422464972,10
0.2,8422,92,673255,79.93054731093434,9
0.2,8423,93,673348,79.9320987654321,8
0.2,8424,93,673441,79.93364985163204,10
0.2,8425,91,673532,79.93496320911464,10
0.2,8426,96,673628,79.93686958585499,6
0.2,8427,26,673654,79.93046986236355,6
0.2,8428,95,673749,79.93225768181279,6
0.2,8429,94,673843,79.93392645314354,7
0.2,8430,89,673932,79.93500177914838,14
0.2,8431,-115,673817,79.91188330170777,10
0.2,8432,91,673908,79.91319815012451,11
0.2,8433,92,674000,79.91463125444629,10
0.2,8434,91,674091,79.91594546532306,10
0.2,8435,95,674186,79.91773352299668,6
0.2,8436,90,674276,79.91892852909803,11
0.2,8437,22,674298,79.91206447025361,10
0.2,8438,93,674391,79.91361535726982,8
0.2,8439,95,674486,79.9154028436019,6
0.2,8440,-49,674437,79.90013031631324,13
0.2,8441,96,674533,79.90203743188817,6
0.2,8442,94,674627,79.90370721307592,7
0.2,8443,95,674722,79.905495026054,6
0.2,8444,93,674815,79.90704558910598,9
0.2,8445,94,674909,79.90871418422923,7
0.2,8446,85,674994,79.90931691724873,16
0.2,8447,86,675080,79.91003787878788,16
0.2,8448,92,675172,79.91146881287726,9
0.2,8449,95,675267,79.91325443786982,7
0.2,8450,96,675363,79.91515796947107,6
0.2,8451,92,675455,79.91658778987222,9
0.2,8452,24,675479,79.90997279072519,9
0.2,8453,93,675572,79.91152117340904,8
0.2,8454,96,675668,79.91342400946186,6
0.2,8455,95,675763,79.91520813623463,6
0.2,8456,23,675786,79.9084781837531,9
0.2,8457,90,675876,79.90967131709624,11
0.2,8458,93,675969,79.91121882019151,8
0.2,8459,87,676056,79.91205673758866,14
0.2,8460,90,676146,79.91324902493795,11
0.2,8461,92,676238,79.91467738123374,10
0.2,8462,92,676330,79.91610539997637,9
0.2,8463,89,676419,79.9171786389414,14
0.2,8464,95,676514,79.91896042528057,6
0.2,8465,96,676610,79.92085991022915,6
0.2,8466,88,676698,79.92181410180702,13
0.2,8467,95,676793,79.92359470949457,6
0.2,8468,87,676880,79.92443027512103,14
0.2,8469,23,676903,79.91770956316411,11
0.2,8470,86,676989,79.91842757643725,15
0.2,8471,94,677083,79.920089707271,7
0.2,8472,95,677178,79.921869467721,8
0.2,8473,22,677200,79.91503422232712,10
0.2,8474,-47,677153,79.90005899705015,10
0.2,8475,25,677178,79.89358187824446,8
0.2,8476,20,677198,79.8865164562935,12
0.2,8477,27,677225,79.88027836753952,6
0.2,8478,94,677319,79.88194362542752,8
0.2,8479,91,677410,79.88325471698113,12
0.2,8480,-47,677363,79.86829383327438,10
0.2,8481,92,677455,79.86972412166942,10
0.2,8482,24,677479,79.86313804078746,10
0.2,8483,93,677572,79.86468646864687,8
0.2,8484,93,677665,79.86623453152622,9
0.2,8485,89,677754,79.86731086495404,12
0.2,8486,90,677844,79.86850477200424,11
0.2,8487,96,677940,79.87040527803958,6
0.2,8488,93,678033,79.87195193780187,8
0.2,8489,93,678126,79.87349823321554,9
0.2,8490,94,678220,79.8751619361677,7
0.2,8491,20,678240,79.86811116344795,12
0.2,8492,87,678327,79.8689509007418,16
0.2,8493,94,678421,79.87061455144809,8
0.2,8494,92,678513,79.87204237786933,10
0.2,8495,18,678531,79.86475988700565,15
0.2,8496,96,678627,79.86665882076026,6
0.2,8497,90,678717,79.86785125911979,12
0.2,8498,89,678806,79.86892575597129,13
0.2,8499,93,678899,79.87047058823529,9
0.2,8500,94,678993,79.87213269027173,8
0.2,8501,93,679086,79.87367678193367,9
0.2,8502,94,679180,79.87533811595907,8
0.2,8503,91,679271,79.8766462841016,10
0.2,8504,94,679365,79.87830687830687,7
0.2,8505,93,679458,79.87984951798731,9
0.2,8506,90,679548,79.88103914423417,14
0.2,8507,94,679642,79.88269863657735,7
0.2,8508,95,679737,79.88447526148784,6
0.2,8509,96,679833,79.88636897767333,6
0.2,8510,95,679928,79.88814475384797,7
0.2,8511,22,679950,79.8813439849624,10
0.2,8512,22,679972,79.87454481381417,11
0.2,8513,96,680068,79.87643880667136,7
0.2,8514,92,680160,79.87786259541984,10
0.2,8515,24,680184,79.8713010803194,8
0.2,8516,94,680278,79.87295996242808,8
0.2,8517,91,680369,79.87426625968537,12
0.2,8518,92,680461,79.87568963493368,9
0.2,8519,90,680551,79.8768779342723,11
0.2,8520,89,680640,79.87794859758245,13
0.2,8521,90,680730,79.87913635296879,11
0.2,8522,91,680821,79.88044115921623,10
0.2,8523,93,680914,79.88198029094322,8
0.2,8524,93,681007,79.88351906158358,8
0.2,8525,95,681102,79.88529204785362,8
0.2,8526,-49,681053,79.87017708455494,13
0.2,8527,95,681148,79.8719512195122,6
0.2,8528,93,681241,79.87349044436628,9
0.2,8529,93,681334,79.87502930832356,9
0.2,8530,23,681357,79.86836244285547,9
0.2,8531,85,681442,79.86896390060947,16
0.2,8532,92,681534,79.87038556193602,9
0.2,8533,91,681625,79.87168971174127,10
0.2,8534,95,681720,79.87346221441125,6
0.2,8535,91,681811,79.8747656982193,10
0.2,8536,93,681904,79.87630315098981,8
0.2,8537,94,681998,79.87795736706488,7
0.2,8538,92,682090,79.87937697622672,9
0.2,8539,20,682110,79.87236533957845,12
0.2,8540,93,682203,79.87390235335441,8
0.2,8541,89,682292,79.87497073284945,12
0.2,8542,91,682383,79.87627297202388,10
0.2,8543,93,682476,79.87780898876404,8
0.2,8544,90,682566,79.87899356348741,11
0.2,8545,91,682657,79.88029487479523,10
0.2,8546,95,682752,79.88206388206389,6
0.2,8547,90,682842,79.88324754328498,11
0.2,8548,92,682934,79.88466487308457,9
0.2,8549,95,683029,79.88643274853801,6
0.2,8550,96,683125,79.8883171558882,6
0.2,8551,93,683218,79.8898503274088,8
0.2,8552,91,683309,79.89114930433766,11
0.2,8553,94,683403,79.89279869067103,7
0.2,8554,91,683494,79.89409701928696,11
0.2,8555,94,683588,79.89574567554932,7
0.2,8556,13,683601,79.8879280121538,22
0.2,8557,94,683695,79.88957700397289,7
0.2,8558,96,683791,79.89145928262647,6
0.2,8559,94,683885,79.89310747663552,7
0.2,8560,93,683978,79.89463847681345,8
0.2,8561,94,684072,79.89628591450595,8
0.2,8562,94,684166,79.89793296741796,7
0.2,8563,17,684183,79.89058851004204,17
0.2,8564,87,684270,79.89141856392294,15
0.2,8565,91,684361,79.8927153864114,10
0.2,8566,95,684456,79.89447881405393,7
0.2,8567,89,684545,79.89554154995332,12
0.2,8568,18,684563,79.88831835686779,14
0.2,8569,94,684657,79.8899649941657,7
0.2,8570,94,684751,79.89161124722902,7
0.2,8571,12,684763,79.88369108726084,22
0.2,8572,89,684852,79.88475446168202,12
0.2,8573,95,684947,79.88651737811989,6
0.2,8574,94,685041,79.88816326530612,7
0.2,8575,91,685132,79.88945895522389,10
0.2,8576,94,685226,79.89110411565815,7
0.2,8577,84,685310,79.8915831196083,18
0.2,8578,88,685398,79.89252826669775,14
0.2,8579,-48,685350,79.87762237762237,11
0.2,8580,26,685376,79.87134366623937,7
0.2,8581,92,685468,79.87275693311582,9
0.2,8582,94,685562,79.8744028894326,7
0.2,8583,96,685658,79.87628145386766,6
0.2,8584,94,685752,79.87792661619103,7
0.2,8585,90,685842,79.87910552061496,11
0.2,8586,93,685935,79.88063351577966,8
0.2,8587,23,685958,79.87401024685607,9
0.2,8588,87,686045,79.87483991151473,14
0.2,8589,93,686138,79.87636786961583,10
0.2,8590,24,686162,79.86986381096496,9
0.2,8591,96,686258,79.87174115456239,6
0.2,8592,93,686351,79.87326893983474,8
0.2,8593,95,686446,79.87502909006284,7
0.2,8594,95,686541,79.87678883071553,8
0.2,8595,95,686636,79.87854816193578,8
0.2,8596,96,686732,79.88042340351285,6
0.2,8597,92,686824,79.88183298441498,9
0.2,8598,95,686919,79.88359111524596,7
0.2,8599,94,687013,79.88523255813953,7
0.2,8600,94,687107,79.88687361934659,8
0.2,8601,27,687134,79.88072541269472,6
0.2,8602,94,687228,79.88236661629664,7
0.2,8603,92,687320,79.8837749883775,9
0.2,8604,93,687413,79.88529924462522,8
0.2,8605,95,687508,79.88705554264466,6
0.2,8606,94,687602,79.8886952480539,7
0.2,8607,90,687692,79.88986988847584,11
0.2,8608,94,687786,79.89150888604948,8
0.2,8609,90,687876,79.89268292682927,12
0.2,8610,89,687965,79.89374056439438,12
0.2,8611,94,688059,79.8953785415699,7
0.2,8612,92,688151,79.8967839312667,9
0.2,8613,96,688247,79.89865335500349,6
0.2,8614,88,688335,79.89959373186304,15
0.2,8615,25,688360,79.89322191272052,7
0.2,8616,94,688454,79.89485899965185,8
0.2,8617,89,688543,79.895915525644,12
0.2,8618,93,688636,79.8974358974359,8
0.2,8619,92,688728,79.89883990719258,9
0.2,8620,93,688821,79.90035958705487,8
0.2,8621,89,688910,79.9014149849223,14
0.2,8622,93,689003,79.90293401368433,8
0.2,8623,24,689027,79.89645176252318,8
0.2,8624,89,689116,79.89750724637682,12
0.2,8625,89,689205,79.89856248550893,12
0.2,8626,91,689296,79.89984931030486,10
0.2,8627,92,689388,79.90125173852573,9
0.2,8628,89,689477,79.90230617684553,14
0.2,8629,92,689569,79.90370799536501,10
0.2,8630,92,689661,79.9051094890511,9
0.2,8631,94,689755,79.90674235403151,8
0.2,8632,94,689849,79.90837484072745,7
0.2,8633,90,689939,79.90954366458189,11
0.2,8634,92,690031,79.91094383323683,9
0.2,8635,94,690125,79.912575266327,8
0.2,8636,93,690218,79.914090540697,8
0.2,8637,27,690245,79.9079648066682,6
0.2,8638,90,690335,79.9091330015048,11
0.2,8639,92,690427,79.9105324074074,9
0.2,8640,94,690521,79.9121629441037,7
0.2,8641,96,690617,79.91402453135848,6
0.2,8642,87,690704,79.91484438273747,16
0.2,8643,91,690795,79.91612679315132,10
0.2,8644,94,690889,79.91775592828225,7
0.2,8645,91,690980,79.91903770529724,11
0.2,8646,23,691003,79.91245518676998,9
0.2,8647,93,691096,79.91396854764108,9
0.2,8648,93,691189,79.91548155856168,8
0.2,8649,96,691285,79.91734104046243,6
0.2,8650,79,691364,79.9172350017339,22
0.2,8651,94,691458,79.91886269070736,7
0.2,8652,87,691545,79.91968103547903,14
0.2,8653,90,691635,79.92084585162931,11
0.2,8654,21,691656,79.91403812824957,11
0.2,8655,95,691751,79.91578096118299,6
0.2,8656,96,691847,79.91763890493243,6
0.2,8657,94,691941,79.91926541926541,7
0.2,8658,91,692032,79.92054509758633,11
0.2,8659,24,692056,79.91408775981525,8
0.2,8660,89,692145,79.91513682022861,15
0.2,8661,93,692238,79.91664742553682,8
0.2,8662,96,692334,79.91850398245411,6
0.2,8663,92,692426,79.91989843028624,9
0.2,8664,95,692521,79.92163877668783,8
0.2,8665,94,692615,79.9232633279483,7
0.2,8666,94,692709,79.92488750432676,7
0.2,8667,91,692800,79.92616520535302,10
0.2,8668,95,692895,79.9279040258392,6
0.2,8669,91,692986,79.92918108419839,10
0.2,8670,22,693008,79.92250028831738,12
0.2,8671,92,693100,79.9238929889299,9
0.2,8672,15,693115,79.91640724086244,18
0.2,8673,17,693132,79.90915379294444,16
0.2,8674,90,693222,79.91031700288184,11
0.2,8675,-192,693030,79.87897648686031,17
0.2,8676,93,693123,79.88048864815028,8
0.2,8677,94,693217,79.88211569486057,7
0.2,8678,23,693240,79.87556170065676,11
0.2,8679,95,693335,79.87730414746544,6
0.2,8680,92,693427,79.87870061052874,9
0.2,8681,94,693521,79.8803271135683,7
0.2,8682,93,693614,79.88183807439825,8
0.2,8683,92,693706,79.88323353293413,9
0.2,8684,21,693727,79.87645365572827,12
0.2,8685,95,693822,79.87819479622381,6
0.2,8686,93,693915,79.87970530678025,8
0.2,8687,90,694005,79.88087016574586,11
0.2,8688,94,694099,79.8824951087582,8
0.2,8689,92,694191,79.88388952819332,9
0.2,8690,96,694287,79.88574387297204,6
0.2,8691,90,694377,79.88690750115049,11
0.2,8692,93,694470,79.8884159668699,9
0.2,8693,94,694564,79.89003910743041,7
0.2,8694,94,694658,79.8916618746406,7
0.2,8695,94,694752,79.89328426862926,7
0.2,8696,26,694778,79.88708750143728,6
0.2,8697,94,694872,79.88871004828697,7
0.2,8698,93,694965,79.89021726635245,8
0.2,8699,94,695059,79.89183908045977,7
0.2,8700,18,695077,79.88472589357545,14
0.2,8701,22,695099,79.87807400597563,11
0.2,8702,94,695193,79.87969665632541,8
0.2,8703,90,695283,79.880859375,11
0.2,8704,93,695376,79.88236645605974,8
0.2,8705,90,695466,79.88352860096485,11
0.2,8706,91,695557,79.88480532904559,11
0.2,8707,94,695651,79.88642627468994,9
0.2,8708,94,695745,79.88804684808818,7
0.2,8709,91,695836,79.88932261768083,10
0.2,8710,93,695929,79.89082768912868,8
0.2,8711,25,695954,79.88452708907255,7
0.2,8712,93,696047,79.88603236543096,8
0.2,8713,93,696140,79.8875372963048,9
0.2,8714,87,696227,79.88835341365461,14
0.2,8715,91,696318,79.88962826984856,10
0.2,8716,94,696412,79.89124698864288,7
0.2,8717,87,696499,79.89206239963295,15
0.2,8718,94,696593,79.89368046794357,7
0.2,8719,93,696686,79.89518348623854,9
0.2,8720,94,696780,79.8968008255934,8
0.2,8721,92,696872,79.8981884888787,9
0.2,8722,26,696898,79.89200962971455,6
0.2,8723,95,696993,79.89374140302614,6
0.2,8724,90,697083,79.89489971346705,12
0.2,8725,93,697176,79.89640155856063,8
0.2,8726,93,697269,79.89790305947061,8
0.2,8727,95,697364,79.89963336388634,6
0.2,8728,91,697455,79.90090502921296,11
0.2,8729,92,697547,79.90229095074456,9
0.2,8730,90,697637,79.90344748596954,11
0.2,8731,94,697731,79.90506184150252,7
0.2,8732,82,697813,79.90530172907363,19
0.2,8733,-53,697760,79.89008472635676,18
0.2,8734,92,697852,79.89147109330281,9
0.2,8735,91,697943,79.89274267399267,10
0.2,8736,-46,697897,79.87833352409294,9
0.2,8737,93,697990,79.87983520256351,8
0.2,8738,88,698078,79.88076438951825,13
0.2,8739,94,698172,79.88237986270023,8
0.2,8740,92,698264,79.88376615947833,9
0.2,8741,94,698358,79.88538091969801,7
0.2,8742,21,698379,79.87864577376186,12
0.2,8743,90,698469,79.8798032936871,11
0.2,8744,90,698559,79.88096054888507,12
0.2,8745,95,698654,79.882689229362,6
0.2,8746,93,698747,79.88418886475363,8
0.2,8747,87,698834,79.88500228623685,14
0.2,8748,93,698927,79.88650131443593,8
0.2,8749,96,699023,79.88834285714286,6
0.2,8750,26,699049,79.88218489315507,6
0.2,8751,95,699144,79.88391224862889,6
0.2,8752,92,699236,79.88529646978179,10
0.2,8753,92,699328,79.88668037468585,9
0.2,8754,94,699422,79.88829240434038,7
0.2,8755,89,699511,79.88933302878027,12
0.2,8756,90,699601,79.89048760991207,11
0.2,8757,94,699695,79.89209865266042,7
0.2,8758,96,699791,79.8939376641169,6
0.2,8759,17,699808,79.88675799086758,15
0.2,8760,93,699901,79.88825476543774,9
0.2,8761,94,699995,79.8898653275508,8
0.2,8762,92,700087,79.89124728974096,9
0.2,8763,83,700170,79.89160200821543,18
0.2,8764,94,700264,79.89321163719339,7
0.2,8765,26,700290,79.8870636550308,6
0.2,8766,21,700311,79.88034675487624,11
0.2,8767,88,700399,79.88127281021897,13
0.2,8768,91,700490,79.88254076861672,11
0.2,8769,89,700579,79.88358038768529,13
0.2,8770,94,700673,79.88518983012199,7
0.2,8771,91,700764,79.88645690834473,10
0.2,8772,93,700857,79.88795166989627,8
0.2,8773,95,700952,79.88967403692729,6
0.2,8774,88,701040,79.89059829059829,13
0.2,8775,87,701127,79.89140838650866,14
0.2,8776,94,701221,79.8930158368463,7
0.2,8777,93,701314,79.89450899977216,8
0.2,8778,96,701410,79.89634354710104,6
0.2,8779,92,701502,79.89772209567198,9
0.2,8780,90,701592,79.898872565767,11
0.2,8781,90,701682,79.90002277385561,11
0.2,8782,94,701776,79.90162814528065,7
0.2,8783,94,701870,79.90323315118397,7
0.2,8784,91,701961,79.90449630051224,11
0.2,8785,91,702052,79.90575916230367,10
0.2,8786,91,702143,79.90702173665642,11
0.2,8787,91,702234,79.90828402366864,10
0.2,8788,92,702326,79.90965980202526,9
0.2,8789,91,702417,79.91092150170648,10
0.2,8790,96,702513,79.91275167785236,6
0.2,8791,91,702604,79.9140127388535,10
0.2,8792,92,702696,79.91538723984988,9
0.2,8793,26,702722,79.90925631112123,6
0.2,8794,87,702809,79.91006253553155,15
0.2,8795,86,702895,79.91075488858571,15
0.2,8796,23,702918,79.90428555189268,9
0.2,8797,92,703010,79.90566037735849,9
0.2,8798,94,703104,79.9072621888851,7
0.2,8799,93,703197,79.90875,9
0.2,8800,88,703285,79.90966935575503,14
0.2,8801,92,703377,79.91104294478528,9
0.2,8802,89,703466,79.91207542883107,13
0.2,8803,94,703560,79.91367560199909,7
0.2,8804,94,703654,79.9152754116979,8
0.2,8805,86,703740,79.91596638655462,15
0.2,8806,93,703833,79.91745202679687,8
0.2,8807,88,703921,79.91836966394187,14
0.2,8808,91,704012,79.91962765353615,10
0.2,8809,91,704103,79.92088535754824,10
0.2,8810,88,704191,79.92180229258881,13
0.2,8811,91,704282,79.92305946436677,10
0.2,8812,93,704375,79.92454328832406,8
0.2,8813,93,704468,79.9260267755843,8
0.2,8814,92,704560,79.92739648326716,9
0.2,8815,94,704654,79.92899274047187,7
0.2,8816,93,704747,79.93047521832823,9
0.2,8817,95,704842,79.93218416874575,6
0.2,8818,94,704936,79.93377934006124,8
0.2,8819,25,704961,79.92755102040816,7
0.2,8820,96,705057,79.9293730869516,7
0.2,8821,21,705078,79.92269326683292,11
0.2,8822,90,705168,79.9238354301258,11
0.2,8823,87,705255,79.92463735267452,14
0.2,8824,23,705278,79.91818696883853,10
0.2,8825,88,705366,79.91910265125765,14
0.2,8826,25,705391,79.9128809334995,7
0.2,8827,94,705485,79.91447666515631,7
0.2,8828,88,705573,79.91539245667686,13
0.2,8829,94,705667,79.91698754246886,8
0.2,8830,93,705760,79.91846902955497,9
0.2,8831,90,705850,79.91961050724638,11
0.2,8832,91,705941,79.92086493829956,11
0.2,8833,-54,705887,79.90570522979398,17
0.2,8834,87,705974,79.90650820599886,14
0.2,8835,91,706065,79.90776369397918,10
0.2,8836,92,706157,79.90913205839085,9
0.2,8837,96,706253,79.91095270423173,6
0.2,8838,95,706348,79.91265980314515,6
0.2,8839,89,706437,79.91368778280543,12
0.2,8840,94,706531,79.91528107680126,7
0.2,8841,94,706625,79.91687401040488,8
0.2,8842,96,706721,79.91869275132873,6
0.2,8843,23,706744,79.91225689733153,9
0.2,8844,88,706832,79.91317128321086,13
0.2,8845,96,706928,79.91498982591001,6
0.2,8846,94,707022,79.91658189216683,7
0.2,8847,91,707113,79.91783453887884,11
0.2,8848,24,707137,79.9115154254718,8
0.2,8849,20,707157,79.90474576271187,12
0.2,8850,96,707253,79.90656423003051,7
0.2,8851,96,707349,79.90838228648893,6
0.2,8852,93,707442,79.90986106404608,8
0.2,8853,93,707535,79.9113395075672,8
0.2,8854,96,707631,79.91315640880859,7
0.2,8855,95,707726,79.91485998193315,6
0.2,8856,26,707752,79.90877272214068,7
0.2,8857,96,707848,79.91058929780989,6
0.2,8858,94,707942,79.91217970425556,8
0.2,8859,-61,707881,79.89627539503385,24
0.2,8860,82,707963,79.89651280893804,19
0.2,8861,18,707981,79.88952832317761,16
0.2,8862,92,708073,79.89089473090375,10
0.2,8863,96,708169,79.89271209386281,6
0.2,8864,88,708257,79.89362662154541,13
0.2,8865,92,708349,79.89499210466953,9
0.2,8866,91,708440,79.89624450208639,10
0.2,8867,94,708534,79.89783491204331,7
0.2,8868,91,708625,79.89908670650581,10
0.2,8869,94,708719,79.90067643742954,7
0.2,8870,93,708812,79.9021530830797,8
0.2,8871,94,708906,79.90374211000902,8
0.2,8872,94,709000,79.90533077876705,7
0.2,8873,89,709089,79.90635564570655,13
0.2,8874,94,709183,79.90794366197183,9
0.2,8875,92,709275,79.90930599369085,10
0.2,8876,92,709367,79.91066801847471,10
0.2,8877,93,709460,79.91214237440865,9
0.2,8878,95,709555,79.91384164883434,7
0.2,8879,16,709571,79.90664414414414,17
0.2,8880,8,709579,79.89854746087153,25
0.2,8881,92,709671,79.8999099301959,10
0.2,8882,84,709755,79.90037149611618,17
0.2,8883,92,709847,79.90173345339937,9
0.2,8884,93,709940,79.90320765334835,8
0.2,8885,89,710029,79.90423137519694,12
0.2,8886,88,710117,79.90514234274784,15
0.2,8887,93,710210,79.90661566156615,8
0.2,8888,94,710304,79.90820114748566,7
0.2,8889,89,710393,79.90922384701912,12
0.2,8890,4,710397,79.90068608705432,30
0.2,8891,86,710483,79.90137201979307,15
0.2,8892,96,710579,79.90318227819634,7
0.2,8893,93,710672,79.9046548234765,8
0.2,8894,87,710759,79.90545250140528,15
0.2,8895,95,710854,79.90714928057554,6
0.2,8896,24,710878,79.90086546026751,8
0.2,8897,90,710968,79.90200044953922,11
0.2,8898,90,711058,79.90313518372851,11
0.2,8899,94,711152,79.90471910112359,7
0.2,8900,91,711243,79.90596562184024,10
0.2,8901,91,711334,79.9072118625028,10
0.2,8902,25,711359,79.90104459171066,7
0.2,8903,94,711453,79.902628032345,8
0.2,8904,94,711547,79.9042111173498,7
0.2,8905,93,711640,79.90568156299125,10
0.2,8906,89,711729,79.90670259346581,12
0.2,8907,90,711819,79.9078356533453,11
0.2,8908,94,711913,79.90941744303514,9
0.2,8909,89,712002,79.9104377104377,12
0.2,8910,94,712096,79.91201885310291,7
0.2,8911,92,712188,79.91337522441651,12
0.2,8912,94,712282,79.91495568271064,7
0.2,8913,91,712373,79.91619923715504,11
0.2,8914,96,712469,79.91800336511497,6
0.2,8915,21,712490,79.91139524450426,11
0.2,8916,90,712580,79.91252663451833,11
0.2,8917,93,712673,79.91399416909621,8
0.2,8918,91,712764,79.91523713420787,10
0.2,8919,94,712858,79.91681614349775,7
0.2,8920,92,712950,79.91817060867616,9
0.2,8921,95,713045,79.91986101770904,6
0.2,8922,95,713140,79.92155104785387,6
0.2,8923,88,713228,79.92245629762438,13
0.2,8924,93,713321,79.92392156862745,8
0.2,8925,22,713343,79.9174322204795,10
0.2,8926,96,713439,79.91923378514619,6
0.2,8927,92,713531,79.92058691756273,9
0.2,8928,92,713623,79.92193974689215,13
0.2,8929,91,713714,79.92318029115341,10
0.2,8930,94,713808,79.92475646624118,8
0.2,8931,93,713901,79.92622033139274,8
0.2,8932,92,713993,79.92757192432553,9
0.2,8933,83,714076,79.92791582717707,18
0.2,8934,92,714168,79.92926692781198,10
0.2,8935,90,714258,79.93039391226499,11
0.2,8936,86,714344,79.93107306702473,15
0.2,8937,95,714439,79.93275900648915,6
0.2,8938,90,714529,79.93388522206064,12
0.2,8939,90,714619,79.93501118568233,11
0.2,8940,82,714701,79.93524214293703,19
0.2,8941,87,714788,79.93603220755983,14
0.2,8942,87,714875,79.93682209549368,14
0.2,8943,94,714969,79.93839445438283,7
0.2,8944,25,714994,79.9322526551146,8
0.2,8945,94,715088,79.9338251732618,7
0.2,8946,92,715180,79.93517380127417,10
0.2,8947,96,715276,79.93696915511846,6
0.2,8948,93,715369,79.93842887473461,10
0.2,8949,91,715460,79.93966480446927,11
0.2,8950,94,715554,79.94123561613227,7
0.2,8951,90,715644,79.94235924932975,11
0.2,8952,90,715734,79.94348263152015,12
0.2,8953,94,715828,79.94505249050704,7
0.2,8954,94,715922,79.9466219988833,7
0.2,8955,88,716010,79.94752121482804,13
0.2,8956,92,716102,79.94886680808307,9
0.2,8957,92,716194,79.95021210091538,9
0.2,8958,94,716288,79.95178033262641,7
0.2,8959,95,716383,79.95345982142857,6
0.2,8960,94,716477,79.95502734069858,8
0.2,8961,82,716559,79.95525552332069,20
0.2,8962,93,716652,79.95671092268213,8
0.2,8963,93,716745,79.95816599732262,9
0.2,8964,92,716837,79.95950920245399,9
0.2,8965,21,716858,79.95293330359135,11
0.2,8966,26,716884,79.94691647150664,6
0.2,8967,94,716978,79.94848349687778,7
0.2,8968,93,717071,79.94993867766752,8
0.2,8969,95,717166,79.95161649944258,6
0.2,8970,94,717260,79.95318247686991,7
0.2,8971,27,717287,79.94728042799822,6
0.2,8972,88,717375,79.94817786693413,13
0.2,8973,91,717466,79.94940940494763,10
0.2,8974,90,717556,79.95052924791086,11
0.2,8975,95,717651,79.95220588235294,7
0.2,8976,94,717745,79.95377074746574,7
0.2,8977,90,717835,79.95488973045222,12
0.2,8978,-44,717791,79.94108475331329,8
0.2,8979,93,717884,79.94253897550111,8
0.2,8980,91,717975,79.94377018149427,12
0.2,8981,92,718067,79.94511244711646,9
0.2,8982,96,718163,79.94689969943227,6
0.2,8983,96,718259,79.94868655387356,6
0.2,8984,91,718350,79.94991652754591,11
0.2,8985,94,718444,79.95148008012464,7
0.2,8986,93,718537,79.95293201290754,8
0.2,8987,92,718629,79.95427236315086,10
0.2,8988,96,718725,79.95605740349316,6
0.2,8989,90,718815,79.9571746384872,11
0.2,8990,26,718841,79.95117339561784,7
0.2,8991,88,718929,79.95206850533808,13
0.2,8992,27,718956,79.94618036250417,6
0.2,8993,90,719046,79.9472981987992,12
0.2,8994,94,719140,79.94886047804336,7
0.2,8995,96,719236,79.95064473099156,6
0.2,8996,18,719254,79.94375903078804,15
0.2,8997,87,719341,79.9445432318293,14
0.2,8998,91,719432,79.94577175241693,11
0.2,8999,95,719527,79.94744444444444,7
0.2,9000,91,719618,79.9486723697367,10
0.2,9001,-48,719570,79.93445900910909,12
0.2,9002,95,719665,79.93613240031101,6
0.2,9003,94,719759,79.93769435806308,8
0.2,9004,95,719854,79.93936701832315,8
0.2,9005,94,719948,79.94092827004219,7
0.2,9006,91,720039,79.94215610081048,10
0.2,9007,94,720133,79.94371669626999,8
0.2,9008,89,720222,79.94472194472195,12
0.2,9009,94,720316,79.94628190899002,7
0.2,9010,93,720409,79.9477305515481,8
0.2,9011,96,720505,79.94951176209499,6
0.2,9012,95,720600,79.95118162653944,6
0.2,9013,95,720695,79.95285112047925,6
0.2,9014,93,720788,79.95429839156961,8
0.2,9015,87,720875,79.95507985803017,14
0.2,9016,19,720894,79.94831984030165,13
0.2,9017,25,720919,79.94222665779552,7
0.2,9018,90,721009,79.9433418339062,11
0.2,9019,90,721099,79.94445676274944,11
0.2,9020,96,721195,79.94623655913979,6
0.2,9021,24,721219,79.9400354688539,8
0.2,9022,96,721315,79.94181536074477,6
0.2,9023,93,721408,79.94326241134752,9
0.2,9024,94,721502,79.94481994459834,8
0.2,9025,94,721596,79.94637713272768,7
0.2,9026,95,721691,79.94804475462502,6
0.2,9027,90,721781,79.94915817456801,12
0.2,9028,92,721873,79.95049285635176,9
0.2,9029,96,721969,79.95227021040975,6
0.2,9030,93,722062,79.9537149817296,8
0.2,9031,95,722157,79.9553808680248,6
0.2,9032,95,722252,79.95704638547548,7
0.2,9033,90,722342,79.95815806951516,11
0.2,9034,88,722430,79.95904814609851,13
0.2,9035,92,722522,79.96038069942452,9
0.2,9036,21,722543,79.9538563682638,12
0.2,9037,96,722639,79.9556317769418,6
0.2,9038,20,722659,79.94899878305122,12
0.2,9039,87,722746,79.94977876106195,15
0.2,9040,94,722840,79.95133281716625,7
0.2,9041,94,722934,79.95288652952887,7
0.2,9042,93,723027,79.95432931549264,10
0.2,9043,95,723122,79.95599292348518,6
0.2,9044,94,723216,79.9575456053068,8
0.2,9045,94,723310,79.95909794384258,7
0.2,9046,94,723404,79.96064993920636,7
0.2,9047,95,723499,79.96231211317418,6
0.2,9048,25,723524,79.95623825837109,7
0.2,9049,94,723618,79.95779005524862,8
0.2,9050,92,723710,79.95912053916695,10
0.2,9051,95,723805,79.96078214759169,6
0.2,9052,91,723896,79.96200154644869,10
0.2,9053,94,723990,79.9635520212061,7
0.2,9054,93,724083,79.96499171728327,8
0.2,9055,26,724109,79.95903268551237,6
0.2,9056,90,724199,79.96014132715027,12
0.2,9057,91,724290,79.96136012364761,10
0.2,9058,26,724316,79.95540346616625,8
0.2,9059,93,724409,79.95684326710817,9
0.2,9060,94,724503,79.9583931133429,7
0.2,9061,94,724597,79.95994261752372,7
0.2,9062,94,724691,79.96149177976388,7
0.2,9063,-48,724643,79.94737422771404,11
0.2,9064,95,724738,79.94903474903475,7
0.2,9065,96,724834,79.95080520626517,6
0.2,9066,92,724926,79.95213411271645,9
0.2,9067,95,725021,79.95379355977062,6
0.2,9068,94,725115,79.95534237512405,8
0.2,9069,12,725127,79.94785005512679,20
0.2,9070,95,725222,79.94950942564216,6
0.2,9071,15,725237,79.94235008818342,18
0.2,9072,96,725333,79.94411991623498,6
0.2,9073,87,725420,79.94489750936742,14
0.2,9074,21,725441,79.93840220385675,11
0.2,9075,92,725533,79.93973115910093,9
0.2,9076,91,725624,79.94094965296904,11
0.2,9077,86,725710,79.94161709627672,15
0.2,9078,92,725802,79.94294525828836,9
0.2,9079,90,725892,79.94405286343613,11
0.2,9080,91,725983,79.94527034467569,10
0.2,9081,89,726072,79.94626734199515,12
0.2,9082,23,726095,79.93999779808433,11
0.2,9083,18,726113,79.93317921620431,14
0.2,9084,90,726203,79.93428728673638,11
0.2,9085,92,726295,79.9356152322254,10
0.2,9086,93,726388,79.93705293276109,8
0.2,9087,94,726482,79.93860035211267,8
0.2,9088,96,726578,79.9403674771702,6
0.2,9089,94,726672,79.94191419141914,8
0.2,9090,88,726760,79.94280057199428,13
0.2,9091,93,726853,79.94423669159701,8
0.2,9092,94,726947,79.94578247003189,7
0.2,9093,89,727036,79.94677809544754,12
0.2,9094,94,727130,79.94832325453545,7
0.2,9095,92,727222,79.94964819700968,9
0.2,9096,-48,727174,79.93558315928328,12
0.2,9097,89,727263,79.93657946801495,12
0.2,9098,90,727353,79.93768545994065,11
0.2,9099,94,727447,79.93923076923078,8
0.2,9100,95,727542,79.94088561696518,6
0.2,9101,94,727636,79.94243023511316,7
0.2,9102,15,727651,79.93529605624519,18
0.2,9103,94,727745,79.9368409490334,7
0.2,9104,93,727838,79.9382756727073,11
0.2,9105,96,727934,79.94003953437294,6
0.2,9106,92,728026,79.9413637860986,9
0.2,9107,92,728118,79.94268774703558,9
0.2,9108,94,728212,79.9442309803491,7
0.2,9109,95,728307,79.94588364434688,6
0.2,9110,95,728402,79.94753594556032,8
0.2,9111,94,728496,79.94907813871818,7
0.2,9112,94,728590,79.950619993416,7
0.2,9113,94,728684,79.95216150976519,7
0.2,9114,86,728770,79.95282501371366,16
0.2,9115,-48,728722,79.93878894251864,11
0.2,9116,-50,728672,79.92453658001536,13
0.2,9117,91,728763,79.9257512612415,10
0.2,9118,95,728858,79.92740432064919,7
0.2,9119,25,728883,79.92138157894736,7
0.2,9120,93,728976,79.92281548075869,8
0.2,9121,95,729071,79.92446831835124,6
0.2,9122,93,729164,79.92590156746684,8
0.2,9123,21,729185,79.91944322665498,12
0.2,9124,83,729268,79.91978082191781,18
0.2,9125,92,729360,79.92110453648915,9
0.2,9126,96,729456,79.92286622110223,6
0.2,9127,90,729546,79.92397020157756,11
0.2,9128,92,729638,79.92529302223683,9
0.2,9129,27,729665,79.91949616648412,6
0.2,9130,93,729758,79.92092870441354,8
0.2,9131,93,729851,79.92236092860271,8
0.2,9132,85,729936,79.92291689477719,18
0.2,9133,87,730023,79.92369170133567,14
0.2,9134,91,730114,79.92490421455939,10
0.2,9135,94,730208,79.92644483362523,7
0.2,9136,94,730302,79.9279851154646,7
0.2,9137,93,730395,79.92941562705187,8
0.2,9138,90,730485,79.93051756209651,11
0.2,9139,94,730579,79.93205689277899,8
0.2,9140,94,730673,79.93359588666448,7
0.2,9141,96,730769,79.93535331437322,6
0.2,9142,91,730860,79.93656349119544,10
0.2,9143,96,730956,79.93832020997375,7
0.2,9144,88,731044,79.93920174958994,15
0.2,9145,94,731138,79.94073912092718,7
0.2,9146,24,731162,79.93462337378375,9
0.2,9147,95,731257,79.93627022299957,6
0.2,9148,96,731353,79.938026013772,6
0.2,9149,93,731446,79.93945355191256,8
0.2,9150,92,731538,79.94077150038247,9
0.2,9151,-46,731492,79.9270104895105,9
0.2,9152,92,731584,79.92832950945045,9
0.2,9153,96,731680,79.93008520865196,6
0.2,9154,18,731698,79.92332058984162,14
0.2,9155,90,731788,79.92442114460464,12
0.2,9156,93,731881,79.9258490772087,8
0.2,9157,94,731975,79.92738589211618,7
0.2,9158,24,731999,79.92127961567857,8
0.2,9159,96,732095,79.92303493449782,6
0.2,9160,91,732186,79.9242440781574,10
0.2,9161,23,732209,79.91803099759878,10
0.2,9162,94,732303,79.91956782713085,7
0.2,9163,88,732391,79.92044958533391,13
0.2,9164,95,732486,79.92209492635024,6
0.2,9165,92,732578,79.92341261182631,11
0.2,9166,94,732672,79.92494818370241,7
0.2,9167,92,732764,79.92626527050611,9
0.2,9168,92,732856,79.92758207001854,9
0.2,9169,92,732948,79.9288985823337,10
0.2,9170,92,733040,79.93021480754552,9
0.2,9171,91,733131,79.931421718273,11
0.2,9172,94,733225,79.93295541262401,7
0.2,9173,22,733247,79.9266405057772,12
0.2,9174,88,733335,79.9275204359673,13
0.2,9175,93,733428,79.92894507410637,10
0.2,9176,94,733522,79.93047836983764,7
0.2,9177,96,733618,79.93222924384398,6
0.2,9178,89,733707,79.93321712604859,12
0.2,9179,90,733797,79.9343137254902,12
0.2,9180,89,733886,79.93530116545038,12
0.2,9181,16,733902,79.92833805271182,18
0.2,9182,93,733995,79.92976151584449,9
0.2,9183,90,734085,79.93085801393728,11
0.2,9184,93,734178,79.93228089275993,9
0.2,9185,94,734272,79.93381232310037,7
0.2,9186,93,734365,79.93523457058888,8
0.2,9187,21,734386,79.92882020026121,12
0.2,9188,92,734478,79.93013385569702,9
0.2,9189,94,734572,79.9316648531012,7
0.2,9190,87,734659,79.93243390273093,14
0.2,9191,95,734754,79.93407310704961,6
0.2,9192,24,734778,79.92798868704449,9
0.2,9193,94,734872,79.92951925168589,8
0.2,9194,93,734965,79.93094072865688,8
0.2,9195,93,735058,79.93236189647673,10
0.2,9196,23,735081,79.92617157768838,9
0.2,9197,89,735170,79.927158077843,12
0.2,9198,90,735260,79.92825307098597,11
0.2,9199,-48,735212,79.91434782608695,11
0.2,9200,95,735307,79.91598739267471,7
0.2,9201,90,735397,79.91708324277332,11
0.2,9202,92,735489,79.91839617516027,10
0.2,9203,93,735582,79.91981747066492,8
0.2,9204,93,735675,79.92123845736013,8
0.2,9205,95,735770,79.92287638496633,6
0.2,9206,23,735793,79.91669381991963,9
0.2,9207,93,735886,79.91811468288445,8
0.2,9208,95,735981,79.91975241611468,7
0.2,9209,91,736072,79.92095548317047,10
0.2,9210,96,736168,79.9227011182282,6
0.2,9211,94,736262,79.92422926617455,7
0.2,9212,94,736356,79.92575708238358,7
0.2,9213,95,736451,79.92739309746038,6
0.2,9214,25,736476,79.92143244709712,8
0.2,9215,94,736570,79.92296006944444,7
0.2,9216,95,736665,79.92459585548443,6
0.2,9217,92,736757,79.92590583640703,11
0.2,9218,94,736851,79.92743247640742,8
0.2,9219,93,736944,79.92885032537961,8
0.2,9220,95,737039,79.93048476304088,6
0.2,9221,92,737131,79.93179353719367,9
0.2,9222,93,737224,79.93321045213054,8
0.2,9223,-49,737175,79.91923243712056,12
0.2,9224,92,737267,79.92054200542006,9
0.2,9225,90,737357,79.9216345111641,12
0.2,9226,86,737443,79.92229326975182,16
0.2,9227,96,737539,79.92403554399654,6
0.2,9228,96,737635,79.92577744067613,6
0.2,9229,96,737731,79.92751895991333,6
0.2,9230,96,737827,79.92926010183079,6
0.2,9231,91,737918,79.93045927209705,10
0.2,9232,94,738012,79.93198310408317,7
0.2,9233,83,738095,79.93231535629197,18
0.2,9234,92,738187,79.93362208987547,14
0.2,9235,86,738273,79.93427890861845,16
0.2,9236,91,738364,79.93547688643498,12
0.2,9237,92,738456,79.93678285343148,9
0.2,9238,94,738550,79.93830501136486,7
0.2,9239,94,738644,79.93982683982684,7
0.2,9240,24,738668,79.93377340114706,8
0.2,9241,89,738757,79.93475438216836,12
0.2,9242,94,738851,79.93627610083307,8
0.2,9243,23,738874,79.93011683254002,11
0.2,9244,96,738970,79.93185505678746,6
0.2,9245,94,739064,79.93337659528444,7
0.2,9246,87,739151,79.9341408024224,16
0.2,9247,88,739239,79.93501297577855,13
0.2,9248,91,739330,79.93620931992648,10
0.2,9249,94,739424,79.93772972972972,8
0.2,9250,94,739518,79.93924981083126,7
0.2,9251,25,739543,79.93331171638565,7
0.2,9252,91,739634,79.9345077272236,10
0.2,9253,-48,739586,79.92068294791441,11
0.2,9254,96,739682,79.92242031334413,6
0.2,9255,91,739773,79.92361711322386,10
0.2,9256,25,739798,79.91768391487523,7
0.2,9257,88,739886,79.91855692374163,13
0.2,9258,91,739977,79.91975375310508,11
0.2,9259,95,740072,79.92138228941684,8
0.2,9260,25,740097,79.91545189504373,8
0.2,9261,95,740192,79.91708054415894,8
0.2,9262,95,740287,79.91870884162799,6
0.2,9263,95,740382,79.92033678756476,7
0.2,9264,91,740473,79.92153264975715,10
0.2,9265,92,740565,79.92283617526441,10
0.2,9266,89,740654,79.92381569008309,12
0.2,9267,95,740749,79.92544238239103,6
0.2,9268,10,740759,79.9178983709138,22
0.2,9269,86,740845,79.9185544768069,15
0.2,9270,90,740935,79.91964189407831,11
0.2,9271,89,741024,79.92062122519414,13
0.2,9272,90,741114,79.92170818505338,12
0.2,9273,93,741207,79.92311839551434,8
0.2,9274,25,741232,79.91719676549866,8
0.2,9275,92,741324,79.91849935316947,9
0.2,9276,93,741417,79.91990945348712,8
0.2,9277,94,741511,79.92142703168787,7
0.2,9278,94,741605,79.92294428278909,8
0.2,9279,93,741698,79.92435344827587,8
0.2,9280,23,741721,79.91822001939447,11
0.2,9281,91,741812,79.91941391941391,10
0.2,9282,83,741895,79.919745771841,18
0.2,9283,94,741989,79.9212623869022,7
0.2,9284,-47,741942,79.9075928917609,10
0.2,9285,94,742036,79.90911048890803,7
0.2,9286,93,742129,79.91052008183482,8
0.2,9287,93,742222,79.9119293712317,8
0.2,9288,92,742314,79.91323070298202,9
0.2,9289,86,742400,79.91388589881593,15
0.2,9290,94,742494,79.91540200193735,7
0.2,9291,94,742588,79.9169177787344,7
0.2,9292,95,742683,79.91854083718928,7
0.2,9293,93,742776,79.91994835377663,8
0.2,9294,93,742869,79.92135556750941,8
0.2,9295,21,742890,79.91501721170395,12
0.2,9296,93,742983,79.9164246531139,8
0.2,9297,92,743075,79.91772424177242,9
0.2,9298,94,743169,79.91923862780945,8
0.2,9299,95,743264,79.92086021505376,6
0.2,9300,93,743357,79.92226642296528,8
0.2,9301,27,743384,79.91657708019781,6
0.2,9302,94,743478,79.91809093840696,8
0.2,9303,26,743504,79.91229578675838,7
0.2,9304,89,743593,79.91327243417517,15
0.2,9305,91,743684,79.9144637868042,10
0.2,9306,93,743777,79.91586977543784,10
0.2,9307,92,743869,79.91716802750322,9
0.2,9308,92,743961,79.91846600064454,9
0.2,9309,94,744055,79.91997851772288,8
0.2,9310,95,744150,79.92159810976264,7
0.2,9311,90,744240,79.92268041237114,11
0.2,9312,90,744330,79.92376248255127,11
0.2,9313,95,744425,79.92538114666094,7
0.2,9314,95,744520,79.92699946323135,6
0.2,9315,93,744613,79.9284027479605,8
0.2,9316,93,744706,79.92980573145863,8
0.2,9317,94,744800,79.93131573298992,8
0.2,9318,94,744894,79.93282541045177,7
0.2,9319,96,744990,79.93454935622317,6
0.2,9320,95,745085,79.93616564746272,6
0.2,9321,95,745180,79.93778159193306,8
0.2,9322,88,745268,79.9386463584683,15
0.2,9323,96,745364,79.94036894036894,6
0.2,9324,86,745450,79.94101876675603,15
0.2,9325,90,745540,79.94209736221316,11
0.2,9326,87,745627,79.94285407955398,14
0.2,9327,95,745722,79.94446826758147,7
0.2,9328,11,745733,79.93707792903848,21
0.2,9329,91,745824,79.93826366559486,10
0.2,9330,94,745918,79.93977065694995,8
0.2,9331,92,746010,79.94106300900128,9
0.2,9332,92,746102,79.94235508411015,9
0.2,9333,94,746196,79.9438611527748,8
0.2,9334,13,746209,79.93668987680772,20
0.2,9335,93,746302,79.93808911739502,8
0.2,9336,91,746393,79.93927385669916,10
0.2,9337,96,746489,79.94099378881988,6
0.2,9338,96,746585,79.94271335260734,6
0.2,9339,91,746676,79.9438972162741,10
0.2,9340,90,746766,79.94497377154481,11
0.2,9341,90,746856,79.9460500963391,11
0.2,9342,95,746951,79.94766135074387,6
0.2,9343,92,747043,79.94895119863014,9
0.2,9344,90,747133,79.95002675227394,11
0.2,9345,95,747228,79.95163706398459,6
0.2,9346,17,747245,79.94490210762811,16
0.2,9347,92,747337,79.9461916987591,9
0.2,9348,93,747430,79.94758797732378,8
0.2,9349,90,747520,79.94866310160428,11
0.2,9350,89,747609,79.94963105550208,12
0.2,9351,92,747701,79.95091958939264,11
0.2,9352,86,747787,79.95156634235005,15
0.2,9353,93,747880,79.95296129997863,9
0.2,9354,94,747974,79.95446285408872,7
0.2,9355,91,748065,79.95564343736639,12
0.2,9356,93,748158,79.95703751202308,9
0.2,9357,94,748252,79.95853814917717,10
0.2,9358,94,748346,79.96003846564804,7
0.2,9359,93,748439,79.96143162393163,8
0.2,9360,25,748464,79.95556030338639,8
0.2,9361,95,748559,79.95716727195044,6
0.2,9362,23,748582,79.95108405425611,9
0.2,9363,95,748677,79.95269115762494,6
0.2,9364,84,748761,79.95312333155366,19
0.2,9365,96,748857,79.95483664317744,6
0.2,9366,24,748881,79.94886302978541,8
0.2,9367,24,748905,79.94289069171649,11
0.2,9368,95,749000,79.94449781193298,7
0.2,9369,90,749090,79.94557097118464,11
0.2,9370,90,749180,79.94664390139793,11
0.2,9371,92,749272,79.94793000426803,10
0.2,9372,92,749364,79.94921583271098,10
0.2,9373,92,749456,79.9505013868146,9
0.2,9374,88,749544,79.95136,13
0.2,9375,90,749634,79.95243174061433,11
0.2,9376,88,749722,79.95328996480751,14
0.2,9377,90,749812,79.95436127105992,12
0.2,9378,96,749908,79.95607207591428,6
0.2,9379,27,749935,79.95042643923242,6
0.2,9380,86,750021,79.95107131435881,16
0.2,9381,93,750114,79.95246216158601,8
0.2,9382,92,750206,79.95374613663007,9
0.2,9383,96,750302,79.95545609548167,6
0.2,9384,92,750394,79.95673947789025,9
0.2,9385,93,750487,79.95812912848923,8
0.2,9386,22,750509,79.95195483114946,10
0.2,9387,93,750602,79.95334469535577,10
0.2,9388,94,750696,79.95484077111513,9
0.2,9389,83,750779,79.95516506922257,18
0.2,9390,87,750866,79.95591523799382,15
0.2,9391,91,750957,79.95709114139693,10
0.2,9392,95,751052,79.9586926434579,6
0.2,9393,95,751147,79.9602938045561,6
0.2,9394,93,751240,79.96168174560937,9
0.2,9395,85,751325,79.96221796509153,16
0.2,9396,95,751420,79.96381823986378,6
0.2,9397,96,751516,79.96552457969781,6
0.2,9398,90,751606,79.96659219065857,13
0.2,9399,94,751700,79.96808510638297,7
0.2,9400,89,751789,79.96904584618657,12
0.2,9401,93,751882,79.97043182301638,8
0.2,9402,92,751974,79.97171115601404,10
0.2,9403,93,752067,79.97309655465759,8
0.2,9404,93,752160,79.97448165869218,8
0.2,9405,94,752254,79.9759727833298,7
0.2,9406,21,752275,79.9697034123525,11
0.2,9407,92,752367,79.97098214285714,10
0.2,9408,95,752462,79.97257944521203,6
0.2,9409,96,752558,79.97428267800213,6
0.2,9410,88,752646,79.97513547975772,13
0.2,9411,93,752739,79.97651933701657,8
0.2,9412,93,752832,79.97790290024435,8
0.2,9413,92,752924,79.97917994476312,9
0.2,9414,92,753016,79.98045671800318,10
0.2,9415,94,753110,79.98194562446899,9
0.2,9416,90,753200,79.98300945099288,11
0.2,9417,90,753290,79.98407305160332,11
0.2,9418,23,753313,79.9780231447075,9
0.2,9419,94,753407,79.97951167728237,7
0.2,9420,25,753432,79.97367583059123,7
0.2,9421,96,753528,79.97537677775419,6
0.2,9422,95,753623,79.97697124058156,6
0.2,9423,21,753644,79.97071307300509,11
0.2,9424,91,753735,79.97188328912466,10
0.2,9425,15,753750,79.96499045194143,20
0.2,9426,11,753761,79.95767476397582,21
0.2,9427,95,753856,79.95927025880357,7
0.2,9428,22,753878,79.95312334287836,11
0.2,9429,93,753971,79.95450689289501,8
0.2,9430,87,754058,79.95525394974023,15
0.2,9431,96,754154,79.9569550466497,6
0.2,9432,95,754249,79.95854977207675,6
0.2,9433,25,754274,79.95272418910325,8
0.2,9434,92,754366,79.95400105988341,9
0.2,9435,94,754460,79.95548961424332,8
0.2,9436,89,754549,79.95644802373636,12
0.2,9437,91,754640,79.95761813943632,10
0.2,9438,23,754663,79.95158385422185,9
0.2,9439,-123,754540,79.93008474576271,17
0.2,9440,96,754636,79.93178688698231,6
0.2,9441,91,754727,79.93295911883075,11
0.2,9442,93,754820,79.93434289950228,11
0.2,9443,88,754908,79.93519695044472,13
0.2,9444,93,755001,79.93658020116463,8
0.2,9445,92,755093,79.93785729409274,10
0.2,9446,89,755182,79.93881655552028,13
0.2,9447,95,755277,79.94041066892464,8
0.2,9448,90,755367,79.94147528839031,11
0.2,9449,93,755460,79.94285714285714,10
0.2,9450,94,755554,79.94434451380806,7
0.2,9451,16,755570,79.93757934828608,18
0.2,9452,95,755665,79.93917274939173,6
0.2,9453,81,755746,79.93928495874762,22
0.2,9454,21,755767,79.93305129561078,13
0.2,9455,90,755857,79.93411590524535,11
0.2,9456,94,755951,79.93560325684678,8
0.2,9457,84,756035,79.93603298794672,17
0.2,9458,87,756122,79.93677978644676,14
0.2,9459,93,756215,79.93816067653277,8
0.2,9460,82,756297,79.9383786069126,19
0.2,9461,92,756389,79.93965335024308,9
0.2,9462,94,756483,79.94113917362358,7
0.2,9463,94,756577,79.9426246830093,8
0.2,9464,91,756668,79.94379292128896,10
0.2,9465,91,756759,79.94496091274033,10
0.2,9466,95,756854,79.94655117777543,8
0.2,9467,92,756946,79.94782425010563,10
0.2,9468,92,757038,79.94909705354314,9
0.2,9469,18,757056,79.94255543822598,14
0.2,9470,94,757150,79.94403970013727,8
0.2,9471,90,757240,79.94510135135135,11
0.2,9472,93,757333,79.94647946796158,9
0.2,9473,96,757429,79.94817394975723,6
0.2,9474,95,757524,79.94976253298152,6
0.2,9475,25,757549,79.94396369776277,7
0.2,9476,21,757570,79.93774401181808,15
0.2,9477,24,757594,79.93184216079342,8
0.2,9478,19,757613,79.92541407321447,13
0.2,9479,84,757697,79.92584388185654,17
0.2,9480,94,757791,79.92732834089232,7
0.2,9481,94,757885,79.92881248681712,7
0.2,9482,90,757975,79.92987451228514,13
0.2,9483,85,758060,79.93040911008013,17
0.2,9484,95,758155,79.93199789140749,6
0.2,9485,94,758249,79.93348091924942,7
0.2,9486,16,758265,79.92674185727839,18
0.2,9487,90,758355,79.92780354131534,11
0.2,9488,27,758382,79.92222573506164,6
0.2,9489,94,758476,79.92370916754479,7
0.2,9490,93,758569,79.92508692445475,8
0.2,9491,93,758662,79.92646439106616,8
0.2,9492,96,758758,79.928157589803,6
0.2,9493,96,758854,79.92985043185169,6
0.2,9494,25,758879,79.92406529752502,7
0.2,9495,23,758902,79.91807076663858,10
0.2,9496,94,758996,79.91955354322418,8
0.2,9497,95,759091,79.92114129290377,6
0.2,9498,90,759181,79.92220233708811,12
0.2,9499,92,759273,79.92347368421052,9
0.2,9500,95,759368,79.92506051994526,6
0.2,9501,93,759461,79.92643653967586,8
0.2,9502,91,759552,79.92760180995475,10
0.2,9503,94,759646,79.92908249158249,7
0.2,9504,92,759738,79.93035244608102,9
0.2,9505,89,759827,79.93130654323585,13
0.2,9506,91,759918,79.93247081098139,10
0.2,9507,86,760004,79.93310896087505,15
0.2,9508,93,760097,79.93448312125355,10
0.2,9509,94,760191,79.93596214511041,7
0.2,9510,94,760285,79.93744085795394,7
0.2,9511,91,760376,79.93860386879732,10
0.2,9512,95,760471,79.94018711237254,6
0.2,9513,92,760563,79.94145469833929,9
0.2,9514,96,760659,79.94314240672622,6
0.2,9515,92,760751,79.9444094157209,9
0.2,9516,10,760761,79.9370599978985,22
0.2,9517,91,760852,79.93822231561252,10
0.2,9518,95,760947,79.93980460132367,7
0.2,9519,95,761042,79.94138655462184,7
0.2,9520,88,761130,79.94223295872283,13
0.2,9521,89,761219,79.94318420499894,12
0.2,9522,94,761313,79.94466029612516,7
0.2,9523,88,761401,79.94550608987821,14
0.2,9524,95,761496,79.94708661417323,6
0.2,9525,22,761518,79.94100356917909,11
0.2,9526,-56,761462,79.92673454392778,19
0.2,9527,94,761556,79.92821158690177,7
0.2,9528,27,761583,79.92265715185223,6
0.2,9529,19,761602,79.91626442812172,15
0.2,9530,92,761694,79.91753226314133,12
0.2,9531,88,761782,79.918380193034,13
0.2,9532,96,761878,79.92006713521452,6
0.2,9533,17,761895,79.91346758967904,15
0.2,9534,93,761988,79.91484006292606,9
0.2,9535,94,762082,79.91631711409396,7
0.2,9536,96,762178,79.91800356506239,6
0.2,9537,95,762273,79.91958481862025,8
0.2,9538,90,762363,79.92064157668518,11
0.2,9539,89,762452,79.92159329140462,12
0.2,9540,26,762478,79.91594172518604,7
0.2,9541,90,762568,79.91699853280235,11
0.2,9542,93,762661,79.91836948548675,8
0.2,9543,93,762754,79.91974015088013,8
0.2,9544,95,762849,79.92132006286013,7
0.2,9545,93,762942,79.92269013199245,9
0.2,9546,94,763036,79.9241646590552,7
0.2,9547,22,763058,79.91809803100125,10
0.2,9548,92,763150,79.91936328411352,9
0.2,9549,92,763242,79.9206282722513,9
0.2,9550,92,763334,79.92189299549786,9
0.2,9551,95,763429,79.9234715242881,7
0.2,9552,87,763516,79.9242122893332,14
0.2,9553,24,763540,79.91835880259578,9
0.2,9554,96,763636,79.92004186289901,6
0.2,9555,90,763726,79.92109669317706,11
0.2,9556,93,763819,79.92246520874751,8
0.2,9557,95,763914,79.92404268675455,6
0.2,9558,93,764007,79.92541060780417,8
0.2,9559,93,764100,79.92677824267783,8
0.2,9560,94,764194,79.92825018303525,7
0.2,9561,24,764218,79.92240117130308,8
0.2,9562,89,764307,79.9233504130503,12
0.2,9563,94,764401,79.92482225010455,7
0.2,9564,94,764495,79.92629377940408,7
0.2,9565,90,764585,79.92734685343926,11
0.2,9566,87,764672,79.92808612940316,15
0.2,9567,21,764693,79.92192725752508,11
0.2,9568,95,764788,79.92350297836765,7
0.2,9569,95,764883,79.92507836990596,6
0.2,9570,92,764975,79.92633998537248,9
0.2,9571,91,765066,79.92749686585876,11
0.2,9572,89,765155,79.92844458372505,13
0.2,9573,88,765243,79.92928765406309,13
0.2,9574,94,765337,79.93075718015666,7
0.2,9575,96,765433,79.93243525480368,6
0.2,9576,25,765458,79.92669938394069,8
0.2,9577,90,765548,79.92775109626227,11
0.2,9578,89,765637,79.92869819396597,13
0.2,9579,96,765733,79.930375782881,6
0.2,9580,91,765824,79.93153115541175,10
0.2,9581,95,765919,79.93310373617199,7
0.2,9582,93,766012,79.93446728581864,8
0.2,9583,18,766030,79.92800500834724,14
0.2,9584,91,766121,79.92916014606155,10
0.2,9585,96,766217,79.93083663676194,6
0.2,9586,90,766307,79.931886930218,11
0.2,9587,92,766399,79.93314559866499,9
0.2,9588,94,766493,79.93461257691105,7
0.2,9589,92,766585,79.93587069864442,9
0.2,9590,25,766610,79.93014284224795,7
0.2,9591,95,766705,79.93171392827357,7
0.2,9592,92,766797,79.9329719587199,9
0.2,9593,89,766886,79.933917031478,12
0.2,9594,89,766975,79.93486190724336,12
0.2,9595,89,767064,79.93580658607753,12
0.2,9596,94,767158,79.93727206418673,7
0.2,9597,93,767251,79.93863304855178,8
0.2,9598,90,767341,79.93968121679342,12
0.2,9599,91,767432,79.94083333333333,10
0.2,9600,94,767526,79.94229767732529,8
0.2,9601,92,767618,79.9435534263695,10
0.2,9602,93,767711,79.94491304800583,8
0.2,9603,91,767802,79.9460641399417,10
0.2,9604,91,767893,79.94721499219156,10
0.2,9605,95,767988,79.94878201124297,6
0.2,9606,93,768081,79.95014052253565,8
0.2,9607,90,768171,79.95118651124064,11
0.2,9608,85,768256,79.95171193672599,16
0.2,9609,24,768280,79.94588969823101,9
0.2,9610,89,768369,79.94683175528041,12
0.2,9611,24,768393,79.94101123595506,8
0.2,9612,92,768485,79.94226568188911,9
0.2,9613,88,768573,79.9431038069482,14
0.2,9614,88,768661,79.9439417576703,13
0.2,9615,94,768755,79.94540349417638,7
0.2,9616,94,768849,79.94686492669231,9
0.2,9617,89,768938,79.9478061967145,13
0.2,9618,89,769027,79.9487472710261,12
0.2,9619,94,769121,79.9502079002079,7
0.2,9620,91,769212,79.95135640785782,10
0.2,9621,88,769300,79.95219289129079,13
0.2,9622,93,769393,79.95354878935883,8
0.2,9623,94,769487,79.95500831255195,7
0.2,9624,91,769578,79.95615584415584,10
0.2,9625,90,769668,79.95719925202576,12
0.2,9626,95,769763,79.9587618157266,6
0.2,9627,94,769857,79.96022019110926,7
0.2,9628,95,769952,79.961782116523,6
0.2,9629,94,770046,79.9632398753894,7
0.2,9630,93,770139,79.96459350015574,8
0.2,9631,91,770230,79.9657392026578,10
0.2,9632,93,770323,79.96709228693034,8
0.2,9633,95,770418,79.96865268839527,6
0.2,9634,25,770443,79.96294758692268,8
0.2,9635,96,770539,79.96461187214612,6
0.2,9636,93,770632,79.96596451177753,8
0.2,9637,22,770654,79.95995019713634,11
0.2,9638,91,770745,79.96109554933085,10
0.2,9639,95,770840,79.96265560165975,6
0.2,9640,93,770933,79.9640078829997,8
0.2,9641,94,771027,79.96546359676415,7
0.2,9642,89,771116,79.96640049777041,13
0.2,9643,91,771207,79.96754458730817,10
0.2,9644,95,771302,79.96910316226024,7
0.2,9645,94,771396,79.97055774414265,7
0.2,9646,91,771487,79.9717010469576,11
0.2,9647,96,771583,79.9733623548922,6
0.2,9648,93,771676,79.97471240543061,8
0.2,9649,89,771765,79.97564766839378,12
0.2,9650,95,771860,79.9772044347736,7
0.2,9651,93,771953,79.97855366763365,8
0.2,9652,96,772049,79.98021340515902,6
0.2,9653,86,772135,79.98083695877357,16
0.2,9654,94,772229,79.98228896944589,8
0.2,9655,85,772314,79.98280861640431,18
0.2,9656,14,772328,79.97597597597597,18
0.2,9657,94,772422,79.97742803893145,7
0.2,9658,94,772516,79.97887980122165,9
0.2,9659,94,772610,79.98033126293996,7
0.2,9660,91,772701,79.98147189731912,10
0.2,9661,23,772724,79.97557441523495,10
0.2,9662,88,772812,79.97640484321639,13
0.2,9663,15,772827,79.96968129139073,17
0.2,9664,87,772914,79.97040869115365,14
0.2,9665,93,773007,79.971756672874,9
0.2,9666,94,773101,79.97320782041999,7
0.2,9667,90,773191,79.97424493173355,11
0.2,9668,93,773284,79.97559209845899,8
0.2,9669,92,773376,79.97683557394002,12
0.2,9670,90,773466,79.97787198841898,11
0.2,9671,94,773560,79.97932175351531,7
0.2,9672,96,773656,79.98097797994417,6
0.2,9673,96,773752,79.98263386396526,6
0.2,9674,88,773840,79.98346253229974,13
0.2,9675,95,773935,79.98501446878876,6
0.2,9676,94,774029,79.98646274671903,8
0.2,9677,94,774123,79.98791072535649,8
0.2,9678,94,774217,79.98935840479389,7
0.2,9679,85,774302,79.98987603305785,16
0.2,9680,94,774396,79.99132321041215,7
0.2,9681,92,774488,79.9925635199339,9
0.2,9682,96,774584,79.99421666838789,6
0.2,9683,92,774676,79.99545642296572,10
0.2,9684,91,774767,79.9965926690759,12
0.2,9685,94,774861,79.99803840594673,8
0.2,9686,89,774950,79.9989676886549,12
0.2,9687,87,775037,79.99969033856317,14
0.2,9688,95,775132,80.0012385179069,6
0.2,9689,93,775225,80.00257997936016,8
0.2,9690,94,775319,80.004024352492,8
0.2,9691,93,775412,80.00536524969047,8
0.2,9692,86,775498,80.00598369957702,15
0.2,9693,91,775589,80.00711780482773,11
0.2,9694,94,775683,80.00856111397627,7
0.2,9695,88,775771,80.00938531353135,13
0.2,9696,25,775796,80.00371248839848,8
0.2,9697,92,775888,80.00494947411838,9
0.2,9698,93,775981,80.00628930817611,8
0.2,9699,77,776058,80.0059793814433,24
0.2,9700,91,776149,80.00711266879703,11
0.2,9701,94,776243,80.00855493712636,8
0.2,9702,94,776337,80.00999690817272,7
0.2,9703,91,776428,80.0111294311624,11
0.2,9704,-45,776383,79.99824832560536,10
0.2,9705,94,776477,79.99969091283742,7
0.2,9706,88,776565,80.00051509220151,13
0.2,9707,94,776659,80.0019571487433,8
0.2,9708,94,776753,80.00339890822947,7
0.2,9709,91,776844,80.00453141091658,11
0.2,9710,24,776868,79.99876428792092,9
0.2,9711,93,776961,80.00010296540363,8
0.2,9712,96,777057,80.0017502316483,6
0.2,9713,83,777140,80.00205888408483,18
0.2,9714,93,777233,80.00339680905816,8
0.2,9715,94,777327,80.00483738163854,7
0.2,9716,94,777421,80.00627765771328,8
0.2,9717,20,777441,80.00010290183165,13
0.2,9718,21,777462,79.9940323078506,11
0.2,9719,87,777549,79.99475308641975,14
0.2,9720,93,777642,79.99609093714638,9
0.2,9721,91,777733,79.99722279366385,10
0.2,9722,94,777827,79.99866296410573,8
0.2,9723,95,777922,80.00020567667626,6
0.2,9724,92,778014,80.00143958868895,9
0.2,9725,92,778106,80.00267324696689,11
0.2,9726,88,778194,80.00349542510537,15
0.2,9727,94,778288,80.00493421052632,7
0.2,9728,95,778383,80.00647548566143,8
0.2,9729,93,778476,80.00781089414183,8
0.2,9730,94,778570,80.00924879251876,7
0.2,9731,96,778666,80.01089190300041,6
0.2,9732,91,778757,80.0120209596219,10
0.2,9733,91,778848,80.01314978426136,12
0.2,9734,91,778939,80.01427837699025,10
0.2,9735,21,778960,80.00821692686935,11
0.2,9736,94,779054,80.00965389750436,7
0.2,9737,88,779142,80.01047443006777,13
0.2,9738,94,779236,80.01191087380634,7
0.2,9739,94,779330,80.01334702258727,7
0.2,9740,94,779424,80.01478287650139,7
0.2,9741,87,779511,80.01549989735167,15
0.2,9742,85,779596,80.01601149543262,16
0.2,9743,93,779689,80.01734400656814,8
0.2,9744,91,779780,80.01847101077476,10
0.2,9745,95,779875,80.0200082084958,6
0.2,9746,93,779968,80.02133989945624,8
0.2,9747,91,780059,80.02246614690193,10
0.2,9748,93,780152,80.02379731254487,8
0.2,9749,94,780246,80.02523076923077,7
0.2,9750,89,780335,80.02615116398319,12
0.2,9751,96,780431,80.02778917145201,6
0.2,9752,94,780525,80.02922177791449,7
0.2,9753,88,780613,80.03003895837605,13
0.2,9754,91,780704,80.03116350589441,12
0.2,9755,93,780797,80.03249282492826,9
0.2,9756,93,780890,80.03382187147689,8
0.2,9757,94,780984,80.0352531256405,7
0.2,9758,92,781076,80.03647914745363,9
0.2,9759,23,781099,80.03063524590164,11
0.2,9760,23,781122,80.02479254174777,10
0.2,9761,95,781217,80.02632657242368,6
0.2,9762,90,781307,80.02734815118303,12
0.2,9763,94,781401,80.02877918885703,7
0.2,9764,91,781492,80.02990271377368,10
0.2,9765,93,781585,80.03123080073725,8
0.2,9766,96,781681,80.03286577249924,6
0.2,9767,87,781768,80.03357903357903,15
0.2,9768,93,781861,80.03490633637016,8
0.2,9769,90,781951,80.03592630501535,12
0.2,9770,94,782045,80.03735543956606,7
0.2,9771,95,782140,80.03888661481784,7
0.2,9772,88,782228,80.03970121764044,13
0.2,9773,95,782323,80.04123183957438,6
0.2,9774,96,782419,80.04286445012788,6
0.2,9775,92,782511,80.0440875613748,11
0.2,9776,21,782532,80.03804848112918,11
0.2,9777,94,782626,80.03947637553692,7
0.2,9778,95,782721,80.04100623785664,7
0.2,9779,96,782817,80.04263803680982,6
0.2,9780,95,782912,80.04416726306104,6
0.2,9781,90,783002,80.04518503373544,11
0.2,9782,95,783097,80.04671368700808,6
0.2,9783,95,783192,80.04824202780048,6
0.2,9784,24,783216,80.0425140521206,8
0.2,9785,25,783241,80.03688943388514,7
0.2,9786,93,783334,80.03821395729028,8
0.2,9787,90,783424,80.03923171230078,12
0.2,9788,95,783519,80.04076003677598,6
0.2,9789,90,783609,80.04177732379979,11
0.2,9790,94,783703,80.04320294147686,7
0.2,9791,91,783794,80.04432189542484,10
0.2,9792,93,783887,80.04564484836108,8
0.2,9793,92,783979,80.04686542781295,9
0.2,9794,81,784060,80.04696273608984,20
0.2,9795,90,784150,80.04797876684361,11
0.2,9796,94,784244,80.04940287843218,7
0.2,9797,77,784321,80.04909165135741,28
0.2,9798,25,784346,80.04347382385957,8
0.2,9799,92,784438,80.04469387755103,10
0.2,9800,91,784529,80.04581165187226,11
0.2,9801,25,784554,80.04019587839217,7
0.2,9802,90,784644,80.04121187391615,13
0.2,9803,91,784735,80.04232966136271,11
0.2,9804,88,784823,80.04314125446201,13
0.2,9805,92,784915,80.04436059555374,9
0.2,9806,89,785004,80.04527378403182,12
0.2,9807,94,785098,80.04669657422512,7
0.2,9808,92,785190,80.0479151799368,10
0.2,9809,92,785282,80.04913353720693,9
0.2,9810,90,785372,80.05014779329325,11
0.2,9811,93,785465,80.05146759070526,8
0.2,9812,92,785557,80.05268521349231,10
0.2,9813,88,785645,80.05349500713267,14
0.2,9814,94,785739,80.05491594498217,7
0.2,9815,94,785833,80.05633659331703,10
0.2,9816,92,785925,80.05755322399918,10
0.2,9817,86,786011,80.05815848441638,15
0.2,9818,93,786104,80.05947652510439,8
0.2,9819,24,786128,80.05376782077393,9
0.2,9820,84,786212,80.05416963649323,17
0.2,9821,95,786307,80.05569130523315,6
0.2,9822,92,786399,80.05690725847501,10
0.2,9823,90,786489,80.0579193811075,12
0.2,9824,23,786512,80.05211195928753,9
0.2,9825,95,786607,80.05363321799308,6
0.2,9826,94,786701,80.05505240663479,8
0.2,9827,24,786725,80.0493487993488,8
0.2,9828,22,786747,80.04344287313053,11
0.2,9829,94,786841,80.04486266531028,7
0.2,9830,91,786932,80.04597701149426,12
0.2,9831,94,787026,80.04739625711962,10
0.2,9832,94,787120,80.04881521407505,7
0.2,9833,93,787213,80.05013219442749,10
0.2,9834,91,787304,80.05124555160143,10
0.2,9835,96,787400,80.05286701911346,6
0.2,9836,91,787491,80.05397987191216,10
0.2,9837,27,787518,80.04858711120147,6
0.2,9838,90,787608,80.04959853643663,11
0.2,9839,94,787702,80.0510162601626,8
0.2,9840,85,787787,80.05151915455747,16
0.2,9841,21,787808,80.04551920341395,11
0.2,9842,27,787835,80.04013004165397,6
0.2,9843,92,787927,80.04134498171474,9
0.2,9844,96,788023,80.0429659725749,6
0.2,9845,96,788119,80.04458663416617,6
0.2,9846,91,788210,80.0456991977252,10
0.2,9847,91,788301,80.04681153533713,10
0.2,9848,93,788394,80.04812671337191,8
0.2,9849,96,788490,80.0497461928934,6
0.2,9850,22,788512,80.04385341589686,12
0.2,9851,89,788601,80.04476248477467,12
0.2,9852,87,788688,80.04546838526338,15
0.2,9853,91,788779,80.0465800690075,10
0.2,9854,90,788869,80.04759005580924,11
0.2,9855,95,788964,80.04910714285714,6
0.2,9856,88,789052,80.04991376686618,14
0.2,9857,93,789145,80.05122742949888,8
0.2,9858,93,789238,80.05254082564154,10
0.2,9859,-51,789187,80.03924949290061,15
0.2,9860,92,789279,80.04046242774567,10
0.2,9861,93,789372,80.0417765159197,8
0.2,9862,96,789468,80.04339450471458,6
0.2,9863,93,789561,80.04470802919708,8
0.2,9864,93,789654,80.04602128737963,8
0.2,9865,-44,789610,80.03344820595986,9
0.2,9866,12,789622,80.02655315698794,21
0.2,9867,94,789716,80.02796919335225,7
0.2,9868,94,789810,80.02938494275003,8
0.2,9869,94,789904,80.0308004052685,7
0.2,9870,95,789999,80.03231688785331,6
0.2,9871,92,790091,80.03352917341978,9
0.2,9872,93,790184,80.03484249974679,8
0.2,9873,88,790272,80.03564917966376,13
0.2,9874,95,790367,80.03716455696203,6
0.2,9875,86,790453,80.037768327258,15
0.2,9876,93,790546,80.03908069251797,8
0.2,9877,92,790638,80.04029155699534,9
0.2,9878,94,790732,80.04170462597429,7
0.2,9879,96,790828,80.04331983805668,6
0.2,9880,94,790922,80.04473231454307,7
0.2,9881,91,791013,80.04584092289011,10
0.2,9882,92,791105,80.04705049074168,9
0.2,9883,95,791200,80.04856333468231,7
0.2,9884,94,791294,80.04997470915528,9
0.2,9885,89,791383,80.05088003236901,12
0.2,9886,96,791479,80.05249317285325,6
0.2,9887,93,791572,80.05380258899676,8
0.2,9888,92,791664,80.05501061785823,9
0.2,9889,92,791756,80.0562184024267,9
0.2,9890,94,791850,80.05762814680013,8
0.2,9891,89,791939,80.05853214718965,12
0.2,9892,91,792030,80.05963812796927,10
0.2,9893,95,792125,80.06114817060845,6
0.2,9894,95,792220,80.06265790803437,6
0.2,9895,94,792314,80.06406628940987,7
0.2,9896,91,792405,80.0651712640194,11
0.2,9897,92,792497,80.06637704586785,9
0.2,9898,93,792590,80.06768360440448,8
0.2,9899,94,792684,80.0690909090909,7
0.2,9900,94,792778,80.07049792950207,7
0.2,9901,23,792801,80.0647343970915,9
0.2,9902,89,792890,80.06563667575482,12
0.2,9903,96,792986,80.06724555735056,6
0.2,9904,20,793006,80.06118122160525,12
0.2,9905,92,793098,80.06238643246517,10
0.2,9906,92,793190,80.06359140002019,9
0.2,9907,95,793285,80.06509890997174,6
0.2,9908,95,793380,80.06660611565243,6
0.2,9909,90,793470,80.06760847628658,13
0.2,9910,26,793496,80.06215316315205,6
0.2,9911,91,793587,80.06325665859565,10
0.2,9912,23,793610,80.05750025219409,9
0.2,9913,94,793704,80.05890659673189,8
0.2,9914,89,793793,80.05980837115482,12
0.2,9915,18,793811,80.05354981847519,14
0.2,9916,95,793906,80.05505697287487,8
0.2,9917,27,793933,80.04970760233918,6
0.2,9918,-51,793882,80.03649561447726,14
0.2,9919,88,793970,80.03729838709677,13
0.2,9920,-120,793850,80.01713536941841,15
0.2,9921,96,793946,80.01874622052006,6
0.2,9922,96,794042,80.02035674695152,6
0.2,9923,85,794127,80.0208585247884,16
0.2,9924,93,794220,80.02216624685138,8
0.2,9925,89,794309,80.02307072335282,12
0.2,9926,91,794400,80.02417648836507,10
0.2,9927,93,794493,80.02548348106366,10
0.2,9928,91,794584,80.02658878034042,11
0.2,9929,95,794679,80.02809667673716,7
0.2,9930,83,794762,80.02839593193032,19
0.2,9931,95,794857,80.02990334273056,6
0.2,9932,83,794940,80.03020235578376,19
0.2,9933,95,795035,80.0317092812563,6
0.2,9934,15,795050,80.02516356316055,19
0.2,9935,95,795145,80.02667069243157,6
0.2,9936,20,795165,80.02062996880346,12
0.2,9937,94,795259,80.02203662708794,8
0.2,9938,90,795349,80.02304054733877,12
0.2,9939,89,795438,80.02394366197183,12
0.2,9940,90,795528,80.02494718841163,11
0.2,9941,94,795622,80.02635284650975,8
0.2,9942,24,795646,80.02071809313085,9
0.2,9943,89,795735,80.021621078037,12
0.2,9944,25,795760,80.01608848667672,7
0.2,9945,93,795853,80.01739392720691,8
0.2,9946,86,795939,80.0179953754901,16
0.2,9947,95,796034,80.01950140731806,6
0.2,9948,90,796124,80.02050457332395,11
0.2,9949,93,796217,80.02180904522614,9
0.2,9950,92,796309,80.02301276253642,9
0.2,9951,90,796399,80.0240152733119,11
0.2,9952,96,796495,80.02562041595499,6
0.2,9953,95,796590,80.02712477396021,8
0.2,9954,88,796678,80.02792566549472,13
0.2,9955,91,796769,80.0290277219767,10
0.2,9956,94,796863,80.03043085266647,7
0.2,9957,83,796946,80.03072906206066,18
0.2,9958,94,797040,80.03213174013455,7
0.2,9959,-45,796995,80.019578313253,8
0.2,9960,87,797082,80.02027908844494,16
0.2,9961,93,797175,80.02158201164424,9
0.2,9962,85,797260,80.02208170229851,16
0.2,9963,91,797351,80.02318346045764,13
0.2,9964,94,797445,80.02458605117913,7
0.2,9965,96,797541,80.02618904274533,7
0.2,9966,90,797631,80.02718972609611,11
0.2,9967,92,797723,80.02839085072232,9
0.2,9968,87,797810,80.02909017955662,14
0.2,9969,87,797897,80.02978936810432,16
0.2,9970,18,797915,80.0235683482098,18
0.2,9971,25,797940,80.01805054151625,7
0.2,9972,96,798036,80.01965306327084,6
0.2,9973,96,798132,80.02125526368559,6
0.2,9974,92,798224,80.02245614035088,9
0.2,9975,96,798320,80.02405773857258,6
0.2,9976,18,798338,80.01784103437907,15
0.2,9977,95,798433,80.01934255361796,6
0.2,9978,93,798526,80.02064335103718,8
0.2,9979,92,798618,80.02184368737475,9
0.2,9980,25,798643,80.01633102895501,7
0.2,9981,94,798737,80.01773191745141,7
0.2,9982,89,798826,80.01863167384553,12
0.2,9983,93,798919,80.01993189102564,9
0.2,9984,94,799013,80.021331997997,7
0.2,9985,21,799034,80.01542159022631,11
0.2,9986,94,799128,80.01682186842896,7
0.2,9987,94,799222,80.01822186623949,7
0.2,9988,84,799306,80.01862048253078,17
0.2,9989,23,799329,80.01291291291291,9
0.2,9990,90,799419,80.01391252126915,11
0.2,9991,91,799510,80.01501200960769,10
0.2,9992,93,799603,80.0163114179926,8
0.2,9993,92,799695,80.01751050630378,9
0.2,9994,93,799788,80.01880940470235,8
0.2,9995,94,799882,80.0202080832333,7
0.2,9996,95,799977,80.02170651195358,6
0.2,9997,96,800073,80.02330466093218,6
0.2,9998,96,800169,80.02490249024902,6
0.2,9999,95,800264,80.0264,6
