0.2,0,82,82,82.0,19
0.2,1,-299,-217,-108.5,160
0.2,2,85,-132,-44.0,63
0.2,3,-11,-143,-35.75,96
0.2,4,22,-121,-24.2,38
0.2,5,-88,-209,-34.833333333333336,99
0.2,6,-86,-295,-42.142857142857146,155
0.2,7,-278,-573,-71.625,84
0.2,8,-219,-792,-88.0,384
0.2,9,-9,-801,-80.1,124
0.2,10,-142,-943,-85.72727272727273,108
0.2,11,-61,-1004,-83.66666666666667,64
0.2,12,-281,-1285,-98.84615384615384,265
0.2,13,18,-1267,-90.5,38
0.2,14,84,-1183,-78.86666666666666,73
0.2,15,4,-1179,-73.6875,136
0.2,16,94,-1085,-63.8235294117647,7
0.2,17,11,-1074,-59.666666666666664,92
0.2,18,26,-1048,-55.1578947368421,8
0.2,19,-52,-1100,-55.0,60
0.2,20,80,-1020,-48.57142857142857,39
0.2,21,87,-933,-42.40909090909091,27
0.2,22,86,-847,-36.82608695652174,25
0.2,23,-48,-895,-37.291666666666664,20
0.2,24,26,-869,-34.76,7
0.2,25,16,-853,-32.80769230769231,27
0.2,26,96,-757,-28.037037037037038,6
0.2,27,23,-734,-26.214285714285715,16
0.2,28,90,-644,-22.20689655172414,13
0.2,29,21,-623,-20.766666666666666,18
0.2,30,77,-546,-17.612903225806452,34
0.2,31,94,-452,-14.125,12
0.2,32,93,-359,-10.878787878787879,10
0.2,33,95,-264,-7.764705882352941,7
0.2,34,-46,-310,-8.857142857142858,10
0.2,35,92,-218,-6.055555555555555,10
0.2,36,94,-124,-3.3513513513513513,8
0.2,37,25,-99,-2.6052631578947367,8
0.2,38,94,-5,-0.1282051282051282,8
0.2,39,93,88,2.2,10
0.2,40,91,179,4.365853658536586,10
0.2,41,94,273,6.5,8
0.2,42,26,299,6.953488372093023,7
0.2,43,21,320,7.2727272727272725,13
0.2,44,95,415,9.222222222222221,8
0.2,45,22,437,9.5,11
0.2,46,-45,392,8.340425531914894,9
0.2,47,25,417,8.6875,8
0.2,48,94,511,10.428571428571429,8
0.2,49,92,603,12.06,10
0.2,50,92,695,13.627450980392156,10
0.2,51,88,783,15.057692307692308,14
0.2,52,23,806,15.20754716981132,10
0.2,53,-46,760,14.074074074074074,12
0.2,54,92,852,15.49090909090909,10
0.2,55,-48,804,14.357142857142858,12
0.2,56,91,895,15.701754385964913,13
0.2,57,95,990,17.06896551724138,7
0.2,58,95,1085,18.389830508474578,8
0.2,59,92,1177,19.616666666666667,10
0.2,60,92,1269,20.80327868852459,10
0.2,61,91,1360,21.93548387096774,11
0.2,62,95,1455,23.095238095238095,7
0.2,63,90,1545,24.140625,12
0.2,64,90,1635,25.153846153846153,12
0.2,65,-45,1590,24.09090909090909,9
0.2,66,21,1611,24.044776119402986,12
0.2,67,94,1705,25.073529411764707,8
0.2,68,24,1729,25.057971014492754,12
0.2,69,89,1818,25.97142857142857,13
0.2,70,96,1914,26.95774647887324,6
0.2,71,93,2007,27.875,8
0.2,72,91,2098,28.73972602739726,11
0.2,73,96,2194,29.64864864864865,6
0.2,74,94,2288,30.506666666666668,8
0.2,75,95,2383,31.355263157894736,7
0.2,76,25,2408,31.272727272727273,8
0.2,77,93,2501,32.06410256410256,8
0.2,78,22,2523,31.936708860759495,12
0.2,79,95,2618,32.725,7
0.2,80,94,2712,33.48148148148148,8
0.2,81,93,2805,34.207317073170735,8
0.2,82,94,2899,34.9277108433735,8
0.2,83,27,2926,34.833333333333336,6
0.2,84,24,2950,34.705882352941174,9
0.2,85,94,3044,35.395348837209305,8
0.2,86,95,3139,36.08045977011494,7
0.2,87,95,3234,36.75,6
0.2,88,88,3322,37.325842696629216,13
0.2,89,93,3415,37.94444444444444,9
0.2,90,90,3505,38.51648351648352,13
0.2,91,95,3600,39.130434782608695,7
0.2,92,94,3694,39.72043010752688,9
0.2,93,95,3789,40.308510638297875,6
0.2,94,91,3880,40.8421052631579,11
0.2,95,94,3974,41.395833333333336,7
0.2,96,23,3997,41.20618556701031,12
0.2,97,92,4089,41.724489795918366,10
0.2,98,93,4182,42.24242424242424,9
0.2,99,95,4277,42.77,7
0.2,100,94,4371,43.277227722772274,8
0.2,101,26,4397,43.1078431372549,7
0.2,102,13,4410,42.81553398058252,20
0.2,103,92,4502,43.28846153846154,10
0.2,104,95,4597,43.78095238095238,7
0.2,105,94,4691,44.25471698113208,7
0.2,106,26,4717,44.08411214953271,7
0.2,107,-49,4668,43.22222222222222,12
0.2,108,93,4761,43.678899082568805,10
0.2,109,96,4857,44.154545454545456,6
0.2,110,23,4880,43.96396396396396,10
0.2,111,24,4904,43.785714285714285,9
0.2,112,95,4999,44.23893805309734,7
0.2,113,93,5092,44.666666666666664,8
0.2,114,23,5115,44.47826086956522,10
0.2,115,95,5210,44.91379310344828,6
0.2,116,-46,5164,44.136752136752136,10
0.2,117,26,5190,43.983050847457626,9
0.2,118,22,5212,43.79831932773109,12
0.2,119,93,5305,44.208333333333336,8
0.2,120,21,5326,44.01652892561984,13
0.2,121,-199,5127,42.02459016393443,26
0.2,122,92,5219,42.43089430894309,13
0.2,123,20,5239,42.25,14
0.2,124,95,5334,42.672,7
0.2,125,90,5424,43.04761904761905,12
0.2,126,92,5516,43.43307086614173,10
0.2,127,87,5603,43.7734375,14
0.2,128,20,5623,43.58914728682171,13
0.2,129,95,5718,43.98461538461538,7
0.2,130,93,5811,44.3587786259542,8
0.2,131,16,5827,44.14393939393939,17
0.2,132,26,5853,44.00751879699248,7
0.2,133,95,5948,44.38805970149254,7
0.2,134,96,6044,44.77037037037037,6
0.2,135,94,6138,45.13235294117647,8
0.2,136,93,6231,45.481751824817515,8
0.2,137,91,6322,45.81159420289855,10
0.2,138,94,6416,46.15827338129496,8
0.2,139,95,6511,46.50714285714286,6
0.2,140,93,6604,46.836879432624116,8
0.2,141,95,6699,47.17605633802817,8
0.2,142,94,6793,47.50349650349651,8
0.2,143,93,6886,47.81944444444444,8
0.2,144,94,6980,48.13793103448276,7
0.2,145,94,7074,48.45205479452055,8
0.2,146,24,7098,48.285714285714285,9
0.2,147,90,7188,48.567567567567565,12
0.2,148,95,7283,48.87919463087248,8
0.2,149,-48,7235,48.233333333333334,12
0.2,150,95,7330,48.54304635761589,8
0.2,151,95,7425,48.848684210526315,7
0.2,152,89,7514,49.111111111111114,13
0.2,153,95,7609,49.40909090909091,6
0.2,154,89,7698,49.66451612903226,12
0.2,155,21,7719,49.48076923076923,12
0.2,156,85,7804,49.70700636942675,17
0.2,157,95,7899,49.99367088607595,8
0.2,158,95,7994,50.276729559748425,7
0.2,159,94,8088,50.55,8
0.2,160,94,8182,50.81987577639752,7
0.2,161,92,8274,51.074074074074076,10
0.2,162,89,8363,51.306748466257666,12
0.2,163,93,8456,51.5609756097561,10
0.2,164,94,8550,51.81818181818182,7
0.2,165,96,8646,52.08433734939759,6
0.2,166,93,8739,52.32934131736527,9
0.2,167,92,8831,52.56547619047619,10
0.2,168,93,8924,52.80473372781065,9
0.2,169,96,9020,53.05882352941177,7
0.2,170,95,9115,53.30409356725146,7
0.2,171,90,9205,53.51744186046512,12
0.2,172,95,9300,53.75722543352601,6
0.2,173,96,9396,54.0,6
0.2,174,10,9406,53.74857142857143,24
0.2,175,90,9496,53.95454545454545,13
0.2,176,22,9518,53.77401129943503,11
0.2,177,96,9614,54.01123595505618,6
0.2,178,96,9710,54.245810055865924,6
0.2,179,92,9802,54.455555555555556,10
0.2,180,92,9894,54.66298342541437,9
0.2,181,95,9989,54.88461538461539,6
0.2,182,96,10085,55.10928961748634,7
0.2,183,95,10180,55.32608695652174,7
0.2,184,92,10272,55.524324324324326,9
0.2,185,93,10365,55.725806451612904,9
0.2,186,93,10458,55.92513368983957,9
0.2,187,92,10550,56.11702127659574,9
0.2,188,95,10645,56.32275132275132,6
0.2,189,95,10740,56.526315789473685,6
0.2,190,18,10758,56.324607329842934,15
0.2,191,92,10850,56.510416666666664,10
0.2,192,96,10946,56.715025906735754,6
0.2,193,95,11041,56.91237113402062,7
0.2,194,24,11065,56.743589743589745,9
0.2,195,96,11161,56.94387755102041,6
0.2,196,90,11251,57.111675126903556,11
0.2,197,23,11274,56.93939393939394,10
0.2,198,26,11300,56.78391959798995,8
0.2,199,85,11385,56.925,16
0.2,200,26,11411,56.77114427860697,7
0.2,201,-45,11366,56.26732673267327,9
0.2,202,94,11460,56.45320197044335,9
0.2,203,95,11555,56.6421568627451,8
0.2,204,95,11650,56.829268292682926,6
0.2,205,85,11735,56.96601941747573,16
0.2,206,23,11758,56.80193236714976,10
0.2,207,94,11852,56.98076923076923,8
0.2,208,93,11945,57.15311004784689,10
0.2,209,95,12040,57.333333333333336,7
0.2,210,22,12062,57.165876777251185,12
0.2,211,91,12153,57.325471698113205,12
0.2,212,95,12248,57.502347417840376,7
0.2,213,93,12341,57.66822429906542,8
0.2,214,26,12367,57.520930232558136,7
0.2,215,-48,12319,57.032407407407405,12
0.2,216,-55,12264,56.516129032258064,20
0.2,217,93,12357,56.68348623853211,9
0.2,218,92,12449,56.84474885844749,11
0.2,219,93,12542,57.00909090909091,8
0.2,220,92,12634,57.16742081447964,10
0.2,221,94,12728,57.333333333333336,8
0.2,222,91,12819,57.48430493273543,11
0.2,223,94,12913,57.64732142857143,8
0.2,224,-52,12861,57.16,15
0.2,225,27,12888,57.02654867256637,6
0.2,226,95,12983,57.19383259911894,6
0.2,227,94,13077,57.35526315789474,8
0.2,228,23,13100,57.20524017467249,11
0.2,229,93,13193,57.36086956521739,9
0.2,230,92,13285,57.510822510822514,11
0.2,231,95,13380,57.672413793103445,7
0.2,232,96,13476,57.836909871244636,6
0.2,233,26,13502,57.7008547008547,7
0.2,234,92,13594,57.8468085106383,9
0.2,235,90,13684,57.983050847457626,13
0.2,236,92,13776,58.12658227848101,9
0.2,237,26,13802,57.99159663865546,6
0.2,238,23,13825,57.84518828451883,12
0.2,239,95,13920,58.0,8
0.2,240,90,14010,58.13278008298755,12
0.2,241,-51,13959,57.68181818181818,17
0.2,242,94,14053,57.83127572016461,7
0.2,243,95,14148,57.98360655737705,8
0.2,244,26,14174,57.85306122448979,7
0.2,245,95,14269,58.00406504065041,7
0.2,246,21,14290,57.85425101214575,12
0.2,247,25,14315,57.721774193548384,8
0.2,248,91,14406,57.855421686746986,12
0.2,249,84,14490,57.96,18
0.2,250,93,14583,58.0996015936255,8
0.2,251,91,14674,58.23015873015873,10
0.2,252,94,14768,58.37154150197628,7
0.2,253,96,14864,58.51968503937008,6
0.2,254,93,14957,58.654901960784315,8
0.2,255,93,15050,58.7890625,9
0.2,256,89,15139,58.90661478599222,13
0.2,257,93,15232,59.03875968992248,9
0.2,258,90,15322,59.15830115830116,11
0.2,259,93,15415,59.28846153846154,8
0.2,260,22,15437,59.1455938697318,11
0.2,261,94,15531,59.278625954198475,9
0.2,262,88,15619,59.38783269961977,17
0.2,263,93,15712,59.515151515151516,8
0.2,264,92,15804,59.637735849056604,9
0.2,265,14,15818,59.46616541353384,20
0.2,266,23,15841,59.329588014981276,10
0.2,267,90,15931,59.44402985074627,14
0.2,268,92,16023,59.56505576208178,11
0.2,269,89,16112,59.67407407407408,16
0.2,270,95,16207,59.80442804428044,8
0.2,271,20,16227,59.658088235294116,12
0.2,272,92,16319,59.776556776556774,10
0.2,273,95,16414,59.90510948905109,7
0.2,274,95,16509,60.03272727272727,8
0.2,275,95,16604,60.15942028985507,6
0.2,276,93,16697,60.27797833935018,8
0.2,277,11,16708,60.10071942446043,21
0.2,278,92,16800,60.215053763440864,9
0.2,279,87,16887,60.31071428571428,14
0.2,280,94,16981,60.430604982206404,7
0.2,281,89,17070,60.53191489361702,12
0.2,282,-120,16950,59.89399293286219,14
0.2,283,95,17045,60.017605633802816,6
0.2,284,93,17138,60.13333333333333,9
0.2,285,93,17231,60.24825174825175,8
0.2,286,95,17326,60.36933797909408,6
0.2,287,90,17416,60.47222222222222,12
0.2,288,93,17509,60.58477508650519,8
0.2,289,90,17599,60.686206896551724,11
0.2,290,93,17692,60.797250859106526,8
0.2,291,27,17719,60.68150684931507,6
0.2,292,92,17811,60.78839590443686,9
0.2,293,91,17902,60.89115646258504,10
0.2,294,95,17997,61.00677966101695,6
0.2,295,92,18089,61.111486486486484,9
0.2,296,93,18182,61.21885521885522,8
0.2,297,21,18203,61.08389261744966,16
0.2,298,-48,18155,60.719063545150505,11
0.2,299,93,18248,60.82666666666667,9
0.2,300,-46,18202,60.47176079734219,10
0.2,301,94,18296,60.58278145695364,8
0.2,302,92,18388,60.68646864686469,9
0.2,303,-52,18336,60.31578947368421,15
0.2,304,95,18431,60.429508196721315,6
0.2,305,94,18525,60.53921568627451,7
0.2,306,93,18618,60.644951140065146,8
0.2,307,94,18712,60.753246753246756,7
0.2,308,20,18732,60.62135922330097,12
0.2,309,93,18825,60.725806451612904,9
0.2,310,87,18912,60.81028938906753,15
0.2,311,90,19002,60.90384615384615,11
0.2,312,91,19093,61.0,10
0.2,313,93,19186,61.10191082802548,8
0.2,314,96,19282,61.212698412698415,6
0.2,315,93,19375,61.313291139240505,8
0.2,316,93,19468,61.413249211356465,8
0.2,317,83,19551,61.4811320754717,18
0.2,318,96,19647,61.58934169278997,6
0.2,319,19,19666,61.45625,14
0.2,320,89,19755,61.54205607476636,12
0.2,321,95,19850,61.64596273291925,6
0.2,322,90,19940,61.73374613003096,11
0.2,323,89,20029,61.8179012345679,12
0.2,324,94,20123,61.91692307692308,7
0.2,325,93,20216,62.012269938650306,8
0.2,326,91,20307,62.10091743119266,10
0.2,327,89,20396,62.18292682926829,12
0.2,328,93,20489,62.276595744680854,10
0.2,329,92,20581,62.36666666666667,10
0.2,330,90,20671,62.45015105740181,13
0.2,331,95,20766,62.54819277108434,6
0.2,332,95,20861,62.645645645645644,6
0.2,333,91,20952,62.73053892215569,10
0.2,334,96,21048,62.829850746268654,6
0.2,335,24,21072,62.714285714285715,8
0.2,336,93,21165,62.804154302670625,8
0.2,337,92,21257,62.8905325443787,9
0.2,338,93,21350,62.97935103244838,9
0.2,339,93,21443,63.06764705882353,8
0.2,340,89,21532,63.143695014662754,13
0.2,341,88,21620,63.21637426900585,13
0.2,342,27,21647,63.11078717201166,6
0.2,343,21,21668,62.98837209302326,11
0.2,344,93,21761,63.07536231884058,9
0.2,345,94,21855,63.164739884393065,7
0.2,346,93,21948,63.2507204610951,8
0.2,347,92,22040,63.333333333333336,9
0.2,348,94,22134,63.421203438395416,8
0.2,349,92,22226,63.502857142857145,9
0.2,350,95,22321,63.592592592592595,7
0.2,351,93,22414,63.67613636363637,8
0.2,352,94,22508,63.76203966005666,7
0.2,353,95,22603,63.85028248587571,6
0.2,354,20,22623,63.72676056338028,12
0.2,355,94,22717,63.811797752808985,7
0.2,356,92,22809,63.890756302521005,10
0.2,357,94,22903,63.97486033519553,7
0.2,358,94,22997,64.05849582172702,7
0.2,359,93,23090,64.13888888888889,8
0.2,360,91,23181,64.21329639889197,10
0.2,361,92,23273,64.29005524861878,9
0.2,362,93,23366,64.36914600550965,9
0.2,363,94,23460,64.45054945054945,7
0.2,364,96,23556,64.53698630136986,6
0.2,365,92,23648,64.6120218579235,11
0.2,366,88,23736,64.6757493188011,13
0.2,367,96,23832,64.76086956521739,6
0.2,368,94,23926,64.84010840108401,7
0.2,369,94,24020,64.91891891891892,7
0.2,370,21,24041,64.80053908355795,11
0.2,371,89,24130,64.86559139784946,12
0.2,372,94,24224,64.94369973190348,7
0.2,373,96,24320,65.02673796791444,6
0.2,374,22,24342,64.912,11
0.2,375,94,24436,64.98936170212765,8
0.2,376,95,24531,65.06896551724138,7
0.2,377,95,24626,65.14814814814815,6
0.2,378,91,24717,65.21635883905013,10
0.2,379,91,24808,65.28421052631579,10
0.2,380,90,24898,65.3490813648294,11
0.2,381,92,24990,65.41884816753927,10
0.2,382,94,25084,65.49347258485639,7
0.2,383,22,25106,65.38020833333333,11
0.2,384,95,25201,65.45714285714286,6
0.2,385,95,25296,65.53367875647669,7
0.2,386,22,25318,65.42118863049096,10
0.2,387,85,25403,65.47164948453609,16
0.2,388,94,25497,65.54498714652956,7
0.2,389,96,25593,65.62307692307692,6
0.2,390,96,25689,65.70076726342711,6
0.2,391,91,25780,65.76530612244898,10
0.2,392,93,25873,65.83460559796438,8
0.2,393,-53,25820,65.53299492385787,16
0.2,394,94,25914,65.60506329113925,7
0.2,395,96,26010,65.68181818181819,6
0.2,396,86,26096,65.73299748110831,15
0.2,397,95,26191,65.80653266331659,6
0.2,398,24,26215,65.70175438596492,9
0.2,399,92,26307,65.7675,9
0.2,400,96,26403,65.8428927680798,6
0.2,401,27,26430,65.74626865671642,6
0.2,402,93,26523,65.81389578163771,8
0.2,403,23,26546,65.70792079207921,9
0.2,404,90,26636,65.7679012345679,11
0.2,405,22,26658,65.66009852216749,10
0.2,406,94,26752,65.72972972972973,8
0.2,407,95,26847,65.80147058823529,6
0.2,408,22,26869,65.69437652811736,10
0.2,409,93,26962,65.7609756097561,8
0.2,410,93,27055,65.82725060827251,8
0.2,411,95,27150,65.89805825242719,6
0.2,412,95,27245,65.9685230024213,6
0.2,413,92,27337,66.03140096618357,9
0.2,414,94,27431,66.09879518072289,9
0.2,415,95,27526,66.16826923076923,6
0.2,416,94,27620,66.23501199040767,7
0.2,417,93,27713,66.29904306220095,8
0.2,418,94,27807,66.36515513126491,8
0.2,419,92,27899,66.42619047619047,9
0.2,420,-126,27773,65.96912114014252,20
0.2,421,95,27868,66.03791469194313,8
0.2,422,92,27960,66.09929078014184,10
0.2,423,92,28052,66.16037735849056,9
0.2,424,95,28147,66.22823529411765,6
0.2,425,94,28241,66.29342723004694,7
0.2,426,92,28333,66.35362997658079,9
0.2,427,96,28429,66.42289719626169,6
0.2,428,20,28449,66.31468531468532,13
0.2,429,92,28541,66.37441860465117,9
0.2,430,93,28634,66.43619489559164,8
0.2,431,95,28729,66.50231481481481,6
0.2,432,25,28754,66.40646651270208,7
0.2,433,94,28848,66.47004608294931,7
0.2,434,93,28941,66.53103448275863,9
0.2,435,95,29036,66.59633027522936,6
0.2,436,95,29131,66.66132723112128,6
0.2,437,94,29225,66.72374429223744,8
0.2,438,94,29319,66.78587699316628,8
0.2,439,25,29344,66.69090909090909,7
0.2,440,93,29437,66.75056689342404,8
0.2,441,94,29531,66.81221719457014,7
0.2,442,94,29625,66.87358916478556,9
0.2,443,23,29648,66.77477477477477,9
0.2,444,93,29741,66.83370786516853,8
0.2,445,90,29831,66.88565022421524,11
0.2,446,93,29924,66.9440715883669,8
0.2,447,95,30019,67.00669642857143,6
0.2,448,95,30114,67.06904231625835,6
0.2,449,94,30208,67.1288888888889,7
0.2,450,90,30298,67.17960088691795,11
0.2,451,23,30321,67.08185840707965,10
0.2,452,89,30410,67.13024282560707,13
0.2,453,96,30506,67.19383259911895,6
0.2,454,27,30533,67.1054945054945,6
0.2,455,93,30626,67.16228070175438,9
0.2,456,85,30711,67.20131291028446,16
0.2,457,94,30805,67.25982532751091,7
0.2,458,94,30899,67.31808278867102,7
0.2,459,21,30920,67.21739130434783,12
0.2,460,90,31010,67.26681127982647,11
0.2,461,92,31102,67.32034632034632,9
0.2,462,94,31196,67.37796976241901,8
0.2,463,94,31290,67.4353448275862,8
0.2,464,95,31385,67.49462365591398,6
0.2,465,27,31412,67.4077253218884,7
0.2,466,23,31435,67.31263383297645,10
0.2,467,93,31528,67.36752136752136,8
0.2,468,90,31618,67.41577825159915,11
0.2,469,95,31713,67.47446808510638,6
0.2,470,94,31807,67.5307855626327,8
0.2,471,92,31899,67.58262711864407,9
0.2,472,89,31988,67.62790697674419,13
0.2,473,-49,31939,67.38185654008439,12
0.2,474,88,32027,67.42526315789473,13
0.2,475,96,32123,67.48529411764706,6
0.2,476,89,32212,67.53039832285116,12
0.2,477,93,32305,67.5836820083682,8
0.2,478,90,32395,67.63048016701461,11
0.2,479,92,32487,67.68125,9
0.2,480,95,32582,67.73804573804574,7
0.2,481,92,32674,67.7883817427386,9
0.2,482,88,32762,67.83022774327122,13
0.2,483,93,32855,67.88223140495867,8
0.2,484,94,32949,67.93608247422681,7
0.2,485,92,33041,67.98559670781893,10
0.2,486,91,33132,68.03285420944559,10
0.2,487,-51,33081,67.7889344262295,14
0.2,488,94,33175,67.84253578732107,7
0.2,489,27,33202,67.7591836734694,6
0.2,490,94,33296,67.81262729124236,7
0.2,491,95,33391,67.8678861788618,6
0.2,492,94,33485,67.920892494929,7
0.2,493,93,33578,67.97165991902834,8
0.2,494,92,33670,68.02020202020202,9
0.2,495,91,33761,68.06653225806451,10
0.2,496,96,33857,68.12273641851107,6
0.2,497,93,33950,68.1726907630522,10
0.2,498,26,33976,68.08817635270542,7
0.2,499,93,34069,68.138,8
0.2,500,23,34092,68.04790419161677,9
0.2,501,94,34186,68.0996015936255,7
0.2,502,86,34272,68.13518886679921,15
0.2,503,95,34367,68.18849206349206,7
0.2,504,87,34454,68.22574257425742,14
0.2,505,-58,34396,67.97628458498023,21
0.2,506,91,34487,68.02169625246549,10
0.2,507,93,34580,68.07086614173228,8
0.2,508,96,34676,68.12573673870334,6
0.2,509,95,34771,68.17843137254901,6
0.2,510,96,34867,68.23287671232876,6
0.2,511,93,34960,68.28125,8
0.2,512,93,35053,68.32943469785575,9
0.2,513,95,35148,68.38132295719845,7
0.2,514,93,35241,68.42912621359223,9
0.2,515,95,35336,68.48062015503876,6
0.2,516,91,35427,68.52417794970987,10
0.2,517,92,35519,68.56949806949807,9
0.2,518,95,35614,68.62042389210019,7
0.2,519,-53,35561,68.38653846153846,16
0.2,520,94,35655,68.43570057581574,7
0.2,521,94,35749,68.48467432950191,8
0.2,522,89,35838,68.52390057361377,12
0.2,523,-49,35789,68.29961832061069,12
0.2,524,93,35882,68.34666666666666,8
0.2,525,95,35977,68.39733840304183,7
0.2,526,94,36071,68.44592030360532,8
0.2,527,95,36166,68.49621212121212,6
0.2,528,88,36254,68.53308128544424,13
0.2,529,88,36342,68.56981132075472,13
0.2,530,92,36434,68.61393596986818,9
0.2,531,90,36524,68.65413533834587,11
0.2,532,93,36617,68.69981238273921,9
0.2,533,95,36712,68.74906367041199,6
0.2,534,88,36800,68.78504672897196,14
0.2,535,95,36895,68.8339552238806,7
0.2,536,94,36989,68.88081936685289,7
0.2,537,24,37013,68.79739776951673,8
0.2,538,90,37103,68.83673469387755,12
0.2,539,92,37195,68.87962962962963,10
0.2,540,94,37289,68.92606284658041,7
0.2,541,19,37308,68.8339483394834,13
0.2,542,22,37330,68.74769797421732,11
0.2,543,94,37424,68.79411764705883,7
0.2,544,95,37519,68.84220183486238,7
0.2,545,88,37607,68.87728937728937,13
0.2,546,90,37697,68.91590493601463,13
0.2,547,94,37791,68.96167883211679,8
0.2,548,93,37884,69.00546448087432,8
0.2,549,91,37975,69.04545454545455,10
0.2,550,91,38066,69.08529945553539,10
0.2,551,22,38088,69.0,13
0.2,552,95,38183,69.04701627486438,6
0.2,553,89,38272,69.08303249097473,12
0.2,554,92,38364,69.12432432432432,9
0.2,555,21,38385,69.03776978417267,11
0.2,556,20,38405,68.94973070017953,12
0.2,557,22,38427,68.86559139784946,10
0.2,558,95,38522,68.91234347048301,6
0.2,559,94,38616,68.95714285714286,7
0.2,560,94,38710,69.0017825311943,7
0.2,561,93,38803,69.04448398576513,8
0.2,562,-56,38747,68.82238010657194,19
0.2,563,84,38831,68.84929078014184,17
0.2,564,95,38926,68.89557522123894,7
0.2,565,95,39021,68.9416961130742,6
0.2,566,92,39113,68.98236331569665,9
0.2,567,92,39205,69.02288732394366,9
0.2,568,91,39296,69.06151142355009,10
0.2,569,93,39389,69.10350877192982,8
0.2,570,14,39403,69.00700525394045,20
0.2,571,93,39496,69.04895104895105,8
0.2,572,91,39587,69.08726003490402,10
0.2,573,93,39680,69.12891986062718,8
0.2,574,90,39770,69.16521739130435,11
0.2,575,90,39860,69.20138888888889,11
0.2,576,94,39954,69.24436741767764,8
0.2,577,93,40047,69.28546712802768,8
0.2,578,95,40142,69.32987910189983,6
0.2,579,94,40236,69.37241379310345,7
0.2,580,-45,40191,69.17555938037866,8
0.2,581,22,40213,69.09450171821305,10
0.2,582,94,40307,69.13722126929675,7
0.2,583,-117,40190,68.81849315068493,12
0.2,584,93,40283,68.85982905982905,8
0.2,585,94,40377,68.90273037542661,7
0.2,586,94,40471,68.94548551959114,8
0.2,587,25,40496,68.87074829931973,8
0.2,588,25,40521,68.79626485568761,8
0.2,589,89,40610,68.83050847457628,12
0.2,590,94,40704,68.8730964467005,7
0.2,591,93,40797,68.91385135135135,8
0.2,592,18,40815,68.82799325463743,14
0.2,593,93,40908,68.86868686868686,8
0.2,594,90,40998,68.90420168067227,11
0.2,595,22,41020,68.8255033557047,11
0.2,596,94,41114,68.8676716917923,8
0.2,597,94,41208,68.90969899665552,7
0.2,598,94,41302,68.95158597662771,7
0.2,599,91,41393,68.98833333333333,12
0.2,600,92,41485,69.02662229617304,10
0.2,601,93,41578,69.06644518272425,9
0.2,602,94,41672,69.1077943615257,7
0.2,603,21,41693,69.02814569536424,11
0.2,604,95,41788,69.07107438016529,7
0.2,605,94,41882,69.11221122112211,7
0.2,606,93,41975,69.15156507413509,8
0.2,607,89,42064,69.1842105263158,12
0.2,608,89,42153,69.21674876847291,13
0.2,609,89,42242,69.24918032786886,13
0.2,610,91,42333,69.2847790507365,10
0.2,611,87,42420,69.31372549019608,14
0.2,612,92,42512,69.35073409461664,9
0.2,613,20,42532,69.27035830618892,15
0.2,614,95,42627,69.31219512195122,6
0.2,615,94,42721,69.35227272727273,7
0.2,616,91,42812,69.38735818476499,10
0.2,617,92,42904,69.42394822006473,9
0.2,618,95,42999,69.46526655896608,6
0.2,619,91,43090,69.5,11
0.2,620,96,43186,69.5426731078905,6
0.2,621,90,43276,69.57556270096462,11
0.2,622,95,43371,69.61637239165329,7
0.2,623,93,43464,69.65384615384616,8
0.2,624,95,43559,69.6944,7
0.2,625,93,43652,69.73162939297124,10
0.2,626,93,43745,69.76874003189792,8
0.2,627,23,43768,69.69426751592357,10
0.2,628,96,43864,69.73608903020667,6
0.2,629,96,43960,69.77777777777777,6
0.2,630,94,44054,69.81616481774961,7
0.2,631,95,44149,69.85601265822785,8
0.2,632,92,44241,69.8909952606635,10
0.2,633,93,44334,69.92744479495268,9
0.2,634,94,44428,69.96535433070866,7
0.2,635,95,44523,70.00471698113208,8
0.2,636,23,44546,69.9309262166405,9
0.2,637,94,44640,69.96865203761756,8
0.2,638,95,44735,70.00782472613459,7
0.2,639,23,44758,69.934375,9
0.2,640,90,44848,69.96567862714508,11
0.2,641,95,44943,70.00467289719626,7
0.2,642,94,45037,70.04199066874028,7
0.2,643,94,45131,70.07919254658385,8
0.2,644,92,45223,70.11317829457364,9
0.2,645,95,45318,70.15170278637771,6
0.2,646,96,45414,70.19165378670789,6
0.2,647,91,45505,70.22376543209876,10
0.2,648,-122,45383,69.92758089368259,18
0.2,649,17,45400,69.84615384615384,16
0.2,650,85,45485,69.86943164362519,16
0.2,651,92,45577,69.90337423312883,9
0.2,652,94,45671,69.94027565084227,8
0.2,653,90,45761,69.97094801223241,11
0.2,654,96,45857,70.01068702290077,6
0.2,655,91,45948,70.04268292682927,10
0.2,656,89,46037,70.07153729071537,12
0.2,657,93,46130,70.1063829787234,8
0.2,658,93,46223,70.14112291350531,9
0.2,659,94,46317,70.17727272727272,8
0.2,660,92,46409,70.21028744326777,11
0.2,661,-46,46363,70.03474320241692,10
0.2,662,95,46458,70.07239819004525,6
0.2,663,89,46547,70.10090361445783,12
0.2,664,90,46637,70.13082706766917,11
0.2,665,85,46722,70.15315315315316,16
0.2,666,89,46811,70.18140929535232,12
0.2,667,91,46902,70.2125748502994,11
0.2,668,24,46926,70.14349775784753,9
0.2,669,90,47016,70.1731343283582,11
0.2,670,26,47042,70.10730253353204,7
0.2,671,95,47137,70.14434523809524,6
0.2,672,93,47230,70.17830609212481,10
0.2,673,89,47319,70.20623145400593,12
0.2,674,94,47413,70.24148148148149,8
0.2,675,95,47508,70.27810650887574,7
0.2,676,96,47604,70.31610044313146,6
0.2,677,95,47699,70.35250737463127,7
0.2,678,91,47790,70.38291605301914,10
0.2,679,93,47883,70.41617647058824,8
0.2,680,17,47900,70.33773861967694,16
0.2,681,90,47990,70.366568914956,12
0.2,682,93,48083,70.39970717423134,8
0.2,683,94,48177,70.4342105263158,7
0.2,684,93,48270,70.46715328467154,8
0.2,685,95,48365,70.50291545189505,6
0.2,686,95,48460,70.53857350800583,6
0.2,687,18,48478,70.46220930232558,14
0.2,688,92,48570,70.49346879535558,9
0.2,689,92,48662,70.52463768115942,10
0.2,690,93,48755,70.55716353111433,8
0.2,691,92,48847,70.58815028901734,9
0.2,692,92,48939,70.61904761904762,9
0.2,693,21,48960,70.54755043227665,11
0.2,694,93,49053,70.57985611510792,8
0.2,695,95,49148,70.61494252873563,6
0.2,696,94,49242,70.64849354375897,7
0.2,697,88,49330,70.67335243553009,13
0.2,698,89,49419,70.69957081545064,12
0.2,699,93,49512,70.73142857142857,9
0.2,700,88,49600,70.75606276747503,13
0.2,701,15,49615,70.67663817663818,17
0.2,702,94,49709,70.70981507823613,8
0.2,703,92,49801,70.74005681818181,9
0.2,704,90,49891,70.76737588652482,11
0.2,705,88,49979,70.79178470254958,14
0.2,706,85,50064,70.81188118811882,16
0.2,707,96,50160,70.84745762711864,6
0.2,708,96,50256,70.88293370944993,6
0.2,709,93,50349,70.91408450704225,8
0.2,710,90,50439,70.94092827004219,13
0.2,711,89,50528,70.96629213483146,12
0.2,712,17,50545,70.89060308555399,15
0.2,713,92,50637,70.9201680672269,9
0.2,714,90,50727,70.94685314685314,11
0.2,715,-49,50678,70.77932960893855,15
0.2,716,89,50767,70.8047419804742,12
0.2,717,95,50862,70.83844011142061,6
0.2,718,91,50953,70.86648122392211,10
0.2,719,96,51049,70.90138888888889,7
0.2,720,94,51143,70.93342579750346,7
0.2,721,95,51238,70.96675900277009,7
0.2,722,25,51263,70.90318118948824,8
0.2,723,88,51351,70.9267955801105,14
0.2,724,92,51443,70.95586206896552,9
0.2,725,92,51535,70.98484848484848,10
0.2,726,94,51629,71.01650618982119,7
0.2,727,94,51723,71.04807692307692,8
0.2,728,96,51819,71.08230452674897,6
0.2,729,95,51914,71.11506849315069,6
0.2,730,91,52005,71.14227086183311,10
0.2,731,94,52099,71.17349726775956,7
0.2,732,94,52193,71.20463847203274,7
0.2,733,92,52285,71.23297002724796,11
0.2,734,95,52380,71.26530612244898,7
0.2,735,95,52475,71.2975543478261,6
0.2,736,94,52569,71.32835820895522,7
0.2,737,94,52663,71.35907859078591,7
0.2,738,93,52756,71.38836265223274,9
0.2,739,91,52847,71.41486486486487,10
0.2,740,94,52941,71.44534412955466,7
0.2,741,87,53028,71.46630727762803,14
0.2,742,93,53121,71.49528936742934,9
0.2,743,95,53216,71.52688172043011,7
0.2,744,95,53311,71.55838926174496,7
0.2,745,95,53406,71.58981233243968,7
0.2,746,93,53499,71.61847389558233,8
0.2,747,95,53594,71.64973262032086,6
0.2,748,89,53683,71.67289719626169,13
0.2,749,96,53779,71.70533333333333,6
0.2,750,94,53873,71.73501997336884,7
0.2,751,77,53950,71.74202127659575,24
0.2,752,95,54045,71.77290836653387,6
0.2,753,95,54140,71.80371352785146,8
0.2,754,94,54234,71.83311258278145,7
0.2,755,95,54329,71.8637566137566,6
0.2,756,93,54422,71.89167767503302,8
0.2,757,26,54448,71.8311345646438,8
0.2,758,88,54536,71.85243741765481,14
0.2,759,88,54624,71.87368421052632,13
0.2,760,93,54717,71.90144546649145,9
0.2,761,92,54809,71.92782152230971,11
0.2,762,24,54833,71.86500655307995,9
0.2,763,93,54926,71.89267015706807,8
0.2,764,22,54948,71.82745098039216,11
0.2,765,21,54969,71.76109660574413,11
0.2,766,92,55061,71.78748370273794,9
0.2,767,95,55156,71.81770833333333,6
0.2,768,92,55248,71.84395318595578,9
0.2,769,94,55342,71.87272727272727,7
0.2,770,94,55436,71.90142671854734,8
0.2,771,93,55529,71.92875647668394,9
0.2,772,92,55621,71.95472186287192,10
0.2,773,93,55714,71.98191214470285,8
0.2,774,93,55807,72.00903225806452,8
0.2,775,94,55901,72.03737113402062,7
0.2,776,93,55994,72.06435006435007,10
0.2,777,91,56085,72.08868894601542,10
0.2,778,93,56178,72.11553273427471,8
0.2,779,96,56274,72.14615384615385,6
0.2,780,90,56364,72.16901408450704,11
0.2,781,95,56459,72.19820971867007,7
0.2,782,93,56552,72.22477650063857,8
0.2,783,23,56575,72.16198979591837,9
0.2,784,21,56596,72.0968152866242,11
0.2,785,18,56614,72.02798982188295,14
0.2,786,94,56708,72.0559085133418,7
0.2,787,94,56802,72.08375634517766,7
0.2,788,18,56820,72.01520912547528,14
0.2,789,93,56913,72.04177215189874,8
0.2,790,92,57005,72.0670037926675,9
0.2,791,94,57099,72.09469696969697,7
0.2,792,20,57119,72.02900378310214,12
0.2,793,93,57212,72.05541561712846,8
0.2,794,24,57236,71.99496855345912,10
0.2,795,85,57321,72.01130653266331,16
0.2,796,95,57416,72.04015056461732,6
0.2,797,92,57508,72.06516290726817,9
0.2,798,92,57600,72.090112640801,9
0.2,799,94,57694,72.1175,8
0.2,800,90,57784,72.1398252184769,11
0.2,801,88,57872,72.15960099750623,13
0.2,802,93,57965,72.18555417185554,9
0.2,803,93,58058,72.21144278606965,8
0.2,804,93,58151,72.23726708074534,8
0.2,805,92,58243,72.26178660049628,9
0.2,806,21,58264,72.19826517967782,13
0.2,807,83,58347,72.21163366336634,18
0.2,808,95,58442,72.2398022249691,7
0.2,809,27,58469,72.18395061728395,6
0.2,810,95,58564,72.21208384710235,8
0.2,811,90,58654,72.23399014778325,11
0.2,812,93,58747,72.25953259532595,8
0.2,813,94,58841,72.28624078624078,7
0.2,814,93,58934,72.31165644171779,9
0.2,815,96,59030,72.3406862745098,6
0.2,816,90,59120,72.36230110159119,11
0.2,817,92,59212,72.38630806845966,9
0.2,818,26,59238,72.32967032967034,7
0.2,819,94,59332,72.35609756097561,8
0.2,820,26,59358,72.29963459196102,7
0.2,821,26,59384,72.2433090024331,8
0.2,822,86,59470,72.26002430133657,15
0.2,823,95,59565,72.2876213592233,6
0.2,824,91,59656,72.31030303030303,10
0.2,825,92,59748,72.33414043583535,10
0.2,826,94,59842,72.36033857315599,7
0.2,827,95,59937,72.3876811594203,6
0.2,828,94,60031,72.41375150784077,7
0.2,829,93,60124,72.43855421686747,8
0.2,830,94,60218,72.46450060168472,10
0.2,831,94,60312,72.49038461538461,8
0.2,832,94,60406,72.51620648259303,7
0.2,833,96,60502,72.54436450839329,7
0.2,834,24,60526,72.48622754491018,8
0.2,835,92,60618,72.50956937799043,10
0.2,836,95,60713,72.53643966547192,6
0.2,837,94,60807,72.56205250596659,7
0.2,838,94,60901,72.58760429082241,7
0.2,839,94,60995,72.61309523809524,7
0.2,840,93,61088,72.63733650416171,8
0.2,841,88,61176,72.65558194774347,17
0.2,842,89,61265,72.6749703440095,12
0.2,843,94,61359,72.70023696682465,9
0.2,844,91,61450,72.72189349112426,10
0.2,845,91,61541,72.74349881796691,10
0.2,846,93,61634,72.76741440377803,8
0.2,847,88,61722,72.78537735849056,14
0.2,848,-47,61675,72.64428739693757,12
0.2,849,95,61770,72.67058823529412,6
0.2,850,93,61863,72.69447708578143,9
0.2,851,93,61956,72.71830985915493,8
0.2,852,25,61981,72.66236811254396,8
0.2,853,93,62074,72.68618266978923,8
0.2,854,95,62169,72.71228070175438,6
0.2,855,-51,62118,72.5677570093458,14
0.2,856,26,62144,72.51341890315052,7
0.2,857,94,62238,72.53846153846153,7
0.2,858,92,62330,72.56111757857974,9
0.2,859,24,62354,72.5046511627907,9
0.2,860,94,62448,72.52961672473867,7
0.2,861,90,62538,72.54988399071925,12
0.2,862,92,62630,72.57242178447277,9
0.2,863,25,62655,72.51736111111111,9
0.2,864,94,62749,72.5421965317919,7
0.2,865,86,62835,72.55773672055427,17
0.2,866,93,62928,72.58131487889273,10
0.2,867,91,63019,72.60253456221199,12
0.2,868,87,63106,72.61910241657077,14
0.2,869,95,63201,72.6448275862069,6
0.2,870,91,63292,72.6659012629162,10
0.2,871,94,63386,72.69036697247707,7
0.2,872,94,63480,72.7147766323024,7
0.2,873,95,63575,72.74027459954233,6
0.2,874,94,63669,72.76457142857143,8
0.2,875,93,63762,72.78767123287672,8
0.2,876,91,63853,72.8084378563284,12
0.2,877,-48,63805,72.67084282460137,11
0.2,878,92,63897,72.69283276450511,10
0.2,879,89,63986,72.71136363636364,12
0.2,880,16,64002,72.64699205448355,16
0.2,881,23,64025,72.5907029478458,10
0.2,882,93,64118,72.61381653454134,8
0.2,883,93,64211,72.6368778280543,8
0.2,884,94,64305,72.66101694915254,8
0.2,885,90,64395,72.68058690744921,11
0.2,886,91,64486,72.70124013528749,10
0.2,887,87,64573,72.71734234234235,14
0.2,888,90,64663,72.73678290213724,11
0.2,889,93,64756,72.75955056179775,8
0.2,890,91,64847,72.78002244668912,11
0.2,891,93,64940,72.80269058295964,9
0.2,892,94,65034,72.82642777155655,7
0.2,893,93,65127,72.8489932885906,8
0.2,894,92,65219,72.87039106145251,9
0.2,895,96,65315,72.89620535714286,6
0.2,896,96,65411,72.92196209587514,6
0.2,897,93,65504,72.94432071269487,8
0.2,898,26,65530,72.89210233592881,8
0.2,899,93,65623,72.91444444444444,8
0.2,900,93,65716,72.93673695893452,8
0.2,901,92,65808,72.95787139689578,9
0.2,902,94,65902,72.9811738648948,8
0.2,903,95,65997,73.00553097345133,6
0.2,904,95,66092,73.02983425414365,6
0.2,905,95,66187,73.0540838852097,6
0.2,906,94,66281,73.07717750826902,7
0.2,907,93,66374,73.09911894273128,8
0.2,908,92,66466,73.11991199119912,9
0.2,909,-51,66415,72.98351648351648,14
0.2,910,96,66511,73.00878155872667,6
0.2,911,22,66533,72.95285087719299,10
0.2,912,95,66628,72.97699890470975,6
0.2,913,87,66715,72.99234135667396,14
0.2,914,-57,66658,72.85027322404372,20
0.2,915,95,66753,72.87445414847161,7
0.2,916,90,66843,72.89312977099236,12
0.2,917,15,66858,72.83006535947712,17
0.2,918,87,66945,72.84548422198041,14
0.2,919,23,66968,72.79130434782608,9
0.2,920,92,67060,72.81216069489685,10
0.2,921,96,67156,72.83731019522777,6
0.2,922,91,67247,72.8569880823402,10
0.2,923,94,67341,72.87987012987013,7
0.2,924,90,67431,72.89837837837838,11
0.2,925,94,67525,72.92116630669547,7
0.2,926,93,67618,72.9428263214671,9
0.2,927,95,67713,72.9665948275862,8
0.2,928,94,67807,72.98923573735199,7
0.2,929,18,67825,72.93010752688173,15
0.2,930,90,67915,72.9484425349087,11
0.2,931,94,68009,72.97103004291846,7
0.2,932,91,68100,72.9903536977492,10
0.2,933,22,68122,72.93576017130621,10
0.2,934,88,68210,72.95187165775401,13
0.2,935,95,68305,72.97542735042735,6
0.2,936,90,68395,72.99359658484525,11
0.2,937,-52,68343,72.86034115138592,16
0.2,938,92,68435,72.88072417465389,9
0.2,939,96,68531,72.90531914893617,6
0.2,940,91,68622,72.92454835281616,12
0.2,941,94,68716,72.94692144373673,7
0.2,942,94,68810,72.96924708377519,7
0.2,943,92,68902,72.98940677966101,9
0.2,944,94,68996,73.01164021164021,7
0.2,945,94,69090,73.0338266384778,7
0.2,946,94,69184,73.0559662090813,8
0.2,947,93,69277,73.07700421940929,8
0.2,948,26,69303,73.02739726027397,7
0.2,949,87,69390,73.0421052631579,16
0.2,950,93,69483,73.06309148264984,8
0.2,951,89,69572,73.0798319327731,12
0.2,952,95,69667,73.10283315844701,6
0.2,953,93,69760,73.12368972746332,8
0.2,954,90,69850,73.1413612565445,11
0.2,955,88,69938,73.15690376569037,13
0.2,956,92,70030,73.17659352142111,9
0.2,957,95,70125,73.19937369519833,6
0.2,958,89,70214,73.21584984358707,12
0.2,959,93,70307,73.23645833333333,9
0.2,960,94,70401,73.25806451612904,7
0.2,961,90,70491,73.27546777546777,12
0.2,962,21,70512,73.22118380062305,11
0.2,963,92,70604,73.24066390041494,9
0.2,964,-125,70479,73.03523316062176,19
0.2,965,92,70571,73.05486542443064,9
0.2,966,23,70594,73.00310237849017,9
0.2,967,96,70690,73.02685950413223,6
0.2,968,95,70785,73.04953560371517,8
0.2,969,20,70805,72.99484536082474,12
0.2,970,94,70899,73.01647785787847,7
0.2,971,90,70989,73.03395061728395,11
0.2,972,88,71077,73.04933196300102,13
0.2,973,94,71171,73.07084188911705,8
0.2,974,91,71262,73.08923076923077,10
0.2,975,90,71352,73.10655737704919,12
0.2,976,26,71378,73.05834186284544,7
0.2,977,94,71472,73.079754601227,7
0.2,978,95,71567,73.10214504596527,6
0.2,979,96,71663,73.12551020408164,6
0.2,980,94,71757,73.14678899082568,7
0.2,981,91,71848,73.16496945010184,10
0.2,982,95,71943,73.18718209562563,6
0.2,983,92,72035,73.20630081300813,9
0.2,984,91,72126,73.22436548223351,10
0.2,985,96,72222,73.2474645030426,6
0.2,986,21,72243,73.19452887537994,12
0.2,987,24,72267,73.14473684210526,8
0.2,988,27,72294,73.09807886754297,6
0.2,989,94,72388,73.11919191919192,7
0.2,990,96,72484,73.14228052472251,6
0.2,991,93,72577,73.16229838709677,8
0.2,992,-48,72529,73.04028197381672,11
0.2,993,23,72552,72.98993963782696,9
0.2,994,96,72648,73.01306532663317,6
0.2,995,90,72738,73.03012048192771,11
0.2,996,26,72764,72.98294884653961,6
0.2,997,96,72860,73.00601202404809,6
0.2,998,92,72952,73.02502502502503,9
0.2,999,92,73044,73.044,9
0.2,1000,95,73139,73.06593406593407,7
0.2,1001,92,73231,73.08483033932136,9
0.2,1002,96,73327,73.10767696909272,6
0.2,1003,87,73414,73.12151394422311,14
0.2,1004,92,73506,73.14029850746269,9
0.2,1005,94,73600,73.1610337972167,7
0.2,1006,95,73695,73.18272095332671,6
0.2,1007,95,73790,73.20436507936508,7
0.2,1008,21,73811,73.15262636273538,12
0.2,1009,93,73904,73.17227722772277,8
0.2,1010,22,73926,73.12166172106825,10
0.2,1011,89,74015,73.13735177865613,12
0.2,1012,96,74111,73.1599210266535,6
0.2,1013,95,74206,73.18145956607495,7
0.2,1014,89,74295,73.19704433497537,12
0.2,1015,-60,74235,73.06594488188976,23
0.2,1016,95,74330,73.08751229105211,6
0.2,1017,23,74353,73.03831041257368,10
0.2,1018,94,74447,73.05888125613346,7
0.2,1019,24,74471,73.0107843137255,9
0.2,1020,27,74498,72.96571988246816,7
0.2,1021,92,74590,72.98434442270059,9
0.2,1022,16,74606,72.92864125122189,16
0.2,1023,93,74699,72.9482421875,9
0.2,1024,92,74791,72.96682926829268,9
0.2,1025,91,74882,72.98440545808967,10
0.2,1026,93,74975,73.00389483933787,8
0.2,1027,26,75001,72.95817120622569,6
0.2,1028,21,75022,72.90767735665695,11
0.2,1029,25,75047,72.86116504854368,8
0.2,1030,92,75139,72.87972841901068,9
0.2,1031,95,75234,72.90116279069767,6
0.2,1032,93,75327,72.92061955469507,8
0.2,1033,91,75418,72.93810444874275,10
0.2,1034,25,75443,72.89178743961352,8
0.2,1035,95,75538,72.91312741312741,6
0.2,1036,89,75627,72.92864030858244,12
0.2,1037,95,75722,72.94990366088632,7
0.2,1038,94,75816,72.97016361886429,7
0.2,1039,93,75909,72.98942307692307,8
0.2,1040,91,76000,73.00672430355428,10
0.2,1041,92,76092,73.02495201535508,9
0.2,1042,22,76114,72.97603068072867,10
0.2,1043,92,76206,72.99425287356321,9
0.2,1044,-115,76091,72.81435406698564,11
0.2,1045,95,76186,72.83556405353728,6
0.2,1046,94,76280,72.85577841451767,7
0.2,1047,94,76374,72.87595419847328,8
0.2,1048,90,76464,72.89227836034318,11
0.2,1049,94,76558,72.91238095238096,7
0.2,1050,89,76647,72.92768791627022,12
0.2,1051,94,76741,72.9477186311787,7
0.2,1052,26,76767,72.9031339031339,7
0.2,1053,94,76861,72.92314990512334,8
0.2,1054,94,76955,72.94312796208531,7
0.2,1055,85,77040,72.95454545454545,18
0.2,1056,90,77130,72.97067171239357,11
0.2,1057,95,77225,72.9914933837429,6
0.2,1058,-53,77172,72.87252124645893,16
0.2,1059,94,77266,72.89245283018867,7
0.2,1060,94,77360,72.91234684260132,8
0.2,1061,93,77453,72.93126177024482,9
0.2,1062,94,77547,72.9510818438382,7
0.2,1063,89,77636,72.96616541353383,12
0.2,1064,96,77732,72.98779342723005,7
0.2,1065,94,77826,73.00750469043152,7
0.2,1066,93,77919,73.02624179943767,8
0.2,1067,92,78011,73.0440074906367,9
0.2,1068,94,78105,73.06361085126287,8
0.2,1069,25,78130,73.01869158878505,8
0.2,1070,93,78223,73.03734827264239,8
0.2,1071,94,78317,73.05690298507463,11
0.2,1072,88,78405,73.0708294501398,13
0.2,1073,85,78490,73.08193668528864,16
0.2,1074,20,78510,73.03255813953488,12
0.2,1075,95,78605,73.05297397769517,6
0.2,1076,89,78694,73.0677808727948,12
0.2,1077,95,78789,73.08812615955473,6
0.2,1078,21,78810,73.03985171455051,13
0.2,1079,93,78903,73.05833333333334,8
0.2,1080,89,78992,73.07308048103607,12
0.2,1081,92,79084,73.090573012939,10
0.2,1082,87,79171,73.1034164358264,14
0.2,1083,94,79265,73.12269372693727,7
0.2,1084,95,79360,73.14285714285714,6
0.2,1085,94,79454,73.16206261510129,7
0.2,1086,91,79545,73.17847286108555,10
0.2,1087,92,79637,73.19577205882354,9
0.2,1088,94,79731,73.21487603305785,7
0.2,1089,91,79822,73.23119266055046,10
0.2,1090,94,79916,73.25022914757103,7
0.2,1091,94,80010,73.26923076923077,7
0.2,1092,95,80105,73.28911253430924,6
0.2,1093,92,80197,73.30621572212065,9
0.2,1094,96,80293,73.32694063926941,6
0.2,1095,94,80387,73.34580291970804,7
0.2,1096,92,80479,73.36280765724703,9
0.2,1097,20,80499,73.31420765027322,14
0.2,1098,92,80591,73.3312101910828,9
0.2,1099,95,80686,73.35090909090908,6
0.2,1100,19,80705,73.30154405086286,14
0.2,1101,92,80797,73.31851179673322,9
0.2,1102,95,80892,73.33816863100634,6
0.2,1103,19,80911,73.28894927536231,13
0.2,1104,89,81000,73.30316742081448,12
0.2,1105,94,81094,73.32188065099457,7
0.2,1106,25,81119,73.27822944896116,9
0.2,1107,94,81213,73.29693140794224,7
0.2,1108,87,81300,73.3092876465284,15
0.2,1109,90,81390,73.32432432432432,11
0.2,1110,94,81484,73.34293429342934,8
0.2,1111,95,81579,73.36241007194245,7
0.2,1112,94,81673,73.38095238095238,7
0.2,1113,94,81767,73.39946140035907,7
0.2,1114,94,81861,73.41793721973094,7
0.2,1115,91,81952,73.4336917562724,10
0.2,1116,95,82047,73.45299910474485,6
0.2,1117,95,82142,73.47227191413238,7
0.2,1118,23,82165,73.42716711349419,10
0.2,1119,88,82253,73.44017857142858,13
0.2,1120,94,82347,73.45851917930419,7
0.2,1121,93,82440,73.475935828877,9
0.2,1122,93,82533,73.49332146037399,8
0.2,1123,93,82626,73.51067615658363,8
0.2,1124,94,82720,73.52888888888889,7
0.2,1125,93,82813,73.5461811722913,8
0.2,1126,25,82838,73.5031055900621,8
0.2,1127,95,82933,73.52216312056737,6
0.2,1128,23,82956,73.47741364038973,9
0.2,1129,22,82978,73.43185840707964,10
0.2,1130,95,83073,73.45092838196287,7
0.2,1131,94,83167,73.46908127208481,7
0.2,1132,94,83261,73.48720211827008,7
0.2,1133,92,83353,73.50352733686067,10
0.2,1134,92,83445,73.51982378854626,9
0.2,1135,22,83467,73.47447183098592,11
0.2,1136,94,83561,73.49252418645558,8
0.2,1137,22,83583,73.44727592267135,11
0.2,1138,91,83674,73.46268656716418,10
0.2,1139,94,83768,73.48070175438596,8
0.2,1140,94,83862,73.49868536371604,7
0.2,1141,94,83956,73.51663747810858,7
0.2,1142,93,84049,73.53368328958881,8
0.2,1143,95,84144,73.55244755244755,7
0.2,1144,93,84237,73.56943231441048,10
0.2,1145,89,84326,73.58289703315882,12
0.2,1146,18,84344,73.53443766346992,14
0.2,1147,-51,84293,73.42595818815332,14
0.2,1148,94,84387,73.44386422976501,8
0.2,1149,96,84483,73.46347826086956,6
0.2,1150,93,84576,73.48045178105995,8
0.2,1151,-57,84519,73.3671875,20
0.2,1152,94,84613,73.38508239375543,7
0.2,1153,22,84635,73.34055459272098,12
0.2,1154,23,84658,73.2969696969697,10
0.2,1155,93,84751,73.31401384083046,8
0.2,1156,22,84773,73.26966292134831,13
0.2,1157,90,84863,73.28411053540587,11
0.2,1158,96,84959,73.3037100949094,6
0.2,1159,26,84985,73.26293103448276,7
0.2,1160,94,85079,73.2807924203273,7
0.2,1161,92,85171,73.29690189328744,9
0.2,1162,18,85189,73.2493551160791,14
0.2,1163,94,85283,73.26718213058419,7
0.2,1164,89,85372,73.28068669527897,12
0.2,1165,27,85399,73.2409948542024,7
0.2,1166,92,85491,73.25706940874036,9
0.2,1167,94,85585,73.27482876712328,7
0.2,1168,93,85678,73.29170230966638,8
0.2,1169,96,85774,73.31111111111112,6
0.2,1170,90,85864,73.32536293766012,11
0.2,1171,92,85956,73.34129692832765,9
0.2,1172,96,86052,73.36061381074168,6
0.2,1173,94,86146,73.37819420783646,7
0.2,1174,94,86240,73.39574468085107,8
0.2,1175,92,86332,73.41156462585035,9
0.2,1176,94,86426,73.42905692438403,8
0.2,1177,94,86520,73.446519524618,8
0.2,1178,92,86612,73.46225614927906,9
0.2,1179,92,86704,73.47796610169492,10
0.2,1180,22,86726,73.43437764606266,10
0.2,1181,92,86818,73.45008460236886,9
0.2,1182,26,86844,73.40997464074387,10
0.2,1183,92,86936,73.42567567567568,9
0.2,1184,23,86959,73.3831223628692,9
0.2,1185,94,87053,73.40050590219224,7
0.2,1186,88,87141,73.41280539174389,13
0.2,1187,88,87229,73.42508417508418,14
0.2,1188,93,87322,73.44154751892347,8
0.2,1189,90,87412,73.45546218487395,12
0.2,1190,95,87507,73.4735516372796,6
0.2,1191,93,87600,73.48993288590604,10
0.2,1192,27,87627,73.45096395641241,6
0.2,1193,94,87721,73.46817420435511,9
0.2,1194,89,87810,73.48117154811716,12
0.2,1195,96,87906,73.5,6
0.2,1196,94,88000,73.5171261487051,7
0.2,1197,93,88093,73.53338898163607,8
0.2,1198,93,88186,73.54962468723937,8
0.2,1199,90,88276,73.56333333333333,11
0.2,1200,15,88291,73.51457119067443,17
0.2,1201,94,88385,73.53161397670549,7
0.2,1202,92,88477,73.546965918537,9
0.2,1203,95,88572,73.56478405315615,7
0.2,1204,20,88592,73.52033195020746,12
0.2,1205,89,88681,73.53316749585406,12
0.2,1206,91,88772,73.54763877381939,11
0.2,1207,91,88863,73.56208609271523,10
0.2,1208,94,88957,73.57899090157154,7
0.2,1209,95,89052,73.59669421487604,6
0.2,1210,90,89142,73.61023947151115,11
0.2,1211,95,89237,73.62788778877888,7
0.2,1212,23,89260,73.58615004122012,10
0.2,1213,96,89356,73.60461285008238,6
0.2,1214,89,89445,73.61728395061728,15
0.2,1215,94,89539,73.63404605263158,8
0.2,1216,95,89634,73.65160230073953,6
0.2,1217,21,89655,73.60837438423646,12
0.2,1218,94,89749,73.6251025430681,7
0.2,1219,95,89844,73.64262295081967,6
0.2,1220,94,89938,73.65929565929567,7
0.2,1221,95,90033,73.67675941080196,6
0.2,1222,90,90123,73.69010629599346,12
0.2,1223,14,90137,73.64133986928104,18
0.2,1224,21,90158,73.59836734693877,11
0.2,1225,89,90247,73.61092985318108,12
0.2,1226,93,90340,73.62673186634066,8
0.2,1227,94,90434,73.64332247557003,7
0.2,1228,90,90524,73.65663140764849,11
0.2,1229,95,90619,73.6739837398374,7
0.2,1230,94,90713,73.69049553208774,7
0.2,1231,94,90807,73.70698051948052,7
0.2,1232,91,90898,73.72100567721006,10
0.2,1233,95,90993,73.73824959481361,6
0.2,1234,94,91087,73.75465587044535,8
0.2,1235,83,91170,73.7621359223301,20
0.2,1236,24,91194,73.72190784155214,9
0.2,1237,92,91286,73.73667205169629,9
0.2,1238,25,91311,73.69733656174334,8
0.2,1239,90,91401,73.71048387096774,12
0.2,1240,95,91496,73.72763900080581,6
0.2,1241,94,91590,73.74396135265701,7
0.2,1242,94,91684,73.76025744167337,7
0.2,1243,96,91780,73.7781350482315,6
0.2,1244,94,91874,73.79437751004016,8
0.2,1245,94,91968,73.81059390048154,7
0.2,1246,96,92064,73.82838813151564,6
0.2,1247,91,92155,73.84214743589743,10
0.2,1248,94,92249,73.85828662930344,7
0.2,1249,-49,92200,73.76,13
0.2,1250,20,92220,73.71702637889689,12
0.2,1251,90,92310,73.73003194888179,11
0.2,1252,96,92406,73.74780526735834,6
0.2,1253,94,92500,73.7639553429027,7
0.2,1254,92,92592,73.7784860557769,9
0.2,1255,26,92618,73.74044585987261,8
0.2,1256,95,92713,73.75735879077168,7
0.2,1257,92,92805,73.77186009538951,9
0.2,1258,92,92897,73.78633836378077,10
0.2,1259,96,92993,73.80396825396825,7
0.2,1260,89,93082,73.81601903251388,12
0.2,1261,90,93172,73.82884310618067,11
0.2,1262,94,93266,73.84481393507522,7
0.2,1263,96,93362,73.8623417721519,6
0.2,1264,91,93453,73.87588932806324,10
0.2,1265,93,93546,73.8909952606635,8
0.2,1266,95,93641,73.90765588003157,6
0.2,1267,91,93732,73.9211356466877,10
0.2,1268,88,93820,73.93223010244287,13
0.2,1269,94,93914,73.948031496063,7
0.2,1270,95,94009,73.9645948072384,6
0.2,1271,93,94102,73.97955974842768,8
0.2,1272,92,94194,73.9937156323645,10
0.2,1273,21,94215,73.95211930926217,11
0.2,1274,94,94309,73.9678431372549,7
0.2,1275,93,94402,73.98275862068965,8
0.2,1276,91,94493,73.99608457321848,10
0.2,1277,93,94586,74.01095461658842,8
0.2,1278,94,94680,74.02658326817827,7
0.2,1279,91,94771,74.03984375,10
0.2,1280,95,94866,74.05620608899298,7
0.2,1281,26,94892,74.01872074882995,7
0.2,1282,23,94915,73.97895557287607,9
0.2,1283,93,95008,73.99376947040498,8
0.2,1284,91,95099,74.00700389105059,10
0.2,1285,93,95192,74.02177293934682,8
0.2,1286,19,95211,73.97902097902097,13
0.2,1287,95,95306,73.99534161490683,6
0.2,1288,94,95400,74.01086113266098,7
0.2,1289,23,95423,73.97131782945736,9
0.2,1290,18,95441,73.92796281951975,14
0.2,1291,93,95534,73.94272445820434,8
0.2,1292,95,95629,73.95901005413766,7
0.2,1293,91,95720,73.97217928902627,10
0.2,1294,93,95813,73.9868725868726,8
0.2,1295,89,95902,73.99845679012346,13
0.2,1296,94,95996,74.01387818041634,8
0.2,1297,95,96091,74.03004622496148,6
0.2,1298,89,96180,74.04157043879907,12
0.2,1299,91,96271,74.05461538461539,10
0.2,1300,94,96365,74.06994619523444,7
0.2,1301,23,96388,74.03072196620583,9
0.2,1302,91,96479,74.04374520337683,10
0.2,1303,20,96499,74.00230061349693,12
0.2,1304,96,96595,74.01915708812261,6
0.2,1305,91,96686,74.03215926493108,10
0.2,1306,93,96779,74.04667176740628,8
0.2,1307,91,96870,74.05963302752293,10
0.2,1308,92,96962,74.0733384262796,10
0.2,1309,22,96984,74.03358778625955,11
0.2,1310,94,97078,74.04881769641496,7
0.2,1311,92,97170,74.0625,9
0.2,1312,20,97190,74.02132520944402,13
0.2,1313,95,97285,74.0372907153729,7
0.2,1314,94,97379,74.05247148288973,9
0.2,1315,18,97397,74.00987841945289,15
0.2,1316,94,97491,74.0250569476082,7
0.2,1317,95,97586,74.04097116843703,6
0.2,1318,90,97676,74.05307050796057,11
0.2,1319,92,97768,74.06666666666666,9
0.2,1320,93,97861,74.08099924299773,9
0.2,1321,93,97954,74.09531013615734,9
0.2,1322,92,98046,74.10884353741497,9
0.2,1323,95,98141,74.12462235649546,6
0.2,1324,22,98163,74.08528301886793,11
0.2,1325,93,98256,74.09954751131222,8
0.2,1326,92,98348,74.11303692539563,9
0.2,1327,93,98441,74.12725903614458,8
0.2,1328,92,98533,74.14070729872084,9
0.2,1329,90,98623,74.15263157894736,11
0.2,1330,90,98713,74.16453794139744,11
0.2,1331,91,98804,74.17717717717717,11
0.2,1332,94,98898,74.192048012003,7
0.2,1333,93,98991,74.20614692653673,8
0.2,1334,94,99085,74.22097378277154,7
0.2,1335,95,99180,74.23652694610779,6
0.2,1336,93,99273,74.25056095736724,9
0.2,1337,94,99367,74.26532137518684,8
0.2,1338,94,99461,74.28005974607916,7
0.2,1339,94,99555,74.29477611940298,8
0.2,1340,20,99575,74.25428784489188,12
0.2,1341,93,99668,74.26825633383011,9
0.2,1342,96,99764,74.28443782576322,6
0.2,1343,94,99858,74.29910714285714,7
0.2,1344,95,99953,74.31449814126394,7
0.2,1345,94,100047,74.32912332838039,8
0.2,1346,91,100138,74.34149962880475,10
0.2,1347,90,100228,74.35311572700297,11
0.2,1348,95,100323,74.36842105263158,7
0.2,1349,19,100342,74.3274074074074,13
0.2,1350,86,100428,74.3360473723168,15
0.2,1351,87,100515,74.34541420118343,14
0.2,1352,94,100609,74.359940872136,7
0.2,1353,92,100701,74.37296898079764,10
0.2,1354,92,100793,74.38597785977859,9
0.2,1355,89,100882,74.39675516224189,12
0.2,1356,96,100978,74.41267501842299,6
0.2,1357,21,100999,74.37334315169366,11
0.2,1358,20,101019,74.33333333333333,12
0.2,1359,93,101112,74.34705882352941,8
0.2,1360,94,101206,74.36149889786921,7
0.2,1361,91,101297,74.37371512481644,10
0.2,1362,93,101390,74.38738077769626,8
0.2,1363,95,101485,74.4024926686217,6
0.2,1364,94,101579,74.41684981684982,7
0.2,1365,94,101673,74.43118594436311,7
0.2,1366,94,101767,74.44550109729335,8
0.2,1367,93,101860,74.45906432748538,8
0.2,1368,93,101953,74.47260774287801,8
0.2,1369,91,102044,74.48467153284672,10
0.2,1370,93,102137,74.4981765134938,9
0.2,1371,94,102231,74.51239067055394,7
0.2,1372,88,102319,74.52221412964312,13
0.2,1373,95,102414,74.53711790393012,6
0.2,1374,94,102508,74.55127272727273,8
0.2,1375,92,102600,74.56395348837209,9
0.2,1376,92,102692,74.5766158315178,9
0.2,1377,95,102787,74.59143686502178,6
0.2,1378,94,102881,74.605511240029,8
0.2,1379,94,102975,74.6195652173913,8
0.2,1380,95,103070,74.63432295438088,6
0.2,1381,90,103160,74.64544138929088,11
0.2,1382,94,103254,74.65943600867679,7
0.2,1383,91,103345,74.67124277456648,10
0.2,1384,94,103439,74.68519855595667,7
0.2,1385,25,103464,74.64935064935065,10
0.2,1386,22,103486,74.6113914924297,10
0.2,1387,25,103511,74.5756484149856,8
0.2,1388,91,103602,74.58747300215983,10
0.2,1389,94,103696,74.60143884892086,7
0.2,1390,95,103791,74.61610352264557,8
0.2,1391,93,103884,74.62931034482759,8
0.2,1392,94,103978,74.64321608040201,7
0.2,1393,96,104074,74.65853658536585,6
0.2,1394,90,104164,74.66953405017921,11
0.2,1395,96,104260,74.68481375358166,6
0.2,1396,95,104355,74.69935576234789,6
0.2,1397,92,104447,74.71173104434907,9
0.2,1398,25,104472,74.67619728377413,8
0.2,1399,95,104567,74.69071428571428,7
0.2,1400,94,104661,74.70449678800857,7
0.2,1401,96,104757,74.71968616262482,6
0.2,1402,25,104782,74.68424803991446,7
0.2,1403,24,104806,74.64814814814815,8
0.2,1404,96,104902,74.66334519572953,6
0.2,1405,94,104996,74.67709815078236,7
0.2,1406,96,105092,74.69225302061123,6
0.2,1407,88,105180,74.70170454545455,13
0.2,1408,93,105273,74.71469127040454,8
0.2,1409,90,105363,74.72553191489362,11
0.2,1410,94,105457,74.73919206236711,8
0.2,1411,92,105549,74.7514164305949,9
0.2,1412,94,105643,74.76503892427459,7
0.2,1413,19,105662,74.72560113154172,14
0.2,1414,95,105757,74.73992932862191,6
0.2,1415,92,105849,74.75211864406779,9
0.2,1416,91,105940,74.7635850388144,10
0.2,1417,94,106034,74.77715091678421,7
0.2,1418,93,106127,74.78999295278365,8
0.2,1419,14,106141,74.74718309859155,19
0.2,1420,92,106233,74.75932441942294,9
0.2,1421,84,106317,74.76582278481013,17
0.2,1422,84,106401,74.77231201686578,17
0.2,1423,94,106495,74.78581460674157,7
0.2,1424,19,106514,74.74666666666667,13
0.2,1425,94,106608,74.7601683029453,7
0.2,1426,92,106700,74.77224947442187,9
0.2,1427,18,106718,74.73249299719888,15
0.2,1428,88,106806,74.74177746675997,13
0.2,1429,25,106831,74.706993006993,8
0.2,1430,91,106922,74.7183787561146,10
0.2,1431,92,107014,74.7304469273743,10
0.2,1432,96,107110,74.74528960223307,6
0.2,1433,92,107202,74.75732217573221,9
0.2,1434,90,107292,74.76794425087108,11
0.2,1435,92,107384,74.77994428969359,9
0.2,1436,89,107473,74.78983994432846,12
0.2,1437,96,107569,74.80458970792768,6
0.2,1438,21,107590,74.76719944405838,11
0.2,1439,96,107686,74.78194444444445,6
0.2,1440,90,107776,74.79250520471895,11
0.2,1441,92,107868,74.80443828016644,9
0.2,1442,94,107962,74.81774081774081,7
0.2,1443,93,108055,74.8303324099723,8
0.2,1444,95,108150,74.84429065743944,6
0.2,1445,95,108245,74.8582295988935,7
0.2,1446,92,108337,74.87007601935038,9
0.2,1447,96,108433,74.88466850828729,6
0.2,1448,94,108527,74.89786059351276,8
0.2,1449,93,108620,74.9103448275862,8
0.2,1450,92,108712,74.92212267401791,9
0.2,1451,94,108806,74.93526170798899,7
0.2,1452,89,108895,74.94494150034411,13
0.2,1453,94,108989,74.95804676753782,7
0.2,1454,21,109010,74.92096219931271,11
0.2,1455,93,109103,74.93337912087912,9
0.2,1456,94,109197,74.94646533973919,8
0.2,1457,94,109291,74.95953360768175,7
0.2,1458,96,109387,74.97395476353667,6
0.2,1459,93,109480,74.98630136986301,8
0.2,1460,93,109573,74.99863107460644,9
0.2,1461,22,109595,74.96238030095759,11
0.2,1462,25,109620,74.92822966507177,8
0.2,1463,92,109712,74.93989071038251,9
0.2,1464,88,109800,74.94880546075085,13
0.2,1465,95,109895,74.962482946794,6
0.2,1466,89,109984,74.97205180640763,12
0.2,1467,95,110079,74.98569482288828,6
0.2,1468,87,110166,74.99387338325391,14
0.2,1469,95,110261,75.00748299319729,7
0.2,1470,90,110351,75.01767505098573,11
0.2,1471,-51,110300,74.9320652173913,14
0.2,1472,91,110391,74.94297352342159,10
0.2,1473,91,110482,74.95386702849389,10
0.2,1474,93,110575,74.96610169491525,9
0.2,1475,96,110671,74.98035230352303,6
0.2,1476,92,110763,74.99187542315505,9
0.2,1477,93,110856,75.00405953991881,8
0.2,1478,94,110950,75.01690331304935,8
0.2,1479,92,111042,75.02837837837838,9
0.2,1480,94,111136,75.04118838622553,8
0.2,1481,91,111227,75.0519568151147,10
0.2,1482,96,111323,75.06608226567768,6
0.2,1483,92,111415,75.07749326145553,9
0.2,1484,87,111502,75.08552188552189,14
0.2,1485,96,111598,75.09959623149395,7
0.2,1486,96,111694,75.11365164761264,6
0.2,1487,19,111713,75.07594086021506,14
0.2,1488,91,111804,75.08663532572196,11
0.2,1489,94,111898,75.0993288590604,7
0.2,1490,94,111992,75.11200536552649,7
0.2,1491,-60,111932,75.02144772117963,24
0.2,1492,92,112024,75.03281982585399,9
0.2,1493,90,112114,75.04283801874163,12
0.2,1494,93,112207,75.05484949832775,8
0.2,1495,90,112297,75.06483957219251,13
0.2,1496,92,112389,75.07615230460922,11
0.2,1497,94,112483,75.08878504672897,7
0.2,1498,94,112577,75.10140093395597,7
0.2,1499,94,112671,75.114,8
0.2,1500,-49,112622,75.03131245836109,12
0.2,1501,96,112718,75.04527296937417,6
0.2,1502,95,112813,75.0585495675316,6
0.2,1503,90,112903,75.0684840425532,12
0.2,1504,92,112995,75.0797342192691,10
0.2,1505,92,113087,75.09096945551128,9
0.2,1506,92,113179,75.10218978102189,9
0.2,1507,90,113269,75.11206896551724,11
0.2,1508,93,113362,75.12392312789927,8
0.2,1509,94,113456,75.1364238410596,7
0.2,1510,26,113482,75.10390469887491,7
0.2,1511,87,113569,75.11177248677248,14
0.2,1512,95,113664,75.1249173826834,7
0.2,1513,91,113755,75.13540290620872,10
0.2,1514,91,113846,75.14587458745875,11
0.2,1515,96,113942,75.15963060686016,6
0.2,1516,91,114033,75.17007251153592,10
0.2,1517,92,114125,75.18115942028986,9
0.2,1518,25,114150,75.14812376563529,8
0.2,1519,95,114245,75.16118421052632,6
0.2,1520,93,114338,75.17291255752794,10
0.2,1521,96,114434,75.18659658344284,6
0.2,1522,95,114529,75.19960604070913,6
0.2,1523,95,114624,75.21259842519684,6
0.2,1524,96,114720,75.22622950819672,6
0.2,1525,-123,114597,75.09633027522936,17
0.2,1526,93,114690,75.10805500982319,10
0.2,1527,19,114709,75.07133507853403,13
0.2,1528,85,114794,75.07782864617397,16
0.2,1529,94,114888,75.09019607843138,7
0.2,1530,86,114974,75.09732201175702,15
0.2,1531,92,115066,75.10835509138381,10
0.2,1532,87,115153,75.11611219830398,15
0.2,1533,92,115245,75.12711864406779,9
0.2,1534,90,115335,75.13680781758957,11
0.2,1535,94,115429,75.14908854166667,7
0.2,1536,92,115521,75.16005204944697,9
0.2,1537,95,115616,75.17295188556567,6
0.2,1538,94,115710,75.18518518518519,7
0.2,1539,-53,115657,75.10194805194806,17
0.2,1540,23,115680,75.06813757300455,9
0.2,1541,90,115770,75.07782101167315,11
0.2,1542,92,115862,75.08878807517823,9
0.2,1543,87,115949,75.09650259067358,14
0.2,1544,92,116041,75.10744336569579,9
0.2,1545,93,116134,75.11901681759379,9
0.2,1546,88,116222,75.1273432449903,13
0.2,1547,92,116314,75.13824289405684,9
0.2,1548,96,116410,75.15171078114913,6
0.2,1549,94,116504,75.16387096774193,7
0.2,1550,27,116531,75.13281753707285,7
0.2,1551,94,116625,75.14497422680412,7
0.2,1552,95,116720,75.1577591757888,6
0.2,1553,88,116808,75.16602316602317,13
0.2,1554,19,116827,75.1299035369775,13
0.2,1555,92,116919,75.14074550128535,9
0.2,1556,92,117011,75.15157353885678,9
0.2,1557,91,117102,75.16174582798459,10
0.2,1558,94,117196,75.17382937780629,7
0.2,1559,23,117219,75.14038461538462,9
0.2,1560,90,117309,75.14990390775144,12
0.2,1561,96,117405,75.16325224071703,6
0.2,1562,95,117500,75.17594369801664,6
0.2,1563,92,117592,75.18670076726343,9
0.2,1564,92,117684,75.19744408945687,9
0.2,1565,91,117775,75.20753512132822,10
0.2,1566,93,117868,75.21888959795788,8
0.2,1567,89,117957,75.22767857142857,12
0.2,1568,95,118052,75.24028043339707,6
0.2,1569,94,118146,75.25222929936305,7
0.2,1570,95,118241,75.26479949077022,7
0.2,1571,94,118335,75.27671755725191,7
0.2,1572,95,118430,75.2892561983471,7
0.2,1573,-56,118374,75.20584498094028,19
0.2,1574,96,118470,75.21904761904761,6
0.2,1575,95,118565,75.23159898477158,7
0.2,1576,94,118659,75.24350031705771,7
0.2,1577,92,118751,75.25411913814956,9
0.2,1578,94,118845,75.26599113362887,7
0.2,1579,92,118937,75.27658227848102,10
0.2,1580,94,119031,75.28842504743832,7
0.2,1581,90,119121,75.29772439949431,11
0.2,1582,94,119215,75.30953885028427,7
0.2,1583,-44,119171,75.23421717171718,8
0.2,1584,23,119194,75.20126182965299,10
0.2,1585,95,119289,75.21374527112232,6
0.2,1586,95,119384,75.22621298046629,7
0.2,1587,95,119479,75.23866498740554,6
0.2,1588,89,119568,75.2473253618628,12
0.2,1589,93,119661,75.25849056603774,8
0.2,1590,90,119751,75.26775612822125,14
0.2,1591,94,119845,75.27952261306532,9
0.2,1592,94,119939,75.29127432517264,7
0.2,1593,19,119958,75.25595984943538,13
0.2,1594,96,120054,75.26896551724138,6
0.2,1595,92,120146,75.27944862155388,9
0.2,1596,-46,120100,75.2035065748278,10
0.2,1597,94,120194,75.21526908635795,8
0.2,1598,92,120286,75.22576610381489,9
0.2,1599,93,120379,75.236875,8
0.2,1600,25,120404,75.20549656464709,8
0.2,1601,91,120495,75.21535580524345,11
0.2,1602,22,120517,75.18215845290081,10
0.2,1603,94,120611,75.19389027431421,7
0.2,1604,96,120707,75.20685358255452,6
0.2,1605,94,120801,75.21855541718556,8
0.2,1606,92,120893,75.2289981331674,9
0.2,1607,89,120982,75.23756218905473,12
0.2,1608,92,121074,75.24798011187073,9
0.2,1609,22,121096,75.21490683229814,10
0.2,1610,93,121189,75.22594661700806,8
0.2,1611,90,121279,75.23511166253101,15
0.2,1612,94,121373,75.24674519528828,7
0.2,1613,95,121468,75.25898389095416,6
0.2,1614,20,121488,75.22476780185758,12
0.2,1615,92,121580,75.23514851485149,9
0.2,1616,96,121676,75.24799010513296,6
0.2,1617,96,121772,75.26081582200247,7
0.2,1618,94,121866,75.27239036442248,8
0.2,1619,95,121961,75.28456790123457,6
0.2,1620,93,122054,75.29549660703269,8
0.2,1621,93,122147,75.30641183723797,8
0.2,1622,91,122238,75.31608133086876,10
0.2,1623,21,122259,75.2826354679803,11
0.2,1624,95,122354,75.29476923076923,7
0.2,1625,16,122370,75.25830258302582,16
0.2,1626,93,122463,75.26920712968654,8
0.2,1627,88,122551,75.27702702702703,13
0.2,1628,93,122644,75.28790669122161,8
0.2,1629,85,122729,75.29386503067485,16
0.2,1630,-122,122607,75.17290006131208,17
0.2,1631,95,122702,75.18504901960785,6
0.2,1632,92,122794,75.19534598897734,9
0.2,1633,23,122817,75.16340269277846,10
0.2,1634,27,122844,75.13394495412844,6
0.2,1635,86,122930,75.14058679706602,16
0.2,1636,94,123024,75.15210751374465,7
0.2,1637,92,123116,75.16239316239316,9
0.2,1638,81,123197,75.1659548505186,20
0.2,1639,92,123289,75.17621951219512,9
0.2,1640,91,123380,75.18586227909812,10
0.2,1641,21,123401,75.15286236297199,13
0.2,1642,91,123492,75.16250760803409,10
0.2,1643,94,123586,75.17396593673966,7
0.2,1644,94,123680,75.1854103343465,7
0.2,1645,94,123774,75.19684082624545,7
0.2,1646,93,123867,75.20765027322405,8
0.2,1647,26,123893,75.17779126213593,7
0.2,1648,95,123988,75.18981200727714,6
0.2,1649,93,124081,75.20060606060606,8
0.2,1650,94,124175,75.21199273167777,8
0.2,1651,27,124202,75.18280871670702,6
0.2,1652,94,124296,75.19419237749547,7
0.2,1653,92,124388,75.2043530834341,9
0.2,1654,94,124482,75.21570996978852,7
0.2,1655,81,124563,75.21920289855072,20
0.2,1656,94,124657,75.23053711526856,7
0.2,1657,92,124749,75.2406513872135,9
0.2,1658,96,124845,75.25316455696202,6
0.2,1659,94,124939,75.2644578313253,7
0.2,1660,25,124964,75.23419626730885,8
0.2,1661,93,125057,75.24488567990373,8
0.2,1662,95,125152,75.25676488274203,7
0.2,1663,95,125247,75.2686298076923,6
0.2,1664,92,125339,75.27867867867867,10
0.2,1665,22,125361,75.24669867947179,10
0.2,1666,83,125444,75.25134973005399,19
0.2,1667,94,125538,75.26258992805755,7
0.2,1668,90,125628,75.27142001198322,11
0.2,1669,91,125719,75.2808383233533,10
0.2,1670,20,125739,75.24775583482945,12
0.2,1671,89,125828,75.25598086124401,12
0.2,1672,94,125922,75.26718469814705,7
0.2,1673,94,126016,75.27837514934289,7
0.2,1674,23,126039,75.24716417910447,9
0.2,1675,25,126064,75.21718377088305,9
0.2,1676,91,126155,75.22659511031604,10
0.2,1677,95,126250,75.238379022646,6
0.2,1678,96,126346,75.25074449076831,6
0.2,1679,93,126439,75.26130952380953,8
0.2,1680,94,126533,75.27245687091018,7
0.2,1681,92,126625,75.28240190249703,9
0.2,1682,22,126647,75.25074272133095,10
0.2,1683,92,126739,75.2606888361045,9
0.2,1684,92,126831,75.27062314540059,9
0.2,1685,90,126921,75.27935943060498,11
0.2,1686,96,127017,75.29164196799051,6
0.2,1687,-53,126964,75.21563981042654,16
0.2,1688,94,127058,75.22676139727649,7
0.2,1689,92,127150,75.23668639053254,9
0.2,1690,96,127246,75.24896510940272,7
0.2,1691,93,127339,75.25945626477541,8
0.2,1692,89,127428,75.26757235676314,12
0.2,1693,93,127521,75.2780401416765,8
0.2,1694,94,127615,75.28908554572271,7
0.2,1695,95,127710,75.30070754716981,6
0.2,1696,12,127722,75.26340601060696,20
0.2,1697,96,127818,75.2756183745583,6
0.2,1698,91,127909,75.2848734549735,10
0.2,1699,-45,127864,75.21411764705883,9
0.2,1700,26,127890,75.18518518518519,7
0.2,1701,90,127980,75.19388954171563,12
0.2,1702,94,128074,75.20493247210804,7
0.2,1703,90,128164,75.21361502347418,12
0.2,1704,96,128260,75.2258064516129,6
0.2,1705,96,128356,75.2379835873388,6
0.2,1706,91,128447,75.2472173403632,10
0.2,1707,89,128536,75.2552693208431,12
0.2,1708,96,128632,75.2674078408426,6
0.2,1709,88,128720,75.27485380116958,13
0.2,1710,91,128811,75.28404441846874,10
0.2,1711,27,128838,75.25584112149532,7
0.2,1712,95,128933,75.26736719206072,6
0.2,1713,92,129025,75.27712952158693,9
0.2,1714,88,129113,75.28454810495627,13
0.2,1715,95,129208,75.2960372960373,6
0.2,1716,92,129300,75.30576587070472,9
0.2,1717,93,129393,75.31606519208381,9
0.2,1718,93,129486,75.32635253054102,8
0.2,1719,94,129580,75.33720930232558,7
0.2,1720,90,129670,75.34572922719349,11
0.2,1721,90,129760,75.35423925667828,11
0.2,1722,27,129787,75.32617527568195,6
0.2,1723,22,129809,75.29524361948955,10
0.2,1724,87,129896,75.30202898550725,15
0.2,1725,96,129992,75.31402085747393,7
0.2,1726,96,130088,75.32599884192241,6
0.2,1727,93,130181,75.33622685185185,9
0.2,1728,92,130273,75.34586466165413,10
0.2,1729,96,130369,75.35780346820809,6
0.2,1730,91,130460,75.36683997689197,10
0.2,1731,86,130546,75.3729792147806,15
0.2,1732,95,130641,75.38430467397576,6
0.2,1733,27,130668,75.35640138408304,6
0.2,1734,96,130764,75.36829971181557,6
0.2,1735,95,130859,75.37960829493088,6
0.2,1736,94,130953,75.39032815198618,7
0.2,1737,92,131045,75.39988492520138,9
0.2,1738,92,131137,75.40943070730304,11
0.2,1739,94,131231,75.42011494252874,7
0.2,1740,91,131322,75.4290637564618,10
0.2,1741,92,131414,75.4385763490241,9
0.2,1742,88,131502,75.44578313253012,13
0.2,1743,20,131522,75.41399082568807,14
0.2,1744,92,131614,75.42349570200572,9
0.2,1745,91,131705,75.43241695303551,10
0.2,1746,96,131801,75.44419004006869,6
0.2,1747,20,131821,75.41247139588101,13
0.2,1748,92,131913,75.42195540308748,9
0.2,1749,95,132008,75.43314285714285,6
0.2,1750,94,132102,75.44374643061109,7
0.2,1751,94,132196,75.45433789954338,8
0.2,1752,94,132290,75.46491728465487,9
0.2,1753,95,132385,75.47605473204105,6
0.2,1754,93,132478,75.48603988603989,9
0.2,1755,-128,132350,75.37015945330296,22
0.2,1756,94,132444,75.38076266363119,11
0.2,1757,95,132539,75.39192263936292,6
0.2,1758,93,132632,75.40193291642979,8
0.2,1759,94,132726,75.4125,7
0.2,1760,89,132815,75.42021578648495,12
0.2,1761,23,132838,75.39046538024972,10
0.2,1762,91,132929,75.39931934203062,11
0.2,1763,22,132951,75.36904761904762,10
0.2,1764,23,132974,75.33937677053824,9
0.2,1765,93,133067,75.3493771234428,8
0.2,1766,96,133163,75.36106395019807,6
0.2,1767,94,133257,75.37160633484163,7
0.2,1768,87,133344,75.37817976257773,14
0.2,1769,92,133436,75.38757062146892,9
0.2,1770,94,133530,75.39808018068888,7
0.2,1771,91,133621,75.4068848758465,10
0.2,1772,93,133714,75.41680767061477,8
0.2,1773,94,133808,75.42728297632469,8
0.2,1774,93,133901,75.43718309859155,9
0.2,1775,87,133988,75.44369369369369,14
0.2,1776,19,134007,75.41193021947102,15
0.2,1777,95,134102,75.42294713160855,6
0.2,1778,93,134195,75.43282743114109,8
0.2,1779,90,134285,75.44101123595506,11
0.2,1780,95,134380,75.45199326221224,6
0.2,1781,94,134474,75.46240179573513,8
0.2,1782,90,134564,75.47055524397084,11
0.2,1783,80,134644,75.47309417040358,21
0.2,1784,96,134740,75.48459383753502,6
0.2,1785,92,134832,75.49384098544233,9
0.2,1786,91,134923,75.50251818690543,10
0.2,1787,92,135015,75.51174496644295,9
0.2,1788,93,135108,75.52152040245947,8
0.2,1789,94,135202,75.53184357541899,8
0.2,1790,94,135296,75.54215522054719,8
0.2,1791,94,135390,75.55245535714286,7
0.2,1792,96,135486,75.56385945343001,6
0.2,1793,95,135581,75.57469342251952,6
0.2,1794,91,135672,75.583286908078,10
0.2,1795,90,135762,75.5913140311804,13
0.2,1796,92,135854,75.60044518642181,10
0.2,1797,94,135948,75.6106785317019,7
0.2,1798,95,136043,75.62145636464703,6
0.2,1799,94,136137,75.63166666666666,7
0.2,1800,90,136227,75.63964464186563,11
0.2,1801,95,136322,75.6503884572697,7
0.2,1802,89,136411,75.65779256794232,13
0.2,1803,95,136506,75.66851441241685,6
0.2,1804,93,136599,75.6781163434903,8
0.2,1805,22,136621,75.64839424141749,10
0.2,1806,87,136708,75.65467625899281,15
0.2,1807,95,136803,75.66537610619469,6
0.2,1808,94,136897,75.67551133222776,8
0.2,1809,24,136921,75.64696132596686,9
0.2,1810,94,137015,75.65709552733297,7
0.2,1811,93,137108,75.66666666666667,8
0.2,1812,84,137192,75.67126309983453,17
0.2,1813,95,137287,75.6819184123484,6
0.2,1814,91,137378,75.69035812672176,10
0.2,1815,19,137397,75.65914096916299,13
0.2,1816,94,137491,75.66923500275179,7
0.2,1817,94,137585,75.67931793179318,8
0.2,1818,94,137679,75.68938977460142,7
0.2,1819,-50,137629,75.62032967032967,14
0.2,1820,93,137722,75.62987369577155,9
0.2,1821,93,137815,75.63940724478594,8
0.2,1822,94,137909,75.64947888096545,7
0.2,1823,92,138001,75.65844298245614,9
0.2,1824,88,138089,75.66520547945206,13
0.2,1825,92,138181,75.67415115005477,9
0.2,1826,89,138270,75.68144499178982,12
0.2,1827,91,138361,75.6898249452954,10
0.2,1828,95,138456,75.70038272279935,7
0.2,1829,88,138544,75.70710382513661,13
0.2,1830,92,138636,75.71600218459858,9
0.2,1831,93,138729,75.7254366812227,8
0.2,1832,92,138821,75.73431533006001,9
0.2,1833,87,138908,75.74045801526718,14
0.2,1834,95,139003,75.75095367847412,6
0.2,1835,23,139026,75.72222222222223,10
0.2,1836,23,139049,75.69352204681546,10
0.2,1837,-51,138998,75.62459194776932,14
0.2,1838,24,139022,75.59651984774334,8
0.2,1839,16,139038,75.56413043478261,16
0.2,1840,91,139129,75.57251493753395,10
0.2,1841,94,139223,75.58251900108577,7
0.2,1842,95,139318,75.59305480195334,6
0.2,1843,90,139408,75.60086767895879,11
0.2,1844,94,139502,75.61084010840108,7
0.2,1845,91,139593,75.61917659804983,10
0.2,1846,94,139687,75.62912831618841,7
0.2,1847,92,139779,75.63798701298701,9
0.2,1848,95,139874,75.64845862628448,6
0.2,1849,95,139969,75.65891891891891,7
0.2,1850,92,140061,75.6677471636953,9
0.2,1851,94,140155,75.67764578833693,8
0.2,1852,95,140250,75.68807339449542,7
0.2,1853,89,140339,75.69525350593312,12
0.2,1854,95,140434,75.70566037735848,6
0.2,1855,94,140528,75.71551724137932,7
0.2,1856,19,140547,75.68497576736672,13
0.2,1857,4,140551,75.64639397201292,28
0.2,1858,95,140646,75.65680473372781,6
0.2,1859,19,140665,75.6263440860215,14
0.2,1860,95,140760,75.63675443310048,6
0.2,1861,95,140855,75.64715359828142,6
0.2,1862,94,140949,75.65700483091787,7
0.2,1863,89,141038,75.66416309012875,12
0.2,1864,96,141134,75.67506702412868,6
0.2,1865,90,141224,75.68274383708467,11
0.2,1866,95,141319,75.69309051955008,6
0.2,1867,94,141413,75.70289079229121,7
0.2,1868,88,141501,75.70947030497592,13
0.2,1869,93,141594,75.7187165775401,8
0.2,1870,94,141688,75.72848743987173,7
0.2,1871,94,141782,75.73824786324786,7
0.2,1872,96,141878,75.74906567004805,6
0.2,1873,95,141973,75.75933831376734,6
0.2,1874,93,142066,75.76853333333334,9
0.2,1875,92,142158,75.7771855010661,9
0.2,1876,93,142251,75.78636121470431,8
0.2,1877,95,142346,75.79659211927583,6
0.2,1878,93,142439,75.8057477381586,8
0.2,1879,26,142465,75.77925531914893,8
0.2,1880,91,142556,75.7873471557682,10
0.2,1881,95,142651,75.79755579171095,6
0.2,1882,90,142741,75.80509824747743,11
0.2,1883,94,142835,75.81475583864119,7
0.2,1884,92,142927,75.82334217506632,9
0.2,1885,18,142945,75.79268292682927,14
0.2,1886,19,142964,75.7625861155273,14
0.2,1887,89,143053,75.76959745762711,12
0.2,1888,27,143080,75.74377977766014,6
0.2,1889,95,143175,75.75396825396825,6
0.2,1890,93,143268,75.76308831306187,8
0.2,1891,94,143362,75.77272727272727,7
0.2,1892,-49,143313,75.70681458003169,13
0.2,1893,95,143408,75.71700105596621,6
0.2,1894,91,143499,75.72506596306069,11
0.2,1895,96,143595,75.73575949367088,6
0.2,1896,92,143687,75.74433315761729,9
0.2,1897,90,143777,75.7518440463646,11
0.2,1898,19,143796,75.7219589257504,14
0.2,1899,96,143892,75.73263157894736,6
0.2,1900,95,143987,75.74276696475539,7
0.2,1901,25,144012,75.71608832807571,8
0.2,1902,93,144105,75.72517078297425,9
0.2,1903,23,144128,75.69747899159664,10
0.2,1904,92,144220,75.70603674540682,11
0.2,1905,20,144240,75.67681007345226,13
0.2,1906,95,144335,75.68694284216046,7
0.2,1907,95,144430,75.69706498951781,6
0.2,1908,93,144523,75.7061288632792,8
0.2,1909,91,144614,75.71413612565445,10
0.2,1910,14,144628,75.68184196755625,18
0.2,1911,95,144723,75.69194560669456,6
0.2,1912,94,144817,75.70151594354417,7
0.2,1913,95,144912,75.7115987460815,6
0.2,1914,91,145003,75.71958224543081,10
0.2,1915,89,145092,75.72651356993737,13
0.2,1916,89,145181,75.73343766301512,13
0.2,1917,90,145271,75.74087591240875,11
0.2,1918,95,145366,75.7509119332986,6
0.2,1919,92,145458,75.759375,9
0.2,1920,94,145552,75.76887038001041,7
0.2,1921,92,145644,75.77731529656607,9
0.2,1922,91,145735,75.78523140925637,11
0.2,1923,88,145823,75.79158004158005,14
0.2,1924,94,145917,75.80103896103896,7
0.2,1925,96,146013,75.81152647975078,6
0.2,1926,95,146108,75.82148417228854,6
0.2,1927,93,146201,75.83039419087137,9
0.2,1928,89,146290,75.8372213582167,12
0.2,1929,91,146381,75.84507772020726,10
0.2,1930,92,146473,75.85344381149663,9
0.2,1931,94,146567,75.8628364389234,7
0.2,1932,22,146589,75.83497154681842,10
0.2,1933,96,146685,75.8453981385729,6
0.2,1934,92,146777,75.85374677002584,9
0.2,1935,91,146868,75.86157024793388,11
0.2,1936,-63,146805,75.78988125967992,26
0.2,1937,92,146897,75.79824561403508,9
0.2,1938,91,146988,75.80608561113976,10
0.2,1939,95,147083,75.8159793814433,6
0.2,1940,91,147174,75.82380216383308,10
0.2,1941,26,147200,75.79814624098867,7
0.2,1942,95,147295,75.80802882141019,6
0.2,1943,91,147386,75.81584362139918,10
0.2,1944,90,147476,75.82313624678663,11
0.2,1945,20,147496,75.79445015416239,12
0.2,1946,84,147580,75.79866461222393,17
0.2,1947,91,147671,75.8064681724846,10
0.2,1948,91,147762,75.81426372498717,11
0.2,1949,95,147857,75.82410256410256,6
0.2,1950,96,147953,75.83444387493593,6
0.2,1951,91,148044,75.8422131147541,10
0.2,1952,95,148139,75.85202252944188,6
0.2,1953,92,148231,75.86028659160696,10
0.2,1954,96,148327,75.87058823529412,6
0.2,1955,96,148423,75.88087934560328,6
0.2,1956,95,148518,75.89064895247829,7
0.2,1957,-47,148471,75.82788559754852,10
0.2,1958,24,148495,75.8014293006636,8
0.2,1959,95,148590,75.81122448979592,6
0.2,1960,96,148686,75.82151963284039,6
0.2,1961,93,148779,75.8302752293578,8
0.2,1962,89,148868,75.83698420784513,12
0.2,1963,96,148964,75.84725050916497,6
0.2,1964,-51,148913,75.78269720101781,14
0.2,1965,91,149004,75.79043743641913,11
0.2,1966,96,149100,75.80071174377224,6
0.2,1967,82,149182,75.80386178861788,20
0.2,1968,91,149273,75.81157948197054,11
0.2,1969,94,149367,75.82081218274112,7
0.2,1970,93,149460,75.82952815829528,9
0.2,1971,94,149554,75.83874239350912,7
0.2,1972,94,149648,75.84794728839331,7
0.2,1973,23,149671,75.82117527862209,10
0.2,1974,92,149763,75.8293670886076,9
0.2,1975,92,149855,75.83755060728745,9
0.2,1976,94,149949,75.84673748103187,8
0.2,1977,95,150044,75.85642062689585,6
0.2,1978,92,150136,75.86457806973219,9
0.2,1979,92,150228,75.87272727272727,9
0.2,1980,94,150322,75.88187783947501,7
0.2,1981,94,150416,75.89101917255297,8
0.2,1982,-51,150365,75.82702975289965,14
0.2,1983,95,150460,75.8366935483871,6
0.2,1984,89,150549,75.8433249370277,12
0.2,1985,96,150645,75.85347432024169,6
0.2,1986,92,150737,75.86160040261701,9
0.2,1987,27,150764,75.83702213279678,6
0.2,1988,92,150856,75.84514831573655,9
0.2,1989,91,150947,75.85276381909547,10
0.2,1990,93,151040,75.86137619286791,9
0.2,1991,83,151123,75.86495983935743,18
0.2,1992,84,151207,75.86904164576016,17
0.2,1993,87,151294,75.87462387161484,15
0.2,1994,91,151385,75.88220551378446,10
0.2,1995,94,151479,75.89128256513025,7
0.2,1996,88,151567,75.89734601902855,13
0.2,1997,94,151661,75.9064064064064,7
0.2,1998,94,151755,75.91545772886444,7
0.2,1999,83,151838,75.919,18
0.2,2000,90,151928,75.92603698150924,12
0.2,2001,95,152023,75.93556443556443,6
0.2,2002,90,152113,75.94258612081877,11
0.2,2003,94,152207,75.95159680638723,8
0.2,2004,94,152301,75.96059850374066,8
0.2,2005,90,152391,75.96759720837487,11
0.2,2006,94,152485,75.97658196312905,7
0.2,2007,24,152509,75.95069721115537,9
0.2,2008,92,152601,75.95868591338974,10
0.2,2009,20,152621,75.93084577114428,12
0.2,2010,93,152714,75.93933366484336,9
0.2,2011,95,152809,75.94880715705766,6
0.2,2012,27,152836,75.92449080973671,6
0.2,2013,95,152931,75.93396226415095,6
0.2,2014,91,153022,75.94143920595533,10
0.2,2015,95,153117,75.95089285714286,7
0.2,2016,95,153212,75.96033713435796,6
0.2,2017,93,153305,75.96878097125867,8
0.2,2018,93,153398,75.97721644378404,8
0.2,2019,92,153490,75.98514851485149,9
0.2,2020,94,153584,75.99406234537358,7
0.2,2021,96,153680,76.00395647873393,6
0.2,2022,94,153774,76.01285219970342,8
0.2,2023,93,153867,76.02124505928853,8
0.2,2024,95,153962,76.03061728395062,7
0.2,2025,94,154056,76.03948667324778,7
0.2,2026,95,154151,76.04884065120868,7
0.2,2027,91,154242,76.05621301775147,10
0.2,2028,-47,154195,75.99556431739774,10
0.2,2029,87,154282,76.00098522167488,14
0.2,2030,94,154376,76.00984736582964,8
0.2,2031,24,154400,75.98425196850394,8
0.2,2032,92,154492,75.99212985735366,9
0.2,2033,94,154586,76.00098328416912,7
0.2,2034,17,154603,75.97199017199017,16
0.2,2035,94,154697,75.98084479371316,7
0.2,2036,96,154793,75.99067255768287,6
0.2,2037,93,154886,75.99901864573111,8
0.2,2038,22,154908,75.97253555664541,10
0.2,2039,93,155001,75.98088235294118,8
0.2,2040,95,155096,75.99020088192063,7
0.2,2041,94,155190,75.99902056807052,7
0.2,2042,21,155211,75.97209985315712,11
0.2,2043,94,155305,75.98091976516633,7
0.2,2044,91,155396,75.9882640586797,10
0.2,2045,25,155421,75.9633431085044,7
0.2,2046,21,155442,75.93649242794334,12
0.2,2047,95,155537,75.94580078125,6
0.2,2048,96,155633,75.95558809175208,6
0.2,2049,12,155645,75.92439024390244,20
0.2,2050,-56,155589,75.86006825938567,19
0.2,2051,25,155614,75.83528265107212,8
0.2,2052,91,155705,75.842669264491,10
0.2,2053,95,155800,75.85199610516067,8
0.2,2054,96,155896,75.86180048661801,6
0.2,2055,91,155987,75.86916342412451,10
0.2,2056,90,156077,75.87603305785125,11
0.2,2057,91,156168,75.88338192419825,11
0.2,2058,95,156263,75.8926663428849,8
0.2,2059,96,156359,75.90242718446602,6
0.2,2060,93,156452,75.91072295002427,9
0.2,2061,94,156546,75.91949563530552,7
0.2,2062,86,156632,75.92438196800775,15
0.2,2063,95,156727,75.93362403100775,6
0.2,2064,91,156818,75.9409200968523,11
0.2,2065,94,156912,75.94966118102614,7
0.2,2066,94,157006,75.9583938074504,7
0.2,2067,94,157100,75.96711798839459,7
0.2,2068,-190,156910,75.83856935717738,15
0.2,2069,26,156936,75.81449275362318,7
0.2,2070,90,157026,75.82134234669242,11
0.2,2071,95,157121,75.83059845559846,7
0.2,2072,94,157215,75.83936324167873,8
0.2,2073,93,157308,75.84763741562199,9
0.2,2074,22,157330,75.82168674698795,11
0.2,2075,27,157357,75.79816955684008,6
0.2,2076,22,157379,75.77226769378912,10
0.2,2077,92,157471,75.7800769971126,9
0.2,2078,93,157564,75.78835978835978,8
0.2,2079,90,157654,75.7951923076923,11
0.2,2080,96,157750,75.80490148966842,6
0.2,2081,95,157845,75.81412103746398,6
0.2,2082,96,157941,75.82381180988958,6
0.2,2083,88,158029,75.82965451055662,13
0.2,2084,90,158119,75.83645083932853,11
0.2,2085,93,158212,75.84467881112177,8
0.2,2086,95,158307,75.8538572113081,6
0.2,2087,88,158395,75.85967432950191,13
0.2,2088,93,158488,75.86787936811872,9
0.2,2089,94,158582,75.87655502392344,8
0.2,2090,95,158677,75.8857006217121,6
0.2,2091,89,158766,75.89196940726578,12
0.2,2092,89,158855,75.89823220258003,12
0.2,2093,92,158947,75.90592168099332,10
0.2,2094,95,159042,75.91503579952267,7
0.2,2095,86,159128,75.91984732824427,15
0.2,2096,89,159217,75.92608488316642,13
0.2,2097,94,159311,75.93469971401335,7
0.2,2098,92,159403,75.94235350166745,9
0.2,2099,92,159495,75.95,9
0.2,2100,93,159588,75.95811518324608,8
0.2,2101,93,159681,75.9662226450999,9
0.2,2102,90,159771,75.97289586305278,11
0.2,2103,92,159863,75.9805133079848,9
0.2,2104,94,159957,75.98907363420427,8
0.2,2105,94,160051,75.99762583095917,7
0.2,2106,95,160146,76.00664451827242,6
0.2,2107,94,160240,76.01518026565465,9
0.2,2108,-49,160191,75.95590327169275,13
0.2,2109,95,160286,75.9649289099526,6
0.2,2110,94,160380,75.97347228801516,7
0.2,2111,26,160406,75.94981060606061,7
0.2,2112,95,160501,75.95882631329863,7
0.2,2113,96,160597,75.96830652790918,6
0.2,2114,94,160691,75.97683215130024,7
0.2,2115,87,160778,75.9820415879017,14
0.2,2116,92,160870,75.98960793575814,9
0.2,2117,23,160893,75.96458923512748,9
0.2,2118,20,160913,75.93817838603114,12
0.2,2119,17,160930,75.91037735849056,15
0.2,2120,96,161026,75.91984912776992,8
0.2,2121,18,161044,75.89255419415646,15
0.2,2122,94,161138,75.90108337258596,8
0.2,2123,96,161234,75.9105461393597,7
0.2,2124,96,161330,75.92,6
0.2,2125,24,161354,75.89557855126999,9
0.2,2126,95,161449,75.90456041372826,6
0.2,2127,92,161541,75.91212406015038,10
0.2,2128,94,161635,75.92062000939409,7
0.2,2129,94,161729,75.92910798122065,9
0.2,2130,90,161819,75.93571093383387,11
0.2,2131,95,161914,75.94465290806754,6
0.2,2132,21,161935,75.91889357712142,11
0.2,2133,95,162030,75.9278350515464,8
0.2,2134,23,162053,75.90304449648713,9
0.2,2135,95,162148,75.9119850187266,7
0.2,2136,90,162238,75.91857744501638,11
0.2,2137,92,162330,75.92609915809167,9
0.2,2138,86,162416,75.93080878915382,15
0.2,2139,93,162509,75.93878504672897,8
0.2,2140,92,162601,75.94628678187763,9
0.2,2141,95,162696,75.95518207282913,6
0.2,2142,95,162791,75.96406906206253,6
0.2,2143,22,162813,75.93889925373135,11
0.2,2144,94,162907,75.94731934731935,8
0.2,2145,90,162997,75.95386766076422,11
0.2,2146,91,163088,75.96087564042851,10
0.2,2147,95,163183,75.96973929236499,7
0.2,2148,23,163206,75.945090739879,9
0.2,2149,95,163301,75.9539534883721,7
0.2,2150,94,163395,75.9623430962343,7
0.2,2151,95,163490,75.97118959107807,6
0.2,2152,91,163581,75.97816999535532,10
0.2,2153,94,163675,75.98653667595171,7
0.2,2154,94,163769,75.99489559164734,7
0.2,2155,95,163864,76.00371057513915,6
0.2,2156,92,163956,76.01112656467316,9
0.2,2157,95,164051,76.01992585727525,6
0.2,2158,91,164142,76.0268642890227,10
0.2,2159,88,164230,76.0324074074074,13
0.2,2160,21,164251,76.00694123091162,11
0.2,2161,94,164345,76.01526364477336,7
0.2,2162,88,164433,76.02080443828017,13
0.2,2163,94,164527,76.02911275415896,8
0.2,2164,93,164620,76.03695150115473,8
0.2,2165,91,164711,76.04385964912281,10
0.2,2166,94,164805,76.05214582371943,7
0.2,2167,88,164893,76.05765682656826,13
0.2,2168,95,164988,76.06639004149378,8
0.2,2169,94,165082,76.07465437788018,7
0.2,2170,93,165175,76.08245048364809,8
0.2,2171,96,165271,76.09162062615101,7
0.2,2172,27,165298,76.06902899217671,6
0.2,2173,86,165384,76.07359705611776,19
0.2,2174,89,165473,76.07954022988505,12
0.2,2175,96,165569,76.08869485294117,6
0.2,2176,93,165662,76.09646302250803,8
0.2,2177,92,165754,76.10376492194673,9
0.2,2178,94,165848,76.11197797154658,7
0.2,2179,23,165871,76.08761467889909,10
0.2,2180,96,165967,76.09674461256304,6
0.2,2181,84,166051,76.10036663611366,17
0.2,2182,94,166145,76.10856619331196,7
0.2,2183,15,166160,76.08058608058609,18
0.2,2184,96,166256,76.08970251716246,6
0.2,2185,93,166349,76.09743824336688,8
0.2,2186,94,166443,76.10562414266118,7
0.2,2187,94,166537,76.11380255941499,8
0.2,2188,94,166631,76.12197350388305,7
0.2,2189,92,166723,76.12922374429223,9
0.2,2190,96,166819,76.13829301688726,6
0.2,2191,92,166911,76.1455291970803,9
0.2,2192,84,166995,76.14911080711354,19
0.2,2193,93,167088,76.15679124886053,8
0.2,2194,87,167175,76.1617312072893,15
0.2,2195,90,167265,76.16803278688525,11
0.2,2196,23,167288,76.14383249886208,10
0.2,2197,19,167307,76.11783439490446,13
0.2,2198,20,167327,76.09231468849477,12
0.2,2199,95,167422,76.10090909090908,6
0.2,2200,95,167517,76.1094956837801,6
0.2,2201,-50,167467,76.05222524977293,13
0.2,2202,91,167558,76.05901044030867,10
0.2,2203,95,167653,76.06760435571688,6
0.2,2204,90,167743,76.07392290249433,11
0.2,2205,95,167838,76.08250226654579,6
0.2,2206,86,167924,76.08699592206615,17
0.2,2207,91,168015,76.09375,10
0.2,2208,94,168109,76.10185604345858,7
0.2,2209,93,168202,76.10950226244344,8
0.2,2210,92,168294,76.11668928086839,9
0.2,2211,-46,168248,76.0614828209765,10
0.2,2212,95,168343,76.07004066877542,6
0.2,2213,94,168437,76.07813911472448,8
0.2,2214,25,168462,76.055079006772,7
0.2,2215,92,168554,76.06227436823104,9
0.2,2216,93,168647,76.06991429860172,10
0.2,2217,95,168742,76.07844905320108,6
0.2,2218,88,168830,76.08382154123478,13
0.2,2219,96,168926,76.09279279279279,6
0.2,2220,85,169011,76.09680324178298,17
0.2,2221,21,169032,76.07200720072007,12
0.2,2222,91,169123,76.0787224471435,10
0.2,2223,93,169216,76.0863309352518,8
0.2,2224,92,169308,76.09348314606741,9
0.2,2225,93,169401,76.1010781671159,8
0.2,2226,88,169489,76.10642119443197,13
0.2,2227,91,169580,76.11310592459606,10
0.2,2228,84,169664,76.116644235083,17
0.2,2229,95,169759,76.12511210762332,6
0.2,2230,94,169853,76.1331241595697,7
0.2,2231,96,169949,76.14202508960574,6
0.2,2232,95,170044,76.15047021943573,7
0.2,2233,27,170071,76.1284691136974,6
0.2,2234,94,170165,76.13646532438479,7
0.2,2235,94,170259,76.14445438282648,7
0.2,2236,91,170350,76.15109521680823,10
0.2,2237,23,170373,76.12734584450402,10
0.2,2238,94,170467,76.1353282715498,7
0.2,2239,94,170561,76.14330357142858,7
0.2,2240,85,170646,76.14725568942437,16
0.2,2241,93,170739,76.15477252453167,8
0.2,2242,89,170828,76.16049933125278,12
0.2,2243,94,170922,76.16844919786097,7
0.2,2244,95,171017,76.17683741648106,8
0.2,2245,93,171110,76.18432769367764,8
0.2,2246,95,171205,76.19270137961726,6
0.2,2247,-52,171153,76.13567615658363,15
0.2,2248,96,171249,76.14450867052022,8
0.2,2249,94,171343,76.15244444444444,7
0.2,2250,93,171436,76.15992892047979,8
0.2,2251,92,171528,76.16696269982238,9
0.2,2252,94,171622,76.17487794052374,7
0.2,2253,94,171716,76.18278615794144,7
0.2,2254,94,171810,76.19068736141907,7
0.2,2255,94,171904,76.19858156028369,7
0.2,2256,95,171999,76.20691182986265,7
0.2,2257,-56,171943,76.14836138175376,19
0.2,2258,92,172035,76.15537848605578,9
0.2,2259,95,172130,76.16371681415929,6
0.2,2260,85,172215,76.16762494471473,16
0.2,2261,93,172308,76.17506631299734,8
0.2,2262,94,172402,76.18294299602297,7
0.2,2263,94,172496,76.19081272084806,7
0.2,2264,94,172590,76.19867549668874,7
0.2,2265,92,172682,76.20564872021183,9
0.2,2266,91,172773,76.2121746801941,10
0.2,2267,94,172867,76.2200176366843,7
0.2,2268,87,172954,76.22476862053769,14
0.2,2269,94,173048,76.23259911894273,7
0.2,2270,93,173141,76.23998238661383,9
0.2,2271,95,173236,76.24823943661971,6
0.2,2272,86,173322,76.25252969643643,15
0.2,2273,88,173410,76.25769569041337,14
0.2,2274,90,173500,76.26373626373626,11
0.2,2275,94,173594,76.27152899824253,8
0.2,2276,94,173688,76.27931488801055,8
0.2,2277,93,173781,76.28665496049166,8
0.2,2278,95,173876,76.29486616937253,6
0.2,2279,93,173969,76.30219298245613,9
0.2,2280,18,173987,76.27663305567734,14
0.2,2281,22,174009,76.25284837861525,12
0.2,2282,89,174098,76.25843188786685,12
0.2,2283,95,174193,76.26663747810858,7
0.2,2284,27,174220,76.24507658643326,6
0.2,2285,96,174316,76.25371828521435,6
0.2,2286,91,174407,76.26016615653695,10
0.2,2287,85,174492,76.26398601398601,18
0.2,2288,93,174585,76.27129750982962,8
0.2,2289,91,174676,76.27772925764192,10
0.2,2290,88,174764,76.28284591881274,15
0.2,2291,94,174858,76.29057591623037,7
0.2,2292,17,174875,76.2647187091147,15
0.2,2293,96,174971,76.27332170880558,6
0.2,2294,89,175060,76.27886710239652,12
0.2,2295,96,175156,76.28745644599303,6
0.2,2296,92,175248,76.29429690901175,9
0.2,2297,95,175343,76.3024369016536,6
0.2,2298,91,175434,76.30882992605481,11
0.2,2299,95,175529,76.31695652173913,6
0.2,2300,19,175548,76.29204693611473,14
0.2,2301,95,175643,76.30017376194614,6
0.2,2302,23,175666,76.27702996092054,9
0.2,2303,86,175752,76.28125,15
0.2,2304,-57,175695,76.22342733188721,20
0.2,2305,-50,175645,76.16869037294016,14
0.2,2306,91,175736,76.1751192024274,10
0.2,2307,94,175830,76.18284228769497,7
0.2,2308,92,175922,76.18969250757904,9
0.2,2309,90,176012,76.195670995671,11
0.2,2310,25,176037,76.17351795759411,8
0.2,2311,89,176126,76.17906574394463,13
0.2,2312,96,176222,76.18763510592305,6
0.2,2313,82,176304,76.19014693171997,19
0.2,2314,-120,176184,76.10539956803456,14
0.2,2315,86,176270,76.10967184801382,15
0.2,2316,93,176363,76.11696158826068,8
0.2,2317,89,176452,76.12251941328732,12
0.2,2318,93,176545,76.1297973264338,8
0.2,2319,94,176639,76.1375,7
0.2,2320,26,176665,76.11589831968979,6
0.2,2321,91,176756,76.12230835486649,10
0.2,2322,92,176848,76.12914334911753,10
0.2,2323,92,176940,76.13597246127367,9
0.2,2324,92,177032,76.14279569892473,9
0.2,2325,92,177124,76.14961306964746,9
0.2,2326,93,177217,76.1568543188655,8
0.2,2327,95,177312,76.16494845360825,6
0.2,2328,95,177407,76.17303563761271,6
0.2,2329,94,177501,76.18068669527896,7
0.2,2330,95,177596,76.18876018876018,6
0.2,2331,96,177692,76.19725557461406,6
0.2,2332,94,177786,76.20488641234462,7
0.2,2333,94,177880,76.21251071122536,7
0.2,2334,94,177974,76.22012847965739,7
0.2,2335,91,178065,76.22645547945206,10
0.2,2336,94,178159,76.23406076166025,7
0.2,2337,94,178253,76.24165953806673,9
0.2,2338,92,178345,76.24839675074819,10
0.2,2339,94,178439,76.2559829059829,8
0.2,2340,94,178533,76.26356258009397,8
0.2,2341,91,178624,76.26985482493595,10
0.2,2342,89,178713,76.2752880921895,12
0.2,2343,74,178787,76.27431740614334,27
0.2,2344,92,178879,76.28102345415778,9
0.2,2345,96,178975,76.28942881500426,6
0.2,2346,94,179069,76.29697486152536,7
0.2,2347,92,179161,76.30366269165248,9
0.2,2348,94,179255,76.31119625372499,7
0.2,2349,93,179348,76.31829787234042,8
0.2,2350,94,179442,76.32581880051042,7
0.2,2351,90,179532,76.33163265306122,11
0.2,2352,93,179625,76.33871653208669,8
0.2,2353,91,179716,76.34494477485131,10
0.2,2354,92,179808,76.3515923566879,9
0.2,2355,22,179830,76.32852292020374,11
0.2,2356,91,179921,76.33474756045821,10
0.2,2357,26,179947,76.31340118744698,7
0.2,2358,95,180042,76.32132259431962,7
0.2,2359,92,180134,76.32796610169491,9
0.2,2360,21,180155,76.30453197797543,11
0.2,2361,25,180180,76.28281117696866,8
0.2,2362,91,180271,76.2890393567499,10
0.2,2363,93,180364,76.29610829103216,8
0.2,2364,90,180454,76.30190274841438,11
0.2,2365,92,180546,76.30853761622993,9
0.2,2366,95,180641,76.31643430502746,9
0.2,2367,88,180729,76.32136824324324,13
0.2,2368,20,180749,76.29759392148586,13
0.2,2369,94,180843,76.30506329113923,7
0.2,2370,21,180864,76.28173766343315,12
0.2,2371,20,180884,76.25801011804384,12
0.2,2372,94,180978,76.26548672566372,7
0.2,2373,95,181073,76.27337826453244,6
0.2,2374,94,181167,76.28084210526316,7
0.2,2375,94,181261,76.28829966329967,7
0.2,2376,94,181355,76.2957509465713,8
0.2,2377,19,181374,76.27165685449958,14
0.2,2378,93,181467,76.27868852459017,10
0.2,2379,92,181559,76.28529411764706,9
0.2,2380,94,181653,76.2927341453171,7
0.2,2381,94,181747,76.30016792611251,7
0.2,2382,95,181842,76.30801510700798,7
0.2,2383,92,181934,76.31459731543625,9
0.2,2384,87,182021,76.31907756813418,14
0.2,2385,95,182116,76.32690695725063,6
0.2,2386,90,182206,76.33263510682866,12
0.2,2387,84,182290,76.3358458961474,17
0.2,2388,90,182380,76.341565508581,11
0.2,2389,95,182475,76.34937238493724,6
0.2,2390,92,182567,76.35591802593058,9
0.2,2391,87,182654,76.36036789297658,14
0.2,2392,92,182746,76.36690346844965,9
0.2,2393,94,182840,76.37426900584795,7
0.2,2394,15,182855,76.34864300626305,17
0.2,2395,94,182949,76.3560100166945,7
0.2,2396,91,183040,76.36211931581143,10
0.2,2397,95,183135,76.36989157631359,7
0.2,2398,93,183228,76.37682367653188,8
0.2,2399,89,183317,76.38208333333333,12
0.2,2400,95,183412,76.38983756768013,7
0.2,2401,96,183508,76.39800166527894,6
0.2,2402,95,183603,76.40574282147315,8
0.2,2403,22,183625,76.38311148086522,10
0.2,2404,96,183721,76.3912681912682,6
0.2,2405,89,183810,76.39650872817955,12
0.2,2406,94,183904,76.4038221852929,7
0.2,2407,92,183996,76.41029900332227,10
0.2,2408,19,184015,76.38646741386468,13
0.2,2409,96,184111,76.39460580912863,6
0.2,2410,94,184205,76.40190792202405,7
0.2,2411,95,184300,76.40961857379767,6
0.2,2412,85,184385,76.41317861583092,16
0.2,2413,96,184481,76.42129246064623,6
0.2,2414,95,184576,76.42898550724638,7
0.2,2415,93,184669,76.43584437086092,8
0.2,2416,88,184757,76.44062887877534,13
0.2,2417,93,184850,76.44747725392887,8
0.2,2418,96,184946,76.45556014882183,6
0.2,2419,89,185035,76.4607438016529,12
0.2,2420,94,185129,76.46798843453118,7
0.2,2421,91,185220,76.47398843930635,10
0.2,2422,27,185247,76.45356995460173,6
0.2,2423,89,185336,76.45874587458746,12
0.2,2424,-50,185286,76.40659793814433,13
0.2,2425,95,185381,76.41426215993405,7
0.2,2426,96,185477,76.42233209723939,6
0.2,2427,94,185571,76.42957166392092,8
0.2,2428,94,185665,76.4368052696583,7
0.2,2429,95,185760,76.44444444444444,6
0.2,2430,-126,185634,76.36116824352118,20
0.2,2431,90,185724,76.36677631578948,11
0.2,2432,92,185816,76.37320180846692,9
0.2,2433,95,185911,76.38085456039441,7
0.2,2434,96,186007,76.38891170431212,6
0.2,2435,20,186027,76.36576354679804,12
0.2,2436,25,186052,76.34468608945424,10
0.2,2437,92,186144,76.35110746513536,9
0.2,2438,92,186236,76.35752357523575,9
0.2,2439,92,186328,76.3639344262295,9
0.2,2440,92,186420,76.37034002458009,9
0.2,2441,85,186505,76.37387387387388,17
0.2,2442,86,186591,76.37781416291445,16
0.2,2443,92,186683,76.3842062193126,9
0.2,2444,93,186776,76.39100204498978,8
0.2,2445,94,186870,76.39820114472609,7
0.2,2446,91,186961,76.40416836943196,10
0.2,2447,94,187055,76.41135620915033,7
0.2,2448,93,187148,76.41812984891793,8
0.2,2449,96,187244,76.4261224489796,6
0.2,2450,95,187339,76.43370053039575,6
0.2,2451,95,187434,76.44127243066885,6
0.2,2452,94,187528,76.44843049327355,7
0.2,2453,92,187620,76.45476772616136,9
0.2,2454,94,187714,76.46191446028513,7
0.2,2455,93,187807,76.46864820846906,8
0.2,2456,-50,187757,76.41717541717541,13
0.2,2457,86,187843,76.42107404393816,15
0.2,2458,-47,187796,76.37088247254982,11
0.2,2459,91,187887,76.37682926829268,11
0.2,2460,24,187911,76.35554652580252,9
0.2,2461,88,187999,76.36027619821283,13
0.2,2462,25,188024,76.33942346731628,9
0.2,2463,91,188115,76.34537337662337,10
0.2,2464,96,188211,76.35334685598377,6
0.2,2465,88,188299,76.3580697485807,13
0.2,2466,96,188395,76.36603161734901,6
0.2,2467,90,188485,76.37155591572123,11
0.2,2468,94,188579,76.37869582827055,7
0.2,2469,93,188672,76.38542510121458,8
0.2,2470,92,188764,76.391744233104,9
0.2,2471,91,188855,76.39765372168284,10
0.2,2472,95,188950,76.40517589971694,7
0.2,2473,95,189045,76.41269199676637,7
0.2,2474,84,189129,76.41575757575758,17
0.2,2475,93,189222,76.42245557350566,8
0.2,2476,94,189316,76.4295518772709,8
0.2,2477,92,189408,76.4358353510896,9
0.2,2478,95,189503,76.44332392093587,9
0.2,2479,96,189599,76.45120967741936,6
0.2,2480,93,189692,76.45787988714228,8
0.2,2481,93,189785,76.4645447219984,8
0.2,2482,90,189875,76.46999597261377,11
0.2,2483,93,189968,76.47665056360708,8
0.2,2484,25,189993,76.45593561368209,8
0.2,2485,91,190084,76.46178600160901,10
0.2,2486,92,190176,76.46803377563329,9
0.2,2487,94,190270,76.4750803858521,7
0.2,2488,95,190365,76.48252310164725,7
0.2,2489,94,190459,76.48955823293173,7
0.2,2490,91,190550,76.4953833801686,10
0.2,2491,94,190644,76.5024077046549,7
0.2,2492,16,190660,76.4781387886081,16
0.2,2493,93,190753,76.48476343223737,9
0.2,2494,94,190847,76.49178356713426,8
0.2,2495,93,190940,76.49839743589743,8
0.2,2496,92,191032,76.50460552663196,9
0.2,2497,90,191122,76.51000800640513,12
0.2,2498,94,191216,76.51700680272108,8
0.2,2499,93,191309,76.5236,9
0.2,2500,95,191404,76.53098760495801,6
0.2,2501,93,191497,76.53756994404476,8
0.2,2502,24,191521,76.51658010387536,10
0.2,2503,94,191615,76.52356230031948,7
0.2,2504,88,191703,76.52814371257485,14
0.2,2505,27,191730,76.50837988826815,6
0.2,2506,95,191825,76.51575588352613,6
0.2,2507,27,191852,76.49601275917065,6
0.2,2508,90,191942,76.50139497807892,11
0.2,2509,92,192034,76.50756972111554,9
0.2,2510,93,192127,76.51413779370769,8
0.2,2511,92,192219,76.5203025477707,9
0.2,2512,87,192306,76.52447274174294,16
0.2,2513,93,192399,76.5310262529833,8
0.2,2514,93,192492,76.53757455268389,8
0.2,2515,93,192585,76.54411764705883,8
0.2,2516,90,192675,76.54946364719905,11
0.2,2517,94,192769,76.55639396346307,7
0.2,2518,95,192864,76.56371576022231,6
0.2,2519,93,192957,76.5702380952381,8
0.2,2520,87,193044,76.57437524791749,15
0.2,2521,90,193134,76.5796986518636,11
0.2,2522,96,193230,76.58739595719382,6
0.2,2523,93,193323,76.59389857369256,8
0.2,2524,89,193412,76.59881188118811,12
0.2,2525,-53,193359,76.54750593824228,16
0.2,2526,95,193454,76.55480807281361,7
0.2,2527,92,193546,76.56091772151899,9
0.2,2528,94,193640,76.56781336496638,7
0.2,2529,27,193667,76.54822134387352,6
0.2,2530,26,193693,76.52824970367443,7
0.2,2531,94,193787,76.53515007898895,7
0.2,2532,94,193881,76.54204500592184,7
0.2,2533,20,193901,76.5197316495659,13
0.2,2534,22,193923,76.498224852071,11
0.2,2535,94,194017,76.5051261829653,7
0.2,2536,18,194035,76.48206543161214,14
0.2,2537,27,194062,76.46256895193065,8
0.2,2538,95,194157,76.46987002756991,6
0.2,2539,88,194245,76.4744094488189,14
0.2,2540,94,194339,76.48130657221566,8
0.2,2541,94,194433,76.48819826907946,7
0.2,2542,19,194452,76.46559182068422,14
0.2,2543,95,194547,76.47287735849056,6
0.2,2544,94,194641,76.47976424361494,7
0.2,2545,92,194733,76.48586017282011,9
0.2,2546,20,194753,76.46368276403612,12
0.2,2547,-50,194703,76.41405023547881,15
0.2,2548,95,194798,76.42134170262848,7
0.2,2549,27,194825,76.40196078431373,6
0.2,2550,94,194919,76.40885927087416,7
0.2,2551,87,195006,76.41300940438872,15
0.2,2552,24,195030,76.3924794359577,8
0.2,2553,93,195123,76.3989819890368,8
0.2,2554,17,195140,76.37573385518591,16
0.2,2555,94,195234,76.38262910798122,9
0.2,2556,95,195329,76.38991005084083,7
0.2,2557,94,195423,76.39679437060204,7
0.2,2558,81,195504,76.39859320046894,20
0.2,2559,90,195594,76.40390625,11
0.2,2560,17,195611,76.38071065989848,15
0.2,2561,91,195702,76.3864168618267,11
0.2,2562,93,195795,76.39289894654702,8
0.2,2563,92,195887,76.39898595943838,9
0.2,2564,91,195978,76.4046783625731,11
0.2,2565,21,195999,76.38308651597818,11
0.2,2566,93,196092,76.3895597974289,8
0.2,2567,92,196184,76.39563862928348,9
0.2,2568,94,196278,76.4024912417283,7
0.2,2569,94,196372,76.40933852140078,7
0.2,2570,93,196465,76.41579152080902,9
0.2,2571,95,196560,76.42301710730949,7
0.2,2572,91,196651,76.42868247182278,10
0.2,2573,91,196742,76.43434343434343,10
0.2,2574,23,196765,76.41359223300971,10
0.2,2575,91,196856,76.4192546583851,10
0.2,2576,93,196949,76.42568878540939,8
0.2,2577,92,197041,76.43173002327386,9
0.2,2578,94,197135,76.43854207057,7
0.2,2579,26,197161,76.41899224806201,8
0.2,2580,96,197257,76.42657884540876,6
0.2,2581,94,197351,76.43338497288923,7
0.2,2582,89,197440,76.43825009678669,12
0.2,2583,23,197463,76.41756965944272,9
0.2,2584,93,197556,76.42398452611218,8
0.2,2585,91,197647,76.42962103634957,10
0.2,2586,92,197739,76.43563973714727,9
0.2,2587,91,197830,76.44126738794436,11
0.2,2588,88,197918,76.44573194283507,13
0.2,2589,89,198007,76.45057915057914,12
0.2,2590,92,198099,76.45658047086067,9
0.2,2591,23,198122,76.43595679012346,10
0.2,2592,95,198217,76.44311608175857,6
0.2,2593,95,198312,76.45026985350809,6
0.2,2594,-45,198267,76.40346820809249,9
0.2,2595,91,198358,76.4090909090909,11
0.2,2596,92,198450,76.41509433962264,11
0.2,2597,91,198541,76.42070823710547,12
0.2,2598,-122,198419,76.34436321662177,17
0.2,2599,91,198510,76.35,11
0.2,2600,89,198599,76.35486351403307,13
0.2,2601,93,198692,76.36126056879324,9
0.2,2602,92,198784,76.36726853630427,9
0.2,2603,93,198877,76.3736559139785,8
0.2,2604,91,198968,76.37927063339731,10
0.2,2605,93,199061,76.38564850345357,8
0.2,2606,94,199155,76.39240506329114,7
0.2,2607,24,199179,76.37231595092024,9
0.2,2608,94,199273,76.37907244154849,8
0.2,2609,95,199368,76.38620689655173,8
0.2,2610,95,199463,76.39333588663348,7
0.2,2611,90,199553,76.39854517611026,11
0.2,2612,95,199648,76.40566398775354,6
0.2,2613,22,199670,76.38485080336649,12
0.2,2614,89,199759,76.38967495219886,12
0.2,2615,94,199853,76.39640672782875,8
0.2,2616,95,199948,76.40351547573557,6
0.2,2617,88,200036,76.40794499618029,13
0.2,2618,87,200123,76.41198930889652,14
0.2,2619,23,200146,76.39160305343512,9
0.2,2620,93,200239,76.39793971766501,8
0.2,2621,94,200333,76.40465293668954,7
0.2,2622,92,200425,76.41059855127716,13
0.2,2623,95,200520,76.41768292682927,6
0.2,2624,92,200612,76.42361904761904,10
0.2,2625,94,200706,76.43031226199543,7
0.2,2626,94,200800,76.43700038066235,8
0.2,2627,94,200894,76.44368340943683,7
0.2,2628,85,200979,76.44693799923925,16
0.2,2629,94,201073,76.45361216730038,7
0.2,2630,88,201161,76.45800076016724,13
0.2,2631,94,201255,76.46466565349544,7
0.2,2632,25,201280,76.44511963539689,8
0.2,2633,91,201371,76.45064540622627,10
0.2,2634,95,201466,76.45768500948766,6
0.2,2635,91,201557,76.46320182094082,10
0.2,2636,21,201578,76.44216913158893,11
0.2,2637,94,201672,76.44882486732374,7
0.2,2638,24,201696,76.42895035998484,9
0.2,2639,95,201791,76.43598484848485,7
0.2,2640,20,201811,76.41461567588034,13
0.2,2641,89,201900,76.41937925813778,12
0.2,2642,89,201989,76.42413923571699,12
0.2,2643,95,202084,76.43116490166415,8
0.2,2644,-47,202037,76.38449905482041,11
0.2,2645,91,202128,76.39002267573696,10
0.2,2646,23,202151,76.36985266339252,9
0.2,2647,20,202171,76.34856495468279,12
0.2,2648,88,202259,76.35296338240846,13
0.2,2649,95,202354,76.36,6
0.2,2650,21,202375,76.33911731422104,12
0.2,2651,95,202470,76.34615384615384,6
0.2,2652,25,202495,76.32679984922729,8
0.2,2653,91,202586,76.33232856066314,10
0.2,2654,93,202679,76.33860640301319,8
0.2,2655,94,202773,76.34525602409639,8
0.2,2656,96,202869,76.35265336846066,6
0.2,2657,23,202892,76.33258088788563,10
0.2,2658,87,202979,76.33659270402407,14
0.2,2659,92,203071,76.34248120300752,9
0.2,2660,88,203159,76.34686208192409,13
0.2,2661,93,203252,76.35311795642374,8
0.2,2662,95,203347,76.36012016522719,7
0.2,2663,93,203440,76.36636636636636,8
0.2,2664,91,203531,76.3718574108818,11
0.2,2665,84,203615,76.37471867966991,17
0.2,2666,87,203702,76.37870266216723,14
0.2,2667,91,203793,76.38418290854572,10
0.2,2668,92,203885,76.39003372049457,9
0.2,2669,94,203979,76.39662921348315,7
0.2,2670,27,204006,76.37813552976414,6
0.2,2671,95,204101,76.38510479041916,7
0.2,2672,96,204197,76.3924429479985,6
0.2,2673,93,204290,76.39865370231863,8
0.2,2674,94,204384,76.40523364485982,7
0.2,2675,89,204473,76.40994020926756,14
0.2,2676,95,204568,76.4168845722824,6
0.2,2677,90,204658,76.4219566840926,11
0.2,2678,95,204753,76.42889137737961,7
0.2,2679,96,204849,76.43619402985074,6
0.2,2680,91,204940,76.44162625885863,10
0.2,2681,96,205036,76.4489187173751,6
0.2,2682,94,205130,76.45546030562802,7
0.2,2683,96,205226,76.46274217585693,6
0.2,2684,95,205321,76.46964618249534,6
0.2,2685,95,205416,76.4765450483991,6
0.2,2686,89,205505,76.48120580573129,13
0.2,2687,88,205593,76.48549107142857,13
0.2,2688,94,205687,76.49200446262552,7
0.2,2689,91,205778,76.49739776951672,10
0.2,2690,95,205873,76.5042735042735,6
0.2,2691,92,205965,76.51002971768202,10
0.2,2692,-47,205918,76.46416635722242,10
0.2,2693,94,206012,76.47067557535263,7
0.2,2694,90,206102,76.47569573283859,11
0.2,2695,94,206196,76.48219584569733,7
0.2,2696,24,206220,76.46273637374861,8
0.2,2697,93,206313,76.46886582653818,8
0.2,2698,93,206406,76.47499073731011,8
0.2,2699,93,206499,76.4811111111111,9
0.2,2700,86,206585,76.48463532025175,17
0.2,2701,89,206674,76.48926720947446,13
0.2,2702,22,206696,76.46910839807622,12
0.2,2703,24,206720,76.44970414201184,8
0.2,2704,94,206814,76.4561922365989,7
0.2,2705,95,206909,76.46304508499631,8
0.2,2706,91,207000,76.46841521980052,10
0.2,2707,94,207094,76.47488921713442,8
0.2,2708,94,207188,76.48135843484681,7
0.2,2709,95,207283,76.48819188191882,6
0.2,2710,24,207307,76.46883068978237,9
0.2,2711,90,207397,76.47382005899705,13
0.2,2712,93,207490,76.47991153704386,8
0.2,2713,20,207510,76.45910095799557,14
0.2,2714,89,207599,76.46372007366483,12
0.2,2715,96,207695,76.47091310751105,6
0.2,2716,95,207790,76.47773279352226,6
0.2,2717,96,207886,76.48491537895511,6
0.2,2718,94,207980,76.49135711658698,7
0.2,2719,95,208075,76.49816176470588,7
0.2,2720,96,208171,76.50532892319,6
0.2,2721,27,208198,76.4871418074945,8
0.2,2722,93,208291,76.493206022769,8
0.2,2723,93,208384,76.4992657856094,9
0.2,2724,-50,208334,76.45284403669724,13
0.2,2725,94,208428,76.45928099779897,8
0.2,2726,96,208524,76.46644664466447,6
0.2,2727,95,208619,76.4732404692082,7
0.2,2728,22,208641,76.45327958959325,10
0.2,2729,92,208733,76.45897435897436,9
0.2,2730,27,208760,76.44086415232516,7
0.2,2731,93,208853,76.44692532942899,8
0.2,2732,93,208946,76.45298207098426,8
0.2,2733,94,209040,76.45940014630578,7
0.2,2734,91,209131,76.46471663619744,10
0.2,2735,95,209226,76.47149122807018,6
0.2,2736,96,209322,76.47862623310193,6
0.2,2737,94,209416,76.48502556610664,7
0.2,2738,95,209511,76.49178532311062,7
0.2,2739,94,209605,76.49817518248175,8
0.2,2740,91,209696,76.50346588836192,10
0.2,2741,93,209789,76.50948212983224,10
0.2,2742,-56,209733,76.46117389719285,19
0.2,2743,96,209829,76.4682944606414,6
0.2,2744,95,209924,76.47504553734062,6
0.2,2745,92,210016,76.48069919883467,9
0.2,2746,92,210108,76.48634874408445,9
0.2,2747,89,210197,76.49090247452693,12
0.2,2748,94,210291,76.49727173517643,7
0.2,2749,26,210317,76.47890909090908,7
0.2,2750,95,210412,76.48564158487822,6
0.2,2751,96,210508,76.49273255813954,6
0.2,2752,19,210527,76.47184889211769,14
0.2,2753,95,210622,76.47857661583151,6
0.2,2754,23,210645,76.45916515426497,10
0.2,2755,91,210736,76.4644412191582,10
0.2,2756,92,210828,76.47007616974973,9
0.2,2757,91,210919,76.47534445250182,11
0.2,2758,93,211012,76.48133381660021,8
0.2,2759,96,211108,76.48840579710145,6
0.2,2760,87,211195,76.49221296631656,15
0.2,2761,95,211290,76.49891383055757,7
0.2,2762,94,211384,76.5052479189287,8
0.2,2763,96,211480,76.5123010130246,6
0.2,2764,95,211575,76.51898734177215,6
0.2,2765,96,211671,76.52603036876356,6
0.2,2766,94,211765,76.5323455005421,8
0.2,2767,91,211856,76.53757225433526,10
0.2,2768,92,211948,76.54315637414228,10
0.2,2769,94,212042,76.5494584837545,8
0.2,2770,-51,211991,76.50342836521112,14
0.2,2771,95,212086,76.51010101010101,6
0.2,2772,94,212180,76.51640822214209,7
0.2,2773,89,212269,76.52090843547224,12
0.2,2774,25,212294,76.50234234234235,7
0.2,2775,88,212382,76.50648414985591,14
0.2,2776,95,212477,76.51314368023047,6
0.2,2777,93,212570,76.5190784737221,9
0.2,2778,94,212664,76.52536883771141,7
0.2,2779,93,212757,76.53129496402877,9
0.2,2780,94,212851,76.53757641136282,7
0.2,2781,94,212945,76.54385334291877,7
0.2,2782,95,213040,76.55048508803449,7
0.2,2783,21,213061,76.5305316091954,11
0.2,2784,95,213156,76.53716337522442,7
0.2,2785,93,213249,76.54307250538406,8
0.2,2786,93,213342,76.54897739504844,8
0.2,2787,90,213432,76.55380200860832,12
0.2,2788,86,213518,76.55718895661528,15
0.2,2789,22,213540,76.53763440860214,10
0.2,2790,95,213635,76.5442493729846,6
0.2,2791,25,213660,76.52578796561605,8
0.2,2792,27,213687,76.50805585392051,6
0.2,2793,93,213780,76.51395848246241,8
0.2,2794,90,213870,76.51878354203936,11
0.2,2795,92,213962,76.52432045779685,9
0.2,2796,94,214056,76.5305684662138,7
0.2,2797,94,214150,76.53681200857756,7
0.2,2798,19,214169,76.51625580564487,13
0.2,2799,82,214251,76.51821428571428,20
0.2,2800,96,214347,76.52516958229204,6
0.2,2801,23,214370,76.50606709493219,9
0.2,2802,85,214455,76.50909739564752,16
0.2,2803,95,214550,76.51569186875892,6
0.2,2804,92,214642,76.52121212121212,10
0.2,2805,93,214735,76.52708481824662,8
0.2,2806,84,214819,76.52974706091914,17
0.2,2807,96,214915,76.53668091168092,6
0.2,2808,93,215008,76.54254182983269,8
0.2,2809,96,215104,76.54946619217081,6
0.2,2810,90,215194,76.55425115617219,11
0.2,2811,94,215288,76.56045519203414,8
0.2,2812,93,215381,76.56629932456453,9
0.2,2813,85,215466,76.56929637526652,16
0.2,2814,94,215560,76.57548845470693,7
0.2,2815,90,215650,76.58025568181819,11
0.2,2816,87,215737,76.58395456159035,14
0.2,2817,93,215830,76.58977998580554,8
0.2,2818,16,215846,76.56828662646329,17
0.2,2819,85,215931,76.57127659574468,16
0.2,2820,91,216022,76.5763913505849,10
0.2,2821,96,216118,76.58327427356485,6
0.2,2822,89,216207,76.58767268862911,12
0.2,2823,93,216300,76.59348441926346,8
0.2,2824,92,216392,76.59893805309734,9
0.2,2825,89,216481,76.6033262561925,12
0.2,2826,84,216565,76.60594269543685,17
0.2,2827,94,216659,76.61209335219236,7
0.2,2828,94,216753,76.61823966065748,7
0.2,2829,91,216844,76.62332155477031,10
0.2,2830,94,216938,76.62945955492759,7
0.2,2831,96,217034,76.63629943502825,6
0.2,2832,-49,216985,76.59195199435227,12
0.2,2833,96,217081,76.59880028228652,6
0.2,2834,21,217102,76.57918871252204,11
0.2,2835,93,217195,76.58497884344146,8
0.2,2836,26,217221,76.56714839619316,7
0.2,2837,93,217314,76.57293868921776,8
0.2,2838,90,217404,76.57766819302572,11
0.2,2839,23,217427,76.5588028169014,9
0.2,2840,95,217522,76.56529391059486,7
0.2,2841,94,217616,76.57142857142857,7
0.2,2842,86,217702,76.57474498768906,16
0.2,2843,94,217796,76.58087201125176,8
0.2,2844,95,217891,76.58734622144112,7
0.2,2845,90,217981,76.59205903021785,11
0.2,2846,24,218005,76.57358623112047,9
0.2,2847,95,218100,76.58005617977528,6
0.2,2848,24,218124,76.56160056160056,8
0.2,2849,20,218144,76.54175438596491,12
0.2,2850,95,218239,76.54822869168713,6
0.2,2851,95,218334,76.554698457223,9
0.2,2852,91,218425,76.55976165439888,10
0.2,2853,92,218517,76.56517168885775,9
0.2,2854,95,218612,76.57162872154116,6
0.2,2855,91,218703,76.5766806722689,10
0.2,2856,91,218794,76.58172908645432,10
0.2,2857,88,218882,76.58572428271519,13
0.2,2858,95,218977,76.59216509268975,6
0.2,2859,94,219071,76.59825174825176,8
0.2,2860,18,219089,76.57777001048585,14
0.2,2861,93,219182,76.58350803633823,8
0.2,2862,95,219277,76.58994062172546,6
0.2,2863,20,219297,76.57018156424581,13
0.2,2864,22,219319,76.55113438045375,10
0.2,2865,93,219412,76.55687369155618,10
0.2,2866,94,219506,76.56295779560516,8
0.2,2867,83,219589,76.56520223152022,18
0.2,2868,91,219680,76.57023353084699,10
0.2,2869,94,219774,76.57630662020905,7
0.2,2870,91,219865,76.5813305468478,13
0.2,2871,89,219954,76.58565459610028,12
0.2,2872,96,220050,76.5924121127741,6
0.2,2873,95,220145,76.59881697981906,9
0.2,2874,96,220241,76.6055652173913,6
0.2,2875,-49,220192,76.56189151599443,12
0.2,2876,94,220286,76.56795272853667,7
0.2,2877,93,220379,76.57366226546213,8
0.2,2878,93,220472,76.57936783605419,9
0.2,2879,18,220490,76.55902777777777,14
0.2,2880,92,220582,76.56438736549809,9
0.2,2881,95,220677,76.5707841776544,6
0.2,2882,94,220771,76.5768296912938,7
0.2,2883,91,220862,76.58183079056866,10
0.2,2884,95,220957,76.58821490467938,8
0.2,2885,95,221052,76.5945945945946,6
0.2,2886,94,221146,76.60062348458608,7
0.2,2887,95,221241,76.6069944598338,6
0.2,2888,92,221333,76.6123226029768,9
0.2,2889,94,221427,76.61833910034602,7
0.2,2890,95,221522,76.62469733656174,7
0.2,2891,27,221549,76.60753803596127,6
0.2,2892,90,221639,76.61216730038022,11
0.2,2893,94,221733,76.61817553559088,7
0.2,2894,-48,221685,76.57512953367876,11
0.2,2895,23,221708,76.55662983425414,9
0.2,2896,95,221803,76.56299620296859,6
0.2,2897,95,221898,76.56935817805383,6
0.2,2898,91,221989,76.57433597792343,10
0.2,2899,96,222085,76.58103448275862,6
0.2,2900,92,222177,76.58634953464323,9
0.2,2901,93,222270,76.592005513439,8
0.2,2902,92,222362,76.59731312435412,9
0.2,2903,25,222387,76.57954545454545,8
0.2,2904,96,222483,76.58623063683305,6
0.2,2905,23,222506,76.5677907777013,9
0.2,2906,89,222595,76.57206742346061,12
0.2,2907,92,222687,76.5773727647868,9
0.2,2908,93,222780,76.58301821931936,10
0.2,2909,11,222791,76.56048109965636,21
0.2,2910,96,222887,76.56715905187221,6
0.2,2911,94,222981,76.5731456043956,8
0.2,2912,90,223071,76.57775489186406,11
0.2,2913,91,223162,76.58270418668496,10
0.2,2914,94,223256,76.58867924528302,8
0.2,2915,19,223275,76.56893004115226,13
0.2,2916,-49,223226,76.52588275625642,14
0.2,2917,94,223320,76.5318711446196,7
0.2,2918,-45,223275,76.4902363823227,10
0.2,2919,92,223367,76.49554794520547,9
0.2,2920,26,223393,76.47826086956522,6
0.2,2921,91,223484,76.48323066392882,11
0.2,2922,95,223579,76.48956551488197,8
0.2,2923,21,223600,76.47058823529412,11
0.2,2924,22,223622,76.4519658119658,11
0.2,2925,92,223714,76.45727956254272,10
0.2,2926,92,223806,76.46258968226853,9
0.2,2927,90,223896,76.4672131147541,11
0.2,2928,95,223991,76.47354045749402,7
0.2,2929,90,224081,76.47815699658703,13
0.2,2930,94,224175,76.48413510747186,7
0.2,2931,92,224267,76.48942701227831,9
0.2,2932,91,224358,76.49437436072282,10
0.2,2933,94,224452,76.50034083162917,7
0.2,2934,94,224546,76.50630323679728,7
0.2,2935,94,224640,76.51226158038148,7
0.2,2936,92,224732,76.51753489955738,10
0.2,2937,-51,224681,76.47413206262763,16
0.2,2938,21,224702,76.45525689009867,11
0.2,2939,94,224796,76.46122448979592,7
0.2,2940,95,224891,76.4675280516831,8
0.2,2941,86,224977,76.47076818490822,15
0.2,2942,92,225069,76.47604485219163,9
0.2,2943,94,225163,76.4819972826087,7
0.2,2944,90,225253,76.48658743633277,12
0.2,2945,92,225345,76.4918533604888,9
0.2,2946,92,225437,76.49711571089243,9
0.2,2947,93,225530,76.50271370420624,8
0.2,2948,88,225618,76.50661241098678,13
0.2,2949,94,225712,76.51254237288136,7
0.2,2950,93,225805,76.51812944764487,8
0.2,2951,94,225899,76.5240514905149,7
0.2,2952,90,225989,76.52861496782933,11
0.2,2953,95,226084,76.53486797562627,6
0.2,2954,-56,226028,76.49001692047378,19
0.2,2955,93,226121,76.49560216508796,8
0.2,2956,88,226209,76.49949272911735,13
0.2,2957,81,226290,76.50101419878297,20
0.2,2958,93,226383,76.50659006421088,8
0.2,2959,91,226474,76.51148648648649,10
0.2,2960,96,226570,76.51806822019589,8
0.2,2961,90,226660,76.52261985145172,11
0.2,2962,94,226754,76.52851839352009,7
0.2,2963,94,226848,76.53441295546558,8
0.2,2964,93,226941,76.53996627318719,8
0.2,2965,94,227035,76.54585300067431,7
0.2,2966,96,227131,76.55240984159083,6
0.2,2967,92,227223,76.55761455525607,9
0.2,2968,94,227317,76.56348939036712,7
0.2,2969,88,227405,76.56734006734007,13
0.2,2970,96,227501,76.57388084819927,6
0.2,2971,74,227575,76.57301480484522,28
0.2,2972,18,227593,76.55331315169862,14
0.2,2973,-130,227463,76.48386012104909,25
0.2,2974,90,227553,76.48840336134454,11
0.2,2975,91,227644,76.49327956989248,10
0.2,2976,88,227732,76.49714477662076,13
0.2,2977,94,227826,76.50302216252518,7
0.2,2978,96,227922,76.50956696878147,7
0.2,2979,95,228017,76.51577181208053,6
0.2,2980,95,228112,76.52197249245219,8
0.2,2981,90,228202,76.52649228705566,11
0.2,2982,93,228295,76.53201475025142,8
0.2,2983,95,228390,76.53820375335121,7
0.2,2984,93,228483,76.54371859296482,8
0.2,2985,91,228574,76.54855994641662,10
0.2,2986,91,228665,76.55339805825243,10
0.2,2987,90,228755,76.55789825970548,14
0.2,2988,15,228770,76.53730344596855,17
0.2,2989,92,228862,76.54247491638796,9
0.2,2990,19,228881,76.52323637579404,13
0.2,2991,93,228974,76.52874331550802,8
0.2,2992,-50,228924,76.4864684263281,13
0.2,2993,93,229017,76.49198396793587,8
0.2,2994,93,229110,76.49749582637729,8
0.2,2995,91,229201,76.50233644859813,10
0.2,2996,95,229296,76.50850850850851,7
0.2,2997,90,229386,76.5130086724483,12
0.2,2998,-49,229337,76.47115705235079,13
0.2,2999,87,229424,76.47466666666666,14
0.2,3000,94,229518,76.48050649783406,8
0.2,3001,93,229611,76.48600932711526,8
0.2,3002,21,229632,76.46753246753246,11
0.2,3003,20,229652,76.44873501997337,12
0.2,3004,89,229741,76.45291181364392,12
0.2,3005,91,229832,76.45775116433799,10
0.2,3006,93,229925,76.4632524110409,8
0.2,3007,94,230019,76.46908244680851,7
0.2,3008,90,230109,76.47357926221336,11
0.2,3009,92,230201,76.47873754152823,9
0.2,3010,88,230289,76.48256393224842,13
0.2,3011,92,230381,76.48771580345286,9
0.2,3012,92,230473,76.49286425489545,9
0.2,3013,21,230494,76.47445255474453,12
0.2,3014,95,230589,76.48059701492538,7
0.2,3015,93,230682,76.48607427055703,8
0.2,3016,92,230774,76.49121644017235,10
0.2,3017,19,230793,76.47216699801193,13
0.2,3018,93,230886,76.47764160317986,8
0.2,3019,93,230979,76.48311258278146,10
0.2,3020,90,231069,76.4875868917577,11
0.2,3021,96,231165,76.49404367968233,6
0.2,3022,27,231192,76.47767118756202,7
0.2,3023,23,231215,76.45998677248677,10
0.2,3024,95,231310,76.46611570247934,7
0.2,3025,-50,231260,76.42432253800396,13
0.2,3026,92,231352,76.42946812025107,9
0.2,3027,91,231443,76.43428005284017,10
0.2,3028,94,231537,76.44007923407065,7
0.2,3029,93,231630,76.44554455445545,8
0.2,3030,93,231723,76.45100626855823,8
0.2,3031,92,231815,76.4561345646438,10
0.2,3032,96,231911,76.46257830530827,6
0.2,3033,20,231931,76.4439683586025,12
0.2,3034,92,232023,76.4490939044481,9
0.2,3035,94,232117,76.45487483530962,7
0.2,3036,95,232212,76.46098123147843,6
0.2,3037,92,232304,76.4660961158657,9
0.2,3038,89,232393,76.47022046725897,12
0.2,3039,95,232488,76.47631578947369,6
0.2,3040,94,232582,76.48207826372904,9
0.2,3041,90,232672,76.48652202498356,14
0.2,3042,87,232759,76.48997699638515,14
0.2,3043,93,232852,76.49540078843627,8
0.2,3044,94,232946,76.50114942528735,7
0.2,3045,95,233041,76.50722258699935,8
0.2,3046,94,233135,76.5129635707253,7
0.2,3047,94,233229,76.51870078740157,9
0.2,3048,22,233251,76.50081994096425,14
0.2,3049,26,233277,76.48426229508196,7
0.2,3050,23,233300,76.46673221894461,9
0.2,3051,94,233394,76.47247706422019,7
0.2,3052,94,233488,76.47821814608582,7
0.2,3053,90,233578,76.48264571054355,11
0.2,3054,94,233672,76.48837970540099,7
0.2,3055,93,233765,76.49378272251309,8
0.2,3056,94,233859,76.49950932286555,7
0.2,3057,96,233955,76.5058862001308,6
0.2,3058,91,234046,76.51062438705459,10
0.2,3059,-55,233991,76.46764705882353,19
0.2,3060,95,234086,76.47370140476968,7
0.2,3061,92,234178,76.47877204441542,10
0.2,3062,96,234274,76.48514528240287,6
0.2,3063,95,234369,76.49118798955614,6
0.2,3064,92,234461,76.4962479608483,9
0.2,3065,92,234553,76.50130463144161,9
0.2,3066,91,234644,76.50603195304858,10
0.2,3067,94,234738,76.51173402868318,7
0.2,3068,94,234832,76.51743238840012,7
0.2,3069,92,234924,76.52247557003257,9
0.2,3070,27,234951,76.5063497232172,7
0.2,3071,94,235045,76.51204427083333,8
0.2,3072,94,235139,76.51773511226814,7
0.2,3073,96,235235,76.52407286922576,6
0.2,3074,16,235251,76.50439024390244,16
0.2,3075,87,235338,76.50780234070221,15
0.2,3076,95,235433,76.51381215469613,6
0.2,3077,94,235527,76.51949317738791,7
0.2,3078,86,235613,76.52257226372198,15
0.2,3079,95,235708,76.52857142857142,8
0.2,3080,96,235804,76.53489126906848,6
0.2,3081,94,235898,76.54055807916937,10
0.2,3082,88,235986,76.5442750567629,15
0.2,3083,90,236076,76.54863813229572,11
0.2,3084,89,236165,76.55267423014587,12
0.2,3085,93,236258,76.55800388852884,9
0.2,3086,90,236348,76.56235827664399,11
0.2,3087,91,236439,76.56703367875647,10
0.2,3088,92,236531,76.57202978310133,9
0.2,3089,94,236625,76.57766990291262,7
0.2,3090,-121,236504,76.51374959560013,16
0.2,3091,94,236598,76.51940491591203,7
0.2,3092,94,236692,76.52505657937277,7
0.2,3093,89,236781,76.52908855850032,13
0.2,3094,92,236873,76.53408723747981,9
0.2,3095,91,236964,76.53875968992249,10
0.2,3096,25,236989,76.52211817888279,8
0.2,3097,24,237013,76.50516462233699,9
0.2,3098,92,237105,76.51016456921587,9
0.2,3099,93,237198,76.51548387096774,9
0.2,3100,96,237294,76.52176717188004,6
0.2,3101,15,237309,76.50193423597679,17
0.2,3102,94,237403,76.50757331614567,7
0.2,3103,94,237497,76.51320876288659,7
0.2,3104,91,237588,76.51787439613527,10
0.2,3105,19,237607,76.49935608499678,14
0.2,3106,94,237701,76.50498873511425,7
0.2,3107,86,237787,76.50804375804375,15
0.2,3108,93,237880,76.51334834351881,8
0.2,3109,91,237971,76.51800643086817,10
0.2,3110,92,238063,76.52298296367728,9
0.2,3111,94,238157,76.52859897172236,7
0.2,3112,93,238250,76.53389013813042,8
0.2,3113,93,238343,76.53917790622992,8
0.2,3114,96,238439,76.5454253611557,6
0.2,3115,95,238534,76.55134788189987,7
0.2,3116,94,238628,76.55694578119987,7
0.2,3117,92,238720,76.56189865298268,9
0.2,3118,25,238745,76.54536710484129,9
0.2,3119,88,238833,76.54903846153846,13
0.2,3120,93,238926,76.55430951618071,9
0.2,3121,95,239021,76.56021780909673,7
0.2,3122,19,239040,76.54178674351586,13
0.2,3123,93,239133,76.54705505761844,8
0.2,3124,94,239227,76.55264,7
0.2,3125,22,239249,76.53518873960333,10
0.2,3126,91,239340,76.53981451870803,10
0.2,3127,92,239432,76.54475703324808,9
0.2,3128,94,239526,76.5503355704698,9
0.2,3129,94,239620,76.55591054313099,7
0.2,3130,92,239712,76.56084318109231,9
0.2,3131,23,239735,76.54374201787995,10
0.2,3132,92,239827,76.54867539099904,9
0.2,3133,17,239844,76.52967453733248,17
0.2,3134,-48,239796,76.48995215311005,12
0.2,3135,95,239891,76.49585459183673,7
0.2,3136,94,239985,76.50143449155244,7
0.2,3137,90,240075,76.5057361376673,11
0.2,3138,93,240168,76.51099076138898,8
0.2,3139,91,240259,76.5156050955414,12
0.2,3140,16,240275,76.49633874562241,16
0.2,3141,93,240368,76.50159134309357,8
0.2,3142,95,240463,76.5074769328667,7
0.2,3143,91,240554,76.51208651399492,10
0.2,3144,84,240638,76.51446740858506,17
0.2,3145,94,240732,76.52002542911634,7
0.2,3146,94,240826,76.52557991738163,7
0.2,3147,-46,240780,76.4866581956798,10
0.2,3148,93,240873,76.4919021911718,8
0.2,3149,95,240968,76.49777777777778,6
0.2,3150,90,241058,76.50206283719454,11
0.2,3151,92,241150,76.50697969543147,9
0.2,3152,90,241240,76.51125911830003,11
0.2,3153,94,241334,76.51680405833862,7
0.2,3154,94,241428,76.52234548335974,8
0.2,3155,20,241448,76.50443599493029,12
0.2,3156,94,241542,76.509977827051,8
0.2,3157,93,241635,76.51519949335022,8
0.2,3158,91,241726,76.51978474200696,11
0.2,3159,93,241819,76.525,8
0.2,3160,25,241844,76.50869977855109,8
0.2,3161,18,241862,76.49019607843137,14
0.2,3162,92,241954,76.49509958899779,10
0.2,3163,95,242049,76.50094816687736,6
0.2,3164,94,242143,76.50647709320695,7
0.2,3165,92,242235,76.5113708149084,9
0.2,3166,94,242329,76.51689295863594,7
0.2,3167,93,242422,76.52209595959596,8
0.2,3168,96,242518,76.52824234774377,6
0.2,3169,92,242610,76.53312302839117,9
0.2,3170,93,242703,76.53831598864711,9
0.2,3171,94,242797,76.5438209331652,7
0.2,3172,95,242892,76.54963756697133,8
0.2,3173,93,242985,76.55482041587902,8
0.2,3174,86,243071,76.55779527559055,16
0.2,3175,90,243161,76.56202770780857,11
0.2,3176,94,243255,76.5675165250236,7
0.2,3177,95,243350,76.57331655129012,8
0.2,3178,88,243438,76.57691097829506,13
0.2,3179,94,243532,76.58238993710692,8
0.2,3180,22,243554,76.56523105941528,10
0.2,3181,94,243648,76.57071024512885,7
0.2,3182,-124,243524,76.5076971410619,18
0.2,3183,19,243543,76.48963567839196,14
0.2,3184,95,243638,76.49544740973312,6
0.2,3185,94,243732,76.50094161958569,8
0.2,3186,92,243824,76.50580483213054,10
0.2,3187,87,243911,76.5090966122961,14
0.2,3188,94,244005,76.5145813734713,7
0.2,3189,93,244098,76.51974921630094,8
0.2,3190,93,244191,76.52491382011908,10
0.2,3191,95,244286,76.53070175438596,7
0.2,3192,-53,244233,76.49013466958972,16
0.2,3193,87,244320,76.49342517219787,14
0.2,3194,87,244407,76.49671361502348,14
0.2,3195,95,244502,76.50250312891114,6
0.2,3196,94,244596,76.50797622771348,7
0.2,3197,96,244692,76.5140712945591,6
0.2,3198,93,244785,76.5192247577368,8
0.2,3199,23,244808,76.5025,9
0.2,3200,92,244900,76.50734145579506,9
0.2,3201,89,244989,76.51124297314179,12
0.2,3202,95,245084,76.51701529815797,6
0.2,3203,94,245178,76.52247191011236,7
0.2,3204,93,245271,76.52761310452418,8
0.2,3205,95,245366,76.53337492202121,7
0.2,3206,94,245460,76.53882132834424,7
0.2,3207,93,245553,76.54395261845387,8
0.2,3208,89,245642,76.54783421626675,12
0.2,3209,20,245662,76.53021806853583,12
0.2,3210,87,245749,76.53347866708191,14
0.2,3211,94,245843,76.53891656288917,7
0.2,3212,93,245936,76.54403983815749,8
0.2,3213,90,246026,76.54822650902302,11
0.2,3214,94,246120,76.55365474339035,8
0.2,3215,93,246213,76.55876865671642,8
0.2,3216,92,246305,76.56356854211998,9
0.2,3217,93,246398,76.56867619639527,8
0.2,3218,92,246490,76.57347002174589,9
0.2,3219,87,246577,76.57670807453417,14
0.2,3220,93,246670,76.58180689226948,8
0.2,3221,24,246694,76.56548727498448,10
0.2,3222,90,246784,76.56965560037233,11
0.2,3223,93,246877,76.57475186104219,8
0.2,3224,89,246966,76.57860465116279,12
0.2,3225,94,247060,76.58400495970241,7
0.2,3226,93,247153,76.5890920359467,8
0.2,3227,25,247178,76.5731102850062,8
0.2,3228,27,247205,76.55775781975844,6
0.2,3229,95,247300,76.56346749226006,6
0.2,3230,96,247396,76.56948313215723,6
0.2,3231,96,247492,76.57549504950495,6
0.2,3232,93,247585,76.580575317043,8
0.2,3233,85,247670,76.58317872603587,17
0.2,3234,92,247762,76.58794435857806,9
0.2,3235,90,247852,76.59208899876391,12
0.2,3236,92,247944,76.59684893419833,9
0.2,3237,23,247967,76.58029647930822,9
0.2,3238,91,248058,76.58474837912937,10
0.2,3239,90,248148,76.58888888888889,11
0.2,3240,94,248242,76.59426103054612,7
0.2,3241,96,248338,76.60024676125849,6
0.2,3242,93,248431,76.60530373111317,8
0.2,3243,26,248457,76.58970406905055,7
0.2,3244,93,248550,76.59476117103236,8
0.2,3245,92,248642,76.59950708564386,9
0.2,3246,95,248737,76.60517400677548,7
0.2,3247,95,248832,76.61083743842364,7
0.2,3248,92,248924,76.61557402277624,9
0.2,3249,94,249018,76.62092307692308,8
0.2,3250,91,249109,76.62534604737004,10
0.2,3251,14,249123,76.60608856088561,18
0.2,3252,93,249216,76.61112818936367,8
0.2,3253,95,249311,76.61677934849416,7
0.2,3254,93,249404,76.62181259600615,8
0.2,3255,20,249424,76.60442260442261,14
0.2,3256,24,249448,76.58827141541296,9
0.2,3257,91,249539,76.5926949048496,10
0.2,3258,94,249633,76.5980362074256,7
0.2,3259,92,249725,76.60276073619632,9
0.2,3260,89,249814,76.6065624041705,13
0.2,3261,91,249905,76.61097486204783,10
0.2,3262,94,249999,76.6163040147104,8
0.2,3263,96,250095,76.62224264705883,6
0.2,3264,24,250119,76.60612557427258,8
0.2,3265,93,250212,76.61114513165953,9
0.2,3266,26,250238,76.59565350474442,7
0.2,3267,15,250253,76.57680538555691,17
0.2,3268,94,250347,76.5821352095442,9
0.2,3269,91,250438,76.58654434250765,10
0.2,3270,93,250531,76.5915622133904,8
0.2,3271,94,250625,76.5968826405868,8
0.2,3272,90,250715,76.60097769630309,11
0.2,3273,93,250808,76.60598656078191,8
0.2,3274,95,250903,76.61160305343512,7
0.2,3275,93,250996,76.61660561660561,9
0.2,3276,90,251086,76.62068965517241,11
0.2,3277,87,251173,76.62385600976205,14
0.2,3278,21,251194,76.60689234522721,11
0.2,3279,92,251286,76.61158536585366,10
0.2,3280,15,251301,76.59280707101493,18
0.2,3281,88,251389,76.59628275441804,13
0.2,3282,93,251482,76.60127931769723,9
0.2,3283,94,251576,76.60657734470158,7
0.2,3284,94,251670,76.61187214611873,7
0.2,3285,90,251760,76.61594643944005,11
0.2,3286,93,251853,76.62093094006693,8
0.2,3287,89,251942,76.62469586374696,12
0.2,3288,83,252025,76.62663423532989,18
0.2,3289,91,252116,76.63100303951367,10
0.2,3290,82,252198,76.63263445761167,19
0.2,3291,93,252291,76.63760631834751,8
0.2,3292,93,252384,76.64257515942909,9
0.2,3293,23,252407,76.62629022465089,10
0.2,3294,94,252501,76.63156297420333,8
0.2,3295,91,252592,76.63592233009709,10
0.2,3296,88,252680,76.63936912344556,13
0.2,3297,23,252703,76.62310491206792,11
0.2,3298,93,252796,76.62806911185207,8
0.2,3299,20,252816,76.61090909090909,12
0.2,3300,87,252903,76.61405634656165,14
0.2,3301,92,252995,76.61871592973955,9
0.2,3302,92,253087,76.62337269149258,10
0.2,3303,20,253107,76.60623486682809,12
0.2,3304,94,253201,76.61149773071105,7
0.2,3305,95,253296,76.61705989110708,6
0.2,3306,94,253390,76.62231629876021,7
0.2,3307,92,253482,76.62696493349456,9
0.2,3308,93,253575,76.63191296464188,9
0.2,3309,94,253669,76.63716012084592,7
0.2,3310,93,253762,76.64210208396256,8
0.2,3311,92,253854,76.64673913043478,9
0.2,3312,92,253946,76.65137337760338,9
0.2,3313,95,254041,76.65691007845504,6
0.2,3314,90,254131,76.66093514328809,11
0.2,3315,92,254223,76.66556091676719,9
0.2,3316,93,254316,76.67048537835393,8
0.2,3317,94,254410,76.67570825798674,8
0.2,3318,93,254503,76.68062669478759,8
0.2,3319,92,254595,76.68524096385542,9
0.2,3320,94,254689,76.6904546823246,9
0.2,3321,92,254781,76.69506321493077,9
0.2,3322,-50,254731,76.6569365031598,14
0.2,3323,94,254825,76.6621540312876,7
0.2,3324,94,254919,76.66736842105263,7
0.2,3325,87,255006,76.67047504509922,14
0.2,3326,83,255089,76.67237751728284,19
0.2,3327,94,255183,76.67758413461539,8
0.2,3328,91,255274,76.6818864523881,10
0.2,3329,92,255366,76.68648648648649,9
0.2,3330,93,255459,76.69138396877814,8
0.2,3331,90,255549,76.6953781512605,11
0.2,3332,17,255566,76.67746774677468,15
0.2,3333,25,255591,76.6619676064787,7
0.2,3334,24,255615,76.64617691154423,10
0.2,3335,88,255703,76.64958033573141,14
0.2,3336,92,255795,76.65418040155829,9
0.2,3337,94,255889,76.65937687237867,7
0.2,3338,90,255979,76.66337226714585,12
0.2,3339,94,256073,76.66856287425149,7
0.2,3340,89,256162,76.67225381622269,12
0.2,3341,23,256185,76.65619389587074,9
0.2,3342,22,256207,76.63984445109183,11
0.2,3343,94,256301,76.64503588516746,7
0.2,3344,89,256390,76.64872944693572,12
0.2,3345,96,256486,76.65451285116558,6
0.2,3346,96,256582,76.66029279952195,6
0.2,3347,87,256669,76.66338112305854,15
0.2,3348,94,256763,76.66855777844133,7
0.2,3349,94,256857,76.67373134328358,7
0.2,3350,95,256952,76.67920023873471,6
0.2,3351,95,257047,76.68466587112172,6
0.2,3352,94,257141,76.6898300029824,7
0.2,3353,92,257233,76.6943947525343,9
0.2,3354,94,257327,76.69955290611028,7
0.2,3355,95,257422,76.70500595947557,7
0.2,3356,94,257516,76.71015787905868,7
0.2,3357,94,257610,76.71530673019655,9
0.2,3358,96,257706,76.72104793093183,6
0.2,3359,94,257800,76.72619047619048,7
0.2,3360,92,257892,76.73073490032728,9
0.2,3361,79,257971,76.73140987507436,22
0.2,3362,92,258063,76.73595004460303,9
0.2,3363,93,258156,76.74078478002379,8
0.2,3364,94,258250,76.74591381872214,7
0.2,3365,95,258345,76.75133689839572,8
0.2,3366,95,258440,76.75675675675676,6
0.2,3367,90,258530,76.7606888361045,11
0.2,3368,94,258624,76.76580587711487,7
0.2,3369,96,258720,76.77151335311572,7
0.2,3370,88,258808,76.77484425986354,13
0.2,3371,86,258894,76.77758007117438,15
0.2,3372,93,258987,76.78238956418619,8
0.2,3373,90,259077,76.78630705394191,11
0.2,3374,96,259173,76.792,6
0.2,3375,86,259259,76.79472748815166,15
0.2,3376,92,259351,76.79923008587504,9
0.2,3377,94,259445,76.80432208407342,8
0.2,3378,24,259469,76.78869488014206,10
0.2,3379,93,259562,76.79349112426036,8
0.2,3380,85,259647,76.79591836734694,16
0.2,3381,90,259737,76.79982259018333,12
0.2,3382,94,259831,76.80490688737807,8
0.2,3383,87,259918,76.8079196217494,15
0.2,3384,95,260013,76.81329394387001,7
0.2,3385,89,260102,76.81689308919078,12
0.2,3386,96,260198,76.82255683495718,6
0.2,3387,90,260288,76.82644628099173,11
0.2,3388,96,260384,76.83210386544704,6
0.2,3389,96,260480,76.83775811209439,6
0.2,3390,95,260575,76.84311412562666,6
0.2,3391,90,260665,76.84699292452831,11
0.2,3392,88,260753,76.85027998821103,13
0.2,3393,89,260842,76.85385975250442,12
0.2,3394,93,260935,76.85861561119293,8
0.2,3395,90,261025,76.86248527679624,11
0.2,3396,93,261118,76.86723579629084,8
0.2,3397,88,261206,76.87051206592113,14
0.2,3398,93,261299,76.87525742865549,8
0.2,3399,17,261316,76.85764705882353,15
0.2,3400,94,261410,76.86268744486915,7
0.2,3401,94,261504,76.86772486772487,7
0.2,3402,96,261600,76.87334704672348,6
0.2,3403,96,261696,76.87896592244418,7
0.2,3404,92,261788,76.8834067547724,9
0.2,3405,95,261883,76.88872577803876,6
0.2,3406,94,261977,76.89374816554154,7
0.2,3407,94,262071,76.89876760563381,7
0.2,3408,18,262089,76.88149017307128,14
0.2,3409,95,262184,76.88680351906159,6
0.2,3410,94,262278,76.89182058047493,7
0.2,3411,-48,262230,76.85521688159437,12
0.2,3412,90,262320,76.85906826838558,11
0.2,3413,93,262413,76.86379613356766,8
0.2,3414,93,262506,76.86852122986822,8
0.2,3415,90,262596,76.87236533957845,11
0.2,3416,94,262690,76.87737781679836,7
0.2,3417,95,262785,76.88267992978349,6
0.2,3418,95,262880,76.88797894121087,7
0.2,3419,93,262973,76.89269005847953,8
0.2,3420,95,263068,76.89798304589301,7
0.2,3421,92,263160,76.90239625949737,9
0.2,3422,92,263252,76.90680689453696,9
0.2,3423,94,263346,76.91179906542057,7
0.2,3424,93,263439,76.91649635036497,8
0.2,3425,94,263533,76.92148277875073,8
0.2,3426,96,263629,76.92704989786986,6
0.2,3427,22,263651,76.9110268378063,10
0.2,3428,93,263744,76.91571886847477,8
0.2,3429,87,263831,76.91865889212828,14
0.2,3430,95,263926,76.92392888370738,6
0.2,3431,92,264018,76.92832167832168,9
0.2,3432,90,264108,76.93212933294495,11
0.2,3433,23,264131,76.91642399534071,10
0.2,3434,93,264224,76.92110625909753,8
0.2,3435,95,264319,76.92636786961583,6
0.2,3436,94,264413,76.93133546697702,7
0.2,3437,96,264509,76.9368819080861,6
0.2,3438,91,264600,76.94097121256179,10
0.2,3439,21,264621,76.92470930232558,11
0.2,3440,93,264714,76.92938099389713,11
0.2,3441,95,264809,76.93463102847181,6
0.2,3442,91,264900,76.93871623584084,10
0.2,3443,21,264921,76.92247386759581,11
0.2,3444,90,265011,76.92626995645864,11
0.2,3445,96,265107,76.93180499129426,6
0.2,3446,95,265202,76.9370467072817,7
0.2,3447,94,265296,76.94199535962878,7
0.2,3448,96,265392,76.94752102058568,6
0.2,3449,92,265484,76.95188405797101,9
0.2,3450,95,265579,76.95711388003477,7
0.2,3451,21,265600,76.94090382387022,12
0.2,3452,96,265696,76.94642339994208,6
0.2,3453,92,265788,76.95078170237406,9
0.2,3454,93,265881,76.95542691751085,8
0.2,3455,92,265973,76.9597800925926,9
0.2,3456,92,266065,76.96413074920451,9
0.2,3457,91,266156,76.9681897050318,10
0.2,3458,94,266250,76.97311361665221,10
0.2,3459,95,266345,76.97832369942196,6
0.2,3460,21,266366,76.9621496677261,11
0.2,3461,-59,266307,76.92287694974003,22
0.2,3462,95,266402,76.92809702570025,7
0.2,3463,93,266495,76.93273672055427,8
0.2,3464,92,266587,76.93708513708513,9
0.2,3465,92,266679,76.94143104443162,9
0.2,3466,90,266769,76.94519757715604,11
0.2,3467,92,266861,76.949538638985,9
0.2,3468,94,266955,76.95445373306428,7
0.2,3469,95,267050,76.95965417867436,6
0.2,3470,95,267145,76.96485162777297,8
0.2,3471,93,267238,76.96947004608295,8
0.2,3472,92,267330,76.97379786927728,9
0.2,3473,93,267423,76.97841105354058,8
0.2,3474,93,267516,76.98302158273381,8
0.2,3475,91,267607,76.98705408515535,11
0.2,3476,92,267699,76.99137187230372,9
0.2,3477,95,267794,76.9965497412306,6
0.2,3478,95,267889,77.00172463351538,7
0.2,3479,95,267984,77.00689655172414,6
0.2,3480,92,268076,77.01120367710428,9
0.2,3481,92,268168,77.01550832854682,9
0.2,3482,94,268262,77.02038472581108,7
0.2,3483,92,268354,77.02468427095293,9
0.2,3484,17,268371,77.00746054519368,16
0.2,3485,92,268463,77.01176133103844,10
0.2,3486,94,268557,77.01663320906223,7
0.2,3487,22,268579,77.00086009174312,10
0.2,3488,94,268673,77.00573230151906,7
0.2,3489,88,268761,77.00888252148997,13
0.2,3490,93,268854,77.01346319106273,8
0.2,3491,21,268875,76.99742268041237,11
0.2,3492,95,268970,77.0025765817349,6
0.2,3493,94,269064,77.00744132799085,7
0.2,3494,96,269160,77.01287553648069,6
0.2,3495,23,269183,76.99742562929062,9
0.2,3496,22,269205,76.98169859879897,10
0.2,3497,94,269299,76.9865637507147,7
0.2,3498,92,269391,76.99085452986567,9
0.2,3499,96,269487,76.99628571428572,6
0.2,3500,92,269579,77.00057126535276,9
0.2,3501,95,269674,77.00571102227299,6
0.2,3502,-53,269621,76.96859834427633,16
0.2,3503,91,269712,76.97260273972603,11
0.2,3504,94,269806,76.97746077032811,7
0.2,3505,93,269899,76.98203080433542,8
0.2,3506,91,269990,76.98602794411178,10
0.2,3507,21,270011,76.97006841505132,13
0.2,3508,94,270105,76.97492163009404,7
0.2,3509,90,270195,76.97863247863248,11
0.2,3510,-49,270146,76.94275135289091,13
0.2,3511,95,270241,76.94789293849658,6
0.2,3512,95,270336,76.9530315969257,6
0.2,3513,93,270429,76.95759817871371,8
0.2,3514,95,270524,76.96273115220484,8
0.2,3515,89,270613,76.96615472127418,12
0.2,3516,25,270638,76.951379016207,7
0.2,3517,94,270732,76.95622512791358,7
0.2,3518,25,270757,76.94146064222791,9
0.2,3519,96,270853,76.946875,6
0.2,3520,96,270949,76.95228628230616,6
0.2,3521,95,271044,76.95741056218058,6
0.2,3522,93,271137,76.96196423502697,9
0.2,3523,92,271229,76.96623155505108,9
0.2,3524,94,271323,76.97106382978724,7
0.2,3525,95,271418,76.97617697107204,7
0.2,3526,89,271507,76.97958605046782,12
0.2,3527,95,271602,76.98469387755102,7
0.2,3528,93,271695,76.98923207707566,8
0.2,3529,19,271714,76.97280453257791,13
0.2,3530,92,271806,76.97706032285471,9
0.2,3531,94,271900,76.98187995469989,7
0.2,3532,90,271990,76.98556467591283,11
0.2,3533,25,272015,76.9708545557442,8
0.2,3534,89,272104,76.97425742574258,12
0.2,3535,84,272188,76.97624434389141,18
0.2,3536,94,272282,76.98105739327113,7
0.2,3537,92,272374,76.98530243075184,9
0.2,3538,94,272468,76.99011020062164,8
0.2,3539,93,272561,76.99463276836158,11
0.2,3540,93,272654,76.99915278170009,8
0.2,3541,93,272747,77.00367024280068,9
0.2,3542,87,272834,77.00649167372283,14
0.2,3543,27,272861,76.99238148984199,6
0.2,3544,88,272949,76.99548660084626,13
0.2,3545,93,273042,77.0,9
0.2,3546,94,273136,77.00479278263322,7
0.2,3547,19,273155,76.98844419391206,14
0.2,3548,93,273248,76.99295576218653,8
0.2,3549,93,273341,76.9974647887324,8
0.2,3550,93,273434,77.00197127569699,8
0.2,3551,25,273459,76.98733108108108,8
0.2,3552,91,273550,76.99127497889108,10
0.2,3553,95,273645,76.99634214969049,6
0.2,3554,90,273735,77.0,11
0.2,3555,96,273831,77.00534308211473,6
0.2,3556,94,273925,77.0101208883891,7
0.2,3557,94,274019,77.01489600899382,7
0.2,3558,96,274115,77.02023040179826,6
0.2,3559,93,274208,77.0247191011236,8
0.2,3560,91,274299,77.02864363942713,10
0.2,3561,94,274393,77.03340819764178,7
0.2,3562,93,274486,77.03788941902891,8
0.2,3563,91,274577,77.04180695847363,10
0.2,3564,93,274670,77.04628330995793,8
0.2,3565,12,274682,77.02804262478968,21
0.2,3566,94,274776,77.03280067283431,7
0.2,3567,25,274801,77.01821748878923,9
0.2,3568,24,274825,77.00336228635472,10
0.2,3569,94,274919,77.00812324929971,7
0.2,3570,19,274938,76.99187902548306,13
0.2,3571,89,275027,76.99524076147816,12
0.2,3572,94,275121,77.0,8
0.2,3573,96,275217,77.0053161723559,7
0.2,3574,94,275311,77.01006993006993,7
0.2,3575,96,275407,77.0153803131991,6
0.2,3576,92,275499,77.01956947162427,9
0.2,3577,92,275591,77.0237562884293,9
0.2,3578,87,275678,77.02654372729813,14
0.2,3579,95,275773,77.03156424581006,7
0.2,3580,92,275865,77.03574420552918,9
0.2,3581,21,275886,77.02010050251256,12
0.2,3582,85,275971,77.02232765838683,16
0.2,3583,94,276065,77.02706473214286,8
0.2,3584,94,276159,77.03179916317991,7
0.2,3585,89,276248,77.0351366424986,12
0.2,3586,89,276337,77.03847226094229,12
0.2,3587,90,276427,77.04208472686733,11
0.2,3588,92,276519,77.04625243800501,9
0.2,3589,95,276614,77.05125348189415,6
0.2,3590,23,276637,77.03620161514898,10
0.2,3591,-58,276579,76.99860801781738,21
0.2,3592,21,276600,76.98302254383523,11
0.2,3593,93,276693,76.98747913188647,8
0.2,3594,92,276785,76.99165507649514,9
0.2,3595,21,276806,76.97608453837597,11
0.2,3596,93,276899,76.98053933833751,8
0.2,3597,92,276991,76.98471372984991,9
0.2,3598,91,277082,76.98860794665185,10
0.2,3599,94,277176,76.99333333333334,8
0.2,3600,94,277270,76.99805609552902,7
0.2,3601,92,277362,77.00222098833981,9
0.2,3602,94,277456,77.00693866222592,7
0.2,3603,92,277548,77.0110987791343,9
0.2,3604,95,277643,77.01608876560333,6
0.2,3605,96,277739,77.02135330005547,6
0.2,3606,91,277830,77.02522872192958,10
0.2,3607,96,277926,77.03048780487805,6
0.2,3608,92,278018,77.03463563313937,10
0.2,3609,92,278110,77.0387811634349,9
0.2,3610,93,278203,77.04320132927167,8
0.2,3611,95,278298,77.04817275747509,6
0.2,3612,95,278393,77.0531414337116,6
0.2,3613,88,278481,77.05617044825678,13
0.2,3614,95,278576,77.06113416320885,6
0.2,3615,88,278664,77.0641592920354,13
0.2,3616,19,278683,77.04810616533038,13
0.2,3617,93,278776,77.05251520176893,8
0.2,3618,94,278870,77.05719812102791,7
0.2,3619,95,278965,77.0621546961326,7
0.2,3620,94,279059,77.06683236674952,7
0.2,3621,94,279153,77.07150745444505,7
0.2,3622,94,279247,77.076179961358,8
0.2,3623,95,279342,77.08112582781457,6
0.2,3624,94,279436,77.08579310344828,9
0.2,3625,96,279532,77.09100937672366,6
0.2,3626,94,279626,77.09567135373587,9
0.2,3627,93,279719,77.10005512679162,8
0.2,3628,23,279742,77.08514742353266,10
0.2,3629,95,279837,77.0900826446281,6
0.2,3630,92,279929,77.0941889286698,9
0.2,3631,22,279951,77.07901982378854,10
0.2,3632,94,280045,77.08367740159647,9
0.2,3633,93,280138,77.08805723720418,8
0.2,3634,92,280230,77.09215955983494,9
0.2,3635,89,280319,77.09543454345435,12
0.2,3636,94,280413,77.10008248556503,7
0.2,3637,93,280506,77.10445299615174,8
0.2,3638,92,280598,77.10854630392966,9
0.2,3639,92,280690,77.11263736263736,9
0.2,3640,94,280784,77.11727547377095,7
0.2,3641,94,280878,77.12191103789127,7
0.2,3642,94,280972,77.1265440570958,7
0.2,3643,93,281065,77.13090010976948,8
0.2,3644,94,281159,77.1355281207133,7
0.2,3645,95,281254,77.1404278661547,6
0.2,3646,22,281276,77.12530847271731,10
0.2,3647,91,281367,77.12911184210526,10
0.2,3648,23,281390,77.11427788435188,10
0.2,3649,90,281480,77.11780821917809,11
0.2,3650,91,281571,77.1216105176664,10
0.2,3651,94,281665,77.12623220153341,7
0.2,3652,25,281690,77.11196277032576,8
0.2,3653,94,281784,77.11658456486043,7
0.2,3654,89,281873,77.11983584131328,12
0.2,3655,90,281963,77.12335886214441,12
0.2,3656,96,282059,77.1285206453377,6
0.2,3657,24,282083,77.11399671951887,9
0.2,3658,90,282173,77.1175184476633,12
0.2,3659,96,282269,77.12267759562842,7
0.2,3660,-53,282216,77.08713466266047,17
0.2,3661,19,282235,77.07127252867285,13
0.2,3662,95,282330,77.07616707616708,7
0.2,3663,92,282422,77.08024017467248,9
0.2,3664,96,282518,77.08540245566167,6
0.2,3665,94,282612,77.0900163666121,7
0.2,3666,96,282708,77.09517316607581,6
0.2,3667,92,282800,77.09923664122137,9
0.2,3668,-54,282746,77.06350504224585,17
0.2,3669,90,282836,77.06702997275204,11
0.2,3670,92,282928,77.07109779351676,11
0.2,3671,92,283020,77.07516339869281,9
0.2,3672,92,283112,77.07922679008985,9
0.2,3673,93,283205,77.08356015242242,9
0.2,3674,92,283297,77.08761904761904,9
0.2,3675,96,283393,77.09276387377584,6
0.2,3676,96,283489,77.09790590155018,6
0.2,3677,95,283584,77.10277324632953,7
0.2,3678,91,283675,77.10655069312313,10
0.2,3679,89,283764,77.10978260869565,12
0.2,3680,93,283857,77.11409942950286,9
0.2,3681,89,283946,77.11732753938077,12
0.2,3682,92,284038,77.12136844963345,9
0.2,3683,93,284131,77.1256786102063,9
0.2,3684,88,284219,77.12862957937585,13
0.2,3685,86,284305,77.13103635377102,16
0.2,3686,20,284325,77.11554109031734,12
0.2,3687,95,284420,77.12039045553145,7
0.2,3688,94,284514,77.12496611547844,7
0.2,3689,93,284607,77.12926829268292,8
0.2,3690,25,284632,77.11514494716879,8
0.2,3691,95,284727,77.11998916576381,6
0.2,3692,88,284815,77.12293528296777,13
0.2,3693,93,284908,77.12723335138061,8
0.2,3694,95,285003,77.13207036535859,7
0.2,3695,89,285092,77.13528138528139,12
0.2,3696,23,285115,77.12063835542331,9
0.2,3697,93,285208,77.12493239588967,9
0.2,3698,94,285302,77.12949445796161,7
0.2,3699,-50,285252,77.09513513513514,13
0.2,3700,95,285347,77.0999729802756,6
0.2,3701,20,285367,77.08454889249055,12
0.2,3702,89,285456,77.08776667566838,14
0.2,3703,93,285549,77.0920626349892,8
0.2,3704,96,285645,77.09716599190283,6
0.2,3705,81,285726,77.09821910415542,20
0.2,3706,15,285741,77.0814674939304,17
0.2,3707,95,285836,77.08629989212514,6
0.2,3708,90,285926,77.08978161229442,12
0.2,3709,96,286022,77.09487870619947,6
0.2,3710,95,286117,77.09970358393964,8
0.2,3711,91,286208,77.10344827586206,10
0.2,3712,94,286302,77.10799892270401,7
0.2,3713,90,286392,77.11147011308562,11
0.2,3714,79,286471,77.11197846567968,22
0.2,3715,92,286563,77.1159849300323,9
0.2,3716,90,286653,77.11945117029863,13
0.2,3717,94,286747,77.12399139322216,7
0.2,3718,20,286767,77.10863135251412,12
0.2,3719,91,286858,77.11236559139785,10
0.2,3720,92,286950,77.11636656812685,10
0.2,3721,95,287045,77.1211714132187,6
0.2,3722,94,287139,77.12570507655117,7
0.2,3723,93,287232,77.12996777658432,8
0.2,3724,85,287317,77.13208053691275,16
0.2,3725,91,287408,77.1358024691358,10
0.2,3726,24,287432,77.12154547893748,9
0.2,3727,93,287525,77.12580472103004,8
0.2,3728,94,287619,77.13032984714401,7
0.2,3729,91,287710,77.13404825737265,10
0.2,3730,20,287730,77.11873492361298,12
0.2,3731,82,287812,77.12004287245445,20
0.2,3732,88,287900,77.12295740691133,13
0.2,3733,94,287994,77.12747723620782,7
0.2,3734,92,288086,77.13145917001339,11
0.2,3735,94,288180,77.13597430406853,8
0.2,3736,-47,288133,77.1027562215681,10
0.2,3737,95,288228,77.107544141252,6
0.2,3738,93,288321,77.11179459748595,8
0.2,3739,-52,288269,77.07727272727273,15
0.2,3740,93,288362,77.08152900294039,8
0.2,3741,95,288457,77.08631747728488,6
0.2,3742,96,288553,77.09137055837563,6
0.2,3743,20,288573,77.0761217948718,12
0.2,3744,95,288668,77.08090787716957,6
0.2,3745,22,288690,77.06620395088093,10
0.2,3746,94,288784,77.07072324526288,7
0.2,3747,92,288876,77.07470651013874,9
0.2,3748,22,288898,77.06001600426781,11
0.2,3749,92,288990,77.064,9
0.2,3750,95,289085,77.06878165822447,7
0.2,3751,22,289107,77.05410447761194,10
0.2,3752,93,289200,77.05835331734612,8
0.2,3753,89,289289,77.06153436334577,12
0.2,3754,96,289385,77.06657789613848,6
0.2,3755,93,289478,77.07082002129926,9
0.2,3756,93,289571,77.07505988820867,8
0.2,3757,94,289665,77.07956359765834,7
0.2,3758,-46,289619,77.04682096302209,10
0.2,3759,-52,289567,77.0125,15
0.2,3760,89,289656,77.01568731720288,13
0.2,3761,96,289752,77.0207336523126,6
0.2,3762,27,289779,77.00744087164496,6
0.2,3763,92,289871,77.0114240170032,9
0.2,3764,96,289967,77.01646746347942,6
0.2,3765,89,290056,77.01964949548592,12
0.2,3766,91,290147,77.02336076453412,10
0.2,3767,91,290238,77.02707006369427,10
0.2,3768,24,290262,77.0130007959671,8
0.2,3769,95,290357,77.01777188328913,6
0.2,3770,93,290450,77.02201007690267,8
0.2,3771,93,290543,77.0262460233298,9
0.2,3772,93,290636,77.03047972435728,11
0.2,3773,94,290730,77.03497615262322,7
0.2,3774,92,290822,77.038940397351,9
0.2,3775,92,290914,77.04290254237289,9
0.2,3776,93,291007,77.04712734974848,8
0.2,3777,23,291030,77.03282159872948,10
0.2,3778,25,291055,77.01905265943371,8
0.2,3779,94,291149,77.02354497354497,7
0.2,3780,93,291242,77.02777043110288,9
0.2,3781,92,291334,77.03172924378636,9
0.2,3782,92,291426,77.03568596352102,9
0.2,3783,92,291518,77.03964059196618,9
0.2,3784,24,291542,77.02562747688243,8
0.2,3785,95,291637,77.03037506603275,6
0.2,3786,93,291730,77.03459202534988,8
0.2,3787,95,291825,77.03933474128827,7
0.2,3788,95,291920,77.04407495381368,7
0.2,3789,93,292013,77.04828496042217,8
0.2,3790,93,292106,77.05249274597732,8
0.2,3791,16,292122,77.0363924050633,16
0.2,3792,94,292216,77.04086475085684,7
0.2,3793,93,292309,77.04507116499737,8
0.2,3794,93,292402,77.04927536231884,8
0.2,3795,92,292494,77.05321390937829,9
0.2,3796,94,292588,77.05767711351066,7
0.2,3797,23,292611,77.0434439178515,11
0.2,3798,90,292701,77.04685443537772,11
0.2,3799,95,292796,77.05157894736843,6
0.2,3800,25,292821,77.03788476716653,9
0.2,3801,93,292914,77.04208311415044,8
0.2,3802,94,293008,77.04654220352353,7
0.2,3803,94,293102,77.05099894847528,7
0.2,3804,93,293195,77.05519053876478,9
0.2,3805,22,293217,77.04072517078298,11
0.2,3806,93,293310,77.04491725768321,9
0.2,3807,15,293325,77.02862394957984,18
0.2,3808,94,293419,77.03307954843791,8
0.2,3809,93,293512,77.03727034120735,8
0.2,3810,93,293605,77.04145893466281,8
0.2,3811,92,293697,77.04538300104932,9
0.2,3812,91,293788,77.049042748492,11
0.2,3813,94,293882,77.0534871525957,7
0.2,3814,92,293974,77.05740498034076,9
0.2,3815,96,294070,77.06236897274633,6
0.2,3816,94,294164,77.06680639245481,7
0.2,3817,89,294253,77.06993190151913,12
0.2,3818,18,294271,77.05446451950772,14
0.2,3819,20,294291,77.03952879581152,12
0.2,3820,90,294381,77.04292070138708,11
0.2,3821,90,294471,77.04631083202511,11
0.2,3822,95,294566,77.05100706251635,6
0.2,3823,95,294661,77.05570083682008,7
0.2,3824,94,294755,77.06013071895426,7
0.2,3825,87,294842,77.0627286983795,14
0.2,3826,90,294932,77.0661092239352,11
0.2,3827,91,295023,77.06974921630093,10
0.2,3828,91,295114,77.07338730739096,10
0.2,3829,90,295204,77.07676240208878,11
0.2,3830,90,295294,77.08013573479509,11
0.2,3831,95,295389,77.0848121085595,6
0.2,3832,96,295485,77.08974693451604,6
0.2,3833,91,295576,77.09337506520605,11
0.2,3834,19,295595,77.07822685788787,13
0.2,3835,94,295689,77.08263816475495,7
0.2,3836,22,295711,77.06828251237947,11
0.2,3837,96,295807,77.07321521625846,6
0.2,3838,92,295899,77.07710341234697,9
0.2,3839,94,295993,77.08151041666666,7
0.2,3840,91,296084,77.08513407966676,10
0.2,3841,94,296178,77.0895366996356,7
0.2,3842,93,296271,77.09367681498829,8
0.2,3843,94,296365,77.0980749219563,7
0.2,3844,89,296454,77.10117035110534,12
0.2,3845,90,296544,77.10452418096723,11
0.2,3846,94,296638,77.10891603847153,8
0.2,3847,93,296731,77.11304573804574,8
0.2,3848,-50,296681,77.08002078461938,13
0.2,3849,95,296776,77.08467532467533,6
0.2,3850,24,296800,77.07089067774604,9
0.2,3851,92,296892,77.07476635514018,10
0.2,3852,27,296919,77.06177004931223,7
0.2,3853,92,297011,77.06564608199274,9
0.2,3854,95,297106,77.07029831387808,7
0.2,3855,92,297198,77.07417012448133,9
0.2,3856,93,297291,77.07829919626653,8
0.2,3857,94,297385,77.0826853291861,7
0.2,3858,94,297479,77.08706918890904,8
0.2,3859,94,297573,77.09145077720207,7
0.2,3860,96,297669,77.0963480963481,6
0.2,3861,94,297763,77.10072501294665,7
0.2,3862,88,297851,77.10354646647683,13
0.2,3863,-46,297805,77.07168737060042,9
0.2,3864,87,297892,77.07425614489004,14
0.2,3865,94,297986,77.07863424728401,7
0.2,3866,20,298006,77.06387380398242,13
0.2,3867,89,298095,77.06695966907962,12
0.2,3868,95,298190,77.07159472731972,7
0.2,3869,-48,298142,77.03927648578811,12
0.2,3870,93,298235,77.04339963833635,8
0.2,3871,20,298255,77.0286673553719,13
0.2,3872,93,298348,77.03279111799638,8
0.2,3873,94,298442,77.03717088280847,9
0.2,3874,90,298532,77.04051612903226,11
0.2,3875,95,298627,77.04514963880288,8
0.2,3876,95,298722,77.04978075831829,6
0.2,3877,-54,298668,77.01598762248582,19
0.2,3878,93,298761,77.0201082753287,10
0.2,3879,96,298857,77.025,6
0.2,3880,21,298878,77.01056428755476,11
0.2,3881,-48,298830,76.97836166924266,12
0.2,3882,94,298924,76.98274530002575,7
0.2,3883,17,298941,76.96730175077239,15
0.2,3884,23,298964,76.95341055341055,10
0.2,3885,93,299057,76.95753988677303,8
0.2,3886,91,299148,76.96115255981476,10
0.2,3887,93,299241,76.96527777777777,8
0.2,3888,26,299267,76.95217279506299,7
0.2,3889,90,299357,76.95552699228791,11
0.2,3890,23,299380,76.94166024158314,10
0.2,3891,95,299475,76.94630010277493,7
0.2,3892,90,299565,76.94965322373491,11
0.2,3893,96,299661,76.95454545454545,6
0.2,3894,94,299755,76.9589216944801,7
0.2,3895,17,299772,76.9435318275154,15
0.2,3896,88,299860,76.94636900179626,13
0.2,3897,96,299956,76.95125705489995,6
0.2,3898,93,300049,76.95537317260836,9
0.2,3899,93,300142,76.95948717948718,8
0.2,3900,13,300155,76.94309151499615,21
0.2,3901,90,300245,76.94643772424398,11
0.2,3902,25,300270,76.93312836279785,8
0.2,3903,96,300366,76.93801229508196,6
0.2,3904,87,300453,76.9405889884763,14
0.2,3905,22,300475,76.92652329749104,11
0.2,3906,94,300569,76.93089326849245,7
0.2,3907,93,300662,76.93500511770726,8
0.2,3908,87,300749,76.93757994371963,15
0.2,3909,86,300835,76.93989769820972,17
0.2,3910,91,300926,76.94349271286116,10
0.2,3911,94,301020,76.9478527607362,7
0.2,3912,20,301040,76.93329925888065,13
0.2,3913,95,301135,76.93791517629025,6
0.2,3914,95,301230,76.94252873563218,6
0.2,3915,-49,301181,76.91036772216547,12
0.2,3916,93,301274,76.91447536379883,8
0.2,3917,94,301368,76.9188361408882,7
0.2,3918,94,301462,76.92319469252361,7
0.2,3919,93,301555,76.92729591836735,8
0.2,3920,93,301648,76.93139505228258,8
0.2,3921,94,301742,76.93574706782253,7
0.2,3922,20,301762,76.92123374968136,12
0.2,3923,94,301856,76.92558613659531,8
0.2,3924,93,301949,76.92968152866241,9
0.2,3925,96,302045,76.9345389709628,6
0.2,3926,93,302138,76.93862999745353,9
0.2,3927,94,302232,76.94297352342159,7
0.2,3928,91,302323,76.94655128531433,10
0.2,3929,85,302408,76.94860050890586,16
0.2,3930,93,302501,76.95268379547188,8
0.2,3931,92,302593,76.95651068158698,9
0.2,3932,22,302615,76.94253750317823,11
0.2,3933,95,302710,76.94712760549059,6
0.2,3934,83,302793,76.94866581956798,19
0.2,3935,94,302887,76.95299796747967,8
0.2,3936,94,302981,76.95732791465583,7
0.2,3937,96,303077,76.96216353478923,6
0.2,3938,94,303171,76.96648895658797,7
0.2,3939,27,303198,76.95380710659899,6
0.2,3940,23,303221,76.94011672164426,10
0.2,3941,91,303312,76.94368340943683,10
0.2,3942,94,303406,76.94800913010398,7
0.2,3943,14,303420,76.93204868154159,18
0.2,3944,95,303515,76.93662864385298,6
0.2,3945,23,303538,76.92295995945261,9
0.2,3946,95,303633,76.92753990372435,6
0.2,3947,93,303726,76.93161094224924,8
0.2,3948,24,303750,76.91820714104837,8
0.2,3949,94,303844,76.92253164556962,8
0.2,3950,95,303939,76.92710706150342,6
0.2,3951,95,304034,76.93168016194332,7
0.2,3952,90,304124,76.93498608651657,12
0.2,3953,22,304146,76.92109256449166,10
0.2,3954,92,304238,76.92490518331226,9
0.2,3955,90,304328,76.92821031344793,12
0.2,3956,95,304423,76.93277735658327,6
0.2,3957,93,304516,76.93683678625568,9
0.2,3958,96,304612,76.94165193230614,6
0.2,3959,24,304636,76.92828282828283,9
0.2,3960,90,304726,76.93158293360263,11
0.2,3961,91,304817,76.93513377082282,12
0.2,3962,93,304910,76.93918748422912,8
0.2,3963,93,305003,76.94323915237135,8
0.2,3964,94,305097,76.94754098360656,7
0.2,3965,96,305193,76.95234493192133,6
0.2,3966,93,305286,76.9563902193093,9
0.2,3967,96,305382,76.96118951612904,6
0.2,3968,94,305476,76.96548248929201,7
0.2,3969,94,305570,76.96977329974811,7
0.2,3970,94,305664,76.9740619491312,7
0.2,3971,90,305754,76.9773413897281,11
0.2,3972,83,305837,76.97885728668513,18
0.2,3973,94,305931,76.98314041268243,7
0.2,3974,91,306022,76.98666666666666,10
0.2,3975,92,306114,76.99044265593561,9
0.2,3976,93,306207,76.9944681921046,8
0.2,3977,89,306296,76.99748617395676,12
0.2,3978,89,306385,77.00050263885399,12
0.2,3979,90,306475,77.0037688442211,11
0.2,3980,96,306571,77.00854056769656,6
0.2,3981,24,306595,76.9952285283777,9
0.2,3982,92,306687,76.9989957318604,10
0.2,3983,92,306779,77.00276104417671,9
0.2,3984,92,306871,77.0065244667503,9
0.2,3985,92,306963,77.01028600100351,10
0.2,3986,95,307058,77.01479809380487,6
0.2,3987,90,307148,77.01805416248746,13
0.2,3988,91,307239,77.02155928804211,11
0.2,3989,92,307331,77.02531328320802,9
0.2,3990,19,307350,77.0107742420446,13
0.2,3991,95,307445,77.01528056112224,6
0.2,3992,94,307539,77.01953418482344,7
0.2,3993,95,307634,77.02403605408112,7
0.2,3994,27,307661,77.01151439299124,6
0.2,3995,94,307755,77.01576576576576,7
0.2,3996,94,307849,77.02001501125844,7
0.2,3997,88,307937,77.02276138069034,13
0.2,3998,92,308029,77.02650662665667,10
0.2,3999,94,308123,77.03075,8
0.2,4000,93,308216,77.03474131467134,8
0.2,4001,92,308308,77.03848075962019,9
0.2,4002,93,308401,77.04246814888833,8
0.2,4003,94,308495,77.0467032967033,8
0.2,4004,95,308590,77.05118601747816,6
0.2,4005,89,308679,77.05416874687968,12
0.2,4006,95,308774,77.05864736710757,6
0.2,4007,90,308864,77.06187624750498,11
0.2,4008,94,308958,77.06610127213769,8
0.2,4009,94,309052,77.07032418952619,7
0.2,4010,94,309146,77.07454500124658,8
0.2,4011,92,309238,77.07826520438684,11
0.2,4012,95,309333,77.0827311238475,6
0.2,4013,89,309422,77.0857000498256,13
0.2,4014,92,309514,77.08941469489415,9
0.2,4015,-47,309467,77.05851593625498,11
0.2,4016,95,309562,77.06298232511824,7
0.2,4017,93,309655,77.0669487307118,9
0.2,4018,92,309747,77.07066434436427,9
0.2,4019,96,309843,77.07537313432836,6
0.2,4020,22,309865,77.06167619995026,10
0.2,4021,25,309890,77.04873197414221,8
0.2,4022,95,309985,77.05319413373104,6
0.2,4023,94,310079,77.0574055666004,8
0.2,4024,96,310175,77.06211180124224,6
0.2,4025,87,310262,77.06458022851466,17
0.2,4026,93,310355,77.06853737273404,8
0.2,4027,94,310449,77.0727408142999,8
0.2,4028,94,310543,77.07694216927277,7
0.2,4029,92,310635,77.08064516129032,10
0.2,4030,92,310727,77.08434631605061,10
0.2,4031,90,310817,77.08754960317461,12
0.2,4032,95,310912,77.09199107364245,7
0.2,4033,91,311003,77.09543877045117,10
0.2,4034,94,311097,77.09962825278811,7
0.2,4035,93,311190,77.10356788899901,9
0.2,4036,24,311214,77.09041367351995,8
0.2,4037,92,311306,77.09410599306588,9
0.2,4038,93,311399,77.09804407031443,9
0.2,4039,85,311484,77.1,17
0.2,4040,92,311576,77.1036872061371,9
0.2,4041,96,311672,77.1083621969322,6
0.2,4042,23,311695,77.09497897600791,10
0.2,4043,96,311791,77.09965380811079,6
0.2,4044,21,311812,77.08578491965389,11
0.2,4045,93,311905,77.08971824023727,8
0.2,4046,92,311997,77.09340252038547,11
0.2,4047,93,312090,77.09733201581028,8
0.2,4048,95,312185,77.1017535193875,6
0.2,4049,94,312279,77.10592592592593,7
0.2,4050,92,312371,77.10960256726734,9
0.2,4051,93,312464,77.11352418558737,10
0.2,4052,25,312489,77.10066617320503,7
0.2,4053,88,312577,77.10335471139615,13
0.2,4054,96,312673,77.10801479654747,6
0.2,4055,95,312768,77.11242603550296,7
0.2,4056,94,312862,77.11658861227508,8
0.2,4057,94,312956,77.12074913750617,7
0.2,4058,21,312977,77.10692288741069,11
0.2,4059,94,313071,77.11108374384237,9
0.2,4060,90,313161,77.11425757202659,11
0.2,4061,96,313257,77.11890694239291,6
0.2,4062,96,313353,77.12355402412011,6
0.2,4063,87,313440,77.1259842519685,14
0.2,4064,90,313530,77.12915129151291,11
0.2,4065,93,313623,77.13305459911462,9
0.2,4066,94,313717,77.1372018686993,7
0.2,4067,20,313737,77.1231563421829,12
0.2,4068,96,313833,77.12779552715655,6
0.2,4069,94,313927,77.13194103194103,7
0.2,4070,86,314013,77.13411938098747,15
0.2,4071,93,314106,77.13801571709234,8
0.2,4072,94,314200,77.14215565921924,7
0.2,4073,25,314225,77.12935689739814,10
0.2,4074,94,314319,77.13349693251534,7
0.2,4075,-49,314270,77.10255152109912,13
0.2,4076,95,314365,77.10694137846455,6
0.2,4077,-49,314316,77.07601765571358,14
0.2,4078,24,314340,77.06300563863692,8
0.2,4079,93,314433,77.06691176470588,8
0.2,4080,90,314523,77.07008086253369,11
0.2,4081,91,314614,77.0734933855953,10
0.2,4082,-53,314561,77.04163605192261,16
0.2,4083,96,314657,77.04627815866797,6
0.2,4084,94,314751,77.05042839657283,7
0.2,4085,92,314843,77.05408712677435,9
0.2,4086,93,314936,77.05798874480058,10
0.2,4087,96,315032,77.06262230919765,6
0.2,4088,92,315124,77.06627537295182,9
0.2,4089,94,315218,77.07041564792176,8
0.2,4090,90,315308,77.07357614275239,11
0.2,4091,20,315328,77.05962854349951,16
0.2,4092,21,315349,77.04593207915954,12
0.2,4093,95,315444,77.05031753786028,6
0.2,4094,93,315537,77.05421245421246,8
0.2,4095,95,315632,77.05859375,7
0.2,4096,95,315727,77.06297290700513,6
0.2,4097,23,315750,77.0497803806735,10
0.2,4098,25,315775,77.03708221517444,8
0.2,4099,96,315871,77.04170731707318,7
0.2,4100,94,315965,77.04584247744452,7
0.2,4101,95,316060,77.0502194051682,7
0.2,4102,94,316154,77.054350475262,7
0.2,4103,91,316245,77.0577485380117,10
0.2,4104,96,316341,77.06236297198538,6
0.2,4105,92,316433,77.06600097418412,10
0.2,4106,94,316527,77.07012417823229,8
0.2,4107,94,316621,77.07424537487829,7
0.2,4108,23,316644,77.06108542224385,10
0.2,4109,25,316669,77.04841849148418,8
0.2,4110,92,316761,77.0520554609584,9
0.2,4111,95,316856,77.05642023346303,6
0.2,4112,25,316881,77.0437636761488,8
0.2,4113,23,316904,77.03062712688381,10
0.2,4114,95,316999,77.03499392466586,6
0.2,4115,93,317092,77.03887269193392,9
0.2,4116,95,317187,77.04323536555745,6
0.2,4117,-117,317070,76.99611461874696,12
0.2,4118,95,317165,77.00048555474629,6
0.2,4119,93,317258,77.00436893203883,8
0.2,4120,89,317347,77.00727978645959,12
0.2,4121,94,317441,77.01140223192625,8
0.2,4122,89,317530,77.01430996846956,12
0.2,4123,95,317625,77.01867119301649,6
0.2,4124,95,317720,77.0230303030303,6
0.2,4125,95,317815,77.02738730004847,7
0.2,4126,95,317910,77.03174218560697,8
0.2,4127,94,318004,77.0358527131783,7
0.2,4128,91,318095,77.03923468152095,11
0.2,4129,92,318187,77.04285714285714,9
0.2,4130,26,318213,77.03050108932462,7
0.2,4131,27,318240,77.01839303000968,6
0.2,4132,96,318336,77.02298572465521,6
0.2,4133,94,318430,77.0270924044509,7
0.2,4134,92,318522,77.03071342200725,9
0.2,4135,94,318616,77.0348162475822,8
0.2,4136,92,318708,77.0384336475707,9
0.2,4137,95,318803,77.04277428709521,6
0.2,4138,19,318822,77.02875090601594,13
0.2,4139,94,318916,77.03285024154589,7
0.2,4140,94,319010,77.03694759719875,7
0.2,4141,95,319105,77.04128440366972,8
0.2,4142,94,319199,77.04537774559498,7
0.2,4143,92,319291,77.04898648648648,9
0.2,4144,96,319387,77.05355850422195,6
0.2,4145,96,319483,77.05812831644958,7
0.2,4146,94,319577,77.06221364842054,7
0.2,4147,91,319668,77.06557377049181,10
0.2,4148,91,319759,77.06893227283683,10
0.2,4149,24,319783,77.05614457831325,9
0.2,4150,93,319876,77.05998554565166,8
0.2,4151,21,319897,77.04648362235068,11
0.2,4152,92,319989,77.05008427642667,9
0.2,4153,92,320081,77.05368319691863,9
0.2,4154,96,320177,77.05824308062576,6
0.2,4155,92,320269,77.06183830606352,9
0.2,4156,89,320358,77.06471012749579,13
0.2,4157,93,320451,77.06854256854257,11
0.2,4158,24,320475,77.0557826400577,8
0.2,4159,94,320569,77.05985576923077,7
0.2,4160,24,320593,77.04710406152367,8
0.2,4161,94,320687,77.05117731859683,8
0.2,4162,96,320783,77.05572904155657,6
0.2,4163,91,320874,77.05907780979827,12
0.2,4164,93,320967,77.06290516206482,8
0.2,4165,81,321048,77.06385021603457,20
0.2,4166,90,321138,77.0669546436285,11
0.2,4167,88,321226,77.06957773512477,13
0.2,4168,94,321320,77.07363876229311,8
0.2,4169,96,321416,77.07817745803358,6
0.2,4170,94,321510,77.0822344761448,8
0.2,4171,92,321602,77.08581016299136,11
0.2,4172,83,321685,77.08722741433021,18
0.2,4173,94,321779,77.09127934834692,7
0.2,4174,90,321869,77.09437125748504,11
0.2,4175,94,321963,77.09841954022988,7
0.2,4176,24,321987,77.08570744553508,8
0.2,4177,94,322081,77.08975586404978,7
0.2,4178,-56,322025,77.05790859057191,19
0.2,4179,92,322117,77.06148325358852,9
0.2,4180,93,322210,77.06529538387946,10
0.2,4181,24,322234,77.05260640841702,9
0.2,4182,92,322326,77.0561797752809,9
0.2,4183,96,322422,77.06070745697897,6
0.2,4184,23,322445,77.04778972520909,9
0.2,4185,89,322534,77.05064500716675,12
0.2,4186,96,322630,77.0551707666587,6
0.2,4187,-117,322513,77.00883476599809,13
0.2,4188,90,322603,77.01193602291717,11
0.2,4189,90,322693,77.01503579952268,11
0.2,4190,95,322788,77.01932712956335,6
0.2,4191,91,322879,77.02266221374046,10
0.2,4192,91,322970,77.02599570713093,10
0.2,4193,89,323059,77.02885073915117,12
0.2,4194,96,323155,77.03337306317044,7
0.2,4195,92,323247,77.03693994280268,9
0.2,4196,96,323343,77.04145818441744,6
0.2,4197,92,323435,77.04502143878037,9
0.2,4198,94,323529,77.04905929983329,7
0.2,4199,94,323623,77.05309523809524,7
0.2,4200,93,323716,77.05689121637705,8
0.2,4201,94,323810,77.0609233698239,7
0.2,4202,91,323901,77.06423982869379,10
0.2,4203,93,323994,77.06803044719315,8
0.2,4204,95,324089,77.07229488703923,6
0.2,4205,90,324179,77.07536852116024,11
0.2,4206,94,324273,77.07939149037318,7
0.2,4207,94,324367,77.08341254752851,7
0.2,4208,94,324461,77.08743169398907,8
0.2,4209,93,324554,77.09121140142518,9
0.2,4210,-51,324503,77.0607931607694,16
0.2,4211,90,324593,77.06386514719848,14
0.2,4212,92,324685,77.06741039639212,10
0.2,4213,91,324776,77.07071665875652,10
0.2,4214,-45,324731,77.04175563463819,10
0.2,4215,93,324824,77.04554079696395,8
0.2,4216,92,324916,77.04908702869338,9
0.2,4217,91,325007,77.05239449976293,11
0.2,4218,92,325099,77.05593742593031,9
0.2,4219,92,325191,77.05947867298578,9
0.2,4220,96,325287,77.0639658848614,7
0.2,4221,93,325380,77.06774040738986,8
0.2,4222,91,325471,77.0710395453469,10
0.2,4223,93,325564,77.07481060606061,8
0.2,4224,95,325659,77.07905325443787,6
0.2,4225,91,325750,77.08234737340274,10
0.2,4226,92,325842,77.08587650816182,10
0.2,4227,89,325931,77.08869441816462,12
0.2,4228,93,326024,77.09245684558998,8
0.2,4229,92,326116,77.09598108747045,9
0.2,4230,90,326206,77.09903096194753,12
0.2,4231,95,326301,77.10326086956522,6
0.2,4232,93,326394,77.1070163004961,8
0.2,4233,-58,326336,77.0751062824752,21
0.2,4234,96,326432,77.07957497048406,8
0.2,4235,95,326527,77.08380547686497,6
0.2,4236,91,326618,77.0870899221147,10
0.2,4237,27,326645,77.07527135441246,6
0.2,4238,94,326739,77.07926397735315,7
0.2,4239,94,326833,77.08325471698113,7
0.2,4240,94,326927,77.08724357462863,7
0.2,4241,-55,326872,77.05610561056106,18
0.2,4242,89,326961,77.05892057506482,13
0.2,4243,92,327053,77.0624410933082,9
0.2,4244,95,327148,77.06666666666666,7
0.2,4245,27,327175,77.05487517663684,6
0.2,4246,87,327262,77.05721685895926,14
0.2,4247,20,327282,77.04378531073446,12
0.2,4248,93,327375,77.04754059778772,9
0.2,4249,94,327469,77.0515294117647,7
0.2,4250,91,327560,77.05481063279228,10
0.2,4251,90,327650,77.05785512699906,11
0.2,4252,93,327743,77.0616035739478,8
0.2,4253,90,327833,77.06464503996239,11
0.2,4254,93,327926,77.0683901292597,8
0.2,4255,93,328019,77.07213345864662,8
0.2,4256,95,328114,77.0763448437867,7
0.2,4257,92,328206,77.07984969469234,12
0.2,4258,94,328300,77.08382249354308,7
0.2,4259,88,328388,77.08638497652582,13
0.2,4260,89,328477,77.08918094344051,12
0.2,4261,95,328572,77.09338338808071,6
0.2,4262,94,328666,77.09734928454141,7
0.2,4263,19,328685,77.08372420262664,14
0.2,4264,94,328779,77.08769050410316,7
0.2,4265,89,328868,77.09048288795124,12
0.2,4266,25,328893,77.0782751347551,8
0.2,4267,91,328984,77.08153701968135,10
0.2,4268,90,329074,77.08456312953854,11
0.2,4269,92,329166,77.08805620608899,9
0.2,4270,20,329186,77.07468976820417,12
0.2,4271,94,329280,77.07865168539325,7
0.2,4272,17,329297,77.06459162181137,15
0.2,4273,-51,329246,77.03462798315395,15
0.2,4274,93,329339,77.03836257309942,8
0.2,4275,94,329433,77.04232927970065,8
0.2,4276,-52,329381,77.01215805471125,15
0.2,4277,84,329465,77.0137914913511,17
0.2,4278,20,329485,77.00046739892498,12
0.2,4279,89,329574,77.00327102803739,12
0.2,4280,96,329670,77.00770847932726,6
0.2,4281,94,329764,77.01167678654834,7
0.2,4282,93,329857,77.01540975951436,8
0.2,4283,94,329951,77.01937441643324,7
0.2,4284,94,330045,77.02333722287048,7
0.2,4285,94,330139,77.02729818012132,8
0.2,4286,24,330163,77.01492885467692,9
0.2,4287,22,330185,77.00209888059702,10
0.2,4288,96,330281,77.00652832828165,7
0.2,4289,96,330377,77.01095571095571,6
0.2,4290,94,330471,77.01491493824284,7
0.2,4291,-115,330356,76.97017707362535,10
0.2,4292,94,330450,76.97414395527603,8
0.2,4293,94,330544,76.97810898928738,8
0.2,4294,87,330631,76.98044237485448,14
0.2,4295,96,330727,76.98486964618249,7
0.2,4296,86,330813,76.98696765185012,15
0.2,4297,95,330908,76.9911586784551,6
0.2,4298,96,331004,76.99558036752734,6
0.2,4299,92,331096,76.99906976744187,9
0.2,4300,86,331182,77.00116252034411,17
0.2,4301,20,331202,76.98791259879125,13
0.2,4302,94,331296,76.9918661399024,7
0.2,4303,94,331390,76.99581784386618,7
0.2,4304,94,331484,76.99976771196283,8
0.2,4305,94,331578,77.00371574547144,7
0.2,4306,16,331594,76.9895518922684,17
0.2,4307,95,331689,76.99373259052925,8
0.2,4308,26,331715,76.98189835228591,7
0.2,4309,94,331809,76.98584686774942,7
0.2,4310,93,331902,76.98956158663883,8
0.2,4311,84,331986,76.99118738404452,17
0.2,4312,88,332074,76.99373985624855,13
0.2,4313,93,332167,76.9974501622624,8
0.2,4314,23,332190,76.98493626882967,9
0.2,4315,95,332285,76.98911028730306,6
0.2,4316,94,332379,76.99305072967339,7
0.2,4317,94,332473,76.99698934691988,7
0.2,4318,96,332569,77.00138921046539,6
0.2,4319,93,332662,77.00509259259259,10
0.2,4320,90,332752,77.00809997685721,11
0.2,4321,90,332842,77.01110596945858,11
0.2,4322,94,332936,77.01503585473051,10
0.2,4323,94,333030,77.01896392229418,7
0.2,4324,92,333122,77.02242774566474,9
0.2,4325,94,333216,77.02635228848821,7
0.2,4326,95,333311,77.03050612433557,7
0.2,4327,23,333334,77.01802218114602,10
0.2,4328,91,333425,77.02125202125202,10
0.2,4329,20,333445,77.0080831408776,12
0.2,4330,95,333540,77.01223735857769,6
0.2,4331,21,333561,76.99930747922437,11
0.2,4332,19,333580,76.98592199399954,13
0.2,4333,88,333668,76.98846331333641,13
0.2,4334,95,333763,76.99261822376009,6
0.2,4335,91,333854,76.99584870848709,11
0.2,4336,88,333942,76.99838598109292,14
0.2,4337,94,334036,77.0023052097741,7
0.2,4338,93,334129,77.00599216409312,8
0.2,4339,89,334218,77.00875576036866,12
0.2,4340,91,334309,77.01197880672656,10
0.2,4341,23,334332,76.99953938277291,9
0.2,4342,95,334427,77.00368408933916,8
0.2,4343,92,334519,77.00713627992633,9
0.2,4344,92,334611,77.01058688147296,10
0.2,4345,92,334703,77.01403589507593,9
0.2,4346,96,334799,77.01840349666436,6
0.2,4347,17,334816,77.00459981600736,15
0.2,4348,92,334908,77.00804782708668,9
0.2,4349,94,335002,77.0119540229885,7
0.2,4350,95,335097,77.01608825557344,6
0.2,4351,96,335193,77.02045036764706,6
0.2,4352,91,335284,77.02366184240753,10
0.2,4353,96,335380,77.02802021129996,6
0.2,4354,95,335475,77.0321469575201,6
0.2,4355,94,335569,77.03604224058769,8
0.2,4356,93,335662,77.03970621987607,8
0.2,4357,96,335758,77.044056906838,6
0.2,4358,92,335850,77.0474879559532,9
0.2,4359,95,335945,77.05160550458716,6
0.2,4360,94,336039,77.05549185966521,7
0.2,4361,93,336132,77.05914718019257,8
0.2,4362,95,336227,77.0632592253037,7
0.2,4363,94,336321,77.06714023831347,8
0.2,4364,22,336343,77.05452462772051,10
0.2,4365,95,336438,77.05863490609254,6
0.2,4366,95,336533,77.06274330203802,6
0.2,4367,17,336550,77.04899267399267,17
0.2,4368,92,336642,77.05241474021516,9
0.2,4369,89,336731,77.05514874141876,12
0.2,4370,94,336825,77.05902539464654,7
0.2,4371,88,336913,77.06152790484904,13
0.2,4372,24,336937,77.04939400868969,9
0.2,4373,96,337033,77.05372656607224,6
0.2,4374,94,337127,77.0576,7
0.2,4375,92,337219,77.06101462522852,9
0.2,4376,92,337311,77.06442769019877,9
0.2,4377,87,337398,77.0666971219735,14
0.2,4378,94,337492,77.07056405572048,7
0.2,4379,90,337582,77.07351598173516,11
0.2,4380,96,337678,77.07783611047707,6
0.2,4381,19,337697,77.06458238247376,13
0.2,4382,95,337792,77.06867442391056,6
0.2,4383,26,337818,77.05702554744525,6
0.2,4384,95,337913,77.06111744583808,7
0.2,4385,93,338006,77.06475148198814,8
0.2,4386,92,338098,77.06815591520402,9
0.2,4387,95,338193,77.07224247948952,9
0.2,4388,95,338288,77.07632718159034,6
0.2,4389,92,338380,77.07972665148064,9
0.2,4390,-58,338322,77.04896378956957,21
0.2,4391,93,338415,77.0525956284153,8
0.2,4392,93,338508,77.05622581379467,8
0.2,4393,23,338531,77.04392353208921,9
0.2,4394,96,338627,77.04823663253697,8
0.2,4395,95,338722,77.0523202911738,6
0.2,4396,18,338740,77.03889015237662,14
0.2,4397,88,338828,77.04138244656662,13
0.2,4398,23,338851,77.02909752216412,10
0.2,4399,90,338941,77.03204545454545,12
0.2,4400,92,339033,77.03544648943422,9
0.2,4401,93,339126,77.03907314856883,8
0.2,4402,96,339222,77.04337951396775,6
0.2,4403,95,339317,77.04745685740237,6
0.2,4404,94,339411,77.05130533484676,7
0.2,4405,93,339504,77.05492510213345,8
0.2,4406,95,339599,77.0589970501475,7
0.2,4407,22,339621,77.04650635208712,12
0.2,4408,93,339714,77.0501247448401,8
0.2,4409,84,339798,77.0517006802721,17
0.2,4410,26,339824,77.04012695533892,7
0.2,4411,94,339918,77.04397098821396,8
0.2,4412,25,339943,77.03217765692273,11
0.2,4413,95,340038,77.03624830086089,6
0.2,4414,96,340134,77.040543601359,6
0.2,4415,92,340226,77.0439311594203,9
0.2,4416,-53,340173,77.01448947249264,17
0.2,4417,93,340266,77.0181077410593,8
0.2,4418,94,340360,77.02195066757184,8
0.2,4419,95,340455,77.02601809954751,8
0.2,4420,87,340542,77.0282741461208,14
0.2,4421,94,340636,77.03211216644053,7
0.2,4422,21,340657,77.0194438164142,11
0.2,4423,-56,340601,76.98937613019892,19
0.2,4424,96,340697,76.99367231638418,6
0.2,4425,18,340715,76.98034342521464,14
0.2,4426,96,340811,76.98463971086514,7
0.2,4427,85,340896,76.98644986449864,16
0.2,4428,91,340987,76.98961390833145,10
0.2,4429,91,341078,76.99277652370203,10
0.2,4430,18,341096,76.97946287519747,14
0.2,4431,94,341190,76.98330324909747,7
0.2,4432,95,341285,76.98736747123844,6
0.2,4433,93,341378,76.99097880018043,8
0.2,4434,92,341470,76.99436302142053,9
0.2,4435,18,341488,76.98106402164112,14
0.2,4436,94,341582,76.98489970700923,8
0.2,4437,91,341673,76.98805768364127,10
0.2,4438,96,341769,76.99234061725613,7
0.2,4439,19,341788,76.97927927927928,16
0.2,4440,94,341882,76.9831119117316,7
0.2,4441,22,341904,76.970733903647,10
0.2,4442,96,342000,76.97501688048615,7
0.2,4443,94,342094,76.97884788478848,7
0.2,4444,93,342187,76.98245219347582,8
0.2,4445,95,342282,76.98650472334683,7
0.2,4446,90,342372,76.98943107713065,11
0.2,4447,94,342466,76.99325539568345,7
0.2,4448,91,342557,76.99640368622163,12
0.2,4449,93,342650,77.0,8
0.2,4450,94,342744,77.00381936643451,7
0.2,4451,82,342826,77.00494159928122,19
0.2,4452,94,342920,77.00875814057939,7
0.2,4453,95,343015,77.01279748540638,6
0.2,4454,93,343108,77.01638608305275,8
0.2,4455,94,343202,77.02019748653501,7
0.2,4456,95,343297,77.02423154588288,7
0.2,4457,94,343391,77.02803947958726,7
0.2,4458,91,343482,77.03117290872393,10
0.2,4459,92,343574,77.03452914798206,9
0.2,4460,92,343666,77.03788388253754,10
0.2,4461,19,343685,77.02487673688928,13
0.2,4462,92,343777,77.02823213085368,9
0.2,4463,91,343868,77.03136200716845,10
0.2,4464,91,343959,77.03449048152295,10
0.2,4465,19,343978,77.02149574563367,14
0.2,4466,89,344067,77.02417730020147,12
0.2,4467,91,344158,77.02730528200537,10
0.2,4468,94,344252,77.03110315506825,8
0.2,4469,94,344346,77.03489932885905,7
0.2,4470,86,344432,77.03690449563857,15
0.2,4471,94,344526,77.04069767441861,8
0.2,4472,95,344621,77.04471272076906,6
0.2,4473,94,344715,77.04850245864998,7
0.2,4474,94,344809,77.0522905027933,7
0.2,4475,91,344900,77.05540661304737,10
0.2,4476,93,344993,77.05896805896806,9
0.2,4477,96,345089,77.0631978561858,6
0.2,4478,95,345184,77.06720250055817,8
0.2,4479,96,345280,77.07142857142857,6
0.2,4480,23,345303,77.05936174960947,9
0.2,4481,94,345397,77.06314145470772,7
0.2,4482,94,345491,77.06691947356681,8
0.2,4483,95,345586,77.07091882247992,7
0.2,4484,91,345677,77.07402452619844,12
0.2,4485,94,345771,77.07779759251004,7
0.2,4486,96,345867,77.0820147091598,6
0.2,4487,90,345957,77.08489304812834,11
0.2,4488,90,346047,77.08777010470038,11
0.2,4489,93,346140,77.0913140311804,8
0.2,4490,90,346230,77.09418837675351,11
0.2,4491,93,346323,77.09772929652716,8
0.2,4492,89,346412,77.10037836634766,12
0.2,4493,95,346507,77.10436137071652,7
0.2,4494,94,346601,77.10812013348165,7
0.2,4495,94,346695,77.11187722419929,7
0.2,4496,15,346710,77.09806537691794,17
0.2,4497,95,346805,77.10204535349044,6
0.2,4498,89,346894,77.1046899310958,12
0.2,4499,23,346917,77.09266666666667,10
0.2,4500,94,347011,77.09642301710731,7
0.2,4501,92,347103,77.0997334517992,9
0.2,4502,91,347194,77.10282034199423,11
0.2,4503,94,347288,77.10657193605684,7
0.2,4504,91,347379,77.10965593784684,10
0.2,4505,93,347472,77.11318242343542,9
0.2,4506,95,347567,77.11715109829154,6
0.2,4507,94,347661,77.12089618456078,7
0.2,4508,91,347752,77.12397427367488,10
0.2,4509,94,347846,77.12771618625277,9
0.2,4510,95,347941,77.13167812015074,6
0.2,4511,94,348035,77.13541666666667,9
0.2,4512,91,348126,77.13848881010415,10
0.2,4513,96,348222,77.14266725742135,6
0.2,4514,-52,348170,77.1140642303433,16
0.2,4515,94,348264,77.11780336581045,8
0.2,4516,95,348359,77.12176223156962,8
0.2,4517,95,348454,77.12571934484285,6
0.2,4518,95,348549,77.12967470679354,7
0.2,4519,96,348645,77.13384955752213,6
0.2,4520,94,348739,77.1375801813758,9
0.2,4521,90,348829,77.14042459088898,11
0.2,4522,91,348920,77.14348883484413,10
0.2,4523,94,349014,77.14721485411141,8
0.2,4524,92,349106,77.15049723756906,9
0.2,4525,94,349200,77.15422006186478,9
0.2,4526,95,349295,77.15816213828143,7
0.2,4527,94,349389,77.1618816254417,7
0.2,4528,94,349483,77.1655994700817,7
0.2,4529,93,349576,77.1690949227373,8
0.2,4530,94,349670,77.17280953431913,7
0.2,4531,96,349766,77.17696381288614,6
0.2,4532,94,349860,77.18067504963601,10
0.2,4533,94,349954,77.18438464931627,7
0.2,4534,95,350049,77.1883131201764,6
0.2,4535,95,350144,77.19223985890653,6
0.2,4536,94,350238,77.19594445668945,7
0.2,4537,96,350334,77.20008814455707,7
0.2,4538,92,350426,77.20334875523243,10
0.2,4539,95,350521,77.20726872246696,6
0.2,4540,89,350610,77.209865668355,14
0.2,4541,94,350704,77.21356230735358,7
0.2,4542,92,350796,77.21681708122387,9
0.2,4543,93,350889,77.22029049295774,9
0.2,4544,92,350981,77.22354235423542,10
0.2,4545,94,351075,77.22723273207215,7
0.2,4546,95,351170,77.23114141191995,7
0.2,4547,92,351262,77.2343887423043,9
0.2,4548,21,351283,77.22202681908112,11
0.2,4549,92,351375,77.22527472527473,9
0.2,4550,94,351469,77.22896066798506,7
0.2,4551,21,351490,77.21660808435853,11
0.2,4552,23,351513,77.20470019767187,9
0.2,4553,95,351608,77.20860781730347,6
0.2,4554,92,351700,77.21185510428101,9
0.2,4555,93,351793,77.21532045654082,8
0.2,4556,93,351886,77.21878428790872,8
0.2,4557,95,351981,77.22268538832822,7
0.2,4558,93,352074,77.22614608466769,9
0.2,4559,93,352167,77.2296052631579,8
0.2,4560,86,352253,77.23152817364613,16
0.2,4561,93,352346,77.2349846558527,8
0.2,4562,95,352441,77.23887793118563,6
0.2,4563,94,352535,77.24255039439089,7
0.2,4564,90,352625,77.24534501642935,11
0.2,4565,95,352720,77.24923346473938,7
0.2,4566,-53,352667,77.22071381650974,16
0.2,4567,21,352688,77.20840630472854,11
0.2,4568,93,352781,77.21186255198074,8
0.2,4569,95,352876,77.21575492341357,6
0.2,4570,94,352970,77.21942682126449,7
0.2,4571,94,353064,77.2230971128609,7
0.2,4572,23,353087,77.21123988628909,12
0.2,4573,-47,353040,77.18408395277656,10
0.2,4574,93,353133,77.18754098360655,8
0.2,4575,93,353226,77.1909965034965,8
0.2,4576,88,353314,77.19335809482193,13
0.2,4577,94,353408,77.19702927042377,7
0.2,4578,21,353429,77.18475649705175,11
0.2,4579,23,353452,77.17292576419214,9
0.2,4580,94,353546,77.17659899585243,8
0.2,4581,17,353563,77.16346573548668,15
0.2,4582,82,353645,77.16452105607681,19
0.2,4583,20,353665,77.15205061082024,12
0.2,4584,91,353756,77.15507088331516,10
0.2,4585,23,353779,77.14326210204972,10
0.2,4586,91,353870,77.1462829736211,10
0.2,4587,92,353962,77.14952048823017,9
0.2,4588,86,354048,77.15144911745479,16
0.2,4589,93,354141,77.15490196078431,8
0.2,4590,93,354234,77.15835329993466,9
0.2,4591,95,354329,77.16223867595819,6
0.2,4592,90,354419,77.16503374700632,11
0.2,4593,-53,354366,77.13670004353504,16
0.2,4594,96,354462,77.14080522306855,6
0.2,4595,94,354556,77.14447345517841,8
0.2,4596,94,354650,77.14814009136393,7
0.2,4597,92,354742,77.15137016093954,9
0.2,4598,92,354834,77.1545988258317,9
0.2,4599,92,354926,77.15782608695652,9
0.2,4600,96,355022,77.16192132145186,6
0.2,4601,96,355118,77.16601477618427,6
0.2,4602,25,355143,77.15468172930697,8
0.2,4603,92,355235,77.15790616854909,10
0.2,4604,92,355327,77.16112920738328,9
0.2,4605,90,355417,77.16391663048198,11
0.2,4606,91,355508,77.16691990449316,12
0.2,4607,93,355601,77.17035590277777,8
0.2,4608,92,355693,77.17357344326318,9
0.2,4609,90,355783,77.1763557483731,11
0.2,4610,94,355877,77.18000433745391,7
0.2,4611,88,355965,77.1823503902862,13
0.2,4612,90,356055,77.18512898330805,12
0.2,4613,94,356149,77.18877329865626,8
0.2,4614,93,356242,77.19219934994582,8
0.2,4615,96,356338,77.19627383015597,6
0.2,4616,94,356432,77.19991336365605,7
0.2,4617,95,356527,77.20376786487657,6
0.2,4618,93,356620,77.20718770296601,9
0.2,4619,87,356707,77.20930735930736,14
0.2,4620,93,356800,77.21272451850248,8
0.2,4621,94,356894,77.21635655560364,7
0.2,4622,19,356913,77.20376378974692,13
0.2,4623,85,356998,77.20544982698962,16
0.2,4624,92,357090,77.20864864864865,9
0.2,4625,92,357182,77.21184608733248,9
0.2,4626,94,357276,77.2154743894532,7
0.2,4627,90,357366,77.21823681936041,13
0.2,4628,93,357459,77.22164614387556,8
0.2,4629,94,357553,77.22526997840173,7
0.2,4630,94,357647,77.22889224789462,7
0.2,4631,92,357739,77.23208117443869,9
0.2,4632,89,357828,77.23462119576948,12
0.2,4633,93,357921,77.23802330599914,8
0.2,4634,23,357944,77.22632146709816,10
0.2,4635,93,358037,77.22972389991372,8
0.2,4636,93,358130,77.23312486521458,8
0.2,4637,19,358149,77.22056921086676,13
0.2,4638,21,358170,77.20845009700366,11
0.2,4639,95,358265,77.21228448275862,7
0.2,4640,95,358360,77.21611721611721,6
0.2,4641,95,358455,77.21994829814734,6
0.2,4642,92,358547,77.22313159595089,9
0.2,4643,94,358641,77.22674418604652,8
0.2,4644,92,358733,77.22992465016146,9
0.2,4645,93,358826,77.23331898407233,8
0.2,4646,92,358918,77.23649666451475,9
0.2,4647,92,359010,77.23967297762478,9
0.2,4648,89,359099,77.24220262422027,13
0.2,4649,92,359191,77.24537634408603,9
0.2,4650,95,359286,77.24919372178026,6
0.2,4651,94,359380,77.25279449699055,7
0.2,4652,95,359475,77.25660863958737,6
0.2,4653,23,359498,77.24495058014611,9
0.2,4654,90,359588,77.24769065520945,11
0.2,4655,87,359675,77.2497852233677,15
0.2,4656,89,359764,77.25230835301696,13
0.2,4657,94,359858,77.25590382138257,7
0.2,4658,93,359951,77.25928310796309,8
0.2,4659,92,360043,77.26244635193133,9
0.2,4660,17,360060,77.2495172709719,16
0.2,4661,94,360154,77.25311025311025,7
0.2,4662,92,360246,77.25627278576025,9
0.2,4663,90,360336,77.2590051457976,11
0.2,4664,84,360420,77.26045016077171,18
0.2,4665,96,360516,77.26446635233604,7
0.2,4666,87,360603,77.26655238911506,14
0.2,4667,93,360696,77.26992287917737,8
0.2,4668,21,360717,77.25787106446776,12
0.2,4669,90,360807,77.26059957173447,11
0.2,4670,90,360897,77.26332691072575,11
0.2,4671,90,360987,77.26605308219177,11
0.2,4672,91,361078,77.2689920821742,10
0.2,4673,94,361172,77.27257167308515,8
0.2,4674,95,361267,77.27636363636364,6
0.2,4675,21,361288,77.26432848588537,11
0.2,4676,12,361300,77.25037417147745,22
0.2,4677,-48,361252,77.22359982898675,12
0.2,4678,90,361342,77.2263304124813,11
0.2,4679,25,361367,77.21517094017094,8
0.2,4680,-59,361308,77.18607135227515,22
0.2,4681,-46,361262,77.1597607859889,9
0.2,4682,96,361358,77.1637838992099,7
0.2,4683,24,361382,77.15243381725021,8
0.2,4684,18,361400,77.13980789754535,14
0.2,4685,90,361490,77.14255228339735,11
0.2,4686,93,361583,77.14593556646042,8
0.2,4687,92,361675,77.14910409556315,9
0.2,4688,95,361770,77.1529110684581,6
0.2,4689,87,361857,77.1550106609808,14
0.2,4690,95,361952,77.1588147516521,6
0.2,4691,92,362044,77.1619778346121,9
0.2,4692,92,362136,77.1651395695717,9
0.2,4693,93,362229,77.16851299531316,8
0.2,4694,95,362324,77.17231096911608,6
0.2,4695,94,362418,77.1758943781942,7
0.2,4696,90,362508,77.1786246540345,11
0.2,4697,90,362598,77.18135376756067,11
0.2,4698,93,362691,77.18472015322409,8
0.2,4699,96,362787,77.18872340425531,6
0.2,4700,25,362812,77.17762178259945,8
0.2,4701,94,362906,77.1811994895789,7
0.2,4702,92,362998,77.18435041462897,11
0.2,4703,89,363087,77.18686224489795,12
0.2,4704,95,363182,77.19064824654623,7
0.2,4705,94,363276,77.19422014449638,7
0.2,4706,94,363370,77.19779052475037,7
0.2,4707,92,363462,77.20093457943925,10
0.2,4708,95,363557,77.20471437672542,7
0.2,4709,-55,363502,77.17664543524417,18
0.2,4710,90,363592,77.17936743791127,11
0.2,4711,95,363687,77.1831494057725,9
0.2,4712,96,363783,77.18714194780395,6
0.2,4713,92,363875,77.1902842596521,9
0.2,4714,94,363969,77.19384941675504,7
0.2,4715,91,364060,77.19677692960136,10
0.2,4716,92,364152,77.1999152003392,9
0.2,4717,88,364240,77.20220432386604,13
0.2,4718,94,364334,77.20576393303666,7
0.2,4719,93,364427,77.20911016949152,9
0.2,4720,88,364515,77.21139589070113,13
0.2,4721,90,364605,77.2141041931385,11
0.2,4722,11,364616,77.2000846919331,22
0.2,4723,91,364707,77.20300592718036,10
0.2,4724,15,364722,77.18984126984127,17
0.2,4725,90,364812,77.19255184088024,11
0.2,4726,92,364904,77.19568436640576,10
0.2,4727,93,364997,77.19902707275804,8
0.2,4728,94,365091,77.20257982660182,7
0.2,4729,94,365185,77.2061310782241,7
0.2,4730,94,365279,77.20968082857746,7
0.2,4731,94,365373,77.2132290786137,7
0.2,4732,91,365464,77.21614198182971,11
0.2,4733,92,365556,77.2192648922687,10
0.2,4734,93,365649,77.22259767687434,9
0.2,4735,94,365743,77.22614020270271,7
0.2,4736,94,365837,77.2296812328478,8
0.2,4737,93,365930,77.23300970873787,9
0.2,4738,94,366024,77.23654779489344,7
0.2,4739,22,366046,77.22489451476794,10
0.2,4740,93,366139,77.22822189411517,8
0.2,4741,91,366230,77.23112610712779,11
0.2,4742,19,366249,77.21884882985452,13
0.2,4743,93,366342,77.22217537942664,8
0.2,4744,96,366438,77.22613277133826,6
0.2,4745,24,366462,77.2149178255373,8
0.2,4746,93,366555,77.21824310090584,8
0.2,4747,93,366648,77.22156697556866,8
0.2,4748,92,366740,77.22467887976416,9
0.2,4749,96,366836,77.22863157894737,6
0.2,4750,96,366932,77.23258261418648,6
0.2,4751,94,367026,77.23611111111111,7
0.2,4752,90,367116,77.23879654954766,11
0.2,4753,22,367138,77.22717711400925,10
0.2,4754,94,367232,77.23070452155626,8
0.2,4755,92,367324,77.23380992430614,9
0.2,4756,93,367417,77.2371242379651,9
0.2,4757,95,367512,77.24085750315258,6
0.2,4758,92,367604,77.24395881487708,9
0.2,4759,96,367700,77.24789915966386,6
0.2,4760,91,367791,77.25078764965343,10
0.2,4761,88,367879,77.25304493910122,13
0.2,4762,94,367973,77.25656099097208,7
0.2,4763,94,368067,77.26007556675063,7
0.2,4764,22,368089,77.24847848898216,10
0.2,4765,14,368103,77.23520772135963,18
0.2,4766,18,368121,77.22278162366268,15
0.2,4767,95,368216,77.22651006711409,7
0.2,4768,-50,368166,77.19983224994758,14
0.2,4769,95,368261,77.20356394129979,6
0.2,4770,91,368352,77.20645566967093,10
0.2,4771,88,368440,77.20871751886001,13
0.2,4772,18,368458,77.19631259166142,14
0.2,4773,94,368552,77.19983242563887,8
0.2,4774,27,368579,77.18931937172775,6
0.2,4775,24,368603,77.17818257956449,8
0.2,4776,91,368694,77.1810759891145,10
0.2,4777,92,368786,77.1841774801172,9
0.2,4778,85,368871,77.18581293157564,16
0.2,4779,94,368965,77.18933054393305,7
0.2,4780,94,369059,77.19284668479398,7
0.2,4781,22,369081,77.18130489335006,10
0.2,4782,88,369169,77.18356679908007,13
0.2,4783,92,369261,77.18666387959867,9
0.2,4784,21,369282,77.17492163009405,11
0.2,4785,92,369374,77.17801922273297,9
0.2,4786,95,369469,77.18174221850846,6
0.2,4787,94,369563,77.18525480367586,7
0.2,4788,95,369658,77.18897473376488,6
0.2,4789,92,369750,77.19206680584551,9
0.2,4790,95,369845,77.19578376121895,6
0.2,4791,94,369939,77.19929048414023,7
0.2,4792,88,370027,77.20154391821406,13
0.2,4793,91,370118,77.20442219440967,10
0.2,4794,27,370145,77.19395203336809,6
0.2,4795,93,370238,77.19724770642202,10
0.2,4796,93,370331,77.20054200542006,8
0.2,4797,88,370419,77.20279283034598,13
0.2,4798,22,370441,77.1912898520525,12
0.2,4799,6,370447,77.17645833333333,26
0.2,4800,95,370542,77.18017079775046,6
0.2,4801,95,370637,77.18388171595169,7
0.2,4802,25,370662,77.17301686445971,8
0.2,4803,94,370756,77.17651956702748,8
0.2,4804,93,370849,77.17981269510926,8
0.2,4805,94,370943,77.18331252600916,7
0.2,4806,93,371036,77.1866028708134,8
0.2,4807,91,371127,77.1894758735441,10
0.2,4808,92,371219,77.19255562487004,9
0.2,4809,94,371313,77.1960498960499,7
0.2,4810,-120,371193,77.15506131781335,14
0.2,4811,96,371289,77.15897755610973,6
0.2,4812,94,371383,77.16247662580511,7
0.2,4813,95,371478,77.16618196925634,7
0.2,4814,92,371570,77.16926272066459,10
0.2,4815,92,371662,77.17234219269103,10
0.2,4816,91,371753,77.17521278804234,10
0.2,4817,88,371841,77.1774595267746,13
0.2,4818,-56,371785,77.14982361485785,20
0.2,4819,92,371877,77.15290456431535,9
0.2,4820,94,371971,77.15639908732628,7
0.2,4821,91,372062,77.15927001244297,10
0.2,4822,94,372156,77.16276176653535,7
0.2,4823,96,372252,77.16666666666667,6
0.2,4824,93,372345,77.1699481865285,8
0.2,4825,95,372440,77.17364276833817,7
0.2,4826,93,372533,77.17692148332297,8
0.2,4827,90,372623,77.17957746478874,11
0.2,4828,95,372718,77.18326775729965,6
0.2,4829,87,372805,77.18530020703933,14
0.2,4830,22,372827,77.17387704409025,11
0.2,4831,21,372848,77.16225165562913,12
0.2,4832,96,372944,77.16614938961308,6
0.2,4833,95,373039,77.1698386429458,8
0.2,4834,93,373132,77.17311271975181,8
0.2,4835,96,373228,77.17700578990902,6
0.2,4836,23,373251,77.16580525118876,9
0.2,4837,94,373345,77.1692848284415,8
0.2,4838,92,373437,77.17234965902045,9
0.2,4839,94,373531,77.175826446281,7
0.2,4840,94,373625,77.17930179714935,7
0.2,4841,95,373720,77.18298223874432,7
0.2,4842,91,373811,77.18583522609953,10
0.2,4843,94,373905,77.1893063583815,7
0.2,4844,95,374000,77.19298245614036,7
0.2,4845,94,374094,77.196450680974,7
0.2,4846,91,374185,77.1992985351764,10
0.2,4847,92,374277,77.20235148514851,9
0.2,4848,95,374372,77.20602186017736,6
0.2,4849,93,374465,77.20927835051546,9
0.2,4850,94,374559,77.21273964131107,7
0.2,4851,94,374653,77.21619950535862,7
0.2,4852,91,374744,77.21903976921492,10
0.2,4853,94,374838,77.22249690976514,7
0.2,4854,93,374931,77.22574665293511,8
0.2,4855,93,375024,77.22899505766063,8
0.2,4856,94,375118,77.23244801317686,7
0.2,4857,93,375211,77.23569370111157,9
0.2,4858,90,375301,77.23832064210742,12
0.2,4859,95,375396,77.24197530864197,6
0.2,4860,93,375489,77.2452170335322,8
0.2,4861,95,375584,77.24886877828054,6
0.2,4862,95,375679,77.25251902118035,6
0.2,4863,92,375771,77.25555098684211,10
0.2,4864,93,375864,77.25878725590955,8
0.2,4865,91,375955,77.26161117961365,10
0.2,4866,-122,375833,77.22066981713581,16
0.2,4867,87,375920,77.22267871815941,14
0.2,4868,95,376015,77.22632984185664,6
0.2,4869,22,376037,77.21498973305955,10
0.2,4870,95,376132,77.21864093615274,7
0.2,4871,90,376222,77.22126436781609,11
0.2,4872,93,376315,77.22450235994253,8
0.2,4873,91,376406,77.22732868280673,10
0.2,4874,92,376498,77.23035897435898,10
0.2,4875,21,376519,77.21882690730106,11
0.2,4876,93,376612,77.22206274348984,8
0.2,4877,93,376705,77.22529725297252,8
0.2,4878,92,376797,77.22832547653208,9
0.2,4879,90,376887,77.23094262295082,11
0.2,4880,95,376982,77.23458307723827,6
0.2,4881,91,377073,77.23740270380992,11
0.2,4882,90,377163,77.24001638337087,11
0.2,4883,91,377254,77.24283374283374,12
0.2,4884,96,377350,77.24667349027635,6
0.2,4885,22,377372,77.23536635284486,10
0.2,4886,91,377463,77.23818293431553,11
0.2,4887,94,377557,77.24161211129297,8
0.2,4888,94,377651,77.24503988545715,7
0.2,4889,92,377743,77.2480572597137,10
0.2,4890,93,377836,77.2512778572889,8
0.2,4891,95,377931,77.25490596892887,6
0.2,4892,19,377950,77.2430002043736,13
0.2,4893,93,378043,77.24621986105436,8
0.2,4894,-49,377994,77.22042900919305,12
0.2,4895,96,378090,77.22426470588235,6
0.2,4896,93,378183,77.22748621605065,8
0.2,4897,92,378275,77.23050224581462,11
0.2,4898,92,378367,77.23351704429476,9
0.2,4899,24,378391,77.22265306122449,9
0.2,4900,22,378413,77.21138543154458,10
0.2,4901,92,378505,77.21440228478173,9
0.2,4902,92,378597,77.21741790740363,9
0.2,4903,86,378683,77.2192088091354,15
0.2,4904,21,378704,77.20774719673803,11
0.2,4905,95,378799,77.21137382796576,6
0.2,4906,-49,378750,77.18565314856328,12
0.2,4907,93,378843,77.18887530562347,8
0.2,4908,96,378939,77.1927072723569,7
0.2,4909,92,379031,77.19572301425661,9
0.2,4910,90,379121,77.19833027896559,11
0.2,4911,22,379143,77.18709283387622,10
0.2,4912,88,379231,77.18929371056382,13
0.2,4913,92,379323,77.1923076923077,10
0.2,4914,88,379411,77.19450661241099,13
0.2,4915,94,379505,77.1979251423922,8
0.2,4916,95,379600,77.2015456579215,6
0.2,4917,89,379689,77.20394469296463,12
0.2,4918,94,379783,77.20735921935352,7
0.2,4919,25,379808,77.19674796747968,8
0.2,4920,92,379900,77.19975614712457,9
0.2,4921,92,379992,77.2027631044291,9
0.2,4922,85,380077,77.20434694292098,17
0.2,4923,91,380168,77.20714865962633,10
0.2,4924,94,380262,77.21055837563452,7
0.2,4925,23,380285,77.19955339017459,10
0.2,4926,96,380381,77.20336919017657,6
0.2,4927,94,380475,77.20677759740259,7
0.2,4928,27,380502,77.19659160073037,6
0.2,4929,22,380524,77.18539553752535,12
0.2,4930,91,380615,77.18819712025959,10
0.2,4931,93,380708,77.19140308191403,8
0.2,4932,24,380732,77.18062031218325,8
0.2,4933,93,380825,77.1838265099311,9
0.2,4934,84,380909,77.18520770010132,17
0.2,4935,88,380997,77.18739870340356,13
0.2,4936,92,381089,77.19039902774965,10
0.2,4937,-47,381042,77.16524908869988,11
0.2,4938,93,381135,77.16845515286495,8
0.2,4939,91,381226,77.17125506072874,10
0.2,4940,92,381318,77.17425622343656,10
0.2,4941,95,381413,77.17786321327398,6
0.2,4942,95,381508,77.18146874367793,6
0.2,4943,93,381601,77.18466828478964,8
0.2,4944,93,381694,77.18786653185036,8
0.2,4945,92,381786,77.19086130206227,9
0.2,4946,93,381879,77.194057004245,8
0.2,4947,95,381974,77.1976556184317,6
0.2,4948,94,382068,77.20105071731663,7
0.2,4949,92,382160,77.2040404040404,9
0.2,4950,91,382251,77.20682690365582,10
0.2,4951,22,382273,77.19567851373182,10
0.2,4952,94,382367,77.1990712699374,7
0.2,4953,15,382382,77.18651594670973,17
0.2,4954,89,382471,77.18890010090817,12
0.2,4955,19,382490,77.1771589991929,13
0.2,4956,91,382581,77.17994754892072,11
0.2,4957,91,382672,77.18273497377974,12
0.2,4958,94,382766,77.18612623512804,7
0.2,4959,94,382860,77.18951612903226,7
0.2,4960,94,382954,77.19290465631929,7
0.2,4961,93,383047,77.19609028617494,8
0.2,4962,95,383142,77.19967761434616,7
0.2,4963,85,383227,77.20124899274778,16
0.2,4964,88,383315,77.20342396777443,15
0.2,4965,94,383409,77.20680628272251,7
0.2,4966,95,383504,77.21038856452587,6
0.2,4967,94,383598,77.21376811594203,7
0.2,4968,92,383690,77.21674381163211,10
0.2,4969,95,383785,77.22032193158954,7
0.2,4970,94,383879,77.22369744518205,7
0.2,4971,91,383970,77.22646822204344,10
0.2,4972,91,384061,77.22923788457672,10
0.2,4973,93,384154,77.2324085243265,8
0.2,4974,18,384172,77.22050251256282,14
0.2,4975,90,384262,77.22307073954984,11
0.2,4976,93,384355,77.22624070725337,8
0.2,4977,92,384447,77.22920851747689,10
0.2,4978,94,384541,77.23257682265515,7
0.2,4979,95,384636,77.23614457831326,6
0.2,4980,93,384729,77.23930937562739,8
0.2,4981,94,384823,77.24267362505019,9
0.2,4982,94,384917,77.24603652418222,7
0.2,4983,96,385013,77.24979935794542,6
0.2,4984,94,385107,77.25315947843531,7
0.2,4985,92,385199,77.25611712795828,9
0.2,4986,90,385289,77.25867254862644,11
0.2,4987,93,385382,77.26182838813152,10
0.2,4988,94,385476,77.26518340348767,7
0.2,4989,91,385567,77.26793587174349,10
0.2,4990,95,385662,77.27148867962332,6
0.2,4991,95,385757,77.27504006410257,7
0.2,4992,94,385851,77.2783897456439,7
0.2,4993,94,385945,77.28173808570284,7
0.2,4994,96,386041,77.28548548548548,6
0.2,4995,87,386128,77.28742994395516,14
0.2,4996,90,386218,77.28997398439063,13
0.2,4997,93,386311,77.29311724689876,9
0.2,4998,93,386404,77.29625925185037,8
0.2,4999,93,386497,77.2994,8
0.2,5000,94,386591,77.30273945210958,7
0.2,5001,13,386604,77.28988404638145,20
0.2,5002,89,386693,77.29222466520088,12
0.2,5003,94,386787,77.29556354916068,7
0.2,5004,94,386881,77.2989010989011,8
0.2,5005,88,386969,77.3010387534958,13
0.2,5006,94,387063,77.3043738765728,7
0.2,5007,92,387155,77.30730830670926,9
0.2,5008,91,387246,77.31004192453584,10
0.2,5009,94,387340,77.31337325349301,7
0.2,5010,91,387431,77.31610456994612,10
0.2,5011,94,387525,77.31943335993616,7
0.2,5012,90,387615,77.32196289646917,11
0.2,5013,25,387640,77.31152772237735,8
0.2,5014,84,387724,77.31286141575274,17
0.2,5015,92,387816,77.3157894736842,9
0.2,5016,93,387909,77.31891568666533,8
0.2,5017,95,388004,77.32243921881228,6
0.2,5018,92,388096,77.32536361825065,9
0.2,5019,95,388191,77.3288844621514,7
0.2,5020,94,388285,77.33220474009161,8
0.2,5021,94,388379,77.33552369573874,7
0.2,5022,92,388471,77.33844316145729,9
0.2,5023,93,388564,77.34156050955414,9
0.2,5024,94,388658,77.34487562189055,7
0.2,5025,89,388747,77.34719458814166,12
0.2,5026,89,388836,77.34951263178834,15
0.2,5027,95,388931,77.3530230708035,8
0.2,5028,94,389025,77.3563332670511,7
0.2,5029,93,389118,77.35944333996024,9
0.2,5030,95,389213,77.36294971178692,6
0.2,5031,94,389307,77.3662559618442,7
0.2,5032,22,389329,77.35525531492152,10
0.2,5033,92,389421,77.35816448152562,9
0.2,5034,89,389510,77.36047666335651,13
0.2,5035,91,389601,77.3631850675139,10
0.2,5036,91,389692,77.36589239626763,10
0.2,5037,92,389784,77.36879714172291,9
0.2,5038,94,389878,77.37209763842033,7
0.2,5039,89,389967,77.37440476190476,12
0.2,5040,90,390057,77.37690934338426,11
0.2,5041,91,390148,77.37961126537088,10
0.2,5042,92,390240,77.38251041046996,10
0.2,5043,83,390323,77.3836241078509,19
0.2,5044,9,390332,77.37006937561942,23
0.2,5045,23,390355,77.3592944906857,10
0.2,5046,11,390366,77.34614622548048,22
0.2,5047,27,390393,77.33617274167987,6
0.2,5048,89,390482,77.33848286789463,12
0.2,5049,94,390576,77.34178217821783,7
0.2,5050,94,390670,77.34508018214215,7
0.2,5051,92,390762,77.3479809976247,9
0.2,5052,94,390856,77.3512764694241,8
0.2,5053,85,390941,77.35278986941037,16
0.2,5054,95,391036,77.3562809099901,6
0.2,5055,95,391131,77.35977056962025,6
0.2,5056,93,391224,77.36286335772196,8
0.2,5057,96,391320,77.36654804270462,6
0.2,5058,94,391414,77.36983593595572,7
0.2,5059,90,391504,77.37233201581027,11
0.2,5060,94,391598,77.37561746690378,7
0.2,5061,91,391689,77.37830896878704,10
0.2,5062,95,391784,77.38178945289354,6
0.2,5063,95,391879,77.38526856240127,6
0.2,5064,93,391972,77.38835143139191,9
0.2,5065,90,392062,77.39084090011843,11
0.2,5066,92,392154,77.39372409709887,9
0.2,5067,27,392181,77.38378058405682,7
0.2,5068,94,392275,77.38705859143815,7
0.2,5069,89,392364,77.38934911242603,12
0.2,5070,92,392456,77.39223032932361,9
0.2,5071,22,392478,77.38130914826499,10
0.2,5072,95,392573,77.38478218016952,9
0.2,5073,20,392593,77.3734726054395,12
0.2,5074,92,392685,77.37635467980296,9
0.2,5075,93,392778,77.37943262411348,8
0.2,5076,89,392867,77.38172148906835,12
0.2,5077,92,392959,77.3846002363135,9
0.2,5078,94,393053,77.38787162827329,8
0.2,5079,91,393144,77.39055118110237,12
0.2,5080,90,393234,77.39303286754576,13
0.2,5081,96,393330,77.39669421487604,7
0.2,5082,92,393422,77.39956718473343,9
0.2,5083,21,393443,77.38847364280095,11
0.2,5084,93,393536,77.39154375614552,8
0.2,5085,94,393630,77.3948092803775,8
0.2,5086,93,393723,77.39787694122272,8
0.2,5087,95,393818,77.40133647798743,8
0.2,5088,94,393912,77.40459815287876,7
0.2,5089,89,394001,77.40687622789784,12
0.2,5090,95,394096,77.41033195835789,8
0.2,5091,87,394183,77.41221523959152,14
0.2,5092,90,394273,77.41468682505399,11
0.2,5093,93,394366,77.4177463682764,9
0.2,5094,27,394393,77.40785083415113,6
0.2,5095,92,394485,77.41071428571429,10
0.2,5096,93,394578,77.41377280753385,8
0.2,5097,13,394591,77.40113770105924,19
0.2,5098,93,394684,77.4041969013532,8
0.2,5099,95,394779,77.40764705882353,7
0.2,5100,93,394872,77.41070378357185,9
0.2,5101,94,394966,77.4139553116425,7
0.2,5102,22,394988,77.40309621791103,10
0.2,5103,19,395007,77.39165360501568,13
0.2,5104,24,395031,77.38119490695397,8
0.2,5105,92,395123,77.3840579710145,9
0.2,5106,96,395219,77.38770315253574,6
0.2,5107,91,395310,77.39036805011746,11
0.2,5108,94,395404,77.39361910354276,7
0.2,5109,85,395489,77.39510763209394,16
0.2,5110,23,395512,77.3844648796713,10
0.2,5111,90,395602,77.38693270735524,12
0.2,5112,90,395692,77.38939956972423,11
0.2,5113,94,395786,77.39264763394603,7
0.2,5114,96,395882,77.39628543499511,6
0.2,5115,93,395975,77.39933541829555,8
0.2,5116,91,396066,77.40199335548172,10
0.2,5117,90,396156,77.4044548651817,12
0.2,5118,91,396247,77.40711076382105,10
0.2,5119,93,396340,77.41015625,8
0.2,5120,92,396432,77.41300527240773,9
0.2,5121,94,396526,77.41624365482234,7
0.2,5122,82,396608,77.4171383954714,19
0.2,5123,23,396631,77.40651834504294,9
0.2,5124,90,396721,77.4089756097561,11
0.2,5125,92,396813,77.4118220834959,11
0.2,5126,91,396904,77.41447240101424,10
0.2,5127,93,396997,77.41751170046801,8
0.2,5128,85,397082,77.41899005654123,16
0.2,5129,92,397174,77.42183235867446,9
0.2,5130,94,397268,77.42506334047944,8
0.2,5131,87,397355,77.42692907248636,14
0.2,5132,26,397381,77.4169101889733,7
0.2,5133,92,397473,77.41975068172964,9
0.2,5134,94,397567,77.42297955209348,7
0.2,5135,89,397656,77.42523364485982,14
0.2,5136,88,397744,77.42729219388748,13
0.2,5137,92,397836,77.43012845465161,9
0.2,5138,94,397930,77.43335279237206,7
0.2,5139,94,398024,77.43657587548638,7
0.2,5140,94,398118,77.4397977047267,7
0.2,5141,91,398209,77.44243485025282,11
0.2,5142,94,398303,77.4456542873809,7
0.2,5143,92,398395,77.44848367029549,9
0.2,5144,93,398488,77.45150631681244,8
0.2,5145,94,398582,77.4547221142635,7
0.2,5146,93,398675,77.45774237419856,8
0.2,5147,94,398769,77.46095571095572,7
0.2,5148,92,398861,77.46377937463585,9
0.2,5149,89,398950,77.46601941747574,12
0.2,5150,88,399038,77.46806445350417,13
0.2,5151,21,399059,77.45710403726709,12
0.2,5152,92,399151,77.45992625654958,9
0.2,5153,25,399176,77.44974776872333,7
0.2,5154,89,399265,77.45198836081474,12
0.2,5155,93,399358,77.45500387897594,8
0.2,5156,-50,399308,77.43028892767113,14
0.2,5157,93,399401,77.43330748352075,8
0.2,5158,91,399492,77.43593719713122,10
0.2,5159,24,399516,77.42558139534884,9
0.2,5160,93,399609,77.42859910869987,8
0.2,5161,92,399701,77.4314219294847,9
0.2,5162,89,399790,77.433662599264,12
0.2,5163,25,399815,77.42350890782339,8
0.2,5164,93,399908,77.42652468538238,8
0.2,5165,94,400002,77.42973286875726,9
0.2,5166,92,400094,77.432552738533,9
0.2,5167,87,400181,77.4344040247678,16
0.2,5168,-53,400128,77.40917005223447,17
0.2,5169,91,400219,77.41179883945841,10
0.2,5170,95,400314,77.41520015470896,7
0.2,5171,91,400405,77.4178267594741,10
0.2,5172,93,400498,77.42083897158322,8
0.2,5173,96,400594,77.42442984151526,6
0.2,5174,94,400688,77.42763285024155,7
0.2,5175,21,400709,77.41673106646058,11
0.2,5176,95,400804,77.42012748696156,6
0.2,5177,88,400892,77.4221707222866,13
0.2,5178,88,400980,77.42421316856536,13
0.2,5179,88,401068,77.42625482625482,13
0.2,5180,95,401163,77.42964678633469,6
0.2,5181,95,401258,77.4330374372829,6
0.2,5182,96,401354,77.43661971830986,6
0.2,5183,89,401443,77.43885030864197,12
0.2,5184,92,401535,77.44165863066539,9
0.2,5185,23,401558,77.4311608175858,10
0.2,5186,21,401579,77.42028147291305,12
0.2,5187,92,401671,77.42309175019275,9
0.2,5188,94,401765,77.42628637502409,8
0.2,5189,93,401858,77.42928709055877,8
0.2,5190,95,401953,77.43267193219033,6
0.2,5191,13,401966,77.42026194144839,19
0.2,5192,18,401984,77.40881956479876,14
0.2,5193,94,402078,77.41201386214863,7
0.2,5194,93,402171,77.41501443695861,11
0.2,5195,87,402258,77.41685912240185,14
0.2,5196,22,402280,77.40619588223976,10
0.2,5197,20,402300,77.39515198153136,13
0.2,5198,94,402394,77.39834583573764,7
0.2,5199,94,402488,77.40153846153846,7
0.2,5200,94,402582,77.40472985964237,7
0.2,5201,24,402606,77.39446366782006,9
0.2,5202,88,402694,77.3965020180665,13
0.2,5203,93,402787,77.39950038431975,8
0.2,5204,91,402878,77.40211335254563,10
0.2,5205,92,402970,77.40491740299655,9
0.2,5206,-51,402919,77.38025734588055,15
0.2,5207,91,403010,77.38287250384025,10
0.2,5208,95,403105,77.3862545594164,6
0.2,5209,93,403198,77.38925143953935,8
0.2,5210,91,403289,77.39186336595662,10
0.2,5211,92,403381,77.39466615502685,10
0.2,5212,94,403475,77.39785152503357,7
0.2,5213,91,403566,77.40046029919448,10
0.2,5214,94,403660,77.40364333652924,8
0.2,5215,91,403751,77.40625,10
0.2,5216,92,403843,77.40904734521756,10
0.2,5217,24,403867,77.39881180528938,9
0.2,5218,17,403884,77.38723893466181,16
0.2,5219,-52,403832,77.3624521072797,15
0.2,5220,94,403926,77.36563876651982,7
0.2,5221,15,403941,77.35369590195327,18
0.2,5222,85,404026,77.35515986980663,16
0.2,5223,25,404051,77.34513782542113,8
0.2,5224,-57,403994,77.31942583732058,20
0.2,5225,95,404089,77.32280903176425,6
0.2,5226,94,404183,77.32599961737134,7
0.2,5227,95,404278,77.32938026013773,7
0.2,5228,91,404369,77.33199464524766,10
0.2,5229,-57,404312,77.30630975143403,20
0.2,5230,95,404407,77.3096922194609,6
0.2,5231,89,404496,77.31192660550458,12
0.2,5232,25,404521,77.30193005923944,8
0.2,5233,22,404543,77.29136415743217,10
0.2,5234,24,404567,77.28118433619866,8
0.2,5235,93,404660,77.28418640183347,10
0.2,5236,94,404754,77.28737827000191,7
0.2,5237,92,404846,77.29018709431081,9
0.2,5238,95,404941,77.29356747470891,8
0.2,5239,23,404964,77.28320610687022,10
0.2,5240,17,404981,77.27170387330662,15
0.2,5241,95,405076,77.2750858450973,6
0.2,5242,93,405169,77.27808506580202,8
0.2,5243,92,405261,77.28089244851259,9
0.2,5244,92,405353,77.2836987607245,9
0.2,5245,94,405447,77.28688524590164,8
0.2,5246,95,405542,77.29026110158186,7
0.2,5247,24,405566,77.28010670731707,9
0.2,5248,94,405660,77.28329205562964,7
0.2,5249,95,405755,77.28666666666666,6
0.2,5250,90,405845,77.28908779280137,11
0.2,5251,94,405939,77.29226961157654,8
0.2,5252,91,406030,77.29487911669523,10
0.2,5253,22,406052,77.28435477731253,10
0.2,5254,95,406147,77.28772597526165,7
0.2,5255,95,406242,77.29109589041096,6
0.2,5256,95,406337,77.29446452349248,6
0.2,5257,92,406429,77.29726131608977,9
0.2,5258,93,406522,77.30024719528427,8
0.2,5259,93,406615,77.3032319391635,8
0.2,5260,95,406710,77.30659570423873,6
0.2,5261,95,406805,77.30995819080198,6
0.2,5262,91,406896,77.31255937678131,10
0.2,5263,19,406915,77.30148176291793,15
0.2,5264,92,407007,77.30427350427351,9
0.2,5265,95,407102,77.30763387770604,6
0.2,5266,93,407195,77.31061325232581,8
0.2,5267,93,407288,77.31359149582384,8
0.2,5268,87,407375,77.31542987284115,14
0.2,5269,91,407466,77.31802656546489,10
0.2,5270,90,407556,77.32043255549232,11
0.2,5271,94,407650,77.32359635811837,9
0.2,5272,95,407745,77.32694860610658,7
0.2,5273,16,407761,77.31532043989382,17
0.2,5274,94,407855,77.31848341232228,7
0.2,5275,92,407947,77.32126611068992,9
0.2,5276,19,407966,77.31021413682016,14
0.2,5277,95,408061,77.31356574460023,7
0.2,5278,25,408086,77.30365599545368,8
0.2,5279,93,408179,77.3066287878788,8
0.2,5280,93,408272,77.30960045445939,8
0.2,5281,95,408367,77.31294964028777,6
0.2,5282,96,408463,77.31648684459587,6
0.2,5283,91,408554,77.31907645722937,10
0.2,5284,95,408649,77.32242194891201,6
0.2,5285,94,408743,77.32557699583806,7
0.2,5286,-46,408697,77.30225080385853,9
0.2,5287,87,408784,77.30408472012103,14
0.2,5288,94,408878,77.30724144450747,7
0.2,5289,93,408971,77.3102079395085,9
0.2,5290,80,409051,77.31071631071632,24
0.2,5291,93,409144,77.31368102796674,8
0.2,5292,92,409236,77.31645569620254,10
0.2,5293,91,409327,77.31904042312051,10
0.2,5294,91,409418,77.32162417374882,11
0.2,5295,22,409440,77.31117824773413,11
0.2,5296,23,409463,77.30092505191618,9
0.2,5297,25,409488,77.29105322763307,8
0.2,5298,94,409582,77.29420645404794,7
0.2,5299,93,409675,77.29716981132076,8
0.2,5300,95,409770,77.30050933786077,6
0.2,5301,19,409789,77.28951339117314,14
0.2,5302,93,409882,77.29247595700546,8
0.2,5303,95,409977,77.29581447963801,7
0.2,5304,94,410071,77.29896324222432,7
0.2,5305,92,410163,77.3017338861666,10
0.2,5306,95,410258,77.30506877708687,7
0.2,5307,94,410352,77.30821401657875,7
0.2,5308,94,410446,77.31135807119985,7
0.2,5309,96,410542,77.31487758945386,6
0.2,5310,93,410635,77.3178309169648,10
0.2,5311,20,410655,77.3070406626506,12
0.2,5312,22,410677,77.29663090532655,11
0.2,5313,95,410772,77.29996236356793,7
0.2,5314,86,410858,77.30159924741298,15
0.2,5315,94,410952,77.30474040632055,7
0.2,5316,93,411045,77.3076923076923,8
0.2,5317,-57,410988,77.28243700639338,22
0.2,5318,92,411080,77.2852039857116,9
0.2,5319,24,411104,77.27518796992481,8
0.2,5320,23,411127,77.26498778425108,9
0.2,5321,94,411221,77.26813228109734,7
0.2,5322,95,411316,77.27146346045463,7
0.2,5323,95,411411,77.27479338842976,6
0.2,5324,91,411502,77.27737089201878,10
0.2,5325,92,411594,77.28013518588058,9
0.2,5326,92,411686,77.28289844189976,10
0.2,5327,94,411780,77.28603603603604,8
0.2,5328,94,411874,77.28917245261775,9
0.2,5329,92,411966,77.29193245778612,9
0.2,5330,90,412056,77.29431626336522,11
0.2,5331,91,412147,77.29688672168042,10
0.2,5332,92,412239,77.29964372773298,9
0.2,5333,94,412333,77.30277465316836,7
0.2,5334,22,412355,77.29240862230553,11
0.2,5335,94,412449,77.29553973013493,7
0.2,5336,90,412539,77.29792017987633,11
0.2,5337,90,412629,77.30029973772949,12
0.2,5338,96,412725,77.30380221015172,6
0.2,5339,24,412749,77.2938202247191,9
0.2,5340,18,412767,77.28271859202397,15
0.2,5341,91,412858,77.28528640958443,10
0.2,5342,94,412952,77.28841474826876,7
0.2,5343,23,412975,77.27825598802396,9
0.2,5344,91,413066,77.28082319925164,10
0.2,5345,92,413158,77.28357650579873,10
0.2,5346,88,413246,77.28558069945764,13
0.2,5347,94,413340,77.28870605833957,7
0.2,5348,86,413426,77.29033464198916,15
0.2,5349,93,413519,77.29327102803738,8
0.2,5350,95,413614,77.29658007849,6
0.2,5351,94,413708,77.29970104633782,8
0.2,5352,94,413802,77.30282084812255,7
0.2,5353,93,413895,77.30575270825551,8
0.2,5354,-59,413836,77.28029878618113,23
0.2,5355,92,413928,77.28304705003734,9
0.2,5356,95,414023,77.2863543027814,7
0.2,5357,23,414046,77.27622247107129,9
0.2,5358,96,414142,77.27971636499348,6
0.2,5359,19,414161,77.26884328358209,13
0.2,5360,23,414184,77.25872038798731,10
0.2,5361,92,414276,77.26146960089518,10
0.2,5362,95,414371,77.2647771769532,6
0.2,5363,89,414460,77.2669649515287,12
0.2,5364,93,414553,77.26989748369058,8
0.2,5365,94,414647,77.27301528140141,8
0.2,5366,94,414741,77.27613191727222,7
0.2,5367,-50,414691,77.2524217585693,13
0.2,5368,94,414785,77.25554106910039,7
0.2,5369,92,414877,77.25828677839851,9
0.2,5370,91,414968,77.26084528020853,13
0.2,5371,23,414991,77.25074460163812,11
0.2,5372,94,415085,77.25386190210311,9
0.2,5373,94,415179,77.2569780424265,7
0.2,5374,95,415274,77.26027906976744,6
0.2,5375,94,415368,77.26339285714286,7
0.2,5376,93,415461,77.2663195090199,8
0.2,5377,96,415557,77.26980290070658,6
0.2,5378,94,415651,77.27291318088864,7
0.2,5379,91,415742,77.27546468401486,10
0.2,5380,96,415838,77.27894443412005,6
0.2,5381,88,415926,77.2809364548495,13
0.2,5382,93,416019,77.2838565855471,8
0.2,5383,94,416113,77.28696136701338,8
0.2,5384,94,416207,77.29006499535747,7
0.2,5385,24,416231,77.28017081321946,8
0.2,5386,93,416324,77.28308891776499,8
0.2,5387,90,416414,77.28544914625093,11
0.2,5388,94,416508,77.28855075153089,7
0.2,5389,94,416602,77.29165120593692,7
0.2,5390,95,416697,77.29493600445187,7
0.2,5391,95,416792,77.29821958456974,7
0.2,5392,93,416885,77.30113109586502,8
0.2,5393,86,416971,77.30274378939562,15
0.2,5394,94,417065,77.30583873957367,7
0.2,5395,95,417160,77.30911786508524,7
0.2,5396,91,417251,77.31165462293868,10
0.2,5397,26,417277,77.30214894405336,7
0.2,5398,26,417303,77.29264678644194,7
0.2,5399,92,417395,77.29537037037036,9
0.2,5400,25,417420,77.285687835586,8
0.2,5401,88,417508,77.28767123287672,13
0.2,5402,93,417601,77.29057930779197,8
0.2,5403,96,417697,77.2940414507772,6
0.2,5404,94,417791,77.29713228492137,7
0.2,5405,83,417874,77.29818719940806,18
0.2,5406,94,417968,77.30127612354356,7
0.2,5407,90,418058,77.30362426035504,11
0.2,5408,26,418084,77.2941393973008,6
0.2,5409,89,418173,77.29630314232902,12
0.2,5410,88,418261,77.29828127887636,14
0.2,5411,-130,418131,77.259977827051,24
0.2,5412,96,418227,77.26343986698689,6
0.2,5413,91,418318,77.26597709641669,10
0.2,5414,93,418411,77.26888273314866,8
0.2,5415,92,418503,77.27160265878878,9
0.2,5416,91,418594,77.27413697618609,10
0.2,5417,93,418687,77.27703949796972,8
0.2,5418,94,418781,77.28012548440671,7
0.2,5419,24,418805,77.27029520295203,8
0.2,5420,89,418894,77.2724589559122,12
0.2,5421,90,418984,77.27480634452232,12
0.2,5422,90,419074,77.27715286741656,11
0.2,5423,95,419169,77.28042035398231,6
0.2,5424,89,419258,77.28258064516129,12
0.2,5425,93,419351,77.28547733136749,8
0.2,5426,94,419445,77.28855721393035,7
0.2,5427,94,419539,77.29163596168017,7
0.2,5428,22,419561,77.28145146435807,11
0.2,5429,86,419647,77.28305709023941,15
0.2,5430,92,419739,77.28576689375805,9
0.2,5431,92,419831,77.28847569955818,9
0.2,5432,89,419920,77.29063132707527,12
0.2,5433,19,419939,77.27990430622009,13
0.2,5434,87,420026,77.28169273229071,14
0.2,5435,95,420121,77.28495217071377,7
0.2,5436,16,420137,77.27368033842193,16
0.2,5437,96,420233,77.27712394262596,6
0.2,5438,25,420258,77.26751241036955,7
0.2,5439,93,420351,77.2704044117647,9
0.2,5440,24,420375,77.26061385774673,9
0.2,5441,93,420468,77.26350606394708,8
0.2,5442,17,420485,77.2524343193092,15
0.2,5443,90,420575,77.25477590007347,11
0.2,5444,95,420670,77.25803489439853,6
0.2,5445,92,420762,77.26074182886522,9
0.2,5446,94,420856,77.26381494400587,7
0.2,5447,93,420949,77.2667033773862,8
0.2,5448,90,421039,77.26904019086071,11
0.2,5449,91,421130,77.27155963302752,10
0.2,5450,22,421152,77.26141992294991,10
0.2,5451,94,421246,77.26449009537784,7
0.2,5452,95,421341,77.26774252704934,7
0.2,5453,95,421436,77.27099376604328,7
0.2,5454,92,421528,77.27369385884509,9
0.2,5455,96,421624,77.27712609970675,6
0.2,5456,21,421645,77.26681326736302,12
0.2,5457,94,421739,77.26987907658483,7
0.2,5458,84,421823,77.27111192526104,18
0.2,5459,94,421917,77.27417582417583,9
0.2,5460,95,422012,77.27742171763413,6
0.2,5461,96,422108,77.28084950567558,6
0.2,5462,92,422200,77.28354384038074,10
0.2,5463,92,422292,77.28623718887262,9
0.2,5464,94,422386,77.28929551692589,7
0.2,5465,94,422480,77.2923527259422,7
0.2,5466,15,422495,77.28095847814157,17
0.2,5467,95,422590,77.28419897585955,7
0.2,5468,91,422681,77.28670689339916,10
0.2,5469,93,422774,77.28957952468008,8
0.2,5470,92,422866,77.2922683238896,9
0.2,5471,95,422961,77.29550438596492,6
0.2,5472,96,423057,77.2989219806322,6
0.2,5473,22,423079,77.2888198757764,11
0.2,5474,92,423171,77.29150684931507,9
0.2,5475,92,423263,77.29419284149014,9
0.2,5476,94,423357,77.29724301624977,8
0.2,5477,95,423452,77.30047462577583,7
0.2,5478,88,423540,77.30242745026464,13
0.2,5479,93,423633,77.30529197080293,9
0.2,5480,93,423726,77.30815544608647,8
0.2,5481,95,423821,77.31138270704123,8
0.2,5482,95,423916,77.31460879080795,6
0.2,5483,90,424006,77.31692195477754,11
0.2,5484,95,424101,77.32014585232452,6
0.2,5485,93,424194,77.3230040102078,8
0.2,5486,23,424217,77.31310369965372,9
0.2,5487,95,424312,77.31632653061224,6
0.2,5488,94,424406,77.31936600473675,8
0.2,5489,92,424498,77.32204007285975,10
0.2,5490,91,424589,77.32453105081042,10
0.2,5491,86,424675,77.32611070648215,15
0.2,5492,24,424699,77.31640269433825,9
0.2,5493,19,424718,77.30578813250818,14
0.2,5494,94,424812,77.3088262056415,7
0.2,5495,96,424908,77.3122270742358,6
0.2,5496,86,424994,77.31380753138075,15
0.2,5497,95,425089,77.31702437249909,7
0.2,5498,93,425182,77.31987634115293,8
0.2,5499,94,425276,77.32290909090909,8
0.2,5500,94,425370,77.32594073804763,7
0.2,5501,90,425460,77.32824427480917,11
0.2,5502,94,425554,77.33127385062693,7
0.2,5503,88,425642,77.33321220930233,14
0.2,5504,95,425737,77.33642143505904,7
0.2,5505,93,425830,77.33926625499456,10
0.2,5506,91,425921,77.34174686762303,11
0.2,5507,92,426013,77.34440813362382,9
0.2,5508,-136,425877,77.30568161190779,31
0.2,5509,94,425971,77.30871143375681,8
0.2,5510,16,425987,77.29758664489204,16
0.2,5511,93,426080,77.30043541364296,9
0.2,5512,88,426168,77.30237620170506,13
0.2,5513,25,426193,77.29289082335872,8
0.2,5514,96,426289,77.29628286491388,6
0.2,5515,92,426381,77.29894851341552,9
0.2,5516,94,426475,77.30197571143738,8
0.2,5517,91,426566,77.30445813700616,10
0.2,5518,23,426589,77.29461859032433,9
0.2,5519,92,426681,77.29728260869565,9
0.2,5520,95,426776,77.30048904184025,7
0.2,5521,94,426870,77.30351321984789,7
0.2,5522,93,426963,77.30635524171646,9
0.2,5523,22,426985,77.29634322954381,13
0.2,5524,27,427012,77.28723981900453,6
0.2,5525,93,427105,77.29008324285198,8
0.2,5526,92,427197,77.29274470779808,9
0.2,5527,93,427290,77.29558610709117,9
0.2,5528,96,427386,77.29896907216495,6
0.2,5529,85,427471,77.30036166365281,18
0.2,5530,96,427567,77.30374254203579,6
0.2,5531,90,427657,77.30603759942154,12
0.2,5532,90,427747,77.30833182721851,11
0.2,5533,93,427840,77.31116732923743,8
0.2,5534,96,427936,77.31454381210479,6
0.2,5535,89,428025,77.31665462427746,12
0.2,5536,94,428119,77.31966769008488,7
0.2,5537,95,428214,77.3228602383532,6
0.2,5538,86,428300,77.32442679183968,15
0.2,5539,94,428394,77.32743682310469,7
0.2,5540,90,428484,77.32972387655659,11
0.2,5541,92,428576,77.3323709852039,9
0.2,5542,95,428671,77.3355583618979,8
0.2,5543,93,428764,77.33838383838383,9
0.2,5544,-50,428714,77.31541929666366,13
0.2,5545,16,428730,77.30436350522899,16
0.2,5546,91,428821,77.30683252208401,12
0.2,5547,94,428915,77.30984138428262,7
0.2,5548,93,429008,77.31266894936024,11
0.2,5549,94,429102,77.31567567567568,7
0.2,5550,95,429197,77.31886146640245,6
0.2,5551,93,429290,77.32168587896254,8
0.2,5552,92,429382,77.32432919142806,9
0.2,5553,88,429470,77.3262513503781,14
0.2,5554,23,429493,77.31647164716472,9
0.2,5555,94,429587,77.31947444204464,9
0.2,5556,94,429681,77.32247615619939,7
0.2,5557,89,429770,77.32457718603814,14
0.2,5558,19,429789,77.31408526713437,13
0.2,5559,93,429882,77.31690647482014,9
0.2,5560,18,429900,77.30623988491278,14
0.2,5561,94,429994,77.30924128011506,7
0.2,5562,23,430017,77.29947869854395,9
0.2,5563,96,430113,77.3028396836808,6
0.2,5564,95,430208,77.30601976639713,6
0.2,5565,93,430301,77.30883938196192,8
0.2,5566,92,430393,77.31147835458954,9
0.2,5567,17,430410,77.30064655172414,15
0.2,5568,94,430504,77.30364517866762,7
0.2,5569,95,430599,77.30682226211849,7
0.2,5570,95,430694,77.30999820499012,7
0.2,5571,91,430785,77.31245513280689,10
0.2,5572,91,430876,77.31491117889826,10
0.2,5573,92,430968,77.31754574811626,9
0.2,5574,93,431061,77.32035874439462,9
0.2,5575,90,431151,77.32263271162124,12
0.2,5576,94,431245,77.32562309485387,7
0.2,5577,-52,431193,77.3024381498745,15
0.2,5578,95,431288,77.3056103244309,6
0.2,5579,93,431381,77.3084229390681,8
0.2,5580,24,431405,77.29887117004121,8
0.2,5581,94,431499,77.30186313149409,7
0.2,5582,94,431593,77.3048540211356,7
0.2,5583,94,431687,77.30784383954155,7
0.2,5584,93,431780,77.31065353625783,8
0.2,5585,96,431876,77.31399928392409,6
0.2,5586,-50,431826,77.29121174154287,13
0.2,5587,92,431918,77.29384395132426,9
0.2,5588,94,432012,77.29683306494901,7
0.2,5589,94,432106,77.29982110912343,7
0.2,5590,95,432201,77.30298694330173,7
0.2,5591,94,432295,77.30597281831187,7
0.2,5592,93,432388,77.3087788306812,8
0.2,5593,-133,432255,77.27118341079728,28
0.2,5594,89,432344,77.27327971403038,12
0.2,5595,95,432439,77.2764474624732,6
0.2,5596,92,432531,77.27907807754154,9
0.2,5597,94,432625,77.28206502322259,7
0.2,5598,87,432712,77.28380067869263,14
0.2,5599,96,432808,77.28714285714285,7
0.2,5600,94,432902,77.29012676307802,7
0.2,5601,92,432994,77.2927525883613,9
0.2,5602,94,433088,77.29573442798501,7
0.2,5603,19,433107,77.28533190578159,13
0.2,5604,92,433199,77.28795718108832,9
0.2,5605,-51,433148,77.26507313592579,15
0.2,5606,24,433172,77.25557339040485,8
0.2,5607,92,433264,77.25820256776034,9
0.2,5608,94,433358,77.26118737742914,7
0.2,5609,92,433450,77.2638146167558,9
0.2,5610,96,433546,77.26715380502584,6
0.2,5611,18,433564,77.25659301496792,14
0.2,5612,93,433657,77.25939782647426,8
0.2,5613,92,433749,77.26202351264695,9
0.2,5614,95,433844,77.26518254674978,7
0.2,5615,95,433939,77.26834045584046,7
0.2,5616,27,433966,77.25939113405732,6
0.2,5617,96,434062,77.2627269490922,6
0.2,5618,90,434152,77.26499377113366,11
0.2,5619,96,434248,77.26832740213523,6
0.2,5620,94,434342,77.27130403842733,7
0.2,5621,92,434434,77.27392387050871,9
0.2,5622,94,434528,77.27689845278321,7
0.2,5623,94,434622,77.2798719772404,7
0.2,5624,94,434716,77.28284444444445,7
0.2,5625,90,434806,77.28510487024529,13
0.2,5626,90,434896,77.28736449262485,11
0.2,5627,94,434990,77.29033404406539,7
0.2,5628,95,435085,77.29348019186357,6
0.2,5629,19,435104,77.28312611012433,13
0.2,5630,95,435199,77.28627242052922,6
0.2,5631,94,435293,77.28924005681819,9
0.2,5632,94,435387,77.29220663944612,8
0.2,5633,90,435477,77.29446219382322,11
0.2,5634,94,435571,77.29742679680568,8
0.2,5635,88,435659,77.29932576295245,14
0.2,5636,91,435750,77.30175625332623,10
0.2,5637,95,435845,77.30489535296205,7
0.2,5638,94,435939,77.30785600283738,7
0.2,5639,92,436031,77.3104609929078,9
0.2,5640,93,436124,77.3132423329197,9
0.2,5641,92,436216,77.31584544487771,9
0.2,5642,93,436309,77.31862484494063,8
0.2,5643,89,436398,77.32069454287739,12
0.2,5644,92,436490,77.32329495128432,9
0.2,5645,92,436582,77.32589443854056,9
0.2,5646,95,436677,77.32902426066939,6
0.2,5647,94,436771,77.33197592067988,7
0.2,5648,94,436865,77.33492653567004,7
0.2,5649,88,436953,77.33681415929203,13
0.2,5650,16,436969,77.3259600070784,16
0.2,5651,93,437062,77.32873319179052,8
0.2,5652,93,437155,77.3315053953653,8
0.2,5653,92,437247,77.33409975238769,9
0.2,5654,87,437334,77.33580901856764,15
0.2,5655,91,437425,77.33822489391797,10
0.2,5656,85,437510,77.33957928230511,16
0.2,5657,95,437605,77.34270060091906,6
0.2,5658,95,437700,77.34582081639866,6
0.2,5659,92,437792,77.34840989399294,9
0.2,5660,92,437884,77.35099805688041,9
0.2,5661,24,437908,77.34157541504769,8
0.2,5662,27,437935,77.33268585555359,6
0.2,5663,89,438024,77.33474576271186,12
0.2,5664,86,438110,77.33627537511033,15
0.2,5665,95,438205,77.33939286974939,6
0.2,5666,94,438299,77.34233280395271,8
0.2,5667,-50,438249,77.31986591390262,14
0.2,5668,21,438270,77.30993120479802,11
0.2,5669,92,438362,77.31252204585537,11
0.2,5670,96,438458,77.31581731616998,6
0.2,5671,15,438473,77.30483074753174,17
0.2,5672,95,438568,77.30794993830425,7
0.2,5673,88,438656,77.3098343320409,13
0.2,5674,94,438750,77.31277533039648,8
0.2,5675,94,438844,77.31571529245947,7
0.2,5676,19,438863,77.3054430156773,13
0.2,5677,94,438957,77.30838323353294,7
0.2,5678,95,439052,77.31149850325761,6
0.2,5679,-52,439000,77.28873239436619,15
0.2,5680,93,439093,77.2914979757085,10
0.2,5681,90,439183,77.29373460049278,11
0.2,5682,22,439205,77.28400492697519,10
0.2,5683,87,439292,77.28571428571429,14
0.2,5684,95,439387,77.28883025505716,7
0.2,5685,93,439480,77.29159338726697,9
0.2,5686,93,439573,77.29435554774047,8
0.2,5687,88,439661,77.29623769338959,13
0.2,5688,88,439749,77.29811917735982,13
0.2,5689,90,439839,77.30035149384885,11
0.2,5690,89,439928,77.30240730978738,13
0.2,5691,92,440020,77.30498945888966,9
0.2,5692,93,440113,77.30774635517302,8
0.2,5693,91,440204,77.31015103617844,10
0.2,5694,93,440297,77.31290605794557,8
0.2,5695,17,440314,77.30231741573034,18
0.2,5696,23,440337,77.29278567667193,10
0.2,5697,92,440429,77.29536679536679,9
0.2,5698,94,440523,77.29829794700825,7
0.2,5699,92,440615,77.30087719298245,9
0.2,5700,94,440709,77.30380634976319,8
0.2,5701,95,440804,77.30690985619081,7
0.2,5702,93,440897,77.3096615816237,8
0.2,5703,93,440990,77.31241234221599,8
0.2,5704,88,441078,77.31428571428572,15
0.2,5705,94,441172,77.31720995443393,7
0.2,5706,95,441267,77.32030839320133,6
0.2,5707,90,441357,77.32252978276104,11
0.2,5708,92,441449,77.32510071816431,9
0.2,5709,92,441541,77.3276707530648,9
0.2,5710,91,441632,77.33006478725267,10
0.2,5711,96,441728,77.33333333333333,6
0.2,5712,21,441749,77.32347278137581,11
0.2,5713,92,441841,77.32604130206511,11
0.2,5714,93,441934,77.32878390201225,9
0.2,5715,92,442026,77.33135059482156,9
0.2,5716,96,442122,77.33461605737274,8
0.2,5717,91,442213,77.33700594613501,13
0.2,5718,93,442306,77.33974471061374,8
0.2,5719,94,442400,77.34265734265735,7
0.2,5720,93,442493,77.34539416185982,8
0.2,5721,89,442582,77.34743096819294,13
0.2,5722,90,442672,77.3496417962607,11
0.2,5723,17,442689,77.33909853249476,16
0.2,5724,95,442784,77.34218340611353,6
0.2,5725,27,442811,77.33339154732798,6
0.2,5726,91,442902,77.33577789418544,10
0.2,5727,92,442994,77.33833798882682,9
0.2,5728,95,443089,77.34142084133357,6
0.2,5729,91,443180,77.34380453752182,11
0.2,5730,93,443273,77.34653638108533,8
0.2,5731,93,443366,77.34926727145847,8
0.2,5732,95,443461,77.35234606663178,6
0.2,5733,94,443555,77.35524938960586,7
0.2,5734,93,443648,77.35797733217088,9
0.2,5735,93,443741,77.36070432357043,9
0.2,5736,24,443765,77.35140317238975,11
0.2,5737,92,443857,77.35395608225862,9
0.2,5738,92,443949,77.35650810245687,9
0.2,5739,92,444041,77.35905923344947,10
0.2,5740,20,444061,77.34906810660164,14
0.2,5741,22,444083,77.33942877046326,10
0.2,5742,93,444176,77.34215566776946,10
0.2,5743,94,444270,77.34505571030641,7
0.2,5744,93,444363,77.34778067885118,8
0.2,5745,96,444459,77.35102680125304,6
0.2,5746,19,444478,77.34087349921698,13
0.2,5747,27,444505,77.3321155184412,6
0.2,5748,94,444599,77.33501478518004,7
0.2,5749,93,444692,77.33773913043478,9
0.2,5750,94,444786,77.34063641105895,7
0.2,5751,92,444878,77.34318497913769,9
0.2,5752,93,444971,77.34590648357378,8
0.2,5753,93,445064,77.3486270420577,8
0.2,5754,90,445154,77.35082536924413,11
0.2,5755,24,445178,77.34155663655316,8
0.2,5756,21,445199,77.33177001910717,11
0.2,5757,95,445294,77.33483848558527,6
0.2,5758,95,445389,77.33790588643862,6
0.2,5759,94,445483,77.34079861111111,7
0.2,5760,96,445579,77.34403749349072,6
0.2,5761,24,445603,77.33477959042,8
0.2,5762,93,445696,77.3374978309908,8
0.2,5763,93,445789,77.34021512838306,8
0.2,5764,88,445877,77.34206418039896,13
0.2,5765,90,445967,77.34425945195976,12
0.2,5766,27,445994,77.33552973816542,6
0.2,5767,95,446089,77.3385922330097,7
0.2,5768,94,446183,77.3414803258797,8
0.2,5769,94,446277,77.34436741767765,7
0.2,5770,90,446367,77.34656038814764,12
0.2,5771,23,446390,77.33714483714483,9
0.2,5772,95,446485,77.34020439979214,7
0.2,5773,93,446578,77.34291652234153,9
0.2,5774,88,446666,77.34476190476191,13
0.2,5775,18,446684,77.33448753462604,14
0.2,5776,13,446697,77.32335122035659,21
0.2,5777,25,446722,77.31429560401523,8
0.2,5778,93,446815,77.31700986329815,8
0.2,5779,95,446910,77.32006920415225,6
0.2,5780,93,447003,77.3227815256876,8
0.2,5781,87,447090,77.32445520581113,14
0.2,5782,96,447186,77.32768459277192,6
0.2,5783,23,447209,77.3182918395574,9
0.2,5784,91,447300,77.32065687121867,10
0.2,5785,95,447395,77.32371240926373,7
0.2,5786,95,447490,77.32676689130811,6
0.2,5787,94,447584,77.32964754664823,8
0.2,5788,92,447676,77.33218172395924,9
0.2,5789,17,447693,77.3217616580311,15
0.2,5790,92,447785,77.32429632187878,9
0.2,5791,93,447878,77.32700276243094,9
0.2,5792,88,447966,77.32884515794925,13
0.2,5793,95,448061,77.33189506385916,7
0.2,5794,95,448156,77.33494391716998,6
0.2,5795,94,448250,77.33781918564527,8
0.2,5796,95,448345,77.34086596515439,7
0.2,5797,20,448365,77.3309761986892,12
0.2,5798,95,448460,77.33402310743232,7
0.2,5799,92,448552,77.33655172413793,10
0.2,5800,93,448645,77.33925185312877,8
0.2,5801,94,448739,77.34212340572216,7
0.2,5802,94,448833,77.34499396863691,7
0.2,5803,92,448925,77.34751895244659,9
0.2,5804,89,449014,77.34952627045651,12
0.2,5805,91,449105,77.35187736823976,12
0.2,5806,94,449199,77.35474427415188,7
0.2,5807,92,449291,77.35726584022039,9
0.2,5808,94,449385,77.36013083146841,7
0.2,5809,85,449470,77.36144578313252,16
0.2,5810,22,449492,77.35191877473757,10
0.2,5811,94,449586,77.35478320715761,7
0.2,5812,25,449611,77.34577670738001,7
0.2,5813,93,449704,77.3484692122463,8
0.2,5814,95,449799,77.35150472914876,8
0.2,5815,92,449891,77.35402338376892,9
0.2,5816,23,449914,77.34467938800069,9
0.2,5817,83,449997,77.34565142660708,18
0.2,5818,89,450086,77.34765423612305,12
0.2,5819,93,450179,77.35034364261169,8
0.2,5820,94,450273,77.35320391685278,8
0.2,5821,95,450368,77.35623497080041,6
0.2,5822,93,450461,77.35892151811781,8
0.2,5823,21,450482,77.34924450549451,11
0.2,5824,94,450576,77.35210300429185,7
0.2,5825,93,450669,77.35478887744593,9
0.2,5826,91,450760,77.35713059893598,10
0.2,5827,91,450851,77.35947151681538,11
0.2,5828,94,450945,77.3623262995368,7
0.2,5829,94,451039,77.36518010291596,7
0.2,5830,22,451061,77.35568513119533,10
0.2,5831,89,451150,77.3576817558299,12
0.2,5832,-48,451102,77.33619063946512,11
0.2,5833,94,451196,77.33904696606102,7
0.2,5834,91,451287,77.3413881748072,10
0.2,5835,93,451380,77.3440712816998,8
0.2,5836,96,451476,77.34726743189995,6
0.2,5837,94,451570,77.35011990407673,7
0.2,5838,17,451587,77.33978420962494,15
0.2,5839,15,451602,77.3291095890411,17
0.2,5840,94,451696,77.33196370484507,7
0.2,5841,92,451788,77.33447449503595,10
0.2,5842,95,451883,77.337497860688,7
0.2,5843,95,451978,77.34052019164956,8
0.2,5844,95,452073,77.34354148845166,7
0.2,5845,94,452167,77.34639069449196,8
0.2,5846,94,452261,77.34923892594493,8
0.2,5847,92,452353,77.35174418604652,9
0.2,5848,20,452373,77.34193879295606,12
0.2,5849,18,452391,77.33179487179487,14
0.2,5850,18,452409,77.3216544180482,14
0.2,5851,21,452430,77.31203007518798,12
0.2,5852,85,452515,77.31334358448659,16
0.2,5853,24,452539,77.30423641954219,9
0.2,5854,88,452627,77.30606319385141,14
0.2,5855,91,452718,77.30840163934427,12
0.2,5856,93,452811,77.31108075806728,8
0.2,5857,95,452906,77.3141003755548,7
0.2,5858,94,453000,77.31694828469023,7
0.2,5859,96,453096,77.32013651877133,6
0.2,5860,90,453186,77.32229994881419,11
0.2,5861,94,453280,77.3251450017059,7
0.2,5862,93,453373,77.32781852294048,8
0.2,5863,94,453467,77.3306616643929,7
0.2,5864,25,453492,77.32173913043478,8
0.2,5865,95,453587,77.32475281281964,7
0.2,5866,88,453675,77.32657235384353,13
0.2,5867,92,453767,77.32907293796865,9
0.2,5868,-46,453721,77.30805929459873,10
0.2,5869,94,453815,77.31090289608177,7
0.2,5870,25,453840,77.30199284619316,8
0.2,5871,24,453864,77.29291553133515,9
0.2,5872,94,453958,77.29576025881151,7
0.2,5873,88,454046,77.29758256724548,13
0.2,5874,91,454137,77.29991489361701,10
0.2,5875,92,454229,77.30241660993873,9
0.2,5876,93,454322,77.30508762974307,8
0.2,5877,90,454412,77.30724736304866,11
0.2,5878,94,454506,77.31008674944718,7
0.2,5879,93,454599,77.31275510204081,8
0.2,5880,94,454693,77.31559258629484,7
0.2,5881,93,454786,77.31825909554573,10
0.2,5882,91,454877,77.32058473567908,10
0.2,5883,16,454893,77.3101631543168,16
0.2,5884,-46,454847,77.28920985556499,10
0.2,5885,95,454942,77.29221882432891,7
0.2,5886,87,455029,77.29386784440293,14
0.2,5887,87,455116,77.29551630434783,14
0.2,5888,94,455210,77.29835286126676,7
0.2,5889,87,455297,77.3,14
0.2,5890,90,455387,77.30215583092854,11
0.2,5891,-49,455338,77.28071961982349,14
0.2,5892,89,455427,77.28270829798066,12
0.2,5893,92,455519,77.28520529351883,9
0.2,5894,23,455542,77.27599660729432,9
0.2,5895,23,455565,77.26679104477611,9
0.2,5896,94,455659,77.26962862472443,7
0.2,5897,95,455754,77.27263479145473,6
0.2,5898,95,455849,77.2756399389727,6
0.2,5899,91,455940,77.27796610169491,10
0.2,5900,94,456034,77.28079986442975,7
0.2,5901,93,456127,77.28346323280245,8
0.2,5902,17,456144,77.27325088937829,15
0.2,5903,95,456239,77.27625338753387,7
0.2,5904,92,456331,77.2787468247248,9
0.2,5905,93,456424,77.28140873687775,10
0.2,5906,91,456515,77.28373116641274,10
0.2,5907,94,456609,77.2865605958023,7
0.2,5908,86,456695,77.28803520054154,16
0.2,5909,93,456788,77.29069373942471,10
0.2,5910,93,456881,77.29335137878532,8
0.2,5911,88,456969,77.29516238159675,13
0.2,5912,94,457063,77.2979874852021,8
0.2,5913,96,457159,77.30114981400068,6
0.2,5914,90,457249,77.30329670329671,11
0.2,5915,86,457335,77.30476673427992,15
0.2,5916,18,457353,77.29474395808687,14
0.2,5917,91,457444,77.29705981750591,10
0.2,5918,87,457531,77.29869910457847,14
0.2,5919,27,457558,77.2902027027027,6
0.2,5920,93,457651,77.29285593649722,8
0.2,5921,95,457746,77.29584599797366,6
0.2,5922,90,457836,77.29799088299848,11
0.2,5923,90,457926,77.30013504388927,11
0.2,5924,92,458018,77.30261603375527,9
0.2,5925,91,458109,77.30492743840702,10
0.2,5926,92,458201,77.30740678252067,9
0.2,5927,94,458295,77.31022267206478,8
0.2,5928,93,458388,77.31286894923258,8
0.2,5929,94,458482,77.31568296795953,7
0.2,5930,95,458577,77.31866464339909,6
0.2,5931,24,458601,77.30967633175995,8
0.2,5932,92,458693,77.31215236811057,9
0.2,5933,24,458717,77.30316818335018,9
0.2,5934,93,458810,77.30581297388375,10
0.2,5935,90,458900,77.30795148247978,11
0.2,5936,92,458992,77.31042614114872,9
0.2,5937,87,459079,77.31205793196362,14
0.2,5938,95,459174,77.3150362013807,8
0.2,5939,95,459269,77.31801346801346,6
0.2,5940,11,459280,77.3068506985356,25
0.2,5941,92,459372,77.30932346011444,9
0.2,5942,95,459467,77.3123001850917,6
0.2,5943,94,459561,77.31510767160161,7
0.2,5944,95,459656,77.31808242220353,6
0.2,5945,94,459750,77.32088799192735,7
0.2,5946,93,459843,77.32352446611738,8
0.2,5947,18,459861,77.3135507733692,15
0.2,5948,95,459956,77.31652378551017,6
0.2,5949,92,460048,77.31899159663865,9
0.2,5950,94,460142,77.32179465636028,7
0.2,5951,95,460237,77.32476478494624,6
0.2,5952,93,460330,77.32739795061313,8
0.2,5953,-52,460278,77.3056768558952,15
0.2,5954,91,460369,77.30797649034425,10
0.2,5955,96,460465,77.31111484217595,6
0.2,5956,25,460490,77.30233338928991,8
0.2,5957,92,460582,77.30480026854649,9
0.2,5958,96,460678,77.30793757341836,6
0.2,5959,93,460771,77.31057046979866,8
0.2,5960,95,460866,77.31353799698037,6
0.2,5961,95,460961,77.31650452868165,6
0.2,5962,93,461054,77.31913466375985,8
0.2,5963,90,461144,77.32126089872568,11
0.2,5964,94,461238,77.32405699916178,8
0.2,5965,94,461332,77.32685216225276,7
0.2,5966,94,461426,77.32964638846991,7
0.2,5967,93,461519,77.33227211796246,8
0.2,5968,90,461609,77.3343943709164,12
0.2,5969,95,461704,77.33735343383584,6
0.2,5970,94,461798,77.3401440294758,7
0.2,5971,93,461891,77.34276624246483,9
0.2,5972,93,461984,77.34538757743178,8
0.2,5973,92,462076,77.3478406427854,9
0.2,5974,87,462163,77.3494560669456,14
0.2,5975,24,462187,77.34052878179384,11
0.2,5976,95,462282,77.3434833528526,7
0.2,5977,18,462300,77.33355637336902,15
0.2,5978,92,462392,77.33600936611474,9
0.2,5979,93,462485,77.3386287625418,9
0.2,5980,93,462578,77.34124728306303,8
0.2,5981,85,462663,77.34252758274825,16
0.2,5982,94,462757,77.34531171653016,7
0.2,5983,92,462849,77.34776069518716,9
0.2,5984,94,462943,77.35054302422724,7
0.2,5985,90,463033,77.35265619779486,11
0.2,5986,94,463127,77.35543677968933,7
0.2,5987,90,463217,77.35754843019372,11
0.2,5988,95,463312,77.36049423943898,6
0.2,5989,93,463405,77.36310517529215,12
0.2,5990,95,463500,77.36604907361041,6
0.2,5991,93,463593,77.36865821094793,8
0.2,5992,91,463684,77.3709327548807,11
0.2,5993,92,463776,77.37337337337337,9
0.2,5994,94,463870,77.37614678899082,7
0.2,5995,95,463965,77.37908605737158,7
0.2,5996,93,464058,77.38169084542271,8
0.2,5997,96,464154,77.38479493164388,7
0.2,5998,94,464248,77.38756459409902,7
0.2,5999,21,464269,77.37816666666667,11
0.2,6000,90,464359,77.38026995500749,11
0.2,6001,92,464451,77.38270576474508,9
0.2,6002,25,464476,77.37397967682826,8
0.2,6003,88,464564,77.37574950033311,13
0.2,6004,94,464658,77.37851790174854,7
0.2,6005,26,464684,77.36996336996337,7
0.2,6006,94,464778,77.37273181288496,7
0.2,6007,25,464803,77.36401464713715,8
0.2,6008,85,464888,77.36528540522549,16
0.2,6009,94,464982,77.36805324459235,8
0.2,6010,93,465075,77.37065380136417,9
0.2,6011,18,465093,77.36077844311377,15
0.2,6012,94,465187,77.36354565108931,7
0.2,6013,95,465282,77.36647821749251,6
0.2,6014,92,465374,77.3689110556941,10
0.2,6015,91,465465,77.37117686170212,10
0.2,6016,94,465559,77.37394050191125,7
0.2,6017,93,465652,77.37653705550017,9
0.2,6018,94,465746,77.37929888685828,7
0.2,6019,89,465835,77.3812292358804,12
0.2,6020,92,465927,77.3836571998007,9
0.2,6021,92,466019,77.38608435735637,9
0.2,6022,95,466114,77.38900879960153,7
0.2,6023,96,466210,77.39209827357237,6
0.2,6024,21,466231,77.38273858921161,11
0.2,6025,91,466322,77.38499834052439,11
0.2,6026,96,466418,77.3880869420939,7
0.2,6027,86,466504,77.38951559389515,15
0.2,6028,94,466598,77.39227069165699,7
0.2,6029,94,466692,77.39502487562189,7
0.2,6030,-62,466630,77.37191178908971,25
0.2,6031,94,466724,77.37466843501326,7
0.2,6032,90,466814,77.3767611470247,11
0.2,6033,96,466910,77.37984753065959,6
0.2,6034,23,466933,77.37083678541839,9
0.2,6035,92,467025,77.37326043737575,9
0.2,6036,27,467052,77.36491634918005,6
0.2,6037,94,467146,77.36767141437562,7
0.2,6038,-48,467098,77.34691174035436,11
0.2,6039,92,467190,77.34933774834437,9
0.2,6040,93,467283,77.35192848866082,8
0.2,6041,92,467375,77.3543528632903,9
0.2,6042,95,467470,77.35727287770975,6
0.2,6043,93,467563,77.35986101919259,8
0.2,6044,89,467652,77.36178660049627,13
0.2,6045,-48,467604,77.34105193516375,11
0.2,6046,93,467697,77.34364147511162,8
0.2,6047,93,467790,77.34623015873017,8
0.2,6048,93,467883,77.34881798644405,10
0.2,6049,23,467906,77.3398347107438,9
0.2,6050,95,468001,77.34275326392331,7
0.2,6051,96,468097,77.34583608724388,6
0.2,6052,95,468192,77.3487526846192,7
0.2,6053,91,468283,77.35100759828212,10
0.2,6054,-52,468231,77.32964492155243,15
0.2,6055,94,468325,77.33239762219287,7
0.2,6056,93,468418,77.33498431566782,9
0.2,6057,91,468509,77.33724001320567,10
0.2,6058,26,468535,77.32876712328768,6
0.2,6059,89,468624,77.33069306930693,13
0.2,6060,25,468649,77.3220590661607,8
0.2,6061,94,468743,77.32481029363247,7
0.2,6062,25,468768,77.316180108857,7
0.2,6063,15,468783,77.3059036939314,17
0.2,6064,96,468879,77.30898598516076,6
0.2,6065,93,468972,77.31157270029674,8
0.2,6066,94,469066,77.31432338882479,9
0.2,6067,93,469159,77.31690837178643,10
0.2,6068,86,469245,77.31833910034602,15
0.2,6069,94,469339,77.32108731466228,7
0.2,6070,95,469434,77.32399934112996,7
0.2,6071,94,469528,77.32674571805006,8
0.2,6072,91,469619,77.32899720072452,11
0.2,6073,91,469710,77.33124794204808,10
0.2,6074,17,469727,77.32131687242799,15
0.2,6075,94,469821,77.32406188281765,7
0.2,6076,93,469914,77.32664143491854,8
0.2,6077,88,470002,77.32839749917736,13
0.2,6078,93,470095,77.3309754893897,8
0.2,6079,78,470173,77.33108552631579,23
0.2,6080,95,470268,77.3339911198816,6
0.2,6081,20,470288,77.32456428806314,12
0.2,6082,93,470381,77.32714121321716,8
0.2,6083,94,470475,77.32988165680473,8
0.2,6084,91,470566,77.33212818405916,10
0.2,6085,91,470657,77.3343739730529,10
0.2,6086,21,470678,77.32511910629209,13
0.2,6087,92,470770,77.32752956636006,11
0.2,6088,94,470864,77.33026769584497,7
0.2,6089,93,470957,77.33284072249589,10
0.2,6090,91,471048,77.33508455097684,11
0.2,6091,23,471071,77.32616546290217,10
0.2,6092,91,471162,77.32840965041851,10
0.2,6093,91,471253,77.33065310141123,10
0.2,6094,92,471345,77.33305988515177,9
0.2,6095,91,471436,77.33530183727034,10
0.2,6096,88,471524,77.3370510086928,13
0.2,6097,92,471616,77.33945555919973,9
0.2,6098,96,471712,77.34251516642072,6
0.2,6099,93,471805,77.34508196721312,8
0.2,6100,93,471898,77.34764792656941,8
0.2,6101,91,471989,77.3498852835136,10
0.2,6102,91,472080,77.35212190725872,10
0.2,6103,-47,472033,77.331749672346,11
0.2,6104,96,472129,77.33480753480754,6
0.2,6105,95,472224,77.33770062233869,7
0.2,6106,95,472319,77.3405927624038,8
0.2,6107,91,472410,77.34282907662083,10
0.2,6108,21,472431,77.3336061548535,11
0.2,6109,25,472456,77.32504091653028,8
0.2,6110,91,472547,77.32727867779414,11
0.2,6111,94,472641,77.33000654450262,7
0.2,6112,92,472733,77.33240634712907,9
0.2,6113,87,472820,77.3339875695126,14
0.2,6114,86,472906,77.33540474243664,15
0.2,6115,22,472928,77.32635709614127,11
0.2,6116,23,472951,77.31747588687266,9
0.2,6117,24,472975,77.30876103301732,8
0.2,6118,90,473065,77.31083510377513,12
0.2,6119,94,473159,77.31356209150327,8
0.2,6120,88,473247,77.3153079562163,13
0.2,6121,94,473341,77.31803332244364,7
0.2,6122,23,473364,77.30916217540421,9
0.2,6123,93,473457,77.31172436316133,8
0.2,6124,94,473551,77.31444897959183,8
0.2,6125,92,473643,77.31684622918708,11
0.2,6126,95,473738,77.31973233229965,6
0.2,6127,93,473831,77.3222911227154,8
0.2,6128,95,473926,77.32517539565998,7
0.2,6129,-55,473871,77.30358890701469,19
0.2,6130,94,473965,77.30631218398304,7
0.2,6131,94,474059,77.3090345727332,7
0.2,6132,95,474154,77.31191912603946,7
0.2,6133,94,474248,77.31463971307467,7
0.2,6134,23,474271,77.30578647106765,9
0.2,6135,85,474356,77.3070404172099,16
0.2,6136,94,474450,77.30976046928467,7
0.2,6137,95,474545,77.31264255457803,8
0.2,6138,94,474639,77.31536080794918,7
0.2,6139,95,474734,77.31824104234528,8
0.2,6140,94,474828,77.3209574987787,7
0.2,6141,92,474920,77.32334744382938,9
0.2,6142,95,475015,77.32622497151229,6
0.2,6143,94,475109,77.32893880208333,7
0.2,6144,94,475203,77.33165174938975,7
0.2,6145,96,475299,77.33468922876668,6
0.2,6146,92,475391,77.33707499593298,9
0.2,6147,94,475485,77.33978529603122,7
0.2,6148,90,475575,77.34184420230932,11
0.2,6149,89,475664,77.34373983739837,12
0.2,6150,93,475757,77.34628515688506,8
0.2,6151,88,475845,77.34801690507152,14
0.2,6152,95,475940,77.35088574679018,6
0.2,6153,22,475962,77.34189145271368,11
0.2,6154,23,475985,77.33306255077173,9
0.2,6155,95,476080,77.33593242365173,6
0.2,6156,94,476174,77.33863894753938,8
0.2,6157,93,476267,77.34118220201364,8
0.2,6158,93,476360,77.34372463062185,8
0.2,6159,95,476455,77.3465909090909,6
0.2,6160,96,476551,77.34961856841421,6
0.2,6161,83,476634,77.35053554040896,18
0.2,6162,89,476723,77.35242576667207,12
0.2,6163,95,476818,77.35528877352368,6
0.2,6164,93,476911,77.35782643957826,8
0.2,6165,91,477002,77.36003892312682,10
0.2,6166,94,477096,77.36273714934327,7
0.2,6167,92,477188,77.3651102464332,9
0.2,6168,94,477282,77.36780677581456,7
0.2,6169,94,477376,77.37050243111831,7
0.2,6170,26,477402,77.36217792902285,7
0.2,6171,19,477421,77.35272197018794,13
0.2,6172,95,477516,77.35558075490037,6
0.2,6173,94,477610,77.35827664399093,9
0.2,6174,92,477702,77.36064777327935,9
0.2,6175,93,477795,77.36318005181347,10
0.2,6176,-56,477739,77.34158976849604,20
0.2,6177,94,477833,77.34428617675623,7
0.2,6178,21,477854,77.33516750283218,11
0.2,6179,94,477948,77.3378640776699,8
0.2,6180,94,478042,77.34055977997087,7
0.2,6181,88,478130,77.3422840504691,13
0.2,6182,92,478222,77.34465469836648,11
0.2,6183,95,478317,77.34750970245796,7
0.2,6184,21,478338,77.33839935327406,11
0.2,6185,88,478426,77.34012285806661,13
0.2,6186,90,478516,77.3421690641668,12
0.2,6187,94,478610,77.34486102133161,7
0.2,6188,25,478635,77.33640329617063,8
0.2,6189,91,478726,77.33861066235865,10
0.2,6190,92,478818,77.34097884025198,9
0.2,6191,92,478910,77.34334625322997,9
0.2,6192,94,479004,77.34603584692394,7
0.2,6193,92,479096,77.34840167904423,9
0.2,6194,91,479187,77.35060532687652,10
0.2,6195,95,479282,77.35345384118786,7
0.2,6196,92,479374,77.3558173309666,9
0.2,6197,95,479469,77.35866408518876,6
0.2,6198,90,479559,77.36070333924826,11
0.2,6199,93,479652,77.36322580645161,8
0.2,6200,92,479744,77.36558619577488,9
0.2,6201,90,479834,77.36762334730732,11
0.2,6202,96,479930,77.37062711591166,6
0.2,6203,18,479948,77.36105738233398,14
0.2,6204,89,480037,77.36293311845286,12
0.2,6205,88,480125,77.3646471156945,13
0.2,6206,91,480216,77.36684388593524,10
0.2,6207,93,480309,77.36936211340206,9
0.2,6208,93,480402,77.37187952971493,9
0.2,6209,91,480493,77.37407407407407,12
0.2,6210,85,480578,77.37530188375463,17
0.2,6211,94,480672,77.37797810688988,7
0.2,6212,95,480767,77.38081442137454,6
0.2,6213,-48,480719,77.3606372706791,11
0.2,6214,91,480810,77.36283185840708,12
0.2,6215,93,480903,77.36534749034749,8
0.2,6216,94,480997,77.36802316229692,7
0.2,6217,95,481092,77.37085879704085,6
0.2,6218,95,481187,77.37369351985849,6
0.2,6219,21,481208,77.36463022508039,11
0.2,6220,92,481300,77.3669828001929,9
0.2,6221,90,481390,77.36901317904211,11
0.2,6222,-45,481345,77.3493491884943,8
0.2,6223,93,481438,77.35186375321337,11
0.2,6224,23,481461,77.34313253012049,9
0.2,6225,96,481557,77.34612913588178,7
0.2,6226,88,481645,77.34784005138911,14
0.2,6227,92,481737,77.35019267822736,10
0.2,6228,96,481833,77.35318670733665,6
0.2,6229,92,481925,77.35553772070627,9
0.2,6230,92,482017,77.35788797945754,11
0.2,6231,94,482111,77.36055840821567,7
0.2,6232,93,482204,77.36306754371891,8
0.2,6233,-130,482074,77.32980429900546,24
0.2,6234,94,482168,77.33247794707297,7
0.2,6235,93,482261,77.33499037844773,8
0.2,6236,94,482355,77.33766233766234,7
0.2,6237,92,482447,77.34001282462327,9
0.2,6238,93,482540,77.34252284019875,8
0.2,6239,96,482636,77.34551282051282,6
0.2,6240,89,482725,77.34738022752764,12
0.2,6241,90,482815,77.34940724126882,11
0.2,6242,20,482835,77.34022104757328,12
0.2,6243,26,482861,77.33199871877002,7
0.2,6244,95,482956,77.33482786228983,6
0.2,6245,94,483050,77.33749599743837,7
0.2,6246,91,483141,77.33968304786298,10
0.2,6247,96,483237,77.34266965428937,6
0.2,6248,92,483329,77.34501520243239,9
0.2,6249,95,483424,77.34784,6
0.2,6250,88,483512,77.34954407294833,13
0.2,6251,96,483608,77.35252719129879,6
0.2,6252,27,483635,77.34447465216697,6
0.2,6253,93,483728,77.34697793412217,8
0.2,6254,96,483824,77.34996003197442,6
0.2,6255,92,483916,77.35230179028133,9
0.2,6256,85,484001,77.35352405306057,16
0.2,6257,93,484094,77.35602428891019,9
0.2,6258,91,484185,77.3582041859722,10
0.2,6259,27,484212,77.35015974440894,6
0.2,6260,96,484308,77.35313847628174,6
0.2,6261,19,484327,77.34381986585755,15
0.2,6262,94,484421,77.34647932300814,7
0.2,6263,86,484507,77.3478607918263,15
0.2,6264,93,484600,77.35035913806864,8
0.2,6265,95,484695,77.35317586977338,6
0.2,6266,19,484714,77.34386468804851,14
0.2,6267,92,484806,77.34620293554563,9
0.2,6268,90,484896,77.34822140692296,11
0.2,6269,20,484916,77.33907496012759,12
0.2,6270,92,485008,77.34141285281454,9
0.2,6271,92,485100,77.34375,9
0.2,6272,92,485192,77.34608640204048,9
0.2,6273,88,485280,77.34778450749123,14
0.2,6274,89,485369,77.34964143426295,12
0.2,6275,95,485464,77.35245379222435,7
0.2,6276,94,485558,77.35510594232913,7
0.2,6277,95,485653,77.357916533928,7
0.2,6278,95,485748,77.36072623029145,6
0.2,6279,95,485843,77.36353503184714,6
0.2,6280,96,485939,77.36650214933928,6
0.2,6281,91,486030,77.3686723973257,12
0.2,6282,91,486121,77.37084195448034,10
0.2,6283,96,486217,77.37380649267982,7
0.2,6284,95,486312,77.37661097852029,7
0.2,6285,21,486333,77.36764237989182,12
0.2,6286,91,486424,77.36981072053443,10
0.2,6287,91,486515,77.37197837150127,10
0.2,6288,19,486534,77.36269677214183,14
0.2,6289,95,486629,77.36550079491256,7
0.2,6290,24,486653,77.35701796216817,8
0.2,6291,19,486672,77.34774316592498,13
0.2,6292,95,486767,77.35054822819005,7
0.2,6293,14,486781,77.34048299968224,18
0.2,6294,93,486874,77.3429706115965,8
0.2,6295,-51,486823,77.32258576874206,14
0.2,6296,92,486915,77.32491662696522,9
0.2,6297,94,487009,77.32756430612893,7
0.2,6298,92,487101,77.32989363391015,9
0.2,6299,94,487195,77.33253968253969,7
0.2,6300,96,487291,77.33550230122202,6
0.2,6301,22,487313,77.32672167565852,10
0.2,6302,89,487402,77.32857369506584,12
0.2,6303,92,487494,77.33090101522842,9
0.2,6304,-52,487442,77.31038858049168,16
0.2,6305,93,487535,77.31287662543609,8
0.2,6306,-50,487485,77.29269066117013,15
0.2,6307,93,487578,77.29518072289157,8
0.2,6308,93,487671,77.29766999524489,8
0.2,6309,91,487762,77.29984152139461,10
0.2,6310,93,487855,77.30232926636032,8
0.2,6311,91,487946,77.30449936628644,10
0.2,6312,94,488040,77.30714398859496,7
0.2,6313,17,488057,77.2975926512512,15
0.2,6314,24,488081,77.28915281076802,8
0.2,6315,95,488176,77.29195693476885,6
0.2,6316,94,488270,77.2946018679753,7
0.2,6317,-52,488218,77.2741373852485,15
0.2,6318,94,488312,77.2767843013135,7
0.2,6319,88,488400,77.27848101265823,13
0.2,6320,94,488494,77.28112640404999,7
0.2,6321,89,488583,77.28298006959822,12
0.2,6322,-52,488531,77.26253360746482,16
0.2,6323,90,488621,77.2645477545857,12
0.2,6324,94,488715,77.26719367588933,7
0.2,6325,95,488810,77.26999683844451,6
0.2,6326,96,488906,77.27295716769402,6
0.2,6327,93,488999,77.27544247787611,9
0.2,6328,92,489091,77.277768999842,9
0.2,6329,91,489182,77.27993680884676,10
0.2,6330,95,489277,77.28273574474807,6
0.2,6331,86,489363,77.28411244472521,15
0.2,6332,23,489386,77.27554081793778,10
0.2,6333,95,489481,77.27833912219766,6
0.2,6334,91,489572,77.28050513022889,10
0.2,6335,91,489663,77.28267045454545,10
0.2,6336,94,489757,77.28530850560202,7
0.2,6337,95,489852,77.28810350268223,6
0.2,6338,94,489946,77.29073986433191,9
0.2,6339,22,489968,77.2820189274448,10
0.2,6340,23,489991,77.27345844504022,10
0.2,6341,94,490085,77.2760958688111,8
0.2,6342,92,490177,77.27841715276683,9
0.2,6343,93,490270,77.28089533417402,8
0.2,6344,93,490363,77.28337273443657,9
0.2,6345,92,490455,77.28569177434605,10
0.2,6346,93,490548,77.2881676382543,8
0.2,6347,27,490575,77.28024574669188,6
0.2,6348,93,490668,77.28272168845487,8
0.2,6349,94,490762,77.28535433070866,7
0.2,6350,91,490853,77.2875137773579,10
0.2,6351,19,490872,77.27833753148614,15
0.2,6352,90,490962,77.28033999685188,11
0.2,6353,93,491055,77.28281397544853,8
0.2,6354,95,491150,77.28560188827694,6
0.2,6355,92,491242,77.28791692888609,9
0.2,6356,93,491335,77.29038854805727,8
0.2,6357,94,491429,77.2930166719094,7
0.2,6358,89,491518,77.29485768202548,12
0.2,6359,95,491613,77.29764150943396,6
0.2,6360,92,491705,77.29995283760415,9
0.2,6361,21,491726,77.29110342659541,12
0.2,6362,92,491818,77.2934150557913,12
0.2,6363,21,491839,77.2845694531741,11
0.2,6364,95,491934,77.28735271013355,6
0.2,6365,94,492028,77.28997800816839,8
0.2,6366,94,492122,77.29260248154547,7
0.2,6367,93,492215,77.29506909547739,8
0.2,6368,94,492309,77.29769194536034,9
0.2,6369,91,492400,77.29984301412873,10
0.2,6370,94,492494,77.30246429132005,7
0.2,6371,96,492590,77.30539861895794,6
0.2,6372,93,492683,77.30786128981642,9
0.2,6373,96,492779,77.31079385001568,6
0.2,6374,95,492874,77.31356862745098,7
0.2,6375,92,492966,77.31587202007528,9
0.2,6376,92,493058,77.31817469029325,10
0.2,6377,92,493150,77.32047663844466,9
0.2,6378,93,493243,77.32293462925223,8
0.2,6379,95,493338,77.3257053291536,6
0.2,6380,95,493433,77.32847516063313,8
0.2,6381,91,493524,77.33061736132873,10
0.2,6382,92,493616,77.33291555694814,9
0.2,6383,91,493707,77.33505639097744,10
0.2,6384,94,493801,77.33766640563822,7
0.2,6385,95,493896,77.3404321954275,6
0.2,6386,24,493920,77.33208078910286,9
0.2,6387,96,494016,77.33500313087038,6
0.2,6388,91,494107,77.33714196274848,10
0.2,6389,93,494200,77.339593114241,8
0.2,6390,94,494294,77.342199968706,8
0.2,6391,93,494387,77.34464956195244,10
0.2,6392,96,494483,77.34756765211951,6
0.2,6393,95,494578,77.35032843290585,7
0.2,6394,94,494672,77.3529319781079,7
0.2,6395,-121,494551,77.32191994996873,17
0.2,6396,92,494643,77.32421447553541,9
0.2,6397,90,494733,77.32619568615192,11
0.2,6398,95,494828,77.32895764963276,6
0.2,6399,24,494852,77.320625,8
0.2,6400,95,494947,77.32338697078582,8
0.2,6401,88,495035,77.3250546704155,13
0.2,6402,95,495130,77.32781508667811,6
0.2,6403,92,495222,77.33010618363522,9
0.2,6404,-53,495169,77.30975800156128,16
0.2,6405,20,495189,77.3008117389947,12
0.2,6406,94,495283,77.3034181364133,7
0.2,6407,95,495378,77.3061797752809,6
0.2,6408,94,495472,77.30878452176627,7
0.2,6409,23,495495,77.3003120124805,10
0.2,6410,95,495590,77.30307284355015,6
0.2,6411,87,495677,77.30458515283843,18
0.2,6412,94,495771,77.30718852331202,8
0.2,6413,95,495866,77.30994699095729,6
0.2,6414,18,495884,77.30070148090414,16
0.2,6415,87,495971,77.30221321695761,14
0.2,6416,93,496064,77.30465949820788,9
0.2,6417,92,496156,77.30694920535993,9
0.2,6418,93,496249,77.30939398660227,8
0.2,6419,21,496270,77.30062305295951,11
0.2,6420,90,496360,77.3026008409905,11
0.2,6421,92,496452,77.30488944254127,10
0.2,6422,86,496538,77.30624318854117,15
0.2,6423,91,496629,77.30837484433376,10
0.2,6424,21,496650,77.29961089494164,12
0.2,6425,96,496746,77.30252100840336,6
0.2,6426,95,496841,77.30527462268554,7
0.2,6427,95,496936,77.30802738021157,7
0.2,6428,93,497029,77.31046819100949,8
0.2,6429,94,497123,77.31306376360808,7
0.2,6430,92,497215,77.31534753537552,9
0.2,6431,24,497239,77.30705845771145,9
0.2,6432,93,497332,77.30949790144567,8
0.2,6433,95,497427,77.31224743549892,6
0.2,6434,95,497522,77.31499611499612,6
0.2,6435,94,497616,77.31758856432567,9
0.2,6436,96,497712,77.32049091191548,6
0.2,6437,93,497805,77.3229263746505,8
0.2,6438,93,497898,77.32536108091318,8
0.2,6439,93,497991,77.3277950310559,8
0.2,6440,96,498087,77.33069399161622,6
0.2,6441,24,498111,77.32241539894443,8
0.2,6442,93,498204,77.32484867297843,8
0.2,6443,94,498298,77.32743637492241,7
0.2,6444,94,498392,77.3300232738557,7
0.2,6445,89,498481,77.33183369531493,12
0.2,6446,95,498576,77.3345742205677,6
0.2,6447,95,498671,77.33731389578163,6
0.2,6448,90,498761,77.33927740734998,11
0.2,6449,93,498854,77.34170542635658,8
0.2,6450,86,498940,77.343047589521,15
0.2,6451,93,499033,77.34547427154371,8
0.2,6452,19,499052,77.3364326669766,14
0.2,6453,22,499074,77.32785869228385,12
0.2,6454,90,499164,77.32982184353214,11
0.2,6455,92,499256,77.33209417596035,9
0.2,6456,91,499347,77.33421093387022,10
0.2,6457,21,499368,77.32548776711056,12
0.2,6458,94,499462,77.32806936058213,7
0.2,6459,89,499551,77.32987616099071,12
0.2,6460,93,499644,77.33230150131558,8
0.2,6461,91,499735,77.33441658929124,10
0.2,6462,94,499829,77.33699520346589,8
0.2,6463,95,499924,77.33972772277228,6
0.2,6464,24,499948,77.33147718484146,9
0.2,6465,87,500035,77.3329724713888,14
0.2,6466,83,500118,77.33384877068193,19
0.2,6467,95,500213,77.33658008658008,7
0.2,6468,22,500235,77.32802597001083,10
0.2,6469,-52,500183,77.3080370942813,16
0.2,6470,94,500277,77.31061659712564,8
0.2,6471,96,500373,77.3135043263288,6
0.2,6472,94,500467,77.31608218754828,9
0.2,6473,92,500559,77.31835032437442,9
0.2,6474,23,500582,77.30996138996139,10
0.2,6475,96,500678,77.31284743668931,6
0.2,6476,87,500765,77.31434306005868,16
0.2,6477,92,500857,77.31661006483482,9
0.2,6478,92,500949,77.31887636981016,9
0.2,6479,91,501040,77.32098765432099,10
0.2,6480,94,501134,77.32356117883043,7
0.2,6481,25,501159,77.31548904659056,8
0.2,6482,94,501253,77.31806262532778,7
0.2,6483,-47,501206,77.29888957433683,10
0.2,6484,90,501296,77.30084811102545,11
0.2,6485,92,501388,77.30311440024668,9
0.2,6486,95,501483,77.30584245413905,8
0.2,6487,23,501506,77.29747225647348,10
0.2,6488,87,501593,77.2989674834335,14
0.2,6489,90,501683,77.30092449922958,11
0.2,6490,92,501775,77.30318903096595,9
0.2,6491,88,501863,77.30483672211953,13
0.2,6492,21,501884,77.29616510087787,11
0.2,6493,93,501977,77.29858330766862,8
0.2,6494,94,502071,77.30115473441109,7
0.2,6495,18,502089,77.29202586206897,15
0.2,6496,27,502116,77.2842850546406,6
0.2,6497,94,502210,77.28685749461373,7
0.2,6498,95,502305,77.28958301277119,6
0.2,6499,21,502326,77.28092307692307,11
0.2,6500,93,502419,77.28334102445777,8
0.2,6501,25,502444,77.27529990772071,9
0.2,6502,20,502464,77.26649238812855,12
0.2,6503,24,502488,77.25830258302582,9
0.2,6504,92,502580,77.26056879323598,9
0.2,6505,86,502666,77.26191208115586,16
0.2,6506,94,502760,77.26448440141387,7
0.2,6507,88,502848,77.26613398893669,13
0.2,6508,-121,502727,77.23567368259333,16
0.2,6509,95,502822,77.2384024577573,7
0.2,6510,17,502839,77.22915066810013,15
0.2,6511,94,502933,77.23172604422605,7
0.2,6512,94,503027,77.23430062951022,7
0.2,6513,93,503120,77.23672090881179,8
0.2,6514,88,503208,77.23837298541827,13
0.2,6515,92,503300,77.24063842848373,9
0.2,6516,96,503396,77.24351695565444,6
0.2,6517,94,503490,77.24608775698067,8
0.2,6518,95,503585,77.24881116735696,8
0.2,6519,95,503680,77.25153374233129,6
0.2,6520,95,503775,77.25425548228799,8
0.2,6521,18,503793,77.24517019319227,14
0.2,6522,89,503882,77.24697225203127,12
0.2,6523,96,503978,77.2498467198038,6
0.2,6524,94,504072,77.25241379310344,8
0.2,6525,92,504164,77.25467361323935,10
0.2,6526,93,504257,77.25708595066646,8
0.2,6527,92,504349,77.2593443627451,9
0.2,6528,94,504443,77.26190840863838,8
0.2,6529,93,504536,77.26431852986218,8
0.2,6530,89,504625,77.26611544939519,12
0.2,6531,92,504717,77.26837109614208,9
0.2,6532,96,504813,77.27123832848615,6
0.2,6533,23,504836,77.26293235384145,10
0.2,6534,-49,504787,77.24361132364193,12
0.2,6535,88,504875,77.2452570379437,13
0.2,6536,94,504969,77.24782010096375,7
0.2,6537,93,505062,77.25022942795962,8
0.2,6538,94,505156,77.25279094662793,7
0.2,6539,92,505248,77.25504587155963,10
0.2,6540,94,505342,77.25760587066198,7
0.2,6541,92,505434,77.25985937022317,10
0.2,6542,94,505528,77.26241785113862,7
0.2,6543,92,505620,77.26466992665037,9
0.2,6544,94,505714,77.2672268907563,8
0.2,6545,92,505806,77.26947754353804,9
0.2,6546,16,505822,77.26011913853674,16
0.2,6547,94,505916,77.2626756261454,7
0.2,6548,85,506001,77.2638570774164,16
0.2,6549,94,506095,77.26641221374045,7
0.2,6550,93,506188,77.2688139215387,8
0.2,6551,93,506281,77.2712148962149,9
0.2,6552,96,506377,77.27407294368992,7
0.2,6553,84,506461,77.27509917607568,17
0.2,6554,94,506555,77.27765064836004,7
0.2,6555,93,506648,77.28004881025015,8
0.2,6556,21,506669,77.27146560927254,14
0.2,6557,92,506761,77.27371149740775,9
0.2,6558,20,506781,77.26497941759415,13
0.2,6559,95,506876,77.26768292682927,7
0.2,6560,21,506897,77.25910684346898,11
0.2,6561,92,506989,77.2613532459616,9
0.2,6562,-53,506936,77.24150540911168,16
0.2,6563,-46,506890,77.22273004265692,10
0.2,6564,96,506986,77.22559025133283,6
0.2,6565,96,507082,77.22844958879074,6
0.2,6566,93,507175,77.2308512258261,8
0.2,6567,95,507270,77.23355663824604,6
0.2,6568,93,507363,77.23595676663115,8
0.2,6569,25,507388,77.22800608828005,8
0.2,6570,91,507479,77.2301019631715,12
0.2,6571,20,507499,77.22139379184419,12
0.2,6572,-45,507454,77.20279933059486,8
0.2,6573,93,507547,77.20520231213872,8
0.2,6574,94,507641,77.20775665399239,8
0.2,6575,23,507664,77.19951338199513,9
0.2,6576,93,507757,77.20191576706705,8
0.2,6577,95,507852,77.20462146549103,7
0.2,6578,91,507943,77.20671834625323,10
0.2,6579,94,508037,77.20927051671732,8
0.2,6580,92,508129,77.21151800638201,9
0.2,6581,90,508219,77.2134609541173,11
0.2,6582,77,508296,77.21342852802674,24
0.2,6583,95,508391,77.21613001215067,7
0.2,6584,95,508486,77.21883067577828,6
0.2,6585,95,508581,77.22153051928333,6
0.2,6586,94,508675,77.22407772885988,7
0.2,6587,93,508768,77.22647237401335,8
0.2,6588,94,508862,77.2290180604037,8
0.2,6589,92,508954,77.23125948406677,9
0.2,6590,21,508975,77.22272796237293,11
0.2,6591,17,508992,77.2135922330097,17
0.2,6592,95,509087,77.21629000455027,6
0.2,6593,93,509180,77.21868365180467,10
0.2,6594,94,509274,77.22122820318422,7
0.2,6595,93,509367,77.22362037598545,8
0.2,6596,89,509456,77.22540548734273,12
0.2,6597,92,509548,77.22764474083056,9
0.2,6598,26,509574,77.21988180027277,7
0.2,6599,15,509589,77.21045454545454,17
0.2,6600,83,509672,77.21133161642176,20
0.2,6601,94,509766,77.21387458345956,7
0.2,6602,94,509860,77.21641678025141,7
0.2,6603,90,509950,77.2183525136281,11
0.2,6604,94,510044,77.2208932626798,7
0.2,6605,26,510070,77.2131395700878,8
0.2,6606,94,510164,77.21568033903436,7
0.2,6607,95,510259,77.21837167070218,8
0.2,6608,95,510354,77.22106218792555,7
0.2,6609,93,510447,77.22344931921332,8
0.2,6610,94,510541,77.22598699137801,9
0.2,6611,21,510562,77.21748336358137,12
0.2,6612,93,510655,77.21986995312264,8
0.2,6613,94,510749,77.22240701542184,7
0.2,6614,92,510841,77.2246409674981,10
0.2,6615,94,510935,77.22717654171704,7
0.2,6616,-56,510879,77.20704246637449,19
0.2,6617,85,510964,77.20822000604412,16
0.2,6618,94,511058,77.21075691192023,7
0.2,6619,92,511150,77.2129909365559,9
0.2,6620,23,511173,77.20480289986406,10
0.2,6621,94,511267,77.20733917245545,8
0.2,6622,93,511360,77.20972369017062,8
0.2,6623,23,511383,77.20153985507247,9
0.2,6624,94,511477,77.20407547169812,8
0.2,6625,88,511565,77.20570479927558,13
0.2,6626,90,511655,77.20763543081334,11
0.2,6627,94,511749,77.21016898008449,7
0.2,6628,21,511770,77.20168954593453,12
0.2,6629,95,511865,77.20437405731523,6
0.2,6630,95,511960,77.20705775901071,6
0.2,6631,20,511980,77.1984318455971,13
0.2,6632,93,512073,77.20081411126188,8
0.2,6633,93,512166,77.20319565872776,8
0.2,6634,91,512257,77.20527505651846,10
0.2,6635,96,512353,77.20810729355033,6
0.2,6636,23,512376,77.19993973180654,9
0.2,6637,94,512470,77.20247062368183,7
0.2,6638,25,512495,77.19460762162976,9
0.2,6639,22,512517,77.1862951807229,10
0.2,6640,93,512610,77.188676404156,10
0.2,6641,93,512703,77.1910569105691,8
0.2,6642,92,512795,77.1932861658889,9
0.2,6643,95,512890,77.19596628537026,6
0.2,6644,95,512985,77.19864559819413,6
0.2,6645,96,513081,77.20147457117064,6
0.2,6646,24,513105,77.19347073867911,8
0.2,6647,90,513195,77.19539711191335,11
0.2,6648,91,513286,77.19747330425628,10
0.2,6649,93,513379,77.19984962406015,8
0.2,6650,96,513475,77.20267628927981,6
0.2,6651,94,513569,77.20520144317499,8
0.2,6652,16,513585,77.19600180369758,18
0.2,6653,92,513677,77.19822663059814,9
0.2,6654,91,513768,77.20030052592035,11
0.2,6655,92,513860,77.20252403846153,9
0.2,6656,95,513955,77.20519753642782,6
0.2,6657,93,514048,77.20756984079303,10
0.2,6658,94,514142,77.21009160534615,7
0.2,6659,95,514237,77.21276276276276,7
0.2,6660,88,514325,77.21438222489115,13
0.2,6661,94,514419,77.2169018312819,7
0.2,6662,95,514514,77.21957076392016,6
0.2,6663,92,514606,77.2217887154862,9
0.2,6664,-54,514552,77.20210052513129,18
0.2,6665,93,514645,77.2044704470447,8
0.2,6666,96,514741,77.20728963551822,6
0.2,6667,95,514836,77.20995800839832,7
0.2,6668,86,514922,77.21127605338131,16
0.2,6669,19,514941,77.20254872563719,13
0.2,6670,91,515032,77.20461699895068,10
0.2,6671,94,515126,77.20713429256595,8
0.2,6672,95,515221,77.20980068934512,7
0.2,6673,89,515310,77.2115672759964,12
0.2,6674,90,515400,77.21348314606742,11
0.2,6675,93,515493,77.21584781306171,8
0.2,6676,92,515585,77.21806200389396,9
0.2,6677,17,515602,77.20904462413897,16
0.2,6678,96,515698,77.21185806258421,6
0.2,6679,89,515787,77.21362275449101,12
0.2,6680,96,515883,77.21643466546924,6
0.2,6681,91,515974,77.21849745585155,10
0.2,6682,94,516068,77.2210085291037,7
0.2,6683,94,516162,77.22351885098743,7
0.2,6684,96,516258,77.22632759910246,6
0.2,6685,23,516281,77.2182171702064,11
0.2,6686,94,516375,77.22072678331091,8
0.2,6687,96,516471,77.22353468899522,6
0.2,6688,94,516565,77.22604275676484,7
0.2,6689,95,516660,77.2286995515695,6
0.2,6690,21,516681,77.2202959198924,11
0.2,6691,12,516693,77.2105499103407,20
0.2,6692,90,516783,77.21246077991933,11
0.2,6693,90,516873,77.21437107857783,11
0.2,6694,95,516968,77.21702763256161,6
0.2,6695,91,517059,77.21908602150538,10
0.2,6696,91,517150,77.22114379572943,10
0.2,6697,23,517173,77.21304867124515,9
0.2,6698,91,517264,77.21510673234812,10
0.2,6699,93,517357,77.21746268656716,8
0.2,6700,92,517449,77.21966870616326,9
0.2,6701,91,517540,77.22172485825126,10
0.2,6702,96,517636,77.22452633149337,7
0.2,6703,94,517730,77.22702863961814,7
0.2,6704,90,517820,77.22893363161819,13
0.2,6705,91,517911,77.23098717566359,10
0.2,6706,24,517935,77.22305054420754,8
0.2,6707,95,518030,77.22570065593321,6
0.2,6708,94,518124,77.22820092413177,7
0.2,6709,96,518220,77.23099850968704,6
0.2,6710,92,518312,77.23319922515273,9
0.2,6711,92,518404,77.23539928486294,9
0.2,6712,95,518499,77.23804558319678,6
0.2,6713,91,518590,77.24009532320524,10
0.2,6714,93,518683,77.24244229337305,9
0.2,6715,96,518779,77.24523525908279,6
0.2,6716,93,518872,77.24758076522257,8
0.2,6717,90,518962,77.2494790116106,11
0.2,6718,96,519058,77.25226968298854,6
0.2,6719,89,519147,77.25401785714286,12
0.2,6720,95,519242,77.25665823538164,6
0.2,6721,94,519336,77.25914906277893,7
0.2,6722,95,519431,77.26178789230998,7
0.2,6723,15,519446,77.25252825698989,19
0.2,6724,24,519470,77.2446096654275,8
0.2,6725,83,519553,77.24546535831104,18
0.2,6726,19,519572,77.23680689757693,13
0.2,6727,-123,519449,77.2070451843044,18
0.2,6728,22,519471,77.19884083816318,11
0.2,6729,95,519566,77.20148588410105,8
0.2,6730,91,519657,77.20353587876987,10
0.2,6731,92,519749,77.20573380867499,11
0.2,6732,91,519840,77.20778256349324,10
0.2,6733,93,519933,77.21012771012771,9
0.2,6734,-53,519880,77.19079435783222,17
0.2,6735,17,519897,77.18185866983373,16
0.2,6736,95,519992,77.1845034881995,7
0.2,6737,95,520087,77.18714752151973,7
0.2,6738,-52,520035,77.16797744472474,15
0.2,6739,94,520129,77.17047477744808,7
0.2,6740,22,520151,77.16229046135588,10
0.2,6741,94,520245,77.16478789676654,8
0.2,6742,94,520339,77.16728459142814,7
0.2,6743,94,520433,77.16978054567022,8
0.2,6744,91,520524,77.17183098591549,10
0.2,6745,89,520613,77.17358434627927,13
0.2,6746,89,520702,77.17533718689788,12
0.2,6747,95,520797,77.17797866034381,8
0.2,6748,94,520891,77.18047118091569,7
0.2,6749,-56,520835,77.16074074074074,19
0.2,6750,21,520856,77.15242186342763,12
0.2,6751,93,520949,77.15476895734596,8
0.2,6752,92,521041,77.15696727380424,10
0.2,6753,24,521065,77.14909683150725,8
0.2,6754,90,521155,77.15099925980755,11
0.2,6755,23,521178,77.14298401420959,9
0.2,6756,91,521269,77.14503477874797,10
0.2,6757,96,521365,77.14782480023676,6
0.2,6758,26,521391,77.14025743453173,7
0.2,6759,94,521485,77.14275147928994,7
0.2,6760,95,521580,77.14539269338856,6
0.2,6761,25,521605,77.1376811594203,8
0.2,6762,89,521694,77.1394351619104,12
0.2,6763,94,521788,77.14192785334122,7
0.2,6764,94,521882,77.14441980783444,7
0.2,6765,94,521976,77.14691102571682,7
0.2,6766,90,522066,77.1488104034284,11
0.2,6767,-51,522015,77.12987588652483,15
0.2,6768,93,522108,77.13222041660511,8
0.2,6769,90,522198,77.13412112259971,11
0.2,6770,94,522292,77.13661202185793,7
0.2,6771,93,522385,77.13895451860603,8
0.2,6772,19,522404,77.13037058910379,13
0.2,6773,95,522499,77.1330085621494,6
0.2,6774,95,522594,77.13564575645756,6
0.2,6775,20,522614,77.12721369539551,13
0.2,6776,94,522708,77.12970340858787,7
0.2,6777,96,522804,77.13248745942757,6
0.2,6778,94,522898,77.13497566012687,8
0.2,6779,93,522991,77.13731563421828,8
0.2,6780,92,523083,77.13950744727916,10
0.2,6781,95,523178,77.14214096136833,6
0.2,6782,93,523271,77.14447884416924,8
0.2,6783,92,523363,77.14666863207547,9
0.2,6784,92,523455,77.14885777450257,9
0.2,6785,91,523546,77.1508989095196,10
0.2,6786,23,523569,77.1429202887874,9
0.2,6787,95,523664,77.14555097230406,9
0.2,6788,95,523759,77.14818088083665,6
0.2,6789,94,523853,77.15066273932253,7
0.2,6790,25,523878,77.14298336032985,9
0.2,6791,93,523971,77.14531802120142,8
0.2,6792,94,524065,77.14779920506403,7
0.2,6793,96,524161,77.15057403591405,6
0.2,6794,89,524250,77.1523178807947,12
0.2,6795,94,524344,77.1547969393761,7
0.2,6796,88,524432,77.15639252611446,13
0.2,6797,92,524524,77.15857605177993,9
0.2,6798,95,524619,77.16120017649655,6
0.2,6799,92,524711,77.16338235294117,9
0.2,6800,91,524802,77.16541685046317,10
0.2,6801,92,524894,77.16759776536313,9
0.2,6802,95,524989,77.17021902102015,7
0.2,6803,94,525083,77.17269253380364,7
0.2,6804,95,525178,77.17531227038943,6
0.2,6805,27,525205,77.16794005289451,6
0.2,6806,93,525298,77.17026590274718,8
0.2,6807,93,525391,77.1725910693302,8
0.2,6808,93,525484,77.17491555294463,8
0.2,6809,25,525509,77.16725403817915,8
0.2,6810,95,525604,77.16987226545294,6
0.2,6811,23,525627,77.16192014092778,9
0.2,6812,17,525644,77.15308968149127,15
0.2,6813,23,525667,77.1451423539771,9
0.2,6814,93,525760,77.1474688187821,8
0.2,6815,91,525851,77.14950117370893,10
0.2,6816,93,525944,77.15182631656154,8
0.2,6817,91,526035,77.1538574361983,10
0.2,6818,17,526052,77.14503592902184,15
0.2,6819,92,526144,77.14721407624633,9
0.2,6820,96,526240,77.14997800908958,6
0.2,6821,14,526254,77.14072119613017,18
0.2,6822,91,526345,77.14275245493185,10
0.2,6823,96,526441,77.14551582649473,6
0.2,6824,18,526459,77.13684981684982,15
0.2,6825,95,526554,77.1394667447993,7
0.2,6826,91,526645,77.14149699721693,10
0.2,6827,90,526735,77.14338019917984,11
0.2,6828,93,526828,77.14570215258456,8
0.2,6829,92,526920,77.14787701317717,9
0.2,6830,94,527014,77.15034401990924,7
0.2,6831,91,527105,77.15237119437938,10
0.2,6832,24,527129,77.1445924191424,11
0.2,6833,95,527224,77.147205150717,7
0.2,6834,92,527316,77.14937820043892,10
0.2,6835,95,527411,77.15198946752487,6
0.2,6836,20,527431,77.14363024718443,12
0.2,6837,92,527523,77.14580286633519,9
0.2,6838,95,527618,77.14841351074719,6
0.2,6839,96,527714,77.15116959064328,6
0.2,6840,92,527806,77.15334015494811,10
0.2,6841,92,527898,77.15551008477054,9
0.2,6842,93,527991,77.15782551512494,9
0.2,6843,90,528081,77.15970192869666,11
0.2,6844,87,528168,77.16113951789627,14
0.2,6845,89,528257,77.162868828513,12
0.2,6846,94,528351,77.16532788082372,7
0.2,6847,82,528433,77.16603387850468,19
0.2,6848,92,528525,77.1681997371879,9
0.2,6849,-52,528473,77.14934306569343,15
0.2,6850,17,528490,77.14056342139834,19
0.2,6851,88,528578,77.14214827787508,13
0.2,6852,94,528672,77.14460820078797,7
0.2,6853,18,528690,77.13597899037059,14
0.2,6854,22,528712,77.12793581327499,10
0.2,6855,92,528804,77.13010501750291,9
0.2,6856,94,528898,77.13256526177629,7
0.2,6857,94,528992,77.13502478856809,8
0.2,6858,95,529087,77.13762939203966,7
0.2,6859,95,529182,77.1402332361516,7
0.2,6860,94,529276,77.14269056988778,7
0.2,6861,93,529369,77.14500145730108,8
0.2,6862,94,529463,77.14745738015445,7
0.2,6863,16,529479,77.13854895104895,17
0.2,6864,90,529569,77.14042243262928,13
0.2,6865,91,529660,77.14244101369064,11
0.2,6866,93,529753,77.144750254842,8
0.2,6867,94,529847,77.14720442632499,7
0.2,6868,91,529938,77.1492211384481,11
0.2,6869,17,529955,77.14046579330422,15
0.2,6870,23,529978,77.13258623198952,10
0.2,6871,94,530072,77.1350407450524,7
0.2,6872,91,530163,77.13705805325185,10
0.2,6873,89,530252,77.13878382310155,13
0.2,6874,92,530344,77.14094545454546,9
0.2,6875,93,530437,77.14325189063409,8
0.2,6876,91,530528,77.14526683146721,11
0.2,6877,96,530624,77.14800814190171,6
0.2,6878,91,530715,77.15002180549499,10
0.2,6879,83,530798,77.15087209302325,18
0.2,6880,93,530891,77.15317541055079,8
0.2,6881,84,530975,77.1541702993316,18
0.2,6882,91,531066,77.15618189742845,10
0.2,6883,92,531158,77.15833817547937,9
0.2,6884,91,531249,77.16034858387799,10
0.2,6885,-49,531200,77.1420273017717,12
0.2,6886,95,531295,77.14462029911428,6
0.2,6887,89,531384,77.14634146341463,12
0.2,6888,94,531478,77.14878792277544,7
0.2,6889,89,531567,77.15050798258345,12
0.2,6890,89,531656,77.15222754317226,12
0.2,6891,94,531750,77.15467208357516,7
0.2,6892,24,531774,77.14696068475264,9
0.2,6893,95,531869,77.14955033362344,6
0.2,6894,95,531964,77.15213923132706,7
0.2,6895,91,532055,77.15414733178655,10
0.2,6896,92,532147,77.15629984051037,9
0.2,6897,87,532234,77.15772687735576,14
0.2,6898,95,532329,77.16031308885346,7
0.2,6899,95,532424,77.16289855072463,7
0.2,6900,93,532517,77.1651934502246,8
0.2,6901,96,532613,77.16792234135033,6
0.2,6902,90,532703,77.16978125452702,11
0.2,6903,91,532794,77.1717844727694,11
0.2,6904,93,532887,77.17407675597393,8
0.2,6905,87,532974,77.17549956559513,14
0.2,6906,23,532997,77.16765600115825,10
0.2,6907,90,533087,77.1695136074117,11
0.2,6908,92,533179,77.17166015342308,9
0.2,6909,96,533275,77.17438494934876,6
0.2,6910,24,533299,77.16669078281001,10
0.2,6911,94,533393,77.1691261574074,7
0.2,6912,95,533488,77.17170548242441,6
0.2,6913,93,533581,77.17399479317328,8
0.2,6914,95,533676,77.1765726681128,6
0.2,6915,95,533771,77.17914979757084,6
0.2,6916,91,533862,77.18114789648692,10
0.2,6917,23,533885,77.17331598727957,11
0.2,6918,93,533978,77.17560341089752,8
0.2,6919,93,534071,77.1778901734104,9
0.2,6920,94,534165,77.18032076289553,7
0.2,6921,88,534253,77.18188384859867,13
0.2,6922,94,534347,77.1843131590351,7
0.2,6923,96,534443,77.1870306181398,6
0.2,6924,96,534539,77.18974729241877,6
0.2,6925,92,534631,77.19188564828184,9
0.2,6926,92,534723,77.1940233867475,9
0.2,6927,95,534818,77.1965935334873,6
0.2,6928,17,534835,77.18790590272766,15
0.2,6929,95,534930,77.19047619047619,6
0.2,6930,93,535023,77.19275717789641,10
0.2,6931,93,535116,77.19503750721293,8
0.2,6932,24,535140,77.18736477715275,9
0.2,6933,90,535230,77.18921257571387,11
0.2,6934,90,535320,77.19105984138429,11
0.2,6935,93,535413,77.19333910034602,8
0.2,6936,95,535508,77.19590601124405,7
0.2,6937,94,535602,77.19832804842895,7
0.2,6938,91,535693,77.20031704856608,12
0.2,6939,94,535787,77.20273775216138,7
0.2,6940,86,535873,77.20400518657254,15
0.2,6941,27,535900,77.19677326418899,6
0.2,6942,96,535996,77.19948149215037,6
0.2,6943,95,536091,77.20204493087557,7
0.2,6944,94,536185,77.20446364290856,7
0.2,6945,86,536271,77.2057299164987,15
0.2,6946,93,536364,77.20800345472865,8
0.2,6947,94,536458,77.2104202648244,8
0.2,6948,89,536547,77.21211685134551,12
0.2,6949,84,536631,77.21309352517986,17
0.2,6950,93,536724,77.21536469572723,9
0.2,6951,93,536817,77.21763521288838,8
0.2,6952,88,536905,77.21918596289372,13
0.2,6953,95,537000,77.22174288179465,6
0.2,6954,96,537096,77.22444284687275,6
0.2,6955,95,537191,77.22699827487061,6
0.2,6956,-51,537140,77.20856691102486,15
0.2,6957,22,537162,77.20063236562231,11
0.2,6958,93,537255,77.20290271590746,8
0.2,6959,25,537280,77.19540229885058,8
0.2,6960,91,537371,77.19738543312742,10
0.2,6961,21,537392,77.18931341568515,11
0.2,6962,91,537483,77.19129685480397,10
0.2,6963,96,537579,77.19399770246984,6
0.2,6964,91,537670,77.19597989949749,11
0.2,6965,95,537765,77.19853574504738,7
0.2,6966,93,537858,77.20080378929238,8
0.2,6967,85,537943,77.20192307692308,16
0.2,6968,93,538036,77.20418998421582,8
0.2,6969,95,538131,77.2067431850789,6
0.2,6970,92,538223,77.20886529909626,9
0.2,6971,92,538315,77.2109868043603,9
0.2,6972,91,538406,77.21296429083608,10
0.2,6973,95,538501,77.21551476914253,8
0.2,6974,92,538593,77.21763440860215,9
0.2,6975,91,538684,77.21961009174312,10
0.2,6976,14,538698,77.21054894653862,18
0.2,6977,93,538791,77.2128116938951,9
0.2,6978,25,538816,77.20533027654392,8
0.2,6979,18,538834,77.19684813753581,14
0.2,6980,93,538927,77.19911187508953,9
0.2,6981,94,539021,77.20151818963048,7
0.2,6982,25,539046,77.19404267506802,7
0.2,6983,96,539142,77.19673539518901,7
0.2,6984,93,539235,77.19899785254115,8
0.2,6985,95,539330,77.20154594904093,6
0.2,6986,94,539424,77.20395019321597,7
0.2,6987,95,539519,77.20649685174585,6
0.2,6988,95,539614,77.2090427815138,6
0.2,6989,96,539710,77.21173104434907,6
0.2,6990,83,539793,77.21255900443427,18
0.2,6991,96,539889,77.21524599542334,6
0.2,6992,95,539984,77.21778921778922,6
0.2,6993,92,540076,77.21990277380613,9
0.2,6994,96,540172,77.22258756254467,6
0.2,6995,94,540266,77.22498570611778,8
0.2,6996,82,540348,77.22566814349007,19
0.2,6997,94,540442,77.2280651614747,7
0.2,6998,94,540536,77.23046149449921,8
0.2,6999,90,540626,77.23228571428571,11
0.2,7000,93,540719,77.23453792315384,8
0.2,7001,92,540811,77.23664667237932,9
0.2,7002,92,540903,77.23875481936312,10
0.2,7003,94,540997,77.24114791547687,8
0.2,7004,95,541092,77.24368308351178,6
0.2,7005,94,541186,77.24607479303454,7
0.2,7006,94,541280,77.24846581989439,8
0.2,7007,92,541372,77.25057077625571,9
0.2,7008,-46,541326,77.2329861606506,10
0.2,7009,94,541420,77.23537803138373,8
0.2,7010,92,541512,77.2374839537869,9
0.2,7011,95,541607,77.24001711351968,7
0.2,7012,94,541701,77.24240695850563,8
0.2,7013,94,541795,77.24479612204163,7
0.2,7014,92,541887,77.24689950106914,10
0.2,7015,91,541978,77.24885974914481,10
0.2,7016,96,542074,77.25153199372951,6
0.2,7017,94,542168,77.25391849529781,7
0.2,7018,92,542260,77.25601937597949,10
0.2,7019,91,542351,77.2579772079772,10
0.2,7020,92,542443,77.26007691212078,9
0.2,7021,94,542537,77.26246083736827,7
0.2,7022,93,542630,77.26470169443257,9
0.2,7023,90,542720,77.26651480637813,12
0.2,7024,94,542814,77.26889679715302,8
0.2,7025,93,542907,77.27113578138344,8
0.2,7026,94,543001,77.27351643660168,10
0.2,7027,88,543089,77.27504268639727,13
0.2,7028,94,543183,77.27742210840802,7
0.2,7029,25,543208,77.26998577524893,9
0.2,7030,94,543302,77.27236523965297,7
0.2,7031,88,543390,77.27389078498294,13
0.2,7032,93,543483,77.27612683065549,9
0.2,7033,93,543576,77.27836224054592,8
0.2,7034,94,543670,77.28073916133617,7
0.2,7035,93,543763,77.28297328027288,8
0.2,7036,91,543854,77.28492255222396,10
0.2,7037,96,543950,77.2875816993464,6
0.2,7038,94,544044,77.28995595965335,7
0.2,7039,89,544133,77.29161931818182,12
0.2,7040,94,544227,77.29399233063485,7
0.2,7041,95,544322,77.29650667424028,6
0.2,7042,89,544411,77.29816839415022,12
0.2,7043,95,544506,77.30068143100512,7
0.2,7044,91,544597,77.3026259758694,10
0.2,7045,22,544619,77.29477717854101,10
0.2,7046,94,544713,77.29714772243508,7
0.2,7047,94,544807,77.29951759364359,7
0.2,7048,94,544901,77.30188679245283,7
0.2,7049,91,544992,77.30382978723404,10
0.2,7050,88,545080,77.30534675932492,13
0.2,7051,92,545172,77.30743051616562,9
0.2,7052,94,545266,77.30979724939742,7
0.2,7053,94,545360,77.31216331159625,7
0.2,7054,90,545450,77.31396172927002,11
0.2,7055,92,545542,77.31604308390023,10
0.2,7056,25,545567,77.30862972934675,8
0.2,7057,93,545660,77.31085293284217,8
0.2,7058,94,545754,77.31321716957076,7
0.2,7059,93,545847,77.31543909348441,8
0.2,7060,93,545940,77.31766038804702,8
0.2,7061,94,546034,77.32002265647125,8
0.2,7062,96,546130,77.32266742177545,6
0.2,7063,95,546225,77.32516987542469,7
0.2,7064,95,546320,77.32767162066526,6
0.2,7065,23,546343,77.31998301726578,11
0.2,7066,92,546435,77.32206028017546,9
0.2,7067,96,546531,77.32470288624788,6
0.2,7068,93,546624,77.32692035648607,8
0.2,7069,90,546714,77.32871287128712,11
0.2,7070,93,546807,77.33092914722104,9
0.2,7071,92,546899,77.33300339366515,9
0.2,7072,95,546994,77.33550120175315,6
0.2,7073,94,547088,77.33785694091037,7
0.2,7074,91,547179,77.33978798586573,10
0.2,7075,95,547274,77.34228377614471,6
0.2,7076,22,547296,77.33446375582874,10
0.2,7077,92,547388,77.3365357445606,9
0.2,7078,94,547482,77.33888967368273,7
0.2,7079,93,547575,77.34110169491525,9
0.2,7080,93,547668,77.34331309137127,8
0.2,7081,95,547763,77.34580626941542,8
0.2,7082,88,547851,77.34731046166878,14
0.2,7083,94,547945,77.34966120835686,7
0.2,7084,94,548039,77.35201129146083,7
0.2,7085,93,548132,77.35421958791984,8
0.2,7086,96,548228,77.35685057146888,6
0.2,7087,20,548248,77.34875846501129,12
0.2,7088,95,548343,77.35124841303428,7
0.2,7089,91,548434,77.35317348377997,10
0.2,7090,91,548525,77.35509801156395,11
0.2,7091,96,548621,77.35772701635646,6
0.2,7092,94,548715,77.36007331171578,8
0.2,7093,92,548807,77.36213701719763,9
0.2,7094,94,548901,77.3644820295983,7
0.2,7095,91,548992,77.36640360766629,10
0.2,7096,91,549083,77.36832464421586,11
0.2,7097,93,549176,77.37052690898845,9
0.2,7098,93,549269,77.37272855331737,8
0.2,7099,94,549363,77.37507042253522,7
0.2,7100,94,549457,77.37741163216448,9
0.2,7101,92,549549,77.37947057166996,9
0.2,7102,24,549573,77.3719555117556,10
0.2,7103,92,549665,77.37401463963964,9
0.2,7104,87,549752,77.37536945812808,14
0.2,7105,95,549847,77.3778497044751,6
0.2,7106,89,549936,77.37948501477416,12
0.2,7107,96,550032,77.38210467079347,6
0.2,7108,94,550126,77.38444225629483,9
0.2,7109,94,550220,77.38677918424754,7
0.2,7110,94,550314,77.38911545492898,7
0.2,7111,88,550402,77.39060742407199,14
0.2,7112,93,550495,77.39280191199212,8
0.2,7113,95,550590,77.39527691875176,6
0.2,7114,94,550684,77.39761068165846,7
0.2,7115,89,550773,77.39924114671163,12
0.2,7116,90,550863,77.40101166221723,11
0.2,7117,94,550957,77.40334363585276,7
0.2,7118,88,551045,77.40483213934542,13
0.2,7119,90,551135,77.40660112359551,11
0.2,7120,22,551157,77.3988203903946,11
0.2,7121,93,551250,77.40101095197979,8
0.2,7122,92,551342,77.40306050821283,9
0.2,7123,25,551367,77.3957046603032,9
0.2,7124,27,551394,77.38863157894737,6
0.2,7125,94,551488,77.3909626719057,7
0.2,7126,92,551580,77.39301248772274,9
0.2,7127,89,551669,77.39464085297419,12
0.2,7128,90,551759,77.39640903352503,11
0.2,7129,92,551851,77.3984572230014,9
0.2,7130,90,551941,77.40022437245828,12
0.2,7131,92,552033,77.40227145260796,9
0.2,7132,96,552129,77.40487873265106,6
0.2,7133,27,552156,77.3978132884777,6
0.2,7134,94,552250,77.40014015416959,7
0.2,7135,27,552277,77.39307735426009,6
0.2,7136,93,552370,77.39526411657559,8
0.2,7137,91,552461,77.39717007565145,10
0.2,7138,92,552553,77.39921557641127,9
0.2,7139,26,552579,77.3920168067227,7
0.2,7140,92,552671,77.39406245623863,9
0.2,7141,94,552765,77.39638756650798,7
0.2,7142,96,552861,77.3989920201596,6
0.2,7143,90,552951,77.40075587905935,11
0.2,7144,91,553042,77.40265920223933,10
0.2,7145,25,553067,77.39532605653513,9
0.2,7146,90,553157,77.39708968798097,11
0.2,7147,93,553250,77.39927252378287,8
0.2,7148,92,553342,77.40131486921247,9
0.2,7149,91,553433,77.40321678321678,10
0.2,7150,92,553525,77.4052580058733,11
0.2,7151,94,553619,77.40757829977629,8
0.2,7152,23,553642,77.39997203970363,9
0.2,7153,86,553728,77.40117416829746,15
0.2,7154,95,553823,77.40363382250175,8
0.2,7155,94,553917,77.40595304639463,7
0.2,7156,92,554009,77.40799217549252,12
0.2,7157,94,554103,77.4103101424979,7
0.2,7158,-51,554052,77.39237323648554,14
0.2,7159,18,554070,77.3840782122905,15
0.2,7160,93,554163,77.38625890238794,8
0.2,7161,86,554249,77.38746160290421,16
0.2,7162,96,554345,77.39006003071339,6
0.2,7163,96,554441,77.39265773311,6
0.2,7164,94,554535,77.39497557571528,7
0.2,7165,95,554630,77.39743231928551,6
0.2,7166,94,554724,77.39974884889075,7
0.2,7167,93,554817,77.40192522321429,9
0.2,7168,25,554842,77.39461570651416,8
0.2,7169,87,554929,77.39595536959554,14
0.2,7170,94,555023,77.3982708129968,7
0.2,7171,93,555116,77.40044617958728,11
0.2,7172,94,555210,77.40276035131744,7
0.2,7173,91,555301,77.40465570114301,10
0.2,7174,93,555394,77.40682926829268,8
0.2,7175,93,555487,77.4090022296544,8
0.2,7176,95,555582,77.41145325344851,6
0.2,7177,96,555678,77.41404290888826,6
0.2,7178,93,555771,77.41621395737567,9
0.2,7179,27,555798,77.4091922005571,7
0.2,7180,90,555888,77.41094555075895,11
0.2,7181,21,555909,77.4030910609858,12
0.2,7182,95,556004,77.40554086036475,8
0.2,7183,95,556099,77.40798997772829,6
0.2,7184,92,556191,77.41002087682672,9
0.2,7185,94,556285,77.41232952964097,8
0.2,7186,92,556377,77.4143592597746,11
0.2,7187,93,556470,77.41652754590984,8
0.2,7188,93,556563,77.41869522882182,8
0.2,7189,93,556656,77.42086230876217,8
0.2,7190,21,556677,77.41301627033792,11
0.2,7191,90,556767,77.41476640711902,11
0.2,7192,17,556784,77.40636730154317,15
0.2,7193,94,556878,77.40867389491243,7
0.2,7194,94,556972,77.41097984711605,8
0.2,7195,26,556998,77.40383546414675,7
0.2,7196,17,557015,77.39544254550508,15
0.2,7197,92,557107,77.39747151986663,9
0.2,7198,96,557203,77.40005556327267,6
0.2,7199,94,557297,77.4023611111111,7
0.2,7200,92,557389,77.40438827940564,10
0.2,7201,94,557483,77.40669258539295,7
0.2,7202,94,557577,77.40899625156185,8
0.2,7203,94,557671,77.41129927817879,7
0.2,7204,94,557765,77.41360166551006,7
0.2,7205,93,557858,77.4157646405773,8
0.2,7206,93,557951,77.41792701540169,8
0.2,7207,96,558047,77.42050499445061,6
0.2,7208,86,558133,77.42169510334304,15
0.2,7209,24,558157,77.41428571428571,8
0.2,7210,16,558173,77.40576896408265,16
0.2,7211,22,558195,77.39808652246256,10
0.2,7212,94,558289,77.4003881879939,7
0.2,7213,94,558383,77.40268921541447,7
0.2,7214,23,558406,77.395148995149,9
0.2,7215,94,558500,77.39745011086474,7
0.2,7216,93,558593,77.3996120271581,8
0.2,7217,92,558685,77.40163480188419,9
0.2,7218,92,558777,77.40365701620723,10
0.2,7219,92,558869,77.40567867036012,9
0.2,7220,92,558961,77.40769976457554,9
0.2,7221,25,558986,77.40044309055664,8
0.2,7222,93,559079,77.4026027966219,8
0.2,7223,95,559174,77.40503875968992,7
0.2,7224,96,559270,77.4076124567474,6
0.2,7225,95,559365,77.4100470523111,6
0.2,7226,92,559457,77.41206586412066,9
0.2,7227,91,559548,77.41394576646375,10
0.2,7228,88,559636,77.41541015354821,13
0.2,7229,96,559732,77.4179806362379,6
0.2,7230,86,559818,77.41916747337851,17
0.2,7231,21,559839,77.41136615044248,11
0.2,7232,24,559863,77.40398175031108,8
0.2,7233,94,559957,77.40627591927012,7
0.2,7234,90,560047,77.40801658604008,11
0.2,7235,91,560138,77.40989496959646,10
0.2,7236,93,560231,77.412049191654,9
0.2,7237,92,560323,77.41406465874552,9
0.2,7238,95,560418,77.41649399088271,6
0.2,7239,90,560508,77.4182320441989,11
0.2,7240,88,560596,77.41969341251209,13
0.2,7241,21,560617,77.41190278928472,12
0.2,7242,95,560712,77.41433107828247,6
0.2,7243,92,560804,77.41634456101602,9
0.2,7244,92,560896,77.4183574879227,9
0.2,7245,20,560916,77.4104333425338,12
0.2,7246,93,561009,77.41258451773147,9
0.2,7247,86,561095,77.41376931567329,16
0.2,7248,91,561186,77.41564353703959,11
0.2,7249,95,561281,77.41806896551724,6
0.2,7250,93,561374,77.42021790097918,8
0.2,7251,94,561468,77.42250413678985,8
0.2,7252,95,561563,77.42492761615883,6
0.2,7253,92,561655,77.42693686242073,9
0.2,7254,93,561748,77.42908339076499,8
0.2,7255,94,561842,77.4313671444322,7
0.2,7256,96,561938,77.43392586468238,7
0.2,7257,95,562033,77.43634610085422,6
0.2,7258,94,562127,77.43862791018047,8
0.2,7259,96,562223,77.44118457300276,6
0.2,7260,96,562319,77.44374053160722,7
0.2,7261,95,562414,77.44615808317268,8
0.2,7262,95,562509,77.44857496902107,6
0.2,7263,84,562593,77.44947687224669,17
0.2,7264,89,562682,77.45106675843083,12
0.2,7265,24,562706,77.44371043214974,10
0.2,7266,89,562795,77.445300674281,12
0.2,7267,93,562888,77.44744083654375,8
0.2,7268,18,562906,77.43926262209382,16
0.2,7269,92,562998,77.44126547455296,9
0.2,7270,96,563094,77.44381790675286,6
0.2,7271,94,563188,77.44609460946094,8
0.2,7272,92,563280,77.44809569641139,9
0.2,7273,95,563375,77.45050866098433,6
0.2,7274,90,563465,77.45223367697595,11
0.2,7275,95,563560,77.4546454095657,7
0.2,7276,90,563650,77.45636938298749,11
0.2,7277,92,563742,77.45836768342951,9
0.2,7278,95,563837,77.46077757933782,6
0.2,7279,95,563932,77.46318681318681,6
0.2,7280,24,563956,77.45584397747562,9
0.2,7281,84,564040,77.45674265311727,17
0.2,7282,93,564133,77.45887683646849,8
0.2,7283,95,564228,77.46128500823723,6
0.2,7284,25,564253,77.45408373369938,8
0.2,7285,-50,564203,77.43659072193248,13
0.2,7286,90,564293,77.43831480719089,13
0.2,7287,93,564386,77.44045005488474,9
0.2,7288,92,564478,77.44244752366579,9
0.2,7289,94,564572,77.44471879286694,7
0.2,7290,21,564593,77.43697709504869,11
0.2,7291,96,564689,77.43952276467361,6
0.2,7292,94,564783,77.44179350061702,9
0.2,7293,93,564876,77.44392651494378,8
0.2,7294,79,564955,77.44413982179574,22
0.2,7295,91,565046,77.44599780701755,10
0.2,7296,91,565137,77.447855282993,10
0.2,7297,24,565161,77.44053165250753,9
0.2,7298,-51,565110,77.422934648582,15
0.2,7299,91,565201,77.42479452054795,10
0.2,7300,20,565221,77.4169291877825,12
0.2,7301,93,565314,77.41906327033689,8
0.2,7302,96,565410,77.42160755853759,6
0.2,7303,94,565504,77.42387732749178,7
0.2,7304,91,565595,77.42573579739904,10
0.2,7305,93,565688,77.42786750615932,8
0.2,7306,78,565766,77.42794580539208,24
0.2,7307,94,565860,77.43021346469622,7
0.2,7308,93,565953,77.43234368586674,8
0.2,7309,93,566046,77.4344733242134,11
0.2,7310,90,566136,77.4361920393927,11
0.2,7311,96,566232,77.43873085339169,6
0.2,7312,88,566320,77.44017503076712,14
0.2,7313,95,566415,77.44257588187038,6
0.2,7314,92,566507,77.44456596035543,9
0.2,7315,94,566601,77.44682886823401,7
0.2,7316,88,566689,77.44827114937816,13
0.2,7317,22,566711,77.44069417873736,10
0.2,7318,91,566802,77.44254679601039,10
0.2,7319,-50,566752,77.42513661202186,13
0.2,7320,-60,566692,77.40636525064882,23
0.2,7321,94,566786,77.40863152144223,7
0.2,7322,92,566878,77.41062406117712,10
0.2,7323,93,566971,77.41275259421082,8
0.2,7324,93,567064,77.41488054607508,11
0.2,7325,16,567080,77.40649740649741,16
0.2,7326,88,567168,77.4079432236932,13
0.2,7327,94,567262,77.41020742358079,7
0.2,7328,87,567349,77.41151589575658,14
0.2,7329,94,567443,77.41377899045021,7
0.2,7330,90,567533,77.41549583958532,13
0.2,7331,92,567625,77.41748499727223,9
0.2,7332,95,567720,77.4198827219419,6
0.2,7333,21,567741,77.4121898009272,11
0.2,7334,24,567765,77.40490797546012,8
0.2,7335,23,567788,77.39749182115594,9
0.2,7336,23,567811,77.39007768842852,9
0.2,7337,-54,567757,77.37217225402017,17
0.2,7338,21,567778,77.36449107507835,11
0.2,7339,96,567874,77.36702997275205,6
0.2,7340,92,567966,77.36902329382917,9
0.2,7341,96,568062,77.3715608825933,6
0.2,7342,95,568157,77.37396159607789,7
0.2,7343,95,568252,77.37636165577342,6
0.2,7344,95,568347,77.3787610619469,7
0.2,7345,92,568439,77.3807514293493,9
0.2,7346,92,568531,77.38274125493399,9
0.2,7347,94,568625,77.38500272182907,8
0.2,7348,94,568719,77.38726357327528,7
0.2,7349,94,568813,77.38952380952381,7
0.2,7350,95,568908,77.39191946673922,7
0.2,7351,23,568931,77.38452121871599,9
0.2,7352,-44,568887,77.36801305589556,8
0.2,7353,94,568981,77.37027468044602,7
0.2,7354,90,569071,77.37199184228416,11
0.2,7355,95,569166,77.37438825448613,6
0.2,7356,90,569256,77.37610439037651,11
0.2,7357,92,569348,77.37809187279152,9
0.2,7358,94,569442,77.38035059111293,8
0.2,7359,93,569535,77.38247282608695,8
0.2,7360,94,569629,77.38473033555223,7
0.2,7361,95,569724,77.38712306438468,8
0.2,7362,89,569813,77.388700258047,12
0.2,7363,89,569902,77.39027702335687,12
0.2,7364,27,569929,77.38343516632722,6
0.2,7365,93,570022,77.38555525386913,8
0.2,7366,23,570045,77.37817293335144,9
0.2,7367,90,570135,77.37988599348535,11
0.2,7368,94,570229,77.38214140317547,7
0.2,7369,96,570325,77.38466757123473,6
0.2,7370,92,570417,77.38665038665039,9
0.2,7371,93,570510,77.38876831253391,8
0.2,7372,96,570606,77.39129255391292,6
0.2,7373,94,570700,77.39354488744236,7
0.2,7374,94,570794,77.3957966101695,7
0.2,7375,95,570889,77.39818329718004,7
0.2,7376,95,570984,77.40056933712891,7
0.2,7377,96,571080,77.40309026836542,6
0.2,7378,90,571170,77.40479739802142,11
0.2,7379,90,571260,77.40650406504065,11
0.2,7380,96,571356,77.40902316759247,6
0.2,7381,88,571444,77.4104578704958,13
0.2,7382,92,571536,77.41243396993092,9
0.2,7383,95,571631,77.41481581798483,6
0.2,7384,91,571722,77.41665538253216,10
0.2,7385,84,571806,77.41754670999188,17
0.2,7386,93,571899,77.4196561527007,8
0.2,7387,26,571925,77.41269626421223,6
0.2,7388,94,572019,77.41494112870483,7
0.2,7389,96,572115,77.41745602165088,6
0.2,7390,94,572209,77.41969963469084,7
0.2,7391,92,572301,77.42167207792208,10
0.2,7392,93,572394,77.4237792506425,8
0.2,7393,93,572487,77.42588585339465,8
0.2,7394,93,572580,77.42799188640974,8
0.2,7395,93,572673,77.43009734991888,8
0.2,7396,89,572762,77.43166148438556,12
0.2,7397,94,572856,77.43390105433902,7
0.2,7398,18,572874,77.42586836058926,15
0.2,7399,90,572964,77.42756756756756,11
0.2,7400,-52,572912,77.4100797189569,15
0.2,7401,94,573006,77.41232099432585,8
0.2,7402,96,573102,77.41483182493583,6
0.2,7403,92,573194,77.41680172879525,9
0.2,7404,89,573283,77.41836596893991,12
0.2,7405,24,573307,77.41115311909263,8
0.2,7406,95,573402,77.41352774402593,6
0.2,7407,23,573425,77.40618250539957,9
0.2,7408,92,573517,77.40815224726684,9
0.2,7409,96,573613,77.41066126855601,6
0.2,7410,94,573707,77.41289974362434,7
0.2,7411,91,573798,77.41473286562331,13
0.2,7412,91,573889,77.41656549305274,10
0.2,7413,94,573983,77.41880226598327,7
0.2,7414,94,574077,77.4210384356035,7
0.2,7415,88,574165,77.42246494066882,13
0.2,7416,96,574261,77.42496966428475,6
0.2,7417,92,574353,77.42693448368833,9
0.2,7418,21,574374,77.41932875050546,11
0.2,7419,90,574464,77.42102425876011,11
0.2,7420,92,574556,77.42298881552351,9
0.2,7421,92,574648,77.42495284289949,9
0.2,7422,-50,574598,77.40778660918765,13
0.2,7423,23,574621,77.40045797413794,9
0.2,7424,95,574716,77.40282828282828,6
0.2,7425,87,574803,77.40412065715056,14
0.2,7426,90,574893,77.40581661505318,11
0.2,7427,16,574909,77.39754981152396,16
0.2,7428,19,574928,77.3896890564006,17
0.2,7429,94,575022,77.39192462987887,7
0.2,7430,21,575043,77.38433589018975,12
0.2,7431,96,575139,77.38684068891281,6
0.2,7432,-48,575091,77.369971747612,11
0.2,7433,96,575187,77.3724778046812,6
0.2,7434,94,575281,77.37471418964358,8
0.2,7435,93,575374,77.37681549220011,8
0.2,7436,96,575470,77.37931961812559,6
0.2,7437,94,575564,77.38155418123151,7
0.2,7438,95,575659,77.38392257023794,6
0.2,7439,95,575754,77.38629032258065,6
0.2,7440,90,575844,77.3879854858218,11
0.2,7441,92,575936,77.38994893845741,9
0.2,7442,92,576028,77.3919118634959,9
0.2,7443,-45,575983,77.37547017732402,9
0.2,7444,93,576076,77.3775688381464,8
0.2,7445,94,576170,77.37980123556272,7
0.2,7446,93,576263,77.38189875117497,8
0.2,7447,91,576354,77.38372717508057,10
0.2,7448,23,576377,77.37642636595517,9
0.2,7449,92,576469,77.37838926174497,9
0.2,7450,93,576562,77.38048584082674,8
0.2,7451,94,576656,77.38271604938272,7
0.2,7452,27,576683,77.37595599087615,6
0.2,7453,88,576771,77.37738127180037,13
0.2,7454,24,576795,77.37022132796781,9
0.2,7455,95,576890,77.37258583690988,6
0.2,7456,96,576986,77.37508381386617,6
0.2,7457,92,577078,77.37704478412444,9
0.2,7458,94,577172,77.37927336104035,8
0.2,7459,22,577194,77.37184986595175,10
0.2,7460,95,577289,77.37421257204129,6
0.2,7461,94,577383,77.37644063253819,7
0.2,7462,23,577406,77.36915449551118,9
0.2,7463,-50,577356,77.35209003215434,14
0.2,7464,93,577449,77.35418620227729,8
0.2,7465,90,577539,77.35587998928476,11
0.2,7466,90,577629,77.35757332261953,11
0.2,7467,87,577716,77.3588644884842,14
0.2,7468,22,577738,77.3514526710403,10
0.2,7469,96,577834,77.35394912985275,6
0.2,7470,96,577930,77.35644492035873,8
0.2,7471,92,578022,77.35840471092077,9
0.2,7472,93,578115,77.36049779205139,8
0.2,7473,92,578207,77.36245651592186,9
0.2,7474,93,578300,77.36454849498328,10
0.2,7475,93,578393,77.36663991439272,9
0.2,7476,95,578488,77.36899826133477,6
0.2,7477,22,578510,77.36159400909334,11
0.2,7478,19,578529,77.35379061371842,14
0.2,7479,92,578621,77.35574866310161,9
0.2,7480,92,578713,77.35770618901216,9
0.2,7481,94,578807,77.35993049986635,7
0.2,7482,91,578898,77.361753307497,10
0.2,7483,89,578987,77.36330839123464,12
0.2,7484,96,579083,77.36579826319306,6
0.2,7485,89,579172,77.36735239113011,14
0.2,7486,92,579264,77.36930679845065,9
0.2,7487,85,579349,77.37032585470085,16
0.2,7488,94,579443,77.3725464013887,7
0.2,7489,91,579534,77.3743658210948,12
0.2,7490,93,579627,77.37645174209051,8
0.2,7491,92,579719,77.37840363053924,9
0.2,7492,26,579745,77.37154677699186,7
0.2,7493,94,579839,77.37376567921004,7
0.2,7494,85,579924,77.37478318879253,16
0.2,7495,91,580015,77.37660085378869,10
0.2,7496,96,580111,77.37908496732027,6
0.2,7497,96,580207,77.38156841824487,6
0.2,7498,92,580299,77.38351780237365,9
0.2,7499,94,580393,77.38573333333333,7
0.2,7500,89,580482,77.3872816957739,12
0.2,7501,93,580575,77.38936283657691,8
0.2,7502,95,580670,77.3917099826736,7
0.2,7503,93,580763,77.39378997867804,8
0.2,7504,94,580857,77.39600266489008,7
0.2,7505,89,580946,77.39754862776445,12
0.2,7506,93,581039,77.3996270147862,8
0.2,7507,90,581129,77.401305274374,11
0.2,7508,92,581221,77.40324943401252,9
0.2,7509,94,581315,77.40545938748336,7
0.2,7510,96,581411,77.40793502862468,6
0.2,7511,94,581505,77.41014376996804,7
0.2,7512,94,581599,77.41235192333289,8
0.2,7513,92,581691,77.41429331913761,9
0.2,7514,92,581783,77.41623419827013,12
0.2,7515,94,581877,77.4184406599255,7
0.2,7516,95,581972,77.42077956631636,7
0.2,7517,-57,581915,77.40289970736899,20
0.2,7518,94,582009,77.40510706210932,7
0.2,7519,95,582104,77.40744680851064,7
0.2,7520,91,582195,77.40925408855206,11
0.2,7521,94,582289,77.41145971816006,7
0.2,7522,23,582312,77.40422703708627,9
0.2,7523,93,582405,77.40629984051037,8
0.2,7524,94,582499,77.40850498338871,8
0.2,7525,95,582594,77.41084241296838,7
0.2,7526,94,582688,77.41304636641424,7
0.2,7527,91,582779,77.41485122210415,10
0.2,7528,94,582873,77.41705405764378,8
0.2,7529,94,582967,77.41925630810093,7
0.2,7530,-44,582923,77.4031337139822,8
0.2,7531,89,583012,77.40467339352098,12
0.2,7532,94,583106,77.40687641046064,7
0.2,7533,95,583201,77.40921157419697,6
0.2,7534,95,583296,77.41154611811547,6
0.2,7535,91,583387,77.41334925690022,10
0.2,7536,91,583478,77.41515191720843,10
0.2,7537,93,583571,77.41721942159724,8
0.2,7538,88,583659,77.41862315957023,13
0.2,7539,22,583681,77.41127320954907,11
0.2,7540,96,583777,77.41373823100385,6
0.2,7541,96,583873,77.41620259878016,6
0.2,7542,93,583966,77.41826859339785,8
0.2,7543,94,584060,77.42046659597031,10
0.2,7544,94,584154,77.42266401590457,7
0.2,7545,19,584173,77.41492181288099,13
0.2,7546,94,584267,77.41711938518617,7
0.2,7547,93,584360,77.41918388977213,8
0.2,7548,93,584453,77.42124784739701,11
0.2,7549,23,584476,77.41403973509934,9
0.2,7550,89,584565,77.4155740961462,12
0.2,7551,96,584661,77.41803495762711,6
0.2,7552,21,584682,77.41056533827619,11
0.2,7553,95,584777,77.41289383108287,8
0.2,7554,93,584870,77.41495698213105,8
0.2,7555,90,584960,77.41662255161461,11
0.2,7556,93,585053,77.41868466322614,8
0.2,7557,95,585148,77.42101084943107,6
0.2,7558,95,585243,77.42333642016139,6
0.2,7559,95,585338,77.42566137566138,7
0.2,7560,93,585431,77.42772120089936,8
0.2,7561,93,585524,77.42978048135414,9
0.2,7562,25,585549,77.42284807616025,8
0.2,7563,95,585644,77.42517186673717,7
0.2,7564,-124,585520,77.39854593522803,18
0.2,7565,17,585537,77.39056304520221,15
0.2,7566,24,585561,77.38350733447865,9
0.2,7567,93,585654,77.38557082452431,8
0.2,7568,96,585750,77.3880301228696,6
0.2,7569,94,585844,77.39022457067371,7
0.2,7570,93,585937,77.39228635583146,8
0.2,7571,94,586031,77.39447966191231,9
0.2,7572,94,586125,77.39667238874951,7
0.2,7573,92,586217,77.39860047531027,9
0.2,7574,91,586308,77.40039603960396,10
0.2,7575,92,586400,77.40232312565998,9
0.2,7576,93,586493,77.40438168140425,8
0.2,7577,26,586519,77.39759831089998,7
0.2,7578,94,586613,77.39978889035493,7
0.2,7579,26,586639,77.39300791556728,7
0.2,7580,94,586733,77.39519852262235,7
0.2,7581,95,586828,77.39752044315485,6
0.2,7582,92,586920,77.39944612950019,10
0.2,7583,90,587010,77.4011075949367,12
0.2,7584,95,587105,77.40342781806197,6
0.2,7585,94,587199,77.4056156076984,7
0.2,7586,95,587294,77.40793462501648,6
0.2,7587,86,587380,77.40906694781233,16
0.2,7588,92,587472,77.41098959019634,9
0.2,7589,19,587491,77.40329380764163,14
0.2,7590,96,587587,77.4057436437887,6
0.2,7591,95,587682,77.40806111696523,7
0.2,7592,90,587772,77.40971947846701,12
0.2,7593,21,587793,77.40229128259152,11
0.2,7594,91,587884,77.40408163265306,11
0.2,7595,95,587979,77.4063981042654,6
0.2,7596,81,588060,77.40687113334211,20
0.2,7597,95,588155,77.40918662806001,6
0.2,7598,91,588246,77.41097512830636,10
0.2,7599,27,588273,77.40434210526315,6
0.2,7600,20,588293,77.39678989606631,13
0.2,7601,92,588385,77.3987108655617,9
0.2,7602,82,588467,77.39931605945021,19
0.2,7603,92,588559,77.40123619147818,12
0.2,7604,16,588575,77.3931623931624,16
0.2,7605,91,588666,77.39495135419406,10
0.2,7606,91,588757,77.39673984487972,11
0.2,7607,93,588850,77.39879074658255,8
0.2,7608,95,588945,77.40110395584176,6
0.2,7609,95,589040,77.40341655716163,6
0.2,7610,95,589135,77.40572855078176,6
0.2,7611,92,589227,77.4076458223857,9
0.2,7612,94,589321,77.40982529883095,7
0.2,7613,91,589412,77.41161019175203,11
0.2,7614,-124,589288,77.38516086671044,18
0.2,7615,94,589382,77.38734243697479,7
0.2,7616,95,589477,77.38965471970592,6
0.2,7617,94,589571,77.39183512733001,7
0.2,7618,95,589666,77.39414621341383,7
0.2,7619,93,589759,77.39619422572179,8
0.2,7620,91,589850,77.39797926781262,10
0.2,7621,94,589944,77.4001574389924,7
0.2,7622,94,590038,77.40233503869868,7
0.2,7623,27,590065,77.3957240293809,7
0.2,7624,89,590154,77.39724590163934,12
0.2,7625,95,590249,77.3995541568319,6
0.2,7626,92,590341,77.40146846728727,9
0.2,7627,96,590437,77.40390665967489,6
0.2,7628,88,590525,77.40529558264517,13
0.2,7629,94,590619,77.40747051114023,7
0.2,7630,19,590638,77.39981653780632,13
0.2,7631,90,590728,77.40146750524109,12
0.2,7632,24,590752,77.39447137429582,11
0.2,7633,95,590847,77.396777574011,7
0.2,7634,96,590943,77.3992141453831,6
0.2,7635,94,591037,77.40138816134102,7
0.2,7636,89,591126,77.40290690061542,12
0.2,7637,94,591220,77.40507986383871,7
0.2,7638,86,591306,77.40620500065454,16
0.2,7639,93,591399,77.40824607329843,8
0.2,7640,93,591492,77.41028661170004,8
0.2,7641,93,591585,77.4123266160691,9
0.2,7642,83,591668,77.41305769985608,18
0.2,7643,89,591757,77.41457352171638,12
0.2,7644,91,591848,77.4163505559189,10
0.2,7645,19,591867,77.40871043682972,14
0.2,7646,94,591961,77.41088008369294,7
0.2,7647,96,592057,77.41331066945607,6
0.2,7648,-50,592007,77.39665315727547,14
0.2,7649,86,592093,77.39777777777778,15
0.2,7650,23,592116,77.39066788655077,10
0.2,7651,21,592137,77.38329848405645,11
0.2,7652,94,592231,77.38546975042468,7
0.2,7653,89,592320,77.38698719623726,12
0.2,7654,23,592343,77.37988242978446,9
0.2,7655,93,592436,77.38192267502612,8
0.2,7656,93,592529,77.38396238735797,9
0.2,7657,96,592625,77.38639331418125,6
0.2,7658,89,592714,77.38790964877921,12
0.2,7659,17,592731,77.38002610966058,15
0.2,7660,94,592825,77.38219553583083,7
0.2,7661,94,592919,77.38436439571913,7
0.2,7662,91,593010,77.38614119796425,10
0.2,7663,93,593103,77.38817849686848,8
0.2,7664,89,593192,77.38969341161122,12
0.2,7665,91,593283,77.39146882337594,10
0.2,7666,95,593378,77.39376548845702,7
0.2,7667,94,593472,77.39593114241002,7
0.2,7668,95,593567,77.39822662667883,7
0.2,7669,94,593661,77.40039113428944,7
0.2,7670,92,593753,77.40229435536436,9
0.2,7671,94,593847,77.40445776850886,8
0.2,7672,94,593941,77.40662061775055,7
0.2,7673,94,594035,77.40878290330988,9
0.2,7674,93,594128,77.41081433224755,8
0.2,7675,91,594219,77.41258467952058,10
0.2,7676,96,594315,77.41500586166471,6
0.2,7677,92,594407,77.41690544412607,9
0.2,7678,95,594502,77.41919520770934,6
0.2,7679,90,594592,77.42083333333333,11
0.2,7680,95,594687,77.4231219893243,6
0.2,7681,90,594777,77.42475917729757,11
0.2,7682,93,594870,77.42678641155798,10
0.2,7683,93,594963,77.42881311816762,8
0.2,7684,94,595057,77.4309694209499,7
0.2,7685,19,595076,77.42336716107208,14
0.2,7686,94,595170,77.4255236112918,7
0.2,7687,91,595261,77.42728928199791,12
0.2,7688,93,595354,77.42931460528027,8
0.2,7689,95,595449,77.43159947984395,6
0.2,7690,88,595537,77.43297360551294,13
0.2,7691,95,595632,77.43525741029642,6
0.2,7692,26,595658,77.42857142857143,6
0.2,7693,86,595744,77.42968546919678,15
0.2,7694,94,595838,77.43183885640026,7
0.2,7695,96,595934,77.43425155925156,6
0.2,7696,88,596022,77.43562426919578,13
0.2,7697,94,596116,77.43777604572617,7
0.2,7698,96,596212,77.44018703727757,6
0.2,7699,19,596231,77.43259740259741,13
0.2,7700,94,596325,77.43474873393066,7
0.2,7701,16,596341,77.42677226694366,16
0.2,7702,86,596427,77.42788523951707,15
0.2,7703,21,596448,77.42056074766356,11
0.2,7704,26,596474,77.4138870863076,7
0.2,7705,93,596567,77.41590968076824,8
0.2,7706,95,596662,77.41819125470352,6
0.2,7707,93,596755,77.42021276595744,8
0.2,7708,93,596848,77.42223375275651,8
0.2,7709,94,596942,77.42438391699092,7
0.2,7710,95,597037,77.42666320840358,6
0.2,7711,25,597062,77.41986514522821,8
0.2,7712,86,597148,77.4209775703358,15
0.2,7713,18,597166,77.41327456572466,14
0.2,7714,95,597261,77.41555411535968,6
0.2,7715,91,597352,77.4173146708139,10
0.2,7716,92,597444,77.41920435402358,10
0.2,7717,94,597538,77.42135268204198,7
0.2,7718,92,597630,77.4232413525068,9
0.2,7719,94,597724,77.42538860103627,7
0.2,7720,24,597748,77.41846911021888,9
0.2,7721,92,597840,77.42035742035742,10
0.2,7722,-53,597787,77.4034701540852,16
0.2,7723,88,597875,77.4048420507509,13
0.2,7724,91,597966,77.40660194174757,11
0.2,7725,93,598059,77.4086202433342,8
0.2,7726,88,598147,77.40999094085673,13
0.2,7727,24,598171,77.40307971014492,9
0.2,7728,90,598261,77.4047095355156,11
0.2,7729,93,598354,77.40672703751618,8
0.2,7730,92,598446,77.40861466821886,9
0.2,7731,93,598539,77.41063114330056,8
0.2,7732,94,598633,77.41277641277641,7
0.2,7733,94,598727,77.41492112748901,7
0.2,7734,95,598822,77.41719457013575,6
0.2,7735,92,598914,77.41907962771458,9
0.2,7736,96,599010,77.42148119426135,6
0.2,7737,92,599102,77.42336521064874,10
0.2,7738,21,599123,77.4160744282207,11
0.2,7739,27,599150,77.40956072351422,7
0.2,7740,90,599240,77.41118718511821,11
0.2,7741,94,599334,77.41332988891759,7
0.2,7742,85,599419,77.41430969908305,16
0.2,7743,93,599512,77.41632231404958,8
0.2,7744,84,599596,77.4171723692705,17
0.2,7745,21,599617,77.40988897495481,11
0.2,7746,89,599706,77.4113850522783,12
0.2,7747,90,599796,77.41300980898296,11
0.2,7748,95,599891,77.41527939088915,7
0.2,7749,91,599982,77.41703225806451,10
0.2,7750,95,600077,77.41930073538899,8
0.2,7751,87,600164,77.42053663570691,14
0.2,7752,26,600190,77.41390429511156,7
0.2,7753,95,600285,77.41617229816869,6
0.2,7754,93,600378,77.41818181818182,8
0.2,7755,94,600472,77.42031975244971,7
0.2,7756,27,600499,77.41381977568648,6
0.2,7757,91,600590,77.41557102345965,10
0.2,7758,19,600609,77.40804227348885,13
0.2,7759,92,600701,77.40992268041236,11
0.2,7760,94,600795,77.41206030150754,7
0.2,7761,94,600889,77.41419737181138,7
0.2,7762,92,600981,77.41607625917815,9
0.2,7763,91,601072,77.41782586295724,10
0.2,7764,90,601162,77.41944623309723,11
0.2,7765,92,601254,77.42132371877415,9
0.2,7766,96,601350,77.42371572035535,6
0.2,7767,95,601445,77.42597837281153,7
0.2,7768,91,601536,77.4277255760072,10
0.2,7769,94,601630,77.42985842985843,7
0.2,7770,93,601723,77.43186205121606,8
0.2,7771,90,601813,77.43347915594441,11
0.2,7772,90,601903,77.43509584459025,13
0.2,7773,94,601997,77.43722665294571,7
0.2,7774,21,602018,77.42996784565916,11
0.2,7775,19,602037,77.42245370370371,13
0.2,7776,93,602130,77.42445673138742,9
0.2,7777,94,602224,77.42658781177681,7
0.2,7778,88,602312,77.4279470368942,13
0.2,7779,96,602408,77.43033419023136,6
0.2,7780,94,602502,77.43246369361265,7
0.2,7781,20,602522,77.42508352608584,13
0.2,7782,93,602615,77.42708467172042,9
0.2,7783,26,602641,77.42047790339157,8
0.2,7784,23,602664,77.41348747591522,10
0.2,7785,94,602758,77.41561777549448,7
0.2,7786,24,602782,77.40875818672146,8
0.2,7787,95,602877,77.41101694915254,6
0.2,7788,93,602970,77.41301835922455,8
0.2,7789,95,603065,77.41527599486521,7
0.2,7790,96,603161,77.41766140418432,6
0.2,7791,91,603252,77.4194045174538,10
0.2,7792,93,603345,77.42140382394456,8
0.2,7793,19,603364,77.4139081344624,14
0.2,7794,-47,603317,77.39794740218089,10
0.2,7795,91,603408,77.39969214982042,10
0.2,7796,21,603429,77.39245863793766,12
0.2,7797,94,603523,77.39458835598872,7
0.2,7798,96,603619,77.39697397102192,6
0.2,7799,93,603712,77.39897435897436,8
0.2,7800,96,603808,77.40135880015383,6
0.2,7801,92,603900,77.40322994104076,9
0.2,7802,95,603995,77.40548506984493,6
0.2,7803,91,604086,77.40722706304459,10
0.2,7804,96,604182,77.40960922485586,6
0.2,7805,94,604276,77.41173456315654,7
0.2,7806,93,604369,77.41373126681184,8
0.2,7807,94,604463,77.41585553278688,7
0.2,7808,90,604553,77.4174670252273,12
0.2,7809,93,604646,77.41946222791293,8
0.2,7810,87,604733,77.42068877224428,14
0.2,7811,14,604747,77.41257040450589,19
0.2,7812,87,604834,77.41379751695891,14
0.2,7813,24,604858,77.40696186332224,8
0.2,7814,93,604951,77.40895713371721,8
0.2,7815,-51,604900,77.39252814738997,14
0.2,7816,91,604991,77.39426890111297,10
0.2,7817,94,605085,77.39639293937068,7
0.2,7818,24,605109,77.38956388284947,8
0.2,7819,13,605122,77.38132992327365,23
0.2,7820,20,605142,77.37399309551208,13
0.2,7821,96,605238,77.37637432881615,6
0.2,7822,94,605332,77.37849929694491,7
0.2,7823,22,605354,77.37142126789367,10
0.2,7824,94,605448,77.37354632587859,7
0.2,7825,95,605543,77.37579861998466,7
0.2,7826,96,605639,77.37817810144372,6
0.2,7827,94,605733,77.38030148185999,7
0.2,7828,90,605823,77.38191339890152,11
0.2,7829,95,605918,77.38416347381865,8
0.2,7830,19,605937,77.37670795556123,13
0.2,7831,94,606031,77.37883043922369,7
0.2,7832,21,606052,77.37163283543981,12
0.2,7833,93,606145,77.37362777635946,8
0.2,7834,94,606239,77.37574984045948,7
0.2,7835,87,606326,77.37697805002553,14
0.2,7836,90,606416,77.3785887456935,11
0.2,7837,92,606508,77.38045419749936,10
0.2,7838,94,606602,77.38257430794744,8
0.2,7839,94,606696,77.38469387755102,7
0.2,7840,92,606788,77.38655783701059,9
0.2,7841,94,606882,77.38867635807192,8
0.2,7842,95,606977,77.39092184113223,7
0.2,7843,91,607068,77.39265680775115,13
0.2,7844,96,607164,77.39502868068834,6
0.2,7845,90,607254,77.39663522814173,12
0.2,7846,92,607346,77.3984962406015,9
0.2,7847,27,607373,77.3920744138634,6
0.2,7848,94,607467,77.39419034271882,7
0.2,7849,95,607562,77.39643312101911,6
0.2,7850,93,607655,77.39842058336518,9
0.2,7851,94,607749,77.40053489556801,7
0.2,7852,26,607775,77.39398955813066,7
0.2,7853,93,607868,77.39597657244715,8
0.2,7854,90,607958,77.39758115849777,11
0.2,7855,94,608052,77.39969450101833,7
0.2,7856,94,608146,77.40180730558737,7
0.2,7857,94,608240,77.40391957241029,7
0.2,7858,96,608336,77.4062857869958,6
0.2,7859,94,608430,77.40839694656489,8
0.2,7860,95,608525,77.41063477929016,7
0.2,7861,95,608620,77.41287204273722,6
0.2,7862,90,608710,77.41447284751366,13
0.2,7863,95,608805,77.41670905391658,6
0.2,7864,95,608900,77.41894469167197,7
0.2,7865,94,608994,77.42105263157895,8
0.2,7866,19,609013,77.41362654124825,13
0.2,7867,91,609104,77.41535332994408,10
0.2,7868,95,609199,77.41758800355827,6
0.2,7869,92,609291,77.41944091486658,9
0.2,7870,88,609379,77.42078516071655,13
0.2,7871,94,609473,77.4228912601626,7
0.2,7872,93,609566,77.42486980820526,8
0.2,7873,88,609654,77.4262128524257,14
0.2,7874,91,609745,77.42793650793651,10
0.2,7875,93,609838,77.42991366175724,8
0.2,7876,16,609854,77.42211501840802,17
0.2,7877,93,609947,77.42409240924093,8
0.2,7878,94,610041,77.42619621779414,7
0.2,7879,89,610130,77.42766497461929,12
0.2,7880,88,610218,77.42900647126,13
0.2,7881,96,610314,77.4313625983253,6
0.2,7882,91,610405,77.43308385132563,11
0.2,7883,-47,610358,77.41730086250634,11
0.2,7884,84,610442,77.41813570069753,17
0.2,7885,93,610535,77.42011159015978,8
0.2,7886,-44,610491,77.40471662228984,8
0.2,7887,95,610586,77.40694726166329,6
0.2,7888,94,610680,77.40905057675243,8
0.2,7889,-57,610623,77.39201520912547,21
0.2,7890,92,610715,77.39386643011025,11
0.2,7891,23,610738,77.38697415103903,9
0.2,7892,17,610755,77.37932345115925,15
0.2,7893,94,610849,77.38142893336712,7
0.2,7894,93,610942,77.38340721975933,8
0.2,7895,94,611036,77.3855116514691,8
0.2,7896,95,611131,77.3877421805749,6
0.2,7897,96,611227,77.39009875917954,6
0.2,7898,92,611319,77.39194834789214,9
0.2,7899,85,611404,77.39291139240507,16
0.2,7900,94,611498,77.39501328945703,7
0.2,7901,22,611520,77.38800303720578,11
0.2,7902,94,611614,77.39010502340884,7
0.2,7903,22,611636,77.3830971659919,10
0.2,7904,89,611725,77.38456672991778,12
0.2,7905,91,611816,77.3862888945105,10
0.2,7906,94,611910,77.38839003414697,7
0.2,7907,93,612003,77.39036418816389,8
0.2,7908,93,612096,77.39233784296371,9
0.2,7909,92,612188,77.39418457648546,9
0.2,7910,94,612282,77.39628365566932,7
0.2,7911,93,612375,77.39825581395348,10
0.2,7912,27,612402,77.39188676860861,6
0.2,7913,92,612494,77.39373262572656,9
0.2,7914,93,612587,77.39570435881238,8
0.2,7915,90,612677,77.39729661445175,11
0.2,7916,84,612761,77.39813060502716,17
0.2,7917,-64,612697,77.38027279616065,27
0.2,7918,90,612787,77.38186639727239,11
0.2,7919,95,612882,77.38409090909092,7
0.2,7920,90,612972,77.38568362580482,11
0.2,7921,94,613066,77.38778086341833,7
0.2,7922,94,613160,77.38987757162691,8
0.2,7923,91,613251,77.39159515396264,10
0.2,7924,94,613345,77.39369085173502,7
0.2,7925,94,613439,77.39578602069139,7
0.2,7926,17,613456,77.38816702409487,15
0.2,7927,95,613551,77.39038849646822,6
0.2,7928,25,613576,77.38378105687981,8
0.2,7929,92,613668,77.38562421185372,9
0.2,7930,92,613760,77.38746690203001,10
0.2,7931,91,613851,77.38918305597579,10
0.2,7932,95,613946,77.39140300012606,6
0.2,7933,27,613973,77.38505167632972,6
0.2,7934,26,613999,77.37857592942659,7
0.2,7935,81,614080,77.37903225806451,20
0.2,7936,93,614173,77.38100037797656,8
0.2,7937,94,614267,77.38309397833207,7
0.2,7938,94,614361,77.3851870512659,7
0.2,7939,95,614456,77.38740554156172,6
0.2,7940,95,614551,77.38962347311421,6
0.2,7941,95,614646,77.39184084613447,7
0.2,7942,94,614740,77.39393176381719,7
0.2,7943,95,614835,77.39614803625378,6
0.2,7944,94,614929,77.39823788546255,7
0.2,7945,93,615022,77.40020135917443,8
0.2,7946,94,615116,77.4022901723921,8
0.2,7947,94,615210,77.40437845998993,7
0.2,7948,94,615304,77.40646622216632,8
0.2,7949,94,615398,77.4085534591195,8
0.2,7950,94,615492,77.41064017104766,7
0.2,7951,94,615586,77.41272635814889,7
0.2,7952,94,615680,77.41481202062116,7
0.2,7953,22,615702,77.40784510937893,10
0.2,7954,94,615796,77.40993086109366,10
0.2,7955,93,615889,77.41189039718452,8
0.2,7956,91,615980,77.41359808973232,11
0.2,7957,94,616074,77.41568233224429,7
0.2,7958,94,616168,77.41776605101143,7
0.2,7959,90,616258,77.41934673366835,11
0.2,7960,94,616352,77.42142946865971,7
0.2,7961,96,616448,77.42376287364984,6
0.2,7962,24,616472,77.41705387416803,8
0.2,7963,93,616565,77.41901054746359,9
0.2,7964,94,616659,77.4210922787194,7
0.2,7965,95,616754,77.42329902083857,6
0.2,7966,24,616778,77.41659344797289,8
0.2,7967,26,616804,77.410140562249,9
0.2,7968,94,616898,77.4122223616514,7
0.2,7969,87,616985,77.41342534504392,14
0.2,7970,94,617079,77.41550621001129,7
0.2,7971,94,617173,77.41758655293528,7
0.2,7972,94,617267,77.4196663740123,8
0.2,7973,-130,617137,77.39365437672436,25
0.2,7974,93,617230,77.39561128526645,9
0.2,7975,23,617253,77.38879137412236,9
0.2,7976,95,617348,77.39099912247713,6
0.2,7977,19,617367,77.38368012033091,13
0.2,7978,93,617460,77.38563729790701,10
0.2,7979,21,617481,77.37857142857143,14
0.2,7980,92,617573,77.38040345821325,9
0.2,7981,94,617667,77.38248559258331,7
0.2,7982,16,617683,77.37479644244019,16
0.2,7983,93,617776,77.37675350701403,8
0.2,7984,95,617871,77.37896055103319,6
0.2,7985,95,617966,77.38116704232407,6
0.2,7986,95,618061,77.38337298109428,6
0.2,7987,93,618154,77.38532799198798,8
0.2,7988,91,618245,77.3870321692327,10
0.2,7989,95,618340,77.38923654568211,9
0.2,7990,24,618364,77.38255537479665,10
0.2,7991,95,618459,77.38475975975976,6
0.2,7992,23,618482,77.37795571124734,9
0.2,7993,90,618572,77.37953465098825,13
0.2,7994,90,618662,77.38111319574735,12
0.2,7995,93,618755,77.38306653326663,8
0.2,7996,95,618850,77.38526947605352,6
0.2,7997,94,618944,77.38734683670917,7
0.2,7998,82,619026,77.38792349043631,19
0.2,7999,93,619119,77.389875,8
0.2,8000,23,619142,77.38307711536058,9
0.2,8001,91,619233,77.38477880529868,11
0.2,8002,91,619324,77.38648006997376,10
0.2,8003,23,619347,77.37968515742129,9
0.2,8004,96,619443,77.38201124297314,6
0.2,8005,92,619535,77.38383712215838,9
0.2,8006,91,619626,77.38553765455227,10
0.2,8007,93,619719,77.38748751248751,8
0.2,8008,92,619811,77.38931202397303,9
0.2,8009,90,619901,77.39088639200999,12
0.2,8010,88,619989,77.39221071027337,13
0.2,8011,23,620012,77.3854218671992,9
0.2,8012,-118,619894,77.3610383127418,12
0.2,8013,96,619990,77.3633641128026,7
0.2,8014,95,620085,77.36556456643793,7
0.2,8015,95,620180,77.36776447105788,7
0.2,8016,95,620275,77.3699638268679,6
0.2,8017,-50,620225,77.35407832377152,13
0.2,8018,93,620318,77.3560294301035,8
0.2,8019,94,620412,77.35810473815461,7
0.2,8020,87,620499,77.35930681959856,14
0.2,8021,95,620594,77.36150585888805,6
0.2,8022,94,620688,77.36357970833852,7
0.2,8023,91,620779,77.36527916251246,10
0.2,8024,90,620869,77.36685358255451,11
0.2,8025,94,620963,77.36892599053077,7
0.2,8026,93,621056,77.37087330260371,8
0.2,8027,96,621152,77.37319382162431,6
0.2,8028,-44,621108,77.35807697098019,8
0.2,8029,93,621201,77.36002490660024,8
0.2,8030,92,621293,77.36184783962146,11
0.2,8031,25,621318,77.35532868525897,7
0.2,8032,23,621341,77.34856218100336,9
0.2,8033,91,621432,77.35026138909635,11
0.2,8034,94,621526,77.35233354075918,7
0.2,8035,94,621620,77.35440517670483,7
0.2,8036,92,621712,77.35622744805275,9
0.2,8037,94,621806,77.35829808410053,7
0.2,8038,90,621896,77.35987063067546,11
0.2,8039,96,621992,77.36218905472637,6
0.2,8040,26,622018,77.35580151722422,7
0.2,8041,91,622109,77.35749813479234,10
0.2,8042,95,622204,77.35969165734178,6
0.2,8043,91,622295,77.36138736946792,11
0.2,8044,92,622387,77.36320696084525,9
0.2,8045,92,622479,77.36502609992543,9
0.2,8046,94,622573,77.3670933267056,7
0.2,8047,92,622665,77.36891153081511,10
0.2,8048,94,622759,77.37097776121257,9
0.2,8049,95,622854,77.37316770186335,7
0.2,8050,-45,622809,77.3579679542914,9
0.2,8051,89,622898,77.35941381023348,12
0.2,8052,94,622992,77.36148019371663,8
0.2,8053,94,623086,77.36354606406755,7
0.2,8054,95,623181,77.3657355679702,6
0.2,8055,94,623275,77.36780039721947,8
0.2,8056,93,623368,77.36974059823756,9
0.2,8057,90,623458,77.37130801687763,11
0.2,8058,96,623554,77.37361955577614,6
0.2,8059,88,623642,77.37493796526054,13
0.2,8060,94,623736,77.37700037216226,7
0.2,8061,92,623828,77.37881419002728,9
0.2,8062,20,623848,77.37169787920129,12
0.2,8063,22,623870,77.36483134920636,10
0.2,8064,-120,623750,77.34035957842529,14
0.2,8065,93,623843,77.34230101661295,8
0.2,8066,92,623935,77.34411801165241,9
0.2,8067,21,623956,77.33713435795737,11
0.2,8068,92,624048,77.33895154294213,10
0.2,8069,90,624138,77.34052044609665,11
0.2,8070,89,624227,77.34196506009168,12
0.2,8071,96,624323,77.34427651139742,6
0.2,8072,87,624410,77.34547256286386,14
0.2,8073,94,624504,77.34753529848898,7
0.2,8074,88,624592,77.34885448916408,13
0.2,8075,22,624614,77.3420009905894,10
0.2,8076,87,624701,77.3431967314597,14
0.2,8077,92,624793,77.34501114137163,9
0.2,8078,-192,624601,77.31167223666296,17
0.2,8079,93,624694,77.31361386138614,8
0.2,8080,95,624789,77.31580249969063,6
0.2,8081,91,624880,77.31749566938876,10
0.2,8082,94,624974,77.31955956946678,7
0.2,8083,94,625068,77.32162295893123,8
0.2,8084,83,625151,77.32232529375386,18
0.2,8085,95,625246,77.32451150136038,6
0.2,8086,17,625263,77.3170520588599,15
0.2,8087,93,625356,77.31899109792285,8
0.2,8088,93,625449,77.32092965755965,8
0.2,8089,94,625543,77.3229913473424,7
0.2,8090,94,625637,77.3250525274997,7
0.2,8091,92,625729,77.32686604053386,9
0.2,8092,90,625819,77.32843197825281,12
0.2,8093,94,625913,77.3304917222634,7
0.2,8094,27,625940,77.3242742433601,6
0.2,8095,91,626031,77.32596343873517,10
0.2,8096,95,626126,77.32814622699766,6
0.2,8097,25,626151,77.32168436651025,7
0.2,8098,90,626241,77.32324978392394,11
0.2,8099,92,626333,77.32506172839506,9
0.2,8100,20,626353,77.31798543389705,12
0.2,8101,91,626444,77.31967415452975,10
0.2,8102,93,626537,77.32160928051339,8
0.2,8103,92,626629,77.32342053307009,9
0.2,8104,94,626723,77.32547809993831,7
0.2,8105,23,626746,77.31877621514927,9
0.2,8106,95,626841,77.32095719748365,7
0.2,8107,92,626933,77.32276763690183,9
0.2,8108,92,627025,77.32457762979405,9
0.2,8109,93,627118,77.32651048088779,8
0.2,8110,95,627213,77.32868943410183,8
0.2,8111,88,627301,77.33000493096647,13
0.2,8112,93,627394,77.33193639837299,8
0.2,8113,93,627487,77.33386738969682,8
0.2,8114,95,627582,77.33604436229206,7
0.2,8115,96,627678,77.33834401182848,6
0.2,8116,93,627771,77.3402735000616,8
0.2,8117,95,627866,77.34244887903425,6
0.2,8118,93,627959,77.34437738637763,8
0.2,8119,89,628048,77.34581280788177,12
0.2,8120,95,628143,77.34798670114517,6
0.2,8121,90,628233,77.34954444718049,12
0.2,8122,89,628322,77.35097870244984,13
0.2,8123,93,628415,77.35290497291975,8
0.2,8124,95,628510,77.35507692307692,7
0.2,8125,24,628534,77.34851095249816,10
0.2,8126,95,628629,77.35068290882245,6
0.2,8127,22,628651,77.34387303149606,11
0.2,8128,96,628747,77.34616804034937,6
0.2,8129,94,628841,77.34821648216482,7
0.2,8130,94,628935,77.35026442012052,7
0.2,8131,27,628962,77.34407279881948,6
0.2,8132,21,628983,77.33714496495757,11
0.2,8133,95,629078,77.33931644947135,7
0.2,8134,95,629173,77.34148740012293,6
0.2,8135,23,629196,77.33480825958702,9
0.2,8136,92,629288,77.33661054442669,9
0.2,8137,94,629382,77.33865814696486,7
0.2,8138,91,629473,77.34033665069418,12
0.2,8139,90,629563,77.34189189189189,11
0.2,8140,91,629654,77.34356958604594,10
0.2,8141,96,629750,77.34586096782117,6
0.2,8142,94,629844,77.34790617708461,7
0.2,8143,94,629938,77.34995088408644,7
0.2,8144,93,630031,77.35187231430325,8
0.2,8145,95,630126,77.35403879204517,6
0.2,8146,94,630220,77.35608199337179,7
0.2,8147,25,630245,77.34965635738831,8
0.2,8148,94,630339,77.35169959504233,8
0.2,8149,95,630434,77.35386503067485,7
0.2,8150,96,630530,77.35615261931052,6
0.2,8151,93,630623,77.35807163886163,8
0.2,8152,93,630716,77.35999018766098,8
0.2,8153,93,630809,77.36190826588178,8
0.2,8154,95,630904,77.36407112201104,7
0.2,8155,93,630997,77.36598822952428,8
0.2,8156,95,631092,77.36815005516735,6
0.2,8157,94,631186,77.37018877175778,7
0.2,8158,22,631208,77.36340237774237,10
0.2,8159,90,631298,77.36495098039215,11
0.2,8160,23,631321,77.35828942531552,10
0.2,8161,22,631343,77.35150698358245,12
0.2,8162,-49,631294,77.33602842092368,13
0.2,8163,21,631315,77.32912787849094,11
0.2,8164,94,631409,77.33116962645438,7
0.2,8165,95,631504,77.33333333333333,8
0.2,8166,91,631595,77.335006734419,10
0.2,8167,92,631687,77.33680215475025,9
0.2,8168,93,631780,77.33871954951647,8
0.2,8169,94,631874,77.340758873929,10
0.2,8170,95,631969,77.34292008322114,6
0.2,8171,95,632064,77.34508076358297,7
0.2,8172,94,632158,77.34711856111586,8
0.2,8173,92,632250,77.34891118179594,9
0.2,8174,-55,632195,77.33272171253823,19
0.2,8175,94,632289,77.3347602739726,9
0.2,8176,90,632379,77.33630915983858,11
0.2,8177,93,632472,77.33822450476889,8
0.2,8178,95,632567,77.34038391001344,6
0.2,8179,21,632588,77.33349633251834,13
0.2,8180,93,632681,77.33541131890966,8
0.2,8181,93,632774,77.33732583720362,8
0.2,8182,27,632801,77.33117438592204,6
0.2,8183,94,632895,77.33321114369501,7
0.2,8184,94,632989,77.33524740378742,8
0.2,8185,23,633012,77.32860982164671,9
0.2,8186,94,633106,77.33064614632954,7
0.2,8187,25,633131,77.32425500732779,9
0.2,8188,85,633216,77.32519233117597,16
0.2,8189,92,633308,77.32698412698413,9
0.2,8190,23,633331,77.32035160542058,10
0.2,8191,18,633349,77.3131103515625,14
0.2,8192,85,633434,77.31404857805444,16
0.2,8193,92,633526,77.31584085916525,9
0.2,8194,90,633616,77.31738865161684,11
0.2,8195,16,633632,77.30990727183992,16
0.2,8196,92,633724,77.31169940222033,9
0.2,8197,90,633814,77.31324713344718,11
0.2,8198,95,633909,77.3154043175997,6
0.2,8199,93,634002,77.31731707317073,8
0.2,8200,90,634092,77.31886355322521,11
0.2,8201,-53,634039,77.30297488417459,16
0.2,8202,90,634129,77.30452273558454,12
0.2,8203,95,634224,77.30667966845441,6
0.2,8204,96,634320,77.308957952468,6
0.2,8205,95,634415,77.31111381915672,6
0.2,8206,93,634508,77.31302546606555,8
0.2,8207,94,634602,77.31505847953217,8
0.2,8208,96,634698,77.31733463272019,6
0.2,8209,91,634789,77.3190012180268,11
0.2,8210,94,634883,77.32103276093046,7
0.2,8211,82,634965,77.32160253287871,19
0.2,8212,92,635057,77.32338974796055,13
0.2,8213,93,635150,77.32529827124422,8
0.2,8214,92,635242,77.32708460133901,9
0.2,8215,95,635337,77.32923563777995,7
0.2,8216,92,635429,77.33102105391262,10
0.2,8217,92,635521,77.33280603553176,9
0.2,8218,90,635611,77.3343472441903,11
0.2,8219,92,635703,77.33613138686131,10
0.2,8220,95,635798,77.33828001459676,6
0.2,8221,90,635888,77.339819995135,12
0.2,8222,94,635982,77.34184604159066,9
0.2,8223,21,636003,77.33499513618678,11
0.2,8224,91,636094,77.3366565349544,11
0.2,8225,96,636190,77.33892535861901,6
0.2,8226,85,636275,77.33985656983104,20
0.2,8227,92,636367,77.34163830821585,9
0.2,8228,93,636460,77.34354113501033,8
0.2,8229,95,636555,77.3456865127582,6
0.2,8230,95,636650,77.34783136921395,6
0.2,8231,95,636745,77.34997570456754,6
0.2,8232,22,636767,77.34325276326977,10
0.2,8233,23,636790,77.33665290259898,10
0.2,8234,23,636813,77.33005464480874,9
0.2,8235,93,636906,77.33195726080622,8
0.2,8236,91,636997,77.33361660798835,10
0.2,8237,93,637090,77.33551832969167,8
0.2,8238,95,637185,77.33766233766234,6
0.2,8239,93,637278,77.33956310679612,8
0.2,8240,90,637368,77.34109938114307,11
0.2,8241,91,637459,77.3427566124727,10
0.2,8242,92,637551,77.34453475676331,9
0.2,8243,96,637647,77.34679767103349,8
0.2,8244,94,637741,77.34881746513038,7
0.2,8245,93,637834,77.35071549842348,8
0.2,8246,93,637927,77.35261307141991,8
0.2,8247,96,638023,77.35487390882638,6
0.2,8248,95,638118,77.35701297126924,6
0.2,8249,93,638211,77.3589090909091,9
0.2,8250,93,638304,77.36080475093928,8
0.2,8251,95,638399,77.36294231701406,7
0.2,8252,88,638487,77.36423118865866,13
0.2,8253,93,638580,77.36612551490187,8
0.2,8254,94,638674,77.36814052089643,7
0.2,8255,92,638766,77.36991279069767,11
0.2,8256,95,638861,77.37204795930725,7
0.2,8257,93,638954,77.37394042140954,9
0.2,8258,18,638972,77.3667514226904,14
0.2,8259,12,638984,77.3588377723971,20
0.2,8260,90,639074,77.36036799418956,11
0.2,8261,94,639168,77.36238198983297,7
0.2,8262,94,639262,77.36439549800315,7
0.2,8263,26,639288,77.35818005808325,6
0.2,8264,94,639382,77.36019358741682,7
0.2,8265,95,639477,77.36232760706508,6
0.2,8266,92,639569,77.3640982218459,9
0.2,8267,24,639593,77.35764392839864,9
0.2,8268,94,639687,77.35965654855484,7
0.2,8269,92,639779,77.36142684401452,9
0.2,8270,94,639873,77.36343852013057,7
0.2,8271,94,639967,77.3654497098646,7
0.2,8272,94,640061,77.36746041339296,7
0.2,8273,91,640152,77.3691080493111,10
0.2,8274,-60,640092,77.3525075528701,23
0.2,8275,90,640182,77.35403576607057,11
0.2,8276,94,640276,77.35604687688776,7
0.2,8277,92,640368,77.3578158975598,9
0.2,8278,94,640462,77.35982606594999,7
0.2,8279,94,640556,77.36183574879227,8
0.2,8280,93,640649,77.36372418790002,8
0.2,8281,21,640670,77.35691861869114,11
0.2,8282,95,640765,77.35904865386937,6
0.2,8283,95,640860,77.36117817479479,6
0.2,8284,96,640956,77.36342788171395,6
0.2,8285,89,641045,77.36483224716389,12
0.2,8286,91,641136,77.36647761554242,10
0.2,8287,25,641161,77.36015926640927,8
0.2,8288,95,641256,77.36228736880203,7
0.2,8289,92,641348,77.36405307599517,9
0.2,8290,88,641436,77.36533590640454,13
0.2,8291,93,641529,77.36722141823444,9
0.2,8292,92,641621,77.36898589171591,10
0.2,8293,22,641643,77.36231010368941,10
0.2,8294,95,641738,77.36443640747439,7
0.2,8295,94,641832,77.36644165863066,7
0.2,8296,94,641926,77.36844642641918,7
0.2,8297,94,642020,77.3704507110147,7
0.2,8298,96,642116,77.37269550548258,6
0.2,8299,94,642210,77.37469879518072,7
0.2,8300,96,642306,77.37694253704373,6
0.2,8301,93,642399,77.37882437966755,9
0.2,8302,94,642493,77.38082620739492,7
0.2,8303,92,642585,77.38258670520231,9
0.2,8304,92,642677,77.38434677904877,9
0.2,8305,96,642773,77.38658800866843,6
0.2,8306,93,642866,77.38846755748165,8
0.2,8307,94,642960,77.39046701974002,7
0.2,8308,90,643050,77.39198459501745,11
0.2,8309,92,643142,77.39374247894104,9
0.2,8310,23,643165,77.38719768980869,10
0.2,8311,95,643260,77.3893166506256,7
0.2,8312,94,643354,77.39131480813184,7
0.2,8313,24,643378,77.38489295164783,10
0.2,8314,95,643473,77.3870114251353,7
0.2,8315,96,643569,77.38924963924964,6
0.2,8316,94,643663,77.39124684381387,7
0.2,8317,-53,643610,77.37557105073336,16
0.2,8318,93,643703,77.37744921264576,8
0.2,8319,94,643797,77.37944711538462,7
0.2,8320,95,643892,77.38156471577935,6
0.2,8321,96,643988,77.38380197068012,6
0.2,8322,96,644084,77.38603868797308,6
0.2,8323,90,644174,77.38755406054781,11
0.2,8324,94,644268,77.38954954954954,7
0.2,8325,93,644361,77.3914244535191,8
0.2,8326,91,644452,77.39305872463072,10
0.2,8327,90,644542,77.39457252641691,11
0.2,8328,92,644634,77.39632608956657,9
0.2,8329,93,644727,77.39819927971189,8
0.2,8330,95,644822,77.40031208738446,7
0.2,8331,92,644914,77.40206433029284,9
0.2,8332,92,645006,77.4038161526461,9
0.2,8333,21,645027,77.3970482361411,11
0.2,8334,92,645119,77.39880023995201,9
0.2,8335,95,645214,77.40091170825336,7
0.2,8336,94,645308,77.40290272280197,7
0.2,8337,95,645403,77.40501319261213,6
0.2,8338,90,645493,77.40652356397649,11
0.2,8339,95,645588,77.40863309352518,7
0.2,8340,12,645600,77.40079127202974,20
0.2,8341,93,645693,77.4026612323184,8
0.2,8342,94,645787,77.40465060529786,7
0.2,8343,24,645811,77.3982502396932,9
0.2,8344,88,645899,77.39952067106051,13
0.2,8345,94,645993,77.40150970524802,7
0.2,8346,-52,645941,77.38600694860429,16
0.2,8347,91,646032,77.38763775754671,10
0.2,8348,94,646126,77.38962750029944,8
0.2,8349,92,646218,77.39137724550898,9
0.2,8350,92,646310,77.39312657166806,9
0.2,8351,93,646403,77.39499521072797,8
0.2,8352,93,646496,77.3968634023704,8
0.2,8353,90,646586,77.39837203734737,11
0.2,8354,92,646678,77.4001196888091,9
0.2,8355,88,646766,77.40138822403064,14
0.2,8356,91,646857,77.4030154361613,10
0.2,8357,92,646949,77.4047619047619,10
0.2,8358,94,647043,77.40674721856682,7
0.2,8359,22,647065,77.40011961722487,10
0.2,8360,93,647158,77.40198540844396,8
0.2,8361,95,647253,77.4040899306386,6
0.2,8362,96,647349,77.40631352385508,6
0.2,8363,92,647441,77.40805834528933,9
0.2,8364,91,647532,77.40968320382547,10
0.2,8365,94,647626,77.41166626822854,7
0.2,8366,94,647720,77.41364885861121,7
0.2,8367,94,647814,77.4156309751434,7
0.2,8368,25,647839,77.40936790536503,8
0.2,8369,94,647933,77.41135005973716,7
0.2,8370,95,648028,77.4134512005734,6
0.2,8371,89,648117,77.41483516483517,16
0.2,8372,91,648208,77.41645766153111,10
0.2,8373,93,648301,77.4183186052066,8
0.2,8374,94,648395,77.42029850746269,8
0.2,8375,23,648418,77.41380133715377,9
0.2,8376,92,648510,77.41554255700132,9
0.2,8377,90,648600,77.4170446407257,11
0.2,8378,87,648687,77.41818832796277,14
0.2,8379,91,648778,77.4198090692124,10
0.2,8380,86,648864,77.42083283617707,15
0.2,8381,23,648887,77.41434025292293,10
0.2,8382,-49,648838,77.39926040796851,12
0.2,8383,93,648931,77.4011211832061,9
0.2,8384,17,648948,77.39391771019677,15
0.2,8385,95,649043,77.39601717147627,6
0.2,8386,95,649138,77.39811613210922,8
0.2,8387,90,649228,77.3996185026228,11
0.2,8388,93,649321,77.40147812611754,8
0.2,8389,89,649410,77.40286054827175,12
0.2,8390,95,649505,77.40495769276606,6
0.2,8391,92,649597,77.4066968541468,9
0.2,8392,18,649615,77.39961872989396,14
0.2,8393,90,649705,77.40111984751013,11
0.2,8394,95,649800,77.40321620011912,6
0.2,8395,18,649818,77.3961410195331,14
0.2,8396,24,649842,77.38978206502323,8
0.2,8397,94,649936,77.39175994284354,8
0.2,8398,90,650026,77.3932611025122,11
0.2,8399,92,650118,77.395,9
0.2,8400,90,650208,77.39650041661707,11
0.2,8401,95,650303,77.39859557248275,6
0.2,8402,90,650393,77.40009520409377,11
0.2,8403,93,650486,77.40195145168967,9
0.2,8404,93,650579,77.40380725758477,8
0.2,8405,95,650674,77.40590054722817,7
0.2,8406,92,650766,77.40763649339836,10
0.2,8407,86,650852,77.40865842055186,15
0.2,8408,26,650878,77.40254489237722,7
0.2,8409,92,650970,77.40428061831153,9
0.2,8410,94,651064,77.40625371537273,7
0.2,8411,95,651159,77.4083452211127,6
0.2,8412,96,651255,77.41055509330798,6
0.2,8413,93,651348,77.41240789160922,8
0.2,8414,92,651440,77.41414141414141,9
0.2,8415,90,651530,77.41563688212928,11
0.2,8416,95,651625,77.41772603065225,6
0.2,8417,93,651718,77.41957709669755,8
0.2,8418,87,651805,77.42071504929326,14
0.2,8419,92,651897,77.42244655581948,10
0.2,8420,92,651989,77.42417765111031,9
0.2,8421,94,652083,77.42614580859653,7
0.2,8422,92,652175,77.42787605366259,11
0.2,8423,95,652270,77.42996201329535,6
0.2,8424,93,652363,77.43181008902077,9
0.2,8425,93,652456,77.43365772608593,9
0.2,8426,95,652551,77.43574225703097,7
0.2,8427,24,652575,77.42940199335548,8
0.2,8428,96,652671,77.43160517261835,7
0.2,8429,23,652694,77.42514827995255,10
0.2,8430,91,652785,77.42675839164987,11
0.2,8431,84,652869,77.42753795066413,17
0.2,8432,88,652957,77.42879165184395,13
0.2,8433,94,653051,77.43075646193977,7
0.2,8434,18,653069,77.42371072910493,14
0.2,8435,95,653164,77.4257942152679,8
0.2,8436,-53,653111,77.41033542728458,16
0.2,8437,93,653204,77.41218298174923,8
0.2,8438,20,653224,77.40537978433464,13
0.2,8439,94,653318,77.40734597156398,7
0.2,8440,90,653408,77.40883781542472,11
0.2,8441,26,653434,77.40274816394219,7
0.2,8442,89,653523,77.40412175766907,12
0.2,8443,92,653615,77.40585030791094,9
0.2,8444,92,653707,77.40757844878627,10
0.2,8445,96,653803,77.40977977740943,6
0.2,8446,17,653820,77.40262815200663,15
0.2,8447,94,653914,77.4045928030303,7
0.2,8448,94,654008,77.40655698899278,7
0.2,8449,16,654024,77.3992899408284,16
0.2,8450,94,654118,77.4012542894332,8
0.2,8451,93,654211,77.40309985802178,10
0.2,8452,94,654305,77.40506329113924,7
0.2,8453,18,654323,77.39803643245801,14
0.2,8454,89,654412,77.39940863394442,12
0.2,8455,94,654506,77.40137180700094,9
0.2,8456,93,654599,77.40321627054512,9
0.2,8457,94,654693,77.40517852920313,9
0.2,8458,93,654786,77.40702210663198,8
0.2,8459,93,654879,77.40886524822695,8
0.2,8460,23,654902,77.40243470039003,10
0.2,8461,94,654996,77.40439612384779,8
0.2,8462,94,655090,77.40635708377644,7
0.2,8463,96,655186,77.4085538752363,6
0.2,8464,23,655209,77.40212640283521,10
0.2,8465,94,655303,77.40408693597921,7
0.2,8466,94,655397,77.40604700602339,7
0.2,8467,94,655491,77.40800661313179,7
0.2,8468,93,655584,77.40984767977329,8
0.2,8469,91,655675,77.41145218417945,10
0.2,8470,96,655771,77.41364655884783,6
0.2,8471,19,655790,77.40675165250236,14
0.2,8472,91,655881,77.40835595420748,10
0.2,8473,25,655906,77.40217134765165,9
0.2,8474,16,655922,77.39492625368732,20
0.2,8475,93,656015,77.39676734308637,8
0.2,8476,92,656107,77.3984900318509,9
0.2,8477,81,656188,77.39891483840529,20
0.2,8478,94,656282,77.4008727444274,7
0.2,8479,94,656376,77.40283018867925,7
0.2,8480,92,656468,77.40455135007664,9
0.2,8481,92,656560,77.40627210563547,9
0.2,8482,93,656653,77.40811033832371,8
0.2,8483,93,656746,77.40994813767091,8
0.2,8484,95,656841,77.4120212139069,7
0.2,8485,22,656863,77.40549139759604,11
0.2,8486,96,656959,77.40768233769295,6
0.2,8487,94,657053,77.4096371347785,7
0.2,8488,88,657141,77.41088467428436,13
0.2,8489,27,657168,77.40494699646644,6
0.2,8490,95,657263,77.40701919679661,6
0.2,8491,92,657355,77.40873763542157,9
0.2,8492,-52,657303,77.39350052984811,15
0.2,8493,92,657395,77.39522015540382,11
0.2,8494,92,657487,77.39693937610359,10
0.2,8495,95,657582,77.39901129943503,6
0.2,8496,94,657676,77.400965046487,7
0.2,8497,93,657769,77.40280065897858,8
0.2,8498,92,657861,77.40451817860925,9
0.2,8499,94,657955,77.4064705882353,7
0.2,8500,13,657968,77.39889424773556,20
0.2,8501,95,658063,77.40096447894614,7
0.2,8502,92,658155,77.4026814065624,9
0.2,8503,93,658248,77.40451552210725,8
0.2,8504,89,658337,77.40587889476778,13
0.2,8505,88,658425,77.40712438278862,13
0.2,8506,94,658519,77.409074879511,7
0.2,8507,94,658613,77.41102491772449,7
0.2,8508,94,658707,77.41297449759078,7
0.2,8509,92,658799,77.41468860164512,9
0.2,8510,95,658894,77.41675478792152,8
0.2,8511,91,658985,77.41835056390977,10
0.2,8512,96,659081,77.42053330200869,6
0.2,8513,95,659176,77.42259807376087,8
0.2,8514,93,659269,77.42442748091604,8
0.2,8515,92,659361,77.42613903240958,9
0.2,8516,91,659452,77.42773276975461,11
0.2,8517,88,659540,77.42897393754403,14
0.2,8518,89,659629,77.43033219861486,12
0.2,8519,89,659718,77.43169014084508,12
0.2,8520,23,659741,77.4253021945781,10
0.2,8521,93,659834,77.42712978174137,8
0.2,8522,88,659922,77.42837029215065,13
0.2,8523,94,660016,77.43031440638198,7
0.2,8524,90,660106,77.43178885630499,11
0.2,8525,95,660201,77.4338494018297,6
0.2,8526,90,660291,77.43532309135686,11
0.2,8527,92,660383,77.43703095684803,9
0.2,8528,94,660477,77.43897291593387,7
0.2,8529,95,660572,77.44103165298945,8
0.2,8530,91,660663,77.44262102918766,10
0.2,8531,92,660755,77.44432723863103,10
0.2,8532,91,660846,77.44591585608813,10
0.2,8533,94,660940,77.44785563627842,8
0.2,8534,93,661033,77.44967779730521,8
0.2,8535,94,661127,77.45161668228678,7
0.2,8536,94,661221,77.45355511303737,7
0.2,8537,94,661315,77.45549308971655,7
0.2,8538,90,661405,77.45696217355662,12
0.2,8539,94,661499,77.45889929742388,8
0.2,8540,19,661518,77.45205479452055,15
0.2,8541,26,661544,77.44603137438538,6
0.2,8542,96,661640,77.44820320730423,6
0.2,8543,94,661734,77.45014044943821,7
0.2,8544,90,661824,77.45160912814511,11
0.2,8545,94,661918,77.45354551837117,7
0.2,8546,93,662011,77.45536445536446,10
0.2,8547,25,662036,77.44922788956481,7
0.2,8548,93,662129,77.45104690607089,8
0.2,8549,96,662225,77.453216374269,6
0.2,8550,95,662320,77.45526838966202,6
0.2,8551,22,662342,77.44878391019644,12
0.2,8552,94,662436,77.45071904594879,8
0.2,8553,94,662530,77.45265372924948,8
0.2,8554,93,662623,77.45447106954997,8
0.2,8555,87,662710,77.45558672276765,14
0.2,8556,94,662804,77.4575201589342,7
0.2,8557,92,662896,77.45921944379528,9
0.2,8558,95,662991,77.46126883981773,6
0.2,8559,25,663016,77.45514018691588,8
0.2,8560,90,663106,77.45660553673636,11
0.2,8561,95,663201,77.45865451997197,7
0.2,8562,96,663297,77.46081980614271,6
0.2,8563,91,663388,77.46240074731433,10
0.2,8564,94,663482,77.46433158201985,7
0.2,8565,95,663577,77.46637870651412,7
0.2,8566,22,663599,77.45990428388001,12
0.2,8567,91,663690,77.46148459383754,10
0.2,8568,92,663782,77.46318123468316,11
0.2,8569,94,663876,77.46511085180863,7
0.2,8570,95,663971,77.46715669116789,6
0.2,8571,95,664066,77.46920205319645,7
0.2,8572,95,664161,77.47124693806136,6
0.2,8573,95,664256,77.47329134592955,8
0.2,8574,93,664349,77.47510204081632,10
0.2,8575,92,664441,77.47679570895522,9
0.2,8576,92,664533,77.4784889821616,9
0.2,8577,94,664627,77.48041501515505,8
0.2,8578,96,664723,77.48257372654156,6
0.2,8579,90,664813,77.48403263403263,11
0.2,8580,90,664903,77.48549120149167,11
0.2,8581,90,664993,77.48694942903752,11
0.2,8582,25,665018,77.48083420715368,8
0.2,8583,94,665112,77.48275862068965,7
0.2,8584,23,665135,77.47641234711706,9
0.2,8585,93,665228,77.4782203587235,9
0.2,8586,93,665321,77.48002794922557,8
0.2,8587,92,665413,77.48171867722404,9
0.2,8588,94,665507,77.48364186750494,7
0.2,8589,94,665601,77.48556461001164,8
0.2,8590,93,665694,77.48737050401583,8
0.2,8591,95,665789,77.48940875232775,6
0.2,8592,91,665880,77.4909810310718,11
0.2,8593,93,665973,77.49278566441704,9
0.2,8594,95,666068,77.49482257126236,6
0.2,8595,93,666161,77.49662633783154,9
0.2,8596,20,666181,77.48993835058741,12
0.2,8597,94,666275,77.49185857176087,7
0.2,8598,91,666366,77.49342946854286,10
0.2,8599,94,666460,77.4953488372093,7
0.2,8600,90,666550,77.49680269736078,11
0.2,8601,94,666644,77.49872122762149,7
0.2,8602,93,666737,77.50052307334651,9
0.2,8603,93,666830,77.50232450023245,8
0.2,8604,96,666926,77.50447414294015,6
0.2,8605,94,667020,77.50639089007669,8
0.2,8606,93,667113,77.50819100731962,8
0.2,8607,93,667206,77.5099907063197,8
0.2,8608,91,667297,77.51155767220351,11
0.2,8609,94,667391,77.51347270615564,7
0.2,8610,94,667485,77.51538729531994,7
0.2,8611,91,667576,77.51695308871342,10
0.2,8612,96,667672,77.51909903634042,6
0.2,8613,87,667759,77.52019967494776,14
0.2,8614,93,667852,77.52199651770168,8
0.2,8615,86,667938,77.52298050139275,15
0.2,8616,88,668026,77.52419635604039,13
0.2,8617,94,668120,77.52610814574147,8
0.2,8618,92,668212,77.52778744633949,10
0.2,8619,93,668305,77.52958236658932,8
0.2,8620,90,668395,77.53102888296021,11
0.2,8621,92,668487,77.53270702853166,9
0.2,8622,91,668578,77.53426881595732,11
0.2,8623,92,668670,77.53594619666048,9
0.2,8624,90,668760,77.53739130434782,11
0.2,8625,93,668853,77.53918386274056,8
0.2,8626,21,668874,77.532630114756,11
0.2,8627,94,668968,77.53453871117293,7
0.2,8628,19,668987,77.52775524394484,13
0.2,8629,95,669082,77.52977983777521,6
0.2,8630,92,669174,77.53145637817171,9
0.2,8631,85,669259,77.53232159406858,16
0.2,8632,11,669270,77.52461484999421,23
0.2,8633,-52,669218,77.50961315728514,16
0.2,8634,24,669242,77.50341632889403,8
0.2,8635,-47,669195,77.4889995368226,11
0.2,8636,92,669287,77.49067963413222,9
0.2,8637,21,669308,77.48413984718685,11
0.2,8638,88,669396,77.48535710151639,13
0.2,8639,94,669490,77.48726851851852,7
0.2,8640,92,669582,77.48894803842148,12
0.2,8641,93,669675,77.49074288359176,9
0.2,8642,91,669766,77.49230591229897,10
0.2,8643,96,669862,77.49444701527071,6
0.2,8644,93,669955,77.49624060150376,9
0.2,8645,93,670048,77.49803377284293,8
0.2,8646,21,670069,77.49149994217647,11
0.2,8647,90,670159,77.49294634597595,11
0.2,8648,93,670252,77.4947392762169,8
0.2,8649,93,670345,77.49653179190751,8
0.2,8650,94,670439,77.49843948676454,7
0.2,8651,94,670533,77.50034674063801,7
0.2,8652,91,670624,77.50190685311453,11
0.2,8653,91,670715,77.50346660503813,10
0.2,8654,96,670811,77.50560369728481,6
0.2,8655,23,670834,77.49930683918669,10
0.2,8656,96,670930,77.50144391821647,6
0.2,8657,93,671023,77.503234003234,8
0.2,8658,94,671117,77.505139161566,8
0.2,8659,95,671212,77.50715935334873,6
0.2,8660,94,671306,77.5090636185198,7
0.2,8661,94,671400,77.51096744400832,7
0.2,8662,95,671495,77.51298626341914,6
0.2,8663,95,671590,77.51500461680517,6
0.2,8664,95,671685,77.51702250432776,6
0.2,8665,23,671708,77.51073159473806,9
0.2,8666,93,671801,77.51251874927887,8
0.2,8667,94,671895,77.51442085832949,7
0.2,8668,94,671989,77.51632252855,7
0.2,8669,95,672084,77.51833910034603,6
0.2,8670,93,672177,77.52012455310806,9
0.2,8671,24,672201,77.51395295202953,9
0.2,8672,90,672291,77.51539259771705,11
0.2,8673,91,672382,77.51694719852432,10
0.2,8674,93,672475,77.51873198847262,8
0.2,8675,88,672563,77.51994006454588,13
0.2,8676,92,672655,77.52160885098536,9
0.2,8677,20,672675,77.51498041023277,13
0.2,8678,94,672769,77.51687982486462,7
0.2,8679,-48,672721,77.50241935483871,11
0.2,8680,24,672745,77.49625619168299,9
0.2,8681,96,672841,77.49838746832528,6
0.2,8682,93,672934,77.50017275135322,8
0.2,8683,91,673025,77.50172731460157,10
0.2,8684,89,673114,77.50305123776626,13
0.2,8685,23,673137,77.49677642182823,12
0.2,8686,92,673229,77.49844595372396,9
0.2,8687,94,673323,77.5003453038674,7
0.2,8688,93,673416,77.50212912878352,9
0.2,8689,92,673508,77.50379746835443,12
0.2,8690,88,673596,77.5050051777701,13
0.2,8691,95,673691,77.50701794753796,6
0.2,8692,90,673781,77.50845507879903,11
0.2,8693,93,673874,77.51023694501956,8
0.2,8694,24,673898,77.50408280621046,8
0.2,8695,91,673989,77.50563477460902,10
0.2,8696,91,674080,77.50718638611015,10
0.2,8697,24,674104,77.50103472062543,10
0.2,8698,95,674199,77.50304632716404,8
0.2,8699,94,674293,77.50494252873563,7
0.2,8700,95,674388,77.50695322376738,6
0.2,8701,90,674478,77.50838887612043,12
0.2,8702,87,674565,77.5094794898311,14
0.2,8703,96,674661,77.51160386029412,7
0.2,8704,23,674684,77.50534175761057,9
0.2,8705,92,674776,77.50700666207213,9
0.2,8706,92,674868,77.50867118410474,9
0.2,8707,91,674959,77.5102204869086,11
0.2,8708,94,675053,77.51211390515559,7
0.2,8709,95,675148,77.51412169919632,7
0.2,8710,94,675242,77.51601423487544,8
0.2,8711,92,675334,77.51767676767676,9
0.2,8712,94,675428,77.51956846092047,8
0.2,8713,91,675519,77.52111544640807,10
0.2,8714,92,675611,77.52277682157201,11
0.2,8715,92,675703,77.5244378155117,9
0.2,8716,23,675726,77.51818286107606,9
0.2,8717,93,675819,77.51995870612525,9
0.2,8718,92,675911,77.521619451772,9
0.2,8719,94,676005,77.52350917431193,8
0.2,8720,91,676096,77.52505446623094,10
0.2,8721,92,676188,77.52671405640908,9
0.2,8722,95,676283,77.52871718445489,7
0.2,8723,23,676306,77.52246675836773,9
0.2,8724,96,676402,77.52458452722063,6
0.2,8725,95,676497,77.52658721063489,6
0.2,8726,94,676591,77.52847484817234,8
0.2,8727,89,676680,77.52978918423464,12
0.2,8728,95,676775,77.53179058311376,7
0.2,8729,92,676867,77.53344788087057,9
0.2,8730,93,676960,77.53521933340969,8
0.2,8731,93,677053,77.53699038021072,9
0.2,8732,93,677146,77.53876102141304,8
0.2,8733,95,677241,77.54076024730936,6
0.2,8734,94,677335,77.54264453348597,8
0.2,8735,96,677431,77.54475732600733,6
0.2,8736,95,677526,77.54675517912327,7
0.2,8737,94,677620,77.54863813229572,7
0.2,8738,93,677713,77.55040622496853,10
0.2,8739,94,677807,77.55228832951946,7
0.2,8740,87,677894,77.55336917972772,14
0.2,8741,93,677987,77.55513612445665,8
0.2,8742,92,678079,77.55678828777307,9
0.2,8743,92,678171,77.55844007319304,9
0.2,8744,94,678265,77.56032018296169,7
0.2,8745,92,678357,77.56197118682826,11
0.2,8746,95,678452,77.56396478792729,7
0.2,8747,94,678546,77.56584362139918,8
0.2,8748,92,678638,77.56749342782032,9
0.2,8749,24,678662,77.56137142857143,8
0.2,8750,94,678756,77.56324991429551,7
0.2,8751,94,678850,77.56512797074954,7
0.2,8752,93,678943,77.56689135153661,8
0.2,8753,94,679037,77.56876856294265,7
0.2,8754,92,679129,77.57041690462593,9
0.2,8755,25,679154,77.56441297396071,9
0.2,8756,96,679250,77.56651821400023,6
0.2,8757,94,679344,77.5683946106417,7
0.2,8758,89,679433,77.56969973741295,12
0.2,8759,95,679528,77.57168949771689,6
0.2,8760,92,679620,77.5733363771259,9
0.2,8761,96,679716,77.57543939739786,6
0.2,8762,18,679734,77.56864087641219,15
0.2,8763,24,679758,77.56252852578731,8
0.2,8764,95,679853,77.56451796919566,6
0.2,8765,93,679946,77.56627880447182,9
0.2,8766,26,679972,77.56039694308201,8
0.2,8767,91,680063,77.56192974452554,10
0.2,8768,22,680085,77.5555935682518,10
0.2,8769,89,680174,77.55689851767389,12
0.2,8770,88,680262,77.5580891574507,13
0.2,8771,93,680355,77.55984952120383,8
0.2,8772,94,680449,77.56172346973669,7
0.2,8773,87,680536,77.56279917939366,14
0.2,8774,94,680630,77.56467236467236,7
0.2,8775,85,680715,77.5655195989061,18
0.2,8776,94,680809,77.56739204739661,9
0.2,8777,90,680899,77.56880838459786,11
0.2,8778,93,680992,77.5705661237043,8
0.2,8779,94,681086,77.57243735763097,8
0.2,8780,96,681182,77.57453592984854,6
0.2,8781,91,681273,77.57606467774994,10
0.2,8782,92,681365,77.57770693384948,9
0.2,8783,11,681376,77.57012750455374,23
0.2,8784,95,681471,77.57211155378486,6
0.2,8785,92,681563,77.5737536990667,9
0.2,8786,92,681655,77.57539547058154,9
0.2,8787,-117,681538,77.55325443786982,12
0.2,8788,91,681629,77.55478438957788,10
0.2,8789,96,681725,77.55688282138794,6
0.2,8790,95,681820,77.55886702309179,6
0.2,8791,16,681836,77.55186533212012,16
0.2,8792,91,681927,77.55339474582054,10
0.2,8793,94,682021,77.5552649533773,7
0.2,8794,93,682114,77.5570210346788,8
0.2,8795,94,682208,77.55889040472942,8
0.2,8796,25,682233,77.55291576673866,8
0.2,8797,94,682327,77.55478517844965,7
0.2,8798,-50,682277,77.54028866916696,13
0.2,8799,91,682368,77.54181818181819,10
0.2,8800,92,682460,77.54346097034428,9
0.2,8801,92,682552,77.54510338559419,9
0.2,8802,94,682646,77.54697262296945,7
0.2,8803,94,682740,77.54884143571104,8
0.2,8804,94,682834,77.55070982396366,7
0.2,8805,89,682923,77.55200999318646,12
0.2,8806,94,683017,77.55387759736573,7
0.2,8807,94,683111,77.55574477747503,8
0.2,8808,95,683206,77.55772505392213,6
0.2,8809,96,683302,77.55981838819524,6
0.2,8810,83,683385,77.56043581886279,18
0.2,8811,93,683478,77.56218792555606,8
0.2,8812,92,683570,77.5638261658913,9
0.2,8813,96,683666,77.56591785795325,6
0.2,8814,94,683760,77.5677821894498,7
0.2,8815,21,683781,77.56136569872959,13
0.2,8816,93,683874,77.5631167063627,8
0.2,8817,94,683968,77.56498072125198,7
0.2,8818,95,684063,77.56695770495521,6
0.2,8819,95,684158,77.56893424036281,6
0.2,8820,95,684253,77.57091032762726,6
0.2,8821,25,684278,77.56495125821809,8
0.2,8822,27,684305,77.55922021987986,6
0.2,8823,94,684399,77.56108340888485,7
0.2,8824,93,684492,77.5628328611898,8
0.2,8825,95,684587,77.56480852028099,7
0.2,8826,92,684679,77.56644386541294,9
0.2,8827,93,684772,77.56819211599456,8
0.2,8828,95,684867,77.570166496772,6
0.2,8829,20,684887,77.56364665911664,12
0.2,8830,89,684976,77.56494168270864,12
0.2,8831,94,685070,77.56680253623189,7
0.2,8832,96,685166,77.56888939205253,6
0.2,8833,91,685257,77.57040978039393,10
0.2,8834,94,685351,77.57226938313526,7
0.2,8835,91,685442,77.57378904481666,10
0.2,8836,24,685466,77.56772660405115,9
0.2,8837,-49,685417,77.55340574790677,13
0.2,8838,91,685508,77.55492702794433,10
0.2,8839,94,685602,77.55678733031674,7
0.2,8840,95,685697,77.55876032123064,7
0.2,8841,93,685790,77.56050667269848,8
0.2,8842,90,685880,77.56191337781296,11
0.2,8843,93,685973,77.56365897783809,9
0.2,8844,92,686065,77.56529112492935,9
0.2,8845,84,686149,77.56601853945286,17
0.2,8846,93,686242,77.56776308353115,8
0.2,8847,95,686337,77.56973327305606,6
0.2,8848,94,686431,77.57159001017064,7
0.2,8849,91,686522,77.57310734463277,10
0.2,8850,94,686616,77.5749632809852,7
0.2,8851,93,686709,77.57670582919114,8
0.2,8852,93,686802,77.57844798373432,9
0.2,8853,16,686818,77.57149311045855,17
0.2,8854,94,686912,77.5733483907397,7
0.2,8855,93,687005,77.57509033423668,8
0.2,8856,93,687098,77.57683188438523,8
0.2,8857,94,687192,77.57868593361933,7
0.2,8858,20,687212,77.572186477029,12
0.2,8859,91,687303,77.5737020316027,10
0.2,8860,92,687395,77.57533009818304,10
0.2,8861,26,687421,77.5695102685624,8
0.2,8862,94,687515,77.57136409793523,7
0.2,8863,95,687610,77.57333032490975,6
0.2,8864,-49,687561,77.5590524534687,13
0.2,8865,95,687656,77.56101962553575,7
0.2,8866,24,687680,77.5549791361227,8
0.2,8867,21,687701,77.54860171402797,12
0.2,8868,90,687791,77.55000563761416,11
0.2,8869,96,687887,77.5520856820744,6
0.2,8870,94,687981,77.55393980385526,7
0.2,8871,91,688072,77.55545536519386,10
0.2,8872,94,688166,77.5573086892821,7
0.2,8873,93,688259,77.55904890691909,8
0.2,8874,94,688353,77.5609014084507,7
0.2,8875,93,688446,77.56264082920234,8
0.2,8876,93,688539,77.56437985806015,8
0.2,8877,93,688632,77.56611849515657,9
0.2,8878,95,688727,77.56808199121522,6
0.2,8879,92,688819,77.5697072072072,9
0.2,8880,24,688843,77.56367526179484,8
0.2,8881,93,688936,77.5654131952263,9
0.2,8882,24,688960,77.55938309129799,9
0.2,8883,90,689050,77.56078343088699,11
0.2,8884,91,689141,77.56229600450197,10
0.2,8885,93,689234,77.56403331082602,8
0.2,8886,94,689328,77.5658827500844,7
0.2,8887,27,689355,77.56019351935194,7
0.2,8888,93,689448,77.56193047586905,9
0.2,8889,90,689538,77.56332958380203,11
0.2,8890,27,689565,77.55764255989203,6
0.2,8891,90,689655,77.55904183535762,11
0.2,8892,18,689673,77.55234454064995,14
0.2,8893,87,689760,77.55340679109511,14
0.2,8894,24,689784,77.54738617200674,8
0.2,8895,19,689803,77.5408048561151,13
0.2,8896,94,689897,77.54265482746993,7
0.2,8897,95,689992,77.544616767813,6
0.2,8898,86,690078,77.54556691763119,15
0.2,8899,94,690172,77.54741573033708,7
0.2,8900,95,690267,77.54937647455343,6
0.2,8901,90,690357,77.5507751067176,11
0.2,8902,90,690447,77.5521734246883,11
0.2,8903,93,690540,77.55390835579514,8
0.2,8904,92,690632,77.55553060078607,9
0.2,8905,94,690726,77.55737704918033,7
0.2,8906,94,690820,77.55922308296846,9
0.2,8907,92,690912,77.56084418500224,9
0.2,8908,94,691006,77.56268941519811,7
0.2,8909,20,691026,77.55622895622895,13
0.2,8910,92,691118,77.55784984850185,9
0.2,8911,91,691209,77.55935816876122,10
0.2,8912,94,691303,77.56120273757433,7
0.2,8913,94,691397,77.5630468925286,7
0.2,8914,91,691488,77.56455412226585,11
0.2,8915,-54,691434,77.54979811574697,17
0.2,8916,92,691526,77.55141863855557,9
0.2,8917,23,691549,77.54530163713837,9
0.2,8918,93,691642,77.54703442089921,8
0.2,8919,21,691663,77.54069506726458,12
0.2,8920,-46,691617,77.52684676605762,10
0.2,8921,20,691637,77.52039901367407,12
0.2,8922,94,691731,77.52224588143001,7
0.2,8923,91,691822,77.52375616315554,12
0.2,8924,91,691913,77.52526610644257,10
0.2,8925,90,692003,77.52666367913959,11
0.2,8926,22,692025,77.52044359807326,11
0.2,8927,18,692043,77.51377688172043,14
0.2,8928,84,692127,77.51450330384142,17
0.2,8929,23,692150,77.50839865621501,9
0.2,8930,94,692244,77.51024521330199,7
0.2,8931,95,692339,77.51220331392746,7
0.2,8932,96,692435,77.51427292063137,6
0.2,8933,93,692528,77.51600626818895,8
0.2,8934,93,692621,77.51773922775601,8
0.2,8935,23,692644,77.51163831692033,9
0.2,8936,23,692667,77.5055387713998,9
0.2,8937,94,692761,77.5073842022824,7
0.2,8938,95,692856,77.50934108960733,6
0.2,8939,87,692943,77.51040268456376,14
0.2,8940,94,693037,77.51224695224248,8
0.2,8941,94,693131,77.51409080742563,7
0.2,8942,92,693223,77.51571061165157,9
0.2,8943,92,693315,77.51733005366727,9
0.2,8944,92,693407,77.51894913359419,9
0.2,8945,96,693503,77.52101497876146,6
0.2,8946,23,693526,77.51492120263775,9
0.2,8947,90,693616,77.51631649530621,11
0.2,8948,96,693712,77.51838194211643,7
0.2,8949,21,693733,77.51206703910614,11
0.2,8950,94,693827,77.51390906044017,7
0.2,8951,23,693850,77.50781948168007,10
0.2,8952,92,693942,77.50943817714733,9
0.2,8953,91,694033,77.51094482912664,10
0.2,8954,25,694058,77.50508096035735,10
0.2,8955,95,694153,77.50703439035284,7
0.2,8956,93,694246,77.50876409512114,9
0.2,8957,25,694271,77.50290243357892,8
0.2,8958,95,694366,77.50485545261748,6
0.2,8959,93,694459,77.50658482142858,8
0.2,8960,94,694553,77.508425398951,8
0.2,8961,95,694648,77.51037714795804,6
0.2,8962,94,694742,77.51221689166573,9
0.2,8963,90,694832,77.5136099955377,11
0.2,8964,93,694925,77.51533742331289,8
0.2,8965,94,695019,77.51717599821548,7
0.2,8966,94,695113,77.51901416304227,7
0.2,8967,96,695209,77.52107493309545,6
0.2,8968,91,695300,77.52257776786709,10
0.2,8969,93,695393,77.52430323299889,8
0.2,8970,20,695413,77.51789098205329,12
0.2,8971,96,695509,77.51995095853768,6
0.2,8972,95,695604,77.5218990304246,6
0.2,8973,91,695695,77.52340093603745,13
0.2,8974,95,695790,77.52534818941504,7
0.2,8975,91,695881,77.52684937611409,10
0.2,8976,22,695903,77.52066391890386,12
0.2,8977,94,695997,77.52249944308309,7
0.2,8978,91,696088,77.5240004454839,10
0.2,8979,93,696181,77.52572383073496,8
0.2,8980,96,696277,77.52778087072709,6
0.2,8981,89,696366,77.52905811623246,12
0.2,8982,-45,696321,77.51541801180007,10
0.2,8983,26,696347,77.50968388245771,7
0.2,8984,93,696440,77.51140790205899,9
0.2,8985,95,696535,77.51335410638771,6
0.2,8986,95,696630,77.51529987760098,7
0.2,8987,92,696722,77.51691143747219,9
0.2,8988,22,696744,77.51073534319724,11
0.2,8989,91,696835,77.51223581757509,10
0.2,8990,91,696926,77.5137359581804,11
0.2,8991,88,697014,77.51490213523131,14
0.2,8992,24,697038,77.50895140664962,9
0.2,8993,20,697058,77.50255726039582,14
0.2,8994,-55,697003,77.48782657031684,18
0.2,8995,96,697099,77.48988439306359,6
0.2,8996,21,697120,77.48360564632655,12
0.2,8997,94,697214,77.48544120915759,8
0.2,8998,94,697308,77.48727636404045,7
0.2,8999,25,697333,77.48144444444445,8
0.2,9000,96,697429,77.48350183312965,6
0.2,9001,95,697524,77.48544767829371,7
0.2,9002,95,697619,77.48739309119182,8
0.2,9003,94,697713,77.48922701021768,7
0.2,9004,-47,697666,77.4754025541366,11
0.2,9005,93,697759,77.47712636020431,9
0.2,9006,91,697850,77.47862773398468,10
0.2,9007,94,697944,77.48046181172292,7
0.2,9008,96,698040,77.48251748251748,6
0.2,9009,95,698135,77.48446170921198,6
0.2,9010,96,698231,77.48651647985795,6
0.2,9011,95,698326,77.488459831336,7
0.2,9012,92,698418,77.49006989903472,9
0.2,9013,92,698510,77.49167960949634,11
0.2,9014,-47,698463,77.47787021630616,11
0.2,9015,93,698556,77.4795918367347,11
0.2,9016,93,698649,77.48131307530221,8
0.2,9017,90,698739,77.48270126413838,11
0.2,9018,94,698833,77.4845326532875,9
0.2,9019,91,698924,77.4860310421286,10
0.2,9020,94,699018,77.48786165613568,7
0.2,9021,27,699045,77.48226557304368,6
0.2,9022,91,699136,77.48376371495068,10
0.2,9023,90,699226,77.48515070921985,11
0.2,9024,21,699247,77.47889196675901,11
0.2,9025,92,699339,77.48050077553734,9
0.2,9026,93,699432,77.48222000664673,8
0.2,9027,10,699442,77.47474523704032,24
0.2,9028,24,699466,77.4688226824676,8
0.2,9029,88,699554,77.46998892580288,13
0.2,9030,91,699645,77.47148709998892,10
0.2,9031,94,699739,77.47331709477413,7
0.2,9032,93,699832,77.47503597918742,9
0.2,9033,91,699923,77.4765330971884,10
0.2,9034,92,700015,77.4781405644715,10
0.2,9035,92,700107,77.47974767596281,9
0.2,9036,92,700199,77.48135443178046,9
0.2,9037,93,700292,77.48307147599026,9
0.2,9038,27,700319,77.47748644761589,6
0.2,9039,93,700412,77.479203539823,8
0.2,9040,93,700505,77.48092025218449,9
0.2,9041,21,700526,77.47467374474674,12
0.2,9042,93,700619,77.47639057834789,8
0.2,9043,91,700710,77.47788589119858,10
0.2,9044,22,700732,77.4717523493643,10
0.2,9045,89,700821,77.47302675215565,12
0.2,9046,79,700900,77.4731955344313,22
0.2,9047,94,700994,77.47502210433245,8
0.2,9048,91,701085,77.47651674218146,10
0.2,9049,91,701176,77.47801104972376,10
0.2,9050,21,701197,77.47177107501933,11
0.2,9051,94,701291,77.47359699513919,8
0.2,9052,24,701315,77.4676902684193,9
0.2,9053,94,701409,77.46951623591782,7
0.2,9054,95,701504,77.47145223633352,6
0.2,9055,95,701599,77.47338780918727,8
0.2,9056,94,701693,77.47521254278459,7
0.2,9057,94,701787,77.477036873482,7
0.2,9058,92,701879,77.478640026493,9
0.2,9059,-49,701830,77.46467991169978,12
0.2,9060,87,701917,77.46573225913255,14
0.2,9061,95,702012,77.46766718163761,7
0.2,9062,92,702104,77.46927066092906,9
0.2,9063,92,702196,77.47087378640776,9
0.2,9064,96,702292,77.47291781577496,6
0.2,9065,89,702381,77.47418927862343,12
0.2,9066,93,702474,77.47590162126393,8
0.2,9067,95,702569,77.47783414203793,6
0.2,9068,10,702579,77.47039364869335,22
0.2,9069,92,702671,77.47199558985668,9
0.2,9070,95,702766,77.47392790210561,6
0.2,9071,93,702859,77.475639329806,8
0.2,9072,90,702949,77.47701972886587,11
0.2,9073,92,703041,77.47862023363456,10
0.2,9074,93,703134,77.4803305785124,8
0.2,9075,91,703225,77.48182018510357,10
0.2,9076,92,703317,77.48341963203701,9
0.2,9077,92,703409,77.48501872659176,9
0.2,9078,95,703504,77.4869479017513,6
0.2,9079,18,703522,77.48039647577093,14
0.2,9080,91,703613,77.48188525492787,10
0.2,9081,94,703707,77.48370402994935,7
0.2,9082,95,703802,77.48563250027524,7
0.2,9083,90,703892,77.48701012769705,11
0.2,9084,90,703982,77.48838745184369,11
0.2,9085,24,704006,77.48250055029716,9
0.2,9086,96,704102,77.48453835149114,6
0.2,9087,94,704196,77.48635563380282,8
0.2,9088,94,704290,77.4881725162284,8
0.2,9089,95,704385,77.49009900990099,7
0.2,9090,25,704410,77.48432515674843,8
0.2,9091,95,704505,77.48625164980203,6
0.2,9092,96,704601,77.48828769383042,6
0.2,9093,96,704697,77.49032329008138,6
0.2,9094,25,704722,77.48455195162177,8
0.2,9095,89,704811,77.4858179419525,12
0.2,9096,95,704906,77.48774321204793,6
0.2,9097,95,705001,77.48966805891405,8
0.2,9098,82,705083,77.49016375425872,20
0.2,9099,92,705175,77.49175824175825,9
0.2,9100,94,705269,77.49357213493023,7
0.2,9101,27,705296,77.48802460997582,6
0.2,9102,92,705388,77.48961880698671,9
0.2,9103,91,705479,77.4911028119508,10
0.2,9104,24,705503,77.48522789676002,9
0.2,9105,95,705598,77.4871513287942,6
0.2,9106,94,705692,77.48896453277699,7
0.2,9107,25,705717,77.48320158102767,8
0.2,9108,21,705738,77.47700076847075,11
0.2,9109,93,705831,77.47870472008782,9
0.2,9110,91,705922,77.48018878279004,10
0.2,9111,95,706017,77.48211150131695,7
0.2,9112,24,706041,77.4762427301657,9
0.2,9113,89,706130,77.477507131885,12
0.2,9114,26,706156,77.47185957213385,7
0.2,9115,82,706238,77.47235629662133,19
0.2,9116,94,706332,77.47416913458375,7
0.2,9117,23,706355,77.46819477955692,9
0.2,9118,90,706445,77.46956903169207,11
0.2,9119,88,706533,77.47072368421053,14
0.2,9120,92,706625,77.47231663194825,9
0.2,9121,88,706713,77.47347073010305,13
0.2,9122,95,706808,77.47539186671051,6
0.2,9123,95,706903,77.4773125822008,6
0.2,9124,94,706997,77.47912328767123,7
0.2,9125,96,707093,77.48115275038352,7
0.2,9126,93,707186,77.482853073299,8
0.2,9127,90,707276,77.48422436459246,11
0.2,9128,-51,707225,77.47015007120166,14
0.2,9129,95,707320,77.47207009857613,7
0.2,9130,93,707413,77.4737706713394,8
0.2,9131,82,707495,77.47426631625055,19
0.2,9132,93,707588,77.47596627614146,8
0.2,9133,93,707681,77.47766586380556,9
0.2,9134,94,707775,77.47947454844007,7
0.2,9135,22,707797,77.47340192644484,10
0.2,9136,92,707889,77.4749917916165,11
0.2,9137,94,707983,77.47680017509302,7
0.2,9138,92,708075,77.47838932049459,9
0.2,9139,25,708100,77.472647702407,8
0.2,9140,-49,708051,77.45881194617657,12
0.2,9141,94,708145,77.46062130824765,7
0.2,9142,23,708168,77.45466477086296,10
0.2,9143,20,708188,77.44838145231846,12
0.2,9144,92,708280,77.44997266265719,9
0.2,9145,93,708373,77.45167286245353,8
0.2,9146,91,708464,77.45315403957582,10
0.2,9147,91,708555,77.45463489287276,10
0.2,9148,92,708647,77.45622472401355,9
0.2,9149,93,708740,77.45792349726776,8
0.2,9150,94,708834,77.45973117692056,7
0.2,9151,94,708928,77.46153846153847,7
0.2,9152,94,709022,77.46334535125095,7
0.2,9153,93,709115,77.46504260432597,8
0.2,9154,91,709206,77.46652102676133,10
0.2,9155,94,709300,77.46832678025339,7
0.2,9156,-54,709246,77.45396964071202,18
0.2,9157,92,709338,77.45555798209216,9
0.2,9158,92,709430,77.457145976635,9
0.2,9159,93,709523,77.45884279475983,8
0.2,9160,96,709619,77.46086671760725,6
0.2,9161,95,709714,77.46278105217202,6
0.2,9162,89,709803,77.46404016151915,12
0.2,9163,96,709899,77.46606285464863,6
0.2,9164,94,709993,77.46786688488817,7
0.2,9165,93,710086,77.46956142264892,9
0.2,9166,94,710180,77.47136467764808,7
0.2,9167,89,710269,77.47262216404887,13
0.2,9168,95,710364,77.47453375504418,6
0.2,9169,93,710457,77.47622682660851,9
0.2,9170,91,710548,77.47770145022353,10
0.2,9171,92,710640,77.4792847797645,10
0.2,9172,92,710732,77.48086776409026,10
0.2,9173,96,710828,77.48288641813822,6
0.2,9174,93,710921,77.48457765667575,8
0.2,9175,92,711013,77.48615954664342,9
0.2,9176,93,711106,77.48785005993244,8
0.2,9177,91,711197,77.48932229243844,11
0.2,9178,95,711292,77.49122998147946,7
0.2,9179,18,711310,77.48474945533769,15
0.2,9180,96,711406,77.48676614747849,7
0.2,9181,90,711496,77.48812894794162,11
0.2,9182,91,711587,77.48960034847,10
0.2,9183,18,711605,77.48312282229965,14
0.2,9184,95,711700,77.48502994011976,8
0.2,9185,96,711796,77.48704550402786,6
0.2,9186,94,711890,77.48884293022749,7
0.2,9187,93,711983,77.49053112755769,9
0.2,9188,94,712077,77.49232778321907,7
0.2,9189,-50,712027,77.4784548422198,14
0.2,9190,92,712119,77.48003481666848,9
0.2,9191,27,712146,77.47454308093995,6
0.2,9192,91,712237,77.47601435875123,11
0.2,9193,95,712332,77.47792038285839,7
0.2,9194,-53,712279,77.46373028820011,17
0.2,9195,90,712369,77.46509351892126,11
0.2,9196,93,712462,77.46678264651517,8
0.2,9197,95,712557,77.46868884540118,6
0.2,9198,90,712647,77.47005109251006,11
0.2,9199,94,712741,77.47184782608696,7
0.2,9200,25,712766,77.46614498424084,8
0.2,9201,26,712792,77.46055205390132,8
0.2,9202,95,712887,77.46245789416494,6
0.2,9203,24,712911,77.45664928292047,9
0.2,9204,88,712999,77.45779467680609,14
0.2,9205,93,713092,77.45948294590484,9
0.2,9206,93,713185,77.46117084826763,9
0.2,9207,94,713279,77.46296698523024,8
0.2,9208,94,713373,77.46476273210989,8
0.2,9209,90,713463,77.46612377850163,11
0.2,9210,95,713558,77.46802735859299,6
0.2,9211,94,713652,77.46982197134173,7
0.2,9212,92,713744,77.47139910995332,9
0.2,9213,93,713837,77.47308443672672,9
0.2,9214,95,713932,77.47498643516006,6
0.2,9215,91,714023,77.47645399305556,10
0.2,9216,93,714116,77.47813822284908,9
0.2,9217,90,714206,77.47949663701453,11
0.2,9218,93,714299,77.48118017138518,8
0.2,9219,95,714394,77.4830802603037,6
0.2,9220,87,714481,77.48411235223945,14
0.2,9221,25,714506,77.4784211667751,8
0.2,9222,94,714600,77.48021251219777,7
0.2,9223,26,714626,77.47463139635732,7
0.2,9224,21,714647,77.46850948509486,11
0.2,9225,94,714741,77.47030132234988,7
0.2,9226,92,714833,77.47187601603989,9
0.2,9227,-120,714713,77.45047680970958,15
0.2,9228,21,714734,77.4443601690324,11
0.2,9229,86,714820,77.44528710725893,15
0.2,9230,95,714915,77.4471888202795,6
0.2,9231,89,715004,77.44844020797227,12
0.2,9232,93,715097,77.45012455323297,8
0.2,9233,89,715186,77.45137535196015,12
0.2,9234,93,715279,77.4530590146183,8
0.2,9235,20,715299,77.44683845820701,13
0.2,9236,94,715393,77.4486305077406,9
0.2,9237,89,715482,77.44988092660749,13
0.2,9238,94,715576,77.45167225890248,7
0.2,9239,95,715671,77.45357142857142,6
0.2,9240,90,715761,77.45492912022509,13
0.2,9241,92,715853,77.45650292144558,9
0.2,9242,90,715943,77.4578600021638,11
0.2,9243,92,716035,77.45943314582432,9
0.2,9244,94,716129,77.46122228231476,8
0.2,9245,94,716223,77.46301103179754,7
0.2,9246,89,716312,77.46425867849032,12
0.2,9247,94,716406,77.46604671280276,7
0.2,9248,91,716497,77.4675100010812,10
0.2,9249,11,716508,77.46032432432432,22
0.2,9250,94,716602,77.46211220408604,8
0.2,9251,90,716692,77.46346735840899,11
0.2,9252,92,716784,77.46503836593537,9
0.2,9253,22,716806,77.45904473741085,10
0.2,9254,88,716894,77.46018368449487,13
0.2,9255,92,716986,77.46175453759723,9
0.2,9256,94,717080,77.46354110402939,7
0.2,9257,95,717175,77.46543529920069,6
0.2,9258,88,717263,77.46657306404579,13
0.2,9259,89,717352,77.46781857451404,12
0.2,9260,92,717444,77.46938775510205,9
0.2,9261,84,717528,77.47009285251565,18
0.2,9262,93,717621,77.47176940516032,10
0.2,9263,93,717714,77.47344559585493,8
0.2,9264,89,717803,77.47468969239071,13
0.2,9265,25,717828,77.46902654867256,8
0.2,9266,94,717922,77.4708104025035,7
0.2,9267,93,718015,77.47248597324126,9
0.2,9268,94,718109,77.47426906893948,7
0.2,9269,25,718134,77.46860841423948,8
0.2,9270,95,718229,77.47049940675224,6
0.2,9271,92,718321,77.47206643658326,9
0.2,9272,94,718415,77.47384880836839,7
0.2,9273,92,718507,77.47541513909856,9
0.2,9274,94,718601,77.47719676549865,7
0.2,9275,92,718693,77.47876239758517,9
0.2,9276,22,718715,77.47278214940175,11
0.2,9277,95,718810,77.47467126535891,8
0.2,9278,92,718902,77.47623666343355,9
0.2,9279,94,718996,77.4780172413793,8
0.2,9280,22,719018,77.47203965089969,10
0.2,9281,85,719103,77.47285067873302,16
0.2,9282,93,719196,77.47452332220188,9
0.2,9283,93,719289,77.47619560534253,8
0.2,9284,24,719313,77.47043618739903,9
0.2,9285,95,719408,77.4723239284945,7
0.2,9286,95,719503,77.47421126305588,6
0.2,9287,95,719598,77.47609819121448,6
0.2,9288,91,719689,77.47755409624287,10
0.2,9289,95,719784,77.47944025834231,6
0.2,9290,94,719878,77.48121838338177,7
0.2,9291,96,719974,77.48321136461472,6
0.2,9292,94,720068,77.48498870117292,7
0.2,9293,95,720163,77.48687325156014,6
0.2,9294,92,720255,77.4884346422808,9
0.2,9295,93,720348,77.49010327022376,8
0.2,9296,93,720441,77.4917715392062,8
0.2,9297,93,720534,77.49343944934394,8
0.2,9298,93,720627,77.49510700075277,8
0.2,9299,92,720719,77.49666666666667,9
0.2,9300,95,720814,77.4985485431674,6
0.2,9301,89,720903,77.49978499247473,12
0.2,9302,89,720992,77.50102117596474,12
0.2,9303,94,721086,77.50279449699055,7
0.2,9304,91,721177,77.504245029554,11
0.2,9305,90,721267,77.50558779282184,11
0.2,9306,18,721285,77.49919415493714,14
0.2,9307,96,721381,77.50118177911475,6
0.2,9308,91,721472,77.50263186163927,10
0.2,9309,18,721490,77.49624060150376,14
0.2,9310,94,721584,77.49801310278166,7
0.2,9311,95,721679,77.49989261168385,7
0.2,9312,93,721772,77.50155696338452,8
0.2,9313,93,721865,77.50322095769809,8
0.2,9314,27,721892,77.49779924852389,6
0.2,9315,84,721976,77.49849720910262,17
0.2,9316,92,722068,77.50005366534292,9
0.2,9317,90,722158,77.50139514917365,12
0.2,9318,93,722251,77.50305826805452,8
0.2,9319,95,722346,77.5049356223176,6
0.2,9320,94,722440,77.50670528913207,8
0.2,9321,93,722533,77.50836730315383,8
0.2,9322,27,722560,77.5029496943044,6
0.2,9323,92,722652,77.50450450450451,9
0.2,9324,96,722748,77.50648793565684,6
0.2,9325,94,722842,77.50825648723998,7
0.2,9326,23,722865,77.50241235123833,10
0.2,9327,88,722953,77.50353773584905,13
0.2,9328,94,723047,77.5053060349448,7
0.2,9329,90,723137,77.50664523043945,12
0.2,9330,88,723225,77.50776979959275,13
0.2,9331,88,723313,77.50889412773253,14
0.2,9332,90,723403,77.51023250830387,11
0.2,9333,91,723494,77.51167773730448,10
0.2,9334,94,723588,77.51344402785217,8
0.2,9335,94,723682,77.51520994001714,7
0.2,9336,93,723775,77.51686837313912,8
0.2,9337,92,723867,77.5184193617477,9
0.2,9338,92,723959,77.51997001820324,9
0.2,9339,93,724052,77.52162740899358,8
0.2,9340,95,724147,77.52349855475859,6
0.2,9341,92,724239,77.52504816955684,9
0.2,9342,94,724333,77.52681151664348,7
0.2,9343,94,724427,77.52857448630137,8
0.2,9344,91,724518,77.53001605136437,11
0.2,9345,96,724614,77.53199229616948,6
0.2,9346,92,724706,77.53354017331765,9
0.2,9347,93,724799,77.53519469405221,8
0.2,9348,92,724891,77.53674189752915,9
0.2,9349,94,724985,77.53850267379678,7
0.2,9350,95,725080,77.54037001390226,8
0.2,9351,22,725102,77.53443113772455,10
0.2,9352,22,725124,77.52849353148723,11
0.2,9353,91,725215,77.52993371819542,10
0.2,9354,91,725306,77.53137359700695,10
0.2,9355,90,725396,77.53270628473707,12
0.2,9356,95,725491,77.53457304691675,6
0.2,9357,90,725581,77.53590510792904,13
0.2,9358,92,725673,77.53745058232717,9
0.2,9359,94,725767,77.5392094017094,7
0.2,9360,94,725861,77.54096784531568,7
0.2,9361,93,725954,77.54261909848323,8
0.2,9362,92,726046,77.54416319555698,9
0.2,9363,93,726139,77.54581375480564,8
0.2,9364,95,726234,77.54767752269088,6
0.2,9365,94,726328,77.54943412342516,7
0.2,9366,95,726423,77.55129710686452,7
0.2,9367,95,726518,77.55315969257045,7
0.2,9368,95,726613,77.5550218806703,6
0.2,9369,93,726706,77.55667022411953,8
0.2,9370,93,726799,77.55831821577206,8
0.2,9371,92,726891,77.55985915492958,11
0.2,9372,93,726984,77.56150645471034,8
0.2,9373,22,727006,77.55557926178793,10
0.2,9374,89,727095,77.5568,12
0.2,9375,27,727122,77.55140784982935,6
0.2,9376,94,727216,77.55316199210834,7
0.2,9377,24,727240,77.54745148219237,8
0.2,9378,92,727332,77.54899242989657,10
0.2,9379,92,727424,77.55053304904051,9
0.2,9380,90,727514,77.55186014284192,11
0.2,9381,94,727608,77.55361330206779,7
0.2,9382,94,727702,77.55536608760525,8
0.2,9383,90,727792,77.55669224211424,11
0.2,9384,95,727887,77.55855087906234,7
0.2,9385,23,727910,77.55273812060516,9
0.2,9386,93,728003,77.55438372216895,9
0.2,9387,95,728098,77.55624201107797,6
0.2,9388,95,728193,77.55809990414315,6
0.2,9389,93,728286,77.55974440894569,10
0.2,9390,96,728382,77.56170801831541,6
0.2,9391,94,728476,77.56345826235093,7
0.2,9392,95,728571,77.56531459597572,7
0.2,9393,94,728665,77.56706408345752,8
0.2,9394,93,728758,77.56870675891432,8
0.2,9395,20,728778,77.56257982120052,13
0.2,9396,89,728867,77.56379695647547,12
0.2,9397,93,728960,77.56543945520323,10
0.2,9398,91,729051,77.56686881583147,10
0.2,9399,93,729144,77.56851063829787,8
0.2,9400,92,729236,77.57004573981492,12
0.2,9401,16,729252,77.56349712827058,16
0.2,9402,18,729270,77.5571626076784,14
0.2,9403,93,729363,77.55880476393024,8
0.2,9404,91,729454,77.56023391812866,10
0.2,9405,96,729550,77.56219434403572,6
0.2,9406,91,729641,77.56362283405974,10
0.2,9407,96,729737,77.5655824829932,6
0.2,9408,96,729833,77.5675417153789,6
0.2,9409,-49,729784,77.55409139213603,12
0.2,9410,94,729878,77.5558389119116,7
0.2,9411,-54,729824,77.54186145346367,17
0.2,9412,96,729920,77.5438223733135,6
0.2,9413,19,729939,77.53760356915232,13
0.2,9414,90,730029,77.53892724375996,11
0.2,9415,91,730120,77.54035683942226,10
0.2,9416,92,730212,77.54189232239567,9
0.2,9417,19,730231,77.53567636440857,14
0.2,9418,93,730324,77.53731818664401,8
0.2,9419,93,730417,77.53895966029724,8
0.2,9420,25,730442,77.53338286806071,8
0.2,9421,95,730537,77.53523668011039,6
0.2,9422,92,730629,77.5367717287488,10
0.2,9423,93,730722,77.53841256366724,8
0.2,9424,95,730817,77.5402652519894,8
0.2,9425,93,730910,77.5419053681307,8
0.2,9426,92,731002,77.54343905802482,11
0.2,9427,-49,730953,77.5300169707255,15
0.2,9428,91,731044,77.53144554035423,10
0.2,9429,92,731136,77.53297985153765,9
0.2,9430,96,731232,77.53493797052275,7
0.2,9431,92,731324,77.5364715860899,9
0.2,9432,24,731348,77.53079614120641,9
0.2,9433,95,731443,77.53264786940852,8
0.2,9434,92,731535,77.53418124006359,10
0.2,9435,91,731626,77.53560830860535,10
0.2,9436,93,731719,77.53724700646391,8
0.2,9437,22,731741,77.53136257681712,10
0.2,9438,92,731833,77.53289543383833,9
0.2,9439,94,731927,77.53463983050847,7
0.2,9440,95,732022,77.53648977862514,6
0.2,9441,94,732116,77.5382334251218,8
0.2,9442,23,732139,77.5324579053267,10
0.2,9443,90,732229,77.533778060144,11
0.2,9444,91,732320,77.5352038115405,10
0.2,9445,95,732415,77.53705272072835,6
0.2,9446,93,732508,77.53868953106806,8
0.2,9447,96,732604,77.54064352243861,6
0.2,9448,95,732699,77.54249126891735,7
0.2,9449,91,732790,77.54391534391534,11
0.2,9450,92,732882,77.5454449264628,10
0.2,9451,94,732976,77.54718578078713,7
0.2,9452,94,733070,77.54892626679361,7
0.2,9453,94,733164,77.55066638459911,7
0.2,9454,94,733258,77.55240613432046,8
0.2,9455,94,733352,77.55414551607446,7
0.2,9456,88,733440,77.55525007930633,13
0.2,9457,90,733530,77.55656587016283,11
0.2,9458,19,733549,77.55037530394334,14
0.2,9459,94,733643,77.55211416490486,7
0.2,9460,27,733670,77.54677095444457,6
0.2,9461,95,733765,77.54861551469034,7
0.2,9462,89,733854,77.54982563669027,12
0.2,9463,27,733881,77.54448436179206,6
0.2,9464,22,733903,77.53861595351295,10
0.2,9465,-53,733850,77.52482569195014,17
0.2,9466,27,733877,77.5194887503961,6
0.2,9467,23,733900,77.51373046049852,9
0.2,9468,-51,733849,77.5001584116591,14
0.2,9469,94,733943,77.50190073917635,7
0.2,9470,91,734034,77.50332594235033,10
0.2,9471,96,734130,77.50527871621621,6
0.2,9472,91,734221,77.50670326190225,10
0.2,9473,92,734313,77.50823305889804,9
0.2,9474,96,734409,77.51018469656992,7
0.2,9475,19,734428,77.5040101308569,13
0.2,9476,92,734520,77.50553972776196,9
0.2,9477,93,734613,77.50717450939017,8
0.2,9478,86,734699,77.50807047156873,15
0.2,9479,94,734793,77.50981012658228,7
0.2,9480,92,734885,77.5113384664065,9
0.2,9481,94,734979,77.51307740982915,7
0.2,9482,91,735070,77.51449963091848,11
0.2,9483,94,735164,77.51623787431464,7
0.2,9484,93,735257,77.51787032156035,8
0.2,9485,95,735352,77.51971326164875,6
0.2,9486,92,735444,77.5212395910193,9
0.2,9487,91,735535,77.52266020236088,10
0.2,9488,13,735548,77.51586047001791,19
0.2,9489,96,735644,77.51780821917808,6
0.2,9490,95,735739,77.51965019492151,6
0.2,9491,14,735753,77.5129582806574,18
0.2,9492,90,735843,77.51427367533972,11
0.2,9493,89,735932,77.51548346323995,12
0.2,9494,24,735956,77.50984728804634,10
0.2,9495,84,736040,77.51053074978938,17
0.2,9496,93,736133,77.51216173528482,8
0.2,9497,93,736226,77.5137923773426,8
0.2,9498,96,736322,77.51573849878935,6
0.2,9499,95,736417,77.51757894736842,7
0.2,9500,22,736439,77.51173560677823,10
0.2,9501,95,736534,77.51357608924437,6
0.2,9502,22,736556,77.50773439966326,11
0.2,9503,94,736650,77.5094696969697,7
0.2,9504,91,736741,77.51088900578642,10
0.2,9505,92,736833,77.51241321270777,9
0.2,9506,91,736924,77.51383191332702,10
0.2,9507,94,737018,77.51556583929323,8
0.2,9508,89,737107,77.51677358292145,12
0.2,9509,88,737195,77.51787592008412,13
0.2,9510,18,737213,77.51161812637999,14
0.2,9511,94,737307,77.51335155592935,7
0.2,9512,-49,737258,77.5000525596552,12
0.2,9513,95,737353,77.50189194870717,7
0.2,9514,92,737445,77.50341565948503,9
0.2,9515,93,737538,77.50504413619167,8
0.2,9516,91,737629,77.5064621204161,10
0.2,9517,90,737719,77.50777474259299,11
0.2,9518,92,737811,77.50929719508352,9
0.2,9519,94,737905,77.51102941176471,7
0.2,9520,23,737928,77.50530406469909,10
0.2,9521,93,738021,77.50693131695022,8
0.2,9522,91,738112,77.50834820959781,10
0.2,9523,91,738203,77.5097648047039,10
0.2,9524,93,738296,77.51139107611549,8
0.2,9525,91,738387,77.51280705437749,10
0.2,9526,-56,738331,77.49879290437704,19
0.2,9527,94,738425,77.5005247691016,7
0.2,9528,19,738444,77.49438555986987,14
0.2,9529,94,738538,77.49611752360966,7
0.2,9530,94,738632,77.49784912391145,8
0.2,9531,86,738718,77.4987410826689,15
0.2,9532,23,738741,77.49302423161649,9
0.2,9533,25,738766,77.48751835535977,8
0.2,9534,95,738861,77.48935500786575,7
0.2,9535,92,738953,77.49087667785236,11
0.2,9536,90,739043,77.49218831917794,11
0.2,9537,87,739130,77.49318515412035,14
0.2,9538,92,739222,77.49470594401929,9
0.2,9539,21,739243,77.48878406708596,12
0.2,9540,93,739336,77.49040981029242,8
0.2,9541,91,739427,77.49182561307902,10
0.2,9542,92,739519,77.49334590799539,9
0.2,9543,95,739614,77.49518021793797,6
0.2,9544,-53,739561,77.48150864326873,18
0.2,9545,-46,739515,77.46857322438717,10
0.2,9546,94,739609,77.47030480779303,7
0.2,9547,26,739635,77.46491411813993,7
0.2,9548,96,739731,77.46685516808043,6
0.2,9549,96,739827,77.46879581151832,6
0.2,9550,93,739920,77.47042194534603,10
0.2,9551,94,740014,77.47215242881072,7
0.2,9552,90,740104,77.47346383335078,11
0.2,9553,95,740199,77.47529830437513,6
0.2,9554,94,740293,77.47702773417059,8
0.2,9555,93,740386,77.47865215571369,8
0.2,9556,94,740480,77.48038087265878,7
0.2,9557,96,740576,77.48231847666877,6
0.2,9558,96,740672,77.48425567527984,6
0.2,9559,94,740766,77.48598326359833,7
0.2,9560,20,740786,77.47997071436042,12
0.2,9561,93,740879,77.4815938088266,8
0.2,9562,95,740974,77.4834257032312,6
0.2,9563,94,741068,77.48515265579256,8
0.2,9564,95,741163,77.48698379508625,6
0.2,9565,94,741257,77.48871001463516,7
0.2,9566,84,741341,77.48939061356747,18
0.2,9567,94,741435,77.49111622073579,8
0.2,9568,23,741458,77.48542167415613,9
0.2,9569,20,741478,77.47941483803552,12
0.2,9570,23,741501,77.47372270400167,11
0.2,9571,92,741593,77.47524028416214,9
0.2,9572,95,741688,77.4770709286535,7
0.2,9573,94,741782,77.47879674117401,8
0.2,9574,94,741876,77.48052219321148,7
0.2,9575,93,741969,77.48214285714286,8
0.2,9576,90,742059,77.48344993212906,11
0.2,9577,24,742083,77.47786594278556,9
0.2,9578,23,742106,77.47217872429272,9
0.2,9579,91,742197,77.47359081419624,10
0.2,9580,96,742293,77.47552447552448,6
0.2,9581,95,742388,77.47735337090378,7
0.2,9582,96,742484,77.479286236043,7
0.2,9583,95,742579,77.4811143572621,6
0.2,9584,94,742673,77.4828377673448,7
0.2,9585,94,742767,77.48456081785937,7
0.2,9586,73,742840,77.48409304266194,28
0.2,9587,93,742933,77.48571130579892,10
0.2,9588,94,743027,77.48743351757221,7
0.2,9589,22,743049,77.48164754953076,10
0.2,9590,92,743141,77.48316129704932,10
0.2,9591,93,743234,77.48477898248541,8
0.2,9592,94,743328,77.48650057333472,7
0.2,9593,95,743423,77.48832603710653,6
0.2,9594,92,743515,77.48983845752997,10
0.2,9595,90,743605,77.4911421425594,11
0.2,9596,27,743632,77.48588100448056,6
0.2,9597,89,743721,77.48708064180038,15
0.2,9598,93,743814,77.48869673924366,8
0.2,9599,95,743909,77.49052083333333,6
0.2,9600,92,744001,77.49203207999167,10
0.2,9601,91,744092,77.49343886690274,10
0.2,9602,91,744183,77.49484536082474,10
0.2,9603,93,744276,77.49645980841316,8
0.2,9604,94,744370,77.49817803227485,8
0.2,9605,96,744466,77.50010410160317,6
0.2,9606,24,744490,77.49453523472468,9
0.2,9607,93,744583,77.49614904246461,8
0.2,9608,22,744605,77.49037360807576,12
0.2,9609,-52,744553,77.47689906347554,15
0.2,9610,93,744646,77.47851420247633,8
0.2,9611,-46,744600,77.46566791510612,10
0.2,9612,86,744686,77.46655570581504,15
0.2,9613,93,744779,77.468171416684,8
0.2,9614,92,744871,77.4696827873115,9
0.2,9615,93,744964,77.47129783693843,8
0.2,9616,-122,744842,77.4505563065405,18
0.2,9617,95,744937,77.45238095238095,9
0.2,9618,92,745029,77.45389333610562,9
0.2,9619,-51,744978,77.44054054054054,14
0.2,9620,27,745005,77.43529778609292,6
0.2,9621,93,745098,77.43691540220328,8
0.2,9622,22,745120,77.43115452561571,10
0.2,9623,88,745208,77.43225270157939,13
0.2,9624,17,745225,77.42597402597403,15
0.2,9625,93,745318,77.4275919384999,8
0.2,9626,94,745412,77.42931338942557,7
0.2,9627,25,745437,77.42386788533445,7
0.2,9628,92,745529,77.42538165957005,10
0.2,9629,95,745624,77.42720664589824,6
0.2,9630,92,745716,77.4287197591112,10
0.2,9631,94,745810,77.43044019933555,7
0.2,9632,93,745903,77.4320564725423,9
0.2,9633,91,745994,77.43346481212373,10
0.2,9634,24,746018,77.4279190451479,10
0.2,9635,94,746112,77.42963885429639,7
0.2,9636,92,746204,77.43115077306216,9
0.2,9637,94,746298,77.43286989001868,7
0.2,9638,96,746394,77.4347961406785,6
0.2,9639,95,746489,77.43661825726142,6
0.2,9640,90,746579,77.43792137745046,11
0.2,9641,95,746674,77.43974279195187,6
0.2,9642,94,746768,77.44146012651665,8
0.2,9643,91,746859,77.44286603069266,11
0.2,9644,93,746952,77.44447900466562,10
0.2,9645,93,747045,77.44609164420486,8
0.2,9646,89,747134,77.44728931273971,12
0.2,9647,89,747223,77.44848673300166,12
0.2,9648,94,747317,77.4502020934812,7
0.2,9649,96,747413,77.45212435233161,7
0.2,9650,87,747500,77.45311366697752,14
0.2,9651,93,747593,77.45472440944881,8
0.2,9652,22,747615,77.44897959183673,11
0.2,9653,95,747710,77.45079759685105,6
0.2,9654,90,747800,77.4520973588814,11
0.2,9655,94,747894,77.45381110190556,8
0.2,9656,87,747981,77.45479962721342,16
0.2,9657,90,748071,77.45609857113274,11
0.2,9658,92,748163,77.45760430686407,9
0.2,9659,92,748255,77.45910973084887,9
0.2,9660,94,748349,77.46082186109098,7
0.2,9661,93,748442,77.46243013868764,9
0.2,9662,93,748535,77.46403808341095,8
0.2,9663,92,748627,77.46554221854305,10
0.2,9664,92,748719,77.4670460424211,9
0.2,9665,27,748746,77.46182495344506,6
0.2,9666,93,748839,77.46343229543808,9
0.2,9667,94,748933,77.46514273893256,7
0.2,9668,95,749028,77.46695625193918,6
0.2,9669,17,749045,77.4607032057911,19
0.2,9670,-50,748995,77.44752352393755,13
0.2,9671,95,749090,77.44933829611249,6
0.2,9672,92,749182,77.45084255143182,9
0.2,9673,94,749276,77.45255323547653,8
0.2,9674,94,749370,77.45426356589147,7
0.2,9675,96,749466,77.4561802397685,6
0.2,9676,91,749557,77.45757982845923,10
0.2,9677,89,749646,77.45877247365158,12
0.2,9678,24,749670,77.45324930261391,8
0.2,9679,92,749762,77.4547520661157,9
0.2,9680,93,749855,77.45635781427538,8
0.2,9681,90,749945,77.45765337740136,11
0.2,9682,94,750039,77.45936176804709,10
0.2,9683,93,750132,77.46096654275092,8
0.2,9684,94,750226,77.46267423851316,7
0.2,9685,94,750320,77.46438158166426,7
0.2,9686,21,750341,77.45855269949416,11
0.2,9687,91,750432,77.45995045417011,10
0.2,9688,23,750455,77.45432965218289,9
0.2,9689,21,750476,77.4485036119711,11
0.2,9690,89,750565,77.44969559384997,12
0.2,9691,94,750659,77.45140321914981,7
0.2,9692,90,750749,77.45269782317136,11
0.2,9693,92,750841,77.45419847328245,9
0.2,9694,87,750928,77.45518308406395,14
0.2,9695,19,750947,77.44915429042905,13
0.2,9696,19,750966,77.44312674022893,13
0.2,9697,96,751062,77.44504021447722,6
0.2,9698,88,751150,77.44612846685226,13
0.2,9699,93,751243,77.44773195876289,8
0.2,9700,88,751331,77.44881970930832,14
0.2,9701,95,751426,77.45062873634302,6
0.2,9702,90,751516,77.4519220859528,11
0.2,9703,94,751610,77.45362737015664,7
0.2,9704,95,751705,77.4554353426069,6
0.2,9705,91,751796,77.45683082629301,10
0.2,9706,-49,751747,77.44380344081591,12
0.2,9707,92,751839,77.44530284301607,9
0.2,9708,91,751930,77.44669893912864,12
0.2,9709,94,752024,77.44840370751803,8
0.2,9710,88,752112,77.44949026876738,14
0.2,9711,96,752208,77.45140032948929,6
0.2,9712,17,752225,77.44517656748687,16
0.2,9713,25,752250,77.43977764051884,8
0.2,9714,93,752343,77.44137931034483,8
0.2,9715,93,752436,77.44298065047344,8
0.2,9716,86,752522,77.44386127405578,15
0.2,9717,94,752616,77.44556493105577,7
0.2,9718,94,752710,77.447268237473,8
0.2,9719,95,752805,77.44907407407408,7
0.2,9720,95,752900,77.45087953914206,6
0.2,9721,94,752994,77.45258177329768,8
0.2,9722,94,753088,77.45428365730741,7
0.2,9723,96,753184,77.45619086795557,6
0.2,9724,92,753276,77.45768637532133,9
0.2,9725,92,753368,77.45918157515936,9
0.2,9726,94,753462,77.460882080806,8
0.2,9727,88,753550,77.46196546052632,13
0.2,9728,89,753639,77.4631514030219,13
0.2,9729,22,753661,77.45745118191161,11
0.2,9730,92,753753,77.45894563765286,10
0.2,9731,96,753849,77.46085080147965,6
0.2,9732,94,753943,77.46255008733176,7
0.2,9733,93,754036,77.4641462913499,8
0.2,9734,20,754056,77.45824345146379,12
0.2,9735,96,754152,77.46014790468365,6
0.2,9736,94,754246,77.4618465646503,7
0.2,9737,90,754336,77.46313411378107,11
0.2,9738,93,754429,77.4647294383407,8
0.2,9739,94,754523,77.4664271047228,7
0.2,9740,95,754618,77.46822708140849,7
0.2,9741,95,754713,77.47002668856497,7
0.2,9742,89,754802,77.47121009955866,13
0.2,9743,91,754893,77.47259852216749,10
0.2,9744,89,754982,77.4737814263725,12
0.2,9745,96,755078,77.47568233121281,6
0.2,9746,94,755172,77.47737765466297,7
0.2,9747,92,755264,77.47886745999179,9
0.2,9748,91,755355,77.48025438506514,10
0.2,9749,93,755448,77.48184615384615,9
0.2,9750,94,755542,77.48354014972823,7
0.2,9751,92,755634,77.48502871205906,9
0.2,9752,90,755724,77.48631190402953,12
0.2,9753,87,755811,77.48728726676235,14
0.2,9754,89,755900,77.48846745258841,12
0.2,9755,86,755986,77.48933989339893,15
0.2,9756,96,756082,77.49123706057189,6
0.2,9757,22,756104,77.48555031768805,10
0.2,9758,17,756121,77.47935239266319,15
0.2,9759,90,756211,77.48063524590164,11
0.2,9760,95,756306,77.48243007888536,7
0.2,9761,93,756399,77.4840196681008,8
0.2,9762,90,756489,77.48530164908327,12
0.2,9763,88,756577,77.48637853338795,13
0.2,9764,79,756656,77.48653353814645,22
0.2,9765,94,756750,77.48822445218103,7
0.2,9766,93,756843,77.48981263438108,8
0.2,9767,94,756937,77.49150286650287,7
0.2,9768,91,757028,77.49288565871635,10
0.2,9769,90,757118,77.49416581371545,11
0.2,9770,94,757212,77.49585508136322,8
0.2,9771,95,757307,77.49764633647155,7
0.2,9772,93,757400,77.49923257955592,8
0.2,9773,94,757494,77.50092081031308,7
0.2,9774,96,757590,77.50281329923274,7
0.2,9775,92,757682,77.50429623567922,9
0.2,9776,87,757769,77.5052674644574,14
0.2,9777,92,757861,77.50674984659439,9
0.2,9778,94,757955,77.50843644544432,7
0.2,9779,95,758050,77.51022494887526,6
0.2,9780,94,758144,77.5119108475616,7
0.2,9781,93,758237,77.51349417297077,9
0.2,9782,96,758333,77.51538382909128,6
0.2,9783,94,758427,77.517068683565,7
0.2,9784,93,758520,77.51865099642309,8
0.2,9785,92,758612,77.52013079910076,9
0.2,9786,91,758703,77.52150812302034,10
0.2,9787,-50,758653,77.50847977114834,14
0.2,9788,-53,758600,77.49514761466952,16
0.2,9789,90,758690,77.49642492339122,11
0.2,9790,94,758784,77.49811050965172,7
0.2,9791,93,758877,77.49969362745098,8
0.2,9792,22,758899,77.49402634534871,10
0.2,9793,93,758992,77.49560955687156,8
0.2,9794,92,759084,77.49709035222052,9
0.2,9795,92,759176,77.49857084524295,9
0.2,9796,94,759270,77.5002551801572,7
0.2,9797,93,759363,77.5018371096142,9
0.2,9798,95,759458,77.50362281865496,6
0.2,9799,16,759474,77.49734693877551,16
0.2,9800,96,759570,77.49923477196205,6
0.2,9801,95,759665,77.50102019995919,6
0.2,9802,92,759757,77.50249923492808,9
0.2,9803,93,759850,77.50407996736025,9
0.2,9804,19,759869,77.49811320754716,14
0.2,9805,24,759893,77.492657556598,9
0.2,9806,91,759984,77.49403487304986,10
0.2,9807,94,760078,77.49571778140293,7
0.2,9808,91,760169,77.49709450504639,10
0.2,9809,93,760262,77.4986748216106,9
0.2,9810,94,760356,77.50035674243196,9
0.2,9811,95,760451,77.50214023644517,6
0.2,9812,94,760545,77.50382146132681,7
0.2,9813,92,760637,77.50529855308743,9
0.2,9814,90,760727,77.50657157412124,11
0.2,9815,21,760748,77.50081499592503,12
0.2,9816,23,760771,77.49526331873281,9
0.2,9817,94,760865,77.49694438785903,7
0.2,9818,25,760890,77.49159792239536,8
0.2,9819,92,760982,77.49307535641547,10
0.2,9820,-52,760930,77.47989003156502,15
0.2,9821,27,760957,77.47475055996742,6
0.2,9822,92,761049,77.47622925786419,10
0.2,9823,91,761140,77.47760586319218,10
0.2,9824,96,761236,77.47949109414758,6
0.2,9825,93,761329,77.48107062894361,10
0.2,9826,94,761423,77.48275160272718,7
0.2,9827,95,761518,77.48453398453398,7
0.2,9828,94,761612,77.48621426391291,7
0.2,9829,23,761635,77.48067141403865,9
0.2,9830,94,761729,77.48235174448175,7
0.2,9831,16,761745,77.47609845402766,16
0.2,9832,23,761768,77.47055832401098,9
0.2,9833,27,761795,77.46542607280863,6
0.2,9834,92,761887,77.46690391459074,9
0.2,9835,91,761978,77.46827978853193,10
0.2,9836,94,762072,77.4699603537664,7
0.2,9837,94,762166,77.47164057735311,7
0.2,9838,94,762260,77.47332045939628,7
0.2,9839,93,762353,77.47489837398373,8
0.2,9840,94,762447,77.4765775835789,8
0.2,9841,90,762537,77.4778500304816,11
0.2,9842,92,762629,77.47932540892005,9
0.2,9843,94,762723,77.48100365704998,7
0.2,9844,92,762815,77.4824784154393,9
0.2,9845,19,762834,77.47653869591713,13
0.2,9846,90,762924,77.4778105006601,11
0.2,9847,96,763020,77.47969130787978,6
0.2,9848,25,763045,77.47436287948015,8
0.2,9849,87,763132,77.47532994923858,14
0.2,9850,20,763152,77.46949548269211,12
0.2,9851,91,763243,77.4708688591149,11
0.2,9852,94,763337,77.47254643255862,7
0.2,9853,96,763433,77.4744266287802,6
0.2,9854,95,763528,77.47620497209539,6
0.2,9855,95,763623,77.47798295454545,6
0.2,9856,93,763716,77.4795576747489,8
0.2,9857,94,763810,77.48123351592615,8
0.2,9858,94,763904,77.4829090171417,8
0.2,9859,92,763996,77.4843813387424,9
0.2,9860,17,764013,77.47824764222696,15
0.2,9861,92,764105,77.47972013790306,9
0.2,9862,93,764198,77.48129372401907,8
0.2,9863,87,764285,77.48225871857258,14
0.2,9864,93,764378,77.48383172833249,9
0.2,9865,94,764472,77.48550577741739,7
0.2,9866,92,764564,77.48697679132462,9
0.2,9867,21,764585,77.48125253344142,11
0.2,9868,-47,764538,77.46863917316851,11
0.2,9869,26,764564,77.46342451874366,6
0.2,9870,91,764655,77.46479586668018,11
0.2,9871,94,764749,77.46647082658022,7
0.2,9872,90,764839,77.46774030183329,11
0.2,9873,90,764929,77.46900951995138,11
0.2,9874,94,765023,77.4706835443038,8
0.2,9875,93,765116,77.47225597407858,8
0.2,9876,94,765210,77.47392933076846,7
0.2,9877,91,765301,77.47529864345009,10
0.2,9878,94,765395,77.47697135337584,7
0.2,9879,92,765487,77.47844129554656,9
0.2,9880,95,765582,77.48021455318288,6
0.2,9881,87,765669,77.48117789921069,14
0.2,9882,91,765760,77.48254578569261,10
0.2,9883,94,765854,77.48421691622825,8
0.2,9884,94,765948,77.48588770864947,7
0.2,9885,92,766040,77.48735585676715,10
0.2,9886,93,766133,77.4889248508142,8
0.2,9887,88,766221,77.48998786407768,13
0.2,9888,94,766315,77.4916573971079,7
0.2,9889,94,766409,77.49332659251769,8
0.2,9890,94,766503,77.49499545040946,9
0.2,9891,94,766597,77.49666397088556,7
0.2,9892,96,766693,77.49853431719397,7
0.2,9893,94,766787,77.50020214271275,7
0.2,9894,95,766882,77.50197069226883,6
0.2,9895,22,766904,77.49636216653194,10
0.2,9896,96,767000,77.49823178741033,6
0.2,9897,95,767095,77.5,6
0.2,9898,90,767185,77.50126275381352,12
0.2,9899,94,767279,77.5029292929293,7
0.2,9900,94,767373,77.5045954954045,7
0.2,9901,91,767464,77.505958392244,11
0.2,9902,96,767560,77.50782591133999,7
0.2,9903,92,767652,77.50928917609046,11
0.2,9904,95,767747,77.5110550227158,6
0.2,9905,95,767842,77.51282051282051,6
0.2,9906,91,767933,77.5141818915918,10
0.2,9907,94,768027,77.51584578118693,7
0.2,9908,93,768120,77.51740841659098,8
0.2,9909,94,768214,77.51907164480323,7
0.2,9910,86,768300,77.51992735344567,16
0.2,9911,94,768394,77.52158999192898,7
0.2,9912,90,768484,77.5228487844245,11
0.2,9913,92,768576,77.52430905789792,9
0.2,9914,92,768668,77.5257690368129,9
0.2,9915,20,768688,77.51996772892295,13
0.2,9916,92,768780,77.52142785116466,9
0.2,9917,92,768872,77.52288767896754,9
0.2,9918,-56,768816,77.50942635346306,19
0.2,9919,93,768909,77.51098790322581,10
0.2,9920,96,769005,77.5128515270638,6
0.2,9921,92,769097,77.51431163071962,9
0.2,9922,22,769119,77.50871712183816,11
0.2,9923,92,769211,77.51017734784361,9
0.2,9924,21,769232,77.50448362720402,13
0.2,9925,95,769327,77.50624622204312,6
0.2,9926,94,769421,77.50790772640273,7
0.2,9927,87,769508,77.5088638195004,14
0.2,9928,95,769603,77.51062544062846,6
0.2,9929,95,769698,77.51238670694865,6
0.2,9930,95,769793,77.51414761856812,6
0.2,9931,88,769881,77.51520338300443,15
0.2,9932,89,769970,77.51635960938286,13
0.2,9933,95,770065,77.51811958928931,6
0.2,9934,95,770160,77.51987921489683,6
0.2,9935,93,770253,77.52143719806763,8
0.2,9936,95,770348,77.52319613565463,6
0.2,9937,92,770440,77.52465284765546,9
0.2,9938,94,770534,77.52631049401349,8
0.2,9939,93,770627,77.52786720321932,8
0.2,9940,24,770651,77.52248264762096,9
0.2,9941,92,770743,77.52393884530275,9
0.2,9942,96,770839,77.52579704314593,6
0.2,9943,95,770934,77.52755430410298,6
0.2,9944,93,771027,77.5291101055807,8
0.2,9945,93,771120,77.53066559420873,8
0.2,9946,91,771211,77.5320197044335,10
0.2,9947,25,771236,77.52673904302372,7
0.2,9948,93,771329,77.52829430093476,8
0.2,9949,96,771425,77.53015075376885,6
0.2,9950,94,771519,77.53180584865842,7
0.2,9951,94,771613,77.53346061093248,8
0.2,9952,92,771705,77.5349140962524,9
0.2,9953,95,771800,77.53666867590918,6
0.2,9954,92,771892,77.53812154696132,9
0.2,9955,-50,771842,77.52531137002812,14
0.2,9956,94,771936,77.52696595360048,9
0.2,9957,96,772032,77.52882104840329,6
0.2,9958,93,772125,77.53037453559594,8
0.2,9959,21,772146,77.52469879518073,11
0.2,9960,92,772238,77.52615199277182,11
0.2,9961,92,772330,77.52760489861474,9
0.2,9962,93,772423,77.52915788417144,9
0.2,9963,18,772441,77.52318346045764,15
0.2,9964,25,772466,77.5179126944305,9
0.2,9965,16,772482,77.51173991571342,16
0.2,9966,92,772574,77.51319353867764,9
0.2,9967,94,772668,77.51484751203853,7
0.2,9968,95,772763,77.51660146454007,7
0.2,9969,-124,772639,77.49638916750251,18
0.2,9970,92,772731,77.49784374686591,9
0.2,9971,93,772824,77.49939831528279,8
0.2,9972,23,772847,77.49393362077609,10
0.2,9973,87,772934,77.49488670543413,14
0.2,9974,94,773028,77.49654135338346,7
0.2,9975,94,773122,77.49819566960706,7
0.2,9976,92,773214,77.49964919314424,9
0.2,9977,95,773309,77.50140308679094,6
0.2,9978,92,773401,77.50285599759495,9
0.2,9979,95,773496,77.50460921843687,6
0.2,9980,95,773591,77.50636208796713,6
0.2,9981,-52,773539,77.49338809857744,16
0.2,9982,94,773633,77.49504157067014,7
0.2,9983,87,773720,77.49599358974359,14
0.2,9984,95,773815,77.4977466199299,6
0.2,9985,91,773906,77.49909873823353,10
0.2,9986,96,774002,77.50095123660759,6
0.2,9987,92,774094,77.50240288346015,9
0.2,9988,93,774187,77.50395434978476,8
0.2,9989,92,774279,77.50540540540541,9
0.2,9990,95,774374,77.50715644079672,7
0.2,9991,92,774466,77.50860688550841,9
0.2,9992,94,774560,77.51025718002602,7
0.2,9993,91,774651,77.51160696417851,10
0.2,9994,95,774746,77.51335667833916,6
0.2,9995,93,774839,77.51490596238496,9
0.2,9996,93,774932,77.51645493648094,8
0.2,9997,94,775026,77.51810362072415,7
0.2,9998,92,775118,77.51955195519552,9
0.2,9999,21,775139,77.5139,12
