0.2,0,-401,-401,-401.0,437
0.2,1,51,-350,-175.0,49
0.2,2,82,-268,-89.33333333333333,18
0.2,3,60,-208,-52.0,43
0.2,4,42,-166,-33.2,59
0.2,5,48,-118,-19.666666666666668,53
0.2,6,25,-93,-13.285714285714286,94
0.2,7,37,-56,-7.0,63
0.2,8,-103,-159,-17.666666666666668,135
0.2,9,92,-67,-6.7,9
0.2,10,47,-20,-1.8181818181818181,53
0.2,11,-81,-101,-8.416666666666666,184
0.2,12,62,-39,-3.0,38
0.2,13,0,-39,-2.7857142857142856,102
0.2,14,27,-12,-0.8,75
0.2,15,69,57,3.5625,31
0.2,16,50,107,6.294117647058823,51
0.2,17,83,190,10.555555555555555,18
0.2,18,49,239,12.578947368421053,51
0.2,19,-80,159,7.95,114
0.2,20,-309,-150,-7.142857142857143,342
0.2,21,-32,-182,-8.272727272727273,134
0.2,22,-120,-302,-13.130434782608695,154
0.2,23,-55,-357,-14.875,87
0.2,24,-1,-358,-14.32,102
0.2,25,91,-267,-10.26923076923077,9
0.2,26,45,-222,-8.222222222222221,57
0.2,27,-8,-230,-8.214285714285714,48
0.2,28,71,-159,-5.482758620689655,29
0.2,29,75,-84,-2.8,27
0.2,30,40,-44,-1.4193548387096775,60
0.2,31,25,-19,-0.59375,75
0.2,32,-153,-172,-5.212121212121212,260
0.2,33,87,-85,-2.5,14
0.2,34,54,-31,-0.8857142857142857,47
0.2,35,-9,-40,-1.1111111111111112,129
0.2,36,48,8,0.21621621621621623,53
0.2,37,79,87,2.289473684210526,21
0.2,38,81,168,4.3076923076923075,20
0.2,39,-205,-37,-0.925,241
0.2,40,72,35,0.8536585365853658,29
0.2,41,-81,-46,-1.0952380952380953,115
0.2,42,25,-21,-0.4883720930232558,78
0.2,43,-71,-92,-2.090909090909091,177
0.2,44,26,-66,-1.4666666666666666,75
0.2,45,37,-29,-0.6304347826086957,69
0.2,46,55,26,0.5531914893617021,46
0.2,47,74,100,2.0833333333333335,26
0.2,48,29,129,2.63265306122449,72
0.2,49,26,155,3.1,76
0.2,50,90,245,4.803921568627451,10
0.2,51,77,322,6.1923076923076925,23
0.2,52,93,415,7.830188679245283,8
0.2,53,94,509,9.425925925925926,7
0.2,54,-288,221,4.0181818181818185,401
0.2,55,14,235,4.196428571428571,87
0.2,56,-171,64,1.1228070175438596,134
0.2,57,74,138,2.3793103448275863,26
0.2,58,84,222,3.76271186440678,17
0.2,59,-3,219,3.65,103
0.2,60,24,243,3.9836065573770494,77
0.2,61,74,317,5.112903225806452,26
0.2,62,53,370,5.873015873015873,47
0.2,63,93,463,7.234375,8
0.2,64,91,554,8.523076923076923,10
0.2,65,-43,511,7.742424242424242,75
0.2,66,49,560,8.35820895522388,52
0.2,67,-5,555,8.161764705882353,36
0.2,68,78,633,9.173913043478262,22
0.2,69,19,652,9.314285714285715,82
0.2,70,77,729,10.267605633802816,24
0.2,71,77,806,11.194444444444445,24
0.2,72,-65,741,10.150684931506849,167
0.2,73,40,781,10.554054054054054,64
0.2,74,4,785,10.466666666666667,97
0.2,75,61,846,11.131578947368421,39
0.2,76,19,865,11.233766233766234,83
0.2,77,95,960,12.307692307692308,6
0.2,78,-14,946,11.974683544303797,45
0.2,79,1,947,11.8375,100
0.2,80,70,1017,12.555555555555555,30
0.2,81,-72,945,11.524390243902438,105
0.2,82,69,1014,12.216867469879517,41
0.2,83,88,1102,13.119047619047619,12
0.2,84,9,1111,13.070588235294117,91
0.2,85,-31,1080,12.55813953488372,64
0.2,86,-113,967,11.114942528735632,214
0.2,87,21,988,11.227272727272727,79
0.2,88,75,1063,11.9438202247191,27
0.2,89,87,1150,12.777777777777779,13
0.2,90,-40,1110,12.197802197802197,151
0.2,91,70,1180,12.826086956521738,31
0.2,92,-60,1120,12.043010752688172,163
0.2,93,93,1213,12.904255319148936,8
0.2,94,-52,1161,12.221052631578948,152
0.2,95,75,1236,12.875,26
0.2,96,-7,1229,12.670103092783505,108
0.2,97,73,1302,13.285714285714286,27
0.2,98,39,1341,13.545454545454545,61
0.2,99,72,1413,14.13,28
0.2,100,82,1495,14.801980198019802,18
0.2,101,87,1582,15.509803921568627,14
0.2,102,-116,1466,14.233009708737864,148
0.2,103,25,1491,14.336538461538462,7
0.2,104,-78,1413,13.457142857142857,181
0.2,105,51,1464,13.81132075471698,50
0.2,106,63,1527,14.271028037383177,37
0.2,107,6,1533,14.194444444444445,97
0.2,108,-27,1506,13.81651376146789,128
0.2,109,-83,1423,12.936363636363636,186
0.2,110,70,1493,13.45045045045045,31
0.2,111,-8,1485,13.258928571428571,110
0.2,112,-19,1466,12.973451327433628,119
0.2,113,55,1521,13.342105263157896,45
0.2,114,70,1591,13.834782608695653,32
0.2,115,-83,1508,13.0,116
0.2,116,-4,1504,12.854700854700855,36
0.2,117,90,1594,13.508474576271187,11
0.2,118,-16,1578,13.260504201680673,48
0.2,119,75,1653,13.775,26
0.2,120,17,1670,13.801652892561984,103
0.2,121,47,1717,14.073770491803279,53
0.2,122,64,1781,14.479674796747968,36
0.2,123,-1,1780,14.35483870967742,32
0.2,124,-18,1762,14.096,118
0.2,125,32,1794,14.238095238095237,68
0.2,126,91,1885,14.84251968503937,10
0.2,127,55,1940,15.15625,46
0.2,128,-49,1891,14.65891472868217,152
0.2,129,-14,1877,14.438461538461539,46
0.2,130,25,1902,14.51908396946565,76
0.2,131,88,1990,15.075757575757576,12
0.2,132,45,2035,15.300751879699249,56
0.2,133,91,2126,15.865671641791044,10
0.2,134,0,2126,15.748148148148148,102
0.2,135,-32,2094,15.397058823529411,138
0.2,136,85,2179,15.905109489051094,16
0.2,137,62,2241,16.23913043478261,39
0.2,138,53,2294,16.503597122302157,48
0.2,139,74,2368,16.914285714285715,27
0.2,140,74,2442,17.319148936170212,27
0.2,141,84,2526,17.788732394366196,17
0.2,142,87,2613,18.272727272727273,14
0.2,143,-89,2524,17.52777777777778,216
0.2,144,-123,2401,16.55862068965517,87
0.2,145,91,2492,17.068493150684933,10
0.2,146,88,2580,17.551020408163264,13
0.2,147,9,2589,17.493243243243242,91
0.2,148,15,2604,17.476510067114095,85
0.2,149,91,2695,17.966666666666665,9
0.2,150,-12,2683,17.7682119205298,118
0.2,151,35,2718,17.88157894736842,65
0.2,152,-249,2469,16.137254901960784,292
0.2,153,50,2519,16.357142857142858,52
0.2,154,-20,2499,16.12258064516129,125
0.2,155,92,2591,16.608974358974358,9
0.2,156,52,2643,16.8343949044586,49
0.2,157,63,2706,17.126582278481013,37
0.2,158,92,2798,17.59748427672956,9
0.2,159,28,2826,17.6625,73
0.2,160,70,2896,17.987577639751553,30
0.2,161,93,2989,18.450617283950617,7
0.2,162,38,3027,18.570552147239265,64
0.2,163,52,3079,18.774390243902438,50
0.2,164,-143,2936,17.793939393939393,176
0.2,165,76,3012,18.14457831325301,25
0.2,166,-131,2881,17.251497005988025,234
0.2,167,-26,2855,16.99404761904762,127
0.2,168,77,2932,17.349112426035504,23
0.2,169,87,3019,17.758823529411764,14
0.2,170,50,3069,17.94736842105263,50
0.2,171,14,3083,17.924418604651162,87
0.2,172,44,3127,18.07514450867052,56
0.2,173,-118,3009,17.29310344827586,150
0.2,174,88,3097,17.697142857142858,12
0.2,175,70,3167,17.994318181818183,32
0.2,176,83,3250,18.361581920903955,17
0.2,177,74,3324,18.674157303370787,26
0.2,178,18,3342,18.670391061452513,82
0.2,179,83,3425,19.02777777777778,17
0.2,180,56,3481,19.23204419889503,44
0.2,181,-67,3414,18.75824175824176,99
0.2,182,95,3509,19.174863387978142,6
0.2,183,-12,3497,19.005434782608695,112
0.2,184,93,3590,19.405405405405407,7
0.2,185,82,3672,19.741935483870968,18
0.2,186,95,3767,20.144385026737968,6
0.2,187,-179,3588,19.085106382978722,226
0.2,188,-8,3580,18.941798941798943,39
0.2,189,-91,3489,18.36315789473684,124
0.2,190,-10,3479,18.214659685863875,120
0.2,191,91,3570,18.59375,9
0.2,192,89,3659,18.958549222797927,11
0.2,193,-29,3630,18.711340206185568,132
0.2,194,-163,3467,17.77948717948718,217
0.2,195,82,3549,18.107142857142858,21
0.2,196,67,3616,18.35532994923858,33
0.2,197,86,3702,18.696969696969695,15
0.2,198,83,3785,19.020100502512562,18
0.2,199,-58,3727,18.635,91
0.2,200,87,3814,18.975124378109452,13
0.2,201,68,3882,19.217821782178216,32
0.2,202,91,3973,19.571428571428573,9
0.2,203,-34,3939,19.308823529411764,65
0.2,204,-147,3792,18.497560975609755,178
0.2,205,-93,3699,17.95631067961165,126
0.2,206,76,3775,18.23671497584541,26
0.2,207,51,3826,18.39423076923077,49
0.2,208,-48,3778,18.076555023923444,149
0.2,209,-28,3750,17.857142857142858,129
0.2,210,63,3813,18.071090047393366,37
0.2,211,-49,3764,17.754716981132077,154
0.2,212,66,3830,17.981220657276996,34
0.2,213,-107,3723,17.397196261682243,210
0.2,214,-17,3706,17.23720930232558,119
0.2,215,79,3785,17.52314814814815,21
0.2,216,62,3847,17.72811059907834,38
0.2,217,55,3902,17.89908256880734,45
0.2,218,84,3986,18.200913242009133,17
0.2,219,84,4070,18.5,17
0.2,220,54,4124,18.660633484162897,47
0.2,221,-34,4090,18.423423423423422,136
0.2,222,23,4113,18.443946188340806,8
0.2,223,86,4199,18.745535714285715,15
0.2,224,82,4281,19.026666666666667,19
0.2,225,68,4349,19.243362831858406,32
0.2,226,57,4406,19.409691629955947,44
0.2,227,93,4499,19.732456140350877,8
0.2,228,61,4560,19.912663755458514,40
0.2,229,87,4647,20.204347826086956,13
0.2,230,58,4705,20.36796536796537,43
0.2,231,72,4777,20.59051724137931,29
0.2,232,9,4786,20.540772532188843,23
0.2,233,17,4803,20.525641025641026,15
0.2,234,68,4871,20.727659574468085,39
0.2,235,42,4913,20.81779661016949,60
0.2,236,75,4988,21.046413502109704,25
0.2,237,77,5065,21.281512605042018,24
0.2,238,31,5096,21.322175732217573,69
0.2,239,57,5153,21.470833333333335,47
0.2,240,23,5176,21.477178423236513,78
0.2,241,-57,5119,21.15289256198347,88
0.2,242,23,5142,21.160493827160494,77
0.2,243,-13,5129,21.020491803278688,44
0.2,244,92,5221,21.31020408163265,9
0.2,245,87,5308,21.577235772357724,14
0.2,246,-68,5240,21.214574898785425,170
0.2,247,90,5330,21.491935483870968,11
0.2,248,71,5401,21.690763052208837,30
0.2,249,62,5463,21.852,39
0.2,250,88,5551,22.115537848605577,13
0.2,251,-103,5448,21.61904761904762,206
0.2,252,87,5535,21.877470355731226,13
0.2,253,-10,5525,21.751968503937007,110
0.2,254,-6,5519,21.643137254901962,37
0.2,255,-12,5507,21.51171875,44
0.2,256,69,5576,21.69649805447471,31
0.2,257,66,5642,21.868217054263567,35
0.2,258,-14,5628,21.72972972972973,46
0.2,259,62,5690,21.884615384615383,39
0.2,260,65,5755,22.049808429118773,35
0.2,261,71,5826,22.236641221374047,30
0.2,262,93,5919,22.505703422053234,7
0.2,263,76,5995,22.708333333333332,25
0.2,264,90,6085,22.962264150943398,11
0.2,265,63,6148,23.112781954887218,37
0.2,266,76,6224,23.310861423220974,25
0.2,267,78,6302,23.51492537313433,23
0.2,268,-95,6207,23.074349442379184,198
0.2,269,-90,6117,22.655555555555555,122
0.2,270,-67,6050,22.324723247232473,100
0.2,271,43,6093,22.40073529411765,57
0.2,272,19,6112,22.388278388278387,81
0.2,273,-39,6073,22.164233576642335,72
0.2,274,57,6130,22.29090909090909,43
0.2,275,39,6169,22.35144927536232,63
0.2,276,71,6240,22.52707581227437,30
0.2,277,-56,6184,22.244604316546763,159
0.2,278,78,6262,22.444444444444443,22
0.2,279,67,6329,22.603571428571428,35
0.2,280,86,6415,22.82918149466192,14
0.2,281,-51,6364,22.56737588652482,94
0.2,282,66,6430,22.720848056537104,35
0.2,283,36,6466,22.767605633802816,65
0.2,284,17,6483,22.74736842105263,83
0.2,285,2,6485,22.674825174825173,30
0.2,286,73,6558,22.850174216027874,27
0.2,287,59,6617,22.975694444444443,41
0.2,288,86,6703,23.19377162629758,14
0.2,289,52,6755,23.29310344827586,49
0.2,290,-263,6492,22.309278350515463,228
0.2,291,82,6574,22.513698630136986,19
0.2,292,-36,6538,22.313993174061434,136
0.2,293,13,6551,22.282312925170068,19
0.2,294,94,6645,22.52542372881356,7
0.2,295,-96,6549,22.125,130
0.2,296,-182,6367,21.437710437710436,284
0.2,297,77,6444,21.624161073825505,43
0.2,298,47,6491,21.70903010033445,55
0.2,299,73,6564,21.88,28
0.2,300,34,6598,21.920265780730897,67
0.2,301,87,6685,22.135761589403973,13
0.2,302,26,6711,22.14851485148515,76
0.2,303,91,6802,22.375,10
0.2,304,85,6887,22.58032786885246,16
0.2,305,90,6977,22.80065359477124,11
0.2,306,50,7027,22.889250814332247,50
0.2,307,-45,6982,22.66883116883117,149
0.2,308,14,6996,22.640776699029125,86
0.2,309,30,7026,22.664516129032258,74
0.2,310,-108,6918,22.244372990353696,208
0.2,311,25,6943,22.253205128205128,76
0.2,312,-14,6929,22.13738019169329,115
0.2,313,13,6942,22.10828025477707,87
0.2,314,89,7031,22.32063492063492,12
0.2,315,93,7124,22.544303797468356,7
0.2,316,80,7204,22.725552050473187,21
0.2,317,87,7291,22.927672955974842,13
0.2,318,95,7386,23.153605015673982,6
0.2,319,24,7410,23.15625,7
0.2,320,-54,7356,22.91588785046729,156
0.2,321,92,7448,23.130434782608695,8
0.2,322,60,7508,23.24458204334365,41
0.2,323,80,7588,23.419753086419753,20
0.2,324,67,7655,23.553846153846155,34
0.2,325,88,7743,23.75153374233129,12
0.2,326,64,7807,23.874617737003057,37
0.2,327,15,7822,23.847560975609756,17
0.2,328,89,7911,24.045592705167174,11
0.2,329,91,8002,24.24848484848485,9
0.2,330,-46,7956,24.036253776435046,148
0.2,331,92,8048,24.240963855421686,9
0.2,332,52,8100,24.324324324324323,49
0.2,333,54,8154,24.41317365269461,46
0.2,334,83,8237,24.588059701492536,17
0.2,335,85,8322,24.767857142857142,16
0.2,336,86,8408,24.949554896142434,15
0.2,337,70,8478,25.08284023668639,32
0.2,338,-54,8424,24.849557522123895,86
0.2,339,65,8489,24.96764705882353,36
0.2,340,-260,8229,24.131964809384165,224
0.2,341,80,8309,24.295321637426902,20
0.2,342,83,8392,24.466472303207,17
0.2,343,8,8400,24.41860465116279,94
0.2,344,-72,8328,24.139130434782608,175
0.2,345,92,8420,24.335260115606935,9
0.2,346,67,8487,24.45821325648415,33
0.2,347,22,8509,24.451149425287355,80
0.2,348,31,8540,24.469914040114613,69
0.2,349,43,8583,24.52285714285714,58
0.2,350,76,8659,24.66951566951567,25
0.2,351,-351,8308,23.602272727272727,249
0.2,352,43,8351,23.657223796033993,57
0.2,353,83,8434,23.824858757062145,18
0.2,354,-40,8394,23.645070422535213,144
0.2,355,-90,8304,23.325842696629213,193
0.2,356,63,8367,23.436974789915965,37
0.2,357,-7,8360,23.35195530726257,110
0.2,358,93,8453,23.545961002785514,8
0.2,359,55,8508,23.633333333333333,45
0.2,360,36,8544,23.667590027700832,64
0.2,361,54,8598,23.751381215469614,47
0.2,362,77,8675,23.898071625344354,23
0.2,363,81,8756,24.054945054945055,22
0.2,364,-458,8298,22.734246575342464,515
0.2,365,89,8387,22.915300546448087,12
0.2,366,67,8454,23.03542234332425,34
0.2,367,-14,8440,22.934782608695652,47
0.2,368,-106,8334,22.585365853658537,208
0.2,369,-11,8323,22.494594594594595,112
0.2,370,-50,8273,22.299191374663074,150
0.2,371,85,8358,22.467741935483872,16
0.2,372,59,8417,22.5656836461126,43
0.2,373,-7,8410,22.486631016042782,107
0.2,374,92,8502,22.672,9
0.2,375,24,8526,22.675531914893618,76
0.2,376,63,8589,22.782493368700266,38
0.2,377,75,8664,22.92063492063492,26
0.2,378,69,8733,23.04221635883905,31
0.2,379,53,8786,23.121052631578948,49
0.2,380,93,8879,23.304461942257216,8
0.2,381,87,8966,23.471204188481675,13
0.2,382,-41,8925,23.302872062663184,86
0.2,383,78,9003,23.4453125,22
0.2,384,60,9063,23.54025974025974,40
0.2,385,-26,9037,23.411917098445596,127
0.2,386,-87,8950,23.126614987080103,121
0.2,387,88,9038,23.29381443298969,12
0.2,388,87,9125,23.457583547557842,13
0.2,389,30,9155,23.474358974358974,73
0.2,390,-8,9147,23.39386189258312,40
0.2,391,2,9149,23.339285714285715,30
0.2,392,-7,9142,23.262086513994912,38
0.2,393,77,9219,23.398477157360407,23
0.2,394,70,9289,23.51645569620253,30
0.2,395,51,9340,23.585858585858585,50
0.2,396,-84,9256,23.31486146095718,128
0.2,397,31,9287,23.334170854271356,70
0.2,398,13,9300,23.30827067669173,89
0.2,399,-3,9297,23.2425,104
0.2,400,94,9391,23.418952618453865,7
0.2,401,-204,9187,22.85323383084577,181
0.2,402,49,9236,22.918114143920594,51
0.2,403,95,9331,23.096534653465348,6
0.2,404,54,9385,23.17283950617284,46
0.2,405,-3,9382,23.108374384236452,103
0.2,406,44,9426,23.159705159705158,57
0.2,407,10,9436,23.127450980392158,91
0.2,408,-67,9369,22.90709046454768,173
0.2,409,-76,9293,22.665853658536584,178
0.2,410,15,9308,22.64720194647202,86
0.2,411,10,9318,22.616504854368934,93
0.2,412,-36,9282,22.47457627118644,68
0.2,413,93,9375,22.644927536231883,7
0.2,414,73,9448,22.766265060240965,27
0.2,415,66,9514,22.870192307692307,34
0.2,416,64,9578,22.968824940047963,36
0.2,417,66,9644,23.071770334928228,34
0.2,418,-82,9562,22.821002386634845,185
0.2,419,87,9649,22.973809523809525,13
0.2,420,89,9738,23.13064133016627,11
0.2,421,-16,9722,23.03791469194313,121
0.2,422,-40,9682,22.88888888888889,143
0.2,423,91,9773,23.04952830188679,10
0.2,424,86,9859,23.19764705882353,14
0.2,425,-170,9689,22.74413145539906,202
0.2,426,85,9774,22.88992974238876,15
0.2,427,27,9801,22.899532710280372,74
0.2,428,63,9864,22.993006993006993,38
0.2,429,-137,9727,22.62093023255814,170
0.2,430,39,9766,22.65893271461717,63
0.2,431,70,9836,22.76851851851852,30
0.2,432,84,9920,22.909930715935335,16
0.2,433,92,10012,23.069124423963135,9
0.2,434,76,10088,23.19080459770115,24
0.2,435,80,10168,23.321100917431192,21
0.2,436,65,10233,23.416475972540045,35
0.2,437,33,10266,23.438356164383563,67
0.2,438,-66,10200,23.234624145785876,98
0.2,439,-180,10020,22.772727272727273,216
0.2,440,46,10066,22.825396825396826,54
0.2,441,-173,9893,22.38235294117647,207
0.2,442,-197,9696,21.887133182844245,234
0.2,443,84,9780,22.027027027027028,16
0.2,444,69,9849,22.13258426966292,31
0.2,445,71,9920,22.242152466367713,30
0.2,446,92,10012,22.39821029082774,8
0.2,447,-14,9998,22.316964285714285,46
0.2,448,76,10074,22.43652561247216,24
0.2,449,69,10143,22.54,31
0.2,450,84,10227,22.676274944567627,16
0.2,451,93,10320,22.831858407079647,7
0.2,452,30,10350,22.8476821192053,70
0.2,453,34,10384,22.87224669603524,67
0.2,454,18,10402,22.861538461538462,82
0.2,455,45,10447,22.910087719298247,57
0.2,456,81,10528,23.037199124726477,19
0.2,457,27,10555,23.04585152838428,76
0.2,458,63,10618,23.132897603485837,38
0.2,459,48,10666,23.18695652173913,56
0.2,460,-228,10438,22.642082429501084,352
0.2,461,-19,10419,22.551948051948052,127
0.2,462,48,10467,22.606911447084233,53
0.2,463,45,10512,22.655172413793103,55
0.2,464,54,10566,22.72258064516129,47
0.2,465,18,10584,22.71244635193133,83
0.2,466,60,10644,22.792291220556745,40
0.2,467,76,10720,22.905982905982906,25
0.2,468,-169,10551,22.49680170575693,132
0.2,469,52,10603,22.559574468085106,49
0.2,470,12,10615,22.537154989384288,89
0.2,471,84,10699,22.66737288135593,16
0.2,472,70,10769,22.767441860465116,31
0.2,473,83,10852,22.89451476793249,18
0.2,474,-110,10742,22.614736842105263,211
0.2,475,92,10834,22.76050420168067,9
0.2,476,-208,10626,22.27672955974843,242
0.2,477,-53,10573,22.119246861924687,85
0.2,478,50,10623,22.177453027139876,50
0.2,479,95,10718,22.329166666666666,6
0.2,480,-342,10376,21.571725571725572,309
0.2,481,-124,10252,21.269709543568464,229
0.2,482,68,10320,21.366459627329192,33
0.2,483,93,10413,21.514462809917354,7
0.2,484,-187,10226,21.084536082474227,223
0.2,485,19,10245,21.080246913580247,13
0.2,486,54,10299,21.147843942505133,46
0.2,487,80,10379,21.26844262295082,21
0.2,488,-24,10355,21.175869120654397,126
0.2,489,-15,10340,21.102040816326532,117
0.2,490,49,10389,21.158859470468432,52
0.2,491,79,10468,21.276422764227643,21
0.2,492,-41,10427,21.150101419878297,142
0.2,493,-49,10378,21.008097165991902,149
0.2,494,-82,10296,20.8,115
0.2,495,-2,10294,20.754032258064516,105
0.2,496,70,10364,20.85311871227364,30
0.2,497,68,10432,20.947791164658636,33
0.2,498,-6,10426,20.893787575150302,107
0.2,499,-12,10414,20.828,114
0.2,500,-71,10343,20.644710578842314,174
0.2,501,73,10416,20.749003984063744,28
0.2,502,-53,10363,20.60238568588469,157
0.2,503,82,10445,20.724206349206348,18
0.2,504,-30,10415,20.623762376237625,133
0.2,505,61,10476,20.703557312252965,40
0.2,506,-65,10411,20.534516765285996,171
0.2,507,56,10467,20.60433070866142,44
0.2,508,75,10542,20.711198428290768,26
0.2,509,47,10589,20.762745098039215,57
0.2,510,87,10676,20.892367906066536,14
0.2,511,-12,10664,20.828125,114
0.2,512,69,10733,20.922027290448344,31
0.2,513,-64,10669,20.7568093385214,97
0.2,514,-48,10621,20.623300970873785,82
0.2,515,-292,10329,20.017441860465116,326
0.2,516,55,10384,20.085106382978722,46
0.2,517,-114,10270,19.826254826254825,147
0.2,518,-30,10240,19.730250481695567,130
0.2,519,71,10311,19.828846153846154,30
0.2,520,17,10328,19.82341650671785,84
0.2,521,37,10365,19.85632183908046,63
0.2,522,56,10421,19.925430210325047,45
0.2,523,75,10496,20.03053435114504,25
0.2,524,-13,10483,19.96761904761905,118
0.2,525,79,10562,20.079847908745247,22
0.2,526,73,10635,20.180265654648956,28
0.2,527,-65,10570,20.018939393939394,100
0.2,528,-14,10556,19.954631379962194,115
0.2,529,16,10572,19.947169811320755,85
0.2,530,74,10646,20.048964218455744,27
0.2,531,93,10739,20.18609022556391,7
0.2,532,-69,10670,20.0187617260788,172
0.2,533,26,10696,20.029962546816478,75
0.2,534,-311,10385,19.411214953271028,345
0.2,535,82,10467,19.527985074626866,19
0.2,536,3,10470,19.497206703910614,100
0.2,537,47,10517,19.54832713754647,53
0.2,538,67,10584,19.636363636363637,33
0.2,539,42,10626,19.677777777777777,60
0.2,540,85,10711,19.798521256931608,16
0.2,541,-216,10495,19.363468634686345,323
0.2,542,76,10571,19.467771639042358,25
0.2,543,20,10591,19.46875,12
0.2,544,43,10634,19.511926605504588,57
0.2,545,-77,10557,19.335164835164836,180
0.2,546,10,10567,19.318098720292504,91
0.2,547,25,10592,19.32846715328467,75
0.2,548,88,10680,19.453551912568305,13
0.2,549,-146,10534,19.152727272727272,179
0.2,550,51,10585,19.210526315789473,50
0.2,551,82,10667,19.32427536231884,18
0.2,552,-190,10477,18.945750452079565,154
0.2,553,64,10541,19.02707581227437,36
0.2,554,91,10632,19.156756756756756,9
0.2,555,55,10687,19.221223021582734,46
0.2,556,-48,10639,19.100538599640934,152
0.2,557,-185,10454,18.734767025089607,289
0.2,558,14,10468,18.726296958855098,86
0.2,559,-83,10385,18.544642857142858,119
0.2,560,46,10431,18.593582887700535,54
0.2,561,65,10496,18.676156583629894,35
0.2,562,-29,10467,18.591474245115453,60
0.2,563,-30,10437,18.50531914893617,62
0.2,564,-130,10307,18.242477876106193,162
0.2,565,57,10364,18.31095406360424,44
0.2,566,59,10423,18.382716049382715,41
0.2,567,2,10425,18.35387323943662,100
0.2,568,49,10474,18.40773286467487,52
0.2,569,74,10548,18.50526315789474,27
0.2,570,43,10591,18.548161120840632,57
0.2,571,2,10593,18.51923076923077,98
0.2,572,43,10636,18.56195462478185,57
0.2,573,54,10690,18.62369337979094,46
0.2,574,-27,10663,18.544347826086955,127
0.2,575,62,10725,18.619791666666668,39
0.2,576,83,10808,18.731369150779894,17
0.2,577,56,10864,18.79584775086505,44
0.2,578,80,10944,18.901554404145077,20
0.2,579,69,11013,18.98793103448276,31
0.2,580,-13,11000,18.9328743545611,114
0.2,581,84,11084,19.0446735395189,16
0.2,582,62,11146,19.11835334476844,38
0.2,583,-68,11078,18.96917808219178,168
0.2,584,50,11128,19.022222222222222,50
0.2,585,-70,11058,18.870307167235495,103
0.2,586,23,11081,18.87734241908007,9
0.2,587,89,11170,18.996598639455783,12
0.2,588,48,11218,19.045840407470287,53
0.2,589,-19,11199,18.98135593220339,119
0.2,590,-174,11025,18.65482233502538,180
0.2,591,68,11093,18.738175675675677,32
0.2,592,76,11169,18.834738617200674,24
0.2,593,11,11180,18.82154882154882,90
0.2,594,-20,11160,18.756302521008404,123
0.2,595,88,11248,18.87248322147651,13
0.2,596,50,11298,18.92462311557789,51
0.2,597,77,11375,19.02173913043478,23
0.2,598,-331,11044,18.437395659432386,367
0.2,599,62,11106,18.51,39
0.2,600,-187,10919,18.168053244592347,224
0.2,601,77,10996,18.26578073089701,24
0.2,602,82,11078,18.371475953565504,18
0.2,603,60,11138,18.44039735099338,41
0.2,604,78,11216,18.538842975206613,22
0.2,605,81,11297,18.641914191419144,21
0.2,606,-14,11283,18.58813838550247,46
0.2,607,62,11345,18.65953947368421,39
0.2,608,-10,11335,18.61247947454844,42
0.2,609,-129,11206,18.37049180327869,161
0.2,610,47,11253,18.41734860883797,53
0.2,611,24,11277,18.426470588235293,77
0.2,612,-25,11252,18.355628058727568,56
0.2,613,73,11325,18.444625407166125,27
0.2,614,90,11415,18.5609756097561,11
0.2,615,1,11416,18.532467532467532,32
0.2,616,69,11485,18.61426256077796,32
0.2,617,-5,11480,18.576051779935273,36
0.2,618,66,11546,18.652665589660742,35
0.2,619,11,11557,18.64032258064516,91
0.2,620,89,11646,18.753623188405797,11
0.2,621,3,11649,18.728295819935692,128
0.2,622,62,11711,18.797752808988765,38
0.2,623,91,11802,18.91346153846154,9
0.2,624,40,11842,18.9472,61
0.2,625,65,11907,19.02076677316294,36
0.2,626,3,11910,18.995215311004785,99
0.2,627,78,11988,19.089171974522294,24
0.2,628,59,12047,19.15262321144674,41
0.2,629,88,12135,19.261904761904763,13
0.2,630,40,12175,19.294770206022186,61
0.2,631,83,12258,19.395569620253166,17
0.2,632,19,12277,19.394944707740915,81
0.2,633,61,12338,19.460567823343847,40
0.2,634,-36,12302,19.373228346456692,148
0.2,635,-75,12227,19.2248427672956,122
0.2,636,85,12312,19.328100470957615,16
0.2,637,64,12376,19.398119122257054,36
0.2,638,92,12468,19.511737089201876,8
0.2,639,87,12555,19.6171875,13
0.2,640,62,12617,19.683307332293293,39
0.2,641,86,12703,19.786604361370717,15
0.2,642,-13,12690,19.73561430793157,113
0.2,643,45,12735,19.774844720496894,55
0.2,644,-149,12586,19.513178294573642,111
0.2,645,78,12664,19.603715170278637,23
0.2,646,55,12719,19.658423493044822,52
0.2,647,71,12790,19.737654320987655,30
0.2,648,-40,12750,19.645608628659478,72
0.2,649,-33,12717,19.564615384615383,136
0.2,650,92,12809,19.67588325652842,8
0.2,651,84,12893,19.774539877300615,25
0.2,652,28,12921,19.787136294027565,73
0.2,653,4,12925,19.762996941896024,97
0.2,654,64,12989,19.830534351145037,36
0.2,655,24,13013,19.836890243902438,77
0.2,656,-197,12816,19.506849315068493,244
0.2,657,49,12865,19.551671732522795,52
0.2,658,-21,12844,19.490136570561457,140
0.2,659,28,12872,19.503030303030304,72
0.2,660,86,12958,19.603630862329805,15
0.2,661,92,13050,19.71299093655589,8
0.2,662,89,13139,19.817496229260936,12
0.2,663,36,13175,19.841867469879517,65
0.2,664,61,13236,19.90375939849624,40
0.2,665,70,13306,19.97897897897898,30
0.2,666,45,13351,20.01649175412294,55
0.2,667,69,13420,20.089820359281436,31
0.2,668,-183,13237,19.78624813153961,218
0.2,669,73,13310,19.865671641791046,28
0.2,670,56,13366,19.91952309985097,44
0.2,671,-37,13329,19.834821428571427,68
0.2,672,90,13419,19.939078751857355,10
0.2,673,26,13445,19.948071216617212,74
0.2,674,-74,13371,19.808888888888887,179
0.2,675,-86,13285,19.652366863905325,186
0.2,676,54,13339,19.703101920236335,47
0.2,677,70,13409,19.777286135693217,31
0.2,678,84,13493,19.871870397643594,17
0.2,679,69,13562,19.944117647058825,32
0.2,680,24,13586,19.95007342143906,83
0.2,681,-4,13582,19.914956011730204,105
0.2,682,3,13585,19.890190336749633,97
0.2,683,75,13660,19.970760233918128,25
0.2,684,-185,13475,19.67153284671533,220
0.2,685,42,13517,19.70408163265306,59
0.2,686,57,13574,19.758369723435226,81
0.2,687,48,13622,19.799418604651162,53
0.2,688,-117,13505,19.60087082728592,80
0.2,689,52,13557,19.64782608695652,50
0.2,690,-8,13549,19.60781476121563,111
0.2,691,78,13627,19.692196531791907,23
0.2,692,-313,13314,19.21212121212121,366
0.2,693,60,13374,19.270893371757925,54
0.2,694,89,13463,19.371223021582733,11
0.2,695,49,13512,19.413793103448278,51
0.2,696,94,13606,19.52080344332855,6
0.2,697,68,13674,19.59025787965616,33
0.2,698,-64,13610,19.470672389127326,164
0.2,699,91,13701,19.572857142857142,10
0.2,700,82,13783,19.66191155492154,19
0.2,701,78,13861,19.745014245014247,22
0.2,702,93,13954,19.84921763869132,7
0.2,703,-114,13840,19.65909090909091,241
0.2,704,26,13866,19.66808510638298,75
0.2,705,-31,13835,19.596317280453256,63
0.2,706,81,13916,19.683168316831683,20
0.2,707,-1,13915,19.653954802259886,101
0.2,708,-11,13904,19.61071932299013,111
0.2,709,-111,13793,19.42676056338028,142
0.2,710,57,13850,19.47960618846695,44
0.2,711,66,13916,19.54494382022472,35
0.2,712,67,13983,19.611500701262273,33
0.2,713,95,14078,19.717086834733895,6
0.2,714,12,14090,19.706293706293707,90
0.2,715,71,14161,19.777932960893853,31
0.2,716,-35,14126,19.701534170153415,135
0.2,717,37,14163,19.725626740947074,64
0.2,718,50,14213,19.767732962447845,59
0.2,719,53,14266,19.81388888888889,49
0.2,720,43,14309,19.84604715672677,57
0.2,721,94,14403,19.94875346260388,7
0.2,722,-5,14398,19.914246196403873,107
0.2,723,-37,14361,19.835635359116022,146
0.2,724,-9,14352,19.795862068965516,117
0.2,725,0,14352,19.768595041322314,114
0.2,726,-71,14281,19.643741403026134,175
0.2,727,69,14350,19.71153846153846,31
0.2,728,-23,14327,19.652949245541837,124
0.2,729,-9,14318,19.613698630136987,109
0.2,730,-14,14304,19.567715458276332,114
0.2,731,24,14328,19.57377049180328,78
0.2,732,90,14418,19.669849931787176,11
0.2,733,52,14470,19.713896457765667,50
0.2,734,78,14548,19.793197278911563,22
0.2,735,84,14632,19.880434782608695,17
0.2,736,70,14702,19.948439620081412,30
0.2,737,55,14757,19.995934959349594,46
0.2,738,1,14758,19.9702300405954,102
0.2,739,85,14843,20.058108108108108,16
0.2,740,-88,14755,19.912280701754387,120
0.2,741,71,14826,19.9811320754717,29
0.2,742,70,14896,20.048452220726784,30
0.2,743,13,14909,20.038978494623656,19
0.2,744,81,14990,20.120805369127517,19
0.2,745,-48,14942,20.029490616621985,152
0.2,746,72,15014,20.099062918340028,29
0.2,747,41,15055,20.127005347593585,59
0.2,748,55,15110,20.173564753004005,45
0.2,749,-19,15091,20.121333333333332,122
0.2,750,64,15155,20.1797603195739,37
0.2,751,50,15205,20.21941489361702,51
0.2,752,13,15218,20.209827357237717,102
0.2,753,-17,15201,20.160477453580903,121
0.2,754,94,15295,20.258278145695364,7
0.2,755,91,15386,20.35185185185185,9
0.2,756,70,15456,20.417437252311757,31
0.2,757,19,15475,20.4155672823219,81
0.2,758,-8,15467,20.37812911725955,109
0.2,759,91,15558,20.471052631578946,9
0.2,760,-47,15511,20.38239159001314,147
0.2,761,-234,15277,20.048556430446194,227
0.2,762,-28,15249,19.985583224115334,60
0.2,763,51,15300,20.026178010471206,50
0.2,764,-255,15045,19.666666666666668,220
0.2,765,92,15137,19.761096605744125,8
0.2,766,53,15190,19.804432855280314,47
0.2,767,35,15225,19.82421875,67
0.2,768,92,15317,19.91807542262679,8
0.2,769,33,15350,19.935064935064936,69
0.2,770,91,15441,20.027237354085603,10
0.2,771,62,15503,20.08160621761658,38
0.2,772,76,15579,20.153945666235447,24
0.2,773,-56,15523,20.055555555555557,88
0.2,774,1,15524,20.030967741935484,99
0.2,775,65,15589,20.088917525773194,36
0.2,776,-163,15426,19.853281853281853,196
0.2,777,21,15447,19.854755784061698,79
0.2,778,89,15536,19.94351732991014,12
0.2,779,24,15560,19.94871794871795,76
0.2,780,49,15609,19.985915492957748,52
0.2,781,20,15629,19.985933503836318,12
0.2,782,-154,15475,19.763729246487866,185
0.2,783,37,15512,19.785714285714285,63
0.2,784,-369,15143,19.290445859872612,408
0.2,785,16,15159,19.286259541984734,85
0.2,786,56,15215,19.332909783989834,44
0.2,787,-42,15173,19.25507614213198,142
0.2,788,69,15242,19.318124207858048,31
0.2,789,86,15328,19.40253164556962,14
0.2,790,46,15374,19.436156763590393,55
0.2,791,67,15441,19.49621212121212,34
0.2,792,39,15480,19.52080706179067,61
0.2,793,95,15575,19.615869017632242,6
0.2,794,4,15579,19.59622641509434,99
0.2,795,87,15666,19.680904522613066,14
0.2,796,-270,15396,19.317440401505646,396
0.2,797,42,15438,19.345864661654137,60
0.2,798,50,15488,19.384230287859825,51
0.2,799,84,15572,19.465,17
0.2,800,-66,15506,19.358302122347066,167
0.2,801,81,15587,19.435162094763093,20
0.2,802,-1,15586,19.409713574097136,102
0.2,803,63,15649,19.463930348258707,38
0.2,804,43,15692,19.493167701863353,58
0.2,805,75,15767,19.562034739454095,27
0.2,806,5,15772,19.543990086741015,96
0.2,807,82,15854,19.621287128712872,18
0.2,808,30,15884,19.634116192830657,72
0.2,809,7,15891,19.618518518518517,121
0.2,810,48,15939,19.65351418002466,54
0.2,811,82,16021,19.730295566502463,18
0.2,812,81,16102,19.805658056580565,20
0.2,813,-106,15996,19.651105651105652,142
0.2,814,-10,15986,19.614723926380368,112
0.2,815,63,16049,19.667892156862745,37
0.2,816,95,16144,19.760097919216648,6
0.2,817,-2,16142,19.73349633251834,102
0.2,818,80,16222,19.807081807081808,20
0.2,819,92,16314,19.89512195121951,9
0.2,820,86,16400,19.97563946406821,15
0.2,821,-43,16357,19.899026763990268,75
0.2,822,73,16430,19.963547995139734,28
0.2,823,79,16509,20.035194174757283,21
0.2,824,-27,16482,19.978181818181817,60
0.2,825,12,16494,19.968523002421307,90
0.2,826,61,16555,20.01813784764208,40
0.2,827,66,16621,20.07367149758454,38
0.2,828,54,16675,20.1145958986731,46
0.2,829,87,16762,20.195180722891568,14
0.2,830,60,16822,20.243080625752107,43
0.2,831,-6,16816,20.21153846153846,106
0.2,832,46,16862,20.24249699879952,54
0.2,833,85,16947,20.320143884892087,15
0.2,834,11,16958,20.308982035928143,90
0.2,835,91,17049,20.39354066985646,10
0.2,836,-59,16990,20.29868578255675,195
0.2,837,76,17066,20.365155131264917,24
0.2,838,-53,17013,20.2777115613826,85
0.2,839,-242,16771,19.965476190476192,352
0.2,840,-80,16691,19.846611177170036,114
0.2,841,46,16737,19.877672209026127,62
0.2,842,-83,16654,19.755634638196916,194
0.2,843,-37,16617,19.688388625592417,68
0.2,844,64,16681,19.740828402366866,37
0.2,845,73,16754,19.803782505910167,27
0.2,846,-112,16642,19.648170011806375,155
0.2,847,-110,16532,19.495283018867923,213
0.2,848,87,16619,19.574793875147233,14
0.2,849,33,16652,19.590588235294117,69
0.2,850,82,16734,19.663924794359577,18
0.2,851,77,16811,19.731220657276996,24
0.2,852,43,16854,19.75849941383353,58
0.2,853,71,16925,19.818501170960186,30
0.2,854,87,17012,19.89707602339181,13
0.2,855,80,17092,19.96728971962617,20
0.2,856,-75,17017,19.856476079346557,178
0.2,857,10,17027,19.844988344988344,21
0.2,858,39,17066,19.86728754365541,63
0.2,859,75,17141,19.93139534883721,25
0.2,860,83,17224,20.004645760743323,18
0.2,861,20,17244,20.004640371229698,80
0.2,862,65,17309,20.05677867902665,36
0.2,863,-62,17247,19.961805555555557,165
0.2,864,87,17334,20.039306358381502,14
0.2,865,-91,17243,19.91108545034642,122
0.2,866,-142,17101,19.724336793540946,107
0.2,867,-57,17044,19.63594470046083,171
0.2,868,-161,16883,19.42807825086306,273
0.2,869,-61,16822,19.335632183908046,163
0.2,870,73,16895,19.39724454649828,27
0.2,871,34,16929,19.413990825688074,67
0.2,872,75,17004,19.477663230240548,26
0.2,873,79,17083,19.545766590389015,21
0.2,874,34,17117,19.562285714285714,67
0.2,875,-100,17017,19.42579908675799,138
0.2,876,68,17085,19.481185860889397,33
0.2,877,-98,16987,19.34738041002278,200
0.2,878,82,17069,19.418657565415245,18
0.2,879,61,17130,19.46590909090909,39
0.2,880,25,17155,19.472190692395007,6
0.2,881,57,17212,19.514739229024944,45
0.2,882,-46,17166,19.440543601359003,150
0.2,883,18,17184,19.43891402714932,85
0.2,884,-203,16981,19.187570621468925,238
0.2,885,24,17005,19.193002257336342,78
0.2,886,1,17006,19.172491544532132,100
0.2,887,86,17092,19.24774774774775,14
0.2,888,89,17181,19.32620922384702,11
0.2,889,77,17258,19.391011235955055,23
0.2,890,22,17280,19.393939393939394,79
0.2,891,69,17349,19.449551569506728,32
0.2,892,93,17442,19.53191489361702,7
0.2,893,31,17473,19.54474272930649,70
0.2,894,46,17519,19.574301675977654,55
0.2,895,-16,17503,19.534598214285715,116
0.2,896,23,17526,19.53846153846154,9
0.2,897,-4,17522,19.51224944320713,106
0.2,898,76,17598,19.57508342602892,25
0.2,899,70,17668,19.63111111111111,31
0.2,900,62,17730,19.67813540510544,38
0.2,901,62,17792,19.725055432372507,38
0.2,902,89,17881,19.801771871539312,11
0.2,903,56,17937,19.841814159292035,44
0.2,904,-100,17837,19.70939226519337,202
0.2,905,51,17888,19.7439293598234,49
0.2,906,23,17911,19.747519294377067,9
0.2,907,-174,17737,19.534140969162994,283
0.2,908,51,17788,19.56875687568757,51
0.2,909,73,17861,19.627472527472527,28
0.2,910,-50,17811,19.551042810098792,161
0.2,911,-38,17773,19.48793859649123,70
0.2,912,60,17833,19.532311062431546,41
0.2,913,43,17876,19.557986870897157,58
0.2,914,43,17919,19.58360655737705,57
0.2,915,89,18008,19.65938864628821,11
0.2,916,94,18102,19.740458015267176,6
0.2,917,84,18186,19.81045751633987,16
0.2,918,73,18259,19.868335146898804,27
0.2,919,92,18351,19.946739130434782,9
0.2,920,84,18435,20.01628664495114,17
0.2,921,58,18493,20.057483731019524,43
0.2,922,47,18540,20.08667388949079,54
0.2,923,92,18632,20.164502164502164,8
0.2,924,82,18714,20.23135135135135,19
0.2,925,-5,18709,20.204103671706264,107
0.2,926,-37,18672,20.142394822006473,69
0.2,927,78,18750,20.204741379310345,22
0.2,928,-66,18684,20.11194833153929,172
0.2,929,61,18745,20.155913978494624,42
0.2,930,94,18839,20.235230934479056,6
0.2,931,64,18903,20.282188841201716,36
0.2,932,94,18997,20.361200428724544,6
0.2,933,95,19092,20.441113490364025,6
0.2,934,-33,19059,20.383957219251336,133
0.2,935,87,19146,20.455128205128204,13
0.2,936,23,19169,20.457844183564568,80
0.2,937,48,19217,20.48720682302772,55
0.2,938,84,19301,20.554845580404685,16
0.2,939,83,19384,20.621276595744682,17
0.2,940,-17,19367,20.581296493092456,118
0.2,941,-71,19296,20.484076433121018,104
0.2,942,-45,19251,20.414634146341463,148
0.2,943,49,19300,20.444915254237287,52
0.2,944,53,19353,20.479365079365078,47
0.2,945,-141,19212,20.308668076109935,105
0.2,946,-118,19094,20.162618796198522,153
0.2,947,17,19111,20.15928270042194,14
0.2,948,-130,18981,20.001053740779767,231
0.2,949,83,19064,20.06736842105263,17
0.2,950,-124,18940,19.915878023133544,235
0.2,951,-14,18926,19.880252100840337,116
0.2,952,51,18977,19.912906610703043,49
0.2,953,-54,18923,19.835429769392032,157
0.2,954,44,18967,19.860732984293193,57
0.2,955,-103,18864,19.732217573221757,135
0.2,956,48,18912,19.761755485893417,53
0.2,957,91,19003,19.836116910229645,10
0.2,958,56,19059,19.873826903023982,44
0.2,959,-289,18770,19.552083333333332,397
0.2,960,-37,18733,19.493236212278877,70
0.2,961,-95,18638,19.374220374220375,200
0.2,962,68,18706,19.424714434060228,32
0.2,963,-24,18682,19.37966804979253,127
0.2,964,40,18722,19.40103626943005,61
0.2,965,40,18762,19.422360248447205,60
0.2,966,-116,18646,19.282316442606,150
0.2,967,89,18735,19.354338842975206,11
0.2,968,24,18759,19.359133126934985,8
0.2,969,-116,18643,19.21958762886598,157
0.2,970,-66,18577,19.131822863027807,171
0.2,971,65,18642,19.179012345679013,36
0.2,972,83,18725,19.244604316546763,18
0.2,973,5,18730,19.229979466119097,96
0.2,974,-26,18704,19.183589743589742,60
0.2,975,20,18724,19.184426229508198,91
0.2,976,75,18799,19.24155578300921,25
0.2,977,49,18848,19.2719836400818,51
0.2,978,55,18903,19.308478038815117,45
0.2,979,-2,18901,19.286734693877552,121
0.2,980,-81,18820,19.184505606523956,112
0.2,981,14,18834,19.179226069246436,87
0.2,982,-32,18802,19.127161749745678,134
0.2,983,71,18873,19.179878048780488,29
0.2,984,11,18884,19.171573604060914,89
0.2,985,16,18900,19.168356997971603,86
0.2,986,42,18942,19.19148936170213,66
0.2,987,47,18989,19.219635627530366,53
0.2,988,-120,18869,19.0788675429727,152
0.2,989,54,18923,19.114141414141415,46
0.2,990,20,18943,19.115035317860748,84
0.2,991,76,19019,19.172379032258064,25
0.2,992,87,19106,19.240684793554884,14
0.2,993,39,19145,19.260563380281692,61
0.2,994,25,19170,19.266331658291456,78
0.2,995,77,19247,19.32429718875502,23
0.2,996,16,19263,19.320962888666,16
0.2,997,71,19334,19.372745490981963,29
0.2,998,-18,19316,19.335335335335337,50
0.2,999,92,19408,19.408,8
0.2,1000,3,19411,19.39160839160839,99
0.2,1001,-490,18921,18.88323353293413,471
0.2,1002,-101,18820,18.763708873379862,138
0.2,1003,-54,18766,18.691235059760956,155
0.2,1004,77,18843,18.749253731343284,24
0.2,1005,30,18873,18.76043737574553,71
0.2,1006,25,18898,18.76663356504469,75
0.2,1007,54,18952,18.8015873015873,46
0.2,1008,86,19038,18.86818632309217,15
0.2,1009,-22,19016,18.827722772277227,124
0.2,1010,81,19097,18.88921859545005,20
0.2,1011,58,19155,18.927865612648223,42
0.2,1012,19,19174,18.927936821322803,82
0.2,1013,92,19266,19.0,9
0.2,1014,-127,19139,18.85615763546798,229
0.2,1015,85,19224,18.921259842519685,16
0.2,1016,89,19313,18.99016715830875,11
0.2,1017,-89,19224,18.88408644400786,192
0.2,1018,83,19307,18.947006869479882,18
0.2,1019,78,19385,19.004901960784313,23
0.2,1020,-235,19150,18.756121449559256,269
0.2,1021,89,19239,18.82485322896282,12
0.2,1022,-25,19214,18.78201368523949,128
0.2,1023,-48,19166,18.716796875,148
0.2,1024,-79,19087,18.621463414634146,182
0.2,1025,58,19145,18.659844054580898,43
0.2,1026,-8,19137,18.63388510223953,41
0.2,1027,-8,19129,18.607976653696497,109
0.2,1028,-69,19060,18.522837706511176,171
0.2,1029,-158,18902,18.351456310679612,122
0.2,1030,77,18979,18.408341416100875,24
0.2,1031,94,19073,18.481589147286822,6
0.2,1032,75,19148,18.53630203291384,26
0.2,1033,89,19237,18.604448742746616,11
0.2,1034,76,19313,18.65990338164251,24
0.2,1035,26,19339,18.666988416988417,74
0.2,1036,81,19420,18.727097396335584,19
0.2,1037,47,19467,18.754335260115607,53
0.2,1038,83,19550,18.816169393647737,18
0.2,1039,-41,19509,18.758653846153845,141
0.2,1040,81,19590,18.818443804034583,20
0.2,1041,-122,19468,18.683301343570058,237
0.2,1042,-202,19266,18.471716203259827,166
0.2,1043,-10,19256,18.444444444444443,42
0.2,1044,-37,19219,18.391387559808614,137
0.2,1045,42,19261,18.41395793499044,58
0.2,1046,26,19287,18.421203438395416,74
0.2,1047,37,19324,18.438931297709924,64
0.2,1048,88,19412,18.505243088655863,12
0.2,1049,70,19482,18.554285714285715,30
0.2,1050,-18,19464,18.51950523311132,139
0.2,1051,90,19554,18.58745247148289,11
0.2,1052,56,19610,18.62298195631529,45
0.2,1053,-30,19580,18.57685009487666,63
0.2,1054,32,19612,18.58957345971564,68
0.2,1055,52,19664,18.62121212121212,50
0.2,1056,-197,19467,18.417218543046356,229
0.2,1057,18,19485,18.416824196597354,84
0.2,1058,94,19579,18.48819641170916,6
0.2,1059,75,19654,18.541509433962265,26
0.2,1060,60,19714,18.58058435438266,40
0.2,1061,15,19729,18.577212806026367,86
0.2,1062,89,19818,18.64346190028222,12
0.2,1063,30,19848,18.654135338345863,70
0.2,1064,54,19902,18.687323943661973,46
0.2,1065,90,19992,18.75422138836773,10
0.2,1066,59,20051,18.791940018744143,42
0.2,1067,49,20100,18.820224719101123,69
0.2,1068,-84,20016,18.72404115996258,119
0.2,1069,-10,20006,18.697196261682244,111
0.2,1070,-44,19962,18.638655462184875,76
0.2,1071,45,20007,18.663246268656717,55
0.2,1072,76,20083,18.71668219944082,25
0.2,1073,-28,20055,18.6731843575419,128
0.2,1074,39,20094,18.692093023255815,62
0.2,1075,41,20135,18.71282527881041,62
0.2,1076,65,20200,18.755803156917363,35
0.2,1077,-121,20079,18.626159554730982,156
0.2,1078,45,20124,18.650602409638555,56
0.2,1079,85,20209,18.71203703703704,16
0.2,1080,-91,20118,18.61054579093432,122
0.2,1081,37,20155,18.6275415896488,64
0.2,1082,-150,20005,18.471837488457986,113
0.2,1083,82,20087,18.530442804428045,18
0.2,1084,86,20173,18.5926267281106,14
0.2,1085,79,20252,18.648250460405155,22
0.2,1086,64,20316,18.689972401103955,37
0.2,1087,77,20393,18.743566176470587,25
0.2,1088,72,20465,18.79247015610652,29
0.2,1089,93,20558,18.860550458715597,8
0.2,1090,62,20620,18.900091659028416,40
0.2,1091,88,20708,18.963369963369964,13
0.2,1092,-120,20588,18.836230558096982,223
0.2,1093,44,20632,18.859232175502743,81
0.2,1094,19,20651,18.859360730593608,84
0.2,1095,53,20704,18.89051094890511,47
0.2,1096,76,20780,18.94257064721969,25
0.2,1097,64,20844,18.983606557377048,36
0.2,1098,-45,20799,18.925386715195632,85
0.2,1099,51,20850,18.954545454545453,50
0.2,1100,55,20905,18.987284287011807,46
0.2,1101,85,20990,19.047186932849364,16
0.2,1102,-53,20937,18.9818676337262,153
0.2,1103,-186,20751,18.796195652173914,221
0.2,1104,-161,20590,18.63348416289593,195
0.2,1105,14,20604,18.629294755877034,86
0.2,1106,-4,20600,18.608852755194217,37
0.2,1107,82,20682,18.666064981949457,18
0.2,1108,78,20760,18.71956717763751,22
0.2,1109,39,20799,18.737837837837837,63
0.2,1110,36,20835,18.753375337533754,77
0.2,1111,40,20875,18.77248201438849,61
0.2,1112,33,20908,18.785265049415994,68
0.2,1113,27,20935,18.792639138240574,73
0.2,1114,86,21021,18.852914798206278,15
0.2,1115,-18,21003,18.81989247311828,118
0.2,1116,94,21097,18.887197851387647,6
0.2,1117,57,21154,18.92128801431127,44
0.2,1118,90,21244,18.984807864164434,10
0.2,1119,-40,21204,18.932142857142857,74
0.2,1120,46,21250,18.95628902765388,55
0.2,1121,-45,21205,18.89928698752228,146
0.2,1122,83,21288,18.956366874443454,18
0.2,1123,91,21379,19.020462633451956,9
0.2,1124,27,21406,19.027555555555555,74
0.2,1125,88,21494,19.088809946714033,12
0.2,1126,58,21552,19.123336291038154,43
0.2,1127,93,21645,19.18882978723404,8
0.2,1128,-9,21636,19.16386182462356,112
0.2,1129,84,21720,19.221238938053098,16
0.2,1130,-46,21674,19.163572060123784,163
0.2,1131,71,21745,19.209363957597173,30
0.2,1132,-58,21687,19.141218005295674,93
0.2,1133,87,21774,19.201058201058203,14
0.2,1134,53,21827,19.230837004405288,48
0.2,1135,74,21901,19.279049295774648,26
0.2,1136,71,21972,19.3245382585752,29
0.2,1137,92,22064,19.3884007029877,8
0.2,1138,62,22126,19.425812115891134,39
0.2,1139,-26,22100,19.385964912280702,128
0.2,1140,57,22157,19.418930762489044,44
0.2,1141,-14,22143,19.389667250437828,46
0.2,1142,49,22192,19.41557305336833,52
0.2,1143,56,22248,19.447552447552447,44
0.2,1144,-74,22174,19.36593886462882,175
0.2,1145,74,22248,19.413612565445025,26
0.2,1146,10,22258,19.405405405405407,22
0.2,1147,14,22272,19.4006968641115,86
0.2,1148,39,22311,19.4177545691906,61
0.2,1149,35,22346,19.43130434782609,66
0.2,1150,-56,22290,19.36576889661164,159
0.2,1151,10,22300,19.35763888888889,91
0.2,1152,23,22323,19.360797918473548,8
0.2,1153,-50,22273,19.300693240901214,154
0.2,1154,73,22346,19.347186147186147,28
0.2,1155,61,22407,19.383217993079583,40
0.2,1156,59,22466,19.417458945548834,42
0.2,1157,83,22549,19.47236614853195,17
0.2,1158,4,22553,19.459016393442624,28
0.2,1159,-38,22515,19.40948275862069,104
0.2,1160,-87,22428,19.31782945736434,120
0.2,1161,89,22517,19.377796901893287,12
0.2,1162,91,22608,19.43938091143594,10
0.2,1163,-36,22572,19.391752577319586,136
0.2,1164,-3,22569,19.372532188841202,105
0.2,1165,70,22639,19.415951972555746,31
0.2,1166,-174,22465,19.250214224507285,208
0.2,1167,39,22504,19.267123287671232,62
0.2,1168,-12,22492,19.24037639007699,113
0.2,1169,5,22497,19.22820512820513,96
0.2,1170,-175,22322,19.062339880444064,223
0.2,1171,6,22328,19.051194539249146,96
0.2,1172,95,22423,19.115942028985508,6
0.2,1173,-23,22400,19.08006814310051,125
0.2,1174,91,22491,19.14127659574468,9
0.2,1175,63,22554,19.178571428571427,62
0.2,1176,72,22626,19.223449447748514,28
0.2,1177,-165,22461,19.06706281833616,211
0.2,1178,79,22540,19.117896522476673,23
0.2,1179,17,22557,19.116101694915255,83
0.2,1180,59,22616,19.149872988992378,42
0.2,1181,-28,22588,19.109983079526227,129
0.2,1182,22,22610,19.11242603550296,78
0.2,1183,94,22704,19.175675675675677,7
0.2,1184,-65,22639,19.104641350210972,166
0.2,1185,92,22731,19.16610455311973,8
0.2,1186,11,22742,19.1592249368155,89
0.2,1187,94,22836,19.22222222222222,6
0.2,1188,-22,22814,19.187552565180823,53
0.2,1189,87,22901,19.24453781512605,14
0.2,1190,84,22985,19.298908480268683,16
0.2,1191,29,23014,19.30704697986577,71
0.2,1192,-115,22899,19.19446772841576,217
0.2,1193,83,22982,19.24790619765494,18
0.2,1194,47,23029,19.27112970711297,54
0.2,1195,74,23103,19.316889632107024,27
0.2,1196,-75,23028,19.238095238095237,177
0.2,1197,88,23116,19.29549248747913,12
0.2,1198,90,23206,19.35446205170976,10
0.2,1199,-13,23193,19.3275,45
0.2,1200,92,23285,19.388009991673606,8
0.2,1201,59,23344,19.420965058236273,42
0.2,1202,26,23370,19.42643391521197,6
0.2,1203,93,23463,19.487541528239202,8
0.2,1204,-53,23410,19.42738589211618,157
0.2,1205,69,23479,19.46849087893864,33
0.2,1206,-322,23157,19.185584092792045,286
0.2,1207,-35,23122,19.14072847682119,139
0.2,1208,83,23205,19.193548387096776,18
0.2,1209,68,23273,19.23388429752066,32
0.2,1210,47,23320,19.25681255161024,54
0.2,1211,4,23324,19.244224422442244,97
0.2,1212,85,23409,19.29843363561418,15
0.2,1213,-58,23351,19.23476112026359,93
0.2,1214,52,23403,19.261728395061727,49
0.2,1215,-20,23383,19.229440789473685,121
0.2,1216,-145,23238,19.094494658997537,248
0.2,1217,-219,23019,18.899014778325125,255
0.2,1218,81,23100,18.949958982772763,20
0.2,1219,-29,23071,18.910655737704918,130
0.2,1220,54,23125,18.939393939393938,47
0.2,1221,27,23152,18.945990180032734,73
0.2,1222,59,23211,18.97874080130826,42
0.2,1223,-153,23058,18.83823529411765,184
0.2,1224,93,23151,18.898775510204082,7
0.2,1225,-488,22663,18.48531810766721,391
0.2,1226,-108,22555,18.382233088834557,71
0.2,1227,35,22590,18.395765472312704,65
0.2,1228,39,22629,18.41253051261188,63
0.2,1229,86,22715,18.46747967479675,14
0.2,1230,-33,22682,18.425670186839966,137
0.2,1231,16,22698,18.4237012987013,85
0.2,1232,93,22791,18.484184914841848,8
0.2,1233,85,22876,18.53808752025932,26
0.2,1234,72,22948,18.581376518218622,29
0.2,1235,62,23010,18.616504854368934,39
0.2,1236,92,23102,18.67582861762328,9
0.2,1237,14,23116,18.67205169628433,107
0.2,1238,-71,23045,18.599677158999192,104
0.2,1239,73,23118,18.643548387096775,27
0.2,1240,87,23205,18.698630136986303,14
0.2,1241,71,23276,18.74074074074074,30
0.2,1242,38,23314,18.75623491552695,64
0.2,1243,-9,23305,18.733922829581992,111
0.2,1244,14,23319,18.73012048192771,88
0.2,1245,74,23393,18.774478330658106,27
0.2,1246,46,23439,18.796311146752206,55
0.2,1247,-298,23141,18.54246794871795,399
0.2,1248,-205,22936,18.363490792634106,239
0.2,1249,53,22989,18.3912,47
0.2,1250,55,23044,18.420463629096723,47
0.2,1251,92,23136,18.47923322683706,8
0.2,1252,76,23212,18.52513966480447,24
0.2,1253,-171,23041,18.374003189792663,138
0.2,1254,-8,23033,18.352988047808765,110
0.2,1255,47,23080,18.37579617834395,56
0.2,1256,-28,23052,18.33890214797136,131
0.2,1257,79,23131,18.387122416534183,22
0.2,1258,90,23221,18.444003177124703,11
0.2,1259,-42,23179,18.396031746031746,74
0.2,1260,89,23268,18.452022204599523,12
0.2,1261,75,23343,18.496830427892235,25
0.2,1262,88,23431,18.55186064924782,13
0.2,1263,-17,23414,18.52373417721519,120
0.2,1264,43,23457,18.54308300395257,59
0.2,1265,79,23536,18.59083728278041,22
0.2,1266,75,23611,18.635359116022098,26
0.2,1267,89,23700,18.690851735015773,11
0.2,1268,4,23704,18.67927501970055,98
0.2,1269,72,23776,18.721259842519686,28
0.2,1270,31,23807,18.7309205350118,71
0.2,1271,26,23833,18.736635220125788,75
0.2,1272,3,23836,18.724273369992144,97
0.2,1273,-121,23715,18.614599686028257,227
0.2,1274,66,23781,18.651764705882353,35
0.2,1275,95,23876,18.711598746081506,6
0.2,1276,74,23950,18.754894283476897,27
0.2,1277,90,24040,18.810641627543035,11
0.2,1278,-9,24031,18.78889757623143,40
0.2,1279,64,24095,18.82421875,36
0.2,1280,49,24144,18.847775175644028,54
0.2,1281,18,24162,18.847113884555384,83
0.2,1282,91,24253,18.903351519875294,9
0.2,1283,91,24344,18.9595015576324,17
0.2,1284,86,24430,19.011673151750973,15
0.2,1285,-199,24231,18.842146189735615,302
0.2,1286,-187,24044,18.682206682206683,294
0.2,1287,89,24133,18.736801242236027,11
0.2,1288,94,24227,18.79519006982157,6
0.2,1289,24,24251,18.79922480620155,76
0.2,1290,94,24345,18.857474825716498,6
0.2,1291,51,24396,18.88235294117647,50
0.2,1292,-114,24282,18.779582366589327,217
0.2,1293,-51,24231,18.72565687789799,152
0.2,1294,-25,24206,18.691891891891892,126
0.2,1295,85,24291,18.743055555555557,16
0.2,1296,-141,24150,18.61989205859676,173
0.2,1297,68,24218,18.65793528505393,33
0.2,1298,83,24301,18.70746728252502,18
0.2,1299,94,24395,18.765384615384615,7
0.2,1300,-86,24309,18.684857801691006,119
0.2,1301,68,24377,18.722734254992318,32
0.2,1302,61,24438,18.755180353031466,39
0.2,1303,-81,24357,18.678680981595093,113
0.2,1304,-4,24353,18.661302681992336,136
0.2,1305,-93,24260,18.575803981623277,196
0.2,1306,51,24311,18.600612088752868,49
0.2,1307,-158,24153,18.46559633027523,123
0.2,1308,-45,24108,18.41711229946524,150
0.2,1309,41,24149,18.434351145038168,60
0.2,1310,41,24190,18.45156369183829,61
0.2,1311,-5,24185,18.433689024390244,106
0.2,1312,-152,24033,18.303884234577303,194
0.2,1313,-10,24023,18.282343987823438,61
0.2,1314,90,24113,18.336882129277566,10
0.2,1315,-30,24083,18.30015197568389,131
0.2,1316,-8,24075,18.28018223234624,39
0.2,1317,76,24151,18.323975720789075,25
0.2,1318,62,24213,18.357088703563306,38
0.2,1319,22,24235,18.359848484848484,78
0.2,1320,30,24265,18.368660105980318,72
0.2,1321,67,24332,18.405446293494705,33
0.2,1322,-1,24331,18.390778533635675,102
0.2,1323,-61,24270,18.330815709969787,101
0.2,1324,78,24348,18.375849056603773,23
0.2,1325,19,24367,18.3763197586727,83
0.2,1326,32,24399,18.386586284853053,68
0.2,1327,20,24419,18.387801204819276,80
0.2,1328,68,24487,18.42513167795335,33
0.2,1329,35,24522,18.437593984962405,67
0.2,1330,84,24606,18.486851990984224,16
0.2,1331,89,24695,18.53978978978979,12
0.2,1332,-1,24694,18.525131282820706,102
0.2,1333,7,24701,18.51649175412294,105
0.2,1334,-24,24677,18.484644194756555,124
0.2,1335,34,24711,18.49625748502994,78
0.2,1336,-39,24672,18.453253552729993,142
0.2,1337,56,24728,18.4813153961136,44
0.2,1338,85,24813,18.530993278566093,16
0.2,1339,73,24886,18.571641791044776,27
0.2,1340,35,24921,18.583892617449663,65
0.2,1341,-286,24635,18.35692995529061,263
0.2,1342,-50,24585,18.3060312732688,154
0.2,1343,72,24657,18.345982142857142,29
0.2,1344,-135,24522,18.231970260223047,240
0.2,1345,83,24605,18.280089153046063,18
0.2,1346,-253,24352,18.078693392724574,287
0.2,1347,50,24402,18.102373887240358,50
0.2,1348,-380,24022,17.807264640474425,351
0.2,1349,39,24061,17.82296296296296,62
0.2,1350,-75,23986,17.754256106587714,178
0.2,1351,-7,23979,17.73594674556213,38
0.2,1352,69,24048,17.773835920177383,32
0.2,1353,61,24109,17.80576070901034,39
0.2,1354,-14,24095,17.782287822878228,115
0.2,1355,78,24173,17.82669616519174,22
0.2,1356,86,24259,17.87693441414886,15
0.2,1357,92,24351,17.931516936671574,8
0.2,1358,-52,24299,17.880058866813833,155
0.2,1359,67,24366,17.916176470588237,34
0.2,1360,58,24424,17.945628214548126,42
0.2,1361,-103,24321,17.856828193832598,136
0.2,1362,74,24395,17.898019075568598,27
0.2,1363,-236,24159,17.711876832844574,203
0.2,1364,-56,24103,17.65787545787546,160
0.2,1365,-8,24095,17.63909224011713,109
0.2,1366,63,24158,17.672275054864667,38
0.2,1367,44,24202,17.691520467836256,59
0.2,1368,-124,24078,17.588020452885317,160
0.2,1369,46,24124,17.60875912408759,54
0.2,1370,2,24126,17.59737417943107,98
0.2,1371,48,24174,17.61953352769679,53
0.2,1372,78,24252,17.66351056081573,23
0.2,1373,-166,24086,17.529839883551674,130
0.2,1374,83,24169,17.577454545454547,17
0.2,1375,32,24201,17.58793604651163,68
0.2,1376,94,24295,17.643427741466958,6
0.2,1377,91,24386,17.6966618287373,9
0.2,1378,-73,24313,17.630891950688905,105
0.2,1379,24,24337,17.63550724637681,77
0.2,1380,89,24426,17.68718320057929,11
0.2,1381,41,24467,17.704052098408106,61
0.2,1382,36,24503,17.717281272595805,65
0.2,1383,85,24588,17.765895953757227,15
0.2,1384,-28,24560,17.732851985559567,60
0.2,1385,-165,24395,17.6010101010101,269
0.2,1386,91,24486,17.653929343907713,9
0.2,1387,-78,24408,17.585014409221902,110
0.2,1388,76,24484,17.62706983441325,25
0.2,1389,92,24576,17.680575539568345,8
0.2,1390,31,24607,17.6901509705248,70
0.2,1391,90,24697,17.742097701149426,10
0.2,1392,-128,24569,17.637473079684135,228
0.2,1393,69,24638,17.674318507890963,31
0.2,1394,60,24698,17.704659498207885,41
0.2,1395,85,24783,17.752865329512893,15
0.2,1396,69,24852,17.78954903364352,32
0.2,1397,42,24894,17.8068669527897,60
0.2,1398,-46,24848,17.761258041458184,152
0.2,1399,25,24873,17.76642857142857,75
0.2,1400,79,24952,17.81013561741613,22
0.2,1401,19,24971,17.810984308131243,81
0.2,1402,10,24981,17.80541696364932,22
0.2,1403,-245,24736,17.618233618233617,280
0.2,1404,92,24828,17.6711743772242,9
0.2,1405,84,24912,17.718349928876243,17
0.2,1406,-132,24780,17.611940298507463,96
0.2,1407,49,24829,17.634232954545453,57
0.2,1408,46,24875,17.654364797728885,55
0.2,1409,-159,24716,17.529078014184396,209
0.2,1410,84,24800,17.576187101346562,16
0.2,1411,60,24860,17.606232294617563,42
0.2,1412,-17,24843,17.581740976645435,119
0.2,1413,91,24934,17.633663366336634,10
0.2,1414,81,25015,17.67844522968198,19
0.2,1415,-81,24934,17.608757062146893,113
0.2,1416,78,25012,17.65137614678899,23
0.2,1417,95,25107,17.70592383638928,6
0.2,1418,72,25179,17.74418604651163,28
0.2,1419,66,25245,17.778169014084508,34
0.2,1420,92,25337,17.83040112596763,9
0.2,1421,62,25399,17.861462728551338,39
0.2,1422,78,25477,17.903724525650034,23
0.2,1423,81,25558,17.948033707865168,19
0.2,1424,-21,25537,17.920701754385966,122
0.2,1425,90,25627,17.97124824684432,10
0.2,1426,86,25713,18.018920812894184,14
0.2,1427,-175,25538,17.88375350140056,209
0.2,1428,4,25542,17.8740377886634,98
0.2,1429,50,25592,17.896503496503495,53
0.2,1430,70,25662,17.932914046121592,31
0.2,1431,58,25720,17.960893854748605,44
0.2,1432,69,25789,17.996510816468945,32
0.2,1433,57,25846,18.02370990237099,44
0.2,1434,71,25917,18.060627177700347,31
0.2,1435,56,25973,18.087047353760447,45
0.2,1436,77,26050,18.12804453723034,24
0.2,1437,41,26091,18.14394993045897,59
0.2,1438,13,26104,18.140375260597636,19
0.2,1439,91,26195,18.19097222222222,10
0.2,1440,12,26207,18.186675919500345,89
0.2,1441,91,26298,18.2371705963939,9
0.2,1442,73,26371,18.275121275121275,27
0.2,1443,-38,26333,18.236149584487535,70
0.2,1444,48,26381,18.25674740484429,53
0.2,1445,86,26467,18.30359612724758,15
0.2,1446,-82,26385,18.23427781617139,184
0.2,1447,93,26478,18.285911602209946,8
0.2,1448,85,26563,18.331953071083507,15
0.2,1449,91,26654,18.38206896551724,9
0.2,1450,76,26730,18.421778084079946,24
0.2,1451,55,26785,18.446969696969695,45
0.2,1452,-8,26777,18.428768066070198,109
0.2,1453,83,26860,18.473177441540578,17
0.2,1454,59,26919,18.501030927835053,42
0.2,1455,43,26962,18.517857142857142,57
0.2,1456,-3,26959,18.50308853809197,106
0.2,1457,64,27023,18.53429355281207,36
0.2,1458,26,27049,18.539410555174776,86
0.2,1459,75,27124,18.578082191780823,26
0.2,1460,22,27146,18.580424366872005,81
0.2,1461,-7,27139,18.562927496580027,39
0.2,1462,82,27221,18.606288448393713,18
0.2,1463,38,27259,18.619535519125684,64
0.2,1464,44,27303,18.636860068259384,57
0.2,1465,23,27326,18.639836289222373,78
0.2,1466,-86,27240,18.568507157464214,118
0.2,1467,9,27249,18.56198910081744,22
0.2,1468,18,27267,18.561606535057862,83
0.2,1469,57,27324,18.587755102040816,44
0.2,1470,-83,27241,18.51869476546567,184
0.2,1471,36,27277,18.530570652173914,64
0.2,1472,79,27356,18.57162253903598,22
0.2,1473,8,27364,18.564450474898237,93
0.2,1474,37,27401,18.576949152542372,66
0.2,1475,26,27427,18.581978319783197,75
0.2,1476,95,27522,18.633716993906567,6
0.2,1477,-193,27329,18.490527740189446,225
0.2,1478,-113,27216,18.40162271805274,145
0.2,1479,7,27223,18.393918918918917,93
0.2,1480,-165,27058,18.270087778528023,129
0.2,1481,4,27062,18.26045883940621,27
0.2,1482,61,27123,18.289278489548213,40
0.2,1483,74,27197,18.326819407008085,27
0.2,1484,-68,27129,18.268686868686867,128
0.2,1485,54,27183,18.292732166890982,47
0.2,1486,81,27264,18.33490248823134,19
0.2,1487,-379,26885,18.06787634408602,274
0.2,1488,68,26953,18.101410342511752,32
0.2,1489,62,27015,18.130872483221477,38
0.2,1490,79,27094,18.171696847753186,22
0.2,1491,95,27189,18.22319034852547,6
0.2,1492,11,27200,18.218352310783658,21
0.2,1493,58,27258,18.244979919678716,43
0.2,1494,59,27317,18.272240802675586,43
0.2,1495,-214,27103,18.11697860962567,247
0.2,1496,76,27179,18.15564462257849,25
0.2,1497,86,27265,18.200934579439252,15
0.2,1498,94,27359,18.251501000667112,6
0.2,1499,84,27443,18.295333333333332,17
0.2,1500,66,27509,18.32711525649567,34
0.2,1501,38,27547,18.340213049267643,63
0.2,1502,4,27551,18.330671989354624,99
0.2,1503,44,27595,18.34773936170213,57
0.2,1504,88,27683,18.394019933554816,12
0.2,1505,65,27748,18.42496679946879,35
0.2,1506,77,27825,18.463835434638355,24
0.2,1507,77,27902,18.5026525198939,23
0.2,1508,-107,27795,18.41948310139165,209
0.2,1509,69,27864,18.45298013245033,31
0.2,1510,62,27926,18.481800132362675,41
0.2,1511,95,28021,18.53240740740741,6
0.2,1512,-19,28002,18.50760079312624,120
0.2,1513,-70,27932,18.449141347424042,103
0.2,1514,74,28006,18.485808580858087,26
0.2,1515,-13,27993,18.46503957783641,45
0.2,1516,0,27993,18.45286750164799,101
0.2,1517,41,28034,18.46772068511199,60
0.2,1518,-144,27890,18.36076366030283,249
0.2,1519,94,27984,18.410526315789475,13
0.2,1520,14,27998,18.407626561472714,86
0.2,1521,32,28030,18.416557161629434,69
0.2,1522,12,28042,18.412344057780697,90
0.2,1523,63,28105,18.441601049868765,37
0.2,1524,-102,28003,18.362622950819674,206
0.2,1525,86,28089,18.40694626474443,14
0.2,1526,76,28165,18.444662737393582,25
0.2,1527,47,28212,18.463350785340314,53
0.2,1528,-14,28198,18.44211903204709,46
0.2,1529,-37,28161,18.405882352941177,139
0.2,1530,-74,28087,18.345525800130634,106
0.2,1531,-43,28044,18.305483028720626,147
0.2,1532,-10,28034,18.287018917155905,43
0.2,1533,82,28116,18.328552803129075,19
0.2,1534,-122,27994,18.2371335504886,225
0.2,1535,30,28024,18.244791666666668,71
0.2,1536,-86,27938,18.176968119713727,189
0.2,1537,-11,27927,18.157997399219767,142
0.2,1538,-75,27852,18.09746588693957,108
0.2,1539,-12,27840,18.07792207792208,112
0.2,1540,25,27865,18.08241401687216,7
0.2,1541,-154,27711,17.970817120622566,257
0.2,1542,-53,27658,17.924821775761504,92
0.2,1543,68,27726,17.957253886010363,32
0.2,1544,20,27746,17.958576051779936,83
0.2,1545,22,27768,17.96119016817594,78
0.2,1546,-105,27663,17.881706528765353,210
0.2,1547,-18,27645,17.858527131782946,51
0.2,1548,-126,27519,17.765655261459006,160
0.2,1549,-27,27492,17.73677419354839,58
0.2,1550,23,27515,17.740167633784655,78
0.2,1551,52,27567,17.762242268041238,49
0.2,1552,-77,27490,17.701223438506116,193
0.2,1553,81,27571,17.74195624195624,19
0.2,1554,44,27615,17.758842443729904,56
0.2,1555,82,27697,17.80012853470437,19
0.2,1556,81,27778,17.840719332048813,20
0.2,1557,90,27868,17.887034659820284,11
0.2,1558,-105,27763,17.80821039127646,139
0.2,1559,39,27802,17.82179487179487,61
0.2,1560,14,27816,17.8193465727098,87
0.2,1561,-45,27771,17.779129321382843,110
0.2,1562,41,27812,17.79398592450416,60
0.2,1563,78,27890,17.83248081841432,23
0.2,1564,91,27981,17.879233226837062,9
0.2,1565,93,28074,17.9272030651341,8
0.2,1566,-162,27912,17.81238034460753,126
0.2,1567,90,28002,17.85841836734694,10
0.2,1568,-15,27987,17.837476099426386,118
0.2,1569,-63,27924,17.785987261146495,172
0.2,1570,59,27983,17.812221514958626,42
0.2,1571,35,28018,17.823155216284988,65
0.2,1572,45,28063,17.84043229497775,56
0.2,1573,61,28124,17.867852604828464,39
0.2,1574,83,28207,17.90920634920635,18
0.2,1575,20,28227,17.91053299492386,82
0.2,1576,26,28253,17.91566265060241,76
0.2,1577,-47,28206,17.874524714828897,150
0.2,1578,19,28225,17.875237492083595,92
0.2,1579,57,28282,17.9,43
0.2,1580,2,28284,17.889943074003796,99
0.2,1581,77,28361,17.927307206068267,26
0.2,1582,55,28416,17.95072646873026,46
0.2,1583,84,28500,17.992424242424242,17
0.2,1584,75,28575,18.028391167192428,25
0.2,1585,-80,28495,17.966582597730138,112
0.2,1586,85,28580,18.008821676118462,15
0.2,1587,86,28666,18.051637279596978,14
0.2,1588,80,28746,18.090623033354312,20
0.2,1589,-15,28731,18.069811320754717,116
0.2,1590,-31,28700,18.0389692017599,135
0.2,1591,37,28737,18.050879396984925,63
0.2,1592,33,28770,18.060263653483993,67
0.2,1593,88,28858,18.10414052697616,12
0.2,1594,-16,28842,18.082758620689656,119
0.2,1595,-300,28542,17.883458646616543,336
0.2,1596,94,28636,17.931120851596745,7
0.2,1597,72,28708,17.964956195244056,28
0.2,1598,36,28744,17.976235146966854,64
0.2,1599,83,28827,18.016875,25
0.2,1600,-32,28795,17.98563397876327,132
0.2,1601,64,28859,18.014357053682897,36
0.2,1602,-50,28809,17.971927635683095,102
0.2,1603,-196,28613,17.83852867830424,229
0.2,1604,-149,28464,17.734579439252336,182
0.2,1605,90,28554,17.779576587795766,11
0.2,1606,65,28619,17.808960796515247,43
0.2,1607,41,28660,17.823383084577113,60
0.2,1608,-59,28601,17.77563704164077,161
0.2,1609,64,28665,17.804347826086957,36
0.2,1610,-88,28577,17.73867163252638,192
0.2,1611,79,28656,17.77667493796526,21
0.2,1612,61,28717,17.8034717916925,39
0.2,1613,85,28802,17.845105328376704,16
0.2,1614,-45,28757,17.806191950464395,78
0.2,1615,42,28799,17.821163366336634,59
0.2,1616,78,28877,17.858379715522574,22
0.2,1617,89,28966,17.902348578491967,12
0.2,1618,-52,28914,17.8591723285979,153
0.2,1619,80,28994,17.89753086419753,20
0.2,1620,3,28997,17.888340530536706,100
0.2,1621,88,29085,17.931565967940813,13
0.2,1622,37,29122,17.943314849044977,64
0.2,1623,67,29189,17.973522167487683,34
0.2,1624,19,29208,17.974153846153847,83
0.2,1625,-2,29206,17.961869618696188,102
0.2,1626,49,29255,17.98094652735095,51
0.2,1627,81,29336,18.01965601965602,19
0.2,1628,27,29363,18.025168815224063,73
0.2,1629,44,29407,18.04110429447853,56
0.2,1630,19,29426,18.041692213366034,84
0.2,1631,87,29513,18.08394607843137,13
0.2,1632,-220,29293,17.938150642988365,269
0.2,1633,68,29361,17.968788249694004,32
0.2,1634,68,29429,17.99938837920489,32
0.2,1635,57,29486,18.02322738386308,44
0.2,1636,87,29573,18.06536346976176,13
0.2,1637,-6,29567,18.050671550671552,39
0.2,1638,-494,29073,17.738255033557046,390
0.2,1639,85,29158,17.779268292682925,15
0.2,1640,80,29238,17.817184643510053,21
0.2,1641,88,29326,17.859926918392205,13
0.2,1642,-261,29065,17.690200852099817,228
0.2,1643,12,29077,17.686739659367397,89
0.2,1644,-90,28987,17.621276595744682,122
0.2,1645,-55,28932,17.5771567436209,88
0.2,1646,1,28933,17.56709168184578,101
0.2,1647,85,29018,17.608009708737864,16
0.2,1648,87,29105,17.65009096422074,14
0.2,1649,69,29174,17.68121212121212,32
0.2,1650,66,29240,17.71047849788007,35
0.2,1651,-37,29203,17.677360774818403,138
0.2,1652,95,29298,17.724137931034484,6
0.2,1653,41,29339,17.73821039903265,60
0.2,1654,-113,29226,17.659214501510576,148
0.2,1655,81,29307,17.69746376811594,19
0.2,1656,-6,29301,17.68316234158117,106
0.2,1657,20,29321,17.68455971049457,80
0.2,1658,55,29376,17.707052441229656,45
0.2,1659,47,29423,17.72469879518072,64
0.2,1660,-18,29405,17.703190848886212,119
0.2,1661,6,29411,17.696149217809868,94
0.2,1662,31,29442,17.70414912808178,71
0.2,1663,94,29536,17.75,7
0.2,1664,32,29568,17.75855855855856,76
0.2,1665,-15,29553,17.73889555822329,117
0.2,1666,20,29573,17.740251949610077,82
0.2,1667,36,29609,17.751199040767386,65
0.2,1668,-120,29489,17.668663870581188,222
0.2,1669,-59,29430,17.622754491017965,163
0.2,1670,79,29509,17.659485338120884,22
0.2,1671,92,29601,17.70394736842105,8
0.2,1672,-92,29509,17.638374178123133,198
0.2,1673,67,29576,17.667861409796895,34
0.2,1674,-106,29470,17.594029850746267,210
0.2,1675,85,29555,17.634248210023866,15
0.2,1676,-48,29507,17.59511031604055,151
0.2,1677,92,29599,17.639451728247913,9
0.2,1678,78,29677,17.67540202501489,23
0.2,1679,90,29767,17.71845238095238,10
0.2,1680,61,29828,17.7441998810232,40
0.2,1681,-235,29593,17.593935790725325,306
0.2,1682,93,29686,17.638740344622697,7
0.2,1683,30,29716,17.64608076009501,70
0.2,1684,-41,29675,17.61127596439169,144
0.2,1685,70,29745,17.6423487544484,30
0.2,1686,73,29818,17.675163011262597,27
0.2,1687,-36,29782,17.643364928909953,143
0.2,1688,83,29865,17.682060390763766,17
0.2,1689,-102,29763,17.611242603550295,134
0.2,1690,-40,29723,17.57717327025429,141
0.2,1691,-59,29664,17.53191489361702,161
0.2,1692,-32,29632,17.502658003544006,63
0.2,1693,91,29723,17.546044864226683,9
0.2,1694,71,29794,17.577581120943954,30
0.2,1695,-26,29768,17.55188679245283,128
0.2,1696,77,29845,17.58691809074838,24
0.2,1697,57,29902,17.61012956419317,43
0.2,1698,48,29950,17.62801648028252,52
0.2,1699,95,30045,17.673529411764704,6
0.2,1700,-14,30031,17.6549088771311,117
0.2,1701,9,30040,17.64982373678026,92
0.2,1702,38,30078,17.661773341162654,63
0.2,1703,92,30170,17.705399061032864,9
0.2,1704,62,30232,17.731378299120234,39
0.2,1705,61,30293,17.756740914419694,40
0.2,1706,70,30363,17.787346221441126,31
0.2,1707,-64,30299,17.739461358313818,96
0.2,1708,38,30337,17.75131655939146,63
0.2,1709,88,30425,17.792397660818715,13
0.2,1710,61,30486,17.817650496785504,41
0.2,1711,75,30561,17.85105140186916,25
0.2,1712,82,30643,17.88849970811442,19
0.2,1713,-172,30471,17.777712952158694,207
0.2,1714,60,30531,17.802332361516036,41
0.2,1715,24,30555,17.805944055944057,76
0.2,1716,88,30643,17.846825859056494,13
0.2,1717,19,30662,17.847497089639116,13
0.2,1718,-56,30606,17.804537521815007,164
0.2,1719,-14,30592,17.78604651162791,51
0.2,1720,45,30637,17.801859384079023,55
0.2,1721,50,30687,17.820557491289197,50
0.2,1722,13,30700,17.817759721416135,88
0.2,1723,44,30744,17.83294663573086,59
0.2,1724,72,30816,17.864347826086956,28
0.2,1725,80,30896,17.90034762456547,21
0.2,1726,78,30974,17.935147654892877,22
0.2,1727,35,31009,17.94502314814815,65
0.2,1728,68,31077,17.973973395026025,32
0.2,1729,43,31120,17.98843930635838,58
0.2,1730,-140,30980,17.897169266320045,172
0.2,1731,19,30999,17.89780600461894,82
0.2,1732,-129,30870,17.813040969417195,233
0.2,1733,20,30890,17.814302191464822,83
0.2,1734,94,30984,17.85821325648415,7
0.2,1735,91,31075,17.900345622119815,10
0.2,1736,92,31167,17.94300518134715,8
0.2,1737,91,31258,17.985040276179518,10
0.2,1738,-34,31224,17.9551466359977,137
0.2,1739,93,31317,17.998275862068965,7
0.2,1740,63,31380,18.024124066628374,37
0.2,1741,20,31400,18.025258323765787,81
0.2,1742,43,31443,18.03958691910499,57
0.2,1743,-5,31438,18.02637614678899,36
0.2,1744,93,31531,18.069340974212036,8
0.2,1745,-17,31514,18.049255441008018,119
0.2,1746,13,31527,18.046365197481396,89
0.2,1747,-21,31506,18.024027459954233,53
0.2,1748,92,31598,18.066323613493424,8
0.2,1749,88,31686,18.106285714285715,13
0.2,1750,25,31711,18.110222729868646,77
0.2,1751,-33,31678,18.081050228310502,137
0.2,1752,75,31753,18.113519680547633,28
0.2,1753,63,31816,18.139110604332952,38
0.2,1754,81,31897,18.174928774928777,20
0.2,1755,70,31967,18.204441913439634,30
0.2,1756,-18,31949,18.18383608423449,121
0.2,1757,-15,31934,18.164960182025027,115
0.2,1758,37,31971,18.175667993177942,64
0.2,1759,73,32044,18.206818181818182,51
0.2,1760,-34,32010,18.17717206132879,136
0.2,1761,16,32026,18.17593643586833,84
0.2,1762,69,32095,18.20476460578559,31
0.2,1763,28,32123,18.21031746031746,73
0.2,1764,77,32200,18.243626062322946,24
0.2,1765,57,32257,18.265571913929787,43
0.2,1766,18,32275,18.265421618562534,84
0.2,1767,45,32320,18.28054298642534,56
0.2,1768,85,32405,18.318258903335217,15
0.2,1769,31,32436,18.325423728813558,71
0.2,1770,94,32530,18.36815358554489,6
0.2,1771,-2,32528,18.35665914221219,104
0.2,1772,23,32551,18.359278059785673,78
0.2,1773,81,32632,18.3945885005637,20
0.2,1774,-26,32606,18.369577464788733,58
0.2,1775,89,32695,18.409346846846848,11
0.2,1776,3,32698,18.400675295441754,99
0.2,1777,88,32786,18.439820022497187,13
0.2,1778,23,32809,18.44238336143901,80
0.2,1779,64,32873,18.467977528089886,37
0.2,1780,91,32964,18.50870297585626,10
0.2,1781,-101,32863,18.441638608305276,207
0.2,1782,75,32938,18.473359506449803,26
0.2,1783,38,32976,18.484304932735427,63
0.2,1784,-104,32872,18.415686274509802,213
0.2,1785,0,32872,18.405375139977604,32
0.2,1786,67,32939,18.432568550643538,34
0.2,1787,16,32955,18.431208053691275,15
0.2,1788,35,32990,18.440469536053662,65
0.2,1789,7,32997,18.4340782122905,95
0.2,1790,81,33078,18.469011725293132,19
0.2,1791,6,33084,18.462053571428573,97
0.2,1792,-184,32900,18.349135527049636,287
0.2,1793,66,32966,18.375696767001116,35
0.2,1794,-88,32878,18.316434540389974,122
0.2,1795,61,32939,18.3402004454343,39
0.2,1796,-56,32883,18.29883138564274,158
0.2,1797,-13,32870,18.281423804226918,115
0.2,1798,-8,32862,18.26681489716509,108
0.2,1799,3,32865,18.258333333333333,98
0.2,1800,78,32943,18.291504719600223,23
0.2,1801,37,32980,18.30188679245283,64
0.2,1802,45,33025,18.31669439822518,56
0.2,1803,2,33027,18.307649667405766,98
0.2,1804,74,33101,18.338504155124653,28
0.2,1805,11,33112,18.334440753045403,94
0.2,1806,-50,33062,18.296624239070283,171
0.2,1807,3,33065,18.28816371681416,28
0.2,1808,84,33149,18.32448866777225,17
0.2,1809,93,33242,18.36574585635359,8
0.2,1810,32,33274,18.373274434014355,69
0.2,1811,-176,33098,18.266004415011036,282
0.2,1812,52,33150,18.284611141754,48
0.2,1813,69,33219,18.312568908489524,32
0.2,1814,80,33299,18.3465564738292,20
0.2,1815,48,33347,18.362885462555067,53
0.2,1816,75,33422,18.394056136488718,26
0.2,1817,58,33480,18.415841584158414,42
0.2,1818,-416,33064,18.177020340846617,391
0.2,1819,-14,33050,18.15934065934066,47
0.2,1820,54,33104,18.179022515101593,47
0.2,1821,84,33188,18.215148188803514,16
0.2,1822,-116,33072,18.141524958859023,242
0.2,1823,62,33134,18.165570175438596,39
0.2,1824,-168,32966,18.063561643835616,277
0.2,1825,77,33043,18.095837897042717,23
0.2,1826,-72,32971,18.046524356869185,105
0.2,1827,-60,32911,18.00382932166302,194
0.2,1828,41,32952,18.01640240568617,59
0.2,1829,72,33024,18.04590163934426,29
0.2,1830,95,33119,18.08793009284544,6
0.2,1831,76,33195,18.11954148471616,25
0.2,1832,34,33229,18.128205128205128,66
0.2,1833,80,33309,18.161941112322793,21
0.2,1834,56,33365,18.182561307901906,45
0.2,1835,89,33454,18.221132897603486,12
0.2,1836,29,33483,18.227000544365815,73
0.2,1837,60,33543,18.24972796517954,40
0.2,1838,70,33613,18.277868406742794,30
0.2,1839,-51,33562,18.24021739130435,154
0.2,1840,-239,33323,18.10048886474742,202
0.2,1841,83,33406,18.135722041259502,18
0.2,1842,64,33470,18.160607704829083,37
0.2,1843,-4,33466,18.148590021691973,36
0.2,1844,34,33500,18.15718157181572,66
0.2,1845,95,33595,18.198808234019502,6
0.2,1846,-138,33457,18.1142393069843,170
0.2,1847,-161,33296,18.017316017316016,276
0.2,1848,48,33344,18.033531638723634,52
0.2,1849,90,33434,18.072432432432432,10
0.2,1850,78,33512,18.104808211777417,23
0.2,1851,40,33552,18.116630669546435,62
0.2,1852,82,33634,18.15110631408527,18
0.2,1853,-212,33422,18.026968716289105,320
0.2,1854,19,33441,18.027493261455525,86
0.2,1855,86,33527,18.064116379310345,15
0.2,1856,73,33600,18.093699515347335,27
0.2,1857,49,33649,18.11033369214209,51
0.2,1858,-4,33645,18.098440021516943,107
0.2,1859,29,33674,18.10430107526882,71
0.2,1860,-127,33547,18.026329930145085,163
0.2,1861,-354,33193,17.8265306122449,252
0.2,1862,-82,33111,17.77294685990338,182
0.2,1863,78,33189,17.805257510729614,23
0.2,1864,42,33231,17.818230563002682,58
0.2,1865,62,33293,17.841907824222936,38
0.2,1866,76,33369,17.873058382431708,25
0.2,1867,-59,33310,17.83190578158458,162
0.2,1868,-145,33165,17.74478330658106,116
0.2,1869,27,33192,17.749732620320856,75
0.2,1870,-172,33020,17.648316408337788,136
0.2,1871,31,33051,17.65544871794872,70
0.2,1872,-165,32886,17.55792845702082,197
0.2,1873,73,32959,17.58751334044824,28
0.2,1874,76,33035,17.618666666666666,25
0.2,1875,35,33070,17.627931769722814,65
0.2,1876,-100,32970,17.565263718700052,137
0.2,1877,13,32983,17.56283280085197,87
0.2,1878,-24,32959,17.54071314529005,56
0.2,1879,66,33025,17.56648936170213,35
0.2,1880,85,33110,17.60233918128655,15
0.2,1881,82,33192,17.636556854410202,18
0.2,1882,6,33198,17.630377057886353,94
0.2,1883,-71,33127,17.583333333333332,104
0.2,1884,65,33192,17.608488063660477,36
0.2,1885,49,33241,17.62513255567338,51
0.2,1886,-127,33114,17.548489666136724,242
0.2,1887,-147,32967,17.461334745762713,253
0.2,1888,30,32997,17.467972472207517,72
0.2,1889,74,33071,17.497883597883597,27
0.2,1890,83,33154,17.532522474881016,18
0.2,1891,13,33167,17.53012684989429,19
0.2,1892,35,33202,17.539355520338088,65
0.2,1893,-7,33195,17.526399155227033,107
0.2,1894,83,33278,17.56094986807388,18
0.2,1895,94,33372,17.60126582278481,7
0.2,1896,-179,33193,17.49762783342119,211
0.2,1897,53,33246,17.516332982086407,48
0.2,1898,9,33255,17.511848341232227,92
0.2,1899,9,33264,17.507368421052632,94
0.2,1900,-154,33110,17.41714886901631,210
0.2,1901,59,33169,17.439011566771818,42
0.2,1902,41,33210,17.45139253809774,59
0.2,1903,-125,33085,17.376575630252102,159
0.2,1904,89,33174,17.414173228346456,12
0.2,1905,-17,33157,17.396117523609654,130
0.2,1906,-33,33124,17.3696906135291,64
0.2,1907,91,33215,17.408280922431867,10
0.2,1908,-63,33152,17.366160293347303,120
0.2,1909,47,33199,17.381675392670157,55
0.2,1910,-185,33014,17.275771847200417,238
0.2,1911,-95,32919,17.21705020920502,130
0.2,1912,73,32992,17.24621014113957,27
0.2,1913,16,33008,17.24555903866249,87
0.2,1914,-69,32939,17.200522193211487,170
0.2,1915,89,33028,17.237995824634655,12
0.2,1916,88,33116,17.27490871152843,13
0.2,1917,47,33163,17.290406673618353,54
0.2,1918,-79,33084,17.240229286086503,179
0.2,1919,14,33098,17.238541666666666,89
0.2,1920,70,33168,17.266007287870902,31
0.2,1921,10,33178,17.262226847034338,93
0.2,1922,30,33208,17.26885075403016,71
0.2,1923,35,33243,17.278066528066528,65
0.2,1924,-25,33218,17.256103896103895,57
0.2,1925,93,33311,17.295430944963655,7
0.2,1926,87,33398,17.331603528801246,14
0.2,1927,71,33469,17.359439834024897,29
0.2,1928,70,33539,17.3867288750648,31
0.2,1929,-81,33458,17.335751295336788,112
0.2,1930,47,33505,17.35111341273951,61
0.2,1931,71,33576,17.37888198757764,29
0.2,1932,-30,33546,17.354371443352303,61
0.2,1933,-51,33495,17.319027921406413,154
0.2,1934,56,33551,17.339018087855298,46
0.2,1935,-2,33549,17.329028925619834,102
0.2,1936,7,33556,17.323696437790396,109
0.2,1937,-16,33540,17.306501547987615,119
0.2,1938,-11,33529,17.29190304280557,111
0.2,1939,80,33609,17.32422680412371,21
0.2,1940,-2,33607,17.31427099433282,105
0.2,1941,71,33678,17.341915550978374,30
0.2,1942,38,33716,17.352547606793618,63
0.2,1943,56,33772,17.372427983539094,45
0.2,1944,-381,33391,17.167609254498714,424
0.2,1945,-72,33319,17.121788283658788,182
0.2,1946,43,33362,17.135079609655882,66
0.2,1947,73,33435,17.163757700205338,28
0.2,1948,82,33517,17.197024114930734,19
0.2,1949,22,33539,17.19948717948718,79
0.2,1950,93,33632,17.23833931317273,8
0.2,1951,79,33711,17.26997950819672,21
0.2,1952,3,33714,17.262672811059907,107
0.2,1953,-10,33704,17.248720573183213,113
0.2,1954,24,33728,17.252173913043478,77
0.2,1955,80,33808,17.284253578732105,20
0.2,1956,82,33890,17.31732243229433,19
0.2,1957,26,33916,17.321756894790603,75
0.2,1958,-19,33897,17.30321592649311,121
0.2,1959,48,33945,17.318877551020407,52
0.2,1960,26,33971,17.323304436511982,75
0.2,1961,-15,33956,17.306829765545363,117
0.2,1962,90,34046,17.343861436576667,10
0.2,1963,24,34070,17.34725050916497,78
0.2,1964,90,34160,17.384223918575064,10
0.2,1965,-72,34088,17.338758901322482,104
0.2,1966,-39,34049,17.31011692933401,71
0.2,1967,89,34138,17.346544715447155,12
0.2,1968,88,34226,17.382427628237686,12
0.2,1969,-68,34158,17.339086294416244,100
0.2,1970,58,34216,17.359715880263824,42
0.2,1971,80,34296,17.391480730223122,21
0.2,1972,89,34385,17.427774961986824,12
0.2,1973,92,34477,17.465552178318134,8
0.2,1974,85,34562,17.499746835443037,15
0.2,1975,48,34610,17.515182186234817,53
0.2,1976,44,34654,17.52857865452706,56
0.2,1977,68,34722,17.554095045500507,32
0.2,1978,-65,34657,17.512379989893887,167
0.2,1979,79,34736,17.543434343434342,22
0.2,1980,74,34810,17.57193336698637,27
0.2,1981,60,34870,17.593340060544904,43
0.2,1982,41,34911,17.605143721633887,60
0.2,1983,87,34998,17.640120967741936,14
0.2,1984,-262,34736,17.499244332493703,365
0.2,1985,77,34813,17.52920443101712,23
0.2,1986,77,34890,17.559134373427277,24
0.2,1987,85,34975,17.593058350100602,15
0.2,1988,45,35020,17.60683760683761,56
0.2,1989,-44,34976,17.575879396984924,75
0.2,1990,-38,34938,17.547965846308387,140
0.2,1991,-183,34755,17.447289156626507,289
0.2,1992,49,34804,17.46312092323131,72
0.2,1993,71,34875,17.489969909729187,30
0.2,1994,86,34961,17.524310776942357,15
0.2,1995,39,35000,17.53507014028056,62
0.2,1996,55,35055,17.55383074611918,45
0.2,1997,57,35112,17.573573573573572,44
0.2,1998,-17,35095,17.556278139069533,118
0.2,1999,-31,35064,17.532,156
0.2,2000,70,35134,17.558220889555223,30
0.2,2001,79,35213,17.58891108891109,21
0.2,2002,51,35264,17.60559161258113,50
0.2,2003,48,35312,17.62075848303393,53
0.2,2004,15,35327,17.61945137157107,86
0.2,2005,-6,35321,17.607676969092722,107
0.2,2006,-88,35233,17.555057299451917,123
0.2,2007,-352,34881,17.37101593625498,392
0.2,2008,-24,34857,17.350423096067697,124
0.2,2009,-87,34770,17.29850746268657,189
0.2,2010,63,34833,17.321233217304822,37
0.2,2011,92,34925,17.358349900596423,8
0.2,2012,81,35006,17.3899652260308,20
0.2,2013,93,35099,17.427507447864944,7
0.2,2014,84,35183,17.460545905707196,16
0.2,2015,-41,35142,17.43154761904762,73
0.2,2016,0,35142,17.42290530490828,37
0.2,2017,34,35176,17.431119920713577,66
0.2,2018,35,35211,17.439821693907874,65
0.2,2019,-7,35204,17.427722772277228,110
0.2,2020,90,35294,17.463631865413163,10
0.2,2021,72,35366,17.490603363006922,28
0.2,2022,82,35448,17.52249134948097,19
0.2,2023,82,35530,17.554347826086957,19
0.2,2024,9,35539,17.550123456790125,95
0.2,2025,8,35547,17.545409674234946,35
0.2,2026,90,35637,17.581154415392206,69
0.2,2027,56,35693,17.600098619329387,45
0.2,2028,-4,35689,17.589452932479055,105
0.2,2029,55,35744,17.607881773399015,45
0.2,2030,50,35794,17.62383062530773,52
0.2,2031,93,35887,17.660925196850393,7
0.2,2032,-89,35798,17.60846040334481,193
0.2,2033,91,35889,17.644542772861357,10
0.2,2034,-36,35853,17.618181818181817,140
0.2,2035,88,35941,17.652750491159136,12
0.2,2036,46,35987,17.666666666666668,55
0.2,2037,3,35990,17.659470068694798,106
0.2,2038,88,36078,17.69396763119176,12
0.2,2039,-9,36069,17.680882352941175,111
0.2,2040,87,36156,17.71484566389025,14
0.2,2041,37,36193,17.724289911851127,63
0.2,2042,73,36266,17.751346059716102,27
0.2,2043,14,36280,17.749510763209393,87
0.2,2044,15,36295,17.748166259168705,88
0.2,2045,6,36301,17.742424242424242,26
0.2,2046,41,36342,17.753786028334147,60
0.2,2047,68,36410,17.7783203125,35
0.2,2048,90,36500,17.813567593948267,11
0.2,2049,16,36516,17.812682926829268,85
0.2,2050,-50,36466,17.779619697708434,151
0.2,2051,-49,36417,17.747076023391813,81
0.2,2052,86,36503,17.780321480759863,18
0.2,2053,86,36589,17.813534566699122,14
0.2,2054,81,36670,17.844282238442823,19
0.2,2055,-339,36331,17.670719844357976,307
0.2,2056,-41,36290,17.642197374817695,166
0.2,2057,90,36380,17.677356656948493,11
0.2,2058,54,36434,17.694997571636716,47
0.2,2059,-21,36413,17.676213592233008,126
0.2,2060,79,36492,17.705967976710333,22
0.2,2061,58,36550,17.725509214354997,43
0.2,2062,20,36570,17.72661173048958,81
0.2,2063,-117,36453,17.661337209302324,243
0.2,2064,19,36472,17.661985472154964,81
0.2,2065,-148,36324,17.581800580832528,180
0.2,2066,22,36346,17.58393807450411,10
0.2,2067,61,36407,17.604932301740813,39
0.2,2068,65,36472,17.627839536007734,35
0.2,2069,85,36557,17.660386473429952,15
0.2,2070,-7,36550,17.648478995654273,38
0.2,2071,92,36642,17.684362934362934,9
0.2,2072,-9,36633,17.67149059334298,40
0.2,2073,-6,36627,17.660077145612345,107
0.2,2074,25,36652,17.663614457831326,83
0.2,2075,63,36715,17.685452793834298,37
0.2,2076,79,36794,17.714973519499278,22
0.2,2077,-60,36734,17.67757459095284,161
0.2,2078,29,36763,17.683020683020683,74
0.2,2079,29,36792,17.68846153846154,71
0.2,2080,-36,36756,17.66266218164344,67
0.2,2081,79,36835,17.692122958693563,22
0.2,2082,94,36929,17.72875660105617,6
0.2,2083,-70,36859,17.68666026871401,102
0.2,2084,67,36926,17.71031175059952,34
0.2,2085,41,36967,17.721476510067113,59
0.2,2086,6,36973,17.715860086248203,25
0.2,2087,52,37025,17.73227969348659,49
0.2,2088,66,37091,17.755385351842985,35
0.2,2089,-229,36862,17.63732057416268,274
0.2,2090,86,36948,17.670014347202297,15
0.2,2091,79,37027,17.699330783938816,22
0.2,2092,88,37115,17.732919254658384,19
0.2,2093,69,37184,17.75740210124164,31
0.2,2094,68,37252,17.781384248210024,33
0.2,2095,92,37344,17.81679389312977,9
0.2,2096,56,37400,17.835002384358607,45
0.2,2097,-54,37346,17.800762631077216,157
0.2,2098,67,37413,17.824202000952834,33
0.2,2099,-74,37339,17.78047619047619,174
0.2,2100,-47,37292,17.749643027129938,79
0.2,2101,74,37366,17.77640342530923,26
0.2,2102,91,37457,17.811222063718496,10
0.2,2103,-47,37410,17.78041825095057,149
0.2,2104,-15,37395,17.764845605700714,118
0.2,2105,92,37487,17.800094966761634,9
0.2,2106,-162,37325,17.714760322733746,202
0.2,2107,19,37344,17.71537001897533,81
0.2,2108,-118,37226,17.651019440493126,150
0.2,2109,-15,37211,17.635545023696682,46
0.2,2110,89,37300,17.669351018474657,11
0.2,2111,-59,37241,17.633049242424242,161
0.2,2112,-123,37118,17.566493137718883,228
0.2,2113,78,37196,17.59508041627247,22
0.2,2114,-48,37148,17.564066193853428,149
0.2,2115,47,37195,17.57797731568998,56
0.2,2116,55,37250,17.59565422768068,46
0.2,2117,88,37338,17.628895184135978,12
0.2,2118,86,37424,17.661160924964605,15
0.2,2119,85,37509,17.692924528301887,15
0.2,2120,91,37600,17.727487034417727,10
0.2,2121,24,37624,17.730442978322337,7
0.2,2122,91,37715,17.764955252001883,10
0.2,2123,75,37790,17.79190207156309,26
0.2,2124,71,37861,17.81694117647059,29
0.2,2125,88,37949,17.849952963311384,13
0.2,2126,-1,37948,17.84109073812882,102
0.2,2127,-62,37886,17.803571428571427,163
0.2,2128,-77,37809,17.759041803663692,179
0.2,2129,-81,37728,17.71267605633803,184
0.2,2130,92,37820,17.747536367902395,9
0.2,2131,-62,37758,17.71013133208255,164
0.2,2132,34,37792,17.717768401312703,70
0.2,2133,-81,37711,17.671508903467668,185
0.2,2134,-44,37667,17.64262295081967,75
0.2,2135,-12,37655,17.62874531835206,115
0.2,2136,35,37690,17.63687412260178,68
0.2,2137,-91,37599,17.586061739943872,124
0.2,2138,76,37675,17.613370733987846,25
0.2,2139,24,37699,17.616355140186915,78
0.2,2140,16,37715,17.615600186828583,15
0.2,2141,74,37789,17.641923436041083,26
0.2,2142,-79,37710,17.59682687820812,111
0.2,2143,87,37797,17.62919776119403,14
0.2,2144,-77,37720,17.585081585081586,111
0.2,2145,-135,37585,17.513979496738116,239
0.2,2146,60,37645,17.533768048439683,41
0.2,2147,-157,37488,17.452513966480446,189
0.2,2148,83,37571,17.483015355979525,17
0.2,2149,87,37658,17.515348837209302,13
0.2,2150,-48,37610,17.484890748489075,178
0.2,2151,0,37610,17.476765799256505,102
0.2,2152,94,37704,17.51230840687413,7
0.2,2153,80,37784,17.541318477251625,21
0.2,2154,-63,37721,17.503944315545244,164
0.2,2155,-13,37708,17.489795918367346,44
0.2,2156,-33,37675,17.466388502549837,136
0.2,2157,52,37727,17.48239110287303,48
0.2,2158,-175,37552,17.393237610004633,208
0.2,2159,14,37566,17.391666666666666,87
0.2,2160,74,37640,17.417862100879223,27
0.2,2161,-108,37532,17.359851988899166,142
0.2,2162,84,37616,17.39066111881646,16
0.2,2163,28,37644,17.395563770794823,73
0.2,2164,-77,37567,17.351963048498845,177
0.2,2165,-113,37454,17.291782086795937,76
0.2,2166,71,37525,17.316566682048915,30
0.2,2167,64,37589,17.33809963099631,36
0.2,2168,70,37659,17.36237897648686,30
0.2,2169,-145,37514,17.287557603686636,181
0.2,2170,26,37540,17.29157070474436,75
0.2,2171,-6,37534,17.28084714548803,37
0.2,2172,-324,37210,17.123791992636907,294
0.2,2173,-29,37181,17.102575896964122,131
0.2,2174,-19,37162,17.085977011494254,50
0.2,2175,58,37220,17.104779411764707,42
0.2,2176,94,37314,17.14010105649977,7
0.2,2177,56,37370,17.157943067033976,44
0.2,2178,43,37413,17.169802661771456,58
0.2,2179,-30,37383,17.14816513761468,131
0.2,2180,-16,37367,17.132966529115084,117
0.2,2181,-33,37334,17.109990834097157,144
0.2,2182,-2,37332,17.10123683005039,102
0.2,2183,18,37350,17.10164835164835,84
0.2,2184,7,37357,17.097025171624715,24
0.2,2185,69,37426,17.120768526989934,31
0.2,2186,15,37441,17.119798811156837,87
0.2,2187,41,37482,17.130712979890312,60
0.2,2188,71,37553,17.155322064869804,30
0.2,2189,40,37593,17.165753424657535,62
0.2,2190,72,37665,17.19078046554085,29
0.2,2191,36,37701,17.199361313868614,66
0.2,2192,39,37740,17.209302325581394,61
0.2,2193,47,37787,17.2228805834093,53
0.2,2194,-15,37772,17.208200455580865,118
0.2,2195,14,37786,17.206739526411656,57
0.2,2196,-88,37698,17.15885298133819,191
0.2,2197,47,37745,17.17242948134668,54
0.2,2198,-2,37743,17.163710777626193,103
0.2,2199,15,37758,17.162727272727274,88
0.2,2200,-180,37578,17.073148568832348,217
0.2,2201,45,37623,17.085831062670298,56
0.2,2202,90,37713,17.118928733545165,10
0.2,2203,20,37733,17.120235934664247,82
0.2,2204,94,37827,17.155102040816328,8
0.2,2205,30,37857,17.160924750679964,74
0.2,2206,75,37932,17.18713185319438,25
0.2,2207,94,38026,17.221920289855074,6
0.2,2208,89,38115,17.254413761883207,12
0.2,2209,-147,37968,17.180090497737556,247
0.2,2210,76,38044,17.206693803708728,24
0.2,2211,46,38090,17.219710669077756,55
0.2,2212,-47,38043,17.190691369182105,147
0.2,2213,81,38124,17.21951219512195,20
0.2,2214,86,38210,17.25056433408578,15
0.2,2215,87,38297,17.282039711191334,14
0.2,2216,-52,38245,17.250789354984214,153
0.2,2217,73,38318,17.275924256086565,27
0.2,2218,-162,38156,17.195132942767014,262
0.2,2219,88,38244,17.227027027027027,12
0.2,2220,-8,38236,17.215668617739755,108
0.2,2221,87,38323,17.247074707470748,14
0.2,2222,79,38402,17.27485380116959,23
0.2,2223,1,38403,17.267535971223023,100
0.2,2224,95,38498,17.30247191011236,6
0.2,2225,47,38545,17.31581311769991,54
0.2,2226,85,38630,17.346205657835654,16
0.2,2227,42,38672,17.357271095152605,58
0.2,2228,42,38714,17.368326603858232,60
0.2,2229,-3,38711,17.359192825112107,106
0.2,2230,68,38779,17.381891528462575,33
0.2,2231,80,38859,17.40994623655914,20
0.2,2232,-13,38846,17.396327810120912,45
0.2,2233,23,38869,17.39883616830797,79
0.2,2234,85,38954,17.429082774049217,16
0.2,2235,55,39009,17.445885509838998,45
0.2,2236,94,39103,17.48010728654448,6
0.2,2237,1,39104,17.472743521000893,99
0.2,2238,-31,39073,17.45109423849933,131
0.2,2239,32,39105,17.457589285714285,68
0.2,2240,-108,38997,17.401606425702813,229
0.2,2241,67,39064,17.423728813559322,33
0.2,2242,50,39114,17.438252340615247,51
0.2,2243,-3,39111,17.42914438502674,106
0.2,2244,55,39166,17.44587973273942,46
0.2,2245,24,39190,17.44879786286732,7
0.2,2246,78,39268,17.47574543836226,22
0.2,2247,34,39302,17.48309608540925,66
0.2,2248,-60,39242,17.448643841707426,160
0.2,2249,27,39269,17.45288888888889,73
0.2,2250,-32,39237,17.43091959129276,134
0.2,2251,74,39311,17.456039076376555,26
0.2,2252,-42,39269,17.42964935641367,145
0.2,2253,95,39364,17.464063886424135,6
0.2,2254,93,39457,17.497560975609755,7
0.2,2255,13,39470,17.495567375886523,19
0.2,2256,-38,39432,17.47097917589721,140
0.2,2257,83,39515,17.5,18
0.2,2258,38,39553,17.509074811863655,62
0.2,2259,65,39618,17.53008849557522,36
0.2,2260,48,39666,17.54356479433879,54
0.2,2261,85,39751,17.57338638373121,15
0.2,2262,0,39751,17.565620857269113,103
0.2,2263,-118,39633,17.505742049469966,220
0.2,2264,49,39682,17.519646799116998,51
0.2,2265,81,39763,17.54766107678729,19
0.2,2266,22,39785,17.54962505513895,10
0.2,2267,42,39827,17.560405643738978,60
0.2,2268,95,39922,17.594535037461437,6
0.2,2269,-36,39886,17.57092511013216,136
0.2,2270,82,39968,17.59929546455306,18
0.2,2271,-62,39906,17.56426056338028,95
0.2,2272,50,39956,17.57853057633084,51
0.2,2273,64,40020,17.598944591029024,37
0.2,2274,22,40042,17.60087912087912,78
0.2,2275,15,40057,17.599736379613358,16
0.2,2276,86,40143,17.629776021080367,14
0.2,2277,94,40237,17.663301141352065,7
0.2,2278,48,40285,17.676612549363757,53
0.2,2279,58,40343,17.694298245614036,42
0.2,2280,6,40349,17.689171416045593,95
0.2,2281,48,40397,17.70245398773006,53
0.2,2282,-205,40192,17.60490582566798,309
0.2,2283,75,40267,17.630035026269702,26
0.2,2284,83,40350,17.65864332603939,17
0.2,2285,-70,40280,17.62029746281715,101
0.2,2286,35,40315,17.627896808045474,66
0.2,2287,-7,40308,17.617132867132867,110
0.2,2288,2,40310,17.61031017911752,31
0.2,2289,-57,40253,17.57772925764192,160
0.2,2290,32,40285,17.584024443474465,68
0.2,2291,94,40379,17.6173647469459,6
0.2,2292,71,40450,17.640645442651547,31
0.2,2293,51,40501,17.655187445510027,52
0.2,2294,89,40590,17.686274509803923,11
0.2,2295,43,40633,17.697299651567945,57
0.2,2296,5,40638,17.69177187636047,27
0.2,2297,87,40725,17.721932114882506,13
0.2,2298,35,40760,17.729447585906914,65
0.2,2299,87,40847,17.759565217391305,13
0.2,2300,82,40929,17.78748370273794,18
0.2,2301,-122,40807,17.726759339704603,153
0.2,2302,-134,40673,17.66087711680417,168
0.2,2303,-23,40650,17.643229166666668,126
0.2,2304,-14,40636,17.629501084598697,114
0.2,2305,94,40730,17.662619254119686,6
0.2,2306,-16,40714,17.64802774165583,116
0.2,2307,63,40777,17.667677642980937,44
0.2,2308,95,40872,17.701169337375486,6
0.2,2309,-4,40868,17.69177489177489,105
0.2,2310,5,40873,17.68628299437473,27
0.2,2311,83,40956,17.714532871972317,18
0.2,2312,51,41007,17.72892347600519,52
0.2,2313,-51,40956,17.699222126188417,154
0.2,2314,-36,40920,17.676025917926566,67
0.2,2315,55,40975,17.692141623488773,46
0.2,2316,31,41006,17.69788519637462,72
0.2,2317,42,41048,17.7083692838654,58
0.2,2318,74,41122,17.732643380767573,27
0.2,2319,55,41177,17.748706896551724,45
0.2,2320,-22,41155,17.731581214993536,104
0.2,2321,82,41237,17.75925925925926,18
0.2,2322,11,41248,17.75634954799828,90
0.2,2323,-86,41162,17.71170395869191,188
0.2,2324,59,41221,17.7294623655914,42
0.2,2325,58,41279,17.74677558039553,43
0.2,2326,58,41337,17.764073914911904,42
0.2,2327,81,41418,17.79123711340206,20
0.2,2328,70,41488,17.813653928724776,43
0.2,2329,16,41504,17.812875536480686,16
0.2,2330,76,41580,17.83783783783784,25
0.2,2331,-170,41410,17.75728987993139,205
0.2,2332,66,41476,17.777968281183025,36
0.2,2333,85,41561,17.806769494430164,15
0.2,2334,81,41642,17.833832976445397,19
0.2,2335,-97,41545,17.784674657534246,199
0.2,2336,60,41605,17.802738553701328,41
0.2,2337,20,41625,17.803678357570572,80
0.2,2338,81,41706,17.830696879008123,20
0.2,2339,15,41721,17.82948717948718,86
0.2,2340,58,41779,17.84664673216574,43
0.2,2341,-15,41764,17.83262169086251,117
0.2,2342,56,41820,17.848911651728553,45
0.2,2343,75,41895,17.873293515358363,26
0.2,2344,83,41978,17.901066098081024,18
0.2,2345,86,42064,17.93009377664109,15
0.2,2346,93,42157,17.96207925010652,7
0.2,2347,48,42205,17.974872231686543,53
0.2,2348,78,42283,18.00042571306939,22
0.2,2349,84,42367,18.028510638297874,17
0.2,2350,85,42452,18.056997022543598,16
0.2,2351,36,42488,18.064625850340136,64
0.2,2352,79,42567,18.090522736931575,42
0.2,2353,94,42661,18.122769753610875,6
0.2,2354,-16,42645,18.10828025477707,49
0.2,2355,81,42726,18.134974533106963,19
0.2,2356,61,42787,18.1531607976241,40
0.2,2357,-103,42684,18.10178117048346,141
0.2,2358,95,42779,18.134378974141587,6
0.2,2359,90,42869,18.164830508474576,10
0.2,2360,-15,42854,18.150783566285472,115
0.2,2361,91,42945,18.181625740897545,10
0.2,2362,76,43021,18.206093948370714,24
0.2,2363,-91,42930,18.15989847715736,193
0.2,2364,92,43022,18.191120507399578,8
0.2,2365,94,43116,18.223161453930686,6
0.2,2366,37,43153,18.231094212082805,64
0.2,2367,-10,43143,18.2191722972973,43
0.2,2368,-117,43026,18.16209371042634,159
0.2,2369,-322,42704,18.018565400843883,362
0.2,2370,-145,42559,17.949810206663855,179
0.2,2371,89,42648,17.979763912310286,12
0.2,2372,-179,42469,17.896755162241888,213
0.2,2373,92,42561,17.927969671440607,9
0.2,2374,88,42649,17.957473684210527,13
0.2,2375,-122,42527,17.898569023569024,156
0.2,2376,11,42538,17.895666806899452,21
0.2,2377,50,42588,17.909167367535744,50
0.2,2378,-51,42537,17.880201765447666,153
0.2,2379,66,42603,17.900420168067228,35
0.2,2380,46,42649,17.91222175556489,55
0.2,2381,85,42734,17.940386230058774,15
0.2,2382,-45,42689,17.913973982375158,145
0.2,2383,36,42725,17.921560402684563,64
0.2,2384,-55,42670,17.89098532494759,155
0.2,2385,-76,42594,17.851634534786253,178
0.2,2386,11,42605,17.848764139086718,89
0.2,2387,72,42677,17.8714405360134,28
0.2,2388,93,42770,17.902888237756382,7
0.2,2389,78,42848,17.928033472803346,22
0.2,2390,-86,42762,17.88456712672522,189
0.2,2391,86,42848,17.91304347826087,15
0.2,2392,5,42853,17.90764730463853,26
0.2,2393,1,42854,17.900584795321638,99
0.2,2394,8,42862,17.896450939457203,24
0.2,2395,-52,42810,17.86727879799666,153
0.2,2396,-150,42660,17.79724655819775,184
0.2,2397,69,42729,17.8185988323603,31
0.2,2398,35,42764,17.825760733639015,73
0.2,2399,65,42829,17.845416666666665,36
0.2,2400,-22,42807,17.828821324448146,123
0.2,2401,65,42872,17.848459616985846,35
0.2,2402,-117,42755,17.792342904702455,221
0.2,2403,-62,42693,17.759151414309486,164
0.2,2404,-7,42686,17.748856548856548,39
0.2,2405,33,42719,17.755195344970907,68
0.2,2406,87,42806,17.783963439966765,13
0.2,2407,87,42893,17.812707641196013,13
0.2,2408,-64,42829,17.778746367787463,95
0.2,2409,92,42921,17.80954356846473,8
0.2,2410,85,43006,17.837411862297802,39
0.2,2411,46,43052,17.849087893864013,56
0.2,2412,-9,43043,17.837961044343142,118
0.2,2413,88,43131,17.867025683512843,12
0.2,2414,80,43211,17.892753623188405,20
0.2,2415,49,43260,17.905629139072847,54
0.2,2416,65,43325,17.92511377741001,37
0.2,2417,28,43353,17.929280397022332,72
0.2,2418,2,43355,17.922695328648203,99
0.2,2419,-371,42984,17.76198347107438,408
0.2,2420,90,43074,17.79182156133829,10
0.2,2421,62,43136,17.81007431874484,38
0.2,2422,-22,43114,17.79364424267437,124
0.2,2423,-215,42899,17.697607260726073,251
0.2,2424,-164,42735,17.622680412371135,196
0.2,2425,39,42774,17.63149216817807,62
0.2,2426,74,42848,17.65471775854965,26
0.2,2427,44,42892,17.665568369028005,58
0.2,2428,-15,42877,17.65212021407987,118
0.2,2429,76,42953,17.676131687242798,24
0.2,2430,64,43017,17.6951871657754,36
0.2,2431,-267,42750,17.578125,235
0.2,2432,49,42799,17.591039868475132,51
0.2,2433,70,42869,17.612571898110108,30
0.2,2434,-17,42852,17.59835728952772,120
0.2,2435,67,42919,17.61863711001642,34
0.2,2436,80,42999,17.644234714813294,20
0.2,2437,40,43039,17.65340442986054,60
0.2,2438,59,43098,17.670356703567034,41
0.2,2439,70,43168,17.691803278688525,30
0.2,2440,75,43243,17.715280622695616,26
0.2,2441,38,43281,17.723587223587224,62
0.2,2442,12,43293,17.72124437167417,89
0.2,2443,-21,43272,17.70540098199673,121
0.2,2444,85,43357,17.732924335378325,16
0.2,2445,76,43433,17.756745707277187,25
0.2,2446,-474,42959,17.555782590927667,309
0.2,2447,59,43018,17.572712418300654,42
0.2,2448,-2,43016,17.56472029399755,102
0.2,2449,90,43106,17.594285714285714,11
0.2,2450,-8,43098,17.583843329253366,109
0.2,2451,-122,42976,17.526916802610113,158
0.2,2452,-21,42955,17.51121076233184,52
0.2,2453,54,43009,17.52607986960065,48
0.2,2454,21,43030,17.527494908350306,80
0.2,2455,-24,43006,17.51058631921824,125
0.2,2456,95,43101,17.542124542124544,6
0.2,2457,59,43160,17.55899104963385,44
0.2,2458,68,43228,17.57950386335909,33
0.2,2459,-4,43224,17.570731707317073,118
0.2,2460,-34,43190,17.549776513612354,66
0.2,2461,89,43279,17.578797725426483,11
0.2,2462,-141,43138,17.514413317092977,246
0.2,2463,45,43183,17.525568181818183,55
0.2,2464,94,43277,17.55659229208925,7
0.2,2465,92,43369,17.5867802108678,8
0.2,2466,30,43399,17.591811917308473,71
0.2,2467,79,43478,17.616693679092382,21
0.2,2468,88,43566,17.64520048602673,12
0.2,2469,-8,43558,17.63481781376518,40
0.2,2470,-76,43482,17.596924322136786,179
0.2,2471,70,43552,17.618122977346278,30
0.2,2472,58,43610,17.634452082490903,42
0.2,2473,42,43652,17.644300727566694,58
0.2,2474,55,43707,17.65939393939394,45
0.2,2475,64,43771,17.6781098546042,37
0.2,2476,-18,43753,17.663706096083974,119
0.2,2477,-316,43437,17.52905569007264,419
0.2,2478,-71,43366,17.493344090359017,106
0.2,2479,61,43427,17.510887096774194,39
0.2,2480,22,43449,17.512696493349456,80
0.2,2481,-21,43428,17.497179693795328,124
0.2,2482,-86,43342,17.455497382198953,188
0.2,2483,58,43400,17.47181964573269,52
0.2,2484,62,43462,17.4897384305835,39
0.2,2485,77,43539,17.513676588897827,24
0.2,2486,78,43617,17.537997587454765,22
0.2,2487,53,43670,17.55225080385852,48
0.2,2488,-67,43603,17.5182804339092,169
0.2,2489,5,43608,17.513253012048192,96
0.2,2490,58,43666,17.52950622240064,42
0.2,2491,59,43725,17.546147672552166,51
0.2,2492,-269,43456,17.431207380665864,381
0.2,2493,-23,43433,17.414995990376905,125
0.2,2494,83,43516,17.441282565130262,18
0.2,2495,-8,43508,17.431089743589745,108
0.2,2496,84,43592,17.45774929915899,17
0.2,2497,54,43646,17.472377902321856,46
0.2,2498,24,43670,17.4749899959984,76
0.2,2499,-14,43656,17.4624,116
0.2,2500,93,43749,17.492602958816473,8
0.2,2501,-3,43746,17.48441247002398,113
0.2,2502,48,43794,17.496604075109868,52
0.2,2503,73,43867,17.518769968051117,27
0.2,2504,48,43915,17.530938123752495,52
0.2,2505,-70,43845,17.496009577015165,171
0.2,2506,14,43859,17.49461507778221,88
0.2,2507,39,43898,17.503189792663477,61
0.2,2508,-5,43893,17.494220805101634,106
0.2,2509,-41,43852,17.470916334661354,141
0.2,2510,46,43898,17.48227797690163,54
0.2,2511,73,43971,17.50437898089172,27
0.2,2512,94,44065,17.534818941504177,7
0.2,2513,82,44147,17.56046141607001,18
0.2,2514,31,44178,17.565805168986085,71
0.2,2515,50,44228,17.578696343402225,51
0.2,2516,18,44246,17.57886372665872,83
0.2,2517,6,44252,17.574265289912628,26
0.2,2518,-53,44199,17.546248511314012,85
0.2,2519,-204,43995,17.458333333333332,171
0.2,2520,55,44050,17.473224910749703,46
0.2,2521,18,44068,17.47343378271213,82
0.2,2522,82,44150,17.49900911613159,19
0.2,2523,87,44237,17.526545166402535,13
0.2,2524,36,44273,17.533861386138614,65
0.2,2525,90,44363,17.562549485352335,10
0.2,2526,56,44419,17.577760189948556,45
0.2,2527,2,44421,17.571598101265824,44
0.2,2528,76,44497,17.594701463028866,25
0.2,2529,-31,44466,17.575494071146245,133
0.2,2530,-154,44312,17.507704464638483,259
0.2,2531,78,44390,17.531595576619274,23
0.2,2532,82,44472,17.55704697986577,19
0.2,2533,-12,44460,17.54538279400158,44
0.2,2534,-43,44417,17.521499013806707,144
0.2,2535,93,44510,17.551261829652997,8
0.2,2536,63,44573,17.569176192353172,39
0.2,2537,-36,44537,17.548069345941688,136
0.2,2538,-224,44313,17.452934226073257,188
0.2,2539,56,44369,17.468110236220472,45
0.2,2540,69,44438,17.488390397481307,31
0.2,2541,93,44531,17.51809598741149,8
0.2,2542,84,44615,17.544239087691704,16
0.2,2543,1,44616,17.537735849056602,100
0.2,2544,80,44696,17.562278978389,20
0.2,2545,-48,44648,17.536527886881384,148
0.2,2546,-190,44458,17.455045151158224,226
0.2,2547,61,44519,17.472135007849293,40
0.2,2548,57,44576,17.487642212632405,43
0.2,2549,94,44670,17.51764705882353,7
0.2,2550,-76,44594,17.48098784790278,178
0.2,2551,-129,44465,17.42358934169279,92
0.2,2552,94,44559,17.45358401880141,7
0.2,2553,59,44618,17.469851213782302,42
0.2,2554,12,44630,17.467710371819962,112
0.2,2555,72,44702,17.48904538341158,29
0.2,2556,49,44751,17.5013687915526,52
0.2,2557,-3,44748,17.493354182955432,104
0.2,2558,-69,44679,17.45955451348183,102
0.2,2559,32,44711,17.465234375,69
0.2,2560,47,44758,17.4767668879344,53
0.2,2561,-213,44545,17.38680718188915,176
0.2,2562,88,44633,17.414358174014826,12
0.2,2563,70,44703,17.43486739469579,31
0.2,2564,-135,44568,17.37543859649123,167
0.2,2565,93,44661,17.404910366328917,7
0.2,2566,-90,44571,17.36306973120374,190
0.2,2567,29,44600,17.36760124610592,72
0.2,2568,-100,44500,17.32191514207863,200
0.2,2569,-102,44398,17.275486381322956,205
0.2,2570,90,44488,17.30377285103073,11
0.2,2571,88,44576,17.33125972006221,13
0.2,2572,88,44664,17.358725223474543,12
0.2,2573,55,44719,17.373348873348874,46
0.2,2574,86,44805,17.4,14
0.2,2575,28,44833,17.404114906832298,74
0.2,2576,63,44896,17.421808304229724,38
0.2,2577,63,44959,17.439487975174554,39
0.2,2578,-103,44856,17.392787902287708,135
0.2,2579,35,44891,17.399612403100775,65
0.2,2580,80,44971,17.42386671832623,21
0.2,2581,28,44999,17.427962819519752,76
0.2,2582,-42,44957,17.404955478126208,142
0.2,2583,26,44983,17.40828173374613,74
0.2,2584,87,45070,17.435203094777563,14
0.2,2585,-115,44955,17.38399071925754,219
0.2,2586,-51,44904,17.357557015848474,154
0.2,2587,-110,44794,17.30834621329212,142
0.2,2588,90,44884,17.33642332947084,11
0.2,2589,70,44954,17.356756756756756,33
0.2,2590,61,45015,17.373600926283288,41
0.2,2591,66,45081,17.39236111111111,36
0.2,2592,-38,45043,17.37099884303895,70
0.2,2593,80,45123,17.395142636854278,21
0.2,2594,-7,45116,17.385741811175336,39
0.2,2595,86,45202,17.412172573189522,15
0.2,2596,11,45213,17.409703504043126,94
0.2,2597,26,45239,17.41301000769823,74
0.2,2598,85,45324,17.439015005771452,16
0.2,2599,90,45414,17.466923076923077,11
0.2,2600,79,45493,17.490580545943867,21
0.2,2601,72,45565,17.51152959262106,28
0.2,2602,-15,45550,17.499039569727238,117
0.2,2603,25,45575,17.501920122887864,78
0.2,2604,-52,45523,17.475239923224567,154
0.2,2605,84,45607,17.500767459708364,17
0.2,2606,64,45671,17.51860375911009,37
0.2,2607,7,45678,17.51457055214724,94
0.2,2608,55,45733,17.52893829053277,58
0.2,2609,-277,45456,17.41609195402299,314
0.2,2610,95,45551,17.445806204519343,6
0.2,2611,39,45590,17.45405819295559,61
0.2,2612,91,45681,17.48220436280138,10
0.2,2613,33,45714,17.48814078041316,67
0.2,2614,94,45808,17.517399617590822,7
0.2,2615,80,45888,17.541284403669724,21
0.2,2616,-34,45854,17.521589606419564,66
0.2,2617,10,45864,17.518716577540108,90
0.2,2618,-38,45826,17.497518136693394,71
0.2,2619,45,45871,17.508015267175573,56
0.2,2620,72,45943,17.52880579931324,28
0.2,2621,86,46029,17.554919908466818,14
0.2,2622,90,46119,17.582539077392298,10
0.2,2623,41,46160,17.591463414634145,60
0.2,2624,-87,46073,17.55161904761905,196
0.2,2625,52,46125,17.564737242955065,50
0.2,2626,89,46214,17.591929958127142,12
0.2,2627,-330,45884,17.459665144596652,296
0.2,2628,26,45910,17.462913655382273,75
0.2,2629,94,46004,17.492015209125476,6
0.2,2630,79,46083,17.51539338654504,21
0.2,2631,53,46136,17.52887537993921,48
0.2,2632,81,46217,17.552981390049375,20
0.2,2633,-184,46033,17.476461655277145,231
0.2,2634,68,46101,17.49563567362429,32
0.2,2635,53,46154,17.509104704097116,48
0.2,2636,84,46238,17.534319302237392,16
0.2,2637,43,46281,17.543972706595905,58
0.2,2638,51,46332,17.55665024630542,49
0.2,2639,85,46417,17.58219696969697,15
0.2,2640,-63,46354,17.55168496781522,163
0.2,2641,78,46432,17.57456472369417,22
0.2,2642,94,46526,17.603480892924708,6
0.2,2643,27,46553,17.607034795763994,73
0.2,2644,-20,46533,17.59281663516068,120
0.2,2645,-27,46506,17.575963718820862,58
0.2,2646,90,46596,17.60332451832263,10
0.2,2647,46,46642,17.61404833836858,54
0.2,2648,69,46711,17.633446583616458,31
0.2,2649,86,46797,17.65924528301887,15
0.2,2650,92,46889,17.68728781591852,8
0.2,2651,36,46925,17.69419306184012,65
0.2,2652,55,46980,17.708254805880134,45
0.2,2653,63,47043,17.72532027128862,37
0.2,2654,80,47123,17.748775894538607,21
0.2,2655,-8,47115,17.739081325301203,145
0.2,2656,74,47189,17.76025592773805,26
0.2,2657,90,47279,17.787434161023327,10
0.2,2658,25,47304,17.790146671681082,89
0.2,2659,84,47388,17.81503759398496,16
0.2,2660,79,47467,17.838030815482902,21
0.2,2661,-6,47461,17.829075882794893,107
0.2,2662,26,47487,17.832144198272626,75
0.2,2663,86,47573,17.85773273273273,14
0.2,2664,63,47636,17.87467166979362,38
0.2,2665,76,47712,17.896474118529632,24
0.2,2666,85,47797,17.921634795650544,15
0.2,2667,21,47818,17.92278860569715,11
0.2,2668,15,47833,17.9216935181716,94
0.2,2669,30,47863,17.92621722846442,71
0.2,2670,29,47892,17.93036315986522,73
0.2,2671,83,47975,17.954715568862277,18
0.2,2672,32,48007,17.959970071081184,69
0.2,2673,58,48065,17.974943904263277,43
0.2,2674,9,48074,17.97158878504673,92
0.2,2675,60,48134,17.98729446935725,41
0.2,2676,80,48214,18.01045946955547,21
0.2,2677,-161,48053,17.943614637789395,198
0.2,2678,18,48071,17.943635684957073,82
0.2,2679,35,48106,17.95,65
0.2,2680,57,48163,17.964565460649013,43
0.2,2681,1,48164,17.958240119313945,100
0.2,2682,78,48242,17.980618710398808,23
0.2,2683,86,48328,18.005961251862892,15
0.2,2684,-4,48324,17.99776536312849,104
0.2,2685,84,48408,18.02233804914371,17
0.2,2686,-177,48231,17.949758094529216,141
0.2,2687,63,48294,17.966517857142858,37
0.2,2688,71,48365,17.986240238006694,29
0.2,2689,75,48440,18.007434944237918,25
0.2,2690,84,48524,18.031958379784466,16
0.2,2691,-42,48482,18.009658246656763,142
0.2,2692,42,48524,18.018566654288897,59
0.2,2693,85,48609,18.043429844097997,15
0.2,2694,51,48660,18.055658627087197,49
0.2,2695,-6,48654,18.04673590504451,108
0.2,2696,82,48736,18.07044864664442,19
0.2,2697,74,48810,18.091178650852484,27
0.2,2698,44,48854,18.10077806595035,56
0.2,2699,21,48875,18.10185185185185,80
0.2,2700,83,48958,18.125879303961497,17
0.2,2701,81,49039,18.149148778682456,20
0.2,2702,85,49124,18.173880873103958,15
0.2,2703,93,49217,18.20155325443787,7
0.2,2704,83,49300,18.22550831792976,18
0.2,2705,-62,49238,18.195861049519586,165
0.2,2706,32,49270,18.20096047284817,69
0.2,2707,-1,49269,18.193870014771047,33
0.2,2708,-143,49126,18.1343669250646,178
0.2,2709,-146,48980,18.07380073800738,249
0.2,2710,16,48996,18.073035780154925,85
0.2,2711,-45,48951,18.049778761061948,149
0.2,2712,93,49044,18.07740508661998,8
0.2,2713,1,49045,18.07111274871039,101
0.2,2714,-29,49016,18.05377532228361,130
0.2,2715,53,49069,18.06664212076583,48
0.2,2716,-208,48861,17.983437615016562,173
0.2,2717,-238,48623,17.88925680647535,204
0.2,2718,-30,48593,17.87164398675984,62
0.2,2719,-83,48510,17.834558823529413,183
0.2,2720,44,48554,17.84417493568541,56
0.2,2721,-126,48428,17.791329904481998,237
0.2,2722,90,48518,17.81784796180683,11
0.2,2723,83,48601,17.841776798825258,17
0.2,2724,46,48647,17.852110091743118,54
0.2,2725,7,48654,17.848129126925897,94
0.2,2726,23,48677,17.85001833516685,78
0.2,2727,-95,48582,17.808651026392962,200
0.2,2728,-88,48494,17.76987907658483,190
0.2,2729,48,48542,17.78095238095238,52
0.2,2730,-27,48515,17.764555108019042,128
0.2,2731,64,48579,17.781478770131773,37
0.2,2732,-69,48510,17.74972557628979,236
0.2,2733,83,48593,17.77359180687637,17
0.2,2734,35,48628,17.779890310786104,65
0.2,2735,-173,48455,17.71016081871345,277
0.2,2736,42,48497,17.719035440263063,58
0.2,2737,43,48540,17.728268809349892,58
0.2,2738,91,48631,17.755020080321284,10
0.2,2739,23,48654,17.75693430656934,78
0.2,2740,92,48746,17.78402043049982,8
0.2,2741,88,48834,17.809628008752735,13
0.2,2742,-67,48767,17.778709442216552,30
0.2,2743,64,48831,17.79555393586006,37
0.2,2744,91,48922,17.822222222222223,9
0.2,2745,-48,48874,17.79825200291333,82
0.2,2746,-78,48796,17.763378230797233,180
0.2,2747,69,48865,17.78202328966521,31
0.2,2748,-106,48759,17.73699527100764,218
0.2,2749,55,48814,17.750545454545456,45
0.2,2750,-24,48790,17.735368956743002,64
0.2,2751,50,48840,17.747093023255815,52
0.2,2752,3,48843,17.74173628768616,97
0.2,2753,5,48848,17.737109658678285,98
0.2,2754,-305,48543,17.619963702359346,281
0.2,2755,82,48625,17.6433236574746,18
0.2,2756,71,48696,17.662676822633298,30
0.2,2757,86,48782,17.687454677302394,14
0.2,2758,83,48865,17.71112722000725,18
0.2,2759,76,48941,17.732246376811595,25
0.2,2760,64,49005,17.749003984063744,36
0.2,2761,57,49062,17.7632150615496,43
0.2,2762,72,49134,17.7828447339848,28
0.2,2763,33,49167,17.7883502170767,68
0.2,2764,76,49243,17.809403254972874,25
0.2,2765,93,49336,17.83658712942878,7
0.2,2766,71,49407,17.85580050596314,30
0.2,2767,87,49494,17.88078034682081,13
0.2,2768,45,49539,17.890574214517876,58
0.2,2769,86,49625,17.915162454873645,15
0.2,2770,27,49652,17.918440996030313,75
0.2,2771,-14,49638,17.906926406926406,114
0.2,2772,79,49717,17.928957807428777,21
0.2,2773,-120,49597,17.87923576063446,154
0.2,2774,66,49663,17.896576576576578,35
0.2,2775,80,49743,17.91894812680115,42
0.2,2776,65,49808,17.935902052574722,63
0.2,2777,81,49889,17.95860331173506,19
0.2,2778,65,49954,17.975530766462757,36
0.2,2779,3,49957,17.970143884892085,30
0.2,2780,54,50011,17.98309960445883,47
0.2,2781,-83,49928,17.946800862688715,184
0.2,2782,83,50011,17.9701760689903,18
0.2,2783,-54,49957,17.944324712643677,88
0.2,2784,71,50028,17.963375224416517,30
0.2,2785,4,50032,17.958363244795407,96
0.2,2786,-61,49971,17.930032292787946,163
0.2,2787,75,50046,17.950502152080343,26
0.2,2788,15,50061,17.949444245249193,86
0.2,2789,22,50083,17.95089605734767,81
0.2,2790,64,50147,17.967395198853456,36
0.2,2791,50,50197,17.978868194842406,50
0.2,2792,-36,50161,17.959541711421412,138
0.2,2793,12,50173,17.957408732999284,93
0.2,2794,68,50241,17.97531305903399,32
0.2,2795,16,50257,17.974606580829757,85
0.2,2796,95,50352,18.002145155523774,6
0.2,2797,81,50433,18.024660471765547,20
0.2,2798,-59,50374,17.997141836370133,161
0.2,2799,12,50386,17.995,88
0.2,2800,-93,50293,17.955373081042485,198
0.2,2801,92,50385,17.981798715203425,9
0.2,2802,61,50446,17.997145915090975,40
0.2,2803,45,50491,18.006776034236804,56
0.2,2804,85,50576,18.03065953654189,15
0.2,2805,93,50669,18.057377049180328,8
0.2,2806,-65,50604,18.02778767367296,168
0.2,2807,84,50688,18.05128205128205,16
0.2,2808,7,50695,18.04734781060876,24
0.2,2809,-176,50519,17.97829181494662,278
0.2,2810,80,50599,18.000355745286374,21
0.2,2811,79,50678,18.022048364153626,22
0.2,2812,68,50746,18.039815143974405,33
0.2,2813,19,50765,18.040156361051885,82
0.2,2814,-135,50630,17.985790408525755,168
0.2,2815,4,50634,17.980823863636363,98
0.2,2816,-89,50545,17.942847000354988,191
0.2,2817,94,50639,17.969836763662173,7
0.2,2818,2,50641,17.964171692089394,100
0.2,2819,-117,50524,17.91631205673759,150
0.2,2820,-12,50512,17.905707196029777,124
0.2,2821,57,50569,17.919560595322466,44
0.2,2822,-34,50535,17.90116896918172,137
0.2,2823,89,50624,17.926345609065155,11
0.2,2824,91,50715,17.95221238938053,9
0.2,2825,11,50726,17.94975230007077,91
0.2,2826,-306,50420,17.835160948001416,415
0.2,2827,78,50498,17.856435643564357,23
0.2,2828,-168,50330,17.79073877695299,202
0.2,2829,72,50402,17.809893992932864,28
0.2,2830,69,50471,17.827975980219005,40
0.2,2831,85,50556,17.85169491525424,16
0.2,2832,64,50620,17.86798446876103,39
0.2,2833,73,50693,17.88743824982357,28
0.2,2834,93,50786,17.913932980599647,8
0.2,2835,-78,50708,17.880112834978842,110
0.2,2836,78,50786,17.90130419457173,26
0.2,2837,-210,50576,17.821000704721634,245
0.2,2838,-8,50568,17.811905600563577,39
0.2,2839,36,50604,17.81830985915493,64
0.2,2840,27,50631,17.821541710665258,74
0.2,2841,86,50717,17.845531315974664,14
0.2,2842,-208,50509,17.766092156173055,172
0.2,2843,2,50511,17.76054852320675,49
0.2,2844,-315,50196,17.64358523725835,417
0.2,2845,61,50257,17.658819395643008,39
0.2,2846,22,50279,17.66034422198806,80
0.2,2847,61,50340,17.67556179775281,40
0.2,2848,29,50369,17.679536679536678,72
0.2,2849,35,50404,17.68561403508772,65
0.2,2850,92,50496,17.711680112241318,8
0.2,2851,77,50573,17.732468443197757,24
0.2,2852,94,50667,17.75920084121977,6
0.2,2853,73,50740,17.77855641205326,28
0.2,2854,68,50808,17.79614711033275,32
0.2,2855,-1,50807,17.78956582633053,103
0.2,2856,-32,50775,17.772138606930348,135
0.2,2857,-82,50693,17.737228831350595,114
0.2,2858,90,50783,17.762504372158098,10
0.2,2859,-70,50713,17.73181818181818,171
0.2,2860,69,50782,17.749737853897237,31
0.2,2861,21,50803,17.75087351502446,79
0.2,2862,74,50877,17.77052043311212,27
0.2,2863,21,50898,17.77164804469274,79
0.2,2864,84,50982,17.79476439790576,16
0.2,2865,4,50986,17.789951151430564,27
0.2,2866,53,51039,17.802232298569933,47
0.2,2867,-26,51013,17.786959553695954,128
0.2,2868,-74,50939,17.75496688741722,114
0.2,2869,77,51016,17.775609756097563,24
0.2,2870,37,51053,17.782305816788575,63
0.2,2871,-16,51037,17.770543175487465,47
0.2,2872,0,51037,17.76435781413157,101
0.2,2873,-42,50995,17.743562978427278,147
0.2,2874,-73,50922,17.712,173
0.2,2875,-129,50793,17.660987482614743,233
0.2,2876,75,50868,17.680917622523463,26
0.2,2877,68,50936,17.69840166782488,34
0.2,2878,68,51004,17.71587356721084,33
0.2,2879,4,51008,17.711111111111112,99
0.2,2880,50,51058,17.722318639361333,52
0.2,2881,74,51132,17.741845940319223,27
0.2,2882,69,51201,17.759625390218524,33
0.2,2883,52,51253,17.77149791955617,50
0.2,2884,-28,51225,17.755632582322356,138
0.2,2885,65,51290,17.77200277200277,37
0.2,2886,-41,51249,17.75164530654659,73
0.2,2887,1,51250,17.74584487534626,100
0.2,2888,35,51285,17.751817237798548,67
0.2,2889,7,51292,17.748096885813148,94
0.2,2890,-58,51234,17.72189553787617,90
0.2,2891,82,51316,17.744121715076073,18
0.2,2892,54,51370,17.75665399239544,46
0.2,2893,86,51456,17.780234968901176,15
0.2,2894,-23,51433,17.76614853195164,124
0.2,2895,95,51528,17.79281767955801,6
0.2,2896,38,51566,17.799792889195718,78
0.2,2897,39,51605,17.80710835058661,61
0.2,2898,77,51682,17.82752673335633,24
0.2,2899,-67,51615,17.798275862068966,98
0.2,2900,-242,51373,17.708721130644605,279
0.2,2901,79,51452,17.729841488628534,22
0.2,2902,1,51453,17.724078539441958,100
0.2,2903,37,51490,17.730716253443525,71
0.2,2904,1,51491,17.724956970740102,99
0.2,2905,-252,51239,17.632140399174123,361
0.2,2906,69,51308,17.64981080151359,32
0.2,2907,-36,51272,17.631361760660248,139
0.2,2908,90,51362,17.656239257476795,10
0.2,2909,52,51414,17.668041237113403,48
0.2,2910,94,51508,17.694263139814495,6
0.2,2911,13,51521,17.6926510989011,88
0.2,2912,26,51547,17.695502917954,75
0.2,2913,79,51626,17.716540837336993,21
0.2,2914,-76,51550,17.684391080617495,108
0.2,2915,21,51571,17.685528120713307,80
0.2,2916,68,51639,17.702776825505655,32
0.2,2917,84,51723,17.725496915695683,17
0.2,2918,29,51752,17.72935936964714,71
0.2,2919,84,51836,17.752054794520546,16
0.2,2920,40,51876,17.75967134542965,62
0.2,2921,-3,51873,17.752566735112936,104
0.2,2922,42,51915,17.760862127950734,58
0.2,2923,-54,51861,17.736320109439124,158
0.2,2924,38,51899,17.743247863247863,62
0.2,2925,14,51913,17.74196855775803,18
0.2,2926,64,51977,17.757772463272975,36
0.2,2927,-58,51919,17.731898907103826,161
0.2,2928,27,51946,17.73506316148856,75
0.2,2929,1,51947,17.729351535836177,105
0.2,2930,78,52025,17.74991470487888,23
0.2,2931,15,52040,17.748976807639835,17
0.2,2932,50,52090,17.759972724173203,51
0.2,2933,94,52184,17.785957736877982,6
0.2,2934,85,52269,17.80885860306644,15
0.2,2935,67,52336,17.825613079019075,34
0.2,2936,86,52422,17.848825331971398,15
0.2,2937,30,52452,17.85296119809394,73
0.2,2938,-58,52394,17.827152092548484,161
0.2,2939,-4,52390,17.81972789115646,37
0.2,2940,66,52456,17.83611016661,34
0.2,2941,84,52540,17.858599592114206,16
0.2,2942,-415,52125,17.711518858307848,382
0.2,2943,14,52139,17.710258152173914,87
0.2,2944,26,52165,17.713073005093378,6
0.2,2945,51,52216,17.724372029871013,50
0.2,2946,55,52271,17.737020699015947,45
0.2,2947,-5,52266,17.72930800542741,105
0.2,2948,7,52273,17.725669718548662,94
0.2,2949,64,52337,17.74135593220339,36
0.2,2950,94,52431,17.767197560149103,7
0.2,2951,17,52448,17.766937669376695,83
0.2,2952,48,52496,17.777175753471045,52
0.2,2953,-95,52401,17.738997968855788,126
0.2,2954,86,52487,17.762098138747884,16
0.2,2955,62,52549,17.777063599458728,39
0.2,2956,65,52614,17.793033479878254,36
0.2,2957,81,52695,17.81440162271805,19
0.2,2958,77,52772,17.834403514700913,23
0.2,2959,91,52863,17.85912162162162,10
0.2,2960,-69,52794,17.829787234042552,101
0.2,2961,89,52883,17.853814989871708,12
0.2,2962,80,52963,17.874789065136685,21
0.2,2963,76,53039,17.894399460188932,25
0.2,2964,83,53122,17.916357504215853,17
0.2,2965,92,53214,17.941335131490224,9
0.2,2966,42,53256,17.949443882709808,59
0.2,2967,61,53317,17.963948787061994,40
0.2,2968,62,53379,17.978780734253956,39
0.2,2969,35,53414,17.984511784511785,65
0.2,2970,-188,53226,17.915180074049143,221
0.2,2971,-80,53146,17.882234185733513,113
0.2,2972,43,53189,17.890682811974436,60
0.2,2973,35,53224,17.896435776731675,66
0.2,2974,73,53297,17.91495798319328,28
0.2,2975,-109,53188,17.872311827956988,141
0.2,2976,16,53204,17.871682902250587,96
0.2,2977,61,53265,17.886165211551376,40
0.2,2978,-22,53243,17.872776099362202,124
0.2,2979,9,53252,17.86979865771812,23
0.2,2980,-42,53210,17.84971486078497,75
0.2,2981,-121,53089,17.803152246814218,226
0.2,2982,-73,53016,17.77271203486423,177
0.2,2983,-59,52957,17.746983914209114,105
0.2,2984,-16,52941,17.735678391959798,128
0.2,2985,75,53016,17.754855994641662,26
0.2,2986,-3,53013,17.74790759959826,34
0.2,2987,48,53061,17.758032128514056,52
0.2,2988,78,53139,17.77818668450987,23
0.2,2989,52,53191,17.78963210702341,49
0.2,2990,-4,53187,17.78234704112337,36
0.2,2991,-76,53111,17.75100267379679,107
0.2,2992,-206,52905,17.676244570664885,242
0.2,2993,-14,52891,17.66566466265865,115
0.2,2994,79,52970,17.686143572621035,22
0.2,2995,-14,52956,17.675567423230973,114
0.2,2996,92,53048,17.700367033700367,8
0.2,2997,-81,52967,17.667444963308874,200
0.2,2998,93,53060,17.692564188062686,8
0.2,2999,-58,53002,17.667333333333332,91
0.2,3000,75,53077,17.686437854048652,30
0.2,3001,46,53123,17.69586942038641,54
0.2,3002,62,53185,17.71062271062271,38
0.2,3003,64,53249,17.726031957390145,36
0.2,3004,86,53335,17.74875207986689,15
0.2,3005,-55,53280,17.724550898203592,89
0.2,3006,52,53332,17.735949451280344,49
0.2,3007,92,53424,17.76063829787234,8
0.2,3008,92,53516,17.785310734463277,8
0.2,3009,-2,53514,17.77873754152824,103
0.2,3010,71,53585,17.796413151776818,29
0.2,3011,70,53655,17.81374501992032,30
0.2,3012,-122,53533,17.767341520079654,223
0.2,3013,-192,53341,17.69774386197744,229
0.2,3014,32,53373,17.702487562189056,68
0.2,3015,-117,53256,17.657824933687003,220
0.2,3016,67,53323,17.674179648657606,34
0.2,3017,-96,53227,17.636514247846257,128
0.2,3018,52,53279,17.647896654521364,49
0.2,3019,56,53335,17.660596026490065,45
0.2,3020,70,53405,17.677921218139687,30
0.2,3021,94,53499,17.703176704169426,6
0.2,3022,92,53591,17.72775388686735,9
0.2,3023,92,53683,17.752314814814813,8
0.2,3024,-22,53661,17.73917355371901,125
0.2,3025,92,53753,17.763714474553865,8
0.2,3026,89,53842,17.78724810042947,11
0.2,3027,87,53929,17.81010568031704,13
0.2,3028,71,54000,17.827665896335425,29
0.2,3029,92,54092,17.852145214521453,8
0.2,3030,54,54146,17.864071263609368,46
0.2,3031,-128,54018,17.815963060686016,240
0.2,3032,14,54032,17.81470491262776,104
0.2,3033,67,54099,17.830916282135796,33
0.2,3034,-73,54026,17.800988467874795,108
0.2,3035,82,54108,17.822134387351777,18
0.2,3036,-95,54013,17.78498518274613,127
0.2,3037,-66,53947,17.757406188281763,99
0.2,3038,33,53980,17.76242184929253,67
0.2,3039,-85,53895,17.72861842105263,189
0.2,3040,88,53983,17.75172640578757,13
0.2,3041,61,54044,17.76594345825115,39
0.2,3042,11,54055,17.763720013144923,91
0.2,3043,53,54108,17.775295663600527,48
0.2,3044,74,54182,17.79376026272578,27
0.2,3045,-37,54145,17.775771503611292,68
0.2,3046,-83,54062,17.74269773547752,186
0.2,3047,91,54153,17.766732283464567,9
0.2,3048,-54,54099,17.74319448999672,85
0.2,3049,48,54147,17.75311475409836,52
0.2,3050,92,54239,17.77745001638807,8
0.2,3051,74,54313,17.795871559633028,26
0.2,3052,10,54323,17.793318047821813,91
0.2,3053,87,54410,17.815979043876883,14
0.2,3054,54,54464,17.827823240589197,47
0.2,3055,51,54515,17.838678010471206,52
0.2,3056,-76,54439,17.80798168138698,176
0.2,3057,63,54502,17.822759973839112,39
0.2,3058,11,54513,17.820529584831643,91
0.2,3059,64,54577,17.83562091503268,36
0.2,3060,6,54583,17.831754328650767,107
0.2,3061,61,54644,17.845852384062702,40
0.2,3062,-43,54601,17.825987593862227,145
0.2,3063,39,54640,17.83289817232376,69
0.2,3064,66,54706,17.848613376835235,35
0.2,3065,-11,54695,17.839204174820612,50
0.2,3066,6,54701,17.835343984349528,94
0.2,3067,-169,54532,17.77444589308996,291
0.2,3068,4,54536,17.769957640925384,99
0.2,3069,59,54595,17.78338762214984,41
0.2,3070,67,54662,17.799413871703027,34
0.2,3071,-29,54633,17.7841796875,61
0.2,3072,7,54640,17.780670354702245,93
0.2,3073,65,54705,17.796031229668184,35
0.2,3074,72,54777,17.813658536585365,29
0.2,3075,72,54849,17.831274382314696,29
0.2,3076,56,54905,17.8436789080273,46
0.2,3077,11,54916,17.841455490578298,90
0.2,3078,82,54998,17.862292952257228,18
0.2,3079,-95,54903,17.82564935064935,208
0.2,3080,77,54980,17.844855566374555,24
0.2,3081,-90,54890,17.80986372485399,123
0.2,3082,89,54979,17.832954914044763,12
0.2,3083,-115,54864,17.78988326848249,219
0.2,3084,93,54957,17.81426256077796,7
0.2,3085,92,55049,17.838302009073235,8
0.2,3086,74,55123,17.85649497894396,27
0.2,3087,90,55213,17.879857512953368,10
0.2,3088,64,55277,17.894787957267724,37
0.2,3089,90,55367,17.91812297734628,10
0.2,3090,-143,55224,17.866062762859915,248
0.2,3091,-63,55161,17.839909443725745,97
0.2,3092,77,55238,17.85903653410928,23
0.2,3093,74,55312,17.877181641887525,27
0.2,3094,-32,55280,17.861066235864296,64
0.2,3095,-241,55039,17.777454780361758,348
0.2,3096,79,55118,17.797223119147564,22
0.2,3097,84,55202,17.81859264041317,16
0.2,3098,92,55294,17.842529848338174,8
0.2,3099,41,55335,17.85,66
0.2,3100,51,55386,17.86069009996775,49
0.2,3101,-26,55360,17.84655061250806,59
0.2,3102,83,55443,17.867547534643894,17
0.2,3103,-44,55399,17.847615979381445,146
0.2,3104,40,55439,17.85475040257649,62
0.2,3105,79,55518,17.874436574372183,22
0.2,3106,-24,55494,17.86095912455745,136
0.2,3107,-24,55470,17.847490347490346,125
0.2,3108,1,55471,17.842071405596656,102
0.2,3109,15,55486,17.841157556270097,85
0.2,3110,50,55536,17.85149469623915,51
0.2,3111,61,55597,17.865359897172237,39
0.2,3112,68,55665,17.881464824927722,32
0.2,3113,47,55712,17.890815671162493,54
0.2,3114,8,55720,17.8876404494382,23
0.2,3115,-2,55718,17.881258023106547,34
0.2,3116,1,55719,17.875842155919152,31
0.2,3117,95,55814,17.900577293136624,6
0.2,3118,89,55903,17.92337287592177,12
0.2,3119,-42,55861,17.904166666666665,148
0.2,3120,83,55944,17.92502403075937,17
0.2,3121,93,56037,17.949071108263933,8
0.2,3122,67,56104,17.964777457572847,33
0.2,3123,-15,56089,17.954225352112676,117
0.2,3124,-10,56079,17.94528,111
0.2,3125,-5,56074,17.93793985924504,108
0.2,3126,-50,56024,17.9162136232811,153
0.2,3127,72,56096,17.933503836317136,43
0.2,3128,36,56132,17.939277724512625,75
0.2,3129,83,56215,17.96006389776358,18
0.2,3130,76,56291,17.97860108591504,25
0.2,3131,42,56333,17.986270753512134,58
0.2,3132,57,56390,17.998723268432812,44
0.2,3133,57,56447,18.011167836630506,44
0.2,3134,78,56525,18.03030303030303,22
0.2,3135,91,56616,18.053571428571427,9
0.2,3136,60,56676,18.066942939113805,40
0.2,3137,93,56769,18.090822179732314,8
0.2,3138,17,56786,18.090474673462886,84
0.2,3139,28,56814,18.093630573248408,73
0.2,3140,8,56822,18.0904170646291,23
0.2,3141,36,56858,18.096117122851687,65
0.2,3142,-35,56823,18.079223671651288,137
0.2,3143,73,56896,18.09669211195929,28
0.2,3144,78,56974,18.115739268680446,23
0.2,3145,93,57067,18.139542275905914,7
0.2,3146,58,57125,18.15220845249444,49
0.2,3147,-44,57081,18.13246505717916,151
0.2,3148,84,57165,18.153382026040013,16
0.2,3149,39,57204,18.16,61
0.2,3150,-35,57169,18.143129165344334,135
0.2,3151,80,57249,18.1627538071066,21
0.2,3152,-66,57183,18.136060894386297,98
0.2,3153,85,57268,18.1572606214331,16
0.2,3154,72,57340,18.1743264659271,28
0.2,3155,82,57422,18.194550063371356,18
0.2,3156,54,57476,18.205891669306304,47
0.2,3157,31,57507,18.209943001899937,69
0.2,3158,79,57586,18.229186451408673,23
0.2,3159,91,57677,18.252215189873418,9
0.2,3160,-14,57663,18.24201202151218,115
0.2,3161,-166,57497,18.183744465528147,201
0.2,3162,95,57592,18.20803035093266,6
0.2,3163,60,57652,18.221238938053098,41
0.2,3164,95,57747,18.245497630331755,6
0.2,3165,75,57822,18.263423878711308,25
0.2,3166,65,57887,18.27818124407957,35
0.2,3167,64,57951,18.292613636363637,37
0.2,3168,19,57970,18.2928368570527,82
0.2,3169,88,58058,18.314826498422715,12
0.2,3170,61,58119,18.328287606433303,39
0.2,3171,-2,58117,18.3218789407314,102
0.2,3172,-23,58094,18.308855972265995,55
0.2,3173,-14,58080,18.29867674858223,118
0.2,3174,33,58113,18.303307086614172,67
0.2,3175,77,58190,18.321788413098236,27
0.2,3176,93,58283,18.345294302801385,8
0.2,3177,32,58315,18.349590937696664,68
0.2,3178,-38,58277,18.331865366467444,138
0.2,3179,53,58330,18.342767295597483,47
0.2,3180,50,58380,18.3527192706696,51
0.2,3181,-73,58307,18.324010056568195,174
0.2,3182,-39,58268,18.306000628338047,139
0.2,3183,26,58294,18.308417085427134,6
0.2,3184,86,58380,18.32967032967033,14
0.2,3185,28,58408,18.332705586942875,72
0.2,3186,53,58461,18.34358330718544,60
0.2,3187,8,58469,18.340338770388957,23
0.2,3188,-32,58437,18.324553151458137,133
0.2,3189,40,58477,18.331347962382445,60
0.2,3190,61,58538,18.344719523660295,40
0.2,3191,-38,58500,18.327067669172934,139
0.2,3192,13,58513,18.325399310992797,19
0.2,3193,62,58575,18.339073262366938,39
0.2,3194,64,58639,18.35336463223787,48
0.2,3195,-49,58590,18.332290362953692,152
0.2,3196,-25,58565,18.318736315295588,126
0.2,3197,68,58633,18.334271419637272,33
0.2,3198,83,58716,18.35448577680525,18
0.2,3199,-12,58704,18.345,44
0.2,3200,66,58770,18.359887535145266,35
0.2,3201,2,58772,18.35477826358526,98
0.2,3202,63,58835,18.368716827973774,39
0.2,3203,-146,58689,18.31741573033708,111
0.2,3204,-216,58473,18.244305772230888,251
0.2,3205,16,58489,18.243605739238927,85
0.2,3206,20,58509,18.244153414405986,81
0.2,3207,95,58604,18.268079800498754,6
0.2,3208,55,58659,18.279526332190713,46
0.2,3209,-141,58518,18.229906542056074,174
0.2,3210,80,58598,18.249143568981626,20
0.2,3211,-19,58579,18.237546699875466,120
0.2,3212,-34,58545,18.22128851540616,71
0.2,3213,39,58584,18.227753578095832,62
0.2,3214,54,58638,18.238880248833592,48
0.2,3215,-6,58632,18.23134328358209,107
0.2,3216,-27,58605,18.217283183089837,60
0.2,3217,44,58649,18.225295214418892,57
0.2,3218,85,58734,18.246039142590867,16
0.2,3219,65,58799,18.26055900621118,35
0.2,3220,76,58875,18.278484942564422,25
0.2,3221,20,58895,18.279019242706394,81
0.2,3222,16,58911,18.278312131554454,85
0.2,3223,67,58978,18.293424317617866,33
0.2,3224,53,59031,18.304186046511628,48
0.2,3225,-229,58802,18.227526348419094,351
0.2,3226,74,58876,18.24480942051441,27
0.2,3227,65,58941,18.259293680297397,35
0.2,3228,89,59030,18.2812016104057,12
0.2,3229,53,59083,18.291950464396283,48
0.2,3230,-53,59030,18.269885484370164,160
0.2,3231,-42,58988,18.251237623762375,144
0.2,3232,3,58991,18.2465202598206,99
0.2,3233,26,59017,18.248917748917748,74
0.2,3234,-79,58938,18.21885625965997,111
0.2,3235,82,59020,18.23856613102596,19
0.2,3236,32,59052,18.242817423540316,69
0.2,3237,80,59132,18.26189005558987,21
0.2,3238,-25,59107,18.248533497993208,57
0.2,3239,66,59173,18.26327160493827,34
0.2,3240,74,59247,18.280468991052146,26
0.2,3241,83,59330,18.300431832202346,18
0.2,3242,81,59411,18.31976564909035,19
0.2,3243,23,59434,18.321208384710236,78
0.2,3244,24,59458,18.32295839753467,76
0.2,3245,89,59547,18.344731977818853,11
0.2,3246,92,59639,18.367416076378195,8
0.2,3247,-116,59523,18.326046798029555,218
0.2,3248,6,59529,18.32225300092336,97
0.2,3249,-59,59470,18.298461538461538,161
0.2,3250,-12,59458,18.289141802522302,43
0.2,3251,-35,59423,18.272755227552274,138
0.2,3252,62,59485,18.286197356286504,38
0.2,3253,18,59503,18.286109403810695,87
0.2,3254,-68,59435,18.259600614439325,173
0.2,3255,36,59471,18.26504914004914,75
0.2,3256,-119,59352,18.22290451335585,223
0.2,3257,-10,59342,18.214241866175566,42
0.2,3258,-22,59320,18.20190242405646,122
0.2,3259,69,59389,18.217484662576688,32
0.2,3260,-79,59310,18.187672493100276,181
0.2,3261,77,59387,18.20570202329859,24
0.2,3262,-8,59379,18.197670855041373,109
0.2,3263,66,59445,18.212316176470587,35
0.2,3264,-3,59442,18.20581929555896,104
0.2,3265,75,59517,18.22320881812615,25
0.2,3266,77,59594,18.241199877563513,24
0.2,3267,84,59678,18.261321909424726,16
0.2,3268,92,59770,18.28387886203732,8
0.2,3269,72,59842,18.300305810397553,28
0.2,3270,63,59905,18.31397126261082,38
0.2,3271,52,59957,18.32426650366748,49
0.2,3272,-81,59876,18.293919951115186,195
0.2,3273,-35,59841,18.277642028100182,141
0.2,3274,87,59928,18.298625954198474,14
0.2,3275,-117,59811,18.257326007326007,221
0.2,3276,-98,59713,18.22184925236497,198
0.2,3277,79,59792,18.24039048200122,21
0.2,3278,81,59873,18.25953034461726,20
0.2,3279,53,59926,18.27012195121951,50
0.2,3280,-140,59786,18.221883572081683,172
0.2,3281,52,59838,18.23217550274223,49
0.2,3282,60,59898,18.244897959183675,40
0.2,3283,-64,59834,18.21985383678441,97
0.2,3284,66,59900,18.234398782343987,34
0.2,3285,59,59959,18.246804625684724,41
0.2,3286,-12,59947,18.237602677213264,123
0.2,3287,93,60040,18.260340632603405,7
0.2,3288,94,60134,18.283368805107937,7
0.2,3289,88,60222,18.304559270516716,13
0.2,3290,32,60254,18.308720753570345,69
0.2,3291,-18,60236,18.297691373025515,118
0.2,3292,15,60251,18.29668994837534,86
0.2,3293,-4,60247,18.289921068609594,35
0.2,3294,-32,60215,18.27465857359636,63
0.2,3295,93,60308,18.29733009708738,8
0.2,3296,28,60336,18.30027297543221,74
0.2,3297,82,60418,18.31958762886598,19
0.2,3298,16,60434,18.318884510457714,16
0.2,3299,90,60524,18.34060606060606,11
0.2,3300,4,60528,18.33626173886701,97
0.2,3301,93,60621,18.358873410054514,7
0.2,3302,90,60711,18.380563124432335,10
0.2,3303,-171,60540,18.32324455205811,203
0.2,3304,91,60631,18.345234493192134,10
0.2,3305,78,60709,18.363278886872354,24
0.2,3306,-193,60516,18.299364983368612,296
0.2,3307,93,60609,18.321946795646916,7
0.2,3308,67,60676,18.33665760048353,34
0.2,3309,75,60751,18.35377643504532,26
0.2,3310,84,60835,18.373603141045002,16
0.2,3311,-36,60799,18.357185990338163,139
0.2,3312,84,60883,18.37699969815877,17
0.2,3313,66,60949,18.39136994568497,35
0.2,3314,5,60954,18.38733031674208,98
0.2,3315,51,61005,18.39716525934861,50
0.2,3316,-16,60989,18.38679529695508,116
0.2,3317,55,61044,18.397830018083184,45
0.2,3318,-151,60893,18.346791202169328,259
0.2,3319,-66,60827,18.321385542168674,98
0.2,3320,-20,60807,18.309846431797652,123
0.2,3321,82,60889,18.32901866345575,18
0.2,3322,70,60959,18.34456816130003,31
0.2,3323,-15,60944,18.33453670276775,116
0.2,3324,41,60985,18.341353383458646,59
0.2,3325,-224,60761,18.26849067949489,220
0.2,3326,69,60830,18.283739104298167,32
0.2,3327,76,60906,18.30108173076923,24
0.2,3328,60,60966,18.313607689996996,41
0.2,3329,45,61011,18.32162162162162,55
0.2,3330,57,61068,18.3332332632843,44
0.2,3331,52,61120,18.343337334933974,48
0.2,3332,-22,61098,18.33123312331233,122
0.2,3333,55,61153,18.342231553689263,46
0.2,3334,-363,60790,18.227886056971514,398
0.2,3335,81,60871,18.246702637889687,20
0.2,3336,7,60878,18.243332334432125,102
0.2,3337,59,60937,18.25554224086279,45
0.2,3338,61,60998,18.268343815513628,39
0.2,3339,81,61079,18.287125748502994,19
0.2,3340,-4,61075,18.280454953606704,105
0.2,3341,68,61143,18.295332136445243,33
0.2,3342,85,61228,18.3152856715525,15
0.2,3343,-61,61167,18.291566985645932,164
0.2,3344,65,61232,18.305530642750373,35
0.2,3345,-8,61224,18.297668858338316,111
0.2,3346,68,61292,18.312518673438902,33
0.2,3347,-19,61273,18.30137395459976,119
0.2,3348,51,61324,18.311137653030755,51
0.2,3349,-34,61290,18.2955223880597,136
0.2,3350,86,61376,18.315726648761565,14
0.2,3351,91,61467,18.337410501193318,9
0.2,3352,49,61516,18.346555323590813,51
0.2,3353,50,61566,18.355992844364938,50
0.2,3354,19,61585,18.35618479880775,82
0.2,3355,78,61663,18.373957091775925,23
0.2,3356,52,61715,18.38397378611856,57
0.2,3357,-59,61656,18.360929124478858,159
0.2,3358,-184,61472,18.3006847275975,289
0.2,3359,57,61529,18.31220238095238,43
0.2,3360,80,61609,18.330556382029158,21
0.2,3361,58,61667,18.342355740630577,42
0.2,3362,11,61678,18.340172465060956,92
0.2,3363,-49,61629,18.32015457788347,81
0.2,3364,13,61642,18.318573551263,89
0.2,3365,67,61709,18.33303624480095,75
0.2,3366,-20,61689,18.32165132165132,122
0.2,3367,-26,61663,18.30849168646081,126
0.2,3368,62,61725,18.321460373998217,39
0.2,3369,91,61816,18.343026706231456,9
0.2,3370,-157,61659,18.29101156926728,121
0.2,3371,80,61739,18.309311981020166,21
0.2,3372,74,61813,18.32582270975393,26
0.2,3373,12,61825,18.32394783639597,90
0.2,3374,39,61864,18.330074074074073,61
0.2,3375,85,61949,18.349822274881518,15
0.2,3376,59,62008,18.361859638732604,41
0.2,3377,91,62099,18.383362936648904,9
0.2,3378,59,62158,18.395383249482094,42
0.2,3379,51,62209,18.405029585798818,50
0.2,3380,49,62258,18.41407867494824,52
0.2,3381,93,62351,18.43613246599645,8
0.2,3382,84,62435,18.455512858409694,17
0.2,3383,-38,62397,18.43882978723404,139
0.2,3384,-11,62386,18.4301329394387,114
0.2,3385,75,62461,18.446839929119907,25
0.2,3386,-14,62447,18.43726011219368,124
0.2,3387,14,62461,18.43595041322314,87
0.2,3388,-61,62400,18.41251106521098,165
0.2,3389,-7,62393,18.405014749262538,107
0.2,3390,33,62426,18.409318785019167,67
0.2,3391,-18,62408,18.39858490566038,118
0.2,3392,71,62479,18.41408782788093,29
0.2,3393,88,62567,18.434590453741897,13
0.2,3394,-10,62557,18.42621502209131,42
0.2,3395,-3,62554,18.419905771495877,103
0.2,3396,59,62613,18.431851633794526,42
0.2,3397,77,62690,18.449087698646263,23
0.2,3398,-162,62528,18.39599882318329,267
0.2,3399,78,62606,18.413529411764706,22
0.2,3400,38,62644,18.419288444575123,64
0.2,3401,77,62721,18.436507936507937,24
0.2,3402,-64,62657,18.412283279459302,167
0.2,3403,70,62727,18.42743830787309,30
0.2,3404,77,62804,18.444640234948604,23
0.2,3405,75,62879,18.461244862008222,26
0.2,3406,60,62939,18.473437041385385,41
0.2,3407,-25,62914,18.460680751173708,58
0.2,3408,38,62952,18.466412437665003,64
0.2,3409,82,63034,18.485043988269794,18
0.2,3410,36,63070,18.49017883318675,64
0.2,3411,-2,63068,18.4841735052755,38
0.2,3412,2,63070,18.479343685906827,100
0.2,3413,-17,63053,18.46895137668424,117
0.2,3414,18,63071,18.468814055636898,83
0.2,3415,50,63121,18.47804449648712,51
0.2,3416,15,63136,18.477026631548142,88
0.2,3417,47,63183,18.485371562317145,54
0.2,3418,-279,62904,18.398362094179586,244
0.2,3419,4,62908,18.394152046783624,96
0.2,3420,15,62923,18.39315989476761,86
0.2,3421,-14,62909,18.383693746347166,114
0.2,3422,39,62948,18.38971662284546,61
0.2,3423,70,63018,18.40478971962617,31
0.2,3424,60,63078,18.416934306569342,45
0.2,3425,-38,63040,18.400467016929365,140
0.2,3426,-171,62869,18.345199883279836,208
0.2,3427,53,62922,18.355309218203033,56
0.2,3428,38,62960,18.36103820355789,62
0.2,3429,95,63055,18.38338192419825,6
0.2,3430,-114,62941,18.344797435150102,147
0.2,3431,-22,62919,18.333041958041957,124
0.2,3432,87,63006,18.3530439848529,13
0.2,3433,95,63101,18.375364006988935,6
0.2,3434,87,63188,18.395342066957788,14
0.2,3435,63,63251,18.408323632130383,37
0.2,3436,6,63257,18.40471341286005,97
0.2,3437,80,63337,18.42262943571844,21
0.2,3438,20,63357,18.42308810700785,82
0.2,3439,-172,63185,18.367732558139537,218
0.2,3440,-103,63082,18.332461493751815,212
0.2,3441,81,63163,18.350668216153398,19
0.2,3442,80,63243,18.368573918094686,21
0.2,3443,-62,63181,18.345238095238095,93
0.2,3444,-49,63132,18.32568940493469,80
0.2,3445,93,63225,18.34735925710969,8
0.2,3446,39,63264,18.353350739773717,62
0.2,3447,-51,63213,18.333236658932716,154
0.2,3448,59,63272,18.345027544215714,41
0.2,3449,-205,63067,18.280289855072464,238
0.2,3450,-397,62670,18.159953636627066,365
0.2,3451,-49,62621,18.140498261877173,151
0.2,3452,5,62626,18.136692730958586,113
0.2,3453,79,62705,18.154313839027214,21
0.2,3454,88,62793,18.17452966714906,12
0.2,3455,8,62801,18.17158564814815,94
0.2,3456,56,62857,18.18252820364478,45
0.2,3457,93,62950,18.204164256795835,8
0.2,3458,44,62994,18.211621856027755,64
0.2,3459,87,63081,18.23150289017341,13
0.2,3460,18,63099,18.231436001155735,84
0.2,3461,-138,62961,18.18630849220104,170
0.2,3462,38,62999,18.192030031764364,63
0.2,3463,-205,62794,18.12759815242494,314
0.2,3464,-14,62780,18.118326118326117,123
0.2,3465,59,62839,18.13012117714945,41
0.2,3466,-59,62780,18.107874242861264,162
0.2,3467,30,62810,18.11130334486736,70
0.2,3468,-45,62765,18.093110406457193,81
0.2,3469,-23,62742,18.081268011527378,127
0.2,3470,0,62742,18.076058772687986,102
0.2,3471,90,62832,18.096774193548388,10
0.2,3472,93,62925,18.118341491505902,7
0.2,3473,73,62998,18.134139320667817,27
0.2,3474,66,63064,18.14791366906475,35
0.2,3475,90,63154,18.168584579976987,10
0.2,3476,36,63190,18.17371297095197,65
0.2,3477,36,63226,18.178838412880967,64
0.2,3478,54,63280,18.18913480885312,47
0.2,3479,72,63352,18.204597701149424,29
0.2,3480,89,63441,18.224935363401322,11
0.2,3481,-352,63089,18.118609994256175,249
0.2,3482,-225,62864,18.0488084984209,265
0.2,3483,81,62945,18.066877152698048,19
0.2,3484,-60,62885,18.04447632711621,160
0.2,3485,79,62964,18.061962134251292,21
0.2,3486,85,63049,18.081158589045025,15
0.2,3487,-232,62817,18.009461009174313,194
0.2,3488,94,62911,18.031241043278875,7
0.2,3489,86,62997,18.050716332378222,15
0.2,3490,88,63085,18.070753365797767,12
0.2,3491,8,63093,18.06786941580756,96
0.2,3492,92,63185,18.08903521328371,8
0.2,3493,-298,62887,17.998568975386377,337
0.2,3494,39,62926,18.004577968526466,63
0.2,3495,-37,62889,17.98884439359268,71
0.2,3496,56,62945,17.999714040606232,46
0.2,3497,72,63017,18.015151515151516,29
0.2,3498,78,63095,18.03229494141183,22
0.2,3499,-68,63027,18.007714285714286,171
0.2,3500,3,63030,18.003427592116537,98
0.2,3501,-54,62976,17.98286693318104,96
0.2,3502,22,62998,17.98401370254068,9
0.2,3503,12,63010,17.98230593607306,19
0.2,3504,-125,62885,17.94151212553495,159
0.2,3505,74,62959,17.95750142612664,26
0.2,3506,79,63038,17.974907328200743,21
0.2,3507,86,63124,17.99429874572406,14
0.2,3508,-348,62776,17.889997150185238,242
0.2,3509,75,62851,17.906267806267806,26
0.2,3510,66,62917,17.91996582170322,34
0.2,3511,57,62974,17.93109339407745,43
0.2,3512,56,63030,17.94192997438087,44
0.2,3513,71,63101,17.957029026750142,29
0.2,3514,58,63159,17.96842105263158,43
0.2,3515,87,63246,17.988054607508534,14
0.2,3516,51,63297,17.997441000853,50
0.2,3517,74,63371,18.01335986355884,27
0.2,3518,49,63420,18.022165387894287,54
0.2,3519,61,63481,18.034375,39
0.2,3520,-115,63366,17.996591877307583,220
0.2,3521,88,63454,18.01646791595684,13
0.2,3522,42,63496,18.02327561737156,59
0.2,3523,-19,63477,18.012769580022702,51
0.2,3524,84,63561,18.03148936170213,17
0.2,3525,-146,63415,17.984968803176404,109
0.2,3526,71,63486,18.0,30
0.2,3527,5,63491,17.996315192743765,27
0.2,3528,66,63557,18.009917823746104,35
0.2,3529,37,63594,18.015297450424928,63
0.2,3530,72,63666,18.030586236193713,28
0.2,3531,75,63741,18.046715741789356,25
0.2,3532,-61,63680,18.024341919048968,92
0.2,3533,18,63698,18.024335031126203,84
0.2,3534,72,63770,18.03960396039604,29
0.2,3535,89,63859,18.059671945701357,12
0.2,3536,94,63953,18.081142210913203,6
0.2,3537,-111,63842,18.04465799886942,211
0.2,3538,-4,63838,18.038428934727325,106
0.2,3539,92,63930,18.059322033898304,9
0.2,3540,53,63983,18.06918949449308,47
0.2,3541,70,64053,18.08385093167702,30
0.2,3542,-96,63957,18.05165114309907,198
0.2,3543,77,64034,18.068284424379232,23
0.2,3544,90,64124,18.0885754583921,11
0.2,3545,11,64135,18.086576424139874,89
0.2,3546,90,64225,18.10685085988159,10
0.2,3547,89,64314,18.126832018038332,11
0.2,3548,42,64356,18.133558748943365,59
0.2,3549,90,64446,18.153802816901408,11
0.2,3550,74,64520,18.16952970994086,26
0.2,3551,55,64575,18.17989864864865,45
0.2,3552,69,64644,18.194202082746976,31
0.2,3553,-34,64610,18.17951603826674,66
0.2,3554,-43,64567,18.162306610407875,143
0.2,3555,6,64573,18.15888638920135,95
0.2,3556,-47,64526,18.140567894292943,154
0.2,3557,59,64585,18.15205171444632,42
0.2,3558,35,64620,18.1567856139365,66
0.2,3559,32,64652,18.160674157303372,69
0.2,3560,18,64670,18.16062903678742,84
0.2,3561,71,64741,18.17546322290848,29
0.2,3562,61,64802,18.1874824586023,41
0.2,3563,20,64822,18.187991021324354,12
0.2,3564,79,64901,18.205049088359047,21
0.2,3565,88,64989,18.22462142456534,12
0.2,3566,81,65070,18.242220353238014,19
0.2,3567,-139,64931,18.198150224215247,199
0.2,3568,-34,64897,18.183524796861867,136
0.2,3569,66,64963,18.196918767507004,34
0.2,3570,92,65055,18.21758611033324,8
0.2,3571,-173,64882,18.164053751399777,206
0.2,3572,26,64908,18.16624685138539,76
0.2,3573,60,64968,18.17795187465025,41
0.2,3574,41,65009,18.184335664335663,59
0.2,3575,-101,64908,18.151006711409394,137
0.2,3576,57,64965,18.161867486720716,45
0.2,3577,35,65000,18.16657350475126,68
0.2,3578,45,65045,18.174070969544566,56
0.2,3579,74,65119,18.189664804469274,27
0.2,3580,44,65163,18.196872382016196,57
0.2,3581,9,65172,18.19430485762144,93
0.2,3582,51,65223,18.20346078704996,49
0.2,3583,77,65300,18.219866071428573,24
0.2,3584,85,65385,18.238493723849373,16
0.2,3585,70,65455,18.25292805354155,30
0.2,3586,95,65550,18.274323947588513,6
0.2,3587,83,65633,18.29236343366778,18
0.2,3588,3,65636,18.288102535525216,97
0.2,3589,89,65725,18.307799442896936,12
0.2,3590,88,65813,18.327206906154274,13
0.2,3591,87,65900,18.34632516703786,13
0.2,3592,19,65919,18.346507097133316,81
0.2,3593,84,66003,18.364774624373958,17
0.2,3594,5,66008,18.36105702364395,95
0.2,3595,21,66029,18.36179087875417,80
0.2,3596,80,66109,18.37892688351404,20
0.2,3597,30,66139,18.382156753752085,70
0.2,3598,23,66162,18.383439844401224,79
0.2,3599,52,66214,18.392777777777777,49
0.2,3600,61,66275,18.40460983060261,39
0.2,3601,-70,66205,18.380066629650194,102
0.2,3602,92,66297,18.400499583680265,8
0.2,3603,-14,66283,18.391509433962263,47
0.2,3604,48,66331,18.399722607489597,55
0.2,3605,61,66392,18.411536328341654,41
0.2,3606,-64,66328,18.388688660937067,200
0.2,3607,85,66413,18.407150776053214,15
0.2,3608,-39,66374,18.391244111942367,72
0.2,3609,45,66419,18.398614958448753,56
0.2,3610,15,66434,18.39767377457768,87
0.2,3611,26,66460,18.399778516057587,74
0.2,3612,-25,66435,18.38776639911431,126
0.2,3613,65,66500,18.40066408411732,36
0.2,3614,70,66570,18.414937759336098,30
0.2,3615,80,66650,18.43196902654867,21
0.2,3616,89,66739,18.451479126347802,11
0.2,3617,84,66823,18.469596462133776,16
0.2,3618,11,66834,18.467532467532468,91
0.2,3619,78,66912,18.483977900552485,22
0.2,3620,42,66954,18.490472245236123,59
0.2,3621,-18,66936,18.480397570403092,120
0.2,3622,40,66976,18.486337289539055,61
0.2,3623,29,67005,18.489238410596027,73
0.2,3624,9,67014,18.486620689655172,92
0.2,3625,51,67065,18.495587424158852,49
0.2,3626,68,67133,18.509236283429832,32
0.2,3627,-96,67037,18.477673649393605,148
0.2,3628,64,67101,18.49021769082392,36
0.2,3629,31,67132,18.49366391184573,79
0.2,3630,-128,67004,18.453318645001378,231
0.2,3631,87,67091,18.472191629955947,13
0.2,3632,12,67103,18.470410129369668,88
0.2,3633,-53,67050,18.45074298293891,202
0.2,3634,81,67131,18.467950481430538,20
0.2,3635,-35,67096,18.453245324532453,66
0.2,3636,63,67159,18.46549353863074,37
0.2,3637,63,67222,18.47773501924134,37
0.2,3638,36,67258,18.482550151140423,67
0.2,3639,34,67292,18.486813186813187,66
0.2,3640,88,67380,18.50590497116177,12
0.2,3641,92,67472,18.526084568918176,9
0.2,3642,-199,67273,18.466373867691463,309
0.2,3643,70,67343,18.480515916575193,39
0.2,3644,12,67355,18.478737997256516,88
0.2,3645,-60,67295,18.45721338453099,93
0.2,3646,-88,67207,18.428023032629557,191
0.2,3647,89,67296,18.44736842105263,12
0.2,3648,32,67328,18.451082488352974,68
0.2,3649,81,67409,18.46821917808219,19
0.2,3650,2,67411,18.4637085729937,33
0.2,3651,29,67440,18.46659364731654,71
0.2,3652,95,67535,18.487544483985765,6
0.2,3653,-190,67345,18.43048713738369,155
0.2,3654,44,67389,18.4374829001368,56
0.2,3655,8,67397,18.434628008752735,94
0.2,3656,86,67483,18.453103636860813,15
0.2,3657,66,67549,18.466101694915253,34
0.2,3658,-44,67505,18.44902978955999,146
0.2,3659,85,67590,18.4672131147541,15
0.2,3660,55,67645,18.477192024037148,45
0.2,3661,23,67668,18.478427089022393,77
0.2,3662,42,67710,18.484848484848484,58
0.2,3663,82,67792,18.502183406113538,18
0.2,3664,-144,67648,18.457844474761256,177
0.2,3665,-152,67496,18.411347517730498,265
0.2,3666,-167,67329,18.360785383146986,198
0.2,3667,30,67359,18.363958560523447,70
0.2,3668,50,67409,18.372581084764242,50
0.2,3669,-1,67408,18.367302452316075,103
0.2,3670,78,67486,18.383546717515664,23
0.2,3671,49,67535,18.391884531590414,52
0.2,3672,86,67621,18.410291315001363,14
0.2,3673,75,67696,18.42569406641263,25
0.2,3674,79,67775,18.4421768707483,22
0.2,3675,-5,67770,18.435799782372143,105
0.2,3676,-13,67757,18.427250475931466,115
0.2,3677,-204,67553,18.366775421424688,306
0.2,3678,54,67607,18.376460994835554,47
0.2,3679,-48,67559,18.358423913043477,150
0.2,3680,-46,67513,18.340939961966857,149
0.2,3681,-189,67324,18.28462791960891,222
0.2,3682,72,67396,18.299212598425196,60
0.2,3683,21,67417,18.299945711183497,11
0.2,3684,52,67469,18.30909090909091,48
0.2,3685,93,67562,18.3293543136191,7
0.2,3686,75,67637,18.34472470843504,27
0.2,3687,75,67712,18.36008676789588,25
0.2,3688,92,67804,18.380048793711033,8
0.2,3689,-22,67782,18.36910569105691,53
0.2,3690,28,67810,18.371714982389598,72
0.2,3691,-49,67761,18.35346695557963,82
0.2,3692,20,67781,18.353912808015163,81
0.2,3693,83,67864,18.3714131023281,17
0.2,3694,85,67949,18.389445196211096,15
0.2,3695,42,67991,18.395833333333332,62
0.2,3696,94,68085,18.416283473086285,7
0.2,3697,-191,67894,18.35965386695511,224
0.2,3698,69,67963,18.373344147066774,32
0.2,3699,-57,67906,18.352972972972974,186
0.2,3700,75,67981,18.368278843555796,26
0.2,3701,21,68002,18.368989735278227,79
0.2,3702,93,68095,18.389143937348095,8
0.2,3703,73,68168,18.40388768898488,27
0.2,3704,59,68227,18.414844804318488,48
0.2,3705,-27,68200,18.402590393955748,128
0.2,3706,62,68262,18.414351227407607,38
0.2,3707,17,68279,18.413969795037755,84
0.2,3708,37,68316,18.418980857373956,64
0.2,3709,71,68387,18.433153638814016,29
0.2,3710,94,68481,18.453516572352466,6
0.2,3711,23,68504,18.454741379310345,78
0.2,3712,-267,68237,18.37786156746566,319
0.2,3713,92,68329,18.397684437264406,9
0.2,3714,72,68401,18.412113055181695,29
0.2,3715,12,68413,18.41038751345533,94
0.2,3716,77,68490,18.426150121065376,23
0.2,3717,-11,68479,18.418235610543302,121
0.2,3718,77,68556,18.433987631083625,24
0.2,3719,15,68571,18.433064516129033,85
0.2,3720,-287,68284,18.350980919107766,325
0.2,3721,-383,67901,18.243148844707147,420
0.2,3722,80,67981,18.259736771420897,21
0.2,3723,32,68013,18.26342642320086,69
0.2,3724,72,68085,18.27785234899329,28
0.2,3725,32,68117,18.281535158346752,68
0.2,3726,56,68173,18.29165548698685,45
0.2,3727,-35,68138,18.27736051502146,140
0.2,3728,-6,68132,18.270850093858943,106
0.2,3729,15,68147,18.269973190348527,85
0.2,3730,-125,68022,18.231573304744035,162
0.2,3731,52,68074,18.240621650589496,52
0.2,3732,-98,67976,18.20948298955264,198
0.2,3733,-6,67970,18.20299946438136,38
0.2,3734,88,68058,18.221686746987952,12
0.2,3735,-165,67893,18.17264453961456,278
0.2,3736,-83,67810,18.145571313888144,47
0.2,3737,56,67866,18.15569823434992,46
0.2,3738,5,67871,18.152179727199787,27
0.2,3739,63,67934,18.164171122994652,37
0.2,3740,-34,67900,18.15022721197541,67
0.2,3741,-95,67805,18.119989310529128,127
0.2,3742,93,67898,18.139994656692494,8
0.2,3743,68,67966,18.153311965811966,33
0.2,3744,-54,67912,18.13404539385848,155
0.2,3745,29,67941,18.1369460758142,71
0.2,3746,70,68011,18.15078729650387,31
0.2,3747,-9,68002,18.143543223052294,40
0.2,3748,61,68063,18.15497465990931,39
0.2,3749,54,68117,18.164533333333335,48
0.2,3750,-27,68090,18.1524926686217,58
0.2,3751,90,68180,18.171641791044777,11
0.2,3752,92,68272,18.191313615774046,8
0.2,3753,21,68293,18.192061800745872,11
0.2,3754,-43,68250,18.175765645805594,76
0.2,3755,5,68255,18.172257720979765,100
0.2,3756,-116,68139,18.13654511578387,217
0.2,3757,47,68186,18.144225651942524,54
0.2,3758,34,68220,18.148443735035915,69
0.2,3759,91,68311,18.16781914893617,9
0.2,3760,-35,68276,18.153682531241692,69
0.2,3761,58,68334,18.16427432216906,42
0.2,3762,25,68359,18.166090884932235,75
0.2,3763,-45,68314,18.14930924548353,147
0.2,3764,94,68408,18.16945551128818,7
0.2,3765,-223,68185,18.10541688794477,266
0.2,3766,46,68231,18.11282187417043,55
0.2,3767,70,68301,18.126592356687897,30
0.2,3768,71,68372,18.14062085433802,29
0.2,3769,14,68386,18.139522546419098,88
0.2,3770,11,68397,18.137629276054096,92
0.2,3771,86,68483,18.15562036055143,14
0.2,3772,57,68540,18.165915716936127,43
0.2,3773,72,68612,18.18018018018018,29
0.2,3774,70,68682,18.193907284768212,30
0.2,3775,-50,68632,18.175847457627118,86
0.2,3776,45,68677,18.182949430765156,56
0.2,3777,94,68771,18.203017469560614,7
0.2,3778,-78,68693,18.177560201111405,180
0.2,3779,34,68727,18.18174603174603,66
0.2,3780,4,68731,18.17799523935467,97
0.2,3781,82,68813,18.194870438921207,18
0.2,3782,-16,68797,18.185831350779804,50
0.2,3783,-15,68782,18.177061310782243,117
0.2,3784,70,68852,18.190752972258917,30
0.2,3785,89,68941,18.2094558901215,12
0.2,3786,68,69009,18.222603644045417,32
0.2,3787,94,69103,18.24260823653643,6
0.2,3788,11,69114,18.240696753760886,90
0.2,3789,86,69200,18.258575197889183,14
0.2,3790,-40,69160,18.24320759694012,71
0.2,3791,19,69179,18.24340717299578,84
0.2,3792,91,69270,18.262588979699448,9
0.2,3793,4,69274,18.258829731154453,96
0.2,3794,-15,69259,18.25006587615283,115
0.2,3795,85,69344,18.267650158061116,16
0.2,3796,15,69359,18.266789570713723,16
0.2,3797,86,69445,18.284623486045287,15
0.2,3798,86,69531,18.302448012634905,15
0.2,3799,90,69621,18.321315789473683,11
0.2,3800,72,69693,18.335438042620364,29
0.2,3801,-4,69689,18.32956338769069,105
0.2,3802,48,69737,18.337365237970022,52
0.2,3803,81,69818,18.35383806519453,19
0.2,3804,25,69843,18.355584756898818,78
0.2,3805,-48,69795,18.338150289017342,82
0.2,3806,-128,69667,18.299711058576307,230
0.2,3807,73,69740,18.314075630252102,28
0.2,3808,-49,69691,18.296403255447625,82
0.2,3809,95,69786,18.316535433070865,6
0.2,3810,58,69844,18.32694830753083,44
0.2,3811,59,69903,18.337618048268624,41
0.2,3812,47,69950,18.345135064253867,54
0.2,3813,72,70022,18.359202936549554,29
0.2,3814,92,70114,18.37850589777195,8
0.2,3815,-72,70042,18.35482180293501,106
0.2,3816,41,70083,18.36075451925596,60
0.2,3817,83,70166,18.37768465165008,18
0.2,3818,39,70205,18.383084577114428,61
0.2,3819,50,70255,18.391361256544503,50
0.2,3820,-2,70253,18.38602460088982,116
0.2,3821,-82,70171,18.359759288330718,114
0.2,3822,-54,70117,18.340831807481035,88
0.2,3823,77,70194,18.356171548117153,24
0.2,3824,74,70268,18.370718954248368,27
0.2,3825,83,70351,18.38761108207005,17
0.2,3826,45,70396,18.394564933368173,55
0.2,3827,69,70465,18.40778474399164,32
0.2,3828,-55,70410,18.388613214938626,158
0.2,3829,58,70468,18.398955613577023,42
0.2,3830,91,70559,18.41790655181415,10
0.2,3831,21,70580,18.41858037578288,79
0.2,3832,80,70660,18.434646490999217,21
0.2,3833,92,70752,18.453834115805947,9
0.2,3834,6,70758,18.45058670143416,96
0.2,3835,-30,70728,18.437956204379564,62
0.2,3836,64,70792,18.449830596820433,37
0.2,3837,90,70882,18.468473163105784,11
0.2,3838,87,70969,18.48632456368846,13
0.2,3839,71,71040,18.5,29
0.2,3840,66,71106,18.512366571205416,35
0.2,3841,-11,71095,18.504685059864652,112
0.2,3842,26,71121,18.506635441061672,75
0.2,3843,16,71137,18.505983350676377,85
0.2,3844,70,71207,18.519375812743824,32
0.2,3845,-72,71135,18.495839833593344,177
0.2,3846,-29,71106,18.483493631401092,130
0.2,3847,-261,70845,18.410862785862786,296
0.2,3848,-5,70840,18.404780462457783,37
0.2,3849,54,70894,18.414025974025975,49
0.2,3850,-125,70769,18.376785250584263,229
0.2,3851,53,70822,18.38577362409138,48
0.2,3852,29,70851,18.388528419413444,71
0.2,3853,95,70946,18.408406850025948,6
0.2,3854,94,71040,18.428015564202333,7
0.2,3855,-35,71005,18.414159751037346,67
0.2,3856,83,71088,18.430904848327717,18
0.2,3857,61,71149,18.441938828408503,39
0.2,3858,44,71193,18.448561803576055,56
0.2,3859,88,71281,18.46658031088083,12
0.2,3860,25,71306,18.468272468272467,76
0.2,3861,43,71349,18.47462454686691,58
0.2,3862,89,71438,18.492881180429716,12
0.2,3863,-49,71389,18.475414078674948,81
0.2,3864,58,71447,18.485640362225098,43
0.2,3865,52,71499,18.494309363683392,50
0.2,3866,31,71530,18.497543315231447,70
0.2,3867,75,71605,18.512150982419854,26
0.2,3868,-26,71579,18.500646161798915,58
0.2,3869,48,71627,18.50826873385013,53
0.2,3870,52,71679,18.516920692327563,49
0.2,3871,-40,71639,18.50180785123967,73
0.2,3872,85,71724,18.518977536793184,16
0.2,3873,-50,71674,18.501290655653072,154
0.2,3874,-1,71673,18.49625806451613,33
0.2,3875,-67,71606,18.47420020639835,100
0.2,3876,93,71699,18.49342274954862,7
0.2,3877,10,71709,18.49123259412068,90
0.2,3878,84,71793,18.50812064965197,17
0.2,3879,-14,71779,18.49974226804124,124
0.2,3880,73,71852,18.513785106931202,28
0.2,3881,90,71942,18.53219989696033,10
0.2,3882,20,71962,18.532577903682718,80
0.2,3883,-143,71819,18.49098867147271,246
0.2,3884,18,71837,18.490862290862292,82
0.2,3885,49,71886,18.498713329902213,52
0.2,3886,35,71921,18.502958579881657,67
0.2,3887,11,71932,18.50102880658436,22
0.2,3888,-6,71926,18.494728722036513,111
0.2,3889,-106,71820,18.46272493573265,208
0.2,3890,-349,71471,18.36828578771524,383
0.2,3891,57,71528,18.378211716341212,43
0.2,3892,-51,71477,18.360390444387363,152
0.2,3893,-169,71308,18.312275295326142,132
0.2,3894,81,71389,18.32836970474968,20
0.2,3895,89,71478,18.346509240246405,12
0.2,3896,87,71565,18.36412625096228,14
0.2,3897,62,71627,18.375320677270395,58
0.2,3898,10,71637,18.37317260836112,21
0.2,3899,89,71726,18.39128205128205,11
0.2,3900,42,71768,18.397334016918737,60
0.2,3901,64,71832,18.409021014864173,38
0.2,3902,61,71893,18.419933384575966,40
0.2,3903,-112,71781,18.38652663934426,146
0.2,3904,38,71819,18.39154929577465,65
0.2,3905,27,71846,18.393753200204813,73
0.2,3906,-26,71820,18.382390581008448,58
0.2,3907,-25,71795,18.37128966223132,128
0.2,3908,-7,71788,18.364799181376313,108
0.2,3909,45,71833,18.37161125319693,56
0.2,3910,86,71919,18.388903093837893,15
0.2,3911,69,71988,18.401840490797547,31
0.2,3912,-72,71916,18.37873754152824,104
0.2,3913,-16,71900,18.369954011241695,47
0.2,3914,59,71959,18.380332056194124,42
0.2,3915,-54,71905,18.361848825331972,155
0.2,3916,-28,71877,18.350012764871074,132
0.2,3917,24,71901,18.35145482388974,78
0.2,3918,86,71987,18.3687165093136,15
0.2,3919,84,72071,18.38545918367347,16
0.2,3920,-20,72051,18.37566947207345,120
0.2,3921,31,72082,18.37888832228455,69
0.2,3922,90,72172,18.39714504205965,11
0.2,3923,53,72225,18.405963302752294,50
0.2,3924,92,72317,18.424713375796177,8
0.2,3925,64,72381,18.436321956189506,36
0.2,3926,2,72383,18.43213649096002,98
0.2,3927,81,72464,18.44806517311609,20
0.2,3928,93,72557,18.46703995927717,7
0.2,3929,64,72621,18.478625954198474,36
0.2,3930,74,72695,18.49274993640295,28
0.2,3931,20,72715,18.493133265513734,11
0.2,3932,-54,72661,18.474701245868292,86
0.2,3933,66,72727,18.486781901372648,35
0.2,3934,30,72757,18.489707750952984,71
0.2,3935,-86,72671,18.463160569105693,120
0.2,3936,-448,72223,18.34467868935738,417
0.2,3937,-111,72112,18.31183341797867,143
0.2,3938,94,72206,18.33104848946433,7
0.2,3939,0,72206,18.326395939086293,103
0.2,3940,-137,72069,18.286982999238774,254
0.2,3941,55,72124,18.296296296296298,45
0.2,3942,38,72162,18.30129343139741,62
0.2,3943,-25,72137,18.29031440162272,126
0.2,3944,65,72202,18.302154626108997,36
0.2,3945,-138,72064,18.262544348707554,251
0.2,3946,-180,71884,18.21231314922726,214
0.2,3947,45,71929,18.219098277608914,55
0.2,3948,24,71953,18.220562167637375,78
0.2,3949,93,72046,18.239493670886077,7
0.2,3950,0,72046,18.23487724626677,101
0.2,3951,45,72091,18.24164979757085,55
0.2,3952,30,72121,18.244624335947382,71
0.2,3953,-203,71918,18.18866970156803,238
0.2,3954,34,71952,18.19266750948167,69
0.2,3955,80,72032,18.208291203235593,23
0.2,3956,24,72056,18.20975486479656,77
0.2,3957,-73,71983,18.186710459828195,104
0.2,3958,83,72066,18.203081586259156,17
0.2,3959,-150,71916,18.16060606060606,252
0.2,3960,5,71921,18.157283514264076,95
0.2,3961,2,71923,18.153205451792026,30
0.2,3962,-331,71592,18.065102195306586,373
0.2,3963,93,71685,18.084006054490413,7
0.2,3964,81,71766,18.09987389659521,19
0.2,3965,-8,71758,18.093292990418558,108
0.2,3966,94,71852,18.112427527098564,6
0.2,3967,88,71940,18.130040322580644,13
0.2,3968,86,72026,18.147140337616527,14
0.2,3969,37,72063,18.15188916876574,65
0.2,3970,-240,71823,18.086879879123646,273
0.2,3971,58,71881,18.096928499496475,42
0.2,3972,-17,71864,18.08809463881198,123
0.2,3973,39,71903,18.093356819325617,63
0.2,3974,78,71981,18.108427672955976,22
0.2,3975,93,72074,18.127263581488933,7
0.2,3976,88,72162,18.14483278853407,18
0.2,3977,-123,72039,18.109351432880846,156
0.2,3978,85,72124,18.126162352349837,15
0.2,3979,59,72183,18.13643216080402,42
0.2,3980,93,72276,18.15523737754333,8
0.2,3981,12,72288,18.153691612255148,20
0.2,3982,-218,72070,18.094401205121766,252
0.2,3983,-14,72056,18.086345381526105,122
0.2,3984,64,72120,18.097867001254706,37
0.2,3985,44,72164,18.10436527847466,56
0.2,3986,95,72259,18.12365186857286,6
0.2,3987,67,72326,18.13590772316951,34
0.2,3988,2,72328,18.13186262221108,100
0.2,3989,86,72414,18.14887218045113,15
0.2,3990,89,72503,18.166624906038585,11
0.2,3991,74,72577,18.180611222444888,26
0.2,3992,83,72660,18.196844477836212,18
0.2,3993,-205,72455,18.140961442163245,240
0.2,3994,78,72533,18.155944931163955,24
0.2,3995,87,72620,18.173173173173172,13
0.2,3996,43,72663,18.179384538403802,57
0.2,3997,-84,72579,18.15382691345673,115
0.2,3998,79,72658,18.169042260565142,21
0.2,3999,51,72709,18.17725,49
0.2,4000,70,72779,18.19020244938765,30
0.2,4001,27,72806,18.19240379810095,73
0.2,4002,7,72813,18.189607794154384,95
0.2,4003,2,72815,18.185564435564437,30
0.2,4004,58,72873,18.195505617977528,42
0.2,4005,82,72955,18.211432850723913,18
0.2,4006,87,73042,18.228599950087347,13
0.2,4007,-22,73020,18.218562874251496,123
0.2,4008,82,73102,18.234472437016713,19
0.2,4009,-141,72961,18.194763092269326,244
0.2,4010,13,72974,18.193467963101472,89
0.2,4011,17,72991,18.193170488534395,83
0.2,4012,-93,72898,18.16546224769499,126
0.2,4013,89,72987,18.183109118086698,11
0.2,4014,-39,72948,18.168866749688668,142
0.2,4015,4,72952,18.165338645418327,98
0.2,4016,60,73012,18.17575304953946,40
0.2,4017,-49,72963,18.159034345445495,153
0.2,4018,92,73055,18.17740731525255,8
0.2,4019,-42,73013,18.162437810945274,144
0.2,4020,26,73039,18.164386968415815,75
0.2,4021,38,73077,18.169318746892092,62
0.2,4022,-21,73056,18.159582401193138,124
0.2,4023,55,73111,18.168737574552683,61
0.2,4024,39,73150,18.17391304347826,64
0.2,4025,78,73228,18.18877297565822,23
0.2,4026,-97,73131,18.160168860193693,129
0.2,4027,-194,72937,18.107497517378352,231
0.2,4028,95,73032,18.126582278481013,6
0.2,4029,44,73076,18.13300248138958,57
0.2,4030,-6,73070,18.127015628876208,110
0.2,4031,87,73157,18.14409722222222,14
0.2,4032,80,73237,18.15943466402182,20
0.2,4033,-113,73124,18.126921170054537,216
0.2,4034,79,73203,18.142007434944237,21
0.2,4035,67,73270,18.154112983151634,33
0.2,4036,93,73363,18.1726529601189,7
0.2,4037,57,73420,18.182268449727587,43
0.2,4038,-4,73416,18.176776429809358,105
0.2,4039,45,73461,18.183415841584157,58
0.2,4040,87,73548,18.20044543429844,13
0.2,4041,40,73588,18.205838693715982,62
0.2,4042,-102,73486,18.17610685134801,208
0.2,4043,-22,73464,18.166172106824927,124
0.2,4044,-45,73419,18.150556242274412,146
0.2,4045,47,73466,18.157686604053385,54
0.2,4046,-24,73442,18.14726958240672,55
0.2,4047,92,73534,18.165513833992094,8
0.2,4048,-22,73512,18.155593973820697,122
0.2,4049,-17,73495,18.146913580246913,117
0.2,4050,-12,73483,18.13947173537398,43
0.2,4051,58,73541,18.149308983218162,42
0.2,4052,78,73619,18.164075993091537,22
0.2,4053,60,73679,18.17439565860878,41
0.2,4054,12,73691,18.172872996300864,89
0.2,4055,94,73785,18.191568047337277,6
0.2,4056,54,73839,18.200394380083807,47
0.2,4057,45,73884,18.206998521439132,55
0.2,4058,61,73945,18.217541266321753,40
0.2,4059,-10,73935,18.210591133004925,115
0.2,4060,87,74022,18.227530164983992,14
0.2,4061,76,74098,18.241752831117676,24
0.2,4062,43,74141,18.247846418902288,57
0.2,4063,29,74170,18.250492125984252,72
0.2,4064,-43,74127,18.23542435424354,75
0.2,4065,-12,74115,18.22798819478603,117
0.2,4066,-116,73999,18.194984017703465,149
0.2,4067,47,74046,18.20206489675516,53
0.2,4068,90,74136,18.219710002457607,11
0.2,4069,-12,74124,18.21228501228501,45
0.2,4070,65,74189,18.223777941537705,36
0.2,4071,-32,74157,18.211444007858546,64
0.2,4072,10,74167,18.2094279400933,93
0.2,4073,48,74215,18.21674030436917,55
0.2,4074,90,74305,18.23435582822086,11
0.2,4075,84,74389,18.250490677134447,16
0.2,4076,26,74415,18.252391464311994,75
0.2,4077,83,74498,18.268268759195685,18
0.2,4078,93,74591,18.28658985045354,8
0.2,4079,64,74655,18.297794117647058,37
0.2,4080,-167,74488,18.252389120313648,199
0.2,4081,-191,74297,18.201126898579126,319
0.2,4082,41,74338,18.206710751898115,60
0.2,4083,-65,74273,18.186336924583742,97
0.2,4084,89,74362,18.203671970624235,11
0.2,4085,89,74451,18.22099853157122,11
0.2,4086,-25,74426,18.21042329336922,127
0.2,4087,-181,74245,18.161692759295498,228
0.2,4088,38,74283,18.166544387380778,62
0.2,4089,19,74302,18.16674816625917,89
0.2,4090,25,74327,18.16841847958934,76
0.2,4091,-98,74229,18.140029325513197,202
0.2,4092,61,74290,18.150500855118494,40
0.2,4093,77,74367,18.164875427454813,24
0.2,4094,79,74446,18.17973137973138,22
0.2,4095,-71,74375,18.157958984375,103
0.2,4096,75,74450,18.171833048572125,27
0.2,4097,63,74513,18.182772083943387,38
0.2,4098,2,74515,18.17882410343986,100
0.2,4099,32,74547,18.18219512195122,70
0.2,4100,-55,74492,18.16435015849793,159
0.2,4101,-16,74476,18.15602145294978,117
0.2,4102,-3,74473,18.150865220570314,35
0.2,4103,54,74527,18.15960038986355,47
0.2,4104,58,74585,18.169305724725945,53
0.2,4105,-51,74534,18.15245981490502,82
0.2,4106,94,74628,18.1709276844412,6
0.2,4107,74,74702,18.184518013631937,27
0.2,4108,68,74770,18.196641518617668,33
0.2,4109,-65,74705,18.176399026763992,168
0.2,4110,83,74788,18.19216735587448,17
0.2,4111,81,74869,18.207441634241246,19
0.2,4112,-1,74868,18.202771699489425,102
0.2,4113,29,74897,18.205396208070006,73
0.2,4114,89,74986,18.222600243013364,12
0.2,4115,86,75072,18.239067055393587,15
0.2,4116,-151,74921,18.197959679378187,253
0.2,4117,9,74930,18.19572608062166,95
0.2,4118,59,74989,18.20563243505705,41
0.2,4119,14,75003,18.204611650485436,87
0.2,4120,70,75073,18.21718029604465,30
0.2,4121,58,75131,18.22683163512858,43
0.2,4122,29,75160,18.22944457918991,79
0.2,4123,89,75249,18.246605237633364,11
0.2,4124,-51,75198,18.22981818181818,84
0.2,4125,-6,75192,18.223945710130877,110
0.2,4126,78,75270,18.238429852192876,22
0.2,4127,83,75353,18.254118217054263,17
0.2,4128,75,75428,18.267861467667718,26
0.2,4129,-68,75360,18.246973365617432,170
0.2,4130,48,75408,18.25417574437182,52
0.2,4131,-56,75352,18.23620522749274,91
0.2,4132,32,75384,18.23953544640697,68
0.2,4133,-17,75367,18.231011127237544,120
0.2,4134,-39,75328,18.217170495767835,72
0.2,4135,-65,75263,18.197050290135397,168
0.2,4136,32,75295,18.200386753686246,69
0.2,4137,-16,75279,18.192121797970035,47
0.2,4138,-40,75239,18.178062333897078,143
0.2,4139,62,75301,18.188647342995168,38
0.2,4140,70,75371,18.201159140304274,30
0.2,4141,88,75459,18.218010622887494,12
0.2,4142,92,75551,18.23581945450157,8
0.2,4143,77,75628,18.25,24
0.2,4144,-41,75587,18.235705669481302,73
0.2,4145,54,75641,18.24433188615533,46
0.2,4146,1,75642,18.240173619483965,122
0.2,4147,-47,75595,18.22444551591128,147
0.2,4148,-5,75590,18.21884791516028,37
0.2,4149,-72,75518,18.19710843373494,172
0.2,4150,64,75582,18.20814261623705,36
0.2,4151,90,75672,18.22543352601156,10
0.2,4152,25,75697,18.227064772453648,96
0.2,4153,82,75779,18.24241694752046,19
0.2,4154,-95,75684,18.215162454873646,242
0.2,4155,35,75719,18.21920115495669,66
0.2,4156,-69,75650,18.19821987009863,198
0.2,4157,90,75740,18.215488215488215,10
0.2,4158,87,75827,18.232026929550372,13
0.2,4159,66,75893,18.243509615384614,34
0.2,4160,-151,75742,18.2028358567652,186
0.2,4161,74,75816,18.216242191254203,26
0.2,4162,-130,75686,18.180638962286814,165
0.2,4163,93,75779,18.19860710854947,8
0.2,4164,46,75825,18.205282112845136,55
0.2,4165,-75,75750,18.182909265482476,108
0.2,4166,37,75787,18.18742500599952,63
0.2,4167,-112,75675,18.156190019193858,75
0.2,4168,79,75754,18.170784360757974,22
0.2,4169,40,75794,18.17601918465228,60
0.2,4170,-211,75583,18.12107408295373,105
0.2,4171,78,75661,18.13542665388303,22
0.2,4172,81,75742,18.15049125329499,19
0.2,4173,81,75823,18.16554863440345,20
0.2,4174,78,75901,18.17988023952096,22
0.2,4175,32,75933,18.183189655172413,70
0.2,4176,90,76023,18.20038305003591,10
0.2,4177,79,76102,18.214935375777884,21
0.2,4178,-8,76094,18.208662359416127,41
0.2,4179,-119,75975,18.175837320574164,153
0.2,4180,23,75998,18.17699115044248,79
0.2,4181,90,76088,18.194165471066476,10
0.2,4182,72,76160,18.20702844848195,29
0.2,4183,89,76249,18.223948374760994,12
0.2,4184,91,76340,18.241338112305854,10
0.2,4185,92,76432,18.258958432871477,8
0.2,4186,71,76503,18.27155481251493,29
0.2,4187,75,76578,18.285100286532952,25
0.2,4188,93,76671,18.302936261637623,7
0.2,4189,29,76700,18.305489260143197,71
0.2,4190,-25,76675,18.29515628728227,126
0.2,4191,95,76770,18.313454198473284,6
0.2,4192,39,76809,18.31838778917243,62
0.2,4193,-29,76780,18.307105388650452,61
0.2,4194,-91,76689,18.281048867699642,124
0.2,4195,-18,76671,18.272402287893232,118
0.2,4196,-124,76547,18.23850369311413,155
0.2,4197,-82,76465,18.21462601238685,183
0.2,4198,80,76545,18.2293403191236,21
0.2,4199,76,76621,18.24309523809524,24
0.2,4200,35,76656,18.247084027612473,67
0.2,4201,70,76726,18.259400285578295,31
0.2,4202,-24,76702,18.24934570544849,55
0.2,4203,84,76786,18.264985727878212,17
0.2,4204,-11,76775,18.258026159334126,43
0.2,4205,-15,76760,18.25011887779363,119
0.2,4206,-33,76727,18.237936772046588,136
0.2,4207,19,76746,18.238117870722434,82
0.2,4208,53,76799,18.246376811594203,49
0.2,4209,-102,76697,18.217814726840857,205
0.2,4210,54,76751,18.22631203989551,47
0.2,4211,78,76829,18.240503323836656,22
0.2,4212,34,76863,18.244244006646095,82
0.2,4213,91,76954,18.261509254864738,9
0.2,4214,-59,76895,18.24317912218268,180
0.2,4215,93,76988,18.26091081593928,7
0.2,4216,-58,76930,18.242826654019446,91
0.2,4217,64,76994,18.253674727358938,36
0.2,4218,65,77059,18.264754681204078,35
0.2,4219,-262,76797,18.198341232227488,229
0.2,4220,8,76805,18.195925136223643,105
0.2,4221,-25,76780,18.185693983893888,127
0.2,4222,54,76834,18.194174757281555,47
0.2,4223,91,76925,18.211410984848484,9
0.2,4224,80,77005,18.22603550295858,21
0.2,4225,1,77006,18.221959299574067,100
0.2,4226,-229,76777,18.163472912230898,269
0.2,4227,-25,76752,18.153263954588457,57
0.2,4228,94,76846,18.1711988649799,6
0.2,4229,92,76938,18.188652482269504,9
0.2,4230,-22,76916,18.179153864334673,122
0.2,4231,-40,76876,18.16540642722117,73
0.2,4232,26,76902,18.167257264351523,75
0.2,4233,21,76923,18.167926310817194,79
0.2,4234,11,76934,18.166233766233766,20
0.2,4235,10,76944,18.164305949008497,93
0.2,4236,93,77037,18.181968373849422,8
0.2,4237,-199,76838,18.1307220386975,236
0.2,4238,56,76894,18.139655579146027,45
0.2,4239,93,76987,18.157311320754715,7
0.2,4240,62,77049,18.167649139353927,38
0.2,4241,93,77142,18.185289957567186,7
0.2,4242,-78,77064,18.162620787178884,112
0.2,4243,32,77096,18.165881244109332,68
0.2,4244,88,77184,18.18233215547703,13
0.2,4245,50,77234,18.189825718323128,50
0.2,4246,-26,77208,18.17942076760066,128
0.2,4247,-468,76740,18.06497175141243,506
0.2,4248,83,76823,18.08025417745352,18
0.2,4249,-24,76799,18.07035294117647,56
0.2,4250,-14,76785,18.062808750882144,115
0.2,4251,81,76866,18.077610536218252,19
0.2,4252,8,76874,18.07524100634846,96
0.2,4253,-5,76869,18.069816643159378,37
0.2,4254,6,76875,18.066980023501763,95
0.2,4255,21,76896,18.06766917293233,96
0.2,4256,85,76981,18.083392060136248,15
0.2,4257,37,77018,18.08783466416158,64
0.2,4258,-57,76961,18.07020427330359,172
0.2,4259,-229,76732,18.01220657276995,272
0.2,4260,82,76814,18.02722365641868,19
0.2,4261,58,76872,18.036602534021586,43
0.2,4262,6,76878,18.03377902885292,25
0.2,4263,81,76959,18.048545966228893,20
0.2,4264,62,77021,18.058851113716294,38
0.2,4265,54,77075,18.06727613689639,47
0.2,4266,29,77104,18.06983829388329,72
0.2,4267,29,77133,18.0723992502343,77
0.2,4268,90,77223,18.089248067463107,12
0.2,4269,14,77237,18.088290398126464,86
0.2,4270,-109,77128,18.058534301100444,160
0.2,4271,-67,77061,18.03862359550562,99
0.2,4272,84,77145,18.05406037912474,16
0.2,4273,87,77232,18.0701918577445,14
0.2,4274,94,77326,18.08795321637427,6
0.2,4275,28,77354,18.090271281571564,72
0.2,4276,-25,77329,18.080196399345336,126
0.2,4277,41,77370,18.08555399719495,60
0.2,4278,-121,77249,18.05304977798551,155
0.2,4279,53,77302,18.06121495327103,48
0.2,4280,32,77334,18.06447091800981,71
0.2,4281,94,77428,18.082204577300327,7
0.2,4282,-33,77395,18.07027784263367,65
0.2,4283,35,77430,18.074229691876752,66
0.2,4284,74,77504,18.08728121353559,26
0.2,4285,9,77513,18.085160989267383,93
0.2,4286,-39,77474,18.071845113132728,141
0.2,4287,35,77509,18.07579291044776,68
0.2,4288,-125,77384,18.04243413383073,89
0.2,4289,59,77443,18.05198135198135,42
0.2,4290,89,77532,18.06851549755302,12
0.2,4291,88,77620,18.084808946877914,13
0.2,4292,54,77674,18.09317493594223,46
0.2,4293,-252,77422,18.03027480204937,287
0.2,4294,56,77478,18.039115250291037,44
0.2,4295,37,77515,18.04352886405959,64
0.2,4296,-22,77493,18.034209913893413,125
0.2,4297,19,77512,18.03443462075384,82
0.2,4298,48,77560,18.041404977901838,54
0.2,4299,-29,77531,18.03046511627907,131
0.2,4300,37,77568,18.03487561032318,65
0.2,4301,70,77638,18.04695490469549,30
0.2,4302,95,77733,18.06483848477806,6
0.2,4303,62,77795,18.07504646840149,39
0.2,4304,-98,77697,18.04808362369338,200
0.2,4305,81,77778,18.06270320483047,19
0.2,4306,95,77873,18.080566519619225,6
0.2,4307,19,77892,18.080779944289695,88
0.2,4308,11,77903,18.07913669064748,21
0.2,4309,-29,77874,18.068213457076567,129
0.2,4310,18,77892,18.068197633959638,85
0.2,4311,-37,77855,18.055426716141003,68
0.2,4312,79,77934,18.06955715279388,21
0.2,4313,56,77990,18.078349559573482,45
0.2,4314,-201,77789,18.02757821552723,305
0.2,4315,78,77867,18.04147358665431,23
0.2,4316,-129,77738,18.00741255501506,230
0.2,4317,33,77771,18.01088466882816,68
0.2,4318,-1,77770,18.0064829821718,102
0.2,4319,35,77805,18.010416666666668,65
0.2,4320,-3,77802,18.005554269844943,35
0.2,4321,92,77894,18.02267468764461,8
0.2,4322,93,77987,18.040018505667362,8
0.2,4323,9,77996,18.037927844588346,50
0.2,4324,-12,77984,18.030982658959537,44
0.2,4325,60,78044,18.040684234858993,41
0.2,4326,75,78119,18.053847931592326,25
0.2,4327,64,78183,18.06446395563771,36
0.2,4328,-37,78146,18.051744051744052,68
0.2,4329,94,78240,18.069284064665126,6
0.2,4330,7,78247,18.066728238282153,94
0.2,4331,47,78294,18.073407202216067,53
0.2,4332,-30,78264,18.062312485575813,132
0.2,4333,18,78282,18.062298107983388,14
0.2,4334,94,78376,18.079815455594,7
0.2,4335,63,78439,18.090175276752767,38
0.2,4336,54,78493,18.098455153331795,46
0.2,4337,44,78537,18.104426002766253,57
0.2,4338,-36,78501,18.09195667204425,140
0.2,4339,15,78516,18.091244239631337,86
0.2,4340,59,78575,18.100668048836674,41
0.2,4341,78,78653,18.114463380930445,23
0.2,4342,25,78678,18.116048814183745,75
0.2,4343,28,78706,18.118324125230203,72
0.2,4344,-69,78637,18.098273878020713,172
0.2,4345,67,78704,18.109526000920386,34
0.2,4346,67,78771,18.120772946859905,33
0.2,4347,91,78862,18.137534498620056,9
0.2,4348,92,78954,18.154518280064384,8
0.2,4349,46,79000,18.160919540229884,54
0.2,4350,-70,78930,18.140657320156286,103
0.2,4351,-55,78875,18.123851102941178,157
0.2,4352,81,78956,18.138295428440156,19
0.2,4353,73,79029,18.150895728066146,28
0.2,4354,85,79114,18.166245694603905,16
0.2,4355,85,79199,18.181588613406795,16
0.2,4356,-31,79168,18.170300665595594,143
0.2,4357,86,79254,18.18586507572281,14
0.2,4358,-122,79132,18.15370497820601,225
0.2,4359,71,79203,18.165825688073394,29
0.2,4360,-11,79192,18.15913781242834,43
0.2,4361,89,79281,18.175378266850068,11
0.2,4362,78,79359,18.18909007563603,22
0.2,4363,-169,79190,18.146196150320808,204
0.2,4364,67,79257,18.157388316151202,34
0.2,4365,-26,79231,18.147274393037105,129
0.2,4366,-136,79095,18.111976185024044,242
0.2,4367,93,79188,18.12912087912088,7
0.2,4368,54,79242,18.137331197070267,47
0.2,4369,-105,79137,18.1091533180778,208
0.2,4370,-78,79059,18.08716540837337,109
0.2,4371,63,79122,18.09743824336688,63
0.2,4372,53,79175,18.105419620397896,47
0.2,4373,59,79234,18.114769090077733,42
0.2,4374,48,79282,18.1216,53
0.2,4375,71,79353,18.133683729433272,31
0.2,4376,40,79393,18.13867946081791,60
0.2,4377,-263,79130,18.074463225216995,298
0.2,4378,88,79218,18.09043160538936,12
0.2,4379,89,79307,18.10662100456621,12
0.2,4380,21,79328,18.107281442593017,79
0.2,4381,-183,79145,18.06138749429484,286
0.2,4382,32,79177,18.064567647729866,70
0.2,4383,-72,79105,18.04402372262774,177
0.2,4384,0,79105,18.039908779931586,105
0.2,4385,-24,79081,18.030323757409942,125
0.2,4386,32,79113,18.033508092090266,69
0.2,4387,-101,79012,18.006381039197812,64
0.2,4388,45,79057,18.0125313283208,55
0.2,4389,-155,78902,17.973120728929384,189
0.2,4390,73,78975,17.985652470963334,27
0.2,4391,91,79066,18.002276867030965,10
0.2,4392,-142,78924,17.965854768950603,175
0.2,4393,68,78992,17.977241693218026,34
0.2,4394,-85,78907,17.95381114903299,186
0.2,4395,8,78915,17.95154686078253,93
0.2,4396,54,78969,17.959745280873324,47
0.2,4397,-143,78826,17.923146884947702,182
0.2,4398,64,78890,17.933621277563084,37
0.2,4399,71,78961,17.945681818181818,29
0.2,4400,48,79009,17.95251079300159,53
0.2,4401,73,79082,17.965015901862788,27
0.2,4402,54,79136,17.97320009084715,47
0.2,4403,65,79201,17.983878292461398,36
0.2,4404,-133,79068,17.949602724177073,166
0.2,4405,-142,78926,17.913300045392646,176
0.2,4406,91,79017,17.929884275017017,9
0.2,4407,-143,78874,17.893375680580764,244
0.2,4408,31,78905,17.89634837831708,69
0.2,4409,80,78985,17.910430839002267,20
0.2,4410,18,79003,17.91045114486511,83
0.2,4411,17,79020,17.910244786944695,85
0.2,4412,1,79021,17.90641287106277,99
0.2,4413,49,79070,17.913457181694607,52
0.2,4414,-140,78930,17.877689694224234,241
0.2,4415,58,78988,17.88677536231884,42
0.2,4416,81,79069,17.901064070636178,19
0.2,4417,47,79116,17.907650520597556,53
0.2,4418,68,79184,17.91898619597194,33
0.2,4419,-21,79163,17.910180995475113,129
0.2,4420,67,79230,17.92128477719973,34
0.2,4421,79,79309,17.93509724106739,22
0.2,4422,93,79402,17.952068731630117,7
0.2,4423,89,79491,17.968128390596746,11
0.2,4424,-67,79424,17.948926553672315,120
0.2,4425,-86,79338,17.925440578400362,187
0.2,4426,-101,79237,17.898576914388975,135
0.2,4427,95,79332,17.9159891598916,6
0.2,4428,-65,79267,17.89726800632197,169
0.2,4429,95,79362,17.914672686230247,6
0.2,4430,86,79448,17.930038366057325,15
0.2,4431,67,79515,17.94111010830325,34
0.2,4432,-134,79381,17.90683510038349,243
0.2,4433,65,79446,17.917456021650878,35
0.2,4434,-62,79384,17.899436302142053,166
0.2,4435,-164,79220,17.858431018935978,198
0.2,4436,7,79227,17.855983772819474,25
0.2,4437,64,79291,17.866381252816584,37
0.2,4438,14,79305,17.865510250056317,88
0.2,4439,81,79386,17.87972972972973,20
0.2,4440,8,79394,17.87750506642648,92
0.2,4441,40,79434,17.882485366951823,63
0.2,4442,93,79527,17.899392302498313,7
0.2,4443,55,79582,17.907740774077407,46
0.2,4444,85,79667,17.92283464566929,16
0.2,4445,-22,79645,17.913855150697255,125
0.2,4446,79,79724,17.927591634809986,22
0.2,4447,62,79786,17.9375,39
0.2,4448,74,79860,17.950101146325018,27
0.2,4449,95,79955,17.967415730337077,6
0.2,4450,91,80046,17.983823859806783,10
0.2,4451,95,80141,18.001123090745732,6
0.2,4452,20,80161,18.001571973950146,82
0.2,4453,7,80168,17.999101930848674,96
0.2,4454,-32,80136,17.98787878787879,134
0.2,4455,-163,79973,17.94726211849192,196
0.2,4456,90,80063,17.963428315010095,11
0.2,4457,65,80128,17.973979362943023,36
0.2,4458,-140,79988,17.938551244673693,174
0.2,4459,75,80063,17.95134529147982,26
0.2,4460,41,80104,17.95651199282672,62
0.2,4461,68,80172,17.967727476467953,33
0.2,4462,91,80263,17.98409141832848,9
0.2,4463,41,80304,17.989247311827956,60
0.2,4464,42,80346,17.994624860022398,60
0.2,4465,26,80372,17.99641737572772,75
0.2,4466,-150,80222,17.958809044101187,182
0.2,4467,67,80289,17.969785138764546,33
0.2,4468,70,80359,17.981427612441262,31
0.2,4469,91,80450,17.997762863534675,10
0.2,4470,-15,80435,17.99038246477298,48
0.2,4471,12,80447,17.989042933810374,91
0.2,4472,95,80542,18.00625978090767,6
0.2,4473,61,80603,18.01586946803755,39
0.2,4474,36,80639,18.019888268156425,87
0.2,4475,82,80721,18.034182305630026,18
0.2,4476,-46,80675,18.019879383515747,147
0.2,4477,-27,80648,18.009825815096026,130
0.2,4478,17,80665,18.009600357222595,86
0.2,4479,-103,80562,17.982589285714287,134
0.2,4480,-163,80399,17.94220040169605,267
0.2,4481,92,80491,17.95872378402499,9
0.2,4482,-60,80431,17.941333928173098,24
0.2,4483,73,80504,17.953612845673504,27
0.2,4484,24,80528,17.954960981047936,78
0.2,4485,60,80588,17.964333481943825,41
0.2,4486,53,80641,17.97214174281257,50
0.2,4487,35,80676,17.975935828877006,66
0.2,4488,-28,80648,17.965693918467366,130
0.2,4489,89,80737,17.9815144766147,12
0.2,4490,81,80818,17.995546648853264,19
0.2,4491,50,80868,18.0026714158504,50
0.2,4492,87,80955,18.018028043623413,14
0.2,4493,58,81013,18.026924788607033,50
0.2,4494,-46,80967,18.012680756395994,147
0.2,4495,37,81004,18.01690391459075,63
0.2,4496,37,81041,18.02112519457416,63
0.2,4497,32,81073,18.024232992441085,68
0.2,4498,46,81119,18.030451211380306,55
0.2,4499,-116,81003,18.000666666666667,79
0.2,4500,20,81023,18.00111086425239,83
0.2,4501,66,81089,18.01177254553532,35
0.2,4502,82,81171,18.025982678214525,19
0.2,4503,-31,81140,18.015097690941385,132
0.2,4504,87,81227,18.030410654827968,14
0.2,4505,87,81314,18.04571682201509,13
0.2,4506,12,81326,18.044375416019527,89
0.2,4507,-80,81246,18.0226264418811,183
0.2,4508,-79,81167,18.001108893324464,111
0.2,4509,28,81195,18.003325942350333,77
0.2,4510,23,81218,18.00443360673908,111
0.2,4511,62,81280,18.01418439716312,39
0.2,4512,-68,81212,17.995125193884334,100
0.2,4513,90,81302,18.01107665042091,11
0.2,4514,-39,81263,17.9984496124031,141
0.2,4515,94,81357,18.015279007971657,6
0.2,4516,22,81379,18.016161168917424,79
0.2,4517,77,81456,18.02921646746348,23
0.2,4518,35,81491,18.032971896437264,66
0.2,4519,-129,81362,18.000442477876106,231
0.2,4520,57,81419,18.009068790090687,44
0.2,4521,92,81511,18.02543122512163,8
0.2,4522,77,81588,18.038470042007518,24
0.2,4523,85,81673,18.053271441202476,15
0.2,4524,41,81714,18.058342541436463,61
0.2,4525,-42,81672,18.04507291206363,73
0.2,4526,-44,81628,18.031367351446875,146
0.2,4527,-186,81442,17.9863074204947,290
0.2,4528,67,81509,17.99712960918525,33
0.2,4529,-53,81456,17.981456953642383,155
0.2,4530,84,81540,17.996027367027146,17
0.2,4531,-53,81487,17.98036187113857,85
0.2,4532,73,81560,17.99249944848886,27
0.2,4533,49,81609,17.999338332598146,51
0.2,4534,78,81687,18.012568908489527,23
0.2,4535,30,81717,18.01521164021164,72
0.2,4536,23,81740,18.016310337227242,78
0.2,4537,86,81826,18.031291317761127,14
0.2,4538,90,81916,18.04714694866711,11
0.2,4539,49,81965,18.053964757709252,52
0.2,4540,-30,81935,18.043382514864568,74
0.2,4541,-26,81909,18.033685601056803,129
0.2,4542,78,81987,18.04688531807176,23
0.2,4543,-11,81976,18.04049295774648,44
0.2,4544,54,82030,18.04840484048405,48
0.2,4545,52,82082,18.055873295204574,48
0.2,4546,77,82159,18.06883659555751,23
0.2,4547,30,82189,18.071459982409852,71
0.2,4548,87,82276,18.08661244229501,14
0.2,4549,40,82316,18.091428571428573,60
0.2,4550,45,82361,18.097341243682706,56
0.2,4551,60,82421,18.106546572934974,40
0.2,4552,-177,82244,18.063694267515924,211
0.2,4553,67,82311,18.074440052700922,33
0.2,4554,69,82380,18.085620197585072,31
0.2,4555,48,82428,18.092186128182615,53
0.2,4556,59,82487,18.101163045863508,41
0.2,4557,61,82548,18.1105748135147,59
0.2,4558,95,82643,18.1274402281202,6
0.2,4559,62,82705,18.13706140350877,39
0.2,4560,48,82753,18.143608857706642,53
0.2,4561,90,82843,18.159359929855327,11
0.2,4562,70,82913,18.170721016874865,31
0.2,4563,-7,82906,18.16520595968449,108
0.2,4564,91,82997,18.181161007667033,10
0.2,4565,92,83089,18.197328077091548,9
0.2,4566,75,83164,18.20976571053208,25
0.2,4567,48,83212,18.21628721541156,53
0.2,4568,-70,83142,18.196979645436638,102
0.2,4569,-103,83039,18.17045951859956,207
0.2,4570,85,83124,18.185079851236054,16
0.2,4571,78,83202,18.198162729658794,22
0.2,4572,66,83268,18.208615788322764,34
0.2,4573,92,83360,18.224748578924356,28
0.2,4574,-94,83266,18.200218579234974,129
0.2,4575,14,83280,18.1993006993007,27
0.2,4576,49,83329,18.20603015075377,51
0.2,4577,41,83370,18.211009174311926,61
0.2,4578,-140,83230,18.176457741865036,104
0.2,4579,78,83308,18.189519650655022,23
0.2,4580,53,83361,18.197118533071382,48
0.2,4581,28,83389,18.19925796595373,73
0.2,4582,87,83476,18.214270128736636,13
0.2,4583,42,83518,18.219458987783597,59
0.2,4584,51,83569,18.22660850599782,55
0.2,4585,70,83639,18.23789795028347,30
0.2,4586,70,83709,18.249182472204055,30
0.2,4587,-5,83704,18.24411508282476,108
0.2,4588,51,83755,18.251252996295488,52
0.2,4589,83,83838,18.265359477124182,18
0.2,4590,76,83914,18.277935090394248,24
0.2,4591,66,83980,18.288327526132406,34
0.2,4592,23,84003,18.2893533638145,78
0.2,4593,73,84076,18.301262516325643,67
0.2,4594,65,84141,18.311425462459194,36
0.2,4595,94,84235,18.327893820713665,7
0.2,4596,88,84323,18.3430498150968,12
0.2,4597,46,84369,18.349064810787297,56
0.2,4598,87,84456,18.36399217221135,13
0.2,4599,-34,84422,18.352608695652172,134
0.2,4600,55,84477,18.36057378830689,46
0.2,4601,54,84531,18.36831812255541,46
0.2,4602,1,84532,18.36454486204649,31
0.2,4603,83,84615,18.378583840139008,17
0.2,4604,-6,84609,18.37328990228013,108
0.2,4605,24,84633,18.37451150673035,77
0.2,4606,38,84671,18.37877143477317,64
0.2,4607,73,84744,18.390625,28
0.2,4608,-232,84512,18.336298546322414,199
0.2,4609,92,84604,18.35227765726681,9
0.2,4610,-74,84530,18.332248969854696,174
0.2,4611,19,84549,18.332393755420643,84
0.2,4612,-17,84532,18.3247344461305,124
0.2,4613,65,84597,18.33485045513654,35
0.2,4614,40,84637,18.339544962080172,63
0.2,4615,84,84721,18.353769497400346,17
0.2,4616,47,84768,18.359974009096817,53
0.2,4617,89,84857,18.37527067994803,11
0.2,4618,95,84952,18.391859709893918,6
0.2,4619,2,84954,18.38831168831169,99
0.2,4620,26,84980,18.38995888335858,75
0.2,4621,78,85058,18.40285590653397,23
0.2,4622,-199,84859,18.35582954791261,235
0.2,4623,-7,84852,18.350346020761247,109
0.2,4624,85,84937,18.36475675675676,16
0.2,4625,-84,84853,18.342628620838738,187
0.2,4626,49,84902,18.349254376485845,52
0.2,4627,65,84967,18.35933448573898,35
0.2,4628,87,85054,18.374162886152515,14
0.2,4629,93,85147,18.390280777537797,7
0.2,4630,28,85175,18.39235586266465,73
0.2,4631,-47,85128,18.378238341968913,80
0.2,4632,-283,84845,18.313187999136627,325
0.2,4633,-112,84733,18.285066896849376,147
0.2,4634,-41,84692,18.2722761596548,146
0.2,4635,83,84775,18.286238136324418,18
0.2,4636,87,84862,18.301056717705414,13
0.2,4637,61,84923,18.310263044415695,40
0.2,4638,-27,84896,18.300495796507867,59
0.2,4639,94,84990,18.316810344827587,7
0.2,4640,87,85077,18.331609566903683,14
0.2,4641,-65,85012,18.31365790607497,97
0.2,4642,76,85088,18.326082274391556,24
0.2,4643,72,85160,18.33763996554694,29
0.2,4644,62,85222,18.3470398277718,39
0.2,4645,-400,84822,18.256995264743864,507
0.2,4646,92,84914,18.272864213471056,8
0.2,4647,13,84927,18.27172977624785,90
0.2,4648,30,84957,18.274252527425254,71
0.2,4649,63,85020,18.283870967741937,38
0.2,4650,7,85027,18.28144485056977,95
0.2,4651,-127,84900,18.250214961306966,163
0.2,4652,72,84972,18.261766602192136,29
0.2,4653,52,85024,18.269015900300815,48
0.2,4654,49,85073,18.27561761546724,52
0.2,4655,-24,85049,18.266537800687285,139
0.2,4656,89,85138,18.281726433326174,11
0.2,4657,22,85160,18.2825246887076,10
0.2,4658,21,85181,18.283107963082205,79
0.2,4659,29,85210,18.28540772532189,72
0.2,4660,-238,84972,18.230422656082386,342
0.2,4661,47,85019,18.236593736593736,54
0.2,4662,91,85110,18.25219815569376,10
0.2,4663,11,85121,18.25064322469983,21
0.2,4664,56,85177,18.258735262593785,45
0.2,4665,-29,85148,18.248606943849122,132
0.2,4666,-56,85092,18.232697664452537,87
0.2,4667,70,85162,18.243787489288774,31
0.2,4668,-84,85078,18.221889055472264,130
0.2,4669,31,85109,18.224625267665953,70
0.2,4670,-64,85045,18.207022050952688,97
0.2,4671,-68,84977,18.18857020547945,99
0.2,4672,57,85034,18.196875668735288,44
0.2,4673,42,85076,18.201968335472827,59
0.2,4674,53,85129,18.209411764705884,48
0.2,4675,68,85197,18.22005988023952,32
0.2,4676,92,85289,18.23583493692538,9
0.2,4677,-69,85220,18.21718683197948,103
0.2,4678,38,85258,18.221414832229108,70
0.2,4679,36,85294,18.225213675213674,65
0.2,4680,24,85318,18.2264473403119,77
0.2,4681,89,85407,18.241563434429732,11
0.2,4682,80,85487,18.254751227845396,20
0.2,4683,78,85565,18.26750640478224,67
0.2,4684,27,85592,18.269370330843117,73
0.2,4685,56,85648,18.277422108408025,44
0.2,4686,35,85683,18.280989972263708,65
0.2,4687,26,85709,18.28263651877133,74
0.2,4688,-41,85668,18.269993602047347,150
0.2,4689,18,85686,18.269936034115137,83
0.2,4690,-30,85656,18.259646130888935,145
0.2,4691,91,85747,18.275149190110827,9
0.2,4692,92,85839,18.290858725761773,8
0.2,4693,94,85933,18.306987643800596,7
0.2,4694,93,86026,18.322896698615548,8
0.2,4695,81,86107,18.336243611584326,19
0.2,4696,80,86187,18.349371939535875,21
0.2,4697,94,86281,18.36547467007237,7
0.2,4698,33,86314,18.368589061502448,68
0.2,4699,90,86404,18.383829787234042,11
0.2,4700,62,86466,18.393107849393747,39
0.2,4701,-185,86281,18.349851127179925,220
0.2,4702,28,86309,18.351903040612374,72
0.2,4703,79,86388,18.364795918367346,22
0.2,4704,-66,86322,18.346865037194473,98
0.2,4705,-138,86184,18.313642158946028,170
0.2,4706,46,86230,18.319524113023157,57
0.2,4707,-4,86226,18.314783347493627,105
0.2,4708,65,86291,18.324697387980464,35
0.2,4709,-4,86287,18.319957537154988,35
0.2,4710,-97,86190,18.29547866694969,202
0.2,4711,83,86273,18.30921052631579,18
0.2,4712,90,86363,18.324421812009337,11
0.2,4713,-73,86290,18.30504879083581,107
0.2,4714,-76,86214,18.285047720042417,177
0.2,4715,30,86244,18.287531806615775,71
0.2,4716,-95,86149,18.263514945940216,198
0.2,4717,1,86150,18.259855871131837,100
0.2,4718,50,86200,18.26658190294554,51
0.2,4719,56,86256,18.27457627118644,45
0.2,4720,81,86337,18.287862740944714,19
0.2,4721,68,86405,18.298390512494706,32
0.2,4722,-3,86402,18.293881007834003,104
0.2,4723,8,86410,18.291701947502116,95
0.2,4724,94,86504,18.30772486772487,6
0.2,4725,70,86574,18.318662716885314,31
0.2,4726,52,86626,18.32578802623228,50
0.2,4727,86,86712,18.34010152284264,14
0.2,4728,-39,86673,18.32797631634595,142
0.2,4729,-162,86511,18.28985200845666,124
0.2,4730,49,86560,18.296343267808073,53
0.2,4731,69,86629,18.307058326289095,32
0.2,4732,-122,86507,18.277413902387494,223
0.2,4733,17,86524,18.27714406421631,83
0.2,4734,65,86589,18.2870116156283,36
0.2,4735,-139,86450,18.253800675675677,241
0.2,4736,-38,86412,18.241925269157694,70
0.2,4737,92,86504,18.257492612916842,9
0.2,4738,89,86593,18.27242034184427,12
0.2,4739,79,86672,18.28523206751055,21
0.2,4740,39,86711,18.289601349926176,62
0.2,4741,42,86753,18.294601433994096,59
0.2,4742,-112,86641,18.267130508117226,151
0.2,4743,83,86724,18.280775716694773,18
0.2,4744,66,86790,18.290832455216016,34
0.2,4745,15,86805,18.290139064475348,85
0.2,4746,66,86871,18.30018959342743,34
0.2,4747,91,86962,18.315501263689974,10
0.2,4748,30,86992,18.317961676142346,73
0.2,4749,-90,86902,18.295157894736843,190
0.2,4750,81,86983,18.30835613555041,20
0.2,4751,79,87062,18.321127946127945,21
0.2,4752,-107,86955,18.294761203450452,139
0.2,4753,71,87026,18.30584770719394,30
0.2,4754,37,87063,18.309779179810725,64
0.2,4755,63,87126,18.319175777964677,38
0.2,4756,-164,86962,18.280849274752995,268
0.2,4757,49,87011,18.28730559058428,52
0.2,4758,81,87092,18.300483294809833,19
0.2,4759,94,87186,18.31638655462185,6
0.2,4760,-119,87067,18.287544633480362,152
0.2,4761,48,87115,18.293784124317515,53
0.2,4762,69,87184,18.304429981104345,31
0.2,4763,3,87187,18.3012174643157,100
0.2,4764,-58,87129,18.28520461699895,160
0.2,4765,24,87153,18.28640369282417,76
0.2,4766,71,87224,18.29746171596392,29
0.2,4767,95,87319,18.313548657718123,6
0.2,4768,-31,87288,18.30320821975257,65
0.2,4769,-11,87277,18.29706498951782,44
0.2,4770,-11,87266,18.290924334521065,112
0.2,4771,-71,87195,18.272212908633698,105
0.2,4772,92,87287,18.287659752776033,9
0.2,4773,62,87349,18.29681608713867,38
0.2,4774,89,87438,18.311623036649216,12
0.2,4775,5,87443,18.308835845896148,95
0.2,4776,61,87504,18.31777266066569,39
0.2,4777,88,87592,18.332356634575135,12
0.2,4778,87,87679,18.346725256329776,14
0.2,4779,88,87767,18.36129707112971,12
0.2,4780,93,87860,18.376908596527922,8
0.2,4781,71,87931,18.387913007109997,30
0.2,4782,94,88025,18.403721513694332,6
0.2,4783,70,88095,18.41450668896321,30
0.2,4784,90,88185,18.429467084639498,11
0.2,4785,-29,88156,18.419557041370666,61
0.2,4786,-364,87792,18.33966993941926,400
0.2,4787,88,87880,18.35421888053467,13
0.2,4788,-31,87849,18.343913134266025,137
0.2,4789,89,87938,18.358663883089772,12
0.2,4790,90,88028,18.37361719891463,11
0.2,4791,79,88107,18.38626878130217,22
0.2,4792,-32,88075,18.375756311287294,63
0.2,4793,30,88105,18.378181059657905,72
0.2,4794,15,88120,18.37747653806048,85
0.2,4795,40,88160,18.381984987489574,61
0.2,4796,58,88218,18.390243902439025,42
0.2,4797,75,88293,18.402042517715714,25
0.2,4798,55,88348,18.4096686809752,45
0.2,4799,14,88362,18.40875,86
0.2,4800,91,88453,18.423870027077694,10
0.2,4801,-8,88445,18.418367346938776,110
0.2,4802,82,88527,18.4316052467208,19
0.2,4803,85,88612,18.445462114904245,15
0.2,4804,72,88684,18.456607700312176,29
0.2,4805,74,88758,18.46816479400749,27
0.2,4806,72,88830,18.479301019346785,28
0.2,4807,-35,88795,18.468178036605657,67
0.2,4808,39,88834,18.472447494281557,61
0.2,4809,-4,88830,18.467775467775468,36
0.2,4810,71,88901,18.478694658075245,30
0.2,4811,-148,88753,18.44409808811305,253
0.2,4812,94,88847,18.45979638479119,7
0.2,4813,-28,88819,18.4501454092231,128
0.2,4814,92,88911,18.465420560747663,9
0.2,4815,79,88990,18.477990033222593,23
0.2,4816,38,89028,18.48204276520656,64
0.2,4817,28,89056,18.484018264840184,75
0.2,4818,-271,88785,18.423946876945426,440
0.2,4819,94,88879,18.4396265560166,7
0.2,4820,83,88962,18.453018046048538,17
0.2,4821,-94,88868,18.429697221070096,134
0.2,4822,29,88897,18.43188886585113,74
0.2,4823,72,88969,18.44299336650083,29
0.2,4824,-15,88954,18.4360621761658,118
0.2,4825,94,89048,18.45171985080812,7
0.2,4826,55,89103,18.459291485394655,46
0.2,4827,42,89145,18.464167357083678,59
0.2,4828,28,89173,18.466142058397185,72
0.2,4829,68,89241,18.47639751552795,32
0.2,4830,64,89305,18.4858207410474,37
0.2,4831,48,89353,18.49192880794702,53
0.2,4832,71,89424,18.502793296089386,29
0.2,4833,36,89460,18.506412908564336,64
0.2,4834,85,89545,18.520165460186142,16
0.2,4835,49,89594,18.526468155500414,51
0.2,4836,65,89659,18.53607608021501,35
0.2,4837,3,89662,18.532864820173625,29
0.2,4838,74,89736,18.54432734035958,42
0.2,4839,41,89777,18.54896694214876,60
0.2,4840,61,89838,18.557736004957654,40
0.2,4841,94,89932,18.573316811235028,6
0.2,4842,95,90027,18.589097666735494,6
0.2,4843,-97,89930,18.56523534269199,198
0.2,4844,57,89987,18.573168214654284,43
0.2,4845,15,90002,18.572430870821297,86
0.2,4846,-54,89948,18.557458221580358,85
0.2,4847,-250,89698,18.502062706270628,294
0.2,4848,91,89789,18.517013817281914,10
0.2,4849,20,89809,18.517319587628865,93
0.2,4850,-5,89804,18.5124716553288,107
0.2,4851,-20,89784,18.504534212695795,54
0.2,4852,26,89810,18.506078714197404,77
0.2,4853,59,89869,18.514421096003296,42
0.2,4854,69,89938,18.524819773429453,32
0.2,4855,10,89948,18.52306425041186,21
0.2,4856,88,90036,18.53736874613959,12
0.2,4857,11,90047,18.53581720872787,89
0.2,4858,-74,89973,18.516772998559375,176
0.2,4859,-63,89910,18.5,165
0.2,4860,-76,89834,18.480559555646987,109
0.2,4861,-206,89628,18.43438914027149,312
0.2,4862,51,89679,18.441085749537322,49
0.2,4863,34,89713,18.444284539473685,66
0.2,4864,39,89752,18.44850976361768,61
0.2,4865,61,89813,18.45725441841348,42
0.2,4866,-161,89652,18.420382165605094,196
0.2,4867,76,89728,18.432210353327854,24
0.2,4868,55,89783,18.43972068186486,46
0.2,4869,18,89801,18.439630390143737,82
0.2,4870,50,89851,18.44610962841306,51
0.2,4871,52,89903,18.45299671592775,48
0.2,4872,-105,89798,18.4276626308229,206
0.2,4873,82,89880,18.440705785802216,18
0.2,4874,-67,89813,18.42317948717949,176
0.2,4875,-211,89602,18.376127973748975,176
0.2,4876,63,89665,18.385277834734467,37
0.2,4877,66,89731,18.395038950389505,34
0.2,4878,59,89790,18.403361344537814,41
0.2,4879,-14,89776,18.39672131147541,45
0.2,4880,-82,89694,18.376152427781193,186
0.2,4881,40,89734,18.380581728799672,61
0.2,4882,-162,89572,18.34364120417776,199
0.2,4883,-116,89456,18.316134316134317,220
0.2,4884,-21,89435,18.308085977482087,125
0.2,4885,-8,89427,18.30270159639787,108
0.2,4886,-42,89385,18.29036218538981,83
0.2,4887,-112,89273,18.263707037643208,223
0.2,4888,29,89302,18.265903047658007,72
0.2,4889,-59,89243,18.25010224948875,160
0.2,4890,92,89335,18.265180944592107,9
0.2,4891,78,89413,18.27739165985282,23
0.2,4892,-35,89378,18.26650316779072,135
0.2,4893,69,89447,18.276869636289334,31
0.2,4894,92,89539,18.291930541368743,8
0.2,4895,87,89626,18.30596405228758,14
0.2,4896,-223,89403,18.256687768021237,326
0.2,4897,-8,89395,18.251327072274396,110
0.2,4898,87,89482,18.265360277607677,13
0.2,4899,62,89544,18.274285714285714,39
0.2,4900,58,89602,18.282391348704348,42
0.2,4901,36,89638,18.286005711954303,65
0.2,4902,-26,89612,18.276973281664286,128
0.2,4903,91,89703,18.291802610114193,10
0.2,4904,-37,89666,18.28053007135576,139
0.2,4905,87,89753,18.29453730126376,13
0.2,4906,76,89829,18.306297126553904,24
0.2,4907,89,89918,18.320700896495516,11
0.2,4908,59,89977,18.32898757384396,54
0.2,4909,82,90059,18.34195519348269,18
0.2,4910,36,90095,18.34555080431684,67
0.2,4911,62,90157,18.354438110749186,39
0.2,4912,94,90251,18.369835131284347,7
0.2,4913,44,90295,18.375050875050874,57
0.2,4914,13,90308,18.373957273652085,89
0.2,4915,57,90365,18.381814483319772,43
0.2,4916,-244,90121,18.32845230831808,209
0.2,4917,95,90216,18.344042293615292,6
0.2,4918,33,90249,18.347021752388695,73
0.2,4919,-17,90232,18.339837398373984,119
0.2,4920,50,90282,18.346271083113187,51
0.2,4921,10,90292,18.34457537586347,90
0.2,4922,48,90340,18.35059922811294,52
0.2,4923,82,90422,18.363525588952072,18
0.2,4924,67,90489,18.373401015228428,34
0.2,4925,12,90501,18.3721071863581,92
0.2,4926,-23,90478,18.36371016845951,127
0.2,4927,71,90549,18.374391233766232,30
0.2,4928,84,90633,18.38770541692027,16
0.2,4929,-87,90546,18.36632860040568,190
0.2,4930,94,90640,18.38166700466437,7
0.2,4931,-33,90607,18.37124898621249,133
0.2,4932,-386,90221,18.28927630245287,355
0.2,4933,22,90243,18.29002837454398,78
0.2,4934,-6,90237,18.285106382978725,37
0.2,4935,76,90313,18.296799027552673,25
0.2,4936,79,90392,18.309094591857402,22
0.2,4937,-175,90217,18.26994734710409,230
0.2,4938,-9,90208,18.264425997165418,43
0.2,4939,90,90298,18.278947368421054,10
0.2,4940,24,90322,18.280105241853875,80
0.2,4941,92,90414,18.29502225819506,9
0.2,4942,-35,90379,18.28424033987457,135
0.2,4943,17,90396,18.283980582524272,121
0.2,4944,-2,90394,18.279878665318503,104
0.2,4945,19,90413,18.280024262029922,13
0.2,4946,4,90417,18.277137659187385,99
0.2,4947,-145,90272,18.244139046079223,179
0.2,4948,65,90337,18.25358658314811,37
0.2,4949,-1,90336,18.24969696969697,102
0.2,4950,-25,90311,18.240961421934962,127
0.2,4951,-37,90274,18.229806138933764,71
0.2,4952,-5,90269,18.225116091257824,37
0.2,4953,78,90347,18.237182075090836,22
0.2,4954,67,90414,18.24702320887992,33
0.2,4955,48,90462,18.253026634382568,52
0.2,4956,-100,90362,18.229170869477507,133
0.2,4957,33,90395,18.23215006050827,67
0.2,4958,14,90409,18.23129663238556,88
0.2,4959,87,90496,18.24516129032258,13
0.2,4960,-159,90337,18.209433581939127,130
0.2,4961,-47,90290,18.196291817815396,164
0.2,4962,-42,90248,18.18416280475519,74
0.2,4963,-6,90242,18.17929089443997,106
0.2,4964,-4,90238,18.17482376636455,109
0.2,4965,-120,90118,18.146999597261377,153
0.2,4966,92,90210,18.161868330984497,8
0.2,4967,44,90254,18.1670692431562,56
0.2,4968,-30,90224,18.157375729523043,132
0.2,4969,-153,90071,18.122937625754528,191
0.2,4970,53,90124,18.129953731643532,48
0.2,4971,82,90206,18.142799678197907,19
0.2,4972,62,90268,18.151618741202494,39
0.2,4973,89,90357,18.165862484921593,11
0.2,4974,91,90448,18.180502512562814,10
0.2,4975,-20,90428,18.172829581993568,52
0.2,4976,69,90497,18.183041993168576,31
0.2,4977,78,90575,18.195058256327844,22
0.2,4978,64,90639,18.204257883109058,39
0.2,4979,81,90720,18.216867469879517,20
0.2,4980,76,90796,18.228468179080505,24
0.2,4981,47,90843,18.234243275792853,56
0.2,4982,44,90887,18.23941400762593,58
0.2,4983,-405,90482,18.15449438202247,440
0.2,4984,34,90516,18.15767301905717,66
0.2,4985,72,90588,18.168471720818292,29
0.2,4986,69,90657,18.17866452777221,31
0.2,4987,32,90689,18.181435445068164,69
0.2,4988,-13,90676,18.175185407897374,44
0.2,4989,6,90682,18.172745490981963,94
0.2,4990,56,90738,18.180324584251654,44
0.2,4991,71,90809,18.19090544871795,30
0.2,4992,-63,90746,18.174644502303224,166
0.2,4993,85,90831,18.188025630756908,16
0.2,4994,-7,90824,18.18298298298298,107
0.2,4995,94,90918,18.19815852682146,7
0.2,4996,-236,90682,18.147288373023816,198
0.2,4997,-22,90660,18.139255702280913,125
0.2,4998,34,90694,18.14242848569714,69
0.2,4999,-26,90668,18.1336,58
0.2,5000,-1,90667,18.129774045190963,103
0.2,5001,-84,90583,18.109356257497,189
0.2,5002,31,90614,18.11193284029582,70
0.2,5003,22,90636,18.112709832134293,79
0.2,5004,-5,90631,18.108091908091907,106
0.2,5005,94,90725,18.12325209748302,7
0.2,5006,95,90820,18.138605951667664,6
0.2,5007,-14,90806,18.132188498402556,55
0.2,5008,83,90889,18.14513875024955,17
0.2,5009,57,90946,18.152894211576847,47
0.2,5010,1,90947,18.14947116344043,102
0.2,5011,-110,90837,18.12390263367917,215
0.2,5012,84,90921,18.13704368641532,17
0.2,5013,-89,90832,18.11567610690068,122
0.2,5014,85,90917,18.12901296111665,16
0.2,5015,-336,90581,18.058413078149922,381
0.2,5016,-109,90472,18.03308750249153,144
0.2,5017,69,90541,18.043244320446394,32
0.2,5018,94,90635,18.058378162980674,7
0.2,5019,77,90712,18.07011952191235,23
0.2,5020,-123,90589,18.042023501294562,226
0.2,5021,73,90662,18.052966945440065,27
0.2,5022,-10,90652,18.04738204260402,112
0.2,5023,-91,90561,18.025676751592357,193
0.2,5024,16,90577,18.025273631840797,16
0.2,5025,75,90652,18.036609629924392,25
0.2,5026,87,90739,18.050328227571114,14
0.2,5027,83,90822,18.06324582338902,18
0.2,5028,82,90904,18.075959435275404,18
0.2,5029,12,90916,18.07475149105368,89
0.2,5030,-61,90855,18.05903398926655,95
0.2,5031,-108,90747,18.03398251192369,141
0.2,5032,86,90833,18.047486588515795,14
0.2,5033,-53,90780,18.03337306317044,157
0.2,5034,69,90849,18.04349553128103,32
0.2,5035,21,90870,18.044082605242256,11
0.2,5036,-83,90787,18.024022235457615,186
0.2,5037,11,90798,18.022628026994838,90
0.2,5038,80,90878,18.034927564993055,21
0.2,5039,52,90930,18.041666666666668,48
0.2,5040,94,91024,18.056734774846262,7
0.2,5041,52,91076,18.06346687822293,48
0.2,5042,87,91163,18.077136625024785,14
0.2,5043,68,91231,18.087034099920697,33
0.2,5044,11,91242,18.085629335976215,90
0.2,5045,-212,91030,18.040031708283788,174
0.2,5046,-44,90986,18.027739251040224,77
0.2,5047,85,91071,18.041006339144214,16
0.2,5048,58,91129,18.048920578332343,43
0.2,5049,82,91211,18.06158415841584,19
0.2,5050,85,91296,18.074836666006732,15
0.2,5051,85,91381,18.088083927157562,15
0.2,5052,74,91455,18.09914902038393,27
0.2,5053,45,91500,18.104471705579737,55
0.2,5054,-307,91193,18.040158259149358,287
0.2,5055,58,91251,18.04806170886076,43
0.2,5056,-14,91237,18.041724342495552,116
0.2,5057,-143,91094,18.00988533017003,183
0.2,5058,-13,91081,18.003755682941293,116
0.2,5059,89,91170,18.01778656126482,11
0.2,5060,51,91221,18.024303497332543,49
0.2,5061,87,91308,18.037929672066376,13
0.2,5062,26,91334,18.039502271380606,11
0.2,5063,-48,91286,18.026461295418642,80
0.2,5064,62,91348,18.035143139190524,40
0.2,5065,14,91362,18.034346624555862,86
0.2,5066,85,91447,18.047562660351293,15
0.2,5067,13,91460,18.04656669297553,87
0.2,5068,75,91535,18.057802327875322,26
0.2,5069,-28,91507,18.04871794871795,128
0.2,5070,59,91566,18.056793531847763,41
0.2,5071,51,91617,18.063288643533124,49
0.2,5072,13,91630,18.062290557855313,87
0.2,5073,72,91702,18.07292077256602,29
0.2,5074,83,91785,18.085714285714285,18
0.2,5075,77,91862,18.0973207249803,24
0.2,5076,-116,91746,18.070908016545204,219
0.2,5077,29,91775,18.07306025994486,73
0.2,5078,81,91856,18.085449891710965,20
0.2,5079,18,91874,18.08543307086614,14
0.2,5080,80,91954,18.097618579019876,20
0.2,5081,32,91986,18.100354191263282,69
0.2,5082,68,92054,18.11017115876451,32
0.2,5083,58,92112,18.11801730920535,43
0.2,5084,-34,92078,18.107767944936086,136
0.2,5085,-22,92056,18.09988202909949,125
0.2,5086,-154,91902,18.066050717515235,205
0.2,5087,-112,91790,18.04048742138365,215
0.2,5088,63,91853,18.04932206720377,37
0.2,5089,-1,91852,18.04557956777996,102
0.2,5090,-37,91815,18.034767236299352,72
0.2,5091,-50,91765,18.021406127258444,154
0.2,5092,32,91797,18.02415079520911,68
0.2,5093,-33,91764,18.014134275618375,66
0.2,5094,93,91857,18.028851815505398,7
0.2,5095,6,91863,18.02649136577708,95
0.2,5096,82,91945,18.039042574063174,18
0.2,5097,2,91947,18.03589642997254,116
0.2,5098,40,91987,18.04020396156109,61
0.2,5099,-35,91952,18.02980392156863,136
0.2,5100,93,92045,18.044501078219955,7
0.2,5101,84,92129,18.057428459427676,16
0.2,5102,51,92180,18.063883989809916,50
0.2,5103,79,92259,18.07582288401254,22
0.2,5104,71,92330,18.08619000979432,29
0.2,5105,31,92361,18.088719153936545,70
0.2,5106,71,92432,18.09907969453691,29
0.2,5107,92,92524,18.113547376664055,8
0.2,5108,-123,92401,18.08592679585046,224
0.2,5109,76,92477,18.0972602739726,25
0.2,5110,22,92499,18.09802387008413,79
0.2,5111,47,92546,18.103677621283254,55
0.2,5112,51,92597,18.1101114805398,50
0.2,5113,91,92688,18.124364489636292,9
0.2,5114,66,92754,18.133724340175952,34
0.2,5115,26,92780,18.135261923377637,75
0.2,5116,-2,92778,18.131326949384405,102
0.2,5117,-1,92777,18.12758890191481,103
0.2,5118,-197,92580,18.085563586638017,160
0.2,5119,19,92599,18.0857421875,81
0.2,5120,84,92683,18.098613552040618,16
0.2,5121,19,92702,18.098789535337758,82
0.2,5122,93,92795,18.113410111262933,7
0.2,5123,74,92869,18.12431693989071,26
0.2,5124,26,92895,18.125853658536585,74
0.2,5125,-66,92829,18.109442060085836,172
0.2,5126,73,92902,18.120148234835185,27
0.2,5127,56,92958,18.127535101404057,44
0.2,5128,-42,92916,18.115812049132384,74
0.2,5129,-244,92672,18.064717348927875,297
0.2,5130,89,92761,18.078542194503996,11
0.2,5131,66,92827,18.08787996882307,34
0.2,5132,-53,92774,18.07403078121956,156
0.2,5133,31,92805,18.07654850019478,69
0.2,5134,-113,92692,18.051022395326193,215
0.2,5135,-173,92519,18.01382398753894,273
0.2,5136,-26,92493,18.005255985984036,126
0.2,5137,80,92573,18.01732191514208,35
0.2,5138,43,92616,18.022183304144775,59
0.2,5139,-41,92575,18.010700389105057,146
0.2,5140,58,92633,18.018478895156584,42
0.2,5141,-127,92506,17.990276157137302,230
0.2,5142,-21,92485,17.98269492514097,123
0.2,5143,-193,92292,17.94167962674961,225
0.2,5144,47,92339,17.947327502429545,53
0.2,5145,93,92432,17.961912164788185,8
0.2,5146,-44,92388,17.949873712842432,146
0.2,5147,15,92403,17.9493006993007,86
0.2,5148,-290,92113,17.88949310545737,404
0.2,5149,-75,92038,17.871456310679612,179
0.2,5150,67,92105,17.880993981751118,33
0.2,5151,68,92173,17.89072204968944,33
0.2,5152,-134,92039,17.86124587618863,169
0.2,5153,20,92059,17.861660845944897,81
0.2,5154,-238,91821,17.812027158098932,270
0.2,5155,63,91884,17.82079131109387,37
0.2,5156,26,91910,17.822377351173163,74
0.2,5157,88,91998,17.835982939123692,12
0.2,5158,45,92043,17.841248303934872,55
0.2,5159,79,92122,17.8531007751938,21
0.2,5160,94,92216,17.86785506684751,6
0.2,5161,40,92256,17.872142580395195,61
0.2,5162,35,92291,17.875460003873716,67
0.2,5163,35,92326,17.878776142525176,65
0.2,5164,-50,92276,17.86563407550823,150
0.2,5165,-51,92225,17.852303523035232,165
0.2,5166,90,92315,17.866266692471452,10
0.2,5167,40,92355,17.870549535603715,63
0.2,5168,91,92446,17.88469723350745,10
0.2,5169,82,92528,17.897098646034816,18
0.2,5170,52,92580,17.903693676271516,53
0.2,5171,71,92651,17.913959783449343,29
0.2,5172,41,92692,17.918422578774404,59
0.2,5173,-11,92681,17.91283339775802,112
0.2,5174,47,92728,17.918454106280194,55
0.2,5175,-128,92600,17.890262751159195,231
0.2,5176,66,92666,17.899555727255166,34
0.2,5177,63,92729,17.908265739667826,38
0.2,5178,29,92758,17.910407414558794,71
0.2,5179,93,92851,17.924903474903473,8
0.2,5180,57,92908,17.932445473846748,44
0.2,5181,49,92957,17.938440756464686,53
0.2,5182,-65,92892,17.92243874204129,167
0.2,5183,-19,92873,17.91531635802469,119
0.2,5184,24,92897,17.91648987463838,78
0.2,5185,85,92982,17.92942537601234,16
0.2,5186,-396,92586,17.849624060150376,365
0.2,5187,75,92661,17.8606399383192,26
0.2,5188,21,92682,17.861244941221816,80
0.2,5189,84,92766,17.87398843930636,16
0.2,5190,90,92856,17.887882874205356,11
0.2,5191,-24,92832,17.879815100154083,125
0.2,5192,12,92844,17.878682842287695,89
0.2,5193,91,92935,17.89276087793608,9
0.2,5194,-57,92878,17.878344562078922,160
0.2,5195,8,92886,17.876443418013857,93
0.2,5196,89,92975,17.890128920531076,11
0.2,5197,95,93070,17.9049634474798,6
0.2,5198,-13,93057,17.899019042123484,114
0.2,5199,91,93148,17.913076923076922,10
0.2,5200,-1,93147,17.909440492213037,101
0.2,5201,77,93224,17.92079969242599,24
0.2,5202,80,93304,17.932731116663465,21
0.2,5203,54,93358,17.93966179861645,47
0.2,5204,-6,93352,17.935062439961577,107
0.2,5205,77,93429,17.946407990779868,24
0.2,5206,75,93504,17.957365085461877,26
0.2,5207,14,93518,17.956605222734254,18
0.2,5208,28,93546,17.95853330773661,74
0.2,5209,80,93626,17.970441458733205,20
0.2,5210,-43,93583,17.958741124544233,156
0.2,5211,19,93602,17.958940905602457,81
0.2,5212,94,93696,17.97352771916363,6
0.2,5213,64,93760,17.982355197545072,37
0.2,5214,64,93824,17.99117929050815,37
0.2,5215,76,93900,18.00230061349693,24
0.2,5216,80,93980,18.01418439716312,21
0.2,5217,-6,93974,18.0095822154082,107
0.2,5218,-26,93948,18.001149645525963,128
0.2,5219,95,94043,18.015900383141762,6
0.2,5220,72,94115,18.026240183872822,28
0.2,5221,-170,93945,17.990233626962848,133
0.2,5222,81,94026,18.002297530155083,20
0.2,5223,22,94048,18.003062787136294,81
0.2,5224,-246,93802,17.952535885167464,213
0.2,5225,67,93869,17.961921163413702,33
0.2,5226,68,93937,17.97149416491295,32
0.2,5227,-20,93917,17.964231063504208,120
0.2,5228,74,93991,17.974947408682347,26
0.2,5229,85,94076,17.98776290630975,16
0.2,5230,67,94143,17.997132479449437,33
0.2,5231,77,94220,18.00840978593272,24
0.2,5232,-37,94183,17.997897955283776,141
0.2,5233,70,94253,18.00783339701949,30
0.2,5234,89,94342,18.02139446036294,12
0.2,5235,94,94436,18.03590527119939,7
0.2,5236,0,94436,18.032461332824138,101
0.2,5237,-45,94391,18.020427644138984,147
0.2,5238,84,94475,18.03302156900172,16
0.2,5239,54,94529,18.039885496183206,47
0.2,5240,49,94578,18.045792787635946,52
0.2,5241,83,94661,18.058183899275086,17
0.2,5242,48,94709,18.063894716765212,52
0.2,5243,-1,94708,18.060259344012206,33
0.2,5244,49,94757,18.06615824594852,54
0.2,5245,67,94824,18.075486084635912,33
0.2,5246,93,94917,18.08976558033162,7
0.2,5247,53,94970,18.09641768292683,47
0.2,5248,-78,94892,18.078110116212613,180
0.2,5249,-43,94849,18.06647619047619,168
0.2,5250,76,94925,18.07750904589602,25
0.2,5251,-335,94590,18.01028179741051,301
0.2,5252,80,94670,18.02208261945555,20
0.2,5253,3,94673,18.019223448800915,29
0.2,5254,-38,94635,18.008563273073264,143
0.2,5255,-87,94548,17.988584474885844,190
0.2,5256,31,94579,17.991059539661403,71
0.2,5257,-63,94516,17.97565614302016,165
0.2,5258,-34,94482,17.965772960638905,66
0.2,5259,24,94506,17.966920152091255,77
0.2,5260,4,94510,17.964265348793006,28
0.2,5261,32,94542,17.966932725199545,69
0.2,5262,83,94625,17.97928937868136,17
0.2,5263,-126,94499,17.951937689969604,161
0.2,5264,95,94594,17.966571699905032,6
0.2,5265,83,94677,17.978921382453475,18
0.2,5266,89,94766,17.992405543952913,11
0.2,5267,18,94784,17.992406985573272,83
0.2,5268,82,94866,18.004554944012146,18
0.2,5269,-34,94832,17.994686907020874,137
0.2,5270,28,94860,17.996585088218556,74
0.2,5271,80,94940,18.008345978755692,20
0.2,5272,13,94953,18.007396169163663,19
0.2,5273,92,95045,18.02142586272279,8
0.2,5274,78,95123,18.032796208530804,23
0.2,5275,-20,95103,18.025587566338135,53
0.2,5276,-131,94972,17.997346977449308,234
0.2,5277,81,95053,18.009283819628646,20
0.2,5278,66,95119,18.018374692176547,35
0.2,5279,83,95202,18.03068181818182,17
0.2,5280,57,95259,18.03806097330051,44
0.2,5281,-39,95220,18.02726240060583,142
0.2,5282,47,95267,18.032746545523377,54
0.2,5283,39,95306,18.03671461014383,63
0.2,5284,-1,95305,18.033112582781456,101
0.2,5285,-2,95303,18.02932273931139,33
0.2,5286,87,95390,18.042368072630982,14
0.2,5287,75,95465,18.053139183055976,25
0.2,5288,-12,95453,18.04745698619777,44
0.2,5289,26,95479,18.048960302457466,77
0.2,5290,85,95564,18.061614061614062,16
0.2,5291,-78,95486,18.043461829176113,181
0.2,5292,77,95563,18.054600415643304,23
0.2,5293,89,95652,18.068001511144693,12
0.2,5294,44,95696,18.07289896128423,58
0.2,5295,86,95782,18.0857250755287,14
0.2,5296,-120,95662,18.059656409288277,222
0.2,5297,-237,95425,18.011513778784447,343
0.2,5298,27,95452,18.01321003963012,74
0.2,5299,69,95521,18.022830188679244,31
0.2,5300,16,95537,18.022448594604793,84
0.2,5301,13,95550,18.021501320256508,90
0.2,5302,-96,95454,18.0,128
0.2,5303,85,95539,18.01263197586727,15
0.2,5304,95,95634,18.02714420358153,6
0.2,5305,82,95716,18.03920090463626,18
0.2,5306,6,95722,18.036932353495384,95
0.2,5307,58,95780,18.044461190655614,43
0.2,5308,40,95820,18.04859672254662,61
0.2,5309,68,95888,18.058003766478343,32
0.2,5310,92,95980,18.071926190924497,9
0.2,5311,52,96032,18.07831325301205,49
0.2,5312,52,96084,18.084697910784868,49
0.2,5313,61,96145,18.092773805043283,39
0.2,5314,15,96160,18.092191909689557,85
0.2,5315,-1,96159,18.08860045146727,102
0.2,5316,78,96237,18.099868346812112,23
0.2,5317,65,96302,18.10868747649492,36
0.2,5318,25,96327,18.109983079526227,76
0.2,5319,26,96353,18.111466165413535,76
0.2,5320,-54,96299,18.09791392595377,158
0.2,5321,70,96369,18.107666290868096,31
0.2,5322,64,96433,18.116287807627277,36
0.2,5323,-105,96328,18.093163035311797,207
0.2,5324,89,96417,18.106478873239436,12
0.2,5325,70,96487,18.116222305670295,31
0.2,5326,88,96575,18.1293410925474,13
0.2,5327,-68,96507,18.113175675675677,170
0.2,5328,57,96564,18.120472884218426,43
0.2,5329,33,96597,18.12326454033771,67
0.2,5330,46,96643,18.12849371600075,55
0.2,5331,75,96718,18.139159789947488,25
0.2,5332,-1,96717,18.135570973185825,102
0.2,5333,91,96808,18.14923134608174,10
0.2,5334,52,96860,18.155576382380506,48
0.2,5335,60,96920,18.163418290854572,40
0.2,5336,53,96973,18.16994566235713,48
0.2,5337,-13,96960,18.164106406893968,117
0.2,5338,37,96997,18.167634388462258,64
0.2,5339,-91,96906,18.147191011235954,125
0.2,5340,94,97000,18.161392997565997,7
0.2,5341,-28,96972,18.152751778360166,64
0.2,5342,57,97029,18.16002245929253,43
0.2,5343,34,97063,18.162986526946106,75
0.2,5344,89,97152,18.17623947614593,12
0.2,5345,33,97185,18.179012345679013,68
0.2,5346,93,97278,18.19300542360202,8
0.2,5347,76,97354,18.20381451009723,26
0.2,5348,80,97434,18.215367358384746,21
0.2,5349,55,97489,18.222242990654205,45
0.2,5350,73,97562,18.23247991029714,28
0.2,5351,57,97619,18.239723467862483,44
0.2,5352,44,97663,18.24453577433215,56
0.2,5353,88,97751,18.257564437803513,12
0.2,5354,22,97773,18.258263305322128,78
0.2,5355,43,97816,18.26288274831964,57
0.2,5356,75,97891,18.27347395930558,26
0.2,5357,-81,97810,18.254945875326616,190
0.2,5358,69,97879,18.26441500279903,31
0.2,5359,-46,97833,18.25242537313433,146
0.2,5360,8,97841,18.250512963999252,95
0.2,5361,40,97881,18.254569190600524,60
0.2,5362,-127,97754,18.227484616818945,159
0.2,5363,41,97795,18.23173005219985,67
0.2,5364,45,97840,18.236719478098788,55
0.2,5365,52,97892,18.24301155423034,49
0.2,5366,82,97974,18.25489100055897,18
0.2,5367,-43,97931,18.243479880774963,146
0.2,5368,80,98011,18.254982305829763,20
0.2,5369,62,98073,18.26312849162011,40
0.2,5370,88,98161,18.276112455781046,12
0.2,5371,15,98176,18.275502606105732,88
0.2,5372,26,98202,18.276940256839755,77
0.2,5373,27,98229,18.278563453665797,74
0.2,5374,70,98299,18.288186046511626,31
0.2,5375,-8,98291,18.28329613095238,111
0.2,5376,85,98376,18.295703924121256,16
0.2,5377,81,98457,18.307363332093715,20
0.2,5378,91,98548,18.32087748652166,9
0.2,5379,63,98611,18.32918215613383,37
0.2,5380,87,98698,18.341943876602862,14
0.2,5381,54,98752,18.348569305091043,49
0.2,5382,68,98820,18.357793052201373,32
0.2,5383,74,98894,18.36812778603269,26
0.2,5384,90,98984,18.38142989786444,10
0.2,5385,-105,98879,18.358522094318605,209
0.2,5386,21,98900,18.359012437349175,11
0.2,5387,82,98982,18.370824053452115,19
0.2,5388,87,99069,18.383559101874187,13
0.2,5389,-45,99024,18.371799628942487,148
0.2,5390,44,99068,18.376553515117788,57
0.2,5391,-160,98908,18.34347181008902,193
0.2,5392,60,98968,18.351195994808084,40
0.2,5393,95,99063,18.365406006674082,6
0.2,5394,-102,98961,18.34309545875811,137
0.2,5395,47,99008,18.348406226834694,54
0.2,5396,73,99081,18.35853251806559,27
0.2,5397,57,99138,18.365690996665432,44
0.2,5398,0,99138,18.36228931283571,101
0.2,5399,88,99226,18.375185185185185,12
0.2,5400,60,99286,18.382892057026478,41
0.2,5401,90,99376,18.396149574231767,10
0.2,5402,-9,99367,18.391079030168424,112
0.2,5403,-91,99276,18.370836417468542,134
0.2,5404,-36,99240,18.36077705827937,136
0.2,5405,49,99289,18.36644469108398,51
0.2,5406,-8,99281,18.361568337340486,109
0.2,5407,-127,99154,18.334689349112427,262
0.2,5408,55,99209,18.341467923830653,53
0.2,5409,72,99281,18.351386321626617,28
0.2,5410,84,99365,18.36351875808538,16
0.2,5411,-428,98937,18.281042128603104,253
0.2,5412,53,98990,18.287456124145574,47
0.2,5413,-28,98962,18.27890653860362,130
0.2,5414,59,99021,18.286426592797785,44
0.2,5415,-17,99004,18.279911373707534,127
0.2,5416,92,99096,18.293520398744693,8
0.2,5417,-46,99050,18.281653746770026,79
0.2,5418,-187,98863,18.243771913637204,291
0.2,5419,92,98955,18.25738007380074,8
0.2,5420,92,99047,18.270983213429258,8
0.2,5421,62,99109,18.279048321652528,39
0.2,5422,47,99156,18.28434445878665,54
0.2,5423,82,99238,18.296091445427727,18
0.2,5424,46,99284,18.301198156682027,54
0.2,5425,-34,99250,18.291559159601917,66
0.2,5426,31,99281,18.29390086604017,71
0.2,5427,45,99326,18.29882092851879,57
0.2,5428,-222,99104,18.254558850617055,324
0.2,5429,58,99162,18.261878453038673,43
0.2,5430,-37,99125,18.25170318541705,68
0.2,5431,24,99149,18.25276141384389,77
0.2,5432,-6,99143,18.248297441560833,38
0.2,5433,26,99169,18.249723960250275,74
0.2,5434,64,99233,18.258141674333025,36
0.2,5435,77,99310,18.268947755702722,23
0.2,5436,90,99400,18.2821408865183,11
0.2,5437,56,99456,18.289076866495034,45
0.2,5438,74,99530,18.299319727891156,27
0.2,5439,92,99622,18.312867647058823,9
0.2,5440,28,99650,18.31464804263922,74
0.2,5441,11,99661,18.313303932377803,23
0.2,5442,-55,99606,18.299834650009185,156
0.2,5443,-44,99562,18.288390889052167,158
0.2,5444,59,99621,18.29586776859504,41
0.2,5445,74,99695,18.306096217407273,26
0.2,5446,33,99728,18.30879383146686,67
0.2,5447,79,99807,18.319933920704845,21
0.2,5448,47,99854,18.325197283905304,54
0.2,5449,-418,99436,18.2451376146789,522
0.2,5450,91,99527,18.258484681709778,10
0.2,5451,-33,99494,18.249082905355834,64
0.2,5452,89,99583,18.262057582981846,12
0.2,5453,-52,99531,18.24917491749175,156
0.2,5454,58,99589,18.25646196150321,43
0.2,5455,67,99656,18.265395894428153,33
0.2,5456,77,99733,18.276159061755543,23
0.2,5457,47,99780,18.28142176621473,54
0.2,5458,89,99869,18.294376259388166,11
0.2,5459,79,99948,18.305494505494504,22
0.2,5460,78,100026,18.316425563083683,22
0.2,5461,-9,100017,18.31142438667155,109
0.2,5462,86,100103,18.323814753798278,14
0.2,5463,-12,100091,18.318265007320644,114
0.2,5464,-49,100042,18.30594693504117,150
0.2,5465,75,100117,18.3163190633004,25
0.2,5466,92,100209,18.32979696359978,8
0.2,5467,-26,100183,18.321689831748355,127
0.2,5468,45,100228,18.326567928323275,59
0.2,5469,-44,100184,18.315173674588664,149
0.2,5470,-73,100111,18.298482909888502,176
0.2,5471,73,100184,18.308479532163744,27
0.2,5472,44,100228,18.313173762104878,57
0.2,5473,47,100275,18.31841432225064,56
0.2,5474,55,100330,18.325114155251143,46
0.2,5475,78,100408,18.33601168736304,22
0.2,5476,89,100497,18.348913638853386,11
0.2,5477,71,100568,18.35852500912742,29
0.2,5478,84,100652,18.370505566709255,17
0.2,5479,61,100713,18.378284671532846,40
0.2,5480,15,100728,18.37766830870279,86
0.2,5481,-5,100723,18.373403867201752,109
0.2,5482,-10,100713,18.36822907167609,111
0.2,5483,-83,100630,18.349744711889134,188
0.2,5484,-90,100540,18.329990884229716,192
0.2,5485,86,100626,18.342325920524974,14
0.2,5486,35,100661,18.345361764169855,66
0.2,5487,-26,100635,18.33728134110787,58
0.2,5488,-40,100595,18.326653306613228,154
0.2,5489,59,100654,18.334061930783243,42
0.2,5490,60,100714,18.34164997268257,40
0.2,5491,91,100805,18.354879825200292,10
0.2,5492,69,100874,18.364099763335155,32
0.2,5493,89,100963,18.376956680014562,11
0.2,5494,69,101032,18.38616924476797,33
0.2,5495,64,101096,18.394468704512374,36
0.2,5496,55,101151,18.401127887938877,45
0.2,5497,18,101169,18.401054929065115,13
0.2,5498,38,101207,18.404619021640297,63
0.2,5499,56,101263,18.411454545454546,45
0.2,5500,90,101353,18.424468278494817,10
0.2,5501,75,101428,18.434750999636496,26
0.2,5502,27,101455,18.43630746865346,73
0.2,5503,65,101520,18.444767441860463,35
0.2,5504,-151,101369,18.41398728428701,262
0.2,5505,-227,101142,18.369415183436253,263
0.2,5506,34,101176,18.372253495551117,67
0.2,5507,92,101268,18.38562091503268,9
0.2,5508,-77,101191,18.368306407696497,177
0.2,5509,6,101197,18.36606170598911,95
0.2,5510,45,101242,18.370894574487387,56
0.2,5511,19,101261,18.37100870827286,81
0.2,5512,-6,101255,18.366588064574643,107
0.2,5513,-18,101237,18.359992745738122,118
0.2,5514,-87,101150,18.340888485947417,122
0.2,5515,94,101244,18.354604786076866,7
0.2,5516,84,101328,18.366503534529635,17
0.2,5517,95,101423,18.38039144617615,6
0.2,5518,-32,101391,18.371262909947454,136
0.2,5519,13,101404,18.370289855072464,87
0.2,5520,87,101491,18.38272052164463,13
0.2,5521,89,101580,18.395508873596523,11
0.2,5522,-322,101258,18.333876516386024,284
0.2,5523,-10,101248,18.328747284576394,41
0.2,5524,-4,101244,18.32470588235294,105
0.2,5525,-5,101239,18.3204849800941,105
0.2,5526,9,101248,18.31879862493215,103
0.2,5527,-21,101227,18.31168596237337,122
0.2,5528,-86,101141,18.292819678061132,190
0.2,5529,39,101180,18.296564195298373,62
0.2,5530,31,101211,18.298860965467366,69
0.2,5531,-66,101145,18.28362255965293,101
0.2,5532,92,101237,18.296945599132478,9
0.2,5533,-82,101155,18.27882182869534,183
0.2,5534,-47,101108,18.26702800361337,79
0.2,5535,57,101165,18.27402456647399,43
0.2,5536,68,101233,18.283005237493228,33
0.2,5537,58,101291,18.290176959191044,42
0.2,5538,-93,101198,18.270084852861526,194
0.2,5539,-14,101184,18.264259927797834,45
0.2,5540,51,101235,18.270167839740118,50
0.2,5541,-1,101234,18.2666907253699,103
0.2,5542,-12,101222,18.261230380660294,113
0.2,5543,9,101231,18.259559884559884,23
0.2,5544,-86,101145,18.240757439134356,192
0.2,5545,14,101159,18.239992787594662,17
0.2,5546,-363,100796,18.1712637461691,263
0.2,5547,-95,100701,18.15086517664023,127
0.2,5548,83,100784,18.162551811137142,18
0.2,5549,88,100872,18.175135135135136,12
0.2,5550,52,100924,18.181228607458117,49
0.2,5551,19,100943,18.181376080691642,82
0.2,5552,47,100990,18.186565820277327,54
0.2,5553,-282,100708,18.13251710478934,317
0.2,5554,24,100732,18.133573357335734,77
0.2,5555,7,100739,18.131569474442045,95
0.2,5556,61,100800,18.139283786215582,39
0.2,5557,82,100882,18.15077365958978,18
0.2,5558,-97,100785,18.130059363194817,129
0.2,5559,54,100839,18.136510791366906,48
0.2,5560,-7,100832,18.131990649163818,108
0.2,5561,46,100878,18.13700107874865,55
0.2,5562,-265,100613,18.086104619809454,300
0.2,5563,82,100695,18.09759166067577,19
0.2,5564,86,100781,18.109793351302784,14
0.2,5565,83,100864,18.121451670858786,17
0.2,5566,-4,100860,18.117477995329622,35
0.2,5567,43,100903,18.12194683908046,59
0.2,5568,94,100997,18.135571915963368,7
0.2,5569,10,101007,18.13411131059246,90
0.2,5570,-47,100960,18.122419673308205,150
0.2,5571,95,101055,18.1362167982771,6
0.2,5572,-35,101020,18.126682217835995,138
0.2,5573,-37,100983,18.116792249730892,138
0.2,5574,75,101058,18.126995515695068,25
0.2,5575,91,101149,18.14006456241033,10
0.2,5576,-51,101098,18.12766720459028,156
0.2,5577,55,101153,18.13427751882395,58
0.2,5578,-14,101139,18.128517655493816,114
0.2,5579,67,101206,18.13727598566308,34
0.2,5580,73,101279,18.147106253359613,28
0.2,5581,-52,101227,18.13453959154425,152
0.2,5582,27,101254,18.13612753000179,76
0.2,5583,-18,101236,18.129656160458453,121
0.2,5584,81,101317,18.140913160250673,19
0.2,5585,79,101396,18.151808091657717,22
0.2,5586,71,101467,18.16126722749239,30
0.2,5587,-11,101456,18.156048675733715,112
0.2,5588,40,101496,18.159957058507782,61
0.2,5589,-20,101476,18.15313059033989,120
0.2,5590,57,101533,18.160078697907352,43
0.2,5591,91,101624,18.17310443490701,9
0.2,5592,-86,101538,18.154478812801717,186
0.2,5593,-120,101418,18.129781909188416,246
0.2,5594,5,101423,18.127435210008937,96
0.2,5595,-76,101347,18.11061472480343,108
0.2,5596,75,101422,18.12077898874397,26
0.2,5597,93,101515,18.13415505537692,8
0.2,5598,-45,101470,18.12287908555099,148
0.2,5599,79,101549,18.13375,21
0.2,5600,39,101588,18.137475450812357,62
0.2,5601,-146,101442,18.108175651553015,179
0.2,5602,-28,101414,18.099946457255044,128
0.2,5603,-291,101123,18.04478943611706,330
0.2,5604,57,101180,18.051739518287242,44
0.2,5605,67,101247,18.06047092400999,34
0.2,5606,92,101339,18.073657927590514,9
0.2,5607,77,101416,18.08416547788873,49
0.2,5608,83,101499,18.09573899090747,18
0.2,5609,82,101581,18.107130124777182,19
0.2,5610,-37,101544,18.097308857601142,69
0.2,5611,66,101610,18.10584461867427,35
0.2,5612,78,101688,18.116515232495992,22
0.2,5613,46,101734,18.121482009262557,56
0.2,5614,82,101816,18.13285841495993,19
0.2,5615,26,101842,18.13425925925926,74
0.2,5616,78,101920,18.144917215595513,22
0.2,5617,80,102000,18.155927376290496,22
0.2,5618,-11,101989,18.150738565581065,111
0.2,5619,84,102073,18.162455516014234,17
0.2,5620,10,102083,18.161003380181462,90
0.2,5621,23,102106,18.161864105300605,9
0.2,5622,46,102152,18.166814867508446,55
0.2,5623,70,102222,18.176031294452347,31
0.2,5624,68,102290,18.18488888888889,33
0.2,5625,-216,102074,18.143263419836472,248
0.2,5626,66,102140,18.151768260174162,34
0.2,5627,-119,102021,18.127398720682304,82
0.2,5628,85,102106,18.139278735121692,15
0.2,5629,52,102158,18.145293072824156,48
0.2,5630,93,102251,18.158586396732375,7
0.2,5631,84,102335,18.170276988636363,17
0.2,5632,75,102410,18.18036570211255,27
0.2,5633,72,102482,18.18991835285765,28
0.2,5634,-15,102467,18.184028393966283,46
0.2,5635,87,102554,18.196238466997873,14
0.2,5636,-14,102540,18.19052687599787,114
0.2,5637,92,102632,18.20361830436325,9
0.2,5638,-17,102615,18.197375421173966,119
0.2,5639,3,102618,18.19468085106383,28
0.2,5640,51,102669,18.200496365892572,50
0.2,5641,58,102727,18.207550514002126,50
0.2,5642,89,102816,18.220095693779903,12
0.2,5643,-19,102797,18.21350106307583,121
0.2,5644,18,102815,18.21346324180691,84
0.2,5645,-69,102746,18.198016294721928,102
0.2,5646,40,102786,18.20187710288649,61
0.2,5647,-92,102694,18.182365439093484,194
0.2,5648,-76,102618,18.165693043016464,178
0.2,5649,-321,102297,18.10566371681416,353
0.2,5650,72,102369,18.115200849407184,29
0.2,5651,-149,102220,18.08563340410474,261
0.2,5652,42,102262,18.089863789138512,60
0.2,5653,79,102341,18.100636717368236,22
0.2,5654,-187,102154,18.064367816091956,221
0.2,5655,73,102227,18.07408062234795,27
0.2,5656,32,102259,18.0765423369277,70
0.2,5657,55,102314,18.08306822198657,46
0.2,5658,-1,102313,18.07969605937445,101
0.2,5659,62,102375,18.08745583038869,39
0.2,5660,77,102452,18.097862568450804,24
0.2,5661,72,102524,18.107382550335572,29
0.2,5662,53,102577,18.11354405791983,47
0.2,5663,19,102596,18.11370056497175,84
0.2,5664,81,102677,18.12480141218005,20
0.2,5665,84,102761,18.136427815037063,16
0.2,5666,-98,102663,18.11593435680254,130
0.2,5667,93,102756,18.129146083274524,8
0.2,5668,-29,102727,18.12083259834186,61
0.2,5669,77,102804,18.13121693121693,24
0.2,5670,91,102895,18.144066302239462,10
0.2,5671,8,102903,18.1422778561354,92
0.2,5672,41,102944,18.146307068570422,59
0.2,5673,79,103023,18.157032076136765,22
0.2,5674,30,103053,18.15911894273128,71
0.2,5675,34,103087,18.161909795630727,67
0.2,5676,-147,102940,18.13281662850097,179
0.2,5677,10,102950,18.131384290243044,91
0.2,5678,-13,102937,18.125902447614017,114
0.2,5679,91,103028,18.138732394366198,10
0.2,5680,70,103098,18.14786129202605,31
0.2,5681,14,103112,18.14713129179866,17
0.2,5682,83,103195,18.158543023051205,17
0.2,5683,31,103226,18.160802251935255,70
0.2,5684,1,103227,18.15778364116095,99
0.2,5685,18,103245,18.157755891663736,83
0.2,5686,84,103329,18.16933356778618,17
0.2,5687,48,103377,18.17457805907173,54
0.2,5688,71,103448,18.18386359641413,30
0.2,5689,70,103518,18.192970123022846,46
0.2,5690,-208,103310,18.15322438938675,242
0.2,5691,-26,103284,18.145467322557977,126
0.2,5692,58,103342,18.152467943088002,42
0.2,5693,49,103391,18.157885493501933,51
0.2,5694,-102,103289,18.136786654960492,136
0.2,5695,-6,103283,18.13254915730337,106
0.2,5696,89,103372,18.14498859048622,12
0.2,5697,57,103429,18.15180765180765,44
0.2,5698,41,103470,18.155816809966662,60
0.2,5699,9,103479,18.15421052631579,92
0.2,5700,-94,103385,18.134537800385896,126
0.2,5701,58,103443,18.141529287969135,43
0.2,5702,-351,103092,18.076801683324565,387
0.2,5703,88,103180,18.0890603085554,12
0.2,5704,76,103256,18.099211218229623,24
0.2,5705,66,103322,18.107606028741674,35
0.2,5706,49,103371,18.113019099351675,52
0.2,5707,54,103425,18.119306236860545,46
0.2,5708,76,103501,18.129444736381153,25
0.2,5709,-47,103454,18.118038528896673,150
0.2,5710,72,103526,18.12747329714586,28
0.2,5711,68,103594,18.136204481792717,33
0.2,5712,-59,103535,18.12270260808682,161
0.2,5713,88,103623,18.13493174658733,12
0.2,5714,16,103639,18.134558180227472,85
0.2,5715,59,103698,18.141707487753674,42
0.2,5716,-46,103652,18.130488018191357,79
0.2,5717,68,103720,18.13920951381602,32
0.2,5718,54,103774,18.14547997901731,49
0.2,5719,91,103865,18.158216783216783,9
0.2,5720,-17,103848,18.15207131620346,117
0.2,5721,-308,103540,18.09507165326809,341
0.2,5722,95,103635,18.10850952297746,6
0.2,5723,-19,103616,18.102026554856742,52
0.2,5724,20,103636,18.10235807860262,12
0.2,5725,-6,103630,18.09814879497031,108
0.2,5726,9,103639,18.09656015365811,93
0.2,5727,-145,103494,18.06808659217877,177
0.2,5728,23,103517,18.068947460289753,78
0.2,5729,89,103606,18.081326352530542,12
0.2,5730,29,103635,18.08323154772291,74
0.2,5731,81,103716,18.09420795533845,20
0.2,5732,18,103734,18.09419152276295,83
0.2,5733,-173,103561,18.06086501569585,207
0.2,5734,89,103650,18.07323452484743,12
0.2,5735,36,103686,18.076359832635983,64
0.2,5736,87,103773,18.088373714484923,14
0.2,5737,-15,103758,18.08260718020216,46
0.2,5738,39,103797,18.086251960271824,63
0.2,5739,-11,103786,18.081184668989547,43
0.2,5740,82,103868,18.092318411426582,19
0.2,5741,-303,103565,18.03639846743295,340
0.2,5742,-272,103293,17.985895873236984,236
0.2,5743,-13,103280,17.98050139275766,116
0.2,5744,6,103286,17.978416013925152,96
0.2,5745,75,103361,17.988339714584058,26
0.2,5746,90,103451,18.00087001914042,10
0.2,5747,87,103538,18.01287404314544,13
0.2,5748,65,103603,18.021047138632806,35
0.2,5749,18,103621,18.021043478260868,82
0.2,5750,93,103714,18.034081029386194,8
0.2,5751,-97,103617,18.014082058414466,129
0.2,5752,35,103652,18.017034590648358,66
0.2,5753,-41,103611,18.006777893639207,143
0.2,5754,4,103615,18.004344048653344,98
0.2,5755,69,103684,18.01320361362057,31
0.2,5756,57,103741,18.019975681778703,43
0.2,5757,72,103813,18.029350468912817,28
0.2,5758,44,103857,18.033860045146728,56
0.2,5759,-148,103709,18.005034722222224,249
0.2,5760,-9,103700,18.00034716195105,112
0.2,5761,87,103787,18.012322110378342,13
0.2,5762,-259,103528,17.96425472844005,362
0.2,5763,90,103618,17.97675225537821,10
0.2,5764,63,103681,17.984562012142238,37
0.2,5765,-12,103669,17.979361775927853,112
0.2,5766,92,103761,17.992196982833363,8
0.2,5767,-137,103624,17.965325936199722,169
0.2,5768,85,103709,17.976945744496447,15
0.2,5769,61,103770,17.984402079722702,40
0.2,5770,-103,103667,17.963437879050424,205
0.2,5771,-7,103660,17.95911295911296,109
0.2,5772,50,103710,17.9646630867833,50
0.2,5773,86,103796,17.97644613785937,14
0.2,5774,57,103853,17.983203463203463,44
0.2,5775,89,103942,17.99549861495845,11
0.2,5776,84,104026,18.00692400900121,16
0.2,5777,62,104088,18.01453790238837,54
0.2,5778,83,104171,18.025783007440733,17
0.2,5779,58,104229,18.032698961937715,44
0.2,5780,-35,104194,18.023525341636397,136
0.2,5781,90,104284,18.035973711518505,10
0.2,5782,82,104366,18.047034411205257,19
0.2,5783,-165,104201,18.01538727524205,127
0.2,5784,11,104212,18.01417458945549,21
0.2,5785,58,104270,18.021085378499826,43
0.2,5786,26,104296,18.02246414377052,76
0.2,5787,84,104380,18.033863165169315,16
0.2,5788,-30,104350,18.025565728105025,132
0.2,5789,81,104431,18.03644214162349,20
0.2,5790,59,104490,18.0435158003799,41
0.2,5791,47,104537,18.048515193370164,54
0.2,5792,2,104539,18.045744864491628,98
0.2,5793,-235,104304,18.002071108042802,200
0.2,5794,-100,104204,17.981708369283865,203
0.2,5795,57,104261,17.988440303657693,44
0.2,5796,3,104264,17.985854752458167,97
0.2,5797,-137,104127,17.95912383580545,245
0.2,5798,76,104203,17.96913260907053,25
0.2,5799,-64,104139,17.955,97
0.2,5800,20,104159,17.95535252542665,81
0.2,5801,92,104251,17.968114443295416,9
0.2,5802,-97,104154,17.948302602102363,131
0.2,5803,-22,104132,17.94141971054445,125
0.2,5804,46,104178,17.94625322997416,55
0.2,5805,-160,104018,17.915604547020322,260
0.2,5806,2,104020,17.912863785086962,99
0.2,5807,26,104046,17.914256198347108,75
0.2,5808,95,104141,17.927526252367016,6
0.2,5809,73,104214,17.937005163511188,28
0.2,5810,58,104272,17.943899500946483,42
0.2,5811,42,104314,17.94803854094976,59
0.2,5812,88,104402,17.960089454670566,12
0.2,5813,86,104488,17.971792225662195,14
0.2,5814,89,104577,17.98400687876182,12
0.2,5815,13,104590,17.983149931224208,87
0.2,5816,19,104609,17.983324737837375,111
0.2,5817,41,104650,17.98728085252664,66
0.2,5818,82,104732,17.998281491665235,18
0.2,5819,-21,104711,17.991580756013747,121
0.2,5820,7,104718,17.98969249269885,24
0.2,5821,66,104784,17.997938852627964,35
0.2,5822,90,104874,18.010303967027305,11
0.2,5823,14,104888,18.009615384615383,87
0.2,5824,19,104907,18.00978540772532,84
0.2,5825,2,104909,18.007037418468933,98
0.2,5826,93,105002,18.019907327956066,8
0.2,5827,84,105086,18.031228551818806,16
0.2,5828,89,105175,18.04340367129868,12
0.2,5829,60,105235,18.050600343053173,41
0.2,5830,-68,105167,18.03584290859201,100
0.2,5831,12,105179,18.034807956104252,88
0.2,5832,93,105272,18.047659866278075,8
0.2,5833,-115,105157,18.024854302365444,147
0.2,5834,23,105180,18.025706940874034,77
0.2,5835,52,105232,18.031528444139823,51
0.2,5836,-64,105168,18.017474730169607,107
0.2,5837,-74,105094,18.00171291538198,107
0.2,5838,-170,104924,17.969515327967116,205
0.2,5839,75,104999,17.979280821917808,25
0.2,5840,89,105088,17.991439821948298,12
0.2,5841,47,105135,17.99640534063677,53
0.2,5842,-35,105100,17.98733527297621,138
0.2,5843,84,105184,17.998631074606433,17
0.2,5844,-15,105169,17.992985457656115,47
0.2,5845,29,105198,17.994868286007527,71
0.2,5846,55,105253,18.001197195142808,66
0.2,5847,74,105327,18.01077291381669,27
0.2,5848,55,105382,18.017096939647804,46
0.2,5849,57,105439,18.023760683760685,43
0.2,5850,75,105514,18.03349854725688,26
0.2,5851,-179,105335,17.999829118250172,283
0.2,5852,-143,105192,17.9723218862122,181
0.2,5853,-65,105127,17.95814827468398,110
0.2,5854,26,105153,17.959521776259606,75
0.2,5855,76,105229,17.96943306010929,24
0.2,5856,17,105246,17.969267543110806,15
0.2,5857,32,105278,17.97166268350973,68
0.2,5858,93,105371,17.98446833930705,7
0.2,5859,-79,105292,17.9679180887372,182
0.2,5860,-51,105241,17.95615082750384,83
0.2,5861,-6,105235,17.952064141931082,106
0.2,5862,7,105242,17.950196145318095,95
0.2,5863,45,105287,17.95480900409277,58
0.2,5864,58,105345,17.9616368286445,44
0.2,5865,85,105430,17.97306512103648,15
0.2,5866,-165,105265,17.941878302369183,265
0.2,5867,14,105279,17.94120654396728,86
0.2,5868,94,105373,17.95416595672176,7
0.2,5869,59,105432,17.96115843270869,42
0.2,5870,22,105454,17.96184636348152,78
0.2,5871,22,105476,17.962534059945504,79
0.2,5872,95,105571,17.975651285544014,6
0.2,5873,78,105649,17.985869935308138,23
0.2,5874,-117,105532,17.962893617021276,220
0.2,5875,-310,105222,17.9070796460177,343
0.2,5876,25,105247,17.908286540752083,75
0.2,5877,42,105289,17.912385165022116,58
0.2,5878,-90,105199,17.894029596870215,125
0.2,5879,-178,105021,17.860714285714284,215
0.2,5880,73,105094,17.870090120727767,28
0.2,5881,93,105187,17.882862971778305,7
0.2,5882,37,105224,17.88611252762196,65
0.2,5883,54,105278,17.892250169952412,48
0.2,5884,-225,105053,17.850977060322855,329
0.2,5885,47,105100,17.855929323819232,53
0.2,5886,-63,105037,17.84219466621369,95
0.2,5887,-117,104920,17.81929347826087,81
0.2,5888,75,104995,17.82900322635422,26
0.2,5889,-13,104982,17.82376910016978,45
0.2,5890,-2,104980,17.820404006111016,102
0.2,5891,-98,104882,17.800746775288527,132
0.2,5892,-268,104614,17.752248430341083,379
0.2,5893,93,104707,17.765015269765865,8
0.2,5894,91,104798,17.7774385072095,10
0.2,5895,59,104857,17.78443012211669,41
0.2,5896,57,104914,17.791080210276412,44
0.2,5897,60,104974,17.798236690403527,54
0.2,5898,-30,104944,17.79013392100356,61
0.2,5899,-50,104894,17.77864406779661,157
0.2,5900,5,104899,17.776478562955432,96
0.2,5901,77,104976,17.78651304642494,24
0.2,5902,14,104990,17.785871590716585,21
0.2,5903,-9,104981,17.781334688346885,109
0.2,5904,70,105051,17.79017781541067,31
0.2,5905,-37,105014,17.780900778868947,71
0.2,5906,69,105083,17.789571694599626,31
0.2,5907,28,105111,17.791299932295193,72
0.2,5908,-46,105065,17.780504315451008,149
0.2,5909,-37,105028,17.771235194585447,141
0.2,5910,94,105122,17.78413128066317,7
0.2,5911,61,105183,17.791441136671178,39
0.2,5912,16,105199,17.791138170133603,85
0.2,5913,36,105235,17.794217111937776,66
0.2,5914,51,105286,17.799830938292477,51
0.2,5915,94,105380,17.812711291413116,6
0.2,5916,-138,105242,17.786378232212268,170
0.2,5917,84,105326,17.797566745522136,16
0.2,5918,87,105413,17.809258320662273,13
0.2,5919,68,105481,17.817736486486485,32
0.2,5920,28,105509,17.81945617294376,75
0.2,5921,68,105577,17.827929753461667,32
0.2,5922,-133,105444,17.802464967077494,167
0.2,5923,28,105472,17.804186360567183,72
0.2,5924,-121,105351,17.780759493670885,156
0.2,5925,86,105437,17.792271346608167,14
0.2,5926,67,105504,17.800573646026656,33
0.2,5927,78,105582,17.810728744939272,23
0.2,5928,41,105623,17.814639905548997,63
0.2,5929,72,105695,17.823777403035415,28
0.2,5930,74,105769,17.83324903051762,26
0.2,5931,45,105814,17.837828725556303,55
0.2,5932,85,105899,17.849148828585875,15
0.2,5933,29,105928,17.851027974384902,71
0.2,5934,73,106001,17.860320134793596,28
0.2,5935,74,106075,17.869777628032345,27
0.2,5936,-248,105827,17.824995789119082,287
0.2,5937,63,105890,17.832603570225665,37
0.2,5938,3,105893,17.83010607846439,98
0.2,5939,7,105900,17.828282828282827,96
0.2,5940,64,105964,17.836054536273355,39
0.2,5941,-151,105813,17.807640525075733,215
0.2,5942,-50,105763,17.7962308598351,154
0.2,5943,41,105804,17.80013458950202,60
0.2,5944,76,105880,17.809924306139614,24
0.2,5945,66,105946,17.818028927009756,34
0.2,5946,80,106026,17.828484950395158,20
0.2,5947,-110,105916,17.806993947545394,142
0.2,5948,-119,105797,17.783997310472348,151
0.2,5949,92,105889,17.796470588235294,9
0.2,5950,90,105979,17.80860359603428,11
0.2,5951,45,106024,17.813172043010752,56
0.2,5952,61,106085,17.820426675625736,39
0.2,5953,-62,106023,17.807020490426606,163
0.2,5954,36,106059,17.81007556675063,65
0.2,5955,76,106135,17.81984553391538,24
0.2,5956,-45,106090,17.809299983213027,78
0.2,5957,-3,106087,17.80580731789191,104
0.2,5958,27,106114,17.807350226548078,74
0.2,5959,-129,105985,17.78271812080537,162
0.2,5960,88,106073,17.794497567522228,13
0.2,5961,93,106166,17.80711170748071,8
0.2,5962,-112,106054,17.785342948180446,144
0.2,5963,9,106063,17.78386988598256,92
0.2,5964,43,106106,17.788097233864207,58
0.2,5965,-96,106010,17.769024472008045,198
0.2,5966,54,106064,17.775096363331656,46
0.2,5967,77,106141,17.785020107238605,23
0.2,5968,-64,106077,17.77131847880717,169
0.2,5969,-19,106058,17.765159128978226,50
0.2,5970,87,106145,17.776754312510466,13
0.2,5971,94,106239,17.789517749497655,7
0.2,5972,70,106309,17.798258831408003,31
0.2,5973,88,106397,17.810010043521928,12
0.2,5974,94,106491,17.82276150627615,7
0.2,5975,-50,106441,17.811412315930387,112
0.2,5976,-27,106414,17.80391500752886,130
0.2,5977,26,106440,17.80528604884577,75
0.2,5978,70,106510,17.81401572169259,31
0.2,5979,56,106566,17.820401337792642,44
0.2,5980,32,106598,17.82277211168701,68
0.2,5981,12,106610,17.8217987295219,102
0.2,5982,-180,106430,17.788734748453955,211
0.2,5983,49,106479,17.793950534759357,52
0.2,5984,82,106561,17.8046783625731,18
0.2,5985,74,106635,17.814066154360173,33
0.2,5986,-92,106543,17.79572406881577,126
0.2,5987,19,106562,17.795925183700735,82
0.2,5988,63,106625,17.803473033895475,38
0.2,5989,91,106716,17.81569282136895,9
0.2,5990,29,106745,17.8175596728426,74
0.2,5991,18,106763,17.817590120160215,82
0.2,5992,84,106847,17.828633405639913,17
0.2,5993,78,106925,17.838672005338672,23
0.2,5994,60,106985,17.845704753961634,41
0.2,5995,44,107029,17.850066711140762,56
0.2,5996,-36,106993,17.8410872102718,68
0.2,5997,95,107088,17.8539513171057,6
0.2,5998,47,107135,17.858809801633605,53
0.2,5999,-137,106998,17.833,100
0.2,6000,54,107052,17.839026828861858,47
0.2,6001,-46,107006,17.828390536487838,148
0.2,6002,-295,106711,17.776278527402965,265
0.2,6003,90,106801,17.788307794803465,10
0.2,6004,-140,106661,17.76203164029975,246
0.2,6005,86,106747,17.773393273393275,14
0.2,6006,-90,106657,17.75545197269852,211
0.2,6007,-384,106273,17.68858189081225,420
0.2,6008,48,106321,17.693626227325677,68
0.2,6009,41,106362,17.69750415973378,66
0.2,6010,41,106403,17.70138080186325,72
0.2,6011,-1,106402,17.69827012641384,112
0.2,6012,26,106428,17.69965075669383,6
0.2,6013,83,106511,17.710508812770204,17
0.2,6014,-4,106507,17.706899418121363,105
0.2,6015,33,106540,17.7094414893617,68
0.2,6016,48,106588,17.71447565231843,52
0.2,6017,85,106673,17.72565636424061,15
0.2,6018,9,106682,17.724206678850308,91
0.2,6019,-84,106598,17.707308970099668,184
0.2,6020,62,106660,17.714665337983725,38
0.2,6021,-329,106331,17.657090667552307,294
0.2,6022,7,106338,17.65532126847086,103
0.2,6023,61,106399,17.662516600265604,39
0.2,6024,-101,106298,17.642821576763485,132
0.2,6025,16,106314,17.64254895453037,84
0.2,6026,93,106407,17.65505226480836,8
0.2,6027,20,106427,17.655441274054414,80
0.2,6028,31,106458,17.657654669099355,69
0.2,6029,35,106493,17.660530679933665,66
0.2,6030,-64,106429,17.646990548831038,97
0.2,6031,78,106507,17.65699602122016,22
0.2,6032,71,106578,17.665837891596222,32
0.2,6033,55,106633,17.672025190586677,46
0.2,6034,80,106713,17.68235294117647,21
0.2,6035,50,106763,17.687707090788603,51
0.2,6036,-60,106703,17.674838495941692,95
0.2,6037,63,106766,17.6823451473998,37
0.2,6038,47,106813,17.687199867527735,55
0.2,6039,58,106871,17.69387417218543,43
0.2,6040,27,106898,17.695414666445952,84
0.2,6041,36,106934,17.698444223766966,64
0.2,6042,74,107008,17.70776104583816,27
0.2,6043,9,107017,17.706320317670418,92
0.2,6044,-156,106861,17.677584780810587,195
0.2,6045,-21,106840,17.67118756202448,125
0.2,6046,-75,106765,17.65586241111295,109
0.2,6047,74,106839,17.665178571428573,27
0.2,6048,25,106864,17.666391139031244,76
0.2,6049,58,106922,17.67305785123967,64
0.2,6050,34,106956,17.675756073376302,66
0.2,6051,94,107050,17.68836748182419,7
0.2,6052,78,107128,17.698331405914423,23
0.2,6053,24,107152,17.69937231582425,8
0.2,6054,67,107219,17.707514450867052,34
0.2,6055,82,107301,17.71813077939234,19
0.2,6056,70,107371,17.726762423642068,30
0.2,6057,-35,107336,17.718058765269067,136
0.2,6058,83,107419,17.728833140782307,17
0.2,6059,59,107478,17.735643564356437,41
0.2,6060,-157,107321,17.70681405708629,191
0.2,6061,54,107375,17.712801055757176,48
0.2,6062,71,107446,17.721589971961077,29
0.2,6063,67,107513,17.72971635883905,33
0.2,6064,22,107535,17.730420445177245,80
0.2,6065,4,107539,17.728156940323114,98
0.2,6066,25,107564,17.72935552991594,7
0.2,6067,-9,107555,17.724950560316415,113
0.2,6068,11,107566,17.723842478167736,99
0.2,6069,21,107587,17.724382207578255,80
0.2,6070,66,107653,17.73233404710921,35
0.2,6071,42,107695,17.73633069828722,58
0.2,6072,19,107714,17.736538778198582,81
0.2,6073,23,107737,17.73740533421139,9
0.2,6074,36,107773,17.740411522633746,65
0.2,6075,17,107790,17.7402896642528,83
0.2,6076,80,107870,17.75053480335692,21
0.2,6077,72,107942,17.759460348798946,28
0.2,6078,16,107958,17.759170916269124,86
0.2,6079,15,107973,17.75871710526316,86
0.2,6080,-12,107961,17.75382338431179,114
0.2,6081,20,107981,17.754192699769813,12
0.2,6082,83,108064,17.76491862567812,17
0.2,6083,-33,108031,17.75657462195924,134
0.2,6084,20,108051,17.7569433032046,96
0.2,6085,-69,107982,17.742688136707198,101
0.2,6086,73,108055,17.751766058813864,27
0.2,6087,-217,107838,17.713206307490143,249
0.2,6088,93,107931,17.725570701264576,7
0.2,6089,83,108014,17.736288998357963,24
0.2,6090,-343,107671,17.677064521425052,381
0.2,6091,64,107735,17.68466841759685,37
0.2,6092,-2,107733,17.68143771541113,103
0.2,6093,-200,107533,17.645717098785692,233
0.2,6094,92,107625,17.65791632485644,8
0.2,6095,91,107716,17.66994750656168,9
0.2,6096,89,107805,17.681646711497457,12
0.2,6097,5,107810,17.679567071170876,97
0.2,6098,-47,107763,17.668962124938513,148
0.2,6099,88,107851,17.680491803278688,12
0.2,6100,-97,107754,17.66169480413047,131
0.2,6101,87,107841,17.673058013765978,14
0.2,6102,59,107900,17.679829592003934,43
0.2,6103,-145,107755,17.653178243774573,179
0.2,6104,-67,107688,17.63931203931204,170
0.2,6105,-85,107603,17.622502456600067,186
0.2,6106,-16,107587,17.616996888816114,120
0.2,6107,68,107655,17.62524557956778,34
0.2,6108,89,107744,17.63692912096906,12
0.2,6109,43,107787,17.641080196399347,58
0.2,6110,-199,107588,17.60562919325806,232
0.2,6111,66,107654,17.613547120418847,34
0.2,6112,41,107695,17.617372812039914,60
0.2,6113,-142,107553,17.59126594700687,174
0.2,6114,90,107643,17.603107113654946,10
0.2,6115,-14,107629,17.597939829954218,46
0.2,6116,69,107698,17.606342978584273,32
0.2,6117,4,107702,17.60411899313501,99
0.2,6118,85,107787,17.61513319169799,15
0.2,6119,-138,107649,17.58970588235294,171
0.2,6120,-22,107627,17.583238033001145,53
0.2,6121,15,107642,17.5828160731787,85
0.2,6122,59,107701,17.589580271108932,42
0.2,6123,65,107766,17.597322011757022,36
0.2,6124,5,107771,17.59526530612245,103
0.2,6125,3,107774,17.59288279464577,98
0.2,6126,-63,107711,17.57972906805941,165
0.2,6127,75,107786,17.58909921671018,25
0.2,6128,78,107864,17.59895578397781,22
0.2,6129,8,107872,17.597389885807505,94
0.2,6130,93,107965,17.60968846843908,7
0.2,6131,7,107972,17.607958251793868,95
0.2,6132,-10,107962,17.603456709603783,41
0.2,6133,63,108025,17.610857515487446,38
0.2,6134,-46,107979,17.60048899755501,148
0.2,6135,88,108067,17.61196219035202,13
0.2,6136,80,108147,17.622128075606973,20
0.2,6137,33,108180,17.624633431085044,67
0.2,6138,72,108252,17.63349079654667,29
0.2,6139,77,108329,17.64315960912052,23
0.2,6140,54,108383,17.64907995440482,47
0.2,6141,93,108476,17.661348095083035,8
0.2,6142,-38,108438,17.65228715611265,140
0.2,6143,-96,108342,17.6337890625,198
0.2,6144,32,108374,17.63612693246542,81
0.2,6145,47,108421,17.64090465343313,53
0.2,6146,64,108485,17.648446396616237,36
0.2,6147,61,108546,17.655497722836696,39
0.2,6148,58,108604,17.662058871361197,43
0.2,6149,-46,108558,17.65170731707317,148
0.2,6150,94,108652,17.664119655340595,7
0.2,6151,79,108731,17.674089726918076,22
0.2,6152,-8,108723,17.66991711360312,39
0.2,6153,71,108794,17.678583035424115,29
0.2,6154,94,108888,17.690982940698618,7
0.2,6155,-292,108596,17.640675763482783,400
0.2,6156,87,108683,17.651940880298845,13
0.2,6157,41,108724,17.655732380643066,59
0.2,6158,87,108811,17.666991394706933,13
0.2,6159,94,108905,17.679383116883116,6
0.2,6160,84,108989,17.69014770329492,17
0.2,6161,-13,108976,17.685167153521583,115
0.2,6162,68,109044,17.693331169884797,33
0.2,6163,85,109129,17.70425048669695,16
0.2,6164,4,109133,17.702027575020274,27
0.2,6165,-7,109126,17.698021407719754,110
0.2,6166,93,109219,17.710231879357874,8
0.2,6167,48,109267,17.715142671854736,52
0.2,6168,94,109361,17.727508510293404,7
0.2,6169,56,109417,17.733711507293354,45
0.2,6170,51,109468,17.739102252471238,50
0.2,6171,51,109519,17.74449125081011,50
0.2,6172,-47,109472,17.734002915924187,152
0.2,6173,-8,109464,17.729834791059282,110
0.2,6174,75,109539,17.73910931174089,25
0.2,6175,91,109630,17.750971502590673,10
0.2,6176,30,109660,17.752954508661162,70
0.2,6177,81,109741,17.763191971511816,20
0.2,6178,-150,109591,17.736041430652207,183
0.2,6179,15,109606,17.73559870550162,87
0.2,6180,11,109617,17.73450897912959,89
0.2,6181,37,109654,17.737625363959882,64
0.2,6182,70,109724,17.746077955684942,30
0.2,6183,90,109814,17.75776196636481,11
0.2,6184,28,109842,17.759417946645108,75
0.2,6185,77,109919,17.768994503718073,24
0.2,6186,76,109995,17.778406335865526,25
0.2,6187,-96,109899,17.760019392372335,139
0.2,6188,84,109983,17.77072224915172,16
0.2,6189,15,109998,17.7702746365105,17
0.2,6190,91,110089,17.78210305281861,10
0.2,6191,67,110156,17.790051679586565,35
0.2,6192,81,110237,17.800258356208623,19
0.2,6193,83,110320,17.810784630287376,17
0.2,6194,68,110388,17.818886198547215,33
0.2,6195,43,110431,17.822950290510008,58
0.2,6196,92,110523,17.834920122639986,9
0.2,6197,49,110572,17.839948370442077,52
0.2,6198,-94,110478,17.821906759154704,211
0.2,6199,76,110554,17.831290322580646,25
0.2,6200,83,110637,17.84179970972424,17
0.2,6201,25,110662,17.842953885843276,76
0.2,6202,-17,110645,17.837336772529422,121
0.2,6203,80,110725,17.847356544165056,21
0.2,6204,74,110799,17.85640612409347,27
0.2,6205,-81,110718,17.84047695778279,113
0.2,6206,94,110812,17.8527468986628,6
0.2,6207,36,110848,17.855670103092784,64
0.2,6208,45,110893,17.86004187469802,78
0.2,6209,55,110948,17.866022544283414,45
0.2,6210,71,111019,17.87457736274352,30
0.2,6211,74,111093,17.883612363168062,26
0.2,6212,-175,110918,17.85256719781104,287
0.2,6213,69,110987,17.86079819761828,33
0.2,6214,93,111080,17.87288817377313,7
0.2,6215,79,111159,17.88272200772201,22
0.2,6216,-134,111025,17.858291780601576,168
0.2,6217,82,111107,17.868607269218398,18
0.2,6218,-96,111011,17.850297475478374,199
0.2,6219,45,111056,17.85466237942122,56
0.2,6220,15,111071,17.854203504259765,87
0.2,6221,10,111081,17.852941176470587,93
0.2,6222,24,111105,17.85392897316407,7
0.2,6223,77,111182,17.863431876606683,23
0.2,6224,67,111249,17.87132530120482,36
0.2,6225,82,111331,17.881625441696112,19
0.2,6226,-112,111219,17.860767624859484,145
0.2,6227,30,111249,17.862716763005782,71
0.2,6228,42,111291,17.8665917482742,62
0.2,6229,25,111316,17.8677367576244,77
0.2,6230,-198,111118,17.833092601508586,164
0.2,6231,61,111179,17.84001925545571,39
0.2,6232,63,111242,17.847264559602117,37
0.2,6233,-130,111112,17.82354828360603,119
0.2,6234,-85,111027,17.807056936647957,189
0.2,6235,93,111120,17.819114817190506,7
0.2,6236,1,111121,17.816418149751485,99
0.2,6237,22,111143,17.81708881051619,78
0.2,6238,58,111201,17.823529411764707,43
0.2,6239,-36,111165,17.814903846153847,138
0.2,6240,-23,111142,17.808364044223683,125
0.2,6241,51,111193,17.81368151233579,51
0.2,6242,-291,110902,17.764215921832452,259
0.2,6243,23,110925,17.765054452274182,77
0.2,6244,3,110928,17.762690152121696,100
0.2,6245,84,111012,17.773294908741594,17
0.2,6246,6,111018,17.77141027693293,94
0.2,6247,27,111045,17.77288732394366,73
0.2,6248,55,111100,17.77884461513842,45
0.2,6249,-128,110972,17.75552,234
0.2,6250,89,111061,17.76691729323308,12
0.2,6251,80,111141,17.77687140115163,21
0.2,6252,-14,111127,17.77178954102031,116
0.2,6253,64,111191,17.77918132395267,37
0.2,6254,61,111252,17.78609112709832,41
0.2,6255,17,111269,17.78596547314578,14
0.2,6256,-13,111256,17.781045229343135,44
0.2,6257,31,111287,17.783157558325343,69
0.2,6258,-5,111282,17.77951749480748,105
0.2,6259,73,111355,17.788338658146966,27
0.2,6260,-80,111275,17.772720012777512,184
0.2,6261,36,111311,17.77563078888534,65
0.2,6262,90,111401,17.787162701580712,10
0.2,6263,60,111461,17.79390166028097,40
0.2,6264,-175,111286,17.76312849162011,295
0.2,6265,66,111352,17.770826683689755,35
0.2,6266,92,111444,17.78267113451412,8
0.2,6267,67,111511,17.7905232929164,35
0.2,6268,26,111537,17.791832828202264,74
0.2,6269,72,111609,17.80047846889952,28
0.2,6270,51,111660,17.80577260405039,49
0.2,6271,-14,111646,17.800701530612244,117
0.2,6272,41,111687,17.80439980870397,60
0.2,6273,87,111774,17.81542875358623,13
0.2,6274,-30,111744,17.80780876494024,130
0.2,6275,66,111810,17.81548757170172,35
0.2,6276,48,111858,17.82029631989804,53
0.2,6277,94,111952,17.83243071041733,7
0.2,6278,95,112047,17.84472049689441,6
0.2,6279,-345,111702,17.786942675159235,385
0.2,6280,27,111729,17.78840948893488,73
0.2,6281,-11,111718,17.783826806749442,114
0.2,6282,-2,111716,17.780678020054115,102
0.2,6283,94,111810,17.79280712921706,7
0.2,6284,14,111824,17.79220365950676,102
0.2,6285,76,111900,17.801463569837736,26
0.2,6286,55,111955,17.807380308573247,46
0.2,6287,83,112038,17.817748091603054,18
0.2,6288,45,112083,17.82207028144379,58
0.2,6289,90,112173,17.833545310015896,10
0.2,6290,63,112236,17.84072484501669,37
0.2,6291,63,112299,17.847902097902097,38
0.2,6292,87,112386,17.858890831082153,14
0.2,6293,70,112456,17.867175087384812,30
0.2,6294,-57,112399,17.855281969817316,98
0.2,6295,79,112478,17.864993646759846,22
0.2,6296,89,112567,17.87629029696681,11
0.2,6297,6,112573,17.87440457288028,95
0.2,6298,-6,112567,17.870614383235434,108
0.2,6299,-162,112405,17.84206349206349,267
0.2,6300,87,112492,17.853039200126965,13
0.2,6301,-98,112394,17.834655664868297,130
0.2,6302,-97,112297,17.81643661748374,202
0.2,6303,-21,112276,17.810279187817258,53
0.2,6304,84,112360,17.820777160983347,16
0.2,6305,41,112401,17.824452901998097,59
0.2,6306,59,112460,17.830981449183447,41
0.2,6307,58,112518,17.837349397590362,43
0.2,6308,88,112606,17.84847043905532,13
0.2,6309,46,112652,17.85293185419968,56
0.2,6310,18,112670,17.852955157661228,83
0.2,6311,51,112721,17.85820659062104,49
0.2,6312,-15,112706,17.85300174243624,116
0.2,6313,84,112790,17.863477985429206,17
0.2,6314,-26,112764,17.856532066508315,129
0.2,6315,-74,112690,17.841988600379988,111
0.2,6316,37,112727,17.84502137090391,65
0.2,6317,84,112811,17.855492244381132,17
0.2,6318,-150,112661,17.82892862794746,183
0.2,6319,-205,112456,17.79367088607595,238
0.2,6320,82,112538,17.803828508147443,18
0.2,6321,38,112576,17.807023093957607,64
0.2,6322,-109,112467,17.78696821129211,213
0.2,6323,58,112525,17.793327008222644,44
0.2,6324,30,112555,17.79525691699605,87
0.2,6325,61,112616,17.802086626620298,39
0.2,6326,85,112701,17.812707444286392,16
0.2,6327,12,112713,17.811788874841973,89
0.2,6328,-3,112710,17.808500553009953,103
0.2,6329,89,112799,17.819747235387045,11
0.2,6330,59,112858,17.826251776970462,41
0.2,6331,67,112925,17.834017687934303,33
0.2,6332,58,112983,17.840360018948367,43
0.2,6333,-237,112746,17.800126302494473,277
0.2,6334,77,112823,17.809471191791634,23
0.2,6335,25,112848,17.810606060606062,77
0.2,6336,91,112939,17.822155594129715,10
0.2,6337,82,113021,17.832281476806564,18
0.2,6338,-30,112991,17.8247357627386,132
0.2,6339,61,113052,17.83154574132492,40
0.2,6340,48,113100,17.83630342217316,55
0.2,6341,57,113157,17.84247871333964,43
0.2,6342,-28,113129,17.83525145830049,141
0.2,6343,-54,113075,17.823928121059268,167
0.2,6344,41,113116,17.827580772261623,59
0.2,6345,1,113117,17.82492908919004,31
0.2,6346,51,113168,17.83015597920277,49
0.2,6347,-77,113091,17.815217391304348,110
0.2,6348,92,113183,17.826901874310916,8
0.2,6349,89,113272,17.838110236220473,12
0.2,6350,7,113279,17.836403715950244,93
0.2,6351,-8,113271,17.8323362720403,110
0.2,6352,-3,113268,17.82905713835983,35
0.2,6353,-106,113162,17.80956877557444,140
0.2,6354,-6,113156,17.80582218725413,37
0.2,6355,43,113199,17.809786028949024,57
0.2,6356,89,113288,17.82098474123014,11
0.2,6357,79,113367,17.83060710915382,21
0.2,6358,5,113372,17.82858940084919,99
0.2,6359,76,113448,17.837735849056603,24
0.2,6360,33,113481,17.840119478069486,68
0.2,6361,41,113522,17.84375982395473,60
0.2,6362,85,113607,17.854314002828854,15
0.2,6363,91,113698,17.86580766813325,9
0.2,6364,73,113771,17.874469756480753,28
0.2,6365,89,113860,17.8856424756519,12
0.2,6366,11,113871,17.88456101774776,91
0.2,6367,67,113938,17.892273869346734,33
0.2,6368,-6,113932,17.888522531009578,38
0.2,6369,-45,113887,17.878649921507066,77
0.2,6370,59,113946,17.885104379218333,41
0.2,6371,75,114021,17.89406779661017,26
0.2,6372,84,114105,17.904440608818454,16
0.2,6373,70,114175,17.912613743332287,30
0.2,6374,72,114247,17.921098039215686,29
0.2,6375,92,114339,17.93271643663739,8
0.2,6376,81,114420,17.942606241179238,20
0.2,6377,49,114469,17.947475697710882,51
0.2,6378,82,114551,17.957516852171185,19
0.2,6379,-21,114530,17.95141065830721,53
0.2,6380,76,114606,17.960507757404795,24
0.2,6381,80,114686,17.970228768411157,20
0.2,6382,-32,114654,17.962400125332916,64
0.2,6383,-11,114643,17.957863408521302,113
0.2,6384,-82,114561,17.942208300704777,183
0.2,6385,-107,114454,17.922643282179767,138
0.2,6386,88,114542,17.933615155785187,12
0.2,6387,-15,114527,17.928459611772073,118
0.2,6388,45,114572,17.932696822663953,55
0.2,6389,88,114660,17.943661971830984,12
0.2,6390,64,114724,17.950868408699733,37
0.2,6391,91,114815,17.96229662077597,9
0.2,6392,81,114896,17.972157046769905,20
0.2,6393,25,114921,17.973256177666563,6
0.2,6394,29,114950,17.97498045347928,73
0.2,6395,5,114955,17.972951844903065,95
0.2,6396,-69,114886,17.959355948100672,100
0.2,6397,60,114946,17.965926852141294,40
0.2,6398,-27,114919,17.95889982809814,132
0.2,6399,-59,114860,17.946875,92
0.2,6400,58,114918,17.95313232307452,43
0.2,6401,44,114962,17.95720087472665,57
0.2,6402,55,115017,17.9629861002655,47
0.2,6403,48,115065,17.967676452217365,52
0.2,6404,27,115092,17.969086651053864,73
0.2,6405,90,115182,17.98033093974399,11
0.2,6406,-39,115143,17.971437490245044,71
0.2,6407,-125,115018,17.94912609238452,158
0.2,6408,79,115097,17.95865189577157,22
0.2,6409,71,115168,17.966926677067082,29
0.2,6410,7,115175,17.965216034939946,93
0.2,6411,-2,115173,17.962102308172177,102
0.2,6412,-70,115103,17.948386090753157,174
0.2,6413,47,115150,17.952915497349547,54
0.2,6414,74,115224,17.961652377240842,26
0.2,6415,38,115262,17.964775561097255,63
0.2,6416,-64,115198,17.952002493376966,166
0.2,6417,56,115254,17.95793081956996,44
0.2,6418,1,115255,17.955288985823337,101
0.2,6419,-60,115195,17.943146417445483,160
0.2,6420,3,115198,17.940819187042518,28
0.2,6421,46,115244,17.94518841482404,55
0.2,6422,56,115300,17.951113186984276,45
0.2,6423,86,115386,17.961706102117063,15
0.2,6424,68,115454,17.969494163424123,32
0.2,6425,-6,115448,17.96576408341114,107
0.2,6426,40,115488,17.969192469270265,61
0.2,6427,76,115564,17.978220286247666,28
0.2,6428,58,115622,17.98444548141235,42
0.2,6429,70,115692,17.992534992223952,31
0.2,6430,28,115720,17.994091121132016,72
0.2,6431,-26,115694,17.987251243781095,134
0.2,6432,85,115779,17.997668272967513,15
0.2,6433,-184,115595,17.966272925085484,218
0.2,6434,-86,115509,17.95011655011655,189
0.2,6435,-13,115496,17.94530764449969,114
0.2,6436,1,115497,17.94267515923567,101
0.2,6437,83,115580,17.95278036657347,18
0.2,6438,-133,115447,17.929336853548687,165
0.2,6439,-11,115436,17.924844720496896,113
0.2,6440,46,115482,17.92920353982301,55
0.2,6441,33,115515,17.93154299906861,68
0.2,6442,11,115526,17.93046717367686,94
0.2,6443,-14,115512,17.925512104283055,116
0.2,6444,-177,115335,17.895267649340575,210
0.2,6445,84,115419,17.90552280484021,16
0.2,6446,5,115424,17.90352101752753,96
0.2,6447,90,115514,17.91470223325062,10
0.2,6448,72,115586,17.923088850984648,28
0.2,6449,-6,115580,17.91937984496124,107
0.2,6450,56,115636,17.92528290187568,47
0.2,6451,66,115702,17.932734035957843,34
0.2,6452,36,115738,17.93553386022005,66
0.2,6453,17,115755,17.93538890610474,83
0.2,6454,-14,115741,17.930441518202944,131
0.2,6455,-84,115657,17.914653035935565,117
0.2,6456,66,115723,17.922100046461203,34
0.2,6457,-6,115717,17.91839578816971,38
0.2,6458,81,115798,17.92816225421892,19
0.2,6459,-9,115789,17.923993808049534,111
0.2,6460,-79,115710,17.90899241603467,180
0.2,6461,74,115784,17.91767254719901,26
0.2,6462,87,115871,17.928361442054772,14
0.2,6463,89,115960,17.939356435643564,11
0.2,6464,95,116055,17.951276102088165,6
0.2,6465,53,116108,17.956696566656355,48
0.2,6466,79,116187,17.96613576619762,22
0.2,6467,47,116234,17.970624613481757,54
0.2,6468,86,116320,17.981140825475343,15
0.2,6469,30,116350,17.982998454404946,71
0.2,6470,34,116384,17.98547365167671,67
0.2,6471,11,116395,17.98439431396786,90
0.2,6472,-177,116218,17.95427158968021,211
0.2,6473,63,116281,17.96122953351869,38
0.2,6474,52,116333,17.966486486486488,49
0.2,6475,92,116425,17.97791846819024,8
0.2,6476,86,116511,17.988420565076424,15
0.2,6477,-29,116482,17.981167026860142,62
0.2,6478,94,116576,17.992900138910326,6
0.2,6479,-15,116561,17.98780864197531,116
0.2,6480,75,116636,17.996605462120044,26
0.2,6481,92,116728,18.008022215365628,8
0.2,6482,58,116786,18.014190960974858,42
0.2,6483,51,116837,18.01927822331894,51
0.2,6484,91,116928,18.03053199691596,10
0.2,6485,61,116989,18.037156953438174,42
0.2,6486,73,117062,18.045629720980422,32
0.2,6487,-184,116878,18.014488286066584,217
0.2,6488,80,116958,18.02404068423486,20
0.2,6489,43,117001,18.02788906009245,58
0.2,6490,-136,116865,18.004159605607764,238
0.2,6491,65,116930,18.01139864448552,36
0.2,6492,-111,116819,17.991529339288466,235
0.2,6493,39,116858,17.994764397905758,63
0.2,6494,75,116933,18.00354118552733,25
0.2,6495,-237,116696,17.964285714285715,365
0.2,6496,33,116729,17.96659996921656,67
0.2,6497,-13,116716,17.961834410587873,150
0.2,6498,11,116727,17.96076319433759,22
0.2,6499,-47,116680,17.950769230769232,151
0.2,6500,79,116759,17.9601599753884,21
0.2,6501,8,116767,17.95862811442633,93
0.2,6502,65,116832,17.965861909887742,36
0.2,6503,72,116904,17.974169741697416,29
0.2,6504,35,116939,17.976787086856266,66
0.2,6505,-3,116936,17.973562865047647,113
0.2,6506,0,116936,17.970800676194866,103
0.2,6507,58,116994,17.97695144437615,43
0.2,6508,78,117072,17.986172991242896,22
0.2,6509,27,117099,17.987557603686636,75
0.2,6510,72,117171,17.99585317155583,28
0.2,6511,90,117261,18.00691031941032,11
0.2,6512,50,117311,18.011822508828498,54
0.2,6513,8,117319,18.010285538839423,93
0.2,6514,50,117369,18.015195702225633,52
0.2,6515,41,117410,18.018723143032535,59
0.2,6516,80,117490,18.02823384993095,20
0.2,6517,-281,117209,17.982356551089293,316
0.2,6518,93,117302,17.993864089584292,8
0.2,6519,67,117369,18.00138036809816,34
0.2,6520,54,117423,18.006900782088636,46
0.2,6521,-39,117384,17.998160073597056,70
0.2,6522,61,117445,18.00475241453319,40
0.2,6523,89,117534,18.01563458001226,11
0.2,6524,52,117586,18.020842911877395,50
0.2,6525,49,117635,18.025589947900706,51
0.2,6526,-256,117379,17.983606557377048,238
0.2,6527,-55,117324,17.972426470588236,143
0.2,6528,-16,117308,17.967223158217184,116
0.2,6529,60,117368,17.973660030627872,40
0.2,6530,-61,117307,17.96156790690553,94
0.2,6531,80,117387,17.97106552357624,21
0.2,6532,48,117435,17.97566202357263,53
0.2,6533,45,117480,17.97979797979798,59
0.2,6534,56,117536,17.985615914307573,44
0.2,6535,91,117627,17.996787025703796,9
0.2,6536,-26,117601,17.990056600887257,59
0.2,6537,44,117645,17.994034873049863,56
0.2,6538,64,117709,18.001070500076466,37
0.2,6539,88,117797,18.01177370030581,13
0.2,6540,79,117876,18.02109769148448,22
0.2,6541,77,117953,18.030113115255272,23
0.2,6542,53,118006,18.035457741097357,47
0.2,6543,81,118087,18.045079462102688,20
0.2,6544,33,118120,18.047364400305575,77
0.2,6545,-47,118073,18.037427436602506,149
0.2,6546,66,118139,18.044753322132273,36
0.2,6547,35,118174,18.047342700061087,66
0.2,6548,77,118251,18.056344480073292,23
0.2,6549,-13,118238,18.051603053435116,44
0.2,6550,83,118321,18.061517325599144,18
0.2,6551,-194,118127,18.029151404151403,294
0.2,6552,60,118187,18.035556233786053,41
0.2,6553,69,118256,18.043332316142813,56
0.2,6554,-52,118204,18.032646834477497,83
0.2,6555,83,118287,18.04255643685174,18
0.2,6556,88,118375,18.053225560469727,13
0.2,6557,-134,118241,18.030039646233607,169
0.2,6558,86,118327,18.040402500381155,14
0.2,6559,91,118418,18.0515243902439,10
0.2,6560,93,118511,18.062947721383935,8
0.2,6561,73,118584,18.071319719597685,27
0.2,6562,61,118645,18.077860734420234,40
0.2,6563,91,118736,18.08897014015844,9
0.2,6564,33,118769,18.091241431835492,67
0.2,6565,-137,118632,18.06762107828206,171
0.2,6566,80,118712,18.077051926298157,21
0.2,6567,-154,118558,18.050852618757613,255
0.2,6568,7,118565,18.04917034556249,95
0.2,6569,-34,118531,18.04124809741248,69
0.2,6570,33,118564,18.043524577689848,78
0.2,6571,91,118655,18.054625684723067,9
0.2,6572,53,118708,18.059942187737715,48
0.2,6573,69,118777,18.067690903559477,32
0.2,6574,91,118868,18.078783269961978,10
0.2,6575,-209,118659,18.04425182481752,172
0.2,6576,-36,118623,18.036034666261212,136
0.2,6577,51,118674,18.04104591061113,50
0.2,6578,60,118734,18.047423620611035,40
0.2,6579,68,118802,18.055015197568387,32
0.2,6580,69,118871,18.062756419996962,31
0.2,6581,54,118925,18.068216347614708,48
0.2,6582,52,118977,18.073370803584993,51
0.2,6583,92,119069,18.08459902794654,9
0.2,6584,82,119151,18.094305239179956,18
0.2,6585,-31,119120,18.08685089583966,132
0.2,6586,20,119140,18.087141339001064,12
0.2,6587,69,119209,18.09486945962356,33
0.2,6588,41,119250,18.09834572772803,60
0.2,6589,-30,119220,18.09104704097117,62
0.2,6590,65,119285,18.09816416325292,36
0.2,6591,63,119348,18.10497572815534,38
0.2,6592,53,119401,18.11026846655544,48
0.2,6593,62,119463,18.116924476797088,39
0.2,6594,-159,119304,18.090068233510234,124
0.2,6595,79,119383,18.099302607640993,21
0.2,6596,-128,119255,18.077156283159013,160
0.2,6597,-30,119225,18.069869657471962,131
0.2,6598,33,119258,18.07213214123352,68
0.2,6599,-71,119187,18.058636363636364,102
0.2,6600,92,119279,18.069837903347977,8
0.2,6601,54,119333,18.075280218115722,49
0.2,6602,54,119387,18.080720884446464,47
0.2,6603,50,119437,18.085554209569956,51
0.2,6604,35,119472,18.088115064345192,66
0.2,6605,21,119493,18.088555858310627,80
0.2,6606,-157,119336,18.062055395792342,192
0.2,6607,52,119388,18.067191283292978,49
0.2,6608,-44,119344,18.057799969738237,77
0.2,6609,50,119394,18.062632375189107,51
0.2,6610,77,119471,18.071547420965057,23
0.2,6611,-104,119367,18.053085299455535,206
0.2,6612,62,119429,18.05973083320732,39
0.2,6613,9,119438,18.058361052313273,92
0.2,6614,62,119500,18.065003779289494,39
0.2,6615,12,119512,18.064087061668683,19
0.2,6616,1,119513,18.06150823636089,31
0.2,6617,-137,119376,18.038077969174978,177
0.2,6618,55,119431,18.043662184620032,46
0.2,6619,42,119473,18.04728096676737,58
0.2,6620,-62,119411,18.035191058752453,165
0.2,6621,67,119478,18.04258532165509,35
0.2,6622,80,119558,18.05194020836479,21
0.2,6623,78,119636,18.060990338164252,23
0.2,6624,16,119652,18.06067924528302,15
0.2,6625,68,119720,18.068216118321764,33
0.2,6626,80,119800,18.077561490870682,20
0.2,6627,52,119852,18.082679541339772,50
0.2,6628,88,119940,18.09322673103032,12
0.2,6629,-60,119880,18.081447963800905,92
0.2,6630,87,119967,18.091841351229075,14
0.2,6631,-183,119784,18.06151990349819,217
0.2,6632,-157,119627,18.03512739333635,122
0.2,6633,45,119672,18.039192041000906,56
0.2,6634,-62,119610,18.02712886209495,184
0.2,6635,64,119674,18.03405666063894,37
0.2,6636,81,119755,18.0435437697755,19
0.2,6637,76,119831,18.052274781560712,24
0.2,6638,9,119840,18.050911281819552,93
0.2,6639,-140,119700,18.02710843373494,173
0.2,6640,30,119730,18.02891130853787,79
0.2,6641,73,119803,18.037187594098164,28
0.2,6642,90,119893,18.048020472678008,11
0.2,6643,64,119957,18.054936785069234,36
0.2,6644,56,120013,18.060647103085028,45
0.2,6645,93,120106,18.071922961179656,7
0.2,6646,72,120178,18.080036106514218,28
0.2,6647,81,120259,18.089500601684716,19
0.2,6648,-84,120175,18.074146488193712,115
0.2,6649,90,120265,18.084962406015038,11
0.2,6650,64,120329,18.09186588482935,37
0.2,6651,87,120416,18.10222489476849,13
0.2,6652,-17,120399,18.0969487449271,48
0.2,6653,-45,120354,18.08746618575293,146
0.2,6654,92,120446,18.098572501878287,9
0.2,6655,82,120528,18.108173076923077,19
0.2,6656,-104,120424,18.089830253868108,135
0.2,6657,38,120462,18.092820666866928,62
0.2,6658,-2,120460,18.08980327376483,33
0.2,6659,8,120468,18.08828828828829,92
0.2,6660,15,120483,18.087824650953312,88
0.2,6661,82,120565,18.097418192734914,18
0.2,6662,-196,120369,18.065285907248988,303
0.2,6663,72,120441,18.073379351740698,28
0.2,6664,51,120492,18.078319579894973,50
0.2,6665,21,120513,18.078757875787577,79
0.2,6666,-31,120482,18.071396430178492,64
0.2,6667,17,120499,18.07123575284943,86
0.2,6668,79,120578,18.080371869845553,21
0.2,6669,-3,120575,18.07721139430285,34
0.2,6670,47,120622,18.081546994453607,53
0.2,6671,51,120673,18.086480815347723,49
0.2,6672,83,120756,18.096208601828263,18
0.2,6673,15,120771,18.095744680851062,86
0.2,6674,30,120801,18.09752808988764,70
0.2,6675,15,120816,18.097064110245658,114
0.2,6676,46,120862,18.101243073236482,54
0.2,6677,61,120923,18.10766696615753,40
0.2,6678,-60,120863,18.095972450965714,93
0.2,6679,-14,120849,18.09116766467066,49
0.2,6680,75,120924,18.099685675797037,26
0.2,6681,15,120939,18.09922178988327,86
0.2,6682,50,120989,18.10399521173126,50
0.2,6683,91,121080,18.114901256732495,9
0.2,6684,-184,120896,18.08466716529544,159
0.2,6685,32,120928,18.08674842955429,70
0.2,6686,-8,120920,18.082847315687154,109
0.2,6687,24,120944,18.083732057416267,78
0.2,6688,73,121017,18.091941994319033,28
0.2,6689,93,121110,18.103139013452914,8
0.2,6690,0,121110,18.100433418024213,101
0.2,6691,41,121151,18.10385534967125,59
0.2,6692,12,121163,18.102943373673988,91
0.2,6693,-21,121142,18.09710188228264,53
0.2,6694,39,121181,18.100224047796864,62
0.2,6695,-14,121167,18.09543010752688,116
0.2,6696,53,121220,18.10064207854263,50
0.2,6697,16,121236,18.1003284562556,87
0.2,6698,52,121288,18.105388864009555,48
0.2,6699,64,121352,18.11223880597015,37
0.2,6700,94,121446,18.123563647216834,7
0.2,6701,88,121534,18.13398985377499,13
0.2,6702,75,121609,18.142473519319708,25
0.2,6703,-206,121403,18.10903937947494,239
0.2,6704,69,121472,18.11662938105891,32
0.2,6705,-66,121406,18.104085893229943,100
0.2,6706,-22,121384,18.098106455941554,125
0.2,6707,-71,121313,18.084824090638044,175
0.2,6708,62,121375,18.09136980175883,39
0.2,6709,-66,121309,18.078837555886736,167
0.2,6710,-50,121259,18.06869319028461,152
0.2,6711,58,121317,18.07464243146603,43
0.2,6712,63,121380,18.08133472367049,38
0.2,6713,93,121473,18.092493297587133,7
0.2,6714,75,121548,18.10096798212956,26
0.2,6715,10,121558,18.099761762954138,90
0.2,6716,89,121647,18.110317105850825,12
0.2,6717,-31,121616,18.103006847275974,131
0.2,6718,88,121704,18.113409733591308,12
0.2,6719,77,121781,18.122172619047618,24
0.2,6720,81,121862,18.131528046421664,19
0.2,6721,85,121947,18.141475751264505,16
0.2,6722,23,121970,18.14219842332292,77
0.2,6723,59,122029,18.1482748364069,42
0.2,6724,82,122111,18.157769516728624,18
0.2,6725,37,122148,18.16057091882248,71
0.2,6726,7,122155,18.158911847777613,94
0.2,6727,62,122217,18.165428061831154,39
0.2,6728,31,122248,18.16733541388022,70
0.2,6729,45,122293,18.171322436849927,55
0.2,6730,28,122321,18.172782647452088,73
0.2,6731,-24,122297,18.166518122400475,125
0.2,6732,-25,122272,18.16010693598693,127
0.2,6733,36,122308,18.162756162756164,65
0.2,6734,86,122394,18.1728285077951,14
0.2,6735,70,122464,18.180522565320665,31
0.2,6736,-83,122381,18.165503933501558,185
0.2,6737,93,122474,18.176610270109826,7
0.2,6738,56,122530,18.182222881733196,46
0.2,6739,-57,122473,18.17106824925816,91
0.2,6740,13,122486,18.17030114226376,89
0.2,6741,-73,122413,18.156778404034412,176
0.2,6742,-244,122169,18.117900044490582,288
0.2,6743,-105,122064,18.09964412811388,209
0.2,6744,30,122094,18.101408450704227,71
0.2,6745,-13,122081,18.096798102579307,45
0.2,6746,-143,121938,18.072921298354824,247
0.2,6747,-2,121936,18.069946650859514,102
0.2,6748,26,121962,18.071121647651506,74
0.2,6749,72,122034,18.07911111111111,28
0.2,6750,87,122121,18.089320100725818,13
0.2,6751,64,122185,18.096119668246445,36
0.2,6752,68,122253,18.10350955131053,32
0.2,6753,93,122346,18.11459875629257,7
0.2,6754,44,122390,18.11843079200592,56
0.2,6755,25,122415,18.119449378330373,75
0.2,6756,-25,122390,18.113067929554536,129
0.2,6757,75,122465,18.12148564664102,25
0.2,6758,-37,122428,18.113330374315726,69
0.2,6759,-41,122387,18.10458579881657,72
0.2,6760,36,122423,18.107232657890844,64
0.2,6761,12,122435,18.106329488317066,19
0.2,6762,74,122509,18.114594115037704,26
0.2,6763,-47,122462,18.104967474866942,150
0.2,6764,-154,122308,18.07952697708795,272
0.2,6765,77,122385,18.08823529411765,24
0.2,6766,-74,122311,18.074626865671643,108
0.2,6767,72,122383,18.082594562647753,29
0.2,6768,51,122434,18.087457526961146,49
0.2,6769,-122,122312,18.066765140324964,158
0.2,6770,16,122328,18.066459902525477,84
0.2,6771,59,122387,18.072504430005907,41
0.2,6772,-56,122331,18.061567990550717,157
0.2,6773,14,122345,18.0609684086212,17
0.2,6774,62,122407,18.067453874538746,39
0.2,6775,83,122490,18.077036599763872,17
0.2,6776,49,122539,18.081599527814667,51
0.2,6777,57,122596,18.087341398642668,43
0.2,6778,27,122623,18.08865614397404,73
0.2,6779,75,122698,18.097050147492624,26
0.2,6780,-33,122665,18.089514820822888,64
0.2,6781,-52,122613,18.07918018283692,84
0.2,6782,85,122698,18.0890461447737,16
0.2,6783,-7,122691,18.08534787735849,107
0.2,6784,43,122734,18.089019896831246,59
0.2,6785,-65,122669,18.07677571470675,167
0.2,6786,31,122700,18.078679829085015,70
0.2,6787,-54,122646,18.06806128461992,86
0.2,6788,25,122671,18.06908233907792,6
0.2,6789,-29,122642,18.062150220913107,63
0.2,6790,91,122733,18.07289059048741,9
0.2,6791,80,122813,18.08200824499411,21
0.2,6792,38,122851,18.084940379802738,64
0.2,6793,38,122889,18.087871651457167,62
0.2,6794,12,122901,18.086975717439294,91
0.2,6795,78,122979,18.095791642142437,23
0.2,6796,76,123055,18.104310725319994,34
0.2,6797,-133,122922,18.08208296557811,236
0.2,6798,49,122971,18.086630386821593,51
0.2,6799,84,123055,18.096323529411766,16
0.2,6800,93,123148,18.107337156300545,8
0.2,6801,4,123152,18.105263157894736,27
0.2,6802,86,123238,18.115243275025723,14
0.2,6803,95,123333,18.126543209876544,6
0.2,6804,94,123427,18.137692872887584,7
0.2,6805,46,123473,18.141786658830444,55
0.2,6806,72,123545,18.14969883943,29
0.2,6807,53,123598,18.154817861339602,47
0.2,6808,34,123632,18.157144955206345,66
0.2,6809,54,123686,18.162408223201176,48
0.2,6810,24,123710,18.163265306122447,7
0.2,6811,-317,123393,18.11406341749853,354
0.2,6812,-3,123390,18.110964332892998,105
0.2,6813,91,123481,18.121661285588495,9
0.2,6814,77,123558,18.130300807043287,23
0.2,6815,37,123595,18.133069248826292,64
0.2,6816,-366,123229,18.0767199647939,361
0.2,6817,91,123320,18.08741566441772,26
0.2,6818,64,123384,18.094148702155742,37
0.2,6819,55,123439,18.09956011730205,46
0.2,6820,12,123451,18.09866588476763,19
0.2,6821,52,123503,18.103635297566697,48
0.2,6822,76,123579,18.11212076799062,25
0.2,6823,-29,123550,18.105216881594373,64
0.2,6824,94,123644,18.116336996336997,6
0.2,6825,-77,123567,18.102402578376793,108
0.2,6826,-25,123542,18.096089058151456,57
0.2,6827,24,123566,18.096953719976568,77
0.2,6828,3,123569,18.094743007761018,29
0.2,6829,90,123659,18.10527086383602,11
0.2,6830,-49,123610,18.09544722588201,82
0.2,6831,-179,123431,18.06659836065574,213
0.2,6832,48,123479,18.07097907214986,52
0.2,6833,76,123555,18.07945566286216,24
0.2,6834,23,123578,18.080175566934894,77
0.2,6835,72,123650,18.08806319485079,28
0.2,6836,-85,123565,18.072985227438934,129
0.2,6837,74,123639,18.081164083065225,27
0.2,6838,54,123693,18.086416142710924,47
0.2,6839,31,123724,18.088304093567253,69
0.2,6840,49,123773,18.092822686741705,51
0.2,6841,66,123839,18.099824612686348,35
0.2,6842,77,123916,18.108431974280286,34
0.2,6843,91,124007,18.119082407948568,9
0.2,6844,-111,123896,18.100219138056975,145
0.2,6845,-150,123746,18.075664621676893,116
0.2,6846,83,123829,18.08514677961151,18
0.2,6847,-61,123768,18.07359813084112,93
0.2,6848,44,123812,18.077383559643742,57
0.2,6849,71,123883,18.085109489051096,35
0.2,6850,56,123939,18.090643701649395,45
0.2,6851,57,123996,18.09632224168126,44
0.2,6852,80,124076,18.105355318838466,21
0.2,6853,68,124144,18.11263495768894,32
0.2,6854,-189,123955,18.082421590080234,232
0.2,6855,-115,123840,18.06301050175029,146
0.2,6856,82,123922,18.072334840309175,19
0.2,6857,-9,123913,18.068387284922718,111
0.2,6858,51,123964,18.073188511444815,50
0.2,6859,-134,123830,18.051020408163264,245
0.2,6860,88,123918,18.061215566243987,12
0.2,6861,-27,123891,18.054648790440105,130
0.2,6862,52,123943,18.059594929331197,49
0.2,6863,55,123998,18.06497668997669,46
0.2,6864,59,124057,18.070939548434087,42
0.2,6865,10,124067,18.069764054762597,93
0.2,6866,78,124145,18.07849133537207,22
0.2,6867,74,124219,18.086633663366335,27
0.2,6868,90,124309,18.09710292619013,10
0.2,6869,-65,124244,18.085007278020377,96
0.2,6870,71,124315,18.09270848493669,29
0.2,6871,91,124406,18.103317811408616,10
0.2,6872,93,124499,18.114215044376547,8
0.2,6873,77,124576,18.122781495490255,23
0.2,6874,67,124643,18.12989090909091,34
0.2,6875,80,124723,18.13888888888889,21
0.2,6876,71,124794,18.146575541660606,29
0.2,6877,65,124859,18.153387612678102,37
0.2,6878,93,124952,18.164268062218344,8
0.2,6879,93,125045,18.17514534883721,7
0.2,6880,74,125119,18.18325824734777,27
0.2,6881,89,125208,18.193548387096776,12
0.2,6882,74,125282,18.201656254540172,26
0.2,6883,81,125363,18.21077861708309,20
0.2,6884,52,125415,18.215686274509803,48
0.2,6885,80,125495,18.224658727853615,21
0.2,6886,43,125538,18.228256134746623,57
0.2,6887,-106,125432,18.21022067363531,88
0.2,6888,64,125496,18.216867469879517,36
0.2,6889,-85,125411,18.20188679245283,190
0.2,6890,-3,125408,18.198810042083878,104
0.2,6891,18,125426,18.19878119558909,93
0.2,6892,91,125517,18.20934281154795,10
0.2,6893,66,125583,18.21627502175805,34
0.2,6894,40,125623,18.219434372733865,62
0.2,6895,75,125698,18.227668213457076,25
0.2,6896,18,125716,18.22763520371176,84
0.2,6897,-26,125690,18.22122354305596,127
0.2,6898,-17,125673,18.216118278011304,119
0.2,6899,65,125738,18.222898550724636,36
0.2,6900,-65,125673,18.210839008839297,168
0.2,6901,83,125756,18.22022602144306,17
0.2,6902,36,125792,18.222801680428798,64
0.2,6903,-4,125788,18.219582850521437,35
0.2,6904,41,125829,18.222881969587256,59
0.2,6905,39,125868,18.225890529973935,61
0.2,6906,-11,125857,18.221659186332705,112
0.2,6907,91,125948,18.23219455703532,9
0.2,6908,0,125948,18.229555652048052,42
0.2,6909,56,126004,18.235021707670043,45
0.2,6910,-122,125882,18.214730140355954,155
0.2,6911,82,125964,18.223958333333332,19
0.2,6912,90,126054,18.234341096484883,11
0.2,6913,89,126143,18.244576222157942,12
0.2,6914,-119,126024,18.22472885032538,83
0.2,6915,26,126050,18.225853094274147,76
0.2,6916,92,126142,18.236518721989302,9
0.2,6917,-30,126112,18.229546111592946,62
0.2,6918,-29,126083,18.222720046249457,131
0.2,6919,38,126121,18.22557803468208,63
0.2,6920,33,126154,18.227712758271927,76
0.2,6921,51,126205,18.232447269575268,49
0.2,6922,32,126237,18.23443593817709,71
0.2,6923,67,126304,18.241478913922588,34
0.2,6924,-39,126265,18.23321299638989,139
0.2,6925,93,126358,18.24400808547502,7
0.2,6926,75,126433,18.252201530243973,25
0.2,6927,0,126433,18.249566974595844,100
0.2,6928,22,126455,18.25010824072738,79
0.2,6929,94,126549,18.26103896103896,7
0.2,6930,33,126582,18.263165488385514,67
0.2,6931,66,126648,18.27005193306405,55
0.2,6932,94,126742,18.280975046877252,6
0.2,6933,77,126819,18.28944332275743,23
0.2,6934,-53,126766,18.27916366258111,86
0.2,6935,86,126852,18.28892733564014,15
0.2,6936,39,126891,18.29191293066167,62
0.2,6937,94,126985,18.302825021620063,7
0.2,6938,-31,126954,18.295719844357976,134
0.2,6939,2,126956,18.293371757925073,98
0.2,6940,17,126973,18.293185419968303,84
0.2,6941,-39,126934,18.28493229616825,142
0.2,6942,81,127015,18.293965144750107,20
0.2,6943,-80,126935,18.2798099078341,113
0.2,6944,56,126991,18.285241180705544,45
0.2,6945,43,127034,18.288799308954793,58
0.2,6946,94,127128,18.299697711242263,6
0.2,6947,-50,127078,18.289867587795047,151
0.2,6948,94,127172,18.30076269966902,6
0.2,6949,53,127225,18.305755395683452,48
0.2,6950,78,127303,18.314343259962595,23
0.2,6951,52,127355,18.319188722669736,51
0.2,6952,64,127419,18.32575866532432,39
0.2,6953,68,127487,18.33290192694852,32
0.2,6954,22,127509,18.333429187634795,80
0.2,6955,72,127581,18.341144335825188,28
0.2,6956,-248,127333,18.30286042834555,216
0.2,6957,-184,127149,18.273785570566254,160
0.2,6958,15,127164,18.27331513148441,86
0.2,6959,74,127238,18.28132183908046,27
0.2,6960,-47,127191,18.271943686251976,80
0.2,6961,90,127281,18.282246480896294,10
0.2,6962,65,127346,18.28895590980899,36
0.2,6963,93,127439,18.299684089603677,7
0.2,6964,4,127443,18.297631012203876,96
0.2,6965,90,127533,18.30792420327304,10
0.2,6966,81,127614,18.31692263528061,20
0.2,6967,72,127686,18.324626865671643,29
0.2,6968,94,127780,18.33548572248529,6
0.2,6969,26,127806,18.336585365853658,77
0.2,6970,92,127898,18.347152488882514,9
0.2,6971,67,127965,18.354130808950085,41
0.2,6972,0,127965,18.35149863760218,102
0.2,6973,32,127997,18.35345569257241,70
0.2,6974,61,128058,18.359569892473118,39
0.2,6975,2,128060,18.3572247706422,100
0.2,6976,92,128152,18.36777984807224,9
0.2,6977,-108,128044,18.349670392662652,141
0.2,6978,-24,128020,18.34360223527726,56
0.2,6979,-42,127978,18.334957020057306,150
0.2,6980,94,128072,18.34579573127059,7
0.2,6981,47,128119,18.349899742194214,54
0.2,6982,28,128147,18.351281684089933,92
0.2,6983,23,128170,18.351947308132875,77
0.2,6984,92,128262,18.362491052254832,9
0.2,6985,85,128347,18.372029773833383,15
0.2,6986,-169,128178,18.345212537569772,269
0.2,6987,15,128193,18.344733829421866,91
0.2,6988,84,128277,18.354127915295464,17
0.2,6989,-14,128263,18.349499284692417,46
0.2,6990,48,128311,18.353740523530252,53
0.2,6991,60,128371,18.35969679633867,40
0.2,6992,47,128418,18.363792363792363,54
0.2,6993,-8,128410,18.3600228767515,111
0.2,6994,-23,128387,18.354110078627592,54
0.2,6995,74,128461,18.36206403659234,26
0.2,6996,-72,128389,18.349149635558096,179
0.2,6997,28,128417,18.35052872249214,72
0.2,6998,94,128511,18.361337333904842,7
0.2,6999,-19,128492,18.356,121
0.2,7000,91,128583,18.36637623196686,9
0.2,7001,59,128642,18.372179377320766,42
0.2,7002,-113,128529,18.353419962873055,146
0.2,7003,3,128532,18.35122786978869,135
0.2,7004,66,128598,18.358029978586725,34
0.2,7005,52,128650,18.36283185840708,48
0.2,7006,81,128731,18.3717710860568,19
0.2,7007,33,128764,18.373858447488583,70
0.2,7008,85,128849,18.383364245969467,15
0.2,7009,37,128886,18.38601997146933,63
0.2,7010,60,128946,18.39195549850235,41
0.2,7011,25,128971,18.392897889332573,76
0.2,7012,87,129058,18.402680735776414,13
0.2,7013,90,129148,18.41288850869689,11
0.2,7014,72,129220,18.420527441197436,28
0.2,7015,-53,129167,18.410347776510832,156
0.2,7016,-173,128994,18.38306968790081,274
0.2,7017,21,129015,18.383442576232547,10
0.2,7018,65,129080,18.390084057558056,35
0.2,7019,-81,128999,18.375925925925927,114
0.2,7020,48,129047,18.380145278450364,52
0.2,7021,80,129127,18.388920535459985,21
0.2,7022,90,129217,18.399117186387585,11
0.2,7023,-33,129184,18.391799544419133,134
0.2,7024,57,129241,18.39729537366548,46
0.2,7025,95,129336,18.408198121263876,6
0.2,7026,20,129356,18.408424647787108,81
0.2,7027,12,129368,18.40751280591918,90
0.2,7028,62,129430,18.41371461089771,39
0.2,7029,88,129518,18.42361308677098,12
0.2,7030,72,129590,18.431233110510597,29
0.2,7031,54,129644,18.436291240045506,47
0.2,7032,43,129687,18.43978387601308,58
0.2,7033,82,129769,18.448820017059994,19
0.2,7034,54,129823,18.453873489694384,68
0.2,7035,-40,129783,18.44556566230813,72
0.2,7036,84,129867,18.454881341480746,17
0.2,7037,87,129954,18.46462063086104,14
0.2,7038,49,130003,18.468958658900412,51
0.2,7039,35,130038,18.47130681818182,67
0.2,7040,76,130114,18.47947734696776,24
0.2,7041,-49,130065,18.469894916216983,149
0.2,7042,-76,129989,18.456481612949027,180
0.2,7043,93,130082,18.467064168086313,7
0.2,7044,1,130083,18.46458481192335,102
0.2,7045,-34,130049,18.457138802157253,66
0.2,7046,-56,129993,18.4465730097914,158
0.2,7047,-18,129975,18.44140181611805,141
0.2,7048,46,130021,18.445311391686765,55
0.2,7049,-108,129913,18.42737588652482,143
0.2,7050,67,129980,18.434264643313004,34
0.2,7051,29,130009,18.43576290414067,71
0.2,7052,36,130045,18.438253225577768,68
0.2,7053,93,130138,18.44882336263113,7
0.2,7054,53,130191,18.453720765414598,48
0.2,7055,76,130267,18.46187641723356,27
0.2,7056,49,130316,18.46620376930707,52
0.2,7057,77,130393,18.474497024652877,24
0.2,7058,61,130454,18.480521320300326,39
0.2,7059,25,130479,18.4814447592068,6
0.2,7060,89,130568,18.491431808525704,12
0.2,7061,61,130629,18.497451146983856,40
0.2,7062,55,130684,18.50261928359054,46
0.2,7063,93,130777,18.513165345413363,8
0.2,7064,-25,130752,18.50700636942675,58
0.2,7065,73,130825,18.514718369657515,27
0.2,7066,65,130890,18.521296165275224,35
0.2,7067,66,130956,18.528013582342954,35
0.2,7068,87,131043,18.537699816098456,13
0.2,7069,24,131067,18.538472418670437,8
0.2,7070,11,131078,18.537406307452976,90
0.2,7071,52,131130,18.542138009049772,48
0.2,7072,-3,131127,18.53909232291814,35
0.2,7073,36,131163,18.54156064461408,65
0.2,7074,86,131249,18.551095406360425,14
0.2,7075,-45,131204,18.542114188807236,149
0.2,7076,-14,131190,18.53751589656634,114
0.2,7077,88,131278,18.547329754167844,12
0.2,7078,78,131356,18.55572821019918,23
0.2,7079,57,131413,18.561158192090396,44
0.2,7080,78,131491,18.569552323118202,22
0.2,7081,31,131522,18.57130754024287,69
0.2,7082,14,131536,18.570662148807003,17
0.2,7083,-158,131378,18.545736871823827,193
0.2,7084,81,131459,18.5545518701482,20
0.2,7085,92,131551,18.564916737228337,9
0.2,7086,67,131618,18.571751093551573,35
0.2,7087,-37,131581,18.563910835214447,68
0.2,7088,-25,131556,18.557765552264073,57
0.2,7089,90,131646,18.56784203102962,11
0.2,7090,12,131658,18.566915808771682,89
0.2,7091,-32,131626,18.55978567399887,134
0.2,7092,89,131715,18.569716622021712,12
0.2,7093,72,131787,18.577248378911758,29
0.2,7094,76,131863,18.585341789992952,24
0.2,7095,0,131863,18.58272266065389,32
0.2,7096,-108,131755,18.564886571790897,140
0.2,7097,89,131844,18.574809805579036,11
0.2,7098,81,131925,18.58360332441189,20
0.2,7099,-56,131869,18.573098591549297,162
0.2,7100,78,131947,18.581467398957894,27
0.2,7101,71,132018,18.58884821177133,30
0.2,7102,-99,131919,18.57229339715613,132
0.2,7103,75,131994,18.580236486486488,25
0.2,7104,-97,131897,18.563969035890217,60
0.2,7105,8,131905,18.562482409231635,24
0.2,7106,-101,131804,18.545659209230337,132
0.2,7107,25,131829,18.546567248171076,6
0.2,7108,11,131840,18.545505697003797,90
0.2,7109,-7,131833,18.541912798874826,108
0.2,7110,-188,131645,18.512867388552944,220
0.2,7111,79,131724,18.52137232845894,22
0.2,7112,13,131737,18.52059609166315,88
0.2,7113,91,131828,18.530784368850156,9
0.2,7114,36,131864,18.53323963457484,64
0.2,7115,-70,131794,18.52079820123665,104
0.2,7116,58,131852,18.52634537024027,58
0.2,7117,-17,131835,18.521354313009272,119
0.2,7118,18,131853,18.521281078803202,83
0.2,7119,9,131862,18.519943820224718,23
0.2,7120,25,131887,18.52085381266676,7
0.2,7121,92,131979,18.53117101937658,8
0.2,7122,-41,131938,18.522813421311245,144
0.2,7123,-131,131807,18.501824817518248,190
0.2,7124,4,131811,18.49978947368421,97
0.2,7125,47,131858,18.50378894190289,54
0.2,7126,17,131875,18.503577943033534,85
0.2,7127,25,131900,18.504489337822672,75
0.2,7128,13,131913,18.503717211390097,94
0.2,7129,77,131990,18.511921458625526,23
0.2,7130,80,132070,18.520544103211332,20
0.2,7131,87,132157,18.530145821648908,14
0.2,7132,-104,132053,18.51296789569606,138
0.2,7133,92,132145,18.523268853378188,9
0.2,7134,-13,132132,18.51885073580939,115
0.2,7135,85,132217,18.528167040358746,15
0.2,7136,15,132232,18.52767269160712,86
0.2,7137,-79,132153,18.514009526478006,183
0.2,7138,46,132199,18.51785964420787,54
0.2,7139,-29,132170,18.511204481792717,61
0.2,7140,77,132247,18.519395042711103,23
0.2,7141,-47,132200,18.510221226547184,147
0.2,7142,-138,132062,18.488310233795325,172
0.2,7143,-35,132027,18.48082306830907,135
0.2,7144,-292,131735,18.43736878936319,256
0.2,7145,-62,131673,18.426112510495383,167
0.2,7146,61,131734,18.432069399748148,40
0.2,7147,80,131814,18.440682708449916,21
0.2,7148,87,131901,18.450272765421737,13
0.2,7149,-9,131892,18.446433566433566,41
0.2,7150,66,131958,18.453083484827296,36
0.2,7151,80,132038,18.46168903803132,21
0.2,7152,61,132099,18.467635956941145,40
0.2,7153,20,132119,18.467850153760136,81
0.2,7154,62,132181,18.47393431167016,40
0.2,7155,58,132239,18.47945779765232,43
0.2,7156,85,132324,18.488752270504403,31
0.2,7157,66,132390,18.4953897736798,35
0.2,7158,92,132482,18.50565721469479,9
0.2,7159,10,132492,18.504469273743016,92
0.2,7160,46,132538,18.50830889540567,54
0.2,7161,30,132568,18.509913432002232,76
0.2,7162,86,132654,18.519335473963423,15
0.2,7163,72,132726,18.52680067001675,29
0.2,7164,-30,132696,18.520027913468248,61
0.2,7165,47,132743,18.524002232765838,53
0.2,7166,-210,132533,18.492116645737408,256
0.2,7167,-54,132479,18.482003348214285,154
0.2,7168,5,132484,18.48012275073232,97
0.2,7169,-115,132369,18.461506276150626,78
0.2,7170,16,132385,18.461163017710223,84
0.2,7171,-101,132284,18.44450641383157,136
0.2,7172,88,132372,18.454203262233374,12
0.2,7173,24,132396,18.454976303317537,79
0.2,7174,-31,132365,18.44808362369338,133
0.2,7175,16,132381,18.44774247491639,85
0.2,7176,-186,132195,18.4192559565278,152
0.2,7177,81,132276,18.427974366118697,19
0.2,7178,1,132277,18.425546733528346,116
0.2,7179,12,132289,18.424651810584958,91
0.2,7180,67,132356,18.431416237292858,34
0.2,7181,51,132407,18.43595098858257,49
0.2,7182,83,132490,18.44493944034526,17
0.2,7183,45,132535,18.448635857461024,55
0.2,7184,74,132609,18.456367432150312,26
0.2,7185,73,132682,18.463957695519063,28
0.2,7186,87,132769,18.473493808264923,13
0.2,7187,11,132780,18.47245409015025,90
0.2,7188,40,132820,18.47544860203088,63
0.2,7189,91,132911,18.485535465924897,9
0.2,7190,46,132957,18.48936170212766,54
0.2,7191,-24,132933,18.48345383759733,56
0.2,7192,2,132935,18.481162241067704,101
0.2,7193,55,132990,18.486238532110093,48
0.2,7194,16,133006,18.48589298123697,85
0.2,7195,-117,132889,18.467065036131185,220
0.2,7196,1,132890,18.46463804362929,30
0.2,7197,37,132927,18.4672131147541,65
0.2,7198,-6,132921,18.46381441866926,37
0.2,7199,-59,132862,18.453055555555554,90
0.2,7200,94,132956,18.463546729620887,6
0.2,7201,25,132981,18.464454318244933,76
0.2,7202,64,133045,18.470776065528252,39
0.2,7203,1,133046,18.46835091615769,100
0.2,7204,-93,132953,18.452879944482998,199
0.2,7205,42,132995,18.456147654732167,58
0.2,7206,-27,132968,18.449840432912445,132
0.2,7207,77,133045,18.457963374028857,23
0.2,7208,83,133128,18.466916354556805,18
0.2,7209,33,133161,18.46893203883495,75
0.2,7210,-68,133093,18.45694078491194,106
0.2,7211,55,133148,18.462007764836383,46
0.2,7212,91,133239,18.47206432829613,10
0.2,7213,40,133279,18.47504851677294,60
0.2,7214,33,133312,18.477061677061677,67
0.2,7215,25,133337,18.477965631929045,77
0.2,7216,91,133428,18.488014410419844,10
0.2,7217,-326,133102,18.44028816846772,296
0.2,7218,44,133146,18.4438287851503,56
0.2,7219,-40,133106,18.43573407202216,142
0.2,7220,-12,133094,18.43151918016895,113
0.2,7221,67,133161,18.438244253669342,33
0.2,7222,27,133188,18.43942959988924,75
0.2,7223,-58,133130,18.428848283499445,91
0.2,7224,-205,132925,18.397923875432525,238
0.2,7225,-6,132919,18.39454746747855,114
0.2,7226,21,132940,18.39490798394908,11
0.2,7227,-48,132892,18.385722191477587,81
0.2,7228,-97,132795,18.36976068612533,59
0.2,7229,89,132884,18.379529737206084,11
0.2,7230,-82,132802,18.3656479048541,189
0.2,7231,42,132844,18.36891592920354,58
0.2,7232,-50,132794,18.359463569749757,81
0.2,7233,54,132848,18.364390378766934,54
0.2,7234,15,132863,18.363925362819625,98
0.2,7235,-89,132774,18.349087893864013,192
0.2,7236,-13,132761,18.34475611441205,113
0.2,7237,-32,132729,18.337800497374964,132
0.2,7238,62,132791,18.343832020997375,38
0.2,7239,65,132856,18.350276243093923,39
0.2,7240,-90,132766,18.335312802099157,214
0.2,7241,-105,132661,18.318282242474453,137
0.2,7242,88,132749,18.32790280270606,12
0.2,7243,87,132836,18.337382661512976,13
0.2,7244,-72,132764,18.324913733609385,106
0.2,7245,20,132784,18.325144907535194,83
0.2,7246,64,132848,18.331447495515384,36
0.2,7247,94,132942,18.341887417218544,6
0.2,7248,-82,132860,18.328045247620363,197
0.2,7249,61,132921,18.33393103448276,41
0.2,7250,45,132966,18.33760860570956,58
0.2,7251,56,133022,18.34280198565913,44
0.2,7252,-57,132965,18.33241417344547,88
0.2,7253,85,133050,18.34160463192721,16
0.2,7254,74,133124,18.349276361130254,27
0.2,7255,90,133214,18.35915104740904,11
0.2,7256,71,133285,18.366404850489182,30
0.2,7257,-117,133168,18.347754202259576,151
0.2,7258,-223,132945,18.314506130320982,329
0.2,7259,69,133014,18.321487603305783,31
0.2,7260,-105,132909,18.30450351191296,139
0.2,7261,20,132929,18.304736987055907,81
0.2,7262,-20,132909,18.29946303180504,52
0.2,7263,79,132988,18.30781938325991,22
0.2,7264,-121,132867,18.288644184445975,223
0.2,7265,52,132919,18.29328378750344,49
0.2,7266,-93,132826,18.27796890050915,195
0.2,7267,85,132911,18.287149146945513,16
0.2,7268,86,132997,18.296464438024486,15
0.2,7269,85,133082,18.305639614855572,15
0.2,7270,-20,133062,18.30037133819282,123
0.2,7271,33,133095,18.302392739273927,69
0.2,7272,-223,132872,18.269214904441082,262
0.2,7273,73,132945,18.276739070662636,27
0.2,7274,92,133037,18.286872852233678,9
0.2,7275,42,133079,18.29013194062672,59
0.2,7276,42,133121,18.29339013329669,59
0.2,7277,66,133187,18.29994503984611,34
0.2,7278,70,133257,18.307047671383433,31
0.2,7279,-28,133229,18.300686813186815,60
0.2,7280,77,133306,18.308748798242,23
0.2,7281,36,133342,18.31117824773414,67
0.2,7282,75,133417,18.31896196622271,25
0.2,7283,-98,133319,18.30299286106535,203
0.2,7284,90,133409,18.31283459162663,10
0.2,7285,2,133411,18.31059566291518,98
0.2,7286,20,133431,18.31082750102923,83
0.2,7287,4,133435,18.308863885839738,97
0.2,7288,-29,133406,18.302373439429278,131
0.2,7289,-2,133404,18.299588477366257,104
0.2,7290,88,133492,18.309148264984227,12
0.2,7291,45,133537,18.312808557323095,55
0.2,7292,60,133597,18.31852461264226,40
0.2,7293,-261,133336,18.280230326295584,311
0.2,7294,58,133394,18.285675119945168,42
0.2,7295,-381,133013,18.23094846491228,418
0.2,7296,12,133025,18.230094559407977,88
0.2,7297,13,133038,18.229377911756647,88
0.2,7298,7,133045,18.22783943005891,93
0.2,7299,-76,132969,18.214931506849315,200
0.2,7300,80,133049,18.22339405560882,21
0.2,7301,32,133081,18.22528074500137,69
0.2,7302,92,133173,18.235382719430373,8
0.2,7303,-64,133109,18.224123767798467,180
0.2,7304,78,133187,18.232306639288158,23
0.2,7305,-138,133049,18.21092252942787,172
0.2,7306,91,133140,18.220884083755305,9
0.2,7307,-101,133039,18.204570333880678,206
0.2,7308,-10,133029,18.20071145163497,110
0.2,7309,94,133123,18.21108071135431,6
0.2,7310,87,133210,18.220489673095337,14
0.2,7311,27,133237,18.221690371991247,73
0.2,7312,73,133310,18.229180910706962,27
0.2,7313,-41,133269,18.221082854799015,170
0.2,7314,-202,133067,18.19097744360902,339
0.2,7315,-24,133043,18.18521049753964,127
0.2,7316,77,133120,18.193248599152657,24
0.2,7317,83,133203,18.20210440010932,17
0.2,7318,90,133293,18.211914195928404,34
0.2,7319,-136,133157,18.19084699453552,99
0.2,7320,71,133228,18.19806037426581,29
0.2,7321,-99,133129,18.18205408358372,199
0.2,7322,83,133212,18.190905366653013,17
0.2,7323,84,133296,18.199890770071,16
0.2,7324,-9,133287,18.19617747440273,109
0.2,7325,15,133302,18.195741195741196,86
0.2,7326,-15,133287,18.191210590964925,47
0.2,7327,-211,133076,18.159934497816593,315
0.2,7328,92,133168,18.170009551098378,9
0.2,7329,65,133233,18.176398362892225,35
0.2,7330,73,133306,18.183876688037103,28
0.2,7331,9,133315,18.18262411347518,92
0.2,7332,-41,133274,18.1745533887904,151
0.2,7333,-54,133220,18.16471229888192,172
0.2,7334,-76,133144,18.151874573960463,107
0.2,7335,91,133235,18.16180479825518,10
0.2,7336,-79,133156,18.148562082595067,111
0.2,7337,-133,133023,18.12796402289452,166
0.2,7338,23,133046,18.128627878457557,78
0.2,7339,34,133080,18.130790190735695,66
0.2,7340,-149,132931,18.1080234300504,184
0.2,7341,69,133000,18.11495505311904,31
0.2,7342,91,133091,18.124880838894185,9
0.2,7343,-8,133083,18.121323529411764,110
0.2,7344,-71,133012,18.10918992511913,180
0.2,7345,-22,132990,18.103729921045467,124
0.2,7346,-82,132908,18.090104804682184,185
0.2,7347,-12,132896,18.086009798584648,44
0.2,7348,3,132899,18.08395700095251,29
0.2,7349,32,132931,18.085850340136055,70
0.2,7350,29,132960,18.087335056454904,75
0.2,7351,-2,132958,18.084602829162133,105
0.2,7352,77,133035,18.092615259077927,24
0.2,7353,92,133127,18.102665216208866,9
0.2,7354,43,133170,18.106050305914344,59
0.2,7355,84,133254,18.11500815660685,16
0.2,7356,60,133314,18.12070137284219,41
0.2,7357,-10,133304,18.116879586844252,113
0.2,7358,66,133370,18.123386329664356,35
0.2,7359,93,133463,18.133559782608696,8
0.2,7360,42,133505,18.13680206493683,59
0.2,7361,-100,133405,18.120755229557187,209
0.2,7362,39,133444,18.12359092761103,62
0.2,7363,85,133529,18.13267246061923,15
0.2,7364,74,133603,18.140257976917855,27
0.2,7365,65,133668,18.146619603584035,35
0.2,7366,89,133757,18.156237274331477,12
0.2,7367,86,133843,18.16544516829533,14
0.2,7368,-71,133772,18.15334509431402,35
0.2,7369,-79,133693,18.140162822252375,110
0.2,7370,70,133763,18.147198480531813,31
0.2,7371,67,133830,18.15382528486164,34
0.2,7372,-476,133354,18.086803200868033,457
0.2,7373,27,133381,18.088011933821534,84
0.2,7374,-21,133360,18.08271186440678,52
0.2,7375,61,133421,18.088530368763557,39
0.2,7376,72,133493,18.095838416700555,28
0.2,7377,71,133564,18.10300894551369,30
0.2,7378,17,133581,18.102859466052312,85
0.2,7379,33,133614,18.10487804878049,68
0.2,7380,53,133667,18.10960574447907,47
0.2,7381,93,133760,18.11975074505554,8
0.2,7382,91,133851,18.129622104835434,9
0.2,7383,66,133917,18.136105092091007,34
0.2,7384,19,133936,18.136222071767097,84
0.2,7385,27,133963,18.13742215001354,73
0.2,7386,26,133989,18.138486530391226,76
0.2,7387,80,134069,18.146859772604223,20
0.2,7388,-102,133967,18.130599539856544,205
0.2,7389,-135,133832,18.109878213802435,236
0.2,7390,-92,133740,18.094980381545124,193
0.2,7391,-24,133716,18.089285714285715,56
0.2,7392,60,133776,18.094954686865954,40
0.2,7393,11,133787,18.093995131187448,90
0.2,7394,-35,133752,18.0868154158215,137
0.2,7395,-417,133335,18.02798810167658,382
0.2,7396,35,133370,18.030282546978505,67
0.2,7397,73,133443,18.03771289537713,28
0.2,7398,36,133479,18.04014055953507,70
0.2,7399,91,133570,18.05,10
0.2,7400,-171,133399,18.024456154573706,206
0.2,7401,-72,133327,18.01229397460146,105
0.2,7402,93,133420,18.022423341888423,7
0.2,7403,-61,133359,18.011750405186387,92
0.2,7404,9,133368,18.01053342336259,22
0.2,7405,50,133418,18.014852822036186,50
0.2,7406,25,133443,18.015795868772784,77
0.2,7407,81,133524,18.02429805615551,20
0.2,7408,49,133573,18.028478877041437,52
0.2,7409,31,133604,18.030229419703105,70
0.2,7410,80,133684,18.038591283227635,20
0.2,7411,82,133766,18.047220723151646,19
0.2,7412,84,133850,18.056117631188453,16
0.2,7413,-73,133777,18.043835985972486,185
0.2,7414,88,133865,18.053270397842212,13
0.2,7415,92,133957,18.06324163969795,8
0.2,7416,38,133995,18.065929621140622,63
0.2,7417,-30,133965,18.059449986519276,63
0.2,7418,3,133968,18.057420137484836,98
0.2,7419,9,133977,18.056199460916442,92
0.2,7420,12,133989,18.055383371513273,20
0.2,7421,-35,133954,18.048234977095124,67
0.2,7422,78,134032,18.056311464367507,22
0.2,7423,79,134111,18.064520474137932,35
0.2,7424,55,134166,18.06949494949495,45
0.2,7425,27,134193,18.070697549151628,74
0.2,7426,59,134252,18.07620842870607,42
0.2,7427,86,134338,18.085352719439957,15
0.2,7428,92,134430,18.095302194104185,9
0.2,7429,41,134471,18.098384925975775,59
0.2,7430,7,134478,18.096891400888172,95
0.2,7431,-37,134441,18.08947793326157,69
0.2,7432,-16,134425,18.084891699179334,116
0.2,7433,-3,134422,18.082055421038472,35
0.2,7434,-32,134390,18.075319435104237,65
0.2,7435,94,134484,18.085529854760622,6
0.2,7436,68,134552,18.09224149522657,32
0.2,7437,-39,134513,18.08456574347943,141
0.2,7438,67,134580,18.091141282430435,34
0.2,7439,83,134663,18.09986559139785,17
0.2,7440,52,134715,18.104421448730008,50
0.2,7441,-93,134622,18.08949207202365,125
0.2,7442,18,134640,18.089480048367594,83
0.2,7443,-1,134639,18.086915636754433,102
0.2,7444,90,134729,18.096574882471458,10
0.2,7445,90,134819,18.106231533709373,10
0.2,7446,82,134901,18.114811333422853,19
0.2,7447,-38,134863,18.107277121374867,91
0.2,7448,47,134910,18.11115585984696,54
0.2,7449,22,134932,18.111677852348993,79
0.2,7450,91,135023,18.12146020668367,9
0.2,7451,-96,134927,18.106146001073537,197
0.2,7452,17,134944,18.105997584865154,88
0.2,7453,-18,134926,18.1011537429568,120
0.2,7454,-258,134668,18.06411804158283,293
0.2,7455,33,134701,18.066121244635195,67
0.2,7456,30,134731,18.067721603862143,70
0.2,7457,67,134798,18.07428264950389,34
0.2,7458,81,134879,18.08271886311838,20
0.2,7459,-47,134832,18.073994638069706,79
0.2,7460,-186,134646,18.046642541214315,218
0.2,7461,41,134687,18.04971857410882,60
0.2,7462,58,134745,18.055071686989148,43
0.2,7463,33,134778,18.057073954983924,68
0.2,7464,27,134805,18.05827193569993,74
0.2,7465,-96,134709,18.042994910259846,215
0.2,7466,33,134742,18.044997991161107,67
0.2,7467,-17,134725,18.04030530262453,49
0.2,7468,67,134792,18.04686035613871,35
0.2,7469,-32,134760,18.04016064257028,65
0.2,7470,3,134763,18.0381475036809,28
0.2,7471,-102,134661,18.02208244111349,207
0.2,7472,80,134741,18.03037602033989,21
0.2,7473,68,134809,18.037061814289537,32
0.2,7474,48,134857,18.04107023411371,52
0.2,7475,73,134930,18.048421615837345,28
0.2,7476,63,134993,18.054433596362177,38
0.2,7477,91,135084,18.064188285637872,10
0.2,7478,67,135151,18.070731381200694,34
0.2,7479,54,135205,18.075534759358288,47
0.2,7480,69,135274,18.08234193289667,31
0.2,7481,45,135319,18.08593958834536,56
0.2,7482,83,135402,18.094614459441402,18
0.2,7483,63,135465,18.100614644575092,38
0.2,7484,77,135542,18.108483633934537,23
0.2,7485,-49,135493,18.09951910232434,149
0.2,7486,10,135503,18.09843729130493,90
0.2,7487,65,135568,18.104700854700855,35
0.2,7488,-37,135531,18.097342769395112,137
0.2,7489,46,135577,18.101068090787717,56
0.2,7490,13,135590,18.100387131224135,88
0.2,7491,-55,135535,18.09063000533903,89
0.2,7492,85,135620,18.099559588949685,15
0.2,7493,-1,135619,18.097010942087003,34
0.2,7494,-53,135566,18.087525016677784,155
0.2,7495,51,135617,18.09191568836713,51
0.2,7496,-76,135541,18.07936507936508,179
0.2,7497,86,135627,18.08842357962123,15
0.2,7498,83,135710,18.09707961061475,18
0.2,7499,-59,135651,18.0868,163
0.2,7500,8,135659,18.085455272630316,24
0.2,7501,74,135733,18.09290855771794,27
0.2,7502,-61,135672,18.08236705317873,162
0.2,7503,26,135698,18.083422174840084,6
0.2,7504,-164,135534,18.059160559626914,127
0.2,7505,-44,135490,18.050892619237942,79
0.2,7506,72,135562,18.05807912614893,29
0.2,7507,-2,135560,18.055407565263717,103
0.2,7508,36,135596,18.05779730989479,64
0.2,7509,-59,135537,18.047536617842876,162
0.2,7510,66,135603,18.05392091598988,37
0.2,7511,88,135691,18.063232161874335,13
0.2,7512,76,135767,18.07094369759084,24
0.2,7513,95,135862,18.081181793984562,6
0.2,7514,92,135954,18.091017964071856,8
0.2,7515,-119,135835,18.07277807344332,153
0.2,7516,92,135927,18.08261274444592,8
0.2,7517,-53,135874,18.073157754722,85
0.2,7518,32,135906,18.075009974730683,68
0.2,7519,52,135958,18.079521276595745,49
0.2,7520,-28,135930,18.073394495412845,60
0.2,7521,22,135952,18.073916511566072,78
0.2,7522,83,136035,18.082546856307324,17
0.2,7523,85,136120,18.09144072301967,16
0.2,7524,13,136133,18.090764119601328,88
0.2,7525,-16,136117,18.086234387456816,118
0.2,7526,-60,136057,18.075860236481997,92
0.2,7527,86,136143,18.08488310308183,15
0.2,7528,68,136211,18.091512817107187,33
0.2,7529,18,136229,18.091500664010624,13
0.2,7530,-275,135954,18.052582658345504,242
0.2,7531,66,136020,18.05894848645778,34
0.2,7532,93,136113,18.06889685384309,8
0.2,7533,48,136161,18.072869657552427,52
0.2,7534,67,136228,18.07936297279363,33
0.2,7535,68,136296,18.085987261146496,32
0.2,7536,10,136306,18.084914422183893,91
0.2,7537,-70,136236,18.07322897320244,170
0.2,7538,-67,136169,18.061944554980766,168
0.2,7539,45,136214,18.06551724137931,55
0.2,7540,91,136305,18.075188966980505,9
0.2,7541,-28,136277,18.069079819676478,130
0.2,7542,24,136301,18.069866101020814,76
0.2,7543,15,136316,18.069459172852596,87
0.2,7544,71,136387,18.076474486414845,29
0.2,7545,89,136476,18.085873310363105,11
0.2,7546,-52,136424,18.076586723201274,154
0.2,7547,0,136424,18.074191838897722,100
0.2,7548,81,136505,18.08252748708438,19
0.2,7549,-39,136466,18.07496688741722,139
0.2,7550,-86,136380,18.061183949145807,188
0.2,7551,49,136429,18.065280720338983,52
0.2,7552,63,136492,18.07122997484443,38
0.2,7553,78,136570,18.079163357161768,22
0.2,7554,-157,136413,18.0559894109861,260
0.2,7555,-18,136395,18.051217575436738,51
0.2,7556,70,136465,18.058091835384413,30
0.2,7557,95,136560,18.06827202963747,6
0.2,7558,-63,136497,18.05754729461569,167
0.2,7559,-80,136417,18.04457671957672,182
0.2,7560,-5,136412,18.041528898293876,36
0.2,7561,57,136469,18.046680772282464,46
0.2,7562,-172,136297,18.021552294063202,135
0.2,7563,74,136371,18.02895293495505,26
0.2,7564,21,136392,18.02934567085261,145
0.2,7565,94,136486,18.03938673010838,7
0.2,7566,-212,136274,18.008986388264834,316
0.2,7567,79,136353,18.017045454545453,21
0.2,7568,-44,136309,18.008851895891134,148
0.2,7569,95,136404,18.019022457067372,6
0.2,7570,49,136453,18.023114515915996,52
0.2,7571,-19,136434,18.01822503961965,119
0.2,7572,-42,136392,18.010299749108675,76
0.2,7573,-246,136146,17.975442302614205,349
0.2,7574,65,136211,17.9816501650165,36
0.2,7575,89,136300,17.99102428722281,11
0.2,7576,-62,136238,17.980467203378645,95
0.2,7577,83,136321,17.989047242016362,17
0.2,7578,14,136335,17.988520913049214,89
0.2,7579,87,136422,17.997625329815303,14
0.2,7580,-23,136399,17.992217385569187,123
0.2,7581,-62,136337,17.981667106304407,96
0.2,7582,66,136403,17.987999472504285,34
0.2,7583,2,136405,17.98589135021097,30
0.2,7584,17,136422,17.985761371127225,83
0.2,7585,67,136489,17.992222515159504,47
0.2,7586,-17,136472,17.987610386186898,48
0.2,7587,61,136533,17.993278861360043,39
0.2,7588,-229,136304,17.96073263934642,334
0.2,7589,65,136369,17.966930171277998,36
0.2,7590,74,136443,17.97431168489,26
0.2,7591,19,136462,17.97444678609062,81
0.2,7592,14,136476,17.973923350454367,89
0.2,7593,79,136555,17.981959441664472,22
0.2,7594,37,136592,17.984463462804477,65
0.2,7595,78,136670,17.99236440231701,22
0.2,7596,84,136754,18.001053047255496,17
0.2,7597,90,136844,18.010529086601736,11
0.2,7598,79,136923,18.018555073035927,21
0.2,7599,73,136996,18.02578947368421,28
0.2,7600,-48,136948,18.017103012761478,150
0.2,7601,90,137038,18.02657195474875,11
0.2,7602,93,137131,18.036432986978824,8
0.2,7603,94,137225,18.046422935297212,6
0.2,7604,92,137317,18.056147271531888,8
0.2,7605,85,137402,18.064948724691032,15
0.2,7606,10,137412,18.063888523728146,123
0.2,7607,-15,137397,18.059542586750787,119
0.2,7608,90,137487,18.068997240110395,11
0.2,7609,71,137558,18.075952693823915,29
0.2,7610,84,137642,18.084614373932467,17
0.2,7611,21,137663,18.084997372569628,80
0.2,7612,74,137737,18.092342046499407,26
0.2,7613,93,137830,18.102180194378775,7
0.2,7614,89,137919,18.111490479317137,12
0.2,7615,-23,137896,18.10609243697479,124
0.2,7616,-48,137848,18.09741367992648,151
0.2,7617,62,137910,18.103176686794434,39
0.2,7618,39,137949,18.105919411996325,61
0.2,7619,91,138040,18.11548556430446,10
0.2,7620,93,138133,18.125311638892533,8
0.2,7621,-25,138108,18.119653634216743,127
0.2,7622,79,138187,18.127640036730945,22
0.2,7623,57,138244,18.13273871983211,44
0.2,7624,-157,138087,18.10977049180328,264
0.2,7625,94,138181,18.11972200367165,6
0.2,7626,95,138276,18.12980201914252,6
0.2,7627,89,138365,18.139092815941268,11
0.2,7628,57,138422,18.144186656180363,44
0.2,7629,-2,138420,18.14154652686763,104
0.2,7630,73,138493,18.148735421307823,34
0.2,7631,-126,138367,18.129848008385743,231
0.2,7632,-66,138301,18.118826149613522,101
0.2,7633,90,138391,18.128242074927954,10
0.2,7634,90,138481,18.13765553372626,10
0.2,7635,61,138542,18.14326872708224,39
0.2,7636,73,138615,18.150451748068612,27
0.2,7637,69,138684,18.157109190887667,31
0.2,7638,-113,138571,18.13993978269407,215
0.2,7639,-58,138513,18.12997382198953,160
0.2,7640,-13,138500,18.125899751341446,44
0.2,7641,12,138512,18.125098141847683,88
0.2,7642,83,138595,18.133586288106763,18
0.2,7643,71,138666,18.14050235478807,30
0.2,7644,83,138749,18.14898626553303,29
0.2,7645,90,138839,18.158383468480253,10
0.2,7646,-29,138810,18.152216555511966,132
0.2,7647,52,138862,18.156642259414227,48
0.2,7648,47,138909,18.16041312589881,54
0.2,7649,32,138941,18.162222222222223,70
0.2,7650,-35,138906,18.155273820415633,67
0.2,7651,17,138923,18.155122843700994,83
0.2,7652,72,138995,18.162158630602377,30
0.2,7653,-20,138975,18.157172720146328,126
0.2,7654,-98,138877,18.14199869366427,200
0.2,7655,70,138947,18.148772204806686,30
0.2,7656,76,139023,18.156327543424318,24
0.2,7657,94,139117,18.166231392008356,6
0.2,7658,79,139196,18.174174174174173,22
0.2,7659,-8,139188,18.17075718015666,110
0.2,7660,-97,139091,18.155723795849106,201
0.2,7661,50,139141,18.159879926912033,51
0.2,7662,-164,138977,18.136108573665666,204
0.2,7663,-12,138965,18.132176409185803,113
0.2,7664,84,139049,18.140769732550556,16
0.2,7665,39,139088,18.14349073832507,61
0.2,7666,-43,139045,18.135515847137082,76
0.2,7667,77,139122,18.143192488262912,23
0.2,7668,-38,139084,18.13587169122441,140
0.2,7669,30,139114,18.1374185136897,71
0.2,7670,63,139177,18.143266849172207,38
0.2,7671,91,139268,18.15276329509906,10
0.2,7672,-20,139248,18.147790955297797,123
0.2,7673,53,139301,18.152332551472504,47
0.2,7674,39,139340,18.155048859934855,63
0.2,7675,-27,139313,18.149166232412714,58
0.2,7676,68,139381,18.155659762928227,33
0.2,7677,-27,139354,18.149778588174005,93
0.2,7678,55,139409,18.154577418934757,46
0.2,7679,-53,139356,18.1453125,95
0.2,7680,47,139403,18.149069131623488,54
0.2,7681,92,139495,18.15868263473054,8
0.2,7682,15,139510,18.158271508525317,17
0.2,7683,-22,139488,18.153045288912026,125
0.2,7684,67,139555,18.159401431359793,34
0.2,7685,-57,139498,18.149622690606297,159
0.2,7686,67,139565,18.155977624560947,35
0.2,7687,11,139576,18.155046826222684,90
0.2,7688,54,139630,18.159708674730133,46
0.2,7689,-119,139511,18.14187256176853,221
0.2,7690,59,139570,18.147185021453648,42
0.2,7691,-159,139411,18.12415496619865,192
0.2,7692,31,139442,18.12582867541921,70
0.2,7693,46,139488,18.129451520665455,55
0.2,7694,-45,139443,18.121247563352828,145
0.2,7695,73,139516,18.12837837837838,28
0.2,7696,44,139560,18.13173963882032,57
0.2,7697,77,139637,18.13938685372824,24
0.2,7698,77,139714,18.147032082088582,23
0.2,7699,68,139782,18.153506493506494,33
0.2,7700,75,139857,18.16088819633814,25
0.2,7701,-108,139749,18.144507920020775,212
0.2,7702,89,139838,18.153706348176037,11
0.2,7703,1,139839,18.151479750778815,100
0.2,7704,-191,139648,18.124334847501622,297
0.2,7705,71,139719,18.131196470282898,30
0.2,7706,61,139780,18.136758790709745,42
0.2,7707,92,139872,18.146341463414632,8
0.2,7708,30,139902,18.147879102347904,70
0.2,7709,-218,139684,18.117250324254215,325
0.2,7710,22,139706,18.117753858124757,79
0.2,7711,7,139713,18.116312240663902,25
0.2,7712,85,139798,18.124983793595227,16
0.2,7713,-28,139770,18.11900440757065,130
0.2,7714,-38,139732,18.111730395333765,141
0.2,7715,21,139753,18.112104717470192,82
0.2,7716,53,139806,18.116625631722172,48
0.2,7717,73,139879,18.123736719357346,28
0.2,7718,-24,139855,18.118279569892472,57
0.2,7719,52,139907,18.122668393782384,57
0.2,7720,10,139917,18.121616370936408,92
0.2,7721,17,139934,18.12147112147112,14
0.2,7722,9,139943,18.120290042729508,92
0.2,7723,95,140038,18.13024339720352,6
0.2,7724,91,140129,18.13967637540453,10
0.2,7725,-284,139845,18.100569505565623,321
0.2,7726,82,139927,18.1088391354989,18
0.2,7727,63,139990,18.114648033126294,37
0.2,7728,36,140026,18.116962090826757,66
0.2,7729,70,140096,18.123673997412677,31
0.2,7730,31,140127,18.12533954210322,69
0.2,7731,39,140166,18.12803931712364,75
0.2,7732,42,140208,18.131126341652656,58
0.2,7733,48,140256,18.13498836307215,56
0.2,7734,75,140331,18.142340012928248,26
0.2,7735,86,140417,18.151111685625647,14
0.2,7736,68,140485,18.157554607729093,33
0.2,7737,-215,140270,18.12742310674593,179
0.2,7738,94,140364,18.137227031916268,6
0.2,7739,70,140434,18.14392764857881,31
0.2,7740,44,140478,18.147267794858546,57
0.2,7741,-15,140463,18.14298630844743,118
0.2,7742,62,140525,18.148650393904173,38
0.2,7743,60,140585,18.154054752066116,42
0.2,7744,45,140630,18.157520981278243,57
0.2,7745,73,140703,18.164601084430675,27
0.2,7746,-12,140691,18.16070737059507,43
0.2,7747,80,140771,18.168688693856478,20
0.2,7748,80,140851,18.17666795715576,21
0.2,7749,94,140945,18.186451612903227,7
0.2,7750,-80,140865,18.173784027867374,114
0.2,7751,24,140889,18.17453560371517,79
0.2,7752,76,140965,18.181994066812848,42
0.2,7753,-11,140954,18.178230590662885,112
0.2,7754,-220,140734,18.147517730496453,327
0.2,7755,75,140809,18.154847859721507,26
0.2,7756,39,140848,18.157535129560397,61
0.2,7757,-5,140843,18.15455014178912,107
0.2,7758,86,140929,18.163294238948318,15
0.2,7759,66,140995,18.1694587628866,35
0.2,7760,60,141055,18.17484860198428,40
0.2,7761,73,141128,18.18191187838186,27
0.2,7762,8,141136,18.180600283395595,93
0.2,7763,76,141212,18.188047398248326,24
0.2,7764,21,141233,18.18840952994205,79
0.2,7765,76,141309,18.195853721349472,24
0.2,7766,95,141404,18.205742242822197,6
0.2,7767,56,141460,18.21060762100927,44
0.2,7768,-47,141413,18.20221392714635,80
0.2,7769,-63,141350,18.19176319176319,96
0.2,7770,64,141414,18.197657959078626,36
0.2,7771,-116,141298,18.180391147709727,151
0.2,7772,79,141377,18.188215618165444,22
0.2,7773,91,141468,18.197581682531514,9
0.2,7774,70,141538,18.204244372990352,31
0.2,7775,-44,141494,18.196244855967077,76
0.2,7776,85,141579,18.204834769191205,15
0.2,7777,25,141604,18.20570840833119,78
0.2,7778,-106,141498,18.189741612032396,139
0.2,7779,32,141530,18.191516709511568,68
0.2,7780,59,141589,18.196761341729854,41
0.2,7781,87,141676,18.205602672834747,14
0.2,7782,49,141725,18.20955929590132,52
0.2,7783,36,141761,18.211844809866392,66
0.2,7784,-4,141757,18.208991650610148,35
0.2,7785,71,141828,18.215771898278962,29
0.2,7786,94,141922,18.225504045203543,6
0.2,7787,63,141985,18.231253210066768,37
0.2,7788,9,141994,18.230068044678394,93
0.2,7789,73,142067,18.23709884467266,28
0.2,7790,79,142146,18.244897959183675,21
0.2,7791,78,142224,18.252566735112936,22
0.2,7792,-1,142223,18.250096240215576,32
0.2,7793,69,142292,18.256607646907877,34
0.2,7794,85,142377,18.265169980756895,16
0.2,7795,95,142472,18.275012827090816,6
0.2,7796,90,142562,18.284211876362704,22
0.2,7797,68,142630,18.290587330084637,32
0.2,7798,31,142661,18.29221695089114,71
0.2,7799,-69,142592,18.28102564102564,173
0.2,7800,-390,142202,18.228688629662862,496
0.2,7801,-154,142048,18.206613688797745,262
0.2,7802,57,142105,18.211585287709855,43
0.2,7803,41,142146,18.21450538185546,59
0.2,7804,-136,142010,18.194746957078795,241
0.2,7805,42,142052,18.19779656674353,59
0.2,7806,-80,141972,18.1852183937492,184
0.2,7807,19,141991,18.18532274590164,82
0.2,7808,-77,141914,18.1731335638366,110
0.2,7809,-1,141913,18.170678617157492,104
0.2,7810,79,141992,18.17846626552298,21
0.2,7811,55,142047,18.183179723502302,67
0.2,7812,84,142131,18.191603737360808,17
0.2,7813,18,142149,18.191579216790377,85
0.2,7814,29,142178,18.192962252079333,72
0.2,7815,82,142260,18.20112589559877,18
0.2,7816,80,142340,18.20903159779967,20
0.2,7817,81,142421,18.21706318751599,19
0.2,7818,36,142457,18.21933751119069,64
0.2,7819,54,142511,18.223913043478262,46
0.2,7820,70,142581,18.23053317990027,31
0.2,7821,-30,142551,18.224367169521862,62
0.2,7822,83,142634,18.232647321999234,18
0.2,7823,91,142725,18.241947852760735,10
0.2,7824,82,142807,18.25009584664537,19
0.2,7825,-23,142784,18.24482494249936,126
0.2,7826,30,142814,18.246326817426855,70
0.2,7827,77,142891,18.253832396525294,24
0.2,7828,68,142959,18.26018648614127,33
0.2,7829,-37,142922,18.253128991060027,68
0.2,7830,34,142956,18.2551398288852,66
0.2,7831,80,143036,18.26302349336057,21
0.2,7832,82,143118,18.271160474913827,18
0.2,7833,76,143194,18.278529486852182,24
0.2,7834,57,143251,18.283471601786854,43
0.2,7835,93,143344,18.293006636038797,8
0.2,7836,-76,143268,18.280974862830163,179
0.2,7837,71,143339,18.2877009441184,30
0.2,7838,73,143412,18.294680443934176,28
0.2,7839,-278,143134,18.256887755102042,385
0.2,7840,81,143215,18.264889682438465,19
0.2,7841,-7,143208,18.26166794185157,108
0.2,7842,86,143294,18.270304730332782,14
0.2,7843,69,143363,18.27677205507394,31
0.2,7844,72,143435,18.283620140216698,29
0.2,7845,22,143457,18.284093805760897,9
0.2,7846,76,143533,18.291448961386518,24
0.2,7847,90,143623,18.30058613659531,11
0.2,7848,94,143717,18.31023060262454,6
0.2,7849,56,143773,18.315031847133756,45
0.2,7850,-197,143576,18.287606674309004,300
0.2,7851,95,143671,18.297376464595008,6
0.2,7852,-17,143654,18.292881701260665,120
0.2,7853,70,143724,18.299465240641712,31
0.2,7854,89,143813,18.308465945257797,11
0.2,7855,3,143816,18.30651731160896,99
0.2,7856,-50,143766,18.297823596792668,152
0.2,7857,18,143784,18.29778569610588,13
0.2,7858,-69,143715,18.28667769436315,172
0.2,7859,76,143791,18.294020356234096,25
0.2,7860,-48,143743,18.285587075435696,82
0.2,7861,-69,143674,18.274484863902316,174
0.2,7862,90,143764,18.283606765865446,11
0.2,7863,81,143845,18.291581892166835,19
0.2,7864,4,143849,18.28976478067387,28
0.2,7865,81,143930,18.2977370963641,19
0.2,7866,-31,143899,18.29147070039405,63
0.2,7867,-125,143774,18.27325876970005,163
0.2,7868,-3,143771,18.270555343753973,111
0.2,7869,-42,143729,18.26289707750953,98
0.2,7870,1,143730,18.260703849574387,99
0.2,7871,88,143818,18.26956300813008,12
0.2,7872,95,143913,18.279309030864983,13
0.2,7873,61,143974,18.28473456946914,39
0.2,7874,84,144058,18.293079365079365,16
0.2,7875,74,144132,18.300152361604876,27
0.2,7876,92,144224,18.309508696204137,8
0.2,7877,37,144261,18.31188118811881,63
0.2,7878,25,144286,18.312730041883487,75
0.2,7879,14,144300,18.31218274111675,87
0.2,7880,67,144367,18.318360614135262,33
0.2,7881,-49,144318,18.309819842679524,152
0.2,7882,-168,144150,18.286185462387415,202
0.2,7883,89,144239,18.29515474378488,11
0.2,7884,67,144306,18.30133164235891,33
0.2,7885,41,144347,18.30420999239158,60
0.2,7886,91,144438,18.313427158615443,10
0.2,7887,70,144508,18.319979716024342,30
0.2,7888,34,144542,18.321967296235265,69
0.2,7889,72,144614,18.32877059569075,30
0.2,7890,-60,144554,18.318844252946395,94
0.2,7891,52,144606,18.323112012164216,67
0.2,7892,-149,144457,18.301913087545927,183
0.2,7893,-98,144359,18.28718013681277,203
0.2,7894,56,144415,18.29195693476884,44
0.2,7895,-60,144355,18.282041540020263,92
0.2,7896,-20,144335,18.277193871090287,123
0.2,7897,43,144378,18.28032413269182,58
0.2,7898,25,144403,18.281174832257246,77
0.2,7899,25,144428,18.282025316455695,76
0.2,7900,-21,144407,18.277053537526896,121
0.2,7901,52,144459,18.28132118451025,48
0.2,7902,93,144552,18.290775654814627,8
0.2,7903,39,144591,18.293395748987855,62
0.2,7904,29,144620,18.294750158127766,72
0.2,7905,47,144667,18.298380976473563,54
0.2,7906,88,144755,18.307196155305427,12
0.2,7907,84,144839,18.31550328780981,16
0.2,7908,59,144898,18.320647363762802,41
0.2,7909,-5,144893,18.31769911504425,105
0.2,7910,-75,144818,18.305903172797372,108
0.2,7911,77,144895,18.313321536905967,23
0.2,7912,-41,144854,18.305825856186022,160
0.2,7913,-32,144822,18.299469294920396,63
0.2,7914,-34,144788,18.292861655085282,137
0.2,7915,94,144882,18.302425467407783,6
0.2,7916,14,144896,18.301882026019957,86
0.2,7917,87,144983,18.310558221773174,14
0.2,7918,54,145037,18.31506503346382,49
0.2,7919,82,145119,18.32310606060606,18
0.2,7920,55,145174,18.32773639691958,45
0.2,7921,-203,144971,18.299798030800304,238
0.2,7922,-57,144914,18.290294080525054,104
0.2,7923,53,144967,18.29467440686522,47
0.2,7924,54,145021,18.29917981072555,47
0.2,7925,59,145080,18.30431491294474,41
0.2,7926,-43,145037,18.296581304402675,146
0.2,7927,82,145119,18.304616548940466,18
0.2,7928,57,145176,18.309496783957623,43
0.2,7929,-21,145155,18.30453972257251,121
0.2,7930,-38,145117,18.297440423654017,72
0.2,7931,70,145187,18.303958648512356,31
0.2,7932,5,145192,18.302281608470945,96
0.2,7933,86,145278,18.310814217292666,15
0.2,7934,-24,145254,18.3054820415879,56
0.2,7935,-140,145114,18.285534274193548,103
0.2,7936,-115,144999,18.268741338037042,222
0.2,7937,93,145092,18.278155706727134,7
0.2,7938,72,145164,18.284922534324224,28
0.2,7939,75,145239,18.29206549118388,25
0.2,7940,70,145309,18.298577005414934,31
0.2,7941,24,145333,18.29929488793755,8
0.2,7942,22,145355,18.299760795669144,78
0.2,7943,-18,145337,18.29519133937563,119
0.2,7944,-70,145267,18.284078036500944,103
0.2,7945,68,145335,18.290334759627484,33
0.2,7946,92,145427,18.299609915691455,8
0.2,7947,74,145501,18.306618017111223,27
0.2,7948,25,145526,18.307460057868916,6
0.2,7949,37,145563,18.30981132075472,63
0.2,7950,63,145626,18.315432021129418,37
0.2,7951,0,145626,18.313128772635814,31
0.2,7952,94,145720,18.322645542562555,7
0.2,7953,-4,145716,18.319839074679408,36
0.2,7954,57,145773,18.32470144563168,44
0.2,7955,-94,145679,18.310583207642033,197
0.2,7956,-111,145568,18.29433203468644,222
0.2,7957,89,145657,18.303216888665492,11
0.2,7958,37,145694,18.305566025882648,63
0.2,7959,61,145755,18.310929648241206,39
0.2,7960,-32,145723,18.304609973621403,133
0.2,7961,36,145759,18.30683245415725,65
0.2,7962,89,145848,18.31571015948763,12
0.2,7963,-87,145761,18.302486187845304,190
0.2,7964,39,145800,18.305084745762713,62
0.2,7965,64,145864,18.310820989204117,36
0.2,7966,27,145891,18.311911635496422,76
0.2,7967,63,145954,18.317520080321284,37
0.2,7968,58,146012,18.322499686284353,43
0.2,7969,46,146058,18.325972396486826,55
0.2,7970,48,146106,18.329695144900263,54
0.2,7971,85,146191,18.338058203712997,15
0.2,7972,-119,146072,18.320832810736235,151
0.2,7973,63,146135,18.32643591672937,39
0.2,7974,69,146204,18.332789968652037,34
0.2,7975,43,146247,18.33588264794383,58
0.2,7976,-121,146126,18.318415444402657,155
0.2,7977,67,146193,18.32451742291301,34
0.2,7978,63,146256,18.330116555959393,43
0.2,7979,34,146290,18.332080200501252,68
0.2,7980,43,146333,18.3351710311991,58
0.2,7981,89,146422,18.344024054121775,11
0.2,7982,12,146434,18.34322936239509,88
0.2,7983,52,146486,18.34744488977956,48
0.2,7984,92,146578,18.35666875391359,8
0.2,7985,57,146635,18.361507638367144,44
0.2,7986,58,146693,18.3664705145862,42
0.2,7987,55,146748,18.371056584877316,48
0.2,7988,38,146786,18.373513581174116,62
0.2,7989,89,146875,18.38235294117647,11
0.2,7990,92,146967,18.3915655112001,8
0.2,7991,-7,146960,18.38838838838839,107
0.2,7992,84,147044,18.396597022394594,17
0.2,7993,45,147089,18.39992494370778,56
0.2,7994,-114,146975,18.3833646028768,217
0.2,7995,83,147058,18.39144572286143,17
0.2,7996,59,147117,18.396523696386144,42
0.2,7997,65,147182,18.40235058764691,36
0.2,7998,-92,147090,18.38854856857107,131
0.2,7999,50,147140,18.3925,51
0.2,8000,60,147200,18.397700287464065,41
0.2,8001,-137,147063,18.378280429892527,169
0.2,8002,78,147141,18.38573035111833,23
0.2,8003,86,147227,18.394177911044476,15
0.2,8004,-223,147004,18.364022485946283,325
0.2,8005,-95,146909,18.349862603047715,199
0.2,8006,94,147003,18.35931060322218,6
0.2,8007,39,147042,18.361888111888113,63
0.2,8008,56,147098,18.366587588962417,45
0.2,8009,65,147163,18.372409488139827,36
0.2,8010,88,147251,18.38110098614405,12
0.2,8011,52,147303,18.385297054418373,49
0.2,8012,-160,147143,18.363035068014476,262
0.2,8013,-13,147130,18.359121537309708,114
0.2,8014,-10,147120,18.355583281347474,112
0.2,8015,82,147202,18.363522954091817,18
0.2,8016,12,147214,18.362729200449046,88
0.2,8017,82,147296,18.370666001496634,18
0.2,8018,92,147388,18.379847861329342,8
0.2,8019,90,147478,18.388778054862843,11
0.2,8020,60,147538,18.393965839670862,40
0.2,8021,12,147550,18.39316878583894,89
0.2,8022,56,147606,18.397856163529852,45
0.2,8023,-15,147591,18.393693918245265,47
0.2,8024,93,147684,18.402990654205606,8
0.2,8025,-14,147670,18.398953401445304,45
0.2,8026,70,147740,18.405381836302478,30
0.2,8027,-1,147739,18.40296462381664,101
0.2,8028,-316,147423,18.361315232282973,419
0.2,8029,7,147430,18.359900373599004,94
0.2,8030,-63,147367,18.34976964263479,163
0.2,8031,68,147435,18.355951195219124,33
0.2,8032,-241,147194,18.323664882360262,277
0.2,8033,70,147264,18.33009708737864,31
0.2,8034,5,147269,18.32843808338519,118
0.2,8035,53,147322,18.33275261324042,48
0.2,8036,56,147378,18.337439343038447,44
0.2,8037,69,147447,18.34374222443394,32
0.2,8038,34,147481,18.34568976240826,67
0.2,8039,56,147537,18.350373134328358,56
0.2,8040,-34,147503,18.343862703643826,137
0.2,8041,65,147568,18.34966426262124,35
0.2,8042,-42,147526,18.342160885241825,144
0.2,8043,89,147615,18.350944803580308,11
0.2,8044,94,147709,18.360348042262274,7
0.2,8045,87,147796,18.368878946060153,13
0.2,8046,6,147802,18.36734186653411,94
0.2,8047,35,147837,18.369408548707753,65
0.2,8048,-226,147611,18.339048328984966,332
0.2,8049,-55,147556,18.329937888198756,93
0.2,8050,56,147612,18.33461681778661,45
0.2,8051,10,147622,18.33358171882762,93
0.2,8052,23,147645,18.334161182168135,79
0.2,8053,86,147731,18.3425627017631,14
0.2,8054,92,147823,18.351707014276847,9
0.2,8055,88,147911,18.36035253227408,12
0.2,8056,-134,147777,18.34144222415291,166
0.2,8057,-29,147748,18.335567138247704,130
0.2,8058,-1,147747,18.333167886834595,104
0.2,8059,92,147839,18.342307692307692,8
0.2,8060,52,147891,18.346483066617044,48
0.2,8061,4,147895,18.34470354750682,97
0.2,8062,60,147955,18.349869775517796,40
0.2,8063,16,147971,18.349578373015873,16
0.2,8064,54,148025,18.353998760074397,46
0.2,8065,51,148076,18.35804611951401,52
0.2,8066,53,148129,18.36234039915706,49
0.2,8067,1,148130,18.3601883986118,99
0.2,8068,42,148172,18.36311810633288,60
0.2,8069,45,148217,18.366418835192068,55
0.2,8070,56,148273,18.371081650353116,44
0.2,8071,50,148323,18.375,50
0.2,8072,-1,148322,18.372600024773938,101
0.2,8073,93,148415,18.381842952687638,7
0.2,8074,76,148491,18.388978328173376,24
0.2,8075,14,148505,18.388434868746906,87
0.2,8076,-115,148390,18.371920267426024,189
0.2,8077,39,148429,18.374473879673186,61
0.2,8078,94,148523,18.383834632999132,7
0.2,8079,9,148532,18.382673267326734,91
0.2,8080,-65,148467,18.37235490657097,97
0.2,8081,37,148504,18.37465973768869,65
0.2,8082,49,148553,18.378448595818384,52
0.2,8083,-76,148477,18.366773874319644,179
0.2,8084,-9,148468,18.36338899196042,129
0.2,8085,-43,148425,18.35580014840465,144
0.2,8086,-10,148415,18.352293804872016,112
0.2,8087,-62,148353,18.342359050445104,172
0.2,8088,91,148444,18.351341327729013,9
0.2,8089,76,148520,18.358467243510507,25
0.2,8090,-180,148340,18.333951303917935,212
0.2,8091,-33,148307,18.327607513593673,75
0.2,8092,71,148378,18.334115902631904,30
0.2,8093,-61,148317,18.324314306893996,161
0.2,8094,92,148409,18.333415688696725,8
0.2,8095,-124,148285,18.315834980237153,226
0.2,8096,-202,148083,18.288625416821045,239
0.2,8097,55,148138,18.29315880464312,46
0.2,8098,36,148174,18.29534510433387,65
0.2,8099,86,148260,18.303703703703704,14
0.2,8100,90,148350,18.31255400567831,10
0.2,8101,5,148355,18.310910886200936,97
0.2,8102,76,148431,18.31803035912625,24
0.2,8103,80,148511,18.325641658440276,20
0.2,8104,15,148526,18.325231338679828,87
0.2,8105,83,148609,18.333209967924994,18
0.2,8106,89,148698,18.341926729986433,12
0.2,8107,69,148767,18.348174642328566,41
0.2,8108,33,148800,18.349981502034776,69
0.2,8109,43,148843,18.353020961775584,58
0.2,8110,90,148933,18.361854271976327,10
0.2,8111,14,148947,18.361316568047336,88
0.2,8112,22,148969,18.361765068408726,79
0.2,8113,27,148996,18.362829677101306,74
0.2,8114,23,149019,18.3634011090573,79
0.2,8115,72,149091,18.37000985707245,29
0.2,8116,44,149135,18.37316742638906,57
0.2,8117,-141,148994,18.353535353535353,249
0.2,8118,-11,148983,18.349919940879417,113
0.2,8119,-9,148974,18.34655172413793,111
0.2,8120,-45,148929,18.33875138529738,149
0.2,8121,76,149005,18.345850775671018,26
0.2,8122,-86,148919,18.33300504739628,118
0.2,8123,-87,148832,18.320039389463318,189
0.2,8124,94,148926,18.329353846153847,7
0.2,8125,83,149009,18.337312330790056,17
0.2,8126,41,149050,18.340100898240433,59
0.2,8127,77,149127,18.347317913385826,23
0.2,8128,46,149173,18.35071964571288,55
0.2,8129,15,149188,18.35030750307503,88
0.2,8130,76,149264,18.357397614069612,24
0.2,8131,-69,149195,18.34665518937531,101
0.2,8132,93,149288,18.355834255502273,7
0.2,8133,73,149361,18.36255224981559,27
0.2,8134,92,149453,18.37160417947142,8
0.2,8135,4,149457,18.369837758112094,97
0.2,8136,87,149544,18.378272090451027,13
0.2,8137,-60,149484,18.368640943720816,165
0.2,8138,58,149542,18.373510259245606,43
0.2,8139,-94,149448,18.35970515970516,126
0.2,8140,45,149493,18.362977521189045,56
0.2,8141,8,149501,18.361704740849913,93
0.2,8142,-87,149414,18.34876581112612,119
0.2,8143,-49,149365,18.340496070726914,82
0.2,8144,-32,149333,18.334315531000613,64
0.2,8145,94,149427,18.3436042229315,6
0.2,8146,28,149455,18.344789493064933,72
0.2,8147,-61,149394,18.335051546391753,162
0.2,8148,84,149478,18.343109583998036,17
0.2,8149,80,149558,18.35067484662577,20
0.2,8150,0,149558,18.348423506318245,103
0.2,8151,73,149631,18.355127576054954,27
0.2,8152,43,149674,18.358150374095423,58
0.2,8153,7,149681,18.356757419671325,93
0.2,8154,67,149748,18.36272225628449,34
0.2,8155,81,149829,18.370402157920548,19
0.2,8156,80,149909,18.377957582444527,21
0.2,8157,75,149984,18.384898259377298,25
0.2,8158,-33,149951,18.378600318666503,134
0.2,8159,-3,149948,18.375980392156862,106
0.2,8160,90,150038,18.384756770003676,11
0.2,8161,56,150094,18.389365351629504,46
0.2,8162,-70,150024,18.37853730246233,105
0.2,8163,36,150060,18.380695737383636,65
0.2,8164,-167,149893,18.3579914268218,200
0.2,8165,37,149930,18.360274308106785,63
0.2,8166,45,149975,18.363536182196643,62
0.2,8167,90,150065,18.372306562193927,10
0.2,8168,69,150134,18.37850410086914,32
0.2,8169,-519,149615,18.312729498164014,567
0.2,8170,87,149702,18.3211357239016,14
0.2,8171,54,149756,18.32550171316691,46
0.2,8172,-133,149623,18.306986418695704,233
0.2,8173,25,149648,18.30780523611451,76
0.2,8174,68,149716,18.31388379204893,33
0.2,8175,-28,149688,18.30821917808219,128
0.2,8176,63,149751,18.31368472544943,38
0.2,8177,83,149834,18.32159452188799,17
0.2,8178,40,149874,18.32424501772833,62
0.2,8179,66,149940,18.330073349633253,34
0.2,8180,47,149987,18.333577802224667,54
0.2,8181,70,150057,18.339892446834515,31
0.2,8182,47,150104,18.343394842967125,56
0.2,8183,56,150160,18.347996089931573,45
0.2,8184,64,150224,18.353573610262675,37
0.2,8185,90,150314,18.362325922306376,11
0.2,8186,-11,150303,18.358739465005495,112
0.2,8187,-71,150232,18.347826086956523,174
0.2,8188,29,150261,18.34912687751862,72
0.2,8189,89,150350,18.357753357753356,12
0.2,8190,-27,150323,18.352215846660968,128
0.2,8191,91,150414,18.361083984375,10
0.2,8192,-19,150395,18.35652386183327,122
0.2,8193,57,150452,18.36123993165731,43
0.2,8194,52,150504,18.3653447223917,49
0.2,8195,29,150533,18.366642264519278,73
0.2,8196,18,150551,18.366597535683788,84
0.2,8197,29,150580,18.367894608441084,72
0.2,8198,71,150651,18.374313940724477,29
0.2,8199,72,150723,18.380853658536584,29
0.2,8200,-93,150630,18.36727228386782,126
0.2,8201,-59,150571,18.357839551328944,163
0.2,8202,67,150638,18.36376935267585,34
0.2,8203,34,150672,18.36567528035105,66
0.2,8204,86,150758,18.373918342474102,15
0.2,8205,-25,150733,18.3686327077748,127
0.2,8206,34,150767,18.370537346167904,74
0.2,8207,-13,150754,18.366715399610136,115
0.2,8208,27,150781,18.36776708490681,73
0.2,8209,94,150875,18.37697929354446,7
0.2,8210,79,150954,18.384362440628426,22
0.2,8211,72,151026,18.39089137847053,28
0.2,8212,-170,150856,18.367953244855716,271
0.2,8213,65,150921,18.3736303871439,36
0.2,8214,-94,150827,18.359951308581863,126
0.2,8215,77,150904,18.367088607594937,24
0.2,8216,-60,150844,18.357551417792383,164
0.2,8217,94,150938,18.36675590167924,6
0.2,8218,-16,150922,18.362574522447986,149
0.2,8219,23,150945,18.363138686131386,79
0.2,8220,-9,150936,18.35981024206301,109
0.2,8221,81,151017,18.367428849428364,20
0.2,8222,83,151100,18.37528882403016,18
0.2,8223,70,151170,18.38156614785992,45
0.2,8224,84,151254,18.38954407294833,16
0.2,8225,79,151333,18.39691222951617,22
0.2,8226,72,151405,18.403427737936063,28
0.2,8227,77,151482,18.410549343704425,23
0.2,8228,31,151513,18.412079231984446,69
0.2,8229,49,151562,18.415795868772783,54
0.2,8230,39,151601,18.41829668327056,61
0.2,8231,-138,151463,18.399295432458697,171
0.2,8232,17,151480,18.399125470666828,15
0.2,8233,-131,151349,18.380981297060966,234
0.2,8234,11,151360,18.380085003035823,92
0.2,8235,-65,151295,18.36996114618747,101
0.2,8236,-30,151265,18.36408886730606,133
0.2,8237,79,151344,18.3714493809177,21
0.2,8238,77,151421,18.37856535987377,23
0.2,8239,-29,151392,18.37281553398058,130
0.2,8240,31,151423,18.37434777332848,70
0.2,8241,38,151461,18.376728949284153,63
0.2,8242,90,151551,18.385417930365158,11
0.2,8243,-8,151543,18.382217370208636,110
0.2,8244,49,151592,18.385930867192236,53
0.2,8245,76,151668,18.39291777831676,26
0.2,8246,-168,151500,18.370316478719534,272
0.2,8247,21,151521,18.370635305528612,79
0.2,8248,-110,151411,18.3550733422233,212
0.2,8249,81,151492,18.362666666666666,30
0.2,8250,-117,151375,18.346261059265544,149
0.2,8251,59,151434,18.351187590887058,42
0.2,8252,-2,151432,18.34872167696595,102
0.2,8253,94,151526,18.357887085049672,6
0.2,8254,91,151617,18.366686856450634,10
0.2,8255,84,151701,18.374636627906977,16
0.2,8256,-203,151498,18.347826086956523,235
0.2,8257,93,151591,18.356866069266164,8
0.2,8258,57,151648,18.361544981232594,45
0.2,8259,8,151656,18.360290556900726,94
0.2,8260,66,151722,18.3660573780414,35
0.2,8261,-46,151676,18.35826676349552,150
0.2,8262,-11,151665,18.35471378433983,113
0.2,8263,62,151727,18.359995159728946,39
0.2,8264,-44,151683,18.352450090744103,75
0.2,8265,48,151731,18.35603677715945,52
0.2,8266,71,151802,18.362404741744285,30
0.2,8267,-63,151739,18.352564102564102,165
0.2,8268,95,151834,18.361833353488933,6
0.2,8269,-102,151732,18.347279322853687,204
0.2,8270,89,151821,18.35582154515778,11
0.2,8271,-62,151759,18.346107350096712,164
0.2,8272,69,151828,18.352230146258915,31
0.2,8273,84,151912,18.360164370316653,16
0.2,8274,-17,151895,18.355891238670694,119
0.2,8275,-40,151855,18.34884001933301,142
0.2,8276,49,151904,18.35254319197777,51
0.2,8277,73,151977,18.35914472094709,27
0.2,8278,7,151984,18.357772677859646,102
0.2,8279,86,152070,18.365942028985508,15
0.2,8280,64,152134,18.371452723101076,37
0.2,8281,1,152135,18.369355228205748,99
0.2,8282,-65,152070,18.35929011227816,97
0.2,8283,76,152146,18.36624818928054,26
0.2,8284,79,152225,18.373566686783345,21
0.2,8285,-89,152136,18.36060825488776,121
0.2,8286,52,152188,18.364667551586823,49
0.2,8287,60,152248,18.36969111969112,40
0.2,8288,90,152338,18.37833273012426,11
0.2,8289,18,152356,18.378287092882992,83
0.2,8290,79,152435,18.385598842117957,22
0.2,8291,63,152498,18.39097925711529,39
0.2,8292,76,152574,18.39792596165441,24
0.2,8293,78,152652,18.40511212925006,23
0.2,8294,84,152736,18.413019891500905,16
0.2,8295,22,152758,18.413452266152362,10
0.2,8296,3,152761,18.411594552247802,97
0.2,8297,88,152849,18.41998071824536,12
0.2,8298,83,152932,18.42776238100976,17
0.2,8299,81,153013,18.43530120481928,19
0.2,8300,-4,153009,18.43259848211059,104
0.2,8301,84,153093,18.44049626596001,17
0.2,8302,76,153169,18.44742864025051,28
0.2,8303,89,153258,18.45592485549133,11
0.2,8304,76,153334,18.462853702588802,24
0.2,8305,91,153425,18.47158680471948,9
0.2,8306,37,153462,18.473817262549655,65
0.2,8307,23,153485,18.47436206066442,8
0.2,8308,91,153576,18.4830906246239,9
0.2,8309,45,153621,18.486281588447653,55
0.2,8310,26,153647,18.487185657562268,75
0.2,8311,94,153741,18.496270452358036,6
0.2,8312,-102,153639,18.48177553229881,207
0.2,8313,72,153711,18.488212653355784,29
0.2,8314,21,153732,18.488514732411303,81
0.2,8315,48,153780,18.49206349206349,52
0.2,8316,89,153869,18.50054106047854,11
0.2,8317,-217,153652,18.472228901178166,250
0.2,8318,-122,153530,18.455343190287294,224
0.2,8319,59,153589,18.460216346153846,42
0.2,8320,70,153659,18.46641028722509,30
0.2,8321,57,153716,18.47104061523672,43
0.2,8322,70,153786,18.477231767391565,30
0.2,8323,-3,153783,18.47465160980298,35
0.2,8324,-28,153755,18.469069069069068,139
0.2,8325,26,153781,18.469973576747538,6
0.2,8326,-130,153651,18.45214362915816,166
0.2,8327,-91,153560,18.439000960614795,54
0.2,8328,74,153634,18.445671749309643,26
0.2,8329,50,153684,18.449459783913564,52
0.2,8330,83,153767,18.457208018245108,18
0.2,8331,-231,153536,18.42726836293807,281
0.2,8332,-2,153534,18.42481699267971,103
0.2,8333,82,153616,18.43244540436765,19
0.2,8334,84,153700,18.440311937612478,16
0.2,8335,30,153730,18.441698656429942,71
0.2,8336,76,153806,18.448602614849467,24
0.2,8337,52,153858,18.45262652914368,50
0.2,8338,-44,153814,18.44513730663149,146
0.2,8339,30,153844,18.44652278177458,71
0.2,8340,77,153921,18.453542740678575,24
0.2,8341,-3,153918,18.450970990170223,106
0.2,8342,-6,153912,18.44804027328299,107
0.2,8343,-181,153731,18.424137104506233,214
0.2,8344,13,153744,18.42348711803475,89
0.2,8345,-22,153722,18.418643661634317,123
0.2,8346,74,153796,18.425302503893615,28
0.2,8347,-204,153592,18.39865836128414,241
0.2,8348,88,153680,18.406994849682597,13
0.2,8349,27,153707,18.408023952095807,79
0.2,8350,76,153783,18.414920368818105,25
0.2,8351,64,153847,18.42037835249042,37
0.2,8352,78,153925,18.427511073865677,23
0.2,8353,69,153994,18.433564759396695,31
0.2,8354,93,154087,18.442489527229203,7
0.2,8355,74,154161,18.449138343705123,26
0.2,8356,55,154216,18.453512025846596,46
0.2,8357,91,154307,18.462191911940657,10
0.2,8358,81,154388,18.4696734059098,20
0.2,8359,77,154465,18.476674641148325,23
0.2,8360,92,154557,18.48546824542519,8
0.2,8361,63,154620,18.490791676632384,38
0.2,8362,52,154672,18.49479851727849,48
0.2,8363,-1,154671,18.492467718794835,101
0.2,8364,32,154703,18.494082486551108,71
0.2,8365,93,154796,18.502988285919198,8
0.2,8366,27,154823,18.50400382454882,74
0.2,8367,-32,154791,18.49796845124283,134
0.2,8368,43,154834,18.500896164416297,58
0.2,8369,62,154896,18.506093189964158,38
0.2,8370,3,154899,18.504240831441884,97
0.2,8371,-43,154856,18.496894409937887,156
0.2,8372,-57,154799,18.487877702137823,159
0.2,8373,51,154850,18.49176021017435,49
0.2,8374,32,154882,18.49337313432836,70
0.2,8375,-7,154875,18.490329512893982,109
0.2,8376,-78,154797,18.478811030201744,111
0.2,8377,90,154887,18.487347815707807,11
0.2,8378,33,154920,18.4890798424633,67
0.2,8379,-134,154786,18.470883054892603,166
0.2,8380,-31,154755,18.46498031261186,63
0.2,8381,21,154776,18.465282748747317,11
0.2,8382,-127,154649,18.447930335202194,230
0.2,8383,42,154691,18.450739503816795,59
0.2,8384,-23,154668,18.445796064400717,126
0.2,8385,91,154759,18.454447889339374,9
0.2,8386,89,154848,18.46285918683677,11
0.2,8387,69,154917,18.468884120171673,32
0.2,8388,78,154995,18.475980450590058,23
0.2,8389,48,155043,18.479499404052444,53
0.2,8390,8,155051,18.478250506495055,96
0.2,8391,95,155146,18.487368922783602,6
0.2,8392,95,155241,18.496485166209936,6
0.2,8393,-82,155159,18.48451274720038,114
0.2,8394,91,155250,18.493150684931507,9
0.2,8395,71,155321,18.49940447832301,30
0.2,8396,78,155399,18.506490413242826,23
0.2,8397,-37,155362,18.49988092402953,138
0.2,8398,13,155375,18.49922609834504,89
0.2,8399,75,155450,18.50595238095238,25
0.2,8400,52,155502,18.509939292941315,50
0.2,8401,23,155525,18.51047369673887,8
0.2,8402,51,155576,18.514340116625014,50
0.2,8403,-4,155572,18.511661113755356,109
0.2,8404,31,155603,18.51314693634741,69
0.2,8405,-87,155516,18.500594813228645,189
0.2,8406,95,155611,18.509694302367077,6
0.2,8407,21,155632,18.50999048525214,80
0.2,8408,66,155698,18.515638006897372,35
0.2,8409,-343,155355,18.472651605231867,449
0.2,8410,28,155383,18.47378433004399,73
0.2,8411,42,155425,18.476581074655254,58
0.2,8412,9,155434,18.475454653512422,93
0.2,8413,86,155520,18.483479914428333,15
0.2,8414,-12,155508,18.479857397504457,45
0.2,8415,80,155588,18.48716730038023,21
0.2,8416,84,155672,18.49495069502198,17
0.2,8417,54,155726,18.499168448562603,46
0.2,8418,33,155759,18.500890842142773,69
0.2,8419,-485,155274,18.441092636579572,456
0.2,8420,-65,155209,18.431183944899654,165
0.2,8421,-25,155184,18.426027071954405,127
0.2,8422,71,155255,18.432268787842812,30
0.2,8423,47,155302,18.435660018993353,54
0.2,8424,-59,155243,18.42646884272997,91
0.2,8425,-112,155131,18.41098979349632,144
0.2,8426,-61,155070,18.401566393734424,164
0.2,8427,49,155119,18.405196962505933,51
0.2,8428,83,155202,18.412860363032387,18
0.2,8429,-126,155076,18.39572953736655,101
0.2,8430,37,155113,18.39793618787807,65
0.2,8431,69,155182,18.403937381404173,32
0.2,8432,35,155217,18.405905371753825,67
0.2,8433,21,155238,18.406212947593076,80
0.2,8434,59,155297,18.411025489033786,41
0.2,8435,26,155323,18.411925082977714,77
0.2,8436,53,155376,18.41602465331279,47
0.2,8437,-50,155326,18.407916567907087,150
0.2,8438,81,155407,18.415333570328237,20
0.2,8439,76,155483,18.422156398104267,25
0.2,8440,-82,155401,18.41025944793271,113
0.2,8441,-277,155124,18.375266524520256,387
0.2,8442,50,155174,18.37901219945517,51
0.2,8443,-2,155172,18.376598768356228,33
0.2,8444,-133,155039,18.358673771462403,96
0.2,8445,-16,155023,18.354605730523325,116
0.2,8446,37,155060,18.356813069728897,63
0.2,8447,25,155085,18.357599431818183,76
0.2,8448,57,155142,18.362173038229376,45
0.2,8449,92,155234,18.3708875739645,9
0.2,8450,79,155313,18.378061767838126,22
0.2,8451,38,155351,18.380383341221012,63
0.2,8452,-34,155317,18.37418667928546,66
0.2,8453,57,155374,18.378755618642064,43
0.2,8454,76,155450,18.38557066824364,25
0.2,8455,57,155507,18.390137180700094,44
0.2,8456,74,155581,18.396712782310512,27
0.2,8457,94,155675,18.405651454244502,6
0.2,8458,-101,155574,18.391535642510934,244
0.2,8459,24,155598,18.392198581560283,7
0.2,8460,63,155661,18.397470748138517,38
0.2,8461,90,155751,18.40593240368707,11
0.2,8462,18,155769,18.405884438142504,85
0.2,8463,48,155817,18.4093809073724,56
0.2,8464,11,155828,18.408505611340814,91
0.2,8465,34,155862,18.410347271438695,67
0.2,8466,93,155955,18.419156726113144,7
0.2,8467,-11,155944,18.41568256967407,118
0.2,8468,86,156030,18.423662770102727,14
0.2,8469,61,156091,18.428689492325855,40
0.2,8470,-7,156084,18.425687640184158,38
0.2,8471,92,156176,18.434372049102926,9
0.2,8472,-35,156141,18.42806562020536,137
0.2,8473,-102,156039,18.41385414208166,207
0.2,8474,58,156097,18.418525073746313,44
0.2,8475,93,156190,18.4273242095328,7
0.2,8476,38,156228,18.429633124926273,62
0.2,8477,13,156241,18.42899268695447,95
0.2,8478,-11,156230,18.425521877579904,114
0.2,8479,-109,156121,18.410495283018868,217
0.2,8480,69,156190,18.41646032307511,31
0.2,8481,-75,156115,18.405446828578164,107
0.2,8482,93,156208,18.414240245196275,7
0.2,8483,-35,156173,18.40794436586516,137
0.2,8484,59,156232,18.412728344136713,41
0.2,8485,-91,156141,18.39983502238982,194
0.2,8486,-18,156123,18.39554612937434,120
0.2,8487,20,156143,18.395735155513666,88
0.2,8488,-55,156088,18.38708917422547,159
0.2,8489,-168,155920,18.365135453474675,270
0.2,8490,-106,155814,18.35048875279708,164
0.2,8491,95,155909,18.35951483749411,6
0.2,8492,93,156002,18.36830330860709,7
0.2,8493,-41,155961,18.361313868613138,145
0.2,8494,46,156007,18.364567392583872,54
0.2,8495,64,156071,18.36993879472693,37
0.2,8496,19,156090,18.370012945745557,13
0.2,8497,38,156128,18.372322899505765,64
0.2,8498,-2,156126,18.36992587363219,102
0.2,8499,79,156205,18.377058823529413,21
0.2,8500,81,156286,18.38442536172215,19
0.2,8501,14,156300,18.383909668313336,87
0.2,8502,-150,156150,18.364106785840292,184
0.2,8503,-151,155999,18.344190968955786,183
0.2,8504,-99,155900,18.33039388594944,132
0.2,8505,89,155989,18.33870209264049,11
0.2,8506,19,156008,18.33877982837663,81
0.2,8507,32,156040,18.34038551951105,70
0.2,8508,58,156098,18.345046421436127,42
0.2,8509,84,156182,18.352761457109285,16
0.2,8510,42,156224,18.355539889554695,58
0.2,8511,90,156314,18.363956766917294,11
0.2,8512,-31,156283,18.358158111124162,133
0.2,8513,-34,156249,18.352008456659618,67
0.2,8514,52,156301,18.355960070463887,49
0.2,8515,77,156378,18.36284640676374,24
0.2,8516,86,156464,18.37078783609252,14
0.2,8517,2,156466,18.36886593096971,30
0.2,8518,87,156553,18.37692217396408,14
0.2,8519,71,156624,18.383098591549295,30
0.2,8520,-16,156608,18.379063490200682,117
0.2,8521,42,156650,18.38183524994133,58
0.2,8522,34,156684,18.383667722632875,66
0.2,8523,46,156730,18.386907555138432,54
0.2,8524,61,156791,18.39190615835777,39
0.2,8525,-150,156641,18.372155758855268,256
0.2,8526,68,156709,18.377975841444822,39
0.2,8527,71,156780,18.384146341463413,30
0.2,8528,17,156797,18.383984054402628,84
0.2,8529,-49,156748,18.376084407971863,154
0.2,8530,-140,156608,18.357519634274997,247
0.2,8531,-87,156521,18.345171120487578,119
0.2,8532,90,156611,18.353568498769484,11
0.2,8533,58,156669,18.358214202015468,42
0.2,8534,60,156729,18.363093145869946,40
0.2,8535,74,156803,18.36961105904405,26
0.2,8536,5,156808,18.368044980672366,95
0.2,8537,10,156818,18.367064886390256,91
0.2,8538,81,156899,18.37439981262443,19
0.2,8539,-1,156898,18.372131147540983,33
0.2,8540,51,156949,18.375951293759513,49
0.2,8541,87,157036,18.38398501521892,14
0.2,8542,-66,156970,18.37410745639705,97
0.2,8543,56,157026,18.378511235955056,44
0.2,8544,69,157095,18.38443534230544,33
0.2,8545,18,157113,18.38439035806225,82
0.2,8546,92,157205,18.393003393003394,9
0.2,8547,25,157230,18.393776321946653,76
0.2,8548,-18,157212,18.38951924201661,118
0.2,8549,-11,157201,18.38608187134503,42
0.2,8550,59,157260,18.390831481698047,42
0.2,8551,48,157308,18.394293732460245,54
0.2,8552,86,157394,18.40219805916053,14
0.2,8553,5,157399,18.400631283610007,27
0.2,8554,91,157490,18.409117475160723,9
0.2,8555,-38,157452,18.402524544179524,141
0.2,8556,79,157531,18.40960617038682,21
0.2,8557,76,157607,18.416335592428137,25
0.2,8558,-34,157573,18.410211473302954,136
0.2,8559,90,157663,18.41857476635514,10
0.2,8560,94,157757,18.427403340731225,19
0.2,8561,64,157821,18.432725998598457,36
0.2,8562,-25,157796,18.427653859628634,127
0.2,8563,-72,157724,18.417094815506772,175
0.2,8564,85,157809,18.424868651488616,15
0.2,8565,85,157894,18.43264067242587,15
0.2,8566,72,157966,18.438893428271275,29
0.2,8567,78,158044,18.445845004668534,22
0.2,8568,-56,157988,18.437157194538454,89
0.2,8569,78,158066,18.444107351225203,23
0.2,8570,79,158145,18.45117255862793,21
0.2,8571,82,158227,18.458586094260383,18
0.2,8572,55,158282,18.462848477779072,45
0.2,8573,-26,158256,18.457662701189644,60
0.2,8574,-133,158123,18.44,164
0.2,8575,86,158209,18.447877798507463,14
0.2,8576,34,158243,18.449691034161127,66
0.2,8577,45,158288,18.452786197248777,56
0.2,8578,-17,158271,18.44865368924117,118
0.2,8579,-87,158184,18.436363636363637,191
0.2,8580,51,158235,18.440158489686517,49
0.2,8581,73,158308,18.44651596364484,28
0.2,8582,82,158390,18.45392054060352,19
0.2,8583,84,158474,18.461556383970176,16
0.2,8584,23,158497,18.462085032032615,80
0.2,8585,92,158589,18.470649895178198,8
0.2,8586,95,158684,18.479562128799348,6
0.2,8587,12,158696,18.47880763856544,90
0.2,8588,76,158772,18.485504715333565,24
0.2,8589,66,158838,18.49103608847497,34
0.2,8590,65,158903,18.496449773018274,35
0.2,8591,8,158911,18.495228119180634,23
0.2,8592,54,158965,18.49935994414058,55
0.2,8593,90,159055,18.50767977658832,11
0.2,8594,44,159099,18.51064572425829,57
0.2,8595,32,159131,18.512214983713356,70
0.2,8596,-96,159035,18.498894963359312,197
0.2,8597,76,159111,18.505582693649686,24
0.2,8598,57,159168,18.510059309222,44
0.2,8599,80,159248,18.517209302325583,20
0.2,8600,-5,159243,18.514475061039413,38
0.2,8601,94,159337,18.52325040688212,6
0.2,8602,27,159364,18.524235731721493,74
0.2,8603,79,159443,18.531264528126453,22
0.2,8604,43,159486,18.534108076699592,59
0.2,8605,-107,159379,18.519521264234257,141
0.2,8606,42,159421,18.52224933193912,58
0.2,8607,15,159436,18.521840148698885,85
0.2,8608,50,159486,18.525496573353468,50
0.2,8609,88,159574,18.5335656213705,13
0.2,8610,74,159648,18.540006967831843,29
0.2,8611,-27,159621,18.534718996748722,60
0.2,8612,23,159644,18.535237431789156,78
0.2,8613,89,159733,18.543417692129093,12
0.2,8614,59,159792,18.54811375507835,42
0.2,8615,77,159869,18.554897864438253,23
0.2,8616,-34,159835,18.548798885923176,65
0.2,8617,81,159916,18.556045486191692,19
0.2,8618,81,159997,18.563290404919364,19
0.2,8619,-13,159984,18.559628770301625,118
0.2,8620,44,160028,18.562579747129103,57
0.2,8621,-134,159894,18.544885177453025,170
0.2,8622,-49,159845,18.537052070045227,169
0.2,8623,7,159852,18.535714285714285,99
0.2,8624,60,159912,18.540521739130433,40
0.2,8625,80,159992,18.547646649663807,21
0.2,8626,81,160073,18.55488582357714,19
0.2,8627,47,160120,18.558182661103384,53
0.2,8628,0,160120,18.5560319851663,102
0.2,8629,-14,160106,18.55225955967555,48
0.2,8630,-206,159900,18.526242613833855,243
0.2,8631,45,159945,18.52930954587581,56
0.2,8632,-24,159921,18.524383180817793,57
0.2,8633,64,159985,18.529650220060226,37
0.2,8634,-32,159953,18.523798494499133,63
0.2,8635,70,160023,18.52975914775359,31
0.2,8636,77,160100,18.536528887345142,24
0.2,8637,-162,159938,18.515628617735587,269
0.2,8638,30,159968,18.51695798124783,71
0.2,8639,7,159975,18.515625,98
0.2,8640,82,160057,18.522971878254832,19
0.2,8641,72,160129,18.529159916685952,29
0.2,8642,56,160185,18.533495314127038,44
0.2,8643,87,160272,18.54141601110597,13
0.2,8644,0,160272,18.53927125506073,101
0.2,8645,71,160343,18.54533888503354,29
0.2,8646,36,160379,18.54735746501677,65
0.2,8647,70,160449,18.553307123034227,31
0.2,8648,88,160537,18.561336570701815,12
0.2,8649,75,160612,18.5678612716763,25
0.2,8650,83,160695,18.575309212807767,18
0.2,8651,92,160787,18.583795654184005,9
0.2,8652,71,160858,18.58985323009361,29
0.2,8653,45,160903,18.592905015021955,55
0.2,8654,6,160909,18.59145002888504,26
0.2,8655,79,160988,18.598428835489834,22
0.2,8656,61,161049,18.60332678757075,40
0.2,8657,81,161130,18.61053361053361,19
0.2,8658,-14,161116,18.606767525118375,115
0.2,8659,81,161197,18.613972286374135,20
0.2,8660,90,161287,18.622214524881652,10
0.2,8661,-69,161218,18.612098822442853,173
0.2,8662,52,161270,18.61595290315133,48
0.2,8663,-46,161224,18.60849492151431,78
0.2,8664,59,161283,18.613156376226197,41
0.2,8665,61,161344,18.618047542118624,39
0.2,8666,-230,161114,18.589361947617398,331
0.2,8667,37,161151,18.59148592524227,69
0.2,8668,80,161231,18.59856961587265,21
0.2,8669,65,161296,18.603921568627452,35
0.2,8670,87,161383,18.611809479875447,13
0.2,8671,76,161459,18.61842712177122,29
0.2,8672,6,161465,18.61697221261386,25
0.2,8673,19,161484,18.6170163707632,88
0.2,8674,90,161574,18.625244956772335,11
0.2,8675,-87,161487,18.613070539419088,118
0.2,8676,-48,161439,18.605393569205948,82
0.2,8677,-139,161300,18.587232081124682,260
0.2,8678,67,161367,18.5928102315935,34
0.2,8679,-22,161345,18.588133640552996,122
0.2,8680,-153,161192,18.56836769957378,184
0.2,8681,-162,161030,18.547569684404515,222
0.2,8682,-53,160977,18.53932972474951,155
0.2,8683,-217,160760,18.512206356517733,253
0.2,8684,90,160850,18.52043753598158,10
0.2,8685,51,160901,18.52417683628828,49
0.2,8686,-65,160836,18.514561989179235,97
0.2,8687,35,160871,18.516459484346225,65
0.2,8688,55,160926,18.520658303602257,46
0.2,8689,52,160978,18.52451093210587,49
0.2,8690,95,161073,18.533310321021748,6
0.2,8691,73,161146,18.539576622181315,27
0.2,8692,72,161218,18.545726446566203,28
0.2,8693,28,161246,18.546813894639982,73
0.2,8694,93,161339,18.555376653248995,7
0.2,8695,-52,161287,18.547263109475622,154
0.2,8696,50,161337,18.550879613659884,52
0.2,8697,-73,161264,18.540354104391813,181
0.2,8698,4,161268,18.53868260719623,97
0.2,8699,47,161315,18.541954022988506,55
0.2,8700,17,161332,18.54177680726353,85
0.2,8701,92,161424,18.550218340611355,9
0.2,8702,80,161504,18.55727909916121,21
0.2,8703,45,161549,18.560317095588236,56
0.2,8704,74,161623,18.56668581275129,27
0.2,8705,13,161636,18.566046404778312,90
0.2,8706,-36,161600,18.559779487768463,68
0.2,8707,89,161689,18.5678686265503,11
0.2,8708,16,161705,18.567573774256516,84
0.2,8709,-87,161618,18.55545350172216,118
0.2,8710,-143,161475,18.536907358512227,190
0.2,8711,7,161482,18.53558310376492,94
0.2,8712,80,161562,18.54263743831057,21
0.2,8713,-22,161540,18.53798485196236,123
0.2,8714,43,161583,18.5407917383821,58
0.2,8715,81,161664,18.547957778797613,20
0.2,8716,69,161733,18.5537455546633,32
0.2,8717,39,161772,18.556090846524434,61
0.2,8718,-90,161682,18.543640325725427,191
0.2,8719,85,161767,18.55126146788991,16
0.2,8720,-235,161532,18.52218782249742,198
0.2,8721,19,161551,18.52224260490713,81
0.2,8722,75,161626,18.52871718445489,25
0.2,8723,-73,161553,18.518225584594223,104
0.2,8724,92,161645,18.526647564469915,9
0.2,8725,-21,161624,18.522117808847124,123
0.2,8726,63,161687,18.52721439211642,37
0.2,8727,-26,161661,18.52211274060495,165
0.2,8728,82,161743,18.529384809256502,19
0.2,8729,3,161746,18.527605956471938,98
0.2,8730,80,161826,18.534646661321727,20
0.2,8731,95,161921,18.54340357306459,6
0.2,8732,-92,161829,18.53074544829955,208
0.2,8733,-37,161792,18.524387451339592,139
0.2,8734,83,161875,18.53176874642244,17
0.2,8735,-31,161844,18.5260989010989,132
0.2,8736,10,161854,18.52512303994506,92
0.2,8737,-18,161836,18.520943007553218,49
0.2,8738,9,161845,18.51985353015219,22
0.2,8739,23,161868,18.52036613272311,8
0.2,8740,-8,161860,18.517332113030545,108
0.2,8741,93,161953,18.525852207732783,7
0.2,8742,65,162018,18.531167791375957,35
0.2,8743,68,162086,18.536825251601098,33
0.2,8744,-19,162067,18.532532875929103,50
0.2,8745,69,162136,18.538303224331123,32
0.2,8746,71,162207,18.5443009031668,29
0.2,8747,51,162258,18.5480109739369,50
0.2,8748,60,162318,18.552748885586926,40
0.2,8749,76,162394,18.559314285714287,25
0.2,8750,35,162429,18.56119300651354,69
0.2,8751,-48,162381,18.553587751371115,149
0.2,8752,53,162434,18.55752313492517,48
0.2,8753,57,162491,18.56191455334704,44
0.2,8754,1,162492,18.559908623643633,30
0.2,8755,-20,162472,18.555504796710828,122
0.2,8756,30,162502,18.55681169350234,70
0.2,8757,10,162512,18.55583466544873,93
0.2,8758,26,162538,18.556684553031168,76
0.2,8759,76,162614,18.56324200913242,24
0.2,8760,-7,162607,18.56032416390823,107
0.2,8761,-97,162510,18.547135357224377,199
0.2,8762,69,162579,18.552892844916126,32
0.2,8763,-25,162554,18.547923322683705,57
0.2,8764,68,162622,18.553565316600114,32
0.2,8765,90,162712,18.5617157198266,11
0.2,8766,-291,162421,18.526405840082127,325
0.2,8767,74,162495,18.532732664233578,26
0.2,8768,-13,162482,18.529136731668377,114
0.2,8769,75,162557,18.53557582668187,25
0.2,8770,91,162648,18.54383764679056,9
0.2,8771,-85,162563,18.53203374373005,119
0.2,8772,-125,162438,18.51567308788328,228
0.2,8773,86,162524,18.523364485981308,14
0.2,8774,84,162608,18.53082621082621,16
0.2,8775,82,162690,18.53805834092981,19
0.2,8776,71,162761,18.54403554745357,29
0.2,8777,10,162771,18.54306220095694,92
0.2,8778,-169,162602,18.521699510194782,135
0.2,8779,-71,162531,18.511503416856492,110
0.2,8780,-72,162459,18.50119576358046,173
0.2,8781,35,162494,18.50307447050786,65
0.2,8782,-3,162491,18.50062620972333,104
0.2,8783,22,162513,18.501024590163933,104
0.2,8784,-142,162371,18.4827546955037,178
0.2,8785,-16,162355,18.478829956749372,116
0.2,8786,-93,162262,18.46614316604074,124
0.2,8787,-74,162188,18.45562130177515,176
0.2,8788,14,162202,18.455114347479803,89
0.2,8789,23,162225,18.455631399317404,78
0.2,8790,65,162290,18.460925946991242,36
0.2,8791,33,162323,18.462579617834393,68
0.2,8792,11,162334,18.461730922324577,89
0.2,8793,53,162387,18.465658403456903,48
0.2,8794,38,162425,18.467879476975554,62
0.2,8795,41,162466,18.47044110959527,59
0.2,8796,87,162553,18.478231215186995,13
0.2,8797,2,162555,18.476358263241647,31
0.2,8798,69,162624,18.482100238663485,32
0.2,8799,77,162701,18.48875,24
0.2,8800,24,162725,18.489376207249176,76
0.2,8801,17,162742,18.489206998409454,87
0.2,8802,7,162749,18.487901851641485,24
0.2,8803,91,162840,18.4961381190368,10
0.2,8804,55,162895,18.500283929585464,46
0.2,8805,88,162983,18.508176243470363,13
0.2,8806,89,163072,18.51618031111616,11
0.2,8807,92,163164,18.524523160762943,8
0.2,8808,52,163216,18.52832330571007,49
0.2,8809,37,163253,18.530419977298525,64
0.2,8810,-23,163230,18.525706503234595,124
0.2,8811,-36,163194,18.51951883794825,138
0.2,8812,49,163243,18.522977419720867,52
0.2,8813,36,163279,18.524960290447016,65
0.2,8814,21,163300,18.525241066364153,79
0.2,8815,45,163345,18.528244101633394,55
0.2,8816,68,163413,18.53385505273903,32
0.2,8817,-126,163287,18.51746427761397,89
0.2,8818,54,163341,18.521487697017804,47
0.2,8819,69,163410,18.527210884353742,32
0.2,8820,-38,163372,18.520802630087292,141
0.2,8821,63,163435,18.525844479709818,37
0.2,8822,59,163494,18.530431825909556,44
0.2,8823,63,163557,18.535471441523118,38
0.2,8824,41,163598,18.538016997167137,59
0.2,8825,90,163688,18.54611375481532,10
0.2,8826,84,163772,18.553528945281524,16
0.2,8827,-22,163750,18.548935206162213,123
0.2,8828,84,163834,18.55634839732699,16
0.2,8829,94,163928,18.564892412231032,6
0.2,8830,78,164006,18.571622692786775,22
0.2,8831,30,164036,18.572916666666668,70
0.2,8832,92,164128,18.58122948035775,9
0.2,8833,19,164147,18.581276884763415,82
0.2,8834,83,164230,18.58856819468025,18
0.2,8835,57,164287,18.592915346310548,44
0.2,8836,-55,164232,18.584587529704653,156
0.2,8837,71,164303,18.59051821679113,30
0.2,8838,66,164369,18.5958818870913,35
0.2,8839,87,164456,18.603619909502264,13
0.2,8840,18,164474,18.603551634430495,85
0.2,8841,85,164559,18.611060845962452,16
0.2,8842,73,164632,18.617211353613026,27
0.2,8843,88,164720,18.625056535504296,13
0.2,8844,6,164726,18.623629169022045,95
0.2,8845,63,164789,18.62864571557766,38
0.2,8846,68,164857,18.634226291398214,32
0.2,8847,53,164910,18.638110307414106,48
0.2,8848,60,164970,18.64278449542321,41
0.2,8849,45,165015,18.645762711864407,55
0.2,8850,-1,165014,18.643543102474297,102
0.2,8851,24,165038,18.644148215092635,81
0.2,8852,83,165121,18.65141759855416,18
0.2,8853,25,165146,18.652134628416533,77
0.2,8854,86,165232,18.65974025974026,14
0.2,8855,62,165294,18.664634146341463,39
0.2,8856,64,165358,18.669752737947388,38
0.2,8857,48,165406,18.673063897042223,53
0.2,8858,66,165472,18.67840614064793,34
0.2,8859,57,165529,18.68273137697517,43
0.2,8860,64,165593,18.687845615619004,37
0.2,8861,31,165624,18.68923493568043,70
0.2,8862,-9,165615,18.686110797698298,40
0.2,8863,80,165695,18.69302797833935,20
0.2,8864,-299,165396,18.657191201353637,264
0.2,8865,9,165405,18.656101962553574,93
0.2,8866,28,165433,18.657155746024586,73
0.2,8867,-20,165413,18.65279657194407,51
0.2,8868,67,165480,18.658247829518547,34
0.2,8869,-9,165471,18.655129650507327,110
0.2,8870,91,165562,18.663284860782323,9
0.2,8871,74,165636,18.669522091974752,27
0.2,8872,-257,165379,18.638453736053194,362
0.2,8873,94,165473,18.64694613477575,6
0.2,8874,79,165552,18.653746478873238,21
0.2,8875,87,165639,18.66144659756647,13
0.2,8876,78,165717,18.668131125380196,23
0.2,8877,90,165807,18.67616580310881,57
0.2,8878,-13,165794,18.672598265570446,129
0.2,8879,6,165800,18.67117117117117,95
0.2,8880,95,165895,18.679765792140525,6
0.2,8881,41,165936,18.682278766043684,60
0.2,8882,67,166003,18.68771811325003,34
0.2,8883,29,166032,18.68887888338586,72
0.2,8884,87,166119,18.696567248171075,14
0.2,8885,-1,166118,18.69435066396579,103
0.2,8886,86,166204,18.701924158883763,15
0.2,8887,62,166266,18.706795679567957,39
0.2,8888,77,166343,18.713353583080213,24
0.2,8889,-19,166324,18.709111361079866,121
0.2,8890,-27,166297,18.703970307052074,133
0.2,8891,49,166346,18.707377417903732,52
0.2,8892,71,166417,18.713257618351513,31
0.2,8893,85,166502,18.72071059140994,15
0.2,8894,77,166579,18.72726250702642,24
0.2,8895,44,166623,18.730103417266186,56
0.2,8896,91,166714,18.7382263684388,10
0.2,8897,79,166793,18.744998876151943,22
0.2,8898,65,166858,18.750196651309135,35
0.2,8899,51,166909,18.7538202247191,49
0.2,8900,-211,166698,18.728008088978765,315
0.2,8901,30,166728,18.729274320377442,71
0.2,8902,-287,166441,18.694934291811748,252
0.2,8903,46,166487,18.698000898472596,54
0.2,8904,-163,166324,18.677596855699047,284
0.2,8905,76,166400,18.68403323602066,24
0.2,8906,94,166494,18.692489053553384,6
0.2,8907,-74,166420,18.682083520431075,106
0.2,8908,86,166506,18.68963969020092,15
0.2,8909,30,166536,18.69090909090909,73
0.2,8910,89,166625,18.698799236898214,12
0.2,8911,0,166625,18.696701077199283,103
0.2,8912,76,166701,18.703130259171996,25
0.2,8913,-37,166664,18.69688131029841,138
0.2,8914,47,166711,18.700056085249578,53
0.2,8915,53,166764,18.703903095558548,49
0.2,8916,-267,166497,18.6718627341034,370
0.2,8917,13,166510,18.671226732451224,89
0.2,8918,55,166565,18.675299921515865,46
0.2,8919,50,166615,18.678811659192824,50
0.2,8920,45,166660,18.681762134289876,57
0.2,8921,93,166753,18.690091907644025,8
0.2,8922,74,166827,18.696290485262804,27
0.2,8923,35,166862,18.698117436127298,67
0.2,8924,4,166866,18.696470588235293,28
0.2,8925,-12,166854,18.693031593098812,117
0.2,8926,-94,166760,18.68040775176431,214
0.2,8927,92,166852,18.68862007168459,8
0.2,8928,30,166882,18.689886885429498,71
0.2,8929,-13,166869,18.686338185890257,45
0.2,8930,69,166938,18.69197178367484,31
0.2,8931,-204,166734,18.66703985669503,240
0.2,8932,47,166781,18.670211575058772,54
0.2,8933,95,166876,18.678755316767404,6
0.2,8934,-164,166712,18.65831001678791,198
0.2,8935,-62,166650,18.649283795881825,94
0.2,8936,-7,166643,18.646413785386596,107
0.2,8937,-348,166295,18.6053927053032,451
0.2,8938,80,166375,18.612260879292986,21
0.2,8939,86,166461,18.61979865771812,14
0.2,8940,64,166525,18.624874175148193,37
0.2,8941,-32,166493,18.619212704093044,63
0.2,8942,-16,166477,18.615341607961533,117
0.2,8943,13,166490,18.614713774597494,89
0.2,8944,76,166566,18.621129122414757,24
0.2,8945,93,166659,18.629443326626426,8
0.2,8946,90,166749,18.637420364367944,10
0.2,8947,30,166779,18.638690210102816,71
0.2,8948,-54,166725,18.630573248407643,86
0.2,8949,64,166789,18.63564245810056,36
0.2,8950,20,166809,18.63579488325327,81
0.2,8951,53,166862,18.63963360142985,48
0.2,8952,-97,166765,18.626717301463195,128
0.2,8953,57,166822,18.631002903730177,44
0.2,8954,65,166887,18.636180904522615,35
0.2,8955,68,166955,18.64169271996427,33
0.2,8956,49,167004,18.64508205872502,51
0.2,8957,7,167011,18.64378209421746,115
0.2,8958,91,167102,18.65185846634669,9
0.2,8959,-96,167006,18.6390625,208
0.2,8960,74,167080,18.64524048655284,27
0.2,8961,12,167092,18.644498995759875,19
0.2,8962,-40,167052,18.637956041503962,143
0.2,8963,-68,166984,18.628290941543952,169
0.2,8964,71,167055,18.634132738427216,30
0.2,8965,-41,167014,18.62748159714477,188
0.2,8966,69,167083,18.63309914129586,32
0.2,8967,48,167131,18.636373773416594,52
0.2,8968,57,167188,18.64065113167577,43
0.2,8969,88,167276,18.648383500557415,12
0.2,8970,5,167281,18.64686211124735,27
0.2,8971,-2,167279,18.644560855996435,104
0.2,8972,-48,167231,18.637133623091497,80
0.2,8973,-153,167078,18.618007577445955,118
0.2,8974,82,167160,18.62506963788301,19
0.2,8975,86,167246,18.632575757575758,14
0.2,8976,-38,167208,18.626267127102597,70
0.2,8977,70,167278,18.631989307195365,31
0.2,8978,95,167373,18.640494487136653,6
0.2,8979,20,167393,18.64064587973274,80
0.2,8980,86,167479,18.64814608618194,15
0.2,8981,-44,167435,18.641171231351592,77
0.2,8982,90,167525,18.649114994990537,11
0.2,8983,-89,167436,18.63713268032057,120
0.2,8984,14,167450,18.63661658319421,86
0.2,8985,60,167510,18.641219675050078,40
0.2,8986,21,167531,18.641482140870146,80
0.2,8987,-110,167421,18.62716955941255,142
0.2,8988,5,167426,18.625653576593614,96
0.2,8989,21,167447,18.625917686318132,79
0.2,8990,-76,167371,18.615393170948728,108
0.2,8991,-4,167367,18.612878113879002,104
0.2,8992,28,167395,18.61392193928611,75
0.2,8993,74,167469,18.620080053368913,27
0.2,8994,-258,167211,18.589327404113398,290
0.2,8995,-16,167195,18.585482436638507,119
0.2,8996,46,167241,18.58852950983661,55
0.2,8997,57,167298,18.592798399644366,46
0.2,8998,87,167385,18.600400044449383,13
0.2,8999,-15,167370,18.596666666666668,116
0.2,9000,52,167422,18.600377735807132,48
0.2,9001,75,167497,18.60664296822928,26
0.2,9002,94,167591,18.615017216483395,6
0.2,9003,61,167652,18.619724566859173,39
0.2,9004,-1,167651,18.617545807884508,102
0.2,9005,18,167669,18.617477237397292,84
0.2,9006,77,167746,18.623959142888864,24
0.2,9007,-103,167643,18.61045737122558,206
0.2,9008,-166,167477,18.58996558996559,269
0.2,9009,87,167564,18.597558268590454,14
0.2,9010,-19,167545,18.59338586172456,121
0.2,9011,-118,167427,18.578229027962717,153
0.2,9012,-497,166930,18.52102518584267,569
0.2,9013,87,167017,18.528622143332594,14
0.2,9014,83,167100,18.53577371048253,17
0.2,9015,-65,167035,18.52650842945874,98
0.2,9016,51,167086,18.530109792613953,49
0.2,9017,78,167164,18.536704369039697,23
0.2,9018,-85,167079,18.525224526000667,118
0.2,9019,74,167153,18.531374722838137,27
0.2,9020,86,167239,18.53885378561135,14
0.2,9021,-23,167216,18.534249612059412,56
0.2,9022,-35,167181,18.52831652443755,67
0.2,9023,-33,167148,18.522606382978722,134
0.2,9024,52,167200,18.526315789473685,49
0.2,9025,76,167276,18.532683359184578,24
0.2,9026,-217,167059,18.506591337099813,259
0.2,9027,81,167140,18.513513513513512,19
0.2,9028,67,167207,18.518883597297595,33
0.2,9029,64,167271,18.52392026578073,37
0.2,9030,-12,167259,18.52054036097885,44
0.2,9031,-460,166799,18.4675597874225,497
0.2,9032,68,166867,18.4730432857301,32
0.2,9033,46,166913,18.476090325437237,55
0.2,9034,74,166987,18.482235749861648,31
0.2,9035,-6,166981,18.479526339088093,109
0.2,9036,-87,166894,18.46785437645236,189
0.2,9037,65,166959,18.47300287674264,36
0.2,9038,-277,166682,18.440314194048014,311
0.2,9039,-96,166586,18.42765486725664,130
0.2,9040,-77,166509,18.417099878332042,179
0.2,9041,-57,166452,18.40875912408759,160
0.2,9042,87,166539,18.416344133583987,13
0.2,9043,-40,166499,18.409885006634234,143
0.2,9044,8,166507,18.40873410724157,93
0.2,9045,24,166531,18.409352199867346,76
0.2,9046,-183,166348,18.38708964297557,220
0.2,9047,-168,166180,18.366489832007073,271
0.2,9048,-46,166134,18.359376726710135,81
0.2,9049,62,166196,18.364198895027624,43
0.2,9050,-282,165914,18.331013147718483,408
0.2,9051,-54,165860,18.323022536456033,88
0.2,9052,74,165934,18.329172649950294,27
0.2,9053,-56,165878,18.320963110227524,157
0.2,9054,25,165903,18.32170071783545,6
0.2,9055,74,165977,18.32784893992933,27
0.2,9056,73,166050,18.333885392514077,34
0.2,9057,40,166090,18.336277323912565,60
0.2,9058,-14,166076,18.332707804393422,118
0.2,9059,55,166131,18.336754966887415,45
0.2,9060,58,166189,18.341132325350404,43
0.2,9061,58,166247,18.345508717722357,44
0.2,9062,-64,166183,18.336422818051417,172
0.2,9063,56,166239,18.34057811120918,44
0.2,9064,56,166295,18.34473248758963,47
0.2,9065,67,166362,18.350099272005295,34
0.2,9066,67,166429,18.355464872614977,34
0.2,9067,60,166489,18.36005734450816,40
0.2,9068,17,166506,18.359907376778036,84
0.2,9069,74,166580,18.366041896361633,26
0.2,9070,67,166647,18.371403373387718,34
0.2,9071,-44,166603,18.364528218694886,146
0.2,9072,-38,166565,18.358315882288107,149
0.2,9073,-155,166410,18.33921093233414,258
0.2,9074,-31,166379,18.333774104683197,62
0.2,9075,-31,166348,18.328338475099162,131
0.2,9076,78,166426,18.334912415996474,22
0.2,9077,9,166435,18.33388411544393,91
0.2,9078,-184,166251,18.31159819363366,227
0.2,9079,66,166317,18.316850220264318,35
0.2,9080,58,166375,18.321220129941636,42
0.2,9081,30,166405,18.322506055934817,70
0.2,9082,73,166478,18.32852581746119,27
0.2,9083,-40,166438,18.322104799647732,141
0.2,9084,-87,166351,18.31051183269125,195
0.2,9085,52,166403,18.314219678626458,48
0.2,9086,69,166472,18.31979751293056,32
0.2,9087,-28,166444,18.314700704225352,131
0.2,9088,-1,166443,18.312575640884585,106
0.2,9089,89,166532,18.32035203520352,12
0.2,9090,76,166608,18.32669673303267,25
0.2,9091,39,166647,18.328970523537176,61
0.2,9092,-13,166634,18.325525129220278,115
0.2,9093,64,166698,18.330547613811305,36
0.2,9094,65,166763,18.335678944474985,36
0.2,9095,60,166823,18.340259454705365,42
0.2,9096,69,166892,18.34582829504232,32
0.2,9097,81,166973,18.352714882391734,20
0.2,9098,17,166990,18.3525662160677,42
0.2,9099,32,167022,18.354065934065932,71
0.2,9100,-76,166946,18.343698494670914,108
0.2,9101,90,167036,18.3515710832784,10
0.2,9102,71,167107,18.357354718224762,30
0.2,9103,-72,167035,18.34742970123023,175
0.2,9104,-42,166993,18.34080175727622,78
0.2,9105,40,167033,18.34318032066769,61
0.2,9106,72,167105,18.349072142308113,28
0.2,9107,-5,167100,18.346508563899867,106
0.2,9108,83,167183,18.3536063234164,18
0.2,9109,69,167252,18.359165751920965,31
0.2,9110,53,167305,18.36296784107123,48
0.2,9111,48,167353,18.366220368744514,52
0.2,9112,-2,167351,18.36398551519807,105
0.2,9113,0,167351,18.361970594689488,102
0.2,9114,84,167435,18.369171695008227,16
0.2,9115,-55,167380,18.36112329969285,86
0.2,9116,18,167398,18.361083689810243,85
0.2,9117,71,167469,18.366856766834832,32
0.2,9118,24,167493,18.36747450378331,78
0.2,9119,27,167520,18.36842105263158,73
0.2,9120,28,167548,18.369477031027298,74
0.2,9121,-14,167534,18.365928524446392,122
0.2,9122,3,167537,18.364244217910773,100
0.2,9123,62,167599,18.36902674265673,39
0.2,9124,3,167602,18.367342465753424,28
0.2,9125,68,167670,18.37278106508876,32
0.2,9126,23,167693,18.37328804645557,79
0.2,9127,-16,167677,18.369522348816826,129
0.2,9128,-23,167654,18.364990689013034,128
0.2,9129,52,167706,18.368674698795182,51
0.2,9130,-2,167704,18.366443982039208,34
0.2,9131,-74,167630,18.35632939115199,178
0.2,9132,-38,167592,18.35015876491843,139
0.2,9133,70,167662,18.35581344427414,31
0.2,9134,92,167754,18.363875205254516,8
0.2,9135,79,167833,18.370512259194395,22
0.2,9136,-75,167758,18.36029331290358,175
0.2,9137,-11,167747,18.357080323922084,114
0.2,9138,82,167829,18.36404420614947,18
0.2,9139,-112,167717,18.349781181619257,144
0.2,9140,58,167775,18.354118805382342,43
0.2,9141,-132,167643,18.337672281776417,165
0.2,9142,68,167711,18.34310401399978,32
0.2,9143,30,167741,18.344378827646544,70
0.2,9144,-186,167555,18.322033898305083,305
0.2,9145,58,167613,18.326372184561556,43
0.2,9146,85,167698,18.333661309719034,15
0.2,9147,-3,167695,18.331329252295582,105
0.2,9148,-138,167557,18.31424199366051,100
0.2,9149,74,167631,18.32032786885246,28
0.2,9150,58,167689,18.324663971150695,42
0.2,9151,79,167768,18.331293706293707,21
0.2,9152,68,167836,18.336720201026985,32
0.2,9153,83,167919,18.343784138081713,18
0.2,9154,42,167961,18.346368104860733,60
0.2,9155,-155,167806,18.327435561380515,260
0.2,9156,-62,167744,18.318663317680464,165
0.2,9157,52,167796,18.322341122515834,49
0.2,9158,78,167874,18.32885686210285,22
0.2,9159,91,167965,18.3367903930131,10
0.2,9160,69,168034,18.34232070734636,32
0.2,9161,12,168046,18.341628465400568,19
0.2,9162,-114,167932,18.327185419622396,248
0.2,9163,-74,167858,18.31711043212571,177
0.2,9164,40,167898,18.319476268412437,63
0.2,9165,72,167970,18.325332751472835,29
0.2,9166,92,168062,18.33336969564743,9
0.2,9167,42,168104,18.335951134380455,58
0.2,9168,88,168192,18.34354891482168,13
0.2,9169,-27,168165,18.338604143947656,64
0.2,9170,67,168232,18.343910151564714,34
0.2,9171,-75,168157,18.333733100741387,107
0.2,9172,90,168247,18.34154584105527,10
0.2,9173,93,168340,18.349683889252233,8
0.2,9174,-58,168282,18.341362397820163,91
0.2,9175,-24,168258,18.33674803836094,126
0.2,9176,2,168260,18.334967854418654,99
0.2,9177,90,168350,18.342776203966007,10
0.2,9178,-140,168210,18.325525656389583,173
0.2,9179,-157,168053,18.306427015250545,190
0.2,9180,78,168131,18.312928874850233,23
0.2,9181,34,168165,18.31463733391418,67
0.2,9182,84,168249,18.321790264619406,26
0.2,9183,74,168323,18.327852787456447,26
0.2,9184,69,168392,18.33336962438759,31
0.2,9185,23,168415,18.333877639886783,79
0.2,9186,38,168453,18.336018286709482,62
0.2,9187,-125,168328,18.320417936438833,228
0.2,9188,39,168367,18.322668407878986,61
0.2,9189,60,168427,18.3272034820457,40
0.2,9190,8,168435,18.326079860733326,92
0.2,9191,93,168528,18.334203655352482,7
0.2,9192,86,168614,18.341564233656044,14
0.2,9193,6,168620,18.340221883837284,96
0.2,9194,79,168699,18.346818923327895,25
0.2,9195,-400,168299,18.301326663766854,437
0.2,9196,90,168389,18.309122539958683,10
0.2,9197,25,168414,18.309849967384213,76
0.2,9198,-22,168392,18.305467985650616,127
0.2,9199,-36,168356,18.299565217391304,67
0.2,9200,91,168447,18.307466579719595,10
0.2,9201,51,168498,18.311019343620952,50
0.2,9202,-55,168443,18.303053352167773,170
0.2,9203,90,168533,18.31084311169057,10
0.2,9204,89,168622,18.318522542096687,11
0.2,9205,67,168689,18.323810558331523,33
0.2,9206,-55,168634,18.315846638427285,156
0.2,9207,-5,168629,18.313314509122502,105
0.2,9208,89,168718,18.320990335541318,11
0.2,9209,53,168771,18.32475570032573,48
0.2,9210,-139,168632,18.307675605254587,102
0.2,9211,36,168668,18.309596178897092,65
0.2,9212,15,168683,18.309236947791163,85
0.2,9213,73,168756,18.31517256349034,28
0.2,9214,-14,168742,18.311665762344003,115
0.2,9215,51,168793,18.31521267361111,50
0.2,9216,-18,168775,18.311272648367147,120
0.2,9217,-35,168740,18.305489260143197,70
0.2,9218,91,168831,18.313374552554507,11
0.2,9219,85,168916,18.32060737527115,16
0.2,9220,-138,168778,18.303654701225465,243
0.2,9221,-21,168757,18.29939275645196,121
0.2,9222,92,168849,18.30738371462648,9
0.2,9223,33,168882,18.308976582827405,68
0.2,9224,86,168968,18.316314363143633,14
0.2,9225,2,168970,18.31454584868849,99
0.2,9226,77,169047,18.320906036631623,23
0.2,9227,90,169137,18.328673602080624,10
0.2,9228,-200,168937,18.305016794885688,231
0.2,9229,-91,168846,18.2931744312026,192
0.2,9230,65,168911,18.298234210811398,35
0.2,9231,40,168951,18.300584922010398,62
0.2,9232,-121,168830,18.28549767139608,224
0.2,9233,85,168915,18.29272254710851,16
0.2,9234,77,168992,18.299079588521927,23
0.2,9235,-86,168906,18.28778692074491,197
0.2,9236,79,168985,18.294359640575944,22
0.2,9237,-28,168957,18.289348343797357,130
0.2,9238,84,169041,18.29646065591514,16
0.2,9239,-135,168906,18.27987012987013,167
0.2,9240,86,168992,18.287198355156367,14
0.2,9241,44,169036,18.28998052369617,57
0.2,9242,48,169084,18.293194850156876,55
0.2,9243,65,169149,18.29824751189961,35
0.2,9244,-64,169085,18.289345592212005,164
0.2,9245,73,169158,18.295262816353016,27
0.2,9246,-20,169138,18.291121444792907,51
0.2,9247,-42,169096,18.284602076124568,74
0.2,9248,88,169184,18.292139690777383,13
0.2,9249,-3,169181,18.289837837837837,103
0.2,9250,91,169272,18.29769754621122,10
0.2,9251,11,169283,18.296908776480763,92
0.2,9252,78,169361,18.30336107208473,23
0.2,9253,-182,169179,18.281716014696347,218
0.2,9254,-16,169163,18.278011885467315,120
0.2,9255,81,169244,18.2847882454624,19
0.2,9256,-19,169225,18.280760505563357,50
0.2,9257,-543,168682,18.220133938215596,587
0.2,9258,4,168686,18.21859812074738,35
0.2,9259,73,168759,18.22451403887689,28
0.2,9260,40,168799,18.22686534931433,64
0.2,9261,70,168869,18.232455193262794,30
0.2,9262,-192,168677,18.209759257260067,155
0.2,9263,92,168769,18.217724525043177,9
0.2,9264,73,168842,18.223637344846196,27
0.2,9265,-75,168767,18.213576516296136,179
0.2,9266,-56,168711,18.205568145030753,157
0.2,9267,84,168795,18.212667242123434,16
0.2,9268,-21,168774,18.208436724565757,53
0.2,9269,91,168865,18.21628910463862,9
0.2,9270,48,168913,18.219501671880057,53
0.2,9271,81,168994,18.226272648835202,19
0.2,9272,-63,168931,18.217513210395772,163
0.2,9273,10,168941,18.216627129609662,92
0.2,9274,24,168965,18.217250673854448,76
0.2,9275,36,169001,18.219167744717552,64
0.2,9276,-109,168892,18.20545434946642,211
0.2,9277,10,168902,18.20456995042035,91
0.2,9278,19,168921,18.204655674102813,82
0.2,9279,16,168937,18.204418103448276,86
0.2,9280,59,168996,18.208813705419676,47
0.2,9281,-223,168773,18.182826976944625,327
0.2,9282,42,168815,18.1853926532371,59
0.2,9283,-128,168687,18.169646704006894,162
0.2,9284,74,168761,18.175659666128162,27
0.2,9285,77,168838,18.181994400172304,23
0.2,9286,78,168916,18.18843544739959,22
0.2,9287,81,168997,18.195198105081825,19
0.2,9288,-42,168955,18.18871783830337,146
0.2,9289,-64,168891,18.179870828848223,171
0.2,9290,64,168955,18.184802497040145,56
0.2,9291,60,169015,18.189302625914767,40
0.2,9292,93,169108,18.197352846228345,8
0.2,9293,21,169129,18.197654400688617,80
0.2,9294,20,169149,18.197848305540614,81
0.2,9295,92,169241,18.20578743545611,9
0.2,9296,64,169305,18.210713133268797,37
0.2,9297,-8,169297,18.207894170789416,132
0.2,9298,83,169380,18.21486181309818,18
0.2,9299,28,169408,18.215913978494623,72
0.2,9300,-13,169395,18.212557789485,45
0.2,9301,37,169432,18.21457751021286,64
0.2,9302,91,169523,18.222401375900247,9
0.2,9303,75,169598,18.228503869303527,26
0.2,9304,-28,169570,18.223535733476627,157
0.2,9305,-88,169482,18.21212121212121,208
0.2,9306,-63,169419,18.203395293864833,166
0.2,9307,-48,169371,18.196282767511818,81
0.2,9308,89,169460,18.20388870985068,11
0.2,9309,2,169462,18.202148227712136,98
0.2,9310,77,169539,18.208463108151648,24
0.2,9311,-65,169474,18.199527491408936,96
0.2,9312,95,169569,18.207774079244068,6
0.2,9313,89,169658,18.215374704745546,12
0.2,9314,-1,169657,18.213311862587226,32
0.2,9315,85,169742,18.220480893087164,16
0.2,9316,79,169821,18.22700440055812,22
0.2,9317,56,169877,18.231058166988625,44
0.2,9318,-329,169548,18.193797617770148,365
0.2,9319,-53,169495,18.186158798283262,154
0.2,9320,82,169577,18.19300504237743,18
0.2,9321,93,169670,18.201029821926625,7
0.2,9322,92,169762,18.208945618363188,9
0.2,9323,8,169770,18.207850707850707,93
0.2,9324,64,169834,18.212761394101875,36
0.2,9325,-27,169807,18.207913360497535,131
0.2,9326,-159,169648,18.188913905864695,259
0.2,9327,90,169738,18.196612349914236,11
0.2,9328,8,169746,18.19551934826884,104
0.2,9329,-30,169716,18.190353697749195,133
0.2,9330,6,169722,18.189047261815453,97
0.2,9331,40,169762,18.191384483497643,60
0.2,9332,88,169850,18.19886424515161,12
0.2,9333,-18,169832,18.194986072423397,121
0.2,9334,60,169892,18.19946438136047,41
0.2,9335,-185,169707,18.177699228791774,218
0.2,9336,77,169784,18.183999143193745,24
0.2,9337,80,169864,18.190618976226173,21
0.2,9338,68,169932,18.195952457436558,32
0.2,9339,-192,169740,18.173447537473233,158
0.2,9340,7,169747,18.17225136495022,93
0.2,9341,93,169840,18.180261186041534,7
0.2,9342,11,169851,18.179492668307823,89
0.2,9343,-49,169802,18.17230308219178,152
0.2,9344,71,169873,18.177956126270733,29
0.2,9345,26,169899,18.178793066552537,77
0.2,9346,33,169932,18.180378731143684,68
0.2,9347,31,169963,18.181750106974754,70
0.2,9348,87,170050,18.189111134880736,14
0.2,9349,56,170106,18.193155080213902,46
0.2,9350,73,170179,18.199016148005562,28
0.2,9351,88,170267,18.20647989734816,12
0.2,9352,-53,170214,18.198866673794505,153
0.2,9353,47,170261,18.201945691682702,53
0.2,9354,58,170319,18.206199893105293,43
0.2,9355,41,170360,18.20863616930312,60
0.2,9356,-11,170349,18.205514588008977,112
0.2,9357,-126,170223,18.19010472323146,160
0.2,9358,2,170225,18.18837482637034,98
0.2,9359,-26,170199,18.183653846153845,58
0.2,9360,83,170282,18.190577929708365,18
0.2,9361,12,170294,18.189916684469132,90
0.2,9362,14,170308,18.189469187226315,87
0.2,9363,91,170399,18.197244767193506,10
0.2,9364,81,170480,18.20395088093967,19
0.2,9365,69,170549,18.209374332692718,32
0.2,9366,79,170628,18.215864204120848,21
0.2,9367,-326,170302,18.179120409906062,363
0.2,9368,-6,170296,18.176539652043974,109
0.2,9369,72,170368,18.182283884738528,29
0.2,9370,4,170372,18.180770462063816,97
0.2,9371,-72,170300,18.171148100725567,177
0.2,9372,39,170339,18.173370319001386,61
0.2,9373,81,170420,18.18007254107105,20
0.2,9374,56,170476,18.18410666666667,45
0.2,9375,64,170540,18.188993174061434,37
0.2,9376,20,170560,18.18918630692119,81
0.2,9377,-71,170489,18.17967583706547,174
0.2,9378,50,170539,18.183068557415503,50
0.2,9379,-82,170457,18.172388059701493,185
0.2,9380,-136,170321,18.155953523078562,168
0.2,9381,90,170411,18.163611170326156,10
0.2,9382,-274,170137,18.132473622508794,377
0.2,9383,-14,170123,18.129049445865302,46
0.2,9384,51,170174,18.132551944592436,49
0.2,9385,41,170215,18.134988280417645,60
0.2,9386,-26,170189,18.130286566528177,127
0.2,9387,79,170268,18.13677034512143,21
0.2,9388,27,170295,18.13771434657578,74
0.2,9389,83,170378,18.144621938232163,18
0.2,9390,-105,170273,18.131508891491855,206
0.2,9391,-115,170158,18.117333901192506,217
0.2,9392,62,170220,18.122005748961993,39
0.2,9393,60,170280,18.126463700234194,41
0.2,9394,30,170310,18.127727514635446,71
0.2,9395,74,170384,18.133673903788846,26
0.2,9396,-12,170372,18.130467170373525,115
0.2,9397,25,170397,18.13119812726112,75
0.2,9398,88,170485,18.138631769337163,12
0.2,9399,-28,170457,18.13372340425532,128
0.2,9400,72,170529,18.13945324965429,29
0.2,9401,95,170624,18.14762816422038,6
0.2,9402,94,170718,18.15569499096033,7
0.2,9403,74,170792,18.161633347511696,27
0.2,9404,-153,170639,18.143434343434343,115
0.2,9405,22,170661,18.143844354667234,78
0.2,9406,39,170700,18.146061443605827,61
0.2,9407,94,170794,18.154124149659864,6
0.2,9408,-76,170718,18.144117334467,177
0.2,9409,83,170801,18.151009564293304,17
0.2,9410,68,170869,18.156306449899056,33
0.2,9411,47,170916,18.159371015724606,53
0.2,9412,26,170942,18.160203973228512,75
0.2,9413,58,171000,18.164435946462714,43
0.2,9414,53,171053,18.168135953266066,47
0.2,9415,86,171139,18.17533984706882,15
0.2,9416,-45,171094,18.168631198895614,147
0.2,9417,93,171187,18.176576767891273,7
0.2,9418,81,171268,18.18324662915384,26
0.2,9419,81,171349,18.18991507430998,20
0.2,9420,-14,171335,18.18649824859357,45
0.2,9421,-108,171227,18.173105497771175,141
0.2,9422,53,171280,18.17680144327709,47
0.2,9423,-95,171185,18.164792020373515,128
0.2,9424,10,171195,18.163925729442973,21
0.2,9425,59,171254,18.168258009760237,41
0.2,9426,66,171320,18.17333191895619,34
0.2,9427,66,171386,18.17840475180314,35
0.2,9428,84,171470,18.18538551277972,17
0.2,9429,79,171549,18.191834570519617,22
0.2,9430,13,171562,18.191284063195845,88
0.2,9431,-98,171464,18.178965224766753,131
0.2,9432,-91,171373,18.167391073889537,132
0.2,9433,-9,171364,18.164511341954633,110
0.2,9434,-10,171354,18.16152623211447,110
0.2,9435,30,171384,18.1627808393387,78
0.2,9436,70,171454,18.168273815831302,31
0.2,9437,30,171484,18.169527442254715,70
0.2,9438,82,171566,18.176289861214112,18
0.2,9439,40,171606,18.178601694915255,70
0.2,9440,26,171632,18.17943014511175,76
0.2,9441,57,171689,18.183541622537597,47
0.2,9442,86,171775,18.190723287090968,15
0.2,9443,-60,171715,18.182443879711986,163
0.2,9444,39,171754,18.184647961884593,61
0.2,9445,53,171807,18.18833368621639,48
0.2,9446,54,171861,18.192124483963163,46
0.2,9447,22,171883,18.19252751905165,78
0.2,9448,-79,171804,18.18224150703778,186
0.2,9449,66,171870,18.187301587301587,35
0.2,9450,-27,171843,18.182520368215005,192
0.2,9451,-17,171826,18.17879813796022,49
0.2,9452,-27,171799,18.174018830001057,65
0.2,9453,-17,171782,18.170298286439603,137
0.2,9454,-38,171744,18.164357482813326,69
0.2,9455,12,171756,18.163705583756347,88
0.2,9456,75,171831,18.169715554615628,26
0.2,9457,48,171879,18.17286952844153,53
0.2,9458,93,171972,18.180780209324453,8
0.2,9459,-128,171844,18.165327695560254,161
0.2,9460,-40,171804,18.159179790719797,72
0.2,9461,46,171850,18.162122172902134,56
0.2,9462,13,171863,18.161576667018917,88
0.2,9463,-202,171661,18.138313609467456,168
0.2,9464,-113,171548,18.12445853143159,218
0.2,9465,75,171623,18.130466934291146,26
0.2,9466,80,171703,18.137002218231753,20
0.2,9467,74,171777,18.142902408111535,26
0.2,9468,12,171789,18.1422536698701,90
0.2,9469,22,171811,18.142661034846885,79
0.2,9470,29,171840,18.143807412100095,71
0.2,9471,91,171931,18.151499155405407,10
0.2,9472,-13,171918,18.148210704106408,125
0.2,9473,-75,171843,18.13837872070931,113
0.2,9474,65,171908,18.143324538258575,36
0.2,9475,53,171961,18.147002954833262,47
0.2,9476,-9,171952,18.144138440434737,110
0.2,9477,92,172044,18.151930787085885,9
0.2,9478,-68,171976,18.142842071948518,104
0.2,9479,-3,171973,18.14061181434599,35
0.2,9480,79,172052,18.14703090391309,22
0.2,9481,36,172088,18.14891373128032,64
0.2,9482,94,172182,18.15691236950332,7
0.2,9483,86,172268,18.1640657950232,15
0.2,9484,68,172336,18.169319978914075,33
0.2,9485,-3,172333,18.167088340712628,103
0.2,9486,56,172389,18.17107620954991,47
0.2,9487,75,172464,18.17706576728499,25
0.2,9488,85,172549,18.18410791442723,16
0.2,9489,-99,172450,18.171759747102215,131
0.2,9490,62,172512,18.176377620904013,39
0.2,9491,80,172592,18.182890855457227,20
0.2,9492,-62,172530,18.174444327399137,94
0.2,9493,87,172617,18.18169370128502,13
0.2,9494,-77,172540,18.171669299631386,180
0.2,9495,79,172619,18.1780749789385,22
0.2,9496,9,172628,18.177108560598082,93
0.2,9497,63,172691,18.181827753211202,37
0.2,9498,-41,172650,18.17559743130856,74
0.2,9499,61,172711,18.180105263157895,40
0.2,9500,-131,172580,18.164403746974003,237
0.2,9501,5,172585,18.16301831193433,96
0.2,9502,63,172648,18.16773650426181,37
0.2,9503,31,172679,18.1690867003367,70
0.2,9504,41,172720,18.171488690163073,59
0.2,9505,-152,172568,18.15358720807911,188
0.2,9506,-43,172525,18.14715472809509,77
0.2,9507,37,172562,18.149137568363482,109
0.2,9508,-124,172438,18.134188663371543,156
0.2,9509,-42,172396,18.127865404837014,146
0.2,9510,-1,172395,18.125854273998527,103
0.2,9511,-35,172360,18.12026913372582,139
0.2,9512,5,172365,18.118889940081992,97
0.2,9513,-13,172352,18.11561908766029,45
0.2,9514,-458,171894,18.065580662112453,357
0.2,9515,71,171965,18.071143337536782,29
0.2,9516,57,172022,18.075233792161395,44
0.2,9517,71,172093,18.080794284513555,31
0.2,9518,-207,171886,18.057148860174387,247
0.2,9519,2,171888,18.05546218487395,98
0.2,9520,12,171900,18.05482617372125,89
0.2,9521,-80,171820,18.044528460407477,113
0.2,9522,59,171879,18.04882915047779,41
0.2,9523,67,171946,18.05396892062159,33
0.2,9524,13,171959,18.053438320209974,88
0.2,9525,92,172051,18.061200923787528,9
0.2,9526,37,172088,18.063188831741368,63
0.2,9527,14,172102,18.062762384550798,86
0.2,9528,47,172149,18.06579913946899,56
0.2,9529,-59,172090,18.057712486883524,180
0.2,9530,51,172141,18.061168817542754,50
0.2,9531,95,172236,18.069240453210238,6
0.2,9532,63,172299,18.073953634742473,37
0.2,9533,51,172350,18.077407174323476,49
0.2,9534,-65,172285,18.068694284216047,98
0.2,9535,-233,172052,18.04236577181208,266
0.2,9536,77,172129,18.04854776135053,23
0.2,9537,87,172216,18.05577689243028,14
0.2,9538,-10,172206,18.05283572701541,121
0.2,9539,91,172297,18.0604821802935,9
0.2,9540,-64,172233,18.05188135415575,171
0.2,9541,36,172269,18.053762313980297,64
0.2,9542,10,172279,18.052918369485486,91
0.2,9543,70,172349,18.05836127409891,30
0.2,9544,44,172393,18.061079099004715,56
0.2,9545,69,172462,18.066415252461763,32
0.2,9546,-88,172374,18.055305331517754,191
0.2,9547,87,172461,18.062526183493926,13
0.2,9548,14,172475,18.062100743533353,98
0.2,9549,76,172551,18.068167539267016,24
0.2,9550,-8,172543,18.06543817401319,109
0.2,9551,15,172558,18.065117252931323,85
0.2,9552,71,172629,18.070658431906207,30
0.2,9553,-18,172611,18.06688298095039,49
0.2,9554,24,172635,18.067503924646783,7
0.2,9555,-41,172594,18.061322729175387,172
0.2,9556,-57,172537,18.05346866171393,160
0.2,9557,9,172546,18.052521448001674,94
0.2,9558,95,172641,18.060571189454965,6
0.2,9559,94,172735,18.068514644351463,7
0.2,9560,4,172739,18.067043196318377,98
0.2,9561,48,172787,18.070173603848566,53
0.2,9562,84,172871,18.07706786573251,16
0.2,9563,26,172897,18.07789627770807,75
0.2,9564,77,172974,18.08405645582854,23
0.2,9565,-3,172971,18.081852393895044,104
0.2,9566,82,173053,18.088533500574894,18
0.2,9567,39,173092,18.09071906354515,62
0.2,9568,38,173130,18.092799665586792,66
0.2,9569,-169,172961,18.07324973876698,142
0.2,9570,-63,172898,18.064779019956116,165
0.2,9571,53,172951,18.068428750522358,47
0.2,9572,-31,172920,18.063303039799436,140
0.2,9573,-11,172909,18.060267390850218,112
0.2,9574,93,173002,18.068093994778067,8
0.2,9575,-11,172991,18.065058479532162,42
0.2,9576,77,173068,18.07121227941944,23
0.2,9577,91,173159,18.078826477343913,10
0.2,9578,90,173249,18.086334690468735,11
0.2,9579,46,173295,18.089248434237994,55
0.2,9580,-91,173204,18.077862436071392,194
0.2,9581,36,173240,18.079732832394072,65
0.2,9582,17,173257,18.079620160701243,84
0.2,9583,33,173290,18.081176961602672,68
0.2,9584,8,173298,18.08012519561815,95
0.2,9585,90,173388,18.087627790527854,10
0.2,9586,8,173396,18.086575571085845,99
0.2,9587,86,173482,18.093658740091783,14
0.2,9588,-106,173376,18.080717488789237,138
0.2,9589,86,173462,18.087799791449427,15
0.2,9590,22,173484,18.088207694713795,80
0.2,9591,-53,173431,18.0807964970809,182
0.2,9592,57,173488,18.084853539038882,44
0.2,9593,65,173553,18.08974358974359,36
0.2,9594,78,173631,18.09598749348619,22
0.2,9595,43,173674,18.098582742809505,58
0.2,9596,86,173760,18.105658018130665,15
0.2,9597,-292,173468,18.073348614294645,329
0.2,9598,77,173545,18.079487446609022,24
0.2,9599,-13,173532,18.07625,45
0.2,9600,63,173595,18.080929069888555,38
0.2,9601,38,173633,18.083003540928974,64
0.2,9602,36,173669,18.084869311673437,64
0.2,9603,-75,173594,18.075177009579342,177
0.2,9604,-12,173582,18.072045809474233,150
0.2,9605,-51,173531,18.0648552987716,155
0.2,9606,40,173571,18.067138544811076,62
0.2,9607,93,173664,18.074937552039966,8
0.2,9608,66,173730,18.079925070246645,35
0.2,9609,89,173819,18.087304890738814,11
0.2,9610,-94,173725,18.075642492976797,224
0.2,9611,-16,173709,18.072097378277153,48
0.2,9612,68,173777,18.077291168209715,33
0.2,9613,-5,173772,18.074890784272934,108
0.2,9614,70,173842,18.080291211648465,30
0.2,9615,-216,173626,18.055948419301163,181
0.2,9616,3,173629,18.054382863678903,99
0.2,9617,7,173636,18.05323352048243,96
0.2,9618,94,173730,18.061129015490177,7
0.2,9619,38,173768,18.063201663201664,64
0.2,9620,-50,173718,18.056127221702525,156
0.2,9621,80,173798,18.062564955310748,21
0.2,9622,-109,173689,18.04936090616232,209
0.2,9623,-69,173620,18.04031587697423,172
0.2,9624,53,173673,18.043948051948053,47
0.2,9625,17,173690,18.043839601080407,15
0.2,9626,62,173752,18.04840552612444,38
0.2,9627,32,173784,18.0498545907769,80
0.2,9628,-2,173782,18.047772354346247,103
0.2,9629,-19,173763,18.04392523364486,50
0.2,9630,37,173800,18.045893469006334,65
0.2,9631,-37,173763,18.040178571428573,139
0.2,9632,-75,173688,18.030520087200248,110
0.2,9633,20,173708,18.03072451733444,81
0.2,9634,-117,173591,18.01670991177997,229
0.2,9635,52,173643,18.020236612702366,48
0.2,9636,-6,173637,18.01774411123794,108
0.2,9637,55,173692,18.021581240921353,46
0.2,9638,14,173706,18.021164021164022,97
0.2,9639,35,173741,18.02292531120332,65
0.2,9640,-23,173718,18.018670262420912,144
0.2,9641,50,173768,18.021987139597595,50
0.2,9642,87,173855,18.02914030903246,14
0.2,9643,84,173939,18.03598092077976,16
0.2,9644,21,173960,18.036288232244686,81
0.2,9645,1,173961,18.034522081691893,101
0.2,9646,86,174047,18.04156732663004,15
0.2,9647,-174,173873,18.021662520729684,211
0.2,9648,7,173880,18.02052026116696,24
0.2,9649,86,173966,18.02756476683938,14
0.2,9650,45,174011,18.030359548233342,56
0.2,9651,-72,173939,18.021031910484872,172
0.2,9652,47,173986,18.024033979073863,56
0.2,9653,-95,173891,18.012326496788894,127
0.2,9654,78,173969,18.01853961677887,22
0.2,9655,-120,173849,18.004246064623032,155
0.2,9656,22,173871,18.004659832246038,9
0.2,9657,-131,173740,17.989231724994823,175
0.2,9658,80,173820,17.99565172378093,20
0.2,9659,70,173890,18.001035196687372,30
0.2,9660,13,173903,18.00051754476762,88
0.2,9661,3,173906,17.9989650175947,99
0.2,9662,70,173976,18.004346476249612,30
0.2,9663,78,174054,18.01055463576159,22
0.2,9664,-51,174003,18.003414381789963,153
0.2,9665,19,174022,18.003517483964412,82
0.2,9666,87,174109,18.010654805006723,13
0.2,9667,0,174109,18.008791890773686,32
0.2,9668,94,174203,18.016651153169924,7
0.2,9669,5,174208,18.0153050672182,95
0.2,9670,52,174260,18.01881915003619,49
0.2,9671,-44,174216,18.01240694789082,75
0.2,9672,48,174264,18.01550708156725,52
0.2,9673,-11,174253,18.0125077527393,44
0.2,9674,64,174317,18.017260981912145,37
0.2,9675,85,174402,18.024183546920217,16
0.2,9676,57,174459,18.02821122248631,43
0.2,9677,-82,174377,18.01787559413102,115
0.2,9678,-23,174354,18.01363777249716,54
0.2,9679,39,174393,18.015805785123966,61
0.2,9680,67,174460,18.020865613056504,33
0.2,9681,-3,174457,18.018694484610617,106
0.2,9682,39,174496,18.020861303315087,62
0.2,9683,-211,174285,17.99721189591078,244
0.2,9684,78,174363,18.00340733092411,22
0.2,9685,11,174374,18.002684286599216,89
0.2,9686,91,174465,18.010219882316505,10
0.2,9687,87,174552,18.017341040462426,13
0.2,9688,93,174645,18.02507998761482,14
0.2,9689,53,174698,18.028689370485036,48
0.2,9690,61,174759,18.033123516664947,40
0.2,9691,75,174834,18.039001238134546,26
0.2,9692,46,174880,18.0418858970391,54
0.2,9693,73,174953,18.047555188776563,27
0.2,9694,-274,174679,18.017431665807116,308
0.2,9695,62,174741,18.021967821782177,39
0.2,9696,44,174785,18.024646797978757,57
0.2,9697,65,174850,18.029490616621985,35
0.2,9698,57,174907,18.033508609134962,44
0.2,9699,48,174955,18.03659793814433,52
0.2,9700,-99,174856,18.024533553241934,61
0.2,9701,93,174949,18.032261389404248,7
0.2,9702,95,175044,18.040193754508916,21
0.2,9703,33,175077,18.041735366859026,68
0.2,9704,88,175165,18.0489438433797,13
0.2,9705,-262,174903,18.02009066556769,226
0.2,9706,-127,174776,18.00515092201504,161
0.2,9707,94,174870,18.012978986402967,6
0.2,9708,-67,174803,18.004222885982077,169
0.2,9709,-35,174768,17.998764160659114,69
0.2,9710,-63,174705,17.990423231387087,100
0.2,9711,94,174799,17.998249588138385,6
0.2,9712,-220,174579,17.973746525275406,325
0.2,9713,19,174598,17.973852172122708,86
0.2,9714,47,174645,17.976839938239834,56
0.2,9715,94,174739,17.98466447097571,7
0.2,9716,12,174751,17.98404857466296,97
0.2,9717,76,174827,17.9900185223297,25
0.2,9718,69,174896,17.995267002778064,32
0.2,9719,54,174950,17.99897119341564,46
0.2,9720,91,175041,18.006480814730995,9
0.2,9721,24,175065,18.00709730508126,76
0.2,9722,-46,175019,18.00051424457472,149
0.2,9723,-63,174956,17.992184286301935,164
0.2,9724,90,175046,17.999588688946016,10
0.2,9725,1,175047,17.997840838988278,101
0.2,9726,49,175096,18.001028066207464,53
0.2,9727,90,175186,18.00842927631579,17
0.2,9728,45,175231,18.01120361804913,55
0.2,9729,-92,175139,17.99989722507708,194
0.2,9730,-69,175070,17.990956736203884,172
0.2,9731,73,175143,17.996609124537606,28
0.2,9732,-26,175117,17.992088770163363,126
0.2,9733,74,175191,17.997842613519623,26
0.2,9734,76,175267,18.003800719054958,24
0.2,9735,-90,175177,17.99270747740345,193
0.2,9736,93,175270,18.000410804149123,8
0.2,9737,-86,175184,17.989730950913945,188
0.2,9738,-47,175137,17.98305780880994,80
0.2,9739,80,175217,17.989425051334702,20
0.2,9740,31,175248,17.990760702186634,89
0.2,9741,-12,175236,17.987682200780128,126
0.2,9742,-54,175182,17.980293544082933,168
0.2,9743,32,175214,17.98173234811166,72
0.2,9744,37,175251,17.983683940482297,63
0.2,9745,66,175317,17.98861071208701,34
0.2,9746,62,175379,17.993126090079,39
0.2,9747,88,175467,18.000307755437014,13
0.2,9748,85,175552,18.00718022361268,15
0.2,9749,41,175593,18.00953846153846,59
0.2,9750,55,175648,18.01333196595221,46
0.2,9751,-36,175612,18.007793273174734,143
0.2,9752,92,175704,18.01537988311289,9
0.2,9753,95,175799,18.02327250358827,6
0.2,9754,64,175863,18.027985648385442,36
0.2,9755,20,175883,18.02818778187782,82
0.2,9756,79,175962,18.03443681459465,22
0.2,9757,68,176030,18.039557286329167,32
0.2,9758,73,176103,18.045189056255765,28
0.2,9759,24,176127,18.04579918032787,77
0.2,9760,83,176210,18.052453642044874,18
0.2,9761,-50,176160,18.045482483097725,151
0.2,9762,82,176242,18.052033186520536,18
0.2,9763,-322,175920,18.0172060630889,305
0.2,9764,91,176011,18.02467997951869,10
0.2,9765,2,176013,18.023039115297973,99
0.2,9766,-44,175969,18.016688850209892,76
0.2,9767,38,176007,18.018734643734643,81
0.2,9768,13,176020,18.018220902855973,87
0.2,9769,-27,175993,18.013613101330606,130
0.2,9770,67,176060,18.01862654794801,35
0.2,9771,94,176154,18.02640196479738,6
0.2,9772,90,176244,18.03376649953955,11
0.2,9773,60,176304,18.03806015960712,40
0.2,9774,-189,176115,18.01687979539642,291
0.2,9775,63,176178,18.021481178396073,38
0.2,9776,-219,175959,17.997238416692237,327
0.2,9777,-218,175741,17.973102884025362,339
0.2,9778,76,175817,17.979036711320177,25
0.2,9779,-203,175614,17.95644171779141,239
0.2,9780,72,175686,17.961967079030774,28
0.2,9781,71,175757,17.967389081987324,31
0.2,9782,54,175811,17.971072268220382,46
0.2,9783,95,175906,17.978945216680295,6
0.2,9784,10,175916,17.978129790495657,90
0.2,9785,69,175985,17.98334355201308,35
0.2,9786,18,176003,17.983345253908247,82
0.2,9787,2,176005,17.98171230077646,31
0.2,9788,17,176022,17.981612013484522,14
0.2,9789,18,176040,17.98161389172625,96
0.2,9790,57,176097,17.98559901950771,43
0.2,9791,94,176191,17.993361928104576,7
0.2,9792,87,176278,18.000408455018892,14
0.2,9793,0,176278,17.99857055340004,101
0.2,9794,14,176292,17.998162327718223,88
0.2,9795,92,176384,18.005716619028174,9
0.2,9796,84,176468,18.01245279167092,16
0.2,9797,37,176505,18.014390691977955,65
0.2,9798,61,176566,18.018777426267988,41
0.2,9799,58,176624,18.02285714285714,42
0.2,9800,-14,176610,18.019589837771655,62
0.2,9801,86,176696,18.02652519893899,15
0.2,9802,-4,176692,18.024278282158523,105
0.2,9803,44,176736,18.026927784577722,56
0.2,9804,89,176825,18.03416624171341,11
0.2,9805,31,176856,18.035488476442993,69
0.2,9806,75,176931,18.041297032731723,26
0.2,9807,60,176991,18.045575040783035,40
0.2,9808,57,177048,18.04954633499847,43
0.2,9809,-7,177041,18.046992864424055,110
0.2,9810,-168,176873,18.028029762511466,203
0.2,9811,-34,176839,18.022727272727273,134
0.2,9812,80,176919,18.029043106083765,21
0.2,9813,69,176988,18.03423680456491,32
0.2,9814,40,177028,18.03647478349465,61
0.2,9815,7,177035,18.03535044824776,24
0.2,9816,80,177115,18.041662422328614,20
0.2,9817,59,177174,18.045834182114483,42
0.2,9818,40,177214,18.048070068235056,61
0.2,9819,52,177266,18.05152749490835,48
0.2,9820,-71,177195,18.042460034619694,103
0.2,9821,33,177228,18.043982895540623,83
0.2,9822,14,177242,18.043571210424513,86
0.2,9823,-36,177206,18.03807003257329,136
0.2,9824,-258,176948,18.00997455470738,385
0.2,9825,-4,176944,18.007734581721962,104
0.2,9826,-20,176924,18.0038668973237,54
0.2,9827,72,176996,18.009361009361008,28
0.2,9828,8,177004,18.00834265947706,92
0.2,9829,59,177063,18.012512716174975,44
0.2,9830,62,177125,18.016987081680398,38
0.2,9831,12,177137,18.016375101708707,88
0.2,9832,23,177160,18.016881928200956,80
0.2,9833,8,177168,18.015863331299574,92
0.2,9834,-41,177127,18.00986273512964,145
0.2,9835,72,177199,18.015351769011794,29
0.2,9836,81,177280,18.02175459997967,20
0.2,9837,-62,177218,18.013620654604594,25
0.2,9838,58,177276,18.01768472405732,42
0.2,9839,79,177355,18.023882113821138,22
0.2,9840,63,177418,18.028452393049488,38
0.2,9841,92,177510,18.035968299126193,9
0.2,9842,30,177540,18.03718378543127,71
0.2,9843,-62,177478,18.029053230394148,166
0.2,9844,68,177546,18.03412899949213,32
0.2,9845,86,177632,18.0410318911233,15
0.2,9846,-66,177566,18.03249720727125,98
0.2,9847,39,177605,18.034626320064987,63
0.2,9848,33,177638,18.036145801604224,70
0.2,9849,-82,177556,18.025989847715735,114
0.2,9850,38,177594,18.02801746015633,62
0.2,9851,78,177672,18.034104750304508,22
0.2,9852,5,177677,18.03278189383944,96
0.2,9853,45,177722,18.035518571138624,57
0.2,9854,74,177796,18.041197361745308,27
0.2,9855,-93,177703,18.029931006493506,198
0.2,9856,71,177774,18.03530485949072,29
0.2,9857,-73,177701,18.026070196794482,175
0.2,9858,51,177752,18.02941474794604,51
0.2,9859,-66,177686,18.020892494929004,99
0.2,9860,42,177728,18.023324206469933,58
0.2,9861,26,177754,18.024133035895357,6
0.2,9862,-46,177708,18.017641691169015,150
0.2,9863,75,177783,18.023418491484186,25
0.2,9864,-43,177740,18.017232640648757,144
0.2,9865,86,177826,18.02412325157105,15
0.2,9866,87,177913,18.03111381372251,14
0.2,9867,-82,177831,18.020976895014186,126
0.2,9868,57,177888,18.024926537643125,44
0.2,9869,69,177957,18.030091185410335,31
0.2,9870,94,178051,18.03778745821092,7
0.2,9871,92,178143,18.04527957860616,8
0.2,9872,90,178233,18.052567608629595,10
0.2,9873,-491,177742,18.0010127607859,614
0.2,9874,62,177804,18.00546835443038,39
0.2,9875,83,177887,18.0120494127177,17
0.2,9876,-250,177637,17.984914447706792,288
0.2,9877,52,177689,17.98835796719984,50
0.2,9878,57,177746,17.992306913655227,44
0.2,9879,-89,177657,17.981477732793522,191
0.2,9880,51,177708,17.984819350268193,50
0.2,9881,-179,177529,17.964885650678,290
0.2,9882,72,177601,17.97035313164019,29
0.2,9883,92,177693,17.977842978551195,8
0.2,9884,15,177708,17.97754172989378,92
0.2,9885,-14,177694,17.97430710095084,115
0.2,9886,14,177708,17.973905127945788,100
0.2,9887,94,177802,17.981593851132686,7
0.2,9888,20,177822,17.98179795732632,83
0.2,9889,15,177837,17.98149646107179,88
0.2,9890,43,177880,17.984025882115056,59
0.2,9891,95,177975,17.99181156490093,6
0.2,9892,86,178061,17.99868593955322,15
0.2,9893,-75,177986,17.989286436223974,177
0.2,9894,86,178072,17.996159676604346,15
0.2,9895,41,178113,17.99848423605497,59
0.2,9896,56,178169,18.00232393654643,45
0.2,9897,78,178247,18.008385532430793,23
0.2,9898,-43,178204,18.00222244671179,143
0.2,9899,94,178298,18.00989898989899,6
0.2,9900,78,178376,18.015957984042014,23
0.2,9901,30,178406,18.01716824883862,73
0.2,9902,37,178443,18.019085125719478,66
0.2,9903,46,178489,18.021910339256866,55
0.2,9904,89,178578,18.029076224129227,12
0.2,9905,32,178610,18.03048657379366,71
0.2,9906,58,178668,18.034521045725246,44
0.2,9907,45,178713,18.03724263221639,56
0.2,9908,60,178773,18.0414774447472,40
0.2,9909,42,178815,18.043895055499494,58
0.2,9910,87,178902,18.050852588033496,13
0.2,9911,77,178979,18.0567998385795,24
0.2,9912,12,178991,18.056188842933523,20
0.2,9913,16,179007,18.05598144038733,84
0.2,9914,85,179092,18.062733232476045,16
0.2,9915,70,179162,18.067970956030656,30
0.2,9916,91,179253,18.07532519915297,9
0.2,9917,81,179334,18.081669691470054,20
0.2,9918,82,179416,18.088113721141244,18
0.2,9919,-14,179402,18.084879032258065,115
0.2,9920,83,179485,18.091422235661728,17
0.2,9921,53,179538,18.09494053618222,48
0.2,9922,74,179612,18.100574423057544,27
0.2,9923,56,179668,18.104393389762194,44
0.2,9924,29,179697,18.105491183879092,72
0.2,9925,77,179774,18.1114245416079,24
0.2,9926,-112,179662,18.098317719351265,147
0.2,9927,-17,179645,18.094782433521353,118
0.2,9928,21,179666,18.0950750327324,80
0.2,9929,81,179747,18.101409869083586,19
0.2,9930,-310,179437,18.06837176517974,414
0.2,9931,84,179521,18.075010068465566,16
0.2,9932,-20,179501,18.071176885130374,123
0.2,9933,69,179570,18.076303603784982,33
0.2,9934,-159,179411,18.058480120785102,259
0.2,9935,44,179455,18.061090982286636,56
0.2,9936,55,179510,18.064808292241118,45
0.2,9937,54,179564,18.06842423022741,47
0.2,9938,94,179658,18.07606399034108,7
0.2,9939,-227,179431,18.051408450704226,191
0.2,9940,29,179460,18.05250980786641,71
0.2,9941,-1,179459,18.050593441963386,103
0.2,9942,67,179526,18.055516443729257,33
0.2,9943,-5,179521,18.053197908286403,109
0.2,9944,59,179580,18.057315233785822,41
0.2,9945,41,179621,18.05962195857631,59
0.2,9946,24,179645,18.060219161556248,7
0.2,9947,95,179740,18.067953357458787,6
0.2,9948,-23,179717,18.063825510101516,129
0.2,9949,-65,179652,18.055477386934673,168
0.2,9950,57,179709,18.059391015978292,49
0.2,9951,-103,179606,18.047226688102892,137
0.2,9952,-30,179576,18.04239927660002,132
0.2,9953,80,179656,18.048623668876832,20
0.2,9954,53,179709,18.052134605725765,47
0.2,9955,7,179716,18.051024507834473,94
0.2,9956,89,179805,18.058150045194335,11
0.2,9957,87,179892,18.06507330789315,13
0.2,9958,64,179956,18.06968571141681,36
0.2,9959,69,180025,18.074799196787147,32
0.2,9960,-11,180014,18.07188033329987,43
0.2,9961,-15,179999,18.068560530014054,46
0.2,9962,66,180065,18.073371474455485,34
0.2,9963,73,180138,18.07888398233641,27
0.2,9964,56,180194,18.08268941294531,44
0.2,9965,91,180285,18.0900060204696,10
0.2,9966,-32,180253,18.084980435436943,63
0.2,9967,-82,180171,18.07493980738363,114
0.2,9968,31,180202,18.076236332631158,69
0.2,9969,-44,180158,18.07001003009027,76
0.2,9970,31,180189,18.0713067896901,69
0.2,9971,66,180255,18.076113116726834,35
0.2,9972,-151,180104,18.05915973127444,183
0.2,9973,21,180125,18.059454581912973,82
0.2,9974,83,180208,18.065964912280702,17
0.2,9975,34,180242,18.06756214915798,67
0.2,9976,-24,180218,18.06334569509873,55
0.2,9977,83,180301,18.069853678091803,18
0.2,9978,-15,180286,18.066539733440223,125
0.2,9979,83,180369,18.07304609218437,18
0.2,9980,-79,180290,18.063320308586313,179
0.2,9981,26,180316,18.064115407733922,75
0.2,9982,-178,180138,18.04447560853451,295
0.2,9983,71,180209,18.049779647435898,32
0.2,9984,-37,180172,18.044266399599397,138
0.2,9985,8,180180,18.043260564790707,101
0.2,9986,-76,180104,18.033843997196357,176
0.2,9987,-89,180015,18.023127753303964,191
0.2,9988,85,180100,18.029832816097706,15
0.2,9989,27,180127,18.03073073073073,85
0.2,9990,84,180211,18.037333600240217,16
0.2,9991,-42,180169,18.03132506004804,145
0.2,9992,74,180243,18.036925848093667,26
0.2,9993,-146,180097,18.02051230738443,181
0.2,9994,-46,180051,18.014107053526764,148
0.2,9995,32,180083,18.015506202480992,70
0.2,9996,-199,179884,17.993798139441832,235
0.2,9997,25,179909,17.994498899779956,78
0.2,9998,57,179966,17.998399839984,44
0.2,9999,24,179990,17.999,77
