0.2,0,-26,-26,-26.0,101
0.2,1,-926,-952,-476.0,886
0.2,2,-129,-1081,-360.3333333333333,269
0.2,3,-438,-1519,-379.75,382
0.2,4,16,-1503,-300.6,39
0.2,5,-62,-1565,-260.8333333333333,93
0.2,6,-10,-1575,-225.0,127
0.2,7,25,-1550,-193.75,15
0.2,8,19,-1531,-170.11111111111111,21
0.2,9,17,-1514,-151.4,36
0.2,10,17,-1497,-136.0909090909091,29
0.2,11,94,-1403,-116.91666666666667,16
0.2,12,91,-1312,-100.92307692307692,10
0.2,13,19,-1293,-92.35714285714286,20
0.2,14,96,-1197,-79.8,6
0.2,15,94,-1103,-68.9375,9
0.2,16,-54,-1157,-68.05882352941177,20
0.2,17,96,-1061,-58.94444444444444,7
0.2,18,94,-967,-50.89473684210526,10
0.2,19,78,-889,-44.45,61
0.2,20,95,-794,-37.80952380952381,12
0.2,21,95,-699,-31.772727272727273,7
0.2,22,93,-606,-26.347826086956523,9
0.2,23,94,-512,-21.333333333333332,8
0.2,24,93,-419,-16.76,9
0.2,25,14,-405,-15.576923076923077,20
0.2,26,91,-314,-11.62962962962963,11
0.2,27,95,-219,-7.821428571428571,7
0.2,28,21,-198,-6.827586206896552,14
0.2,29,92,-106,-3.533333333333333,10
0.2,30,24,-82,-2.6451612903225805,9
0.2,31,-56,-138,-4.3125,22
0.2,32,20,-118,-3.5757575757575757,15
0.2,33,93,-25,-0.7352941176470589,10
0.2,34,95,70,2.0,7
0.2,35,96,166,4.611111111111111,7
0.2,36,-50,116,3.135135135135135,14
0.2,37,91,207,5.447368421052632,13
0.2,38,91,298,7.641025641025641,11
0.2,39,86,384,9.6,17
0.2,40,25,409,9.975609756097562,9
0.2,41,72,481,11.452380952380953,31
0.2,42,95,576,13.395348837209303,8
0.2,43,96,672,15.272727272727273,6
0.2,44,94,766,17.022222222222222,10
0.2,45,93,859,18.67391304347826,11
0.2,46,95,954,20.29787234042553,8
0.2,47,93,1047,21.8125,10
0.2,48,93,1140,23.26530612244898,9
0.2,49,94,1234,24.68,8
0.2,50,93,1327,26.019607843137255,11
0.2,51,95,1422,27.346153846153847,7
0.2,52,95,1517,28.62264150943396,8
0.2,53,21,1538,28.48148148148148,12
0.2,54,26,1564,28.436363636363637,8
0.2,55,96,1660,29.642857142857142,6
0.2,56,22,1682,29.50877192982456,13
0.2,57,22,1704,29.379310344827587,11
0.2,58,93,1797,30.45762711864407,9
0.2,59,14,1811,30.183333333333334,23
0.2,60,-49,1762,28.885245901639344,13
0.2,61,90,1852,29.870967741935484,13
0.2,62,96,1948,30.92063492063492,6
0.2,63,92,2040,31.875,13
0.2,64,91,2131,32.784615384615385,11
0.2,65,22,2153,32.621212121212125,11
0.2,66,94,2247,33.53731343283582,8
0.2,67,24,2271,33.39705882352941,9
0.2,68,-51,2220,32.17391304347826,16
0.2,69,24,2244,32.05714285714286,8
0.2,70,90,2334,32.87323943661972,12
0.2,71,92,2426,33.69444444444444,10
0.2,72,93,2519,34.50684931506849,9
0.2,73,88,2607,35.229729729729726,15
0.2,74,94,2701,36.013333333333335,8
0.2,75,87,2788,36.68421052631579,17
0.2,76,95,2883,37.44155844155844,7
0.2,77,89,2972,38.1025641025641,17
0.2,78,95,3067,38.822784810126585,7
0.2,79,27,3094,38.675,6
0.2,80,92,3186,39.333333333333336,10
0.2,81,87,3273,39.91463414634146,15
0.2,82,25,3298,39.734939759036145,8
0.2,83,89,3387,40.32142857142857,13
0.2,84,92,3479,40.92941176470588,10
0.2,85,96,3575,41.56976744186046,6
0.2,86,25,3600,41.37931034482759,9
0.2,87,96,3696,42.0,6
0.2,88,91,3787,42.550561797752806,11
0.2,89,23,3810,42.333333333333336,11
0.2,90,94,3904,42.9010989010989,8
0.2,91,96,4000,43.47826086956522,6
0.2,92,92,4092,44.0,10
0.2,93,92,4184,44.51063829787234,10
0.2,94,94,4278,45.03157894736842,8
0.2,95,93,4371,45.53125,9
0.2,96,94,4465,46.03092783505155,8
0.2,97,94,4559,46.52040816326531,8
0.2,98,20,4579,46.25252525252525,15
0.2,99,93,4672,46.72,10
0.2,100,91,4763,47.15841584158416,12
0.2,101,23,4786,46.92156862745098,10
0.2,102,96,4882,47.398058252427184,6
0.2,103,94,4976,47.84615384615385,8
0.2,104,95,5071,48.2952380952381,7
0.2,105,-55,5016,47.320754716981135,21
0.2,106,90,5106,47.7196261682243,12
0.2,107,22,5128,47.48148148148148,11
0.2,108,24,5152,47.26605504587156,10
0.2,109,25,5177,47.06363636363636,9
0.2,110,91,5268,47.45945945945946,13
0.2,111,17,5285,47.1875,16
0.2,112,-48,5237,46.34513274336283,12
0.2,113,93,5330,46.75438596491228,9
0.2,114,-53,5277,45.88695652173913,17
0.2,115,93,5370,46.293103448275865,9
0.2,116,92,5462,46.68376068376068,11
0.2,117,93,5555,47.07627118644068,10
0.2,118,23,5578,46.87394957983193,11
0.2,119,89,5667,47.225,14
0.2,120,18,5685,46.98347107438016,16
0.2,121,93,5778,47.36065573770492,9
0.2,122,95,5873,47.7479674796748,7
0.2,123,93,5966,48.11290322580645,9
0.2,124,94,6060,48.48,8
0.2,125,94,6154,48.84126984126984,8
0.2,126,94,6248,49.196850393700785,8
0.2,127,93,6341,49.5390625,10
0.2,128,95,6436,49.89147286821706,7
0.2,129,93,6529,50.223076923076924,9
0.2,130,92,6621,50.541984732824424,11
0.2,131,27,6648,50.36363636363637,6
0.2,132,93,6741,50.68421052631579,11
0.2,133,91,6832,50.985074626865675,11
0.2,134,24,6856,50.785185185185185,10
0.2,135,24,6880,50.588235294117645,9
0.2,136,-51,6829,49.846715328467155,16
0.2,137,94,6923,50.166666666666664,11
0.2,138,95,7018,50.489208633093526,7
0.2,139,92,7110,50.785714285714285,10
0.2,140,-48,7062,50.08510638297872,12
0.2,141,91,7153,50.37323943661972,11
0.2,142,96,7249,50.69230769230769,6
0.2,143,94,7343,50.99305555555556,8
0.2,144,95,7438,51.296551724137935,7
0.2,145,94,7532,51.58904109589041,8
0.2,146,94,7626,51.87755102040816,8
0.2,147,23,7649,51.682432432432435,10
0.2,148,95,7744,51.97315436241611,6
0.2,149,89,7833,52.22,16
0.2,150,93,7926,52.49006622516556,10
0.2,151,19,7945,52.26973684210526,15
0.2,152,89,8034,52.509803921568626,14
0.2,153,24,8058,52.324675324675326,9
0.2,154,94,8152,52.593548387096774,8
0.2,155,94,8246,52.85897435897436,8
0.2,156,92,8338,53.10828025477707,12
0.2,157,19,8357,52.892405063291136,14
0.2,158,94,8451,53.15094339622642,10
0.2,159,93,8544,53.4,9
0.2,160,94,8638,53.65217391304348,8
0.2,161,25,8663,53.47530864197531,8
0.2,162,96,8759,53.736196319018404,6
0.2,163,89,8848,53.951219512195124,16
0.2,164,93,8941,54.18787878787879,9
0.2,165,94,9035,54.4277108433735,8
0.2,166,20,9055,54.221556886227546,13
0.2,167,93,9148,54.45238095238095,9
0.2,168,90,9238,54.662721893491124,11
0.2,169,23,9261,54.476470588235294,10
0.2,170,24,9285,54.29824561403509,9
0.2,171,95,9380,54.53488372093023,7
0.2,172,93,9473,54.75722543352601,9
0.2,173,92,9565,54.97126436781609,11
0.2,174,94,9659,55.19428571428571,8
0.2,175,23,9682,55.01136363636363,11
0.2,176,94,9776,55.23163841807909,9
0.2,177,90,9866,55.42696629213483,12
0.2,178,94,9960,55.642458100558656,9
0.2,179,88,10048,55.82222222222222,14
0.2,180,92,10140,56.02209944751381,10
0.2,181,16,10156,55.8021978021978,17
0.2,182,25,10181,55.63387978142077,8
0.2,183,-49,10132,55.06521739130435,16
0.2,184,13,10145,54.83783783783784,20
0.2,185,24,10169,54.67204301075269,9
0.2,186,93,10262,54.87700534759358,9
0.2,187,24,10286,54.712765957446805,9
0.2,188,92,10378,54.91005291005291,11
0.2,189,95,10473,55.12105263157895,7
0.2,190,25,10498,54.96335078534032,8
0.2,191,89,10587,55.140625,13
0.2,192,88,10675,55.310880829015545,15
0.2,193,90,10765,55.48969072164948,14
0.2,194,92,10857,55.676923076923075,10
0.2,195,92,10949,55.86224489795919,11
0.2,196,93,11042,56.0507614213198,11
0.2,197,90,11132,56.22222222222222,14
0.2,198,94,11226,56.41206030150754,9
0.2,199,93,11319,56.595,9
0.2,200,96,11415,56.791044776119406,6
0.2,201,18,11433,56.5990099009901,15
0.2,202,-50,11383,56.073891625615765,14
0.2,203,87,11470,56.22549019607843,15
0.2,204,92,11562,56.4,11
0.2,205,20,11582,56.22330097087379,14
0.2,206,90,11672,56.38647342995169,12
0.2,207,91,11763,56.55288461538461,11
0.2,208,22,11785,56.38755980861244,15
0.2,209,22,11807,56.22380952380952,12
0.2,210,19,11826,56.04739336492891,16
0.2,211,87,11913,56.193396226415096,16
0.2,212,87,12000,56.33802816901409,20
0.2,213,92,12092,56.504672897196265,10
0.2,214,23,12115,56.348837209302324,10
0.2,215,96,12211,56.532407407407405,7
0.2,216,94,12305,56.705069124423964,9
0.2,217,94,12399,56.87614678899082,9
0.2,218,93,12492,57.04109589041096,10
0.2,219,94,12586,57.20909090909091,8
0.2,220,25,12611,57.06334841628959,8
0.2,221,24,12635,56.914414414414416,11
0.2,222,23,12658,56.762331838565025,12
0.2,223,95,12753,56.933035714285715,7
0.2,224,21,12774,56.77333333333333,13
0.2,225,91,12865,56.924778761061944,11
0.2,226,96,12961,57.096916299559474,6
0.2,227,84,13045,57.21491228070175,18
0.2,228,93,13138,57.37117903930131,9
0.2,229,92,13230,57.52173913043478,10
0.2,230,93,13323,57.675324675324674,10
0.2,231,-52,13271,57.202586206896555,16
0.2,232,92,13363,57.351931330472105,12
0.2,233,96,13459,57.51709401709402,6
0.2,234,91,13550,57.659574468085104,11
0.2,235,90,13640,57.79661016949152,12
0.2,236,95,13735,57.95358649789029,7
0.2,237,94,13829,58.10504201680672,8
0.2,238,96,13925,58.26359832635983,6
0.2,239,93,14018,58.40833333333333,9
0.2,240,92,14110,58.54771784232365,10
0.2,241,22,14132,58.396694214876035,14
0.2,242,22,14154,58.24691358024691,11
0.2,243,92,14246,58.385245901639344,12
0.2,244,94,14340,58.53061224489796,9
0.2,245,90,14430,58.65853658536585,13
0.2,246,92,14522,58.79352226720648,11
0.2,247,21,14543,58.641129032258064,12
0.2,248,26,14569,58.51004016064257,7
0.2,249,93,14662,58.648,9
0.2,250,19,14681,58.49003984063745,14
0.2,251,93,14774,58.62698412698413,9
0.2,252,91,14865,58.75494071146245,11
0.2,253,93,14958,58.889763779527556,9
0.2,254,27,14985,58.76470588235294,6
0.2,255,94,15079,58.90234375,9
0.2,256,87,15166,59.011673151750976,17
0.2,257,90,15256,59.13178294573643,14
0.2,258,93,15349,59.262548262548265,10
0.2,259,95,15444,59.4,7
0.2,260,93,15537,59.52873563218391,9
0.2,261,23,15560,59.38931297709924,11
0.2,262,89,15649,59.50190114068441,15
0.2,263,92,15741,59.625,11
0.2,264,92,15833,59.74716981132075,10
0.2,265,95,15928,59.8796992481203,8
0.2,266,92,16020,60.0,10
0.2,267,94,16114,60.12686567164179,9
0.2,268,26,16140,60.0,7
0.2,269,90,16230,60.111111111111114,12
0.2,270,88,16318,60.2140221402214,18
0.2,271,95,16413,60.341911764705884,7
0.2,272,96,16509,60.472527472527474,6
0.2,273,-48,16461,60.07664233576642,15
0.2,274,94,16555,60.2,8
0.2,275,89,16644,60.30434782608695,16
0.2,276,91,16735,60.415162454873645,11
0.2,277,95,16830,60.539568345323744,7
0.2,278,92,16922,60.65232974910394,10
0.2,279,93,17015,60.767857142857146,10
0.2,280,96,17111,60.8932384341637,6
0.2,281,92,17203,61.00354609929078,10
0.2,282,96,17299,61.12720848056537,6
0.2,283,16,17315,60.96830985915493,17
0.2,284,95,17410,61.08771929824562,7
0.2,285,93,17503,61.1993006993007,10
0.2,286,92,17595,61.30662020905923,10
0.2,287,19,17614,61.15972222222222,15
0.2,288,96,17710,61.280276816608996,6
0.2,289,90,17800,61.37931034482759,11
0.2,290,86,17886,61.4639175257732,16
0.2,291,92,17978,61.56849315068493,10
0.2,292,94,18072,61.67918088737201,7
0.2,293,95,18167,61.79251700680272,7
0.2,294,94,18261,61.90169491525424,9
0.2,295,91,18352,62.0,12
0.2,296,90,18442,62.0942760942761,12
0.2,297,94,18536,62.20134228187919,8
0.2,298,92,18628,62.30100334448161,10
0.2,299,25,18653,62.17666666666667,8
0.2,300,24,18677,62.04983388704319,9
0.2,301,21,18698,61.913907284768214,13
0.2,302,96,18794,62.026402640264024,7
0.2,303,26,18820,61.9078947368421,6
0.2,304,26,18846,61.79016393442623,7
0.2,305,93,18939,61.8921568627451,9
0.2,306,96,19035,62.00325732899023,6
0.2,307,92,19127,62.10064935064935,12
0.2,308,91,19218,62.19417475728155,11
0.2,309,18,19236,62.05161290322581,15
0.2,310,24,19260,61.92926045016077,9
0.2,311,95,19355,62.03525641025641,7
0.2,312,87,19442,62.115015974440894,17
0.2,313,22,19464,61.98726114649681,11
0.2,314,18,19482,61.84761904761905,15
0.2,315,93,19575,61.94620253164557,10
0.2,316,91,19666,62.03785488958991,11
0.2,317,94,19760,62.138364779874216,8
0.2,318,90,19850,62.225705329153605,14
0.2,319,91,19941,62.315625,12
0.2,320,-47,19894,61.97507788161994,12
0.2,321,95,19989,62.077639751552795,7
0.2,322,95,20084,62.17956656346749,7
0.2,323,92,20176,62.27160493827161,12
0.2,324,93,20269,62.36615384615384,10
0.2,325,22,20291,62.24233128834356,11
0.2,326,94,20385,62.3394495412844,7
0.2,327,95,20480,62.4390243902439,7
0.2,328,91,20571,62.525835866261396,11
0.2,329,25,20596,62.412121212121214,10
0.2,330,92,20688,62.50151057401813,11
0.2,331,26,20714,62.39156626506024,7
0.2,332,92,20806,62.48048048048048,11
0.2,333,96,20902,62.58083832335329,6
0.2,334,22,20924,62.45970149253731,11
0.2,335,92,21016,62.54761904761905,10
0.2,336,-47,20969,62.22255192878338,11
0.2,337,95,21064,62.319526627218934,7
0.2,338,-54,21010,61.976401179941,20
0.2,339,93,21103,62.06764705882353,9
0.2,340,91,21194,62.152492668621704,14
0.2,341,27,21221,62.04970760233918,6
0.2,342,94,21315,62.142857142857146,8
0.2,343,94,21409,62.23546511627907,8
0.2,344,94,21503,62.32753623188406,8
0.2,345,89,21592,62.40462427745665,13
0.2,346,93,21685,62.49279538904899,10
0.2,347,95,21780,62.58620689655172,7
0.2,348,95,21875,62.67908309455587,7
0.2,349,93,21968,62.76571428571429,11
0.2,350,95,22063,62.857549857549856,7
0.2,351,94,22157,62.94602272727273,8
0.2,352,92,22249,63.02832861189802,11
0.2,353,-50,22199,62.7090395480226,14
0.2,354,89,22288,62.7830985915493,14
0.2,355,25,22313,62.67696629213483,8
0.2,356,93,22406,62.76190476190476,12
0.2,357,24,22430,62.6536312849162,9
0.2,358,25,22455,62.54874651810585,7
0.2,359,92,22547,62.63055555555555,10
0.2,360,96,22643,62.72299168975069,6
0.2,361,92,22735,62.80386740331492,11
0.2,362,17,22752,62.67768595041322,16
0.2,363,92,22844,62.75824175824176,10
0.2,364,26,22870,62.657534246575345,7
0.2,365,24,22894,62.55191256830601,9
0.2,366,86,22980,62.6158038147139,18
0.2,367,93,23073,62.69836956521739,9
0.2,368,92,23165,62.77777777777778,10
0.2,369,26,23191,62.678378378378376,7
0.2,370,21,23212,62.56603773584906,12
0.2,371,95,23307,62.653225806451616,8
0.2,372,92,23399,62.73190348525469,10
0.2,373,95,23494,62.81818181818182,7
0.2,374,93,23587,62.898666666666664,9
0.2,375,95,23682,62.984042553191486,7
0.2,376,94,23776,63.06631299734748,8
0.2,377,17,23793,62.94444444444444,18
0.2,378,-122,23671,62.45646437994723,18
0.2,379,27,23698,62.363157894736844,6
0.2,380,26,23724,62.267716535433074,7
0.2,381,94,23818,62.35078534031414,9
0.2,382,95,23913,62.43603133159269,7
0.2,383,93,24006,62.515625,9
0.2,384,91,24097,62.58961038961039,12
0.2,385,19,24116,62.476683937823836,17
0.2,386,94,24210,62.55813953488372,9
0.2,387,93,24303,62.63659793814433,9
0.2,388,88,24391,62.70179948586118,14
0.2,389,92,24483,62.776923076923076,10
0.2,390,24,24507,62.67774936061381,9
0.2,391,91,24598,62.75,11
0.2,392,22,24620,62.646310432569976,11
0.2,393,91,24711,62.71827411167513,11
0.2,394,95,24806,62.8,7
0.2,395,91,24897,62.871212121212125,12
0.2,396,94,24991,62.949622166246854,9
0.2,397,95,25086,63.030150753768844,8
0.2,398,94,25180,63.1077694235589,10
0.2,399,95,25275,63.1875,7
0.2,400,92,25367,63.25935162094763,10
0.2,401,93,25460,63.333333333333336,10
0.2,402,86,25546,63.38957816377171,18
0.2,403,95,25641,63.46782178217822,7
0.2,404,90,25731,63.53333333333333,12
0.2,405,91,25822,63.600985221674875,11
0.2,406,92,25914,63.67076167076167,10
0.2,407,96,26010,63.75,6
0.2,408,-56,25954,63.45721271393643,24
0.2,409,94,26048,63.53170731707317,8
0.2,410,95,26143,63.60827250608273,7
0.2,411,24,26167,63.512135922330096,9
0.2,412,21,26188,63.409200968523,12
0.2,413,27,26215,63.32125603864734,6
0.2,414,92,26307,63.390361445783135,10
0.2,415,92,26399,63.45913461538461,10
0.2,416,92,26491,63.52757793764988,10
0.2,417,94,26585,63.600478468899524,8
0.2,418,25,26610,63.50835322195704,8
0.2,419,96,26706,63.58571428571429,6
0.2,420,93,26799,63.65558194774347,9
0.2,421,91,26890,63.720379146919434,12
0.2,422,95,26985,63.794326241134755,7
0.2,423,93,27078,63.863207547169814,9
0.2,424,-44,27034,63.60941176470588,8
0.2,425,94,27128,63.68075117370892,8
0.2,426,93,27221,63.749414519906324,10
0.2,427,-50,27171,63.48364485981308,13
0.2,428,92,27263,63.55011655011655,10
0.2,429,90,27353,63.61162790697674,13
0.2,430,94,27447,63.68213457076566,8
0.2,431,92,27539,63.74768518518518,10
0.2,432,95,27634,63.81986143187067,7
0.2,433,-48,27586,63.56221198156682,12
0.2,434,93,27679,63.62988505747126,9
0.2,435,90,27769,63.690366972477065,13
0.2,436,93,27862,63.75743707093822,9
0.2,437,-49,27813,63.5,13
0.2,438,96,27909,63.57403189066059,6
0.2,439,25,27934,63.486363636363635,8
0.2,440,91,28025,63.54875283446712,12
0.2,441,91,28116,63.61085972850679,12
0.2,442,94,28210,63.67945823927765,7
0.2,443,-51,28159,63.421171171171174,15
0.2,444,19,28178,63.321348314606745,14
0.2,445,93,28271,63.38789237668161,9
0.2,446,27,28298,63.30648769574944,6
0.2,447,24,28322,63.21875,9
0.2,448,94,28416,63.28730512249443,9
0.2,449,94,28510,63.355555555555554,8
0.2,450,95,28605,63.42572062084257,6
0.2,451,89,28694,63.482300884955755,14
0.2,452,95,28789,63.55187637969095,7
0.2,453,88,28877,63.6057268722467,15
0.2,454,92,28969,63.668131868131866,10
0.2,455,95,29064,63.73684210526316,7
0.2,456,93,29157,63.800875273522976,9
0.2,457,93,29250,63.8646288209607,8
0.2,458,94,29344,63.930283224400874,8
0.2,459,90,29434,63.98695652173913,12
0.2,460,92,29526,64.0477223427332,10
0.2,461,20,29546,63.95238095238095,13
0.2,462,94,29640,64.01727861771059,8
0.2,463,94,29734,64.08189655172414,9
0.2,464,24,29758,63.99569892473118,9
0.2,465,-53,29705,63.74463519313305,17
0.2,466,91,29796,63.80299785867238,11
0.2,467,93,29889,63.86538461538461,11
0.2,468,95,29984,63.9317697228145,7
0.2,469,92,30076,63.99148936170213,10
0.2,470,95,30171,64.05732484076434,7
0.2,471,93,30264,64.11864406779661,9
0.2,472,96,30360,64.18604651162791,7
0.2,473,91,30451,64.24261603375527,11
0.2,474,90,30541,64.29684210526315,12
0.2,475,96,30637,64.36344537815125,6
0.2,476,90,30727,64.41719077568135,12
0.2,477,90,30817,64.47071129707113,12
0.2,478,95,30912,64.53444676409185,7
0.2,479,83,30995,64.57291666666667,19
0.2,480,92,31087,64.62993762993763,10
0.2,481,-51,31036,64.39004149377594,16
0.2,482,95,31131,64.45341614906832,7
0.2,483,19,31150,64.35950413223141,19
0.2,484,95,31245,64.42268041237114,7
0.2,485,87,31332,64.46913580246914,16
0.2,486,87,31419,64.51540041067761,17
0.2,487,92,31511,64.57172131147541,11
0.2,488,-53,31458,64.33128834355828,22
0.2,489,93,31551,64.38979591836734,9
0.2,490,96,31647,64.45417515274949,6
0.2,491,93,31740,64.51219512195122,9
0.2,492,95,31835,64.57403651115618,7
0.2,493,23,31858,64.48987854251013,10
0.2,494,93,31951,64.54747474747475,10
0.2,495,87,32038,64.59274193548387,15
0.2,496,94,32132,64.65191146881288,8
0.2,497,94,32226,64.71084337349397,8
0.2,498,96,32322,64.77354709418837,6
0.2,499,90,32412,64.824,12
0.2,500,92,32504,64.87824351297405,10
0.2,501,95,32599,64.93824701195219,8
0.2,502,93,32692,64.99403578528828,9
0.2,503,25,32717,64.91468253968254,7
0.2,504,24,32741,64.83366336633664,9
0.2,505,95,32836,64.89328063241106,7
0.2,506,23,32859,64.81065088757397,10
0.2,507,92,32951,64.86417322834646,10
0.2,508,95,33046,64.92337917485266,8
0.2,509,18,33064,64.8313725490196,16
0.2,510,95,33159,64.89041095890411,7
0.2,511,93,33252,64.9453125,10
0.2,512,94,33346,65.00194931773879,10
0.2,513,96,33442,65.06225680933852,6
0.2,514,92,33534,65.11456310679611,10
0.2,515,95,33629,65.17248062015504,7
0.2,516,94,33723,65.22823984526113,8
0.2,517,93,33816,65.28185328185329,9
0.2,518,20,33836,65.19460500963392,13
0.2,519,24,33860,65.11538461538461,9
0.2,520,94,33954,65.17082533589252,8
0.2,521,93,34047,65.22413793103448,9
0.2,522,22,34069,65.1414913957935,11
0.2,523,94,34163,65.19656488549619,8
0.2,524,89,34252,65.24190476190476,14
0.2,525,-50,34202,65.02281368821293,14
0.2,526,92,34294,65.07400379506642,10
0.2,527,90,34384,65.12121212121212,12
0.2,528,93,34477,65.17391304347827,9
0.2,529,96,34573,65.23207547169811,6
0.2,530,22,34595,65.15065913370998,12
0.2,531,26,34621,65.07706766917293,7
0.2,532,-48,34573,64.86491557223265,12
0.2,533,21,34594,64.78277153558052,12
0.2,534,95,34689,64.8392523364486,7
0.2,535,93,34782,64.89179104477611,10
0.2,536,94,34876,64.94599627560521,8
0.2,537,96,34972,65.00371747211896,6
0.2,538,95,35067,65.05936920222635,7
0.2,539,94,35161,65.11296296296297,8
0.2,540,94,35255,65.16635859519408,8
0.2,541,92,35347,65.21586715867159,10
0.2,542,95,35442,65.2707182320442,7
0.2,543,91,35533,65.31801470588235,11
0.2,544,23,35556,65.24036697247706,10
0.2,545,96,35652,65.2967032967033,6
0.2,546,94,35746,65.3491773308958,11
0.2,547,96,35842,65.4051094890511,6
0.2,548,95,35937,65.45901639344262,7
0.2,549,19,35956,65.37454545454545,14
0.2,550,94,36050,65.42649727767694,8
0.2,551,25,36075,65.35326086956522,8
0.2,552,81,36156,65.38155515370705,24
0.2,553,94,36250,65.4332129963899,8
0.2,554,24,36274,65.35855855855856,9
0.2,555,24,36298,65.2841726618705,9
0.2,556,96,36394,65.33931777378815,6
0.2,557,90,36484,65.38351254480287,12
0.2,558,95,36579,65.43649373881932,8
0.2,559,94,36673,65.4875,8
0.2,560,94,36767,65.53832442067736,8
0.2,561,94,36861,65.58896797153025,8
0.2,562,95,36956,65.64120781527531,7
0.2,563,94,37050,65.69148936170212,8
0.2,564,92,37142,65.73805309734513,12
0.2,565,94,37236,65.78798586572438,8
0.2,566,93,37329,65.83597883597884,9
0.2,567,95,37424,65.88732394366197,8
0.2,568,24,37448,65.81370826010544,9
0.2,569,27,37475,65.74561403508773,6
0.2,570,94,37569,65.79509632224168,9
0.2,571,93,37662,65.84265734265735,9
0.2,572,90,37752,65.8848167539267,12
0.2,573,91,37843,65.92857142857143,12
0.2,574,-49,37794,65.72869565217391,13
0.2,575,95,37889,65.77951388888889,6
0.2,576,90,37979,65.82149046793761,12
0.2,577,96,38075,65.87370242214533,6
0.2,578,92,38167,65.9188255613126,11
0.2,579,96,38263,65.97068965517241,6
0.2,580,94,38357,66.01893287435456,8
0.2,581,96,38453,66.0704467353952,7
0.2,582,91,38544,66.11320754716981,11
0.2,583,25,38569,66.04280821917808,8
0.2,584,96,38665,66.09401709401709,7
0.2,585,-52,38613,65.89249146757679,16
0.2,586,94,38707,65.94037478705282,8
0.2,587,87,38794,65.97619047619048,15
0.2,588,94,38888,66.02376910016977,9
0.2,589,95,38983,66.0728813559322,7
0.2,590,95,39078,66.12182741116752,7
0.2,591,25,39103,66.05236486486487,8
0.2,592,19,39122,65.97301854974705,14
0.2,593,94,39216,66.02020202020202,8
0.2,594,94,39310,66.0672268907563,9
0.2,595,24,39334,65.99664429530202,8
0.2,596,96,39430,66.04690117252932,6
0.2,597,92,39522,66.09030100334448,10
0.2,598,96,39618,66.14023372287146,6
0.2,599,93,39711,66.185,9
0.2,600,94,39805,66.23128119800333,8
0.2,601,95,39900,66.27906976744185,7
0.2,602,94,39994,66.32504145936981,8
0.2,603,24,40018,66.25496688741723,9
0.2,604,93,40111,66.29917355371902,9
0.2,605,93,40204,66.34323432343234,9
0.2,606,88,40292,66.37891268533772,14
0.2,607,95,40387,66.42598684210526,8
0.2,608,23,40410,66.35467980295566,10
0.2,609,93,40503,66.3983606557377,9
0.2,610,24,40527,66.32896890343699,9
0.2,611,88,40615,66.36437908496733,15
0.2,612,20,40635,66.28874388254486,13
0.2,613,95,40730,66.33550488599349,7
0.2,614,96,40826,66.38373983739838,6
0.2,615,93,40919,66.42694805194805,9
0.2,616,93,41012,66.47001620745543,9
0.2,617,90,41102,66.50809061488673,13
0.2,618,95,41197,66.5541195476575,7
0.2,619,24,41221,66.48548387096774,10
0.2,620,91,41312,66.52495974235104,11
0.2,621,95,41407,66.57073954983923,7
0.2,622,-188,41219,66.1621187800963,14
0.2,623,88,41307,66.19711538461539,14
0.2,624,95,41402,66.2432,7
0.2,625,95,41497,66.28913738019169,7
0.2,626,94,41591,66.33333333333333,8
0.2,627,26,41617,66.26910828025478,7
0.2,628,90,41707,66.30683624801271,14
0.2,629,95,41802,66.35238095238095,7
0.2,630,93,41895,66.3946117274168,9
0.2,631,91,41986,66.43354430379746,11
0.2,632,25,42011,66.36808846761454,8
0.2,633,93,42104,66.41009463722398,10
0.2,634,92,42196,66.4503937007874,10
0.2,635,95,42291,66.49528301886792,8
0.2,636,96,42387,66.54160125588697,6
0.2,637,93,42480,66.58307210031347,9
0.2,638,96,42576,66.62910798122066,6
0.2,639,25,42601,66.5640625,8
0.2,640,93,42694,66.60530421216849,10
0.2,641,93,42787,66.64641744548287,11
0.2,642,93,42880,66.68740279937792,9
0.2,643,93,42973,66.72826086956522,9
0.2,644,21,42994,66.65736434108527,12
0.2,645,95,43089,66.70123839009288,7
0.2,646,91,43180,66.7387944358578,11
0.2,647,95,43275,66.7824074074074,7
0.2,648,95,43370,66.82588597842835,7
0.2,649,90,43460,66.86153846153846,12
0.2,650,93,43553,66.90168970814132,9
0.2,651,90,43643,66.93711656441718,12
0.2,652,94,43737,66.97856049004594,8
0.2,653,93,43830,67.01834862385321,9
0.2,654,94,43924,67.05954198473282,8
0.2,655,94,44018,67.10060975609755,8
0.2,656,95,44113,67.14307458143075,7
0.2,657,95,44208,67.1854103343465,8
0.2,658,19,44227,67.11229135053111,14
0.2,659,94,44321,67.1530303030303,9
0.2,660,94,44415,67.19364599092285,8
0.2,661,20,44435,67.12235649546828,14
0.2,662,92,44527,67.15987933634993,9
0.2,663,23,44550,67.0933734939759,10
0.2,664,22,44572,67.02556390977443,11
0.2,665,95,44667,67.06756756756756,7
0.2,666,27,44694,67.00749625187406,6
0.2,667,89,44783,67.04041916167665,14
0.2,668,90,44873,67.0747384155456,12
0.2,669,93,44966,67.1134328358209,9
0.2,670,95,45061,67.15499254843517,8
0.2,671,94,45155,67.19494047619048,9
0.2,672,83,45238,67.2184249628529,20
0.2,673,87,45325,67.24777448071217,15
0.2,674,-50,45275,67.07407407407408,14
0.2,675,92,45367,67.11094674556213,10
0.2,676,96,45463,67.1536189069424,6
0.2,677,91,45554,67.18879056047197,11
0.2,678,91,45645,67.22385861561119,11
0.2,679,93,45738,67.26176470588236,9
0.2,680,94,45832,67.30102790014685,8
0.2,681,94,45926,67.34017595307918,8
0.2,682,93,46019,67.37774524158127,9
0.2,683,95,46114,67.41812865497076,6
0.2,684,94,46208,67.45693430656934,8
0.2,685,22,46230,67.39067055393586,11
0.2,686,90,46320,67.4235807860262,15
0.2,687,95,46415,67.46366279069767,7
0.2,688,93,46508,67.50072568940493,9
0.2,689,95,46603,67.54057971014493,7
0.2,690,-48,46555,67.37337192474675,12
0.2,691,95,46650,67.41329479768787,8
0.2,692,92,46742,67.44877344877345,11
0.2,693,95,46837,67.48847262247838,7
0.2,694,18,46855,67.41726618705036,15
0.2,695,92,46947,67.45258620689656,10
0.2,696,94,47041,67.49067431850789,8
0.2,697,94,47135,67.52865329512893,8
0.2,698,22,47157,67.46351931330472,11
0.2,699,94,47251,67.50142857142858,10
0.2,700,87,47338,67.52924393723252,16
0.2,701,95,47433,67.56837606837607,7
0.2,702,93,47526,67.6045519203414,9
0.2,703,95,47621,67.6434659090909,7
0.2,704,90,47711,67.67517730496454,12
0.2,705,-48,47663,67.51133144475921,12
0.2,706,94,47757,67.54879773691655,8
0.2,707,23,47780,67.48587570621469,10
0.2,708,94,47874,67.52327221438647,9
0.2,709,92,47966,67.55774647887324,11
0.2,710,27,47993,67.50070323488045,6
0.2,711,94,48087,67.53792134831461,9
0.2,712,21,48108,67.4726507713885,12
0.2,713,92,48200,67.50700280112045,10
0.2,714,91,48291,67.53986013986014,13
0.2,715,19,48310,67.47206703910615,14
0.2,716,93,48403,67.50767085076708,9
0.2,717,86,48489,67.53342618384401,15
0.2,718,92,48581,67.56745479833101,10
0.2,719,18,48599,67.49861111111112,18
0.2,720,93,48692,67.53398058252426,9
0.2,721,22,48714,67.47091412742382,11
0.2,722,96,48810,67.5103734439834,6
0.2,723,92,48902,67.54419889502762,10
0.2,724,27,48929,67.48827586206896,6
0.2,725,96,49025,67.52754820936639,6
0.2,726,95,49120,67.56533700137551,7
0.2,727,-49,49071,67.40521978021978,15
0.2,728,89,49160,67.43484224965707,12
0.2,729,87,49247,67.46164383561644,15
0.2,730,26,49273,67.40492476060192,8
0.2,731,94,49367,67.44125683060109,8
0.2,732,93,49460,67.47612551159618,9
0.2,733,93,49553,67.5108991825613,9
0.2,734,88,49641,67.53877551020408,14
0.2,735,87,49728,67.56521739130434,17
0.2,736,91,49819,67.59701492537313,11
0.2,737,92,49911,67.630081300813,10
0.2,738,88,49999,67.65764546684709,15
0.2,739,26,50025,67.60135135135135,7
0.2,740,93,50118,67.63562753036437,9
0.2,741,23,50141,67.5754716981132,10
0.2,742,18,50159,67.50874831763123,15
0.2,743,90,50249,67.53897849462365,17
0.2,744,95,50344,67.5758389261745,7
0.2,745,94,50438,67.6112600536193,8
0.2,746,86,50524,67.63587684069611,17
0.2,747,22,50546,67.57486631016043,11
0.2,748,95,50641,67.61148197596796,7
0.2,749,94,50735,67.64666666666666,8
0.2,750,92,50827,67.67909454061251,9
0.2,751,94,50921,67.71409574468085,9
0.2,752,92,51013,67.74634794156707,10
0.2,753,25,51038,67.6896551724138,8
0.2,754,95,51133,67.72582781456954,7
0.2,755,96,51229,67.76322751322752,6
0.2,756,91,51320,67.79392338177014,11
0.2,757,94,51414,67.82849604221636,8
0.2,758,96,51510,67.86561264822134,6
0.2,759,22,51532,67.80526315789474,11
0.2,760,90,51622,67.83442838370566,13
0.2,761,94,51716,67.86876640419948,8
0.2,762,-46,51670,67.71952817824378,10
0.2,763,94,51764,67.75392670157068,10
0.2,764,94,51858,67.78823529411764,8
0.2,765,96,51954,67.82506527415144,6
0.2,766,27,51981,67.77183833116037,7
0.2,767,95,52076,67.80729166666667,7
0.2,768,91,52167,67.83745123537061,11
0.2,769,94,52261,67.87142857142857,7
0.2,770,94,52355,67.905317769131,8
0.2,771,26,52381,67.85103626943005,7
0.2,772,92,52473,67.88227684346701,10
0.2,773,93,52566,67.91472868217055,9
0.2,774,91,52657,67.94451612903225,11
0.2,775,-123,52534,67.69845360824742,18
0.2,776,91,52625,67.72844272844273,12
0.2,777,89,52714,67.75578406169666,14
0.2,778,23,52737,67.69833119383826,10
0.2,779,90,52827,67.72692307692307,12
0.2,780,22,52849,67.66837387964148,11
0.2,781,92,52941,67.6994884910486,10
0.2,782,24,52965,67.64367816091954,9
0.2,783,96,53061,67.67984693877551,6
0.2,784,95,53156,67.71464968152866,7
0.2,785,93,53249,67.7468193384224,8
0.2,786,23,53272,67.68996188055908,11
0.2,787,12,53284,67.61928934010152,22
0.2,788,91,53375,67.6489226869455,11
0.2,789,25,53400,67.59493670886076,8
0.2,790,94,53494,67.6283185840708,8
0.2,791,93,53587,67.66035353535354,9
0.2,792,90,53677,67.68852459016394,14
0.2,793,91,53768,67.71788413098237,11
0.2,794,90,53858,67.74591194968554,13
0.2,795,92,53950,67.77638190954774,12
0.2,796,-47,53903,67.6323713927227,11
0.2,797,96,53999,67.66791979949875,6
0.2,798,95,54094,67.70212765957447,7
0.2,799,93,54187,67.73375,10
0.2,800,94,54281,67.76654182272159,8
0.2,801,95,54376,67.80049875311721,8
0.2,802,91,54467,67.8293897882939,10
0.2,803,92,54559,67.8594527363184,10
0.2,804,88,54647,67.88447204968944,16
0.2,805,95,54742,67.91811414392059,7
0.2,806,20,54762,67.85873605947955,13
0.2,807,-57,54705,67.70420792079207,21
0.2,808,16,54721,67.64029666254635,17
0.2,809,93,54814,67.6716049382716,10
0.2,810,96,54910,67.70653514180025,6
0.2,811,94,55004,67.73891625615764,8
0.2,812,95,55099,67.77244772447725,6
0.2,813,95,55194,67.80589680589681,7
0.2,814,95,55289,67.83926380368098,7
0.2,815,93,55382,67.87009803921569,9
0.2,816,95,55477,67.90330477356181,8
0.2,817,94,55571,67.93520782396088,8
0.2,818,21,55592,67.87789987789988,12
0.2,819,92,55684,67.90731707317073,10
0.2,820,94,55778,67.93909866017053,9
0.2,821,96,55874,67.97323600973236,8
0.2,822,93,55967,68.00364520048603,9
0.2,823,96,56063,68.0376213592233,6
0.2,824,90,56153,68.06424242424242,11
0.2,825,94,56247,68.0956416464891,9
0.2,826,94,56341,68.12696493349456,8
0.2,827,90,56431,68.15338164251207,12
0.2,828,90,56521,68.17973462002412,13
0.2,829,92,56613,68.20843373493976,10
0.2,830,-52,56561,68.06377858002406,16
0.2,831,95,56656,68.09615384615384,7
0.2,832,23,56679,68.04201680672269,10
0.2,833,92,56771,68.07074340527578,10
0.2,834,94,56865,68.10179640718563,8
0.2,835,95,56960,68.13397129186603,7
0.2,836,93,57053,68.1636798088411,9
0.2,837,89,57142,68.18854415274463,13
0.2,838,94,57236,68.21930870083433,8
0.2,839,95,57331,68.25119047619047,7
0.2,840,89,57420,68.27586206896552,14
0.2,841,24,57444,68.22327790973871,9
0.2,842,93,57537,68.25266903914591,9
0.2,843,26,57563,68.20260663507109,7
0.2,844,91,57654,68.22958579881657,11
0.2,845,93,57747,68.25886524822695,9
0.2,846,20,57767,68.20188902007084,14
0.2,847,92,57859,68.22995283018868,10
0.2,848,11,57870,68.16254416961131,21
0.2,849,26,57896,68.11294117647058,7
0.2,850,94,57990,68.14336075205641,9
0.2,851,89,58079,68.16784037558685,13
0.2,852,93,58172,68.19695193434936,9
0.2,853,92,58264,68.22482435597189,11
0.2,854,92,58356,68.25263157894737,11
0.2,855,95,58451,68.2838785046729,7
0.2,856,90,58541,68.30921820303384,12
0.2,857,89,58630,68.33333333333333,13
0.2,858,91,58721,68.35972060535507,11
0.2,859,16,58737,68.29883720930232,17
0.2,860,17,58754,68.23925667828107,16
0.2,861,90,58844,68.2645011600928,14
0.2,862,88,58932,68.28736964078794,14
0.2,863,93,59025,68.31597222222223,8
0.2,864,20,59045,68.26011560693641,13
0.2,865,96,59141,68.29214780600462,6
0.2,866,95,59236,68.32295271049597,7
0.2,867,90,59326,68.34792626728111,13
0.2,868,95,59421,68.37859608745684,8
0.2,869,95,59516,68.40919540229885,8
0.2,870,95,59611,68.43972445464983,6
0.2,871,90,59701,68.46444954128441,12
0.2,872,25,59726,68.41466208476518,9
0.2,873,24,59750,68.36384439359267,9
0.2,874,94,59844,68.39314285714286,9
0.2,875,21,59865,68.33904109589041,12
0.2,876,95,59960,68.36944127708095,7
0.2,877,21,59981,68.31548974943053,12
0.2,878,25,60006,68.26621160409556,8
0.2,879,25,60031,68.21704545454546,9
0.2,880,95,60126,68.24744608399546,6
0.2,881,23,60149,68.19614512471655,10
0.2,882,93,60242,68.2242355605889,10
0.2,883,95,60337,68.25452488687783,7
0.2,884,95,60432,68.28474576271186,7
0.2,885,87,60519,68.3058690744921,17
0.2,886,90,60609,68.33032694475762,15
0.2,887,94,60703,68.35923423423424,8
0.2,888,96,60799,68.39032620922384,6
0.2,889,95,60894,68.42022471910113,7
0.2,890,-117,60777,68.21212121212122,12
0.2,891,93,60870,68.23991031390135,10
0.2,892,91,60961,68.26539753639418,11
0.2,893,22,60983,68.21364653243847,12
0.2,894,89,61072,68.23687150837989,13
0.2,895,95,61167,68.26674107142857,7
0.2,896,94,61261,68.29542920847268,8
0.2,897,95,61356,68.32516703786192,7
0.2,898,94,61450,68.35372636262514,8
0.2,899,27,61477,68.30777777777777,6
0.2,900,23,61500,68.25749167591565,10
0.2,901,94,61594,68.2860310421286,8
0.2,902,95,61689,68.3156146179402,7
0.2,903,26,61715,68.26880530973452,7
0.2,904,89,61804,68.29171270718233,15
0.2,905,94,61898,68.32008830022075,8
0.2,906,-61,61837,68.17750826901874,25
0.2,907,93,61930,68.20484581497797,10
0.2,908,23,61953,68.15511551155116,10
0.2,909,94,62047,68.18351648351648,8
0.2,910,89,62136,68.20636663007684,13
0.2,911,90,62226,68.23026315789474,12
0.2,912,89,62315,68.25301204819277,14
0.2,913,25,62340,68.20568927789934,8
0.2,914,95,62435,68.23497267759562,7
0.2,915,95,62530,68.26419213973799,7
0.2,916,95,62625,68.29334787350055,7
0.2,917,23,62648,68.24400871459694,10
0.2,918,-47,62601,68.11860718171926,11
0.2,919,96,62697,68.14891304347826,6
0.2,920,94,62791,68.17698154180239,8
0.2,921,94,62885,68.20498915401302,8
0.2,922,19,62904,68.15167930660888,14
0.2,923,95,62999,68.18073593073593,7
0.2,924,94,63093,68.20864864864865,9
0.2,925,94,63187,68.23650107991361,9
0.2,926,95,63282,68.26537216828478,6
0.2,927,94,63376,68.29310344827586,9
0.2,928,24,63400,68.2454251883746,9
0.2,929,93,63493,68.27204301075268,9
0.2,930,95,63588,68.30075187969925,7
0.2,931,94,63682,68.3283261802575,8
0.2,932,15,63697,68.27116827438371,19
0.2,933,94,63791,68.29871520342613,9
0.2,934,93,63884,68.32513368983957,9
0.2,935,93,63977,68.35149572649573,9
0.2,936,94,64071,68.37886872998932,8
0.2,937,93,64164,68.4051172707889,9
0.2,938,94,64258,68.43237486687966,9
0.2,939,20,64278,68.38085106382978,13
0.2,940,22,64300,68.33156216790648,11
0.2,941,88,64388,68.35244161358811,14
0.2,942,94,64482,68.3796394485684,9
0.2,943,95,64577,68.40783898305085,7
0.2,944,93,64670,68.43386243386243,9
0.2,945,94,64764,68.46088794926004,8
0.2,946,95,64859,68.48891235480464,7
0.2,947,-46,64813,68.36814345991561,11
0.2,948,94,64907,68.39515279241307,8
0.2,949,-55,64852,68.26526315789474,19
0.2,950,93,64945,68.29127234490011,9
0.2,951,85,65030,68.30882352941177,18
0.2,952,90,65120,68.33158447009444,13
0.2,953,27,65147,68.28825995807128,6
0.2,954,96,65243,68.317277486911,6
0.2,955,96,65339,68.34623430962343,6
0.2,956,23,65362,68.29885057471265,10
0.2,957,94,65456,68.32567849686848,7
0.2,958,94,65550,68.35245046923879,8
0.2,959,91,65641,68.37604166666667,11
0.2,960,93,65734,68.40166493236212,9
0.2,961,94,65828,68.42827442827443,7
0.2,962,83,65911,68.44340602284528,19
0.2,963,93,66004,68.4688796680498,11
0.2,964,91,66095,68.49222797927462,13
0.2,965,-120,65975,68.29710144927536,15
0.2,966,90,66065,68.3195449844881,13
0.2,967,92,66157,68.34400826446281,10
0.2,968,19,66176,68.29308565531475,14
0.2,969,94,66270,68.31958762886597,8
0.2,970,92,66362,68.34397528321318,11
0.2,971,92,66454,68.36831275720165,9
0.2,972,95,66549,68.39568345323741,7
0.2,973,95,66644,68.42299794661191,7
0.2,974,95,66739,68.45025641025642,8
0.2,975,96,66835,68.47848360655738,7
0.2,976,95,66930,68.50562947799386,7
0.2,977,93,67023,68.53067484662577,8
0.2,978,93,67116,68.55566905005107,9
0.2,979,92,67208,68.57959183673469,10
0.2,980,94,67302,68.60550458715596,8
0.2,981,95,67397,68.63238289205702,7
0.2,982,95,67492,68.65920651068159,7
0.2,983,25,67517,68.61483739837398,8
0.2,984,93,67610,68.63959390862944,8
0.2,985,91,67701,68.66227180527383,12
0.2,986,95,67796,68.68895643363729,7
0.2,987,23,67819,68.64271255060729,10
0.2,988,91,67910,68.66531850353893,12
0.2,989,94,68004,68.69090909090909,8
0.2,990,92,68096,68.71442986881938,10
0.2,991,16,68112,68.66129032258064,18
0.2,992,93,68205,68.68580060422961,9
0.2,993,86,68291,68.70321931589537,18
0.2,994,94,68385,68.7286432160804,8
0.2,995,95,68480,68.75502008032129,7
0.2,996,23,68503,68.70912738214643,10
0.2,997,94,68597,68.73446893787575,9
0.2,998,25,68622,68.69069069069069,8
0.2,999,94,68716,68.716,8
0.2,1000,20,68736,68.66733266733267,13
0.2,1001,16,68752,68.61477045908184,17
0.2,1002,94,68846,68.64007976071785,8
0.2,1003,86,68932,68.65737051792829,16
0.2,1004,22,68954,68.61094527363184,16
0.2,1005,94,69048,68.6361829025845,8
0.2,1006,89,69137,68.65640516385302,14
0.2,1007,95,69232,68.68253968253968,7
0.2,1008,91,69323,68.70465807730426,11
0.2,1009,95,69418,68.73069306930694,7
0.2,1010,-47,69371,68.6162215628091,11
0.2,1011,96,69467,68.64328063241106,6
0.2,1012,94,69561,68.66831194471865,7
0.2,1013,95,69656,68.69428007889546,7
0.2,1014,92,69748,68.71724137931035,10
0.2,1015,96,69844,68.74409448818898,6
0.2,1016,93,69937,68.76794493608652,9
0.2,1017,95,70032,68.79371316306484,7
0.2,1018,94,70126,68.81844946025515,9
0.2,1019,93,70219,68.8421568627451,9
0.2,1020,92,70311,68.86483839373163,10
0.2,1021,92,70403,68.88747553816047,10
0.2,1022,23,70426,68.84261974584555,10
0.2,1023,19,70445,68.7939453125,13
0.2,1024,89,70534,68.81365853658536,14
0.2,1025,-58,70476,68.69005847953217,24
0.2,1026,94,70570,68.71470301850049,8
0.2,1027,95,70665,68.74027237354086,7
0.2,1028,89,70754,68.75996112730806,13
0.2,1029,12,70766,68.70485436893203,21
0.2,1030,-53,70713,68.58680892337536,18
0.2,1031,18,70731,68.53779069767442,16
0.2,1032,25,70756,68.49564375605034,8
0.2,1033,20,70776,68.44874274661508,12
0.2,1034,94,70870,68.47342995169082,9
0.2,1035,89,70959,68.49324324324324,13
0.2,1036,95,71054,68.51880424300867,7
0.2,1037,96,71150,68.54527938342967,6
0.2,1038,24,71174,68.50240615976901,9
0.2,1039,95,71269,68.52788461538462,8
0.2,1040,25,71294,68.48607108549471,8
0.2,1041,95,71389,68.51151631477927,7
0.2,1042,23,71412,68.46788111217641,11
0.2,1043,89,71501,68.4875478927203,13
0.2,1044,93,71594,68.51100478468899,9
0.2,1045,95,71689,68.53632887189292,7
0.2,1046,26,71715,68.49570200573066,7
0.2,1047,91,71806,68.51717557251908,10
0.2,1048,93,71899,68.54051477597712,8
0.2,1049,95,71994,68.56571428571428,6
0.2,1050,96,72090,68.5918173168411,6
0.2,1051,26,72116,68.55133079847909,6
0.2,1052,-47,72069,68.44159544159544,11
0.2,1053,93,72162,68.46489563567363,9
0.2,1054,92,72254,68.4872037914692,11
0.2,1055,95,72349,68.51231060606061,6
0.2,1056,25,72374,68.47114474929045,9
0.2,1057,92,72466,68.49338374291115,11
0.2,1058,95,72561,68.51841359773371,7
0.2,1059,90,72651,68.53867924528302,12
0.2,1060,26,72677,68.4985862393968,7
0.2,1061,95,72772,68.52354048964219,7
0.2,1062,90,72862,68.54374412041392,11
0.2,1063,91,72953,68.56484962406014,10
0.2,1064,25,72978,68.52394366197183,8
0.2,1065,95,73073,68.54878048780488,7
0.2,1066,95,73168,68.57357075913777,7
0.2,1067,91,73259,68.59456928838951,10
0.2,1068,93,73352,68.61739943872779,8
0.2,1069,94,73446,68.6411214953271,8
0.2,1070,95,73541,68.6657329598506,6
0.2,1071,-121,73420,68.48880597014926,16
0.2,1072,-45,73375,68.38303821062442,10
0.2,1073,24,73399,68.3417132216015,10
0.2,1074,90,73489,68.36186046511628,13
0.2,1075,18,73507,68.31505576208178,16
0.2,1076,95,73602,68.33983286908078,7
0.2,1077,24,73626,68.2987012987013,9
0.2,1078,93,73719,68.32159406858202,9
0.2,1079,95,73814,68.3462962962963,7
0.2,1080,-188,73626,68.10915818686402,14
0.2,1081,93,73719,68.13216266173752,8
0.2,1082,93,73812,68.1551246537396,9
0.2,1083,-56,73756,68.04059040590406,20
0.2,1084,26,73782,68.00184331797234,7
0.2,1085,19,73801,67.95672191528546,15
0.2,1086,89,73890,67.97608095676173,12
0.2,1087,95,73985,68.00091911764706,6
0.2,1088,94,74079,68.02479338842976,8
0.2,1089,94,74173,68.04862385321101,7
0.2,1090,90,74263,68.06874427131072,11
0.2,1091,94,74357,68.09249084249085,7
0.2,1092,95,74452,68.1171088746569,6
0.2,1093,95,74547,68.14168190127971,7
0.2,1094,95,74642,68.1662100456621,7
0.2,1095,25,74667,68.12682481751825,8
0.2,1096,94,74761,68.15041020966272,8
0.2,1097,94,74855,68.17395264116576,9
0.2,1098,95,74950,68.19836214740673,7
0.2,1099,95,75045,68.22272727272727,6
0.2,1100,94,75139,68.24613987284287,8
0.2,1101,93,75232,68.26860254083485,10
0.2,1102,23,75255,68.22756119673618,9
0.2,1103,95,75350,68.2518115942029,7
0.2,1104,21,75371,68.20904977375565,11
0.2,1105,26,75397,68.17088607594937,7
0.2,1106,93,75490,68.193315266486,9
0.2,1107,93,75583,68.21570397111914,8
0.2,1108,21,75604,68.1731289449955,13
0.2,1109,95,75699,68.1972972972973,7
0.2,1110,92,75791,68.21872187218722,10
0.2,1111,95,75886,68.24280575539568,7
0.2,1112,96,75982,68.26774483378257,6
0.2,1113,92,76074,68.28904847396768,11
0.2,1114,96,76170,68.31390134529148,6
0.2,1115,94,76264,68.33691756272401,8
0.2,1116,22,76286,68.29543419874665,11
0.2,1117,93,76379,68.3175313059034,8
0.2,1118,93,76472,68.33958891867739,10
0.2,1119,92,76564,68.36071428571428,9
0.2,1120,95,76659,68.38447814451382,7
0.2,1121,91,76750,68.40463458110517,12
0.2,1122,-47,76703,68.30186999109529,10
0.2,1123,96,76799,68.32651245551601,6
0.2,1124,95,76894,68.35022222222223,7
0.2,1125,93,76987,68.3721136767318,9
0.2,1126,95,77082,68.39574090505768,7
0.2,1127,24,77106,68.3563829787234,9
0.2,1128,94,77200,68.3790965456156,8
0.2,1129,95,77295,68.40265486725664,6
0.2,1130,94,77389,68.42528735632185,8
0.2,1131,21,77410,68.38339222614842,11
0.2,1132,91,77501,68.40335392762577,12
0.2,1133,26,77527,68.36596119929453,7
0.2,1134,93,77620,68.38766519823788,9
0.2,1135,94,77714,68.41021126760563,8
0.2,1136,25,77739,68.37203166226912,8
0.2,1137,94,77833,68.3945518453427,7
0.2,1138,26,77859,68.35733099209833,7
0.2,1139,22,77881,68.31666666666666,11
0.2,1140,95,77976,68.34005258545136,7
0.2,1141,88,78064,68.35726795096322,13
0.2,1142,21,78085,68.31583552055993,12
0.2,1143,89,78174,68.33391608391608,13
0.2,1144,26,78200,68.29694323144105,7
0.2,1145,96,78296,68.32111692844677,6
0.2,1146,93,78389,68.34263295553617,8
0.2,1147,94,78483,68.36498257839722,8
0.2,1148,94,78577,68.38729329852045,7
0.2,1149,94,78671,68.4095652173913,9
0.2,1150,95,78766,68.43266724587315,7
0.2,1151,-47,78719,68.33246527777777,10
0.2,1152,15,78734,68.28620988725065,18
0.2,1153,96,78830,68.3102253032929,6
0.2,1154,96,78926,68.33419913419914,6
0.2,1155,24,78950,68.29584775086505,8
0.2,1156,92,79042,68.31633535004322,9
0.2,1157,95,79137,68.33937823834196,6
0.2,1158,93,79230,68.36065573770492,8
0.2,1159,94,79324,68.38275862068966,8
0.2,1160,95,79419,68.40568475452196,7
0.2,1161,95,79514,68.42857142857143,6
0.2,1162,93,79607,68.44969905417025,8
0.2,1163,87,79694,68.46563573883161,15
0.2,1164,20,79714,68.42403433476395,12
0.2,1165,94,79808,68.4459691252144,7
0.2,1166,92,79900,68.46615252784919,10
0.2,1167,11,79911,68.41695205479452,23
0.2,1168,93,80004,68.43798118049615,9
0.2,1169,95,80099,68.46068376068376,7
0.2,1170,90,80189,68.47907771135782,12
0.2,1171,94,80283,68.50085324232082,9
0.2,1172,93,80376,68.52173913043478,8
0.2,1173,-56,80320,68.41567291311755,21
0.2,1174,24,80344,68.37787234042553,8
0.2,1175,94,80438,68.39965986394557,9
0.2,1176,94,80532,68.4214103653356,7
0.2,1177,93,80625,68.44227504244482,8
0.2,1178,27,80652,68.40712468193384,6
0.2,1179,94,80746,68.42881355932204,8
0.2,1180,95,80841,68.45131244707875,9
0.2,1181,25,80866,68.414551607445,8
0.2,1182,93,80959,68.43533389687236,9
0.2,1183,89,81048,68.45270270270271,14
0.2,1184,95,81143,68.47510548523206,6
0.2,1185,95,81238,68.49747048903879,8
0.2,1186,94,81332,68.5189553496209,8
0.2,1187,95,81427,68.54124579124579,7
0.2,1188,94,81521,68.56265769554247,8
0.2,1189,25,81546,68.52605042016806,8
0.2,1190,94,81640,68.54743912678421,9
0.2,1191,94,81734,68.56879194630872,7
0.2,1192,24,81758,68.5314333612741,9
0.2,1193,22,81780,68.49246231155779,10
0.2,1194,87,81867,68.50794979079498,15
0.2,1195,95,81962,68.53010033444816,7
0.2,1196,23,81985,68.4920634920635,10
0.2,1197,95,82080,68.51419031719533,6
0.2,1198,95,82175,68.53628023352795,7
0.2,1199,18,82193,68.49416666666667,15
0.2,1200,93,82286,68.51457119067443,9
0.2,1201,95,82381,68.53660565723794,6
0.2,1202,91,82472,68.55527847049044,10
0.2,1203,95,82567,68.57724252491694,6
0.2,1204,23,82590,68.53941908713693,10
0.2,1205,89,82679,68.5563847429519,13
0.2,1206,93,82772,68.57663628831814,8
0.2,1207,94,82866,68.5976821192053,8
0.2,1208,92,82958,68.61703887510339,9
0.2,1209,91,83049,68.63553719008264,10
0.2,1210,93,83142,68.65565648224607,8
0.2,1211,91,83233,68.67409240924093,12
0.2,1212,95,83328,68.69579554822754,6
0.2,1213,93,83421,68.7158154859967,8
0.2,1214,93,83514,68.7358024691358,8
0.2,1215,96,83610,68.75822368421052,6
0.2,1216,21,83631,68.7189811010682,11
0.2,1217,24,83655,68.68226600985221,10
0.2,1218,96,83751,68.70467596390483,6
0.2,1219,89,83840,68.72131147540983,12
0.2,1220,93,83933,68.74119574119574,8
0.2,1221,93,84026,68.76104746317512,9
0.2,1222,23,84049,68.72363041700736,11
0.2,1223,94,84143,68.74428104575163,8
0.2,1224,-51,84092,68.6465306122449,16
0.2,1225,93,84185,68.66639477977162,8
0.2,1226,93,84278,68.68622656886716,9
0.2,1227,26,84304,68.6514657980456,7
0.2,1228,23,84327,68.61432058584215,10
0.2,1229,96,84423,68.63658536585366,6
0.2,1230,91,84514,68.65475223395613,10
0.2,1231,89,84603,68.67126623376623,13
0.2,1232,95,84698,68.6926196269262,9
0.2,1233,95,84793,68.71393841166937,8
0.2,1234,23,84816,68.67692307692307,10
0.2,1235,25,84841,68.6415857605178,8
0.2,1236,95,84936,68.66289409862571,7
0.2,1237,92,85028,68.68174474959612,10
0.2,1238,96,85124,68.70379338175948,6
0.2,1239,94,85218,68.72419354838709,8
0.2,1240,96,85314,68.74617244157938,6
0.2,1241,92,85406,68.76489533011272,9
0.2,1242,92,85498,68.7835880933226,9
0.2,1243,93,85591,68.80305466237942,9
0.2,1244,92,85683,68.82168674698795,9
0.2,1245,18,85701,68.78089887640449,17
0.2,1246,95,85796,68.80192461908581,6
0.2,1247,93,85889,68.8213141025641,10
0.2,1248,20,85909,68.7822257806245,13
0.2,1249,95,86004,68.8032,7
0.2,1250,96,86100,68.82494004796163,7
0.2,1251,93,86193,68.84424920127796,8
0.2,1252,92,86285,68.86272944932163,12
0.2,1253,18,86303,68.82216905901116,19
0.2,1254,95,86398,68.84302788844622,7
0.2,1255,96,86494,68.86464968152866,6
0.2,1256,92,86586,68.88305489260144,9
0.2,1257,-49,86537,68.7893481717011,14
0.2,1258,94,86631,68.80937251787132,7
0.2,1259,25,86656,68.77460317460317,7
0.2,1260,26,86682,68.74068199841396,7
0.2,1261,94,86776,68.76069730586372,7
0.2,1262,95,86871,68.78147268408551,6
0.2,1263,96,86967,68.80300632911393,6
0.2,1264,93,87060,68.82213438735178,9
0.2,1265,93,87153,68.84123222748815,8
0.2,1266,93,87246,68.8602999210734,10
0.2,1267,90,87336,68.8769716088328,13
0.2,1268,96,87432,68.89834515366431,6
0.2,1269,93,87525,68.91732283464567,12
0.2,1270,96,87621,68.93863099921322,6
0.2,1271,95,87716,68.95911949685535,7
0.2,1272,92,87808,68.9772191673213,9
0.2,1273,78,87886,68.98430141287284,24
0.2,1274,95,87981,69.00470588235294,6
0.2,1275,23,88004,68.96865203761756,10
0.2,1276,94,88098,68.98825371965545,7
0.2,1277,93,88191,69.00704225352112,9
0.2,1278,94,88285,69.02658326817827,10
0.2,1279,95,88380,69.046875,6
0.2,1280,-121,88259,68.89851678376269,18
0.2,1281,93,88352,68.91731669266771,8
0.2,1282,94,88446,68.93686671862821,8
0.2,1283,92,88538,68.95482866043614,12
0.2,1284,95,88633,68.97509727626459,7
0.2,1285,24,88657,68.94012441679627,9
0.2,1286,96,88753,68.96114996114996,6
0.2,1287,92,88845,68.97903726708074,9
0.2,1288,94,88939,68.99844840961985,7
0.2,1289,88,89027,69.01317829457365,13
0.2,1290,93,89120,69.03175832687839,8
0.2,1291,16,89136,68.9907120743034,17
0.2,1292,93,89229,69.0092807424594,9
0.2,1293,95,89324,69.02936630602782,7
0.2,1294,90,89414,69.04555984555985,11
0.2,1295,93,89507,69.06404320987654,9
0.2,1296,89,89596,69.07941403238242,12
0.2,1297,91,89687,69.09630200308166,11
0.2,1298,89,89776,69.11162432640492,12
0.2,1299,94,89870,69.13076923076923,8
0.2,1300,93,89963,69.14911606456572,9
0.2,1301,94,90057,69.16820276497695,8
0.2,1302,86,90143,69.18112049117421,15
0.2,1303,90,90233,69.19708588957056,12
0.2,1304,93,90326,69.21532567049809,9
0.2,1305,22,90348,69.1791730474732,10
0.2,1306,95,90443,69.19892884468248,7
0.2,1307,89,90532,69.21406727828746,13
0.2,1308,89,90621,69.22918258212376,12
0.2,1309,92,90713,69.24656488549618,9
0.2,1310,95,90808,69.26620900076277,6
0.2,1311,87,90895,69.2797256097561,15
0.2,1312,95,90990,69.2993145468393,7
0.2,1313,96,91086,69.31963470319634,6
0.2,1314,94,91180,69.33840304182509,8
0.2,1315,23,91203,69.30319148936171,10
0.2,1316,93,91296,69.32118451025057,8
0.2,1317,96,91392,69.34142640364188,6
0.2,1318,93,91485,69.35936315390447,8
0.2,1319,95,91580,69.37878787878788,7
0.2,1320,92,91672,69.39591218773656,10
0.2,1321,91,91763,69.41225416036309,11
0.2,1322,24,91787,69.37792894935752,9
0.2,1323,27,91814,69.34592145015105,6
0.2,1324,95,91909,69.36528301886793,6
0.2,1325,88,91997,69.37933634992459,13
0.2,1326,93,92090,69.39713639788998,8
0.2,1327,23,92113,69.36219879518072,10
0.2,1328,17,92130,69.32279909706546,15
0.2,1329,93,92223,69.3406015037594,8
0.2,1330,89,92312,69.35537190082644,12
0.2,1331,93,92405,69.37312312312312,8
0.2,1332,94,92499,69.39159789947487,8
0.2,1333,93,92592,69.40929535232384,12
0.2,1334,90,92682,69.4247191011236,12
0.2,1335,94,92776,69.44311377245509,7
0.2,1336,24,92800,69.4091249065071,9
0.2,1337,95,92895,69.42825112107623,7
0.2,1338,23,92918,69.39357729648992,11
0.2,1339,88,93006,69.40746268656716,14
0.2,1340,95,93101,69.42654735272185,7
0.2,1341,94,93195,69.44485842026826,9
0.2,1342,95,93290,69.46388682055101,6
0.2,1343,91,93381,69.47991071428571,10
0.2,1344,95,93476,69.49888475836431,8
0.2,1345,22,93498,69.46359583952452,11
0.2,1346,96,93594,69.48329621380846,7
0.2,1347,90,93684,69.49851632047478,11
0.2,1348,26,93710,69.46627131208302,7
0.2,1349,96,93806,69.48592592592593,6
0.2,1350,94,93900,69.5040710584752,7
0.2,1351,95,93995,69.52292899408285,7
0.2,1352,93,94088,69.54028085735403,9
0.2,1353,94,94182,69.55834564254062,8
0.2,1354,95,94277,69.57712177121772,6
0.2,1355,95,94372,69.59587020648968,6
0.2,1356,92,94464,69.61238025055269,10
0.2,1357,90,94554,69.62739322533137,11
0.2,1358,91,94645,69.6431199411332,13
0.2,1359,93,94738,69.66029411764706,10
0.2,1360,93,94831,69.67744305657605,9
0.2,1361,94,94925,69.69530102790014,8
0.2,1362,89,95014,69.70946441672781,13
0.2,1363,95,95109,69.72800586510265,8
0.2,1364,94,95203,69.74578754578755,7
0.2,1365,95,95298,69.76427525622255,7
0.2,1366,91,95389,69.7798098024872,12
0.2,1367,92,95481,69.79605263157895,10
0.2,1368,27,95508,69.76479181884588,6
0.2,1369,94,95602,69.78248175182482,10
0.2,1370,91,95693,69.79795769511306,11
0.2,1371,89,95782,69.81195335276968,13
0.2,1372,93,95875,69.82884195193007,9
0.2,1373,95,95970,69.8471615720524,7
0.2,1374,95,96065,69.86545454545454,6
0.2,1375,93,96158,69.88226744186046,9
0.2,1376,-50,96108,69.79520697167756,15
0.2,1377,14,96122,69.75471698113208,20
0.2,1378,93,96215,69.77157360406092,8
0.2,1379,93,96308,69.78840579710145,9
0.2,1380,95,96403,69.80666183924693,7
0.2,1381,95,96498,69.82489146164978,7
0.2,1382,93,96591,69.84164859002169,9
0.2,1383,90,96681,69.85621387283237,12
0.2,1384,95,96776,69.87436823104693,7
0.2,1385,26,96802,69.84271284271284,7
0.2,1386,93,96895,69.85940879596251,9
0.2,1387,94,96989,69.87680115273776,8
0.2,1388,27,97016,69.84593232541397,6
0.2,1389,95,97111,69.86402877697842,7
0.2,1390,93,97204,69.88066139468009,9
0.2,1391,-46,97158,69.79741379310344,11
0.2,1392,27,97185,69.76669059583632,7
0.2,1393,92,97277,69.78263988522238,9
0.2,1394,96,97373,69.80143369175627,6
0.2,1395,96,97469,69.8202005730659,6
0.2,1396,92,97561,69.83607730851826,9
0.2,1397,91,97652,69.85121602288984,10
0.2,1398,90,97742,69.86561829878485,12
0.2,1399,92,97834,69.88142857142857,10
0.2,1400,22,97856,69.84725196288366,11
0.2,1401,25,97881,69.81526390870185,10
0.2,1402,94,97975,69.83250178189594,9
0.2,1403,93,98068,69.84900284900284,11
0.2,1404,95,98163,69.86690391459075,7
0.2,1405,91,98254,69.88193456614509,11
0.2,1406,93,98347,69.89836531627576,9
0.2,1407,92,98439,69.9140625,10
0.2,1408,95,98534,69.93186657203691,6
0.2,1409,96,98630,69.95035460992908,6
0.2,1410,93,98723,69.96669029057406,8
0.2,1411,93,98816,69.98300283286119,8
0.2,1412,94,98910,70.0,8
0.2,1413,91,99001,70.01485148514851,10
0.2,1414,95,99096,70.03250883392226,6
0.2,1415,94,99190,70.04943502824858,7
0.2,1416,18,99208,70.01270289343684,15
0.2,1417,95,99303,70.03032440056417,8
0.2,1418,91,99394,70.04510218463707,11
0.2,1419,94,99488,70.06197183098591,7
0.2,1420,88,99576,70.07459535538354,13
0.2,1421,94,99670,70.0914205344585,7
0.2,1422,91,99761,70.10611384399157,11
0.2,1423,88,99849,70.1186797752809,14
0.2,1424,92,99941,70.1340350877193,10
0.2,1425,24,99965,70.10168302945301,9
0.2,1426,92,100057,70.11702873160476,10
0.2,1427,17,100074,70.0798319327731,16
0.2,1428,96,100170,70.09797060881735,6
0.2,1429,93,100263,70.11398601398601,8
0.2,1430,94,100357,70.13067784765897,8
0.2,1431,93,100450,70.14664804469274,9
0.2,1432,-130,100320,70.0069783670621,26
0.2,1433,93,100413,70.02301255230125,8
0.2,1434,27,100440,69.99303135888502,6
0.2,1435,95,100535,70.01044568245125,7
0.2,1436,95,100630,70.02783576896312,6
0.2,1437,93,100723,70.04381084840055,9
0.2,1438,-47,100676,69.96247394023628,11
0.2,1439,92,100768,69.97777777777777,9
0.2,1440,93,100861,69.99375433726578,11
0.2,1441,23,100884,69.96116504854369,9
0.2,1442,21,100905,69.92723492723492,13
0.2,1443,96,101001,69.94529085872576,6
0.2,1444,17,101018,69.90865051903114,16
0.2,1445,96,101114,69.92669432918396,7
0.2,1446,93,101207,69.94263994471319,9
0.2,1447,-52,101155,69.85842541436465,16
0.2,1448,94,101249,69.87508626639061,9
0.2,1449,20,101269,69.84068965517241,12
0.2,1450,95,101364,69.85802894555479,6
0.2,1451,95,101459,69.87534435261708,7
0.2,1452,96,101555,69.89332415691672,6
0.2,1453,94,101649,69.9099037138927,8
0.2,1454,93,101742,69.92577319587629,8
0.2,1455,95,101837,69.94299450549451,7
0.2,1456,87,101924,69.95470144131778,16
0.2,1457,96,102020,69.97256515775034,6
0.2,1458,96,102116,69.99040438656614,6
0.2,1459,87,102203,70.00205479452055,15
0.2,1460,93,102296,70.01779603011636,10
0.2,1461,90,102386,70.03146374829001,12
0.2,1462,92,102478,70.04647983595352,9
0.2,1463,92,102570,70.06147540983606,10
0.2,1464,91,102661,70.07576791808874,11
0.2,1465,95,102756,70.09276944065485,6
0.2,1466,91,102847,70.10702113156101,11
0.2,1467,95,102942,70.12397820163488,7
0.2,1468,94,103036,70.14023144996597,8
0.2,1469,92,103128,70.15510204081633,11
0.2,1470,93,103221,70.17063222297756,11
0.2,1471,23,103244,70.13858695652173,9
0.2,1472,95,103339,70.15546503733876,6
0.2,1473,94,103433,70.17164179104478,7
0.2,1474,94,103527,70.18779661016949,7
0.2,1475,92,103619,70.20257452574526,10
0.2,1476,27,103646,70.17332430602573,6
0.2,1477,95,103741,70.19012178619757,7
0.2,1478,94,103835,70.20622041920217,7
0.2,1479,91,103926,70.22027027027028,12
0.2,1480,95,104021,70.23700202565834,6
0.2,1481,93,104114,70.2523616734143,9
0.2,1482,94,104208,70.26837491571139,8
0.2,1483,93,104301,70.28369272237197,9
0.2,1484,93,104394,70.2989898989899,10
0.2,1485,94,104488,70.3149394347241,8
0.2,1486,93,104581,70.33019502353733,8
0.2,1487,25,104606,70.2997311827957,8
0.2,1488,24,104630,70.2686366689053,11
0.2,1489,19,104649,70.23422818791947,14
0.2,1490,94,104743,70.25016767270289,7
0.2,1491,91,104834,70.26407506702412,11
0.2,1492,25,104859,70.2337575351641,8
0.2,1493,88,104947,70.24564926372155,15
0.2,1494,95,105042,70.26220735785954,7
0.2,1495,90,105132,70.27540106951872,13
0.2,1496,96,105228,70.29258517034069,6
0.2,1497,94,105322,70.30841121495327,8
0.2,1498,95,105417,70.32488325550366,7
0.2,1499,21,105438,70.292,13
0.2,1500,24,105462,70.26115922718188,9
0.2,1501,25,105487,70.23102529960053,8
0.2,1502,25,105512,70.20093147039255,8
0.2,1503,95,105607,70.21742021276596,8
0.2,1504,92,105699,70.23189368770764,10
0.2,1505,95,105794,70.24833997343957,7
0.2,1506,93,105887,70.26343729263438,10
0.2,1507,94,105981,70.2791777188329,9
0.2,1508,96,106077,70.2962226640159,6
0.2,1509,95,106172,70.31258278145695,7
0.2,1510,94,106266,70.3282594308405,7
0.2,1511,95,106361,70.34457671957672,6
0.2,1512,94,106455,70.36021150033046,7
0.2,1513,94,106549,70.37582562747689,8
0.2,1514,24,106573,70.34521452145215,9
0.2,1515,90,106663,70.35817941952507,12
0.2,1516,95,106758,70.37442320369149,7
0.2,1517,8,106766,70.33333333333333,24
0.2,1518,94,106860,70.34891375905201,8
0.2,1519,94,106954,70.36447368421052,8
0.2,1520,26,106980,70.33530571992111,7
0.2,1521,96,107076,70.35216819973719,6
0.2,1522,96,107172,70.36900853578463,7
0.2,1523,96,107268,70.38582677165354,6
0.2,1524,95,107363,70.40196721311476,7
0.2,1525,92,107455,70.41612057667103,9
0.2,1526,19,107474,70.38244924688932,14
0.2,1527,94,107568,70.3979057591623,8
0.2,1528,23,107591,70.36690647482014,10
0.2,1529,89,107680,70.37908496732027,13
0.2,1530,95,107775,70.39516655780535,7
0.2,1531,88,107863,70.40665796344648,14
0.2,1532,94,107957,70.42204827136334,8
0.2,1533,92,108049,70.4361147327249,10
0.2,1534,86,108135,70.44625407166124,17
0.2,1535,94,108229,70.46158854166667,8
0.2,1536,93,108322,70.47625243981783,9
0.2,1537,89,108411,70.48829648894669,13
0.2,1538,93,108504,70.50292397660819,9
0.2,1539,94,108598,70.51818181818182,9
0.2,1540,-51,108547,70.43932511356262,14
0.2,1541,94,108641,70.45460440985732,8
0.2,1542,91,108732,70.46791963707064,10
0.2,1543,-49,108683,70.39054404145078,13
0.2,1544,96,108779,70.40711974110032,6
0.2,1545,94,108873,70.42238033635188,8
0.2,1546,93,108966,70.43697478991596,8
0.2,1547,95,109061,70.45284237726098,7
0.2,1548,91,109152,70.4661071659135,11
0.2,1549,88,109240,70.47741935483872,16
0.2,1550,22,109262,70.4461637653127,12
0.2,1551,-44,109218,70.37242268041237,8
0.2,1552,89,109307,70.38441725692209,13
0.2,1553,96,109403,70.40090090090091,6
0.2,1554,22,109425,70.36977491961414,13
0.2,1555,18,109443,70.33611825192801,15
0.2,1556,95,109538,70.3519588953115,7
0.2,1557,93,109631,70.36649550706034,8
0.2,1558,17,109648,70.33226427196921,16
0.2,1559,95,109743,70.34807692307692,6
0.2,1560,91,109834,70.36130685458039,12
0.2,1561,95,109929,70.37708066581305,6
0.2,1562,26,109955,70.3486884197057,6
0.2,1563,95,110050,70.36445012787723,7
0.2,1564,95,110145,70.38019169329074,6
0.2,1565,95,110240,70.39591315453384,7
0.2,1566,92,110332,70.4097000638162,10
0.2,1567,95,110427,70.42538265306122,7
0.2,1568,95,110522,70.44104525175271,6
0.2,1569,23,110545,70.41082802547771,10
0.2,1570,91,110636,70.4239338001273,11
0.2,1571,95,110731,70.43956743002545,7
0.2,1572,90,110821,70.45200254291163,12
0.2,1573,19,110840,70.41931385006353,14
0.2,1574,93,110933,70.4336507936508,9
0.2,1575,95,111028,70.44923857868021,6
0.2,1576,26,111054,70.42105263157895,7
0.2,1577,93,111147,70.43536121673004,8
0.2,1578,95,111242,70.45091830272324,7
0.2,1579,91,111333,70.46392405063291,11
0.2,1580,27,111360,70.43643263757116,6
0.2,1581,96,111456,70.45259165613147,6
0.2,1582,96,111552,70.4687302590019,6
0.2,1583,94,111646,70.48358585858585,10
0.2,1584,90,111736,70.49589905362777,12
0.2,1585,94,111830,70.51071878940732,8
0.2,1586,89,111919,70.52236925015752,13
0.2,1587,17,111936,70.48866498740554,16
0.2,1588,96,112032,70.50471994965388,6
0.2,1589,22,112054,70.47421383647799,11
0.2,1590,23,112077,70.4443746071653,10
0.2,1591,95,112172,70.45979899497488,7
0.2,1592,85,112257,70.46892655367232,17
0.2,1593,90,112347,70.48117942283564,11
0.2,1594,91,112438,70.49404388714734,13
0.2,1595,22,112460,70.46365914786968,10
0.2,1596,93,112553,70.47777082028804,12
0.2,1597,94,112647,70.49249061326658,8
0.2,1598,94,112741,70.50719199499687,8
0.2,1599,94,112835,70.521875,8
0.2,1600,95,112930,70.53716427232979,7
0.2,1601,91,113021,70.54993757802747,11
0.2,1602,23,113044,70.52027448533998,10
0.2,1603,95,113139,70.535536159601,7
0.2,1604,94,113233,70.55015576323987,8
0.2,1605,93,113326,70.56413449564134,9
0.2,1606,95,113421,70.57934038581207,6
0.2,1607,19,113440,70.54726368159204,14
0.2,1608,95,113535,70.56246115599751,6
0.2,1609,92,113627,70.57577639751553,11
0.2,1610,94,113721,70.59031657355679,8
0.2,1611,95,113816,70.60545905707195,6
0.2,1612,95,113911,70.6205827650341,7
0.2,1613,94,114005,70.63506815365551,8
0.2,1614,25,114030,70.60681114551083,8
0.2,1615,94,114124,70.62128712871286,8
0.2,1616,87,114211,70.63141620284478,14
0.2,1617,95,114306,70.64647713226205,6
0.2,1618,88,114394,70.65719579987646,13
0.2,1619,93,114487,70.67098765432098,8
0.2,1620,94,114581,70.68537939543492,7
0.2,1621,92,114673,70.69852034525277,11
0.2,1622,26,114699,70.67097966728281,8
0.2,1623,95,114794,70.68596059113301,7
0.2,1624,25,114819,70.65784615384615,9
0.2,1625,93,114912,70.67158671586716,8
0.2,1626,95,115007,70.68653964351567,7
0.2,1627,95,115102,70.7014742014742,6
0.2,1628,19,115121,70.66973603437692,15
0.2,1629,94,115215,70.6840490797546,8
0.2,1630,-48,115167,70.61128142244021,11
0.2,1631,92,115259,70.62438725490196,9
0.2,1632,90,115349,70.63625229638701,11
0.2,1633,94,115443,70.65055079559363,7
0.2,1634,25,115468,70.62262996941897,8
0.2,1635,94,115562,70.63691931540342,7
0.2,1636,-47,115515,70.56505803298717,13
0.2,1637,94,115609,70.57936507936508,8
0.2,1638,94,115703,70.59365466748017,8
0.2,1639,95,115798,70.60853658536585,6
0.2,1640,95,115893,70.62340036563072,6
0.2,1641,95,115988,70.63824604141291,7
0.2,1642,96,116084,70.65368228849665,6
0.2,1643,89,116173,70.66484184914842,13
0.2,1644,92,116265,70.67781155015197,9
0.2,1645,91,116356,70.69015795868773,12
0.2,1646,92,116448,70.70309653916212,10
0.2,1647,91,116539,70.71541262135922,10
0.2,1648,93,116632,70.72892662219527,9
0.2,1649,95,116727,70.74363636363637,6
0.2,1650,93,116820,70.75711689884918,9
0.2,1651,94,116914,70.77118644067797,8
0.2,1652,89,117003,70.78221415607986,12
0.2,1653,92,117095,70.7950423216445,10
0.2,1654,96,117191,70.81027190332327,6
0.2,1655,94,117285,70.82427536231884,8
0.2,1656,25,117310,70.7966203983102,8
0.2,1657,92,117402,70.80940892641738,11
0.2,1658,82,117484,70.8161543098252,19
0.2,1659,15,117499,70.78253012048192,18
0.2,1660,23,117522,70.7537627934979,10
0.2,1661,93,117615,70.76714801444044,9
0.2,1662,92,117707,70.77991581479255,10
0.2,1663,95,117802,70.79447115384616,7
0.2,1664,96,117898,70.80960960960961,6
0.2,1665,92,117990,70.82232893157263,11
0.2,1666,-48,117942,70.75104979004199,12
0.2,1667,92,118034,70.76378896882494,12
0.2,1668,95,118129,70.77831036548832,7
0.2,1669,93,118222,70.79161676646707,9
0.2,1670,96,118318,70.8067025733094,6
0.2,1671,93,118411,70.81997607655502,9
0.2,1672,95,118506,70.8344291691572,6
0.2,1673,94,118600,70.84826762246117,7
0.2,1674,95,118695,70.86268656716418,6
0.2,1675,95,118790,70.87708830548927,6
0.2,1676,95,118885,70.89147286821705,6
0.2,1677,94,118979,70.9052443384982,7
0.2,1678,88,119067,70.91542584871948,15
0.2,1679,90,119157,70.92678571428571,12
0.2,1680,16,119173,70.89411064842356,17
0.2,1681,27,119200,70.8680142687277,6
0.2,1682,96,119296,70.88294711824123,6
0.2,1683,24,119320,70.85510688836105,9
0.2,1684,94,119414,70.86884272997032,7
0.2,1685,94,119508,70.88256227758008,7
0.2,1686,-56,119452,70.80735032602253,19
0.2,1687,26,119478,70.7808056872038,7
0.2,1688,93,119571,70.79396092362344,10
0.2,1689,96,119667,70.80887573964498,6
0.2,1690,95,119762,70.82318154937907,8
0.2,1691,92,119854,70.83569739952719,11
0.2,1692,24,119878,70.80803307737743,8
0.2,1693,24,119902,70.78040141676506,9
0.2,1694,94,119996,70.79410029498526,8
0.2,1695,89,120085,70.80483490566037,14
0.2,1696,93,120178,70.81791396582204,8
0.2,1697,90,120268,70.82921083627798,13
0.2,1698,95,120363,70.84343731606828,8
0.2,1699,95,120458,70.85764705882353,6
0.2,1700,93,120551,70.87066431510875,8
0.2,1701,96,120647,70.88542890716803,6
0.2,1702,93,120740,70.8984145625367,10
0.2,1703,92,120832,70.91079812206573,9
0.2,1704,95,120927,70.924926686217,7
0.2,1705,23,120950,70.8968347010551,10
0.2,1706,95,121045,70.91095489162274,6
0.2,1707,16,121061,70.8788056206089,17
0.2,1708,96,121157,70.89350497366881,6
0.2,1709,90,121247,70.9046783625731,14
0.2,1710,93,121340,70.91759205143191,9
0.2,1711,92,121432,70.92990654205607,11
0.2,1712,93,121525,70.94279042615295,9
0.2,1713,94,121619,70.95624270711785,9
0.2,1714,95,121714,70.97026239067056,7
0.2,1715,94,121808,70.98368298368298,8
0.2,1716,93,121901,70.99650553290623,9
0.2,1717,95,121996,71.0104772991851,6
0.2,1718,95,122091,71.02443280977312,8
0.2,1719,95,122186,71.03837209302326,7
0.2,1720,18,122204,71.00755374782104,14
0.2,1721,93,122297,71.02032520325203,9
0.2,1722,27,122324,70.99477655252467,6
0.2,1723,95,122419,71.00870069605568,6
0.2,1724,95,122514,71.02260869565217,7
0.2,1725,87,122601,71.03186558516802,14
0.2,1726,23,122624,71.00405327156919,11
0.2,1727,23,122647,70.97627314814815,10
0.2,1728,89,122736,70.9866975130133,12
0.2,1729,26,122762,70.96069364161849,7
0.2,1730,95,122857,70.97458116695552,7
0.2,1731,95,122952,70.98845265588915,7
0.2,1732,95,123047,71.00230813618003,7
0.2,1733,26,123073,70.97635524798154,7
0.2,1734,94,123167,70.98962536023055,8
0.2,1735,94,123261,71.0028801843318,8
0.2,1736,95,123356,71.01669545192861,7
0.2,1737,92,123448,71.02876869965478,12
0.2,1738,92,123540,71.04082806210465,9
0.2,1739,96,123636,71.0551724137931,6
0.2,1740,92,123728,71.06720275703618,11
0.2,1741,-129,123599,70.95235361653272,24
0.2,1742,-55,123544,70.88009179575445,19
0.2,1743,94,123638,70.89334862385321,7
0.2,1744,93,123731,70.90601719197707,9
0.2,1745,27,123758,70.88087056128293,6
0.2,1746,91,123849,70.89238694905552,11
0.2,1747,95,123944,70.90617848970251,6
0.2,1748,20,123964,70.87707261292167,14
0.2,1749,95,124059,70.89085714285714,7
0.2,1750,22,124081,70.86293546544832,10
0.2,1751,96,124177,70.87728310502283,6
0.2,1752,93,124270,70.88990302338847,8
0.2,1753,22,124292,70.86202964652223,12
0.2,1754,95,124387,70.87578347578348,6
0.2,1755,94,124481,70.88895216400911,7
0.2,1756,91,124572,70.9003984063745,10
0.2,1757,96,124668,70.91467576791808,6
0.2,1758,23,124691,70.88743604320636,10
0.2,1759,93,124784,70.9,9
0.2,1760,95,124879,70.91368540601931,7
0.2,1761,95,124974,70.92735527809307,7
0.2,1762,91,125065,70.93874078275667,10
0.2,1763,93,125158,70.95124716553288,8
0.2,1764,95,125253,70.96487252124646,6
0.2,1765,96,125349,70.97904869762175,7
0.2,1766,91,125440,70.9903791737408,12
0.2,1767,92,125532,71.00226244343891,10
0.2,1768,95,125627,71.01582815149803,6
0.2,1769,93,125720,71.02824858757062,9
0.2,1770,93,125813,71.04065499717673,8
0.2,1771,27,125840,71.0158013544018,6
0.2,1772,26,125866,70.99041173152848,7
0.2,1773,94,125960,71.0033821871477,8
0.2,1774,92,126052,71.01521126760564,10
0.2,1775,93,126145,71.02759009009009,8
0.2,1776,92,126237,71.03939223410242,9
0.2,1777,96,126333,71.05343082114736,6
0.2,1778,95,126428,71.06689151208545,7
0.2,1779,88,126516,71.07640449438202,13
0.2,1780,95,126611,71.08983717012914,6
0.2,1781,91,126702,71.1010101010101,11
0.2,1782,20,126722,71.07234997195738,12
0.2,1783,96,126818,71.08632286995515,6
0.2,1784,18,126836,71.05658263305322,14
0.2,1785,95,126931,71.06998880179171,7
0.2,1786,-46,126885,71.00447677672076,10
0.2,1787,-50,126835,70.93680089485458,14
0.2,1788,92,126927,70.94857462269424,12
0.2,1789,95,127022,70.96201117318435,8
0.2,1790,95,127117,70.97543271915131,7
0.2,1791,92,127209,70.98716517857143,10
0.2,1792,89,127298,70.99721137757948,13
0.2,1793,94,127392,71.01003344481606,7
0.2,1794,96,127488,71.02395543175487,6
0.2,1795,93,127581,71.03619153674833,9
0.2,1796,20,127601,71.00779076238175,12
0.2,1797,23,127624,70.98109010011123,10
0.2,1798,95,127719,70.99444135630905,6
0.2,1799,94,127813,71.00722222222223,8
0.2,1800,80,127893,71.01221543586897,23
0.2,1801,93,127986,71.02441731409544,8
0.2,1802,93,128079,71.03660565723794,8
0.2,1803,88,128167,71.0460088691796,14
0.2,1804,94,128261,71.05872576177285,7
0.2,1805,91,128352,71.06976744186046,11
0.2,1806,90,128442,71.08024349750968,11
0.2,1807,96,128538,71.09402654867256,6
0.2,1808,24,128562,71.06799336650083,8
0.2,1809,92,128654,71.07955801104973,11
0.2,1810,93,128747,71.09166206515737,9
0.2,1811,96,128843,71.10540838852097,6
0.2,1812,96,128939,71.11913954771097,7
0.2,1813,96,129035,71.13285556780595,6
0.2,1814,89,129124,71.14269972451791,15
0.2,1815,95,129219,71.15583700440529,9
0.2,1816,20,129239,71.12768299394607,13
0.2,1817,93,129332,71.13971397139714,9
0.2,1818,94,129426,71.152281473337,7
0.2,1819,95,129521,71.16538461538461,6
0.2,1820,88,129609,71.17462932454696,15
0.2,1821,93,129702,71.18660812294182,9
0.2,1822,94,129796,71.19912232583653,8
0.2,1823,95,129891,71.21217105263158,6
0.2,1824,92,129983,71.22356164383562,10
0.2,1825,95,130078,71.23658269441403,6
0.2,1826,22,130100,71.2096332785988,11
0.2,1827,96,130196,71.22319474835886,6
0.2,1828,95,130291,71.23619464188081,7
0.2,1829,25,130316,71.21092896174864,8
0.2,1830,93,130409,71.22282905516111,9
0.2,1831,93,130502,71.23471615720524,11
0.2,1832,22,130524,71.20785597381342,12
0.2,1833,94,130618,71.22028353326063,8
0.2,1834,82,130700,71.22615803814713,19
0.2,1835,92,130792,71.23747276688454,9
0.2,1836,95,130887,71.25040827436037,7
0.2,1837,95,130982,71.2633297062024,6
0.2,1838,23,131005,71.23708537248504,11
0.2,1839,89,131094,71.24673913043478,12
0.2,1840,95,131189,71.25964149918522,6
0.2,1841,95,131284,71.27252985884908,6
0.2,1842,92,131376,71.28377645143787,9
0.2,1843,93,131469,71.29555314533623,9
0.2,1844,93,131562,71.30731707317074,9
0.2,1845,95,131657,71.3201516793066,7
0.2,1846,95,131752,71.33297238765566,6
0.2,1847,95,131847,71.34577922077922,7
0.2,1848,91,131938,71.35640886965928,12
0.2,1849,90,132028,71.36648648648648,11
0.2,1850,94,132122,71.37871420853592,9
0.2,1851,94,132216,71.39092872570194,8
0.2,1852,22,132238,71.36427415002699,10
0.2,1853,22,132260,71.33764832793959,11
0.2,1854,21,132281,71.31051212938006,12
0.2,1855,93,132374,71.32219827586206,9
0.2,1856,95,132469,71.33494884221864,8
0.2,1857,24,132493,71.30947255113024,9
0.2,1858,26,132519,71.28509951586875,8
0.2,1859,23,132542,71.25913978494624,10
0.2,1860,94,132636,71.2713594841483,8
0.2,1861,95,132731,71.28410311493018,7
0.2,1862,92,132823,71.29522275899087,10
0.2,1863,91,132914,71.30579399141631,10
0.2,1864,95,133009,71.31849865951743,6
0.2,1865,24,133033,71.29314040728832,9
0.2,1866,93,133126,71.3047670058918,8
0.2,1867,95,133221,71.31745182012848,7
0.2,1868,92,133313,71.32851792402354,11
0.2,1869,90,133403,71.3385026737968,11
0.2,1870,94,133497,71.35061464457509,7
0.2,1871,96,133593,71.36378205128206,6
0.2,1872,95,133688,71.37640149492792,6
0.2,1873,95,133783,71.38900747065101,6
0.2,1874,20,133803,71.3616,13
0.2,1875,95,133898,71.37420042643923,7
0.2,1876,93,133991,71.38572189664357,9
0.2,1877,94,134085,71.39776357827476,7
0.2,1878,20,134105,71.37040979244279,13
0.2,1879,94,134199,71.38244680851064,8
0.2,1880,95,134294,71.39500265816055,7
0.2,1881,94,134388,71.40701381509032,8
0.2,1882,22,134410,71.38077535847053,11
0.2,1883,26,134436,71.35668789808918,7
0.2,1884,93,134529,71.36816976127321,8
0.2,1885,92,134621,71.37910922587487,9
0.2,1886,25,134646,71.35453100158982,9
0.2,1887,95,134741,71.36705508474576,7
0.2,1888,95,134836,71.37956590788777,7
0.2,1889,94,134930,71.39153439153439,8
0.2,1890,94,135024,71.4034902168165,8
0.2,1891,96,135120,71.41649048625793,6
0.2,1892,89,135209,71.42577918647649,13
0.2,1893,92,135301,71.43664202745512,10
0.2,1894,95,135396,71.4490765171504,7
0.2,1895,90,135486,71.45886075949367,11
0.2,1896,-50,135436,71.39483394833948,14
0.2,1897,93,135529,71.40621707060063,9
0.2,1898,95,135624,71.41864139020537,7
0.2,1899,89,135713,71.4278947368421,12
0.2,1900,92,135805,71.43871646501842,9
0.2,1901,95,135900,71.45110410094637,8
0.2,1902,94,135994,71.46295323173936,9
0.2,1903,94,136088,71.47478991596638,7
0.2,1904,86,136174,71.48241469816273,17
0.2,1905,89,136263,71.4916054564533,13
0.2,1906,95,136358,71.50393287886733,7
0.2,1907,95,136453,71.51624737945492,7
0.2,1908,95,136548,71.52854897852279,6
0.2,1909,96,136644,71.5413612565445,6
0.2,1910,95,136739,71.55363683935113,7
0.2,1911,91,136830,71.56380753138075,10
0.2,1912,92,136922,71.57449032932567,10
0.2,1913,24,136946,71.5496342737722,9
0.2,1914,95,137041,71.56187989556136,6
0.2,1915,94,137135,71.57359081419624,7
0.2,1916,94,137229,71.58528951486699,8
0.2,1917,95,137324,71.59749739311783,6
0.2,1918,91,137415,71.60760812923398,10
0.2,1919,94,137509,71.61927083333333,7
0.2,1920,95,137604,71.6314419573139,6
0.2,1921,95,137699,71.64360041623308,7
0.2,1922,95,137794,71.6557462298492,7
0.2,1923,92,137886,71.66632016632016,9
0.2,1924,93,137979,71.67740259740259,11
0.2,1925,93,138072,71.68847352024922,9
0.2,1926,92,138164,71.69901401141671,10
0.2,1927,95,138259,71.71109958506224,6
0.2,1928,90,138349,71.72058061171592,12
0.2,1929,93,138442,71.73160621761659,9
0.2,1930,95,138537,71.74365613671672,6
0.2,1931,95,138632,71.75569358178053,7
0.2,1932,93,138725,71.76668391101914,8
0.2,1933,94,138819,71.77817993795243,9
0.2,1934,-52,138767,71.71421188630491,18
0.2,1935,95,138862,71.72623966942149,7
0.2,1936,18,138880,71.69850283944244,17
0.2,1937,26,138906,71.6749226006192,7
0.2,1938,95,139001,71.68695203713254,7
0.2,1939,87,139088,71.69484536082474,18
0.2,1940,95,139183,71.70685213807316,7
0.2,1941,94,139277,71.7183316168898,9
0.2,1942,20,139297,71.69171384457026,12
0.2,1943,88,139385,71.70010288065843,14
0.2,1944,93,139478,71.71105398457584,9
0.2,1945,92,139570,71.72147995889003,9
0.2,1946,17,139587,71.69337442218799,15
0.2,1947,94,139681,71.70482546201232,7
0.2,1948,93,139774,71.7157516675218,8
0.2,1949,92,139866,71.72615384615385,9
0.2,1950,20,139886,71.69964120963608,13
0.2,1951,92,139978,71.71004098360656,11
0.2,1952,95,140073,71.72196620583718,6
0.2,1953,-49,140024,71.66018423746162,13
0.2,1954,93,140117,71.67109974424552,8
0.2,1955,21,140138,71.64519427402863,13
0.2,1956,95,140233,71.65712825753705,7
0.2,1957,95,140328,71.66905005107252,7
0.2,1958,91,140419,71.67891781521185,11
0.2,1959,94,140513,71.69030612244897,9
0.2,1960,18,140531,71.66292707802141,15
0.2,1961,96,140627,71.67533129459736,6
0.2,1962,95,140722,71.68721344880285,7
0.2,1963,93,140815,71.69806517311609,9
0.2,1964,95,140910,71.70992366412214,7
0.2,1965,95,141005,71.72177009155646,7
0.2,1966,26,141031,71.69852567361464,7
0.2,1967,94,141125,71.70985772357723,7
0.2,1968,94,141219,71.7211782630777,7
0.2,1969,94,141313,71.73248730964467,8
0.2,1970,94,141407,71.74378488077119,8
0.2,1971,92,141499,71.75405679513185,10
0.2,1972,89,141588,71.76279776989357,13
0.2,1973,91,141679,71.7725430597771,11
0.2,1974,21,141700,71.74683544303798,12
0.2,1975,94,141794,71.7580971659919,8
0.2,1976,95,141889,71.76985331310065,6
0.2,1977,93,141982,71.78058645096057,10
0.2,1978,88,142070,71.788782213239,13
0.2,1979,96,142166,71.8010101010101,6
0.2,1980,-46,142120,71.74154467440687,10
0.2,1981,91,142211,71.75126135216952,10
0.2,1982,86,142297,71.75844679778113,15
0.2,1983,93,142390,71.76915322580645,10
0.2,1984,93,142483,71.77984886649874,9
0.2,1985,95,142578,71.79154078549848,6
0.2,1986,93,142671,71.80221439355813,11
0.2,1987,21,142692,71.77665995975855,13
0.2,1988,94,142786,71.78783308195072,9
0.2,1989,93,142879,71.79849246231156,10
0.2,1990,94,142973,71.80964339527875,8
0.2,1991,95,143068,71.82128514056225,6
0.2,1992,95,143163,71.83291520321124,6
0.2,1993,14,143177,71.80391173520562,20
0.2,1994,94,143271,71.81503759398497,7
0.2,1995,92,143363,71.82515030060121,9
0.2,1996,91,143454,71.83475212819229,10
0.2,1997,-54,143400,71.77177177177177,18
0.2,1998,94,143494,71.78289144572287,7
0.2,1999,18,143512,71.756,19
0.2,2000,95,143607,71.76761619190405,7
0.2,2001,90,143697,71.77672327672327,11
0.2,2002,19,143716,71.75037443834249,14
0.2,2003,24,143740,71.72654690618762,9
0.2,2004,93,143833,71.73715710723192,9
0.2,2005,95,143928,71.74875373878365,8
0.2,2006,93,144021,71.75934230194319,10
0.2,2007,95,144116,71.77091633466135,7
0.2,2008,95,144211,71.78247884519662,6
0.2,2009,93,144304,71.79303482587065,8
0.2,2010,94,144398,71.80407757334659,8
0.2,2011,90,144488,71.8131212723658,12
0.2,2012,93,144581,71.82364629905614,9
0.2,2013,94,144675,71.83465739821251,8
0.2,2014,96,144771,71.84665012406948,6
0.2,2015,91,144862,71.8561507936508,10
0.2,2016,25,144887,71.8329201784829,8
0.2,2017,94,144981,71.84390485629336,9
0.2,2018,94,145075,71.85487865279842,8
0.2,2019,95,145170,71.86633663366337,6
0.2,2020,95,145265,71.87778327560613,7
0.2,2021,-52,145213,71.81651829871414,17
0.2,2022,94,145307,71.82748393475038,8
0.2,2023,84,145391,71.83349802371542,18
0.2,2024,93,145484,71.84395061728395,9
0.2,2025,94,145578,71.85488647581441,9
0.2,2026,94,145672,71.86581154415393,8
0.2,2027,95,145767,71.87721893491124,7
0.2,2028,89,145856,71.885657959586,13
0.2,2029,21,145877,71.86059113300493,12
0.2,2030,27,145904,71.8385032003939,6
0.2,2031,93,145997,71.84891732283465,8
0.2,2032,24,146021,71.82538121003444,9
0.2,2033,94,146115,71.83628318584071,8
0.2,2034,94,146209,71.84717444717445,7
0.2,2035,93,146302,71.85756385068763,9
0.2,2036,93,146395,71.86794305351006,10
0.2,2037,25,146420,71.84494602551521,8
0.2,2038,26,146446,71.82246199117215,7
0.2,2039,94,146540,71.83333333333333,8
0.2,2040,95,146635,71.84468397844194,7
0.2,2041,86,146721,71.85161606268365,16
0.2,2042,93,146814,71.86196769456681,9
0.2,2043,93,146907,71.87230919765166,9
0.2,2044,95,147002,71.88361858190709,6
0.2,2045,93,147095,71.89393939393939,11
0.2,2046,95,147190,71.90522716170005,7
0.2,2047,91,147281,71.91455078125,12
0.2,2048,95,147376,71.92581747193753,6
0.2,2049,94,147470,71.93658536585366,8
0.2,2050,95,147565,71.94783032666992,6
0.2,2051,25,147590,71.92495126705653,8
0.2,2052,21,147611,71.90014612761811,12
0.2,2053,21,147632,71.87536514118793,11
0.2,2054,90,147722,71.88418491484185,12
0.2,2055,95,147817,71.8954280155642,7
0.2,2056,91,147908,71.90471560525036,10
0.2,2057,20,147928,71.87949465500486,12
0.2,2058,95,148023,71.89072365225837,7
0.2,2059,95,148118,71.90194174757282,8
0.2,2060,93,148211,71.91217855409995,9
0.2,2061,94,148305,71.92289039767216,8
0.2,2062,95,148400,71.93407658749395,6
0.2,2063,94,148494,71.94476744186046,7
0.2,2064,95,148589,71.95593220338984,7
0.2,2065,94,148683,71.96660212971926,7
0.2,2066,24,148707,71.94339622641509,9
0.2,2067,24,148731,71.92021276595744,11
0.2,2068,93,148824,71.93040115998066,9
0.2,2069,95,148919,71.9415458937198,7
0.2,2070,94,149013,71.95219700627716,8
0.2,2071,87,149100,71.95945945945945,15
0.2,2072,21,149121,71.93487698986975,12
0.2,2073,23,149144,71.91128254580521,10
0.2,2074,93,149237,71.92144578313253,9
0.2,2075,96,149333,71.93304431599229,6
0.2,2076,88,149421,71.94077997111218,14
0.2,2077,26,149447,71.91867179980751,7
0.2,2078,92,149539,71.92833092833092,10
0.2,2079,95,149634,71.93942307692308,7
0.2,2080,94,149728,71.95002402691014,8
0.2,2081,24,149752,71.92699327569645,8
0.2,2082,92,149844,71.93662986077773,9
0.2,2083,23,149867,71.91314779270634,10
0.2,2084,94,149961,71.92374100719424,7
0.2,2085,95,150056,71.93480345158197,7
0.2,2086,93,150149,71.9448969813129,9
0.2,2087,95,150244,71.955938697318,6
0.2,2088,95,150339,71.96696984202968,7
0.2,2089,92,150431,71.97655502392344,9
0.2,2090,23,150454,71.9531324725012,11
0.2,2091,-120,150334,71.86137667304016,15
0.2,2092,95,150429,71.87243191591018,6
0.2,2093,93,150522,71.88252148997135,9
0.2,2094,95,150617,71.89355608591886,6
0.2,2095,22,150639,71.86975190839695,12
0.2,2096,96,150735,71.88125894134478,6
0.2,2097,-46,150689,71.82507149666348,11
0.2,2098,93,150782,71.83515959980943,9
0.2,2099,88,150870,71.84285714285714,13
0.2,2100,94,150964,71.85340314136126,8
0.2,2101,26,150990,71.83158896289248,6
0.2,2102,94,151084,71.84213029006182,8
0.2,2103,94,151178,71.85266159695817,8
0.2,2104,95,151273,71.86365795724465,6
0.2,2105,93,151366,71.87369420702754,9
0.2,2106,91,151457,71.8827717133365,11
0.2,2107,95,151552,71.89373814041745,7
0.2,2108,95,151647,71.90469416785206,7
0.2,2109,94,151741,71.91516587677725,8
0.2,2110,94,151835,71.92562766461393,7
0.2,2111,94,151929,71.93607954545455,8
0.2,2112,94,152023,71.94652153336489,8
0.2,2113,95,152118,71.95742667928099,6
0.2,2114,92,152210,71.96690307328605,10
0.2,2115,92,152302,71.97637051039698,10
0.2,2116,-193,152109,71.85120453471895,19
0.2,2117,95,152204,71.86213408876299,7
0.2,2118,24,152228,71.83954695611138,9
0.2,2119,89,152317,71.84764150943396,14
0.2,2120,87,152404,71.85478547854785,15
0.2,2121,95,152499,71.86569274269557,6
0.2,2122,94,152593,71.8761186999529,8
0.2,2123,95,152688,71.88700564971751,7
0.2,2124,95,152783,71.89788235294118,7
0.2,2125,95,152878,71.90874882408278,7
0.2,2126,94,152972,71.91913493182886,8
0.2,2127,18,152990,71.8937969924812,15
0.2,2128,93,153083,71.90371066228276,8
0.2,2129,25,153108,71.88169014084507,9
0.2,2130,95,153203,71.89253871421867,6
0.2,2131,91,153294,71.9015009380863,11
0.2,2132,93,153387,71.9113924050633,9
0.2,2133,94,153481,71.92174320524836,10
0.2,2134,93,153574,71.93161592505855,8
0.2,2135,23,153597,71.90870786516854,10
0.2,2136,96,153693,71.91998128217126,6
0.2,2137,92,153785,71.92937324602433,11
0.2,2138,92,153877,71.9387564282375,10
0.2,2139,94,153971,71.94906542056074,8
0.2,2140,26,153997,71.92760392340028,7
0.2,2141,95,154092,71.93837535014005,7
0.2,2142,88,154180,71.94587027531497,13
0.2,2143,26,154206,71.92444029850746,7
0.2,2144,84,154290,71.93006993006993,18
0.2,2145,94,154384,71.9403541472507,9
0.2,2146,95,154479,71.95109455053563,7
0.2,2147,93,154572,71.9608938547486,10
0.2,2148,94,154666,71.97114937180083,8
0.2,2149,25,154691,71.9493023255814,8
0.2,2150,95,154786,71.96001859600186,8
0.2,2151,25,154811,71.93819702602231,8
0.2,2152,95,154906,71.94890849976777,6
0.2,2153,93,154999,71.95868152274838,9
0.2,2154,94,155093,71.96890951276102,8
0.2,2155,96,155189,71.98005565862708,6
0.2,2156,95,155284,71.99072786277237,6
0.2,2157,-55,155229,71.9318813716404,19
0.2,2158,95,155324,71.94256600277906,7
0.2,2159,20,155344,71.91851851851852,12
0.2,2160,22,155366,71.89541878759833,11
0.2,2161,96,155462,71.90656799259945,6
0.2,2162,92,155554,71.91585760517799,9
0.2,2163,24,155578,71.89371534195934,9
0.2,2164,93,155671,71.90346420323326,8
0.2,2165,20,155691,71.87950138504155,14
0.2,2166,25,155716,71.85786802030456,8
0.2,2167,91,155807,71.86669741697418,10
0.2,2168,95,155902,71.87736284001844,6
0.2,2169,95,155997,71.88801843317972,6
0.2,2170,92,156089,71.8972823583602,10
0.2,2171,93,156182,71.90699815837938,9
0.2,2172,94,156276,71.91716520938795,8
0.2,2173,94,156370,71.92732290708372,7
0.2,2174,23,156393,71.90482758620689,10
0.2,2175,95,156488,71.9154411764706,7
0.2,2176,95,156583,71.92604501607717,7
0.2,2177,87,156670,71.93296602387511,14
0.2,2178,93,156763,71.94263423588802,8
0.2,2179,95,156858,71.95321100917431,6
0.2,2180,27,156885,71.93259972489683,6
0.2,2181,90,156975,71.94087992667278,11
0.2,2182,95,157070,71.95144296839212,7
0.2,2183,93,157163,71.96108058608058,8
0.2,2184,96,157259,71.9720823798627,6
0.2,2185,95,157354,71.98261665141811,6
0.2,2186,95,157449,71.99314128943759,7
0.2,2187,94,157543,72.00319926873857,8
0.2,2188,95,157638,72.01370488807675,7
0.2,2189,95,157733,72.02420091324201,6
0.2,2190,95,157828,72.03468735737107,8
0.2,2191,94,157922,72.04470802919708,9
0.2,2192,93,158015,72.05426356589147,9
0.2,2193,95,158110,72.06472196900638,7
0.2,2194,91,158201,72.07334851936218,11
0.2,2195,93,158294,72.08287795992715,9
0.2,2196,91,158385,72.09148839326355,11
0.2,2197,94,158479,72.1014558689718,8
0.2,2198,94,158573,72.11141427921783,9
0.2,2199,82,158655,72.11590909090908,20
0.2,2200,-126,158529,72.02589731940027,21
0.2,2201,26,158555,72.00499545867393,7
0.2,2202,24,158579,71.98320472083522,9
0.2,2203,94,158673,71.9931941923775,8
0.2,2204,-47,158626,71.93922902494332,11
0.2,2205,95,158721,71.94968268359021,6
0.2,2206,96,158817,71.96057997281378,6
0.2,2207,94,158911,71.9705615942029,7
0.2,2208,95,159006,71.98098687188774,7
0.2,2209,85,159091,71.9868778280543,17
0.2,2210,95,159186,71.99728629579376,7
0.2,2211,94,159280,72.00723327305606,9
0.2,2212,94,159374,72.01717126073204,7
0.2,2213,92,159466,72.02619692863595,9
0.2,2214,91,159557,72.03476297968398,10
0.2,2215,94,159651,72.04467509025271,8
0.2,2216,89,159740,72.05232295895354,12
0.2,2217,-53,159687,71.99594229035166,16
0.2,2218,25,159712,71.97476340694006,8
0.2,2219,93,159805,71.98423423423424,8
0.2,2220,90,159895,71.9923457901846,11
0.2,2221,24,159919,71.97074707470748,9
0.2,2222,92,160011,71.97975708502024,11
0.2,2223,94,160105,71.9896582733813,8
0.2,2224,91,160196,71.99820224719102,11
0.2,2225,-55,160141,71.94115004492363,18
0.2,2226,95,160236,71.95150426582848,7
0.2,2227,91,160327,71.96005385996409,10
0.2,2228,95,160422,71.97039030955585,7
0.2,2229,90,160512,71.97847533632287,12
0.2,2230,96,160608,71.98924249215598,6
0.2,2231,93,160701,71.9986559139785,8
0.2,2232,93,160794,72.00806090461263,8
0.2,2233,95,160889,72.0183527305282,6
0.2,2234,94,160983,72.0281879194631,8
0.2,2235,92,161075,72.0371198568873,13
0.2,2236,94,161169,72.04693786320965,7
0.2,2237,94,161263,72.05674709562109,8
0.2,2238,89,161352,72.06431442608307,13
0.2,2239,91,161443,72.07276785714286,12
0.2,2240,95,161538,72.08299866131192,7
0.2,2241,21,161559,72.06021409455843,13
0.2,2242,96,161655,72.07088720463665,6
0.2,2243,95,161750,72.08110516934046,6
0.2,2244,89,161839,72.08864142538975,15
0.2,2245,95,161934,72.09884238646482,6
0.2,2246,18,161952,72.07476635514018,14
0.2,2247,24,161976,72.05338078291815,8
0.2,2248,-52,161924,71.99822143174744,17
0.2,2249,95,162019,72.00844444444445,6
0.2,2250,22,162041,71.98622834295868,10
0.2,2251,96,162137,71.99689165186501,6
0.2,2252,-333,161804,71.81713271193964,21
0.2,2253,21,161825,71.79458740017746,12
0.2,2254,23,161848,71.77294900221729,10
0.2,2255,94,161942,71.78280141843972,8
0.2,2256,16,161958,71.75808595480727,17
0.2,2257,93,162051,71.76749335695305,11
0.2,2258,89,162140,71.7751217352811,12
0.2,2259,95,162235,71.78539823008849,7
0.2,2260,94,162329,71.7952233524989,8
0.2,2261,93,162422,71.80459770114942,9
0.2,2262,90,162512,71.81263809102961,11
0.2,2263,24,162536,71.79151943462898,9
0.2,2264,87,162623,71.798233995585,14
0.2,2265,25,162648,71.77758164165931,8
0.2,2266,93,162741,71.78694309660344,9
0.2,2267,94,162835,71.79673721340389,9
0.2,2268,16,162851,71.77214631996475,17
0.2,2269,91,162942,71.7806167400881,10
0.2,2270,93,163035,71.78996036988111,9
0.2,2271,21,163056,71.76760563380282,11
0.2,2272,25,163081,71.74703035635724,9
0.2,2273,-46,163035,71.6952506596306,10
0.2,2274,24,163059,71.67428571428572,8
0.2,2275,23,163082,71.65289982425307,10
0.2,2276,93,163175,71.6622749231445,11
0.2,2277,26,163201,71.6422300263389,7
0.2,2278,92,163293,71.65116279069767,10
0.2,2279,93,163386,71.66052631578947,9
0.2,2280,27,163413,71.64094695309075,6
0.2,2281,93,163506,71.65030674846626,8
0.2,2282,94,163600,71.66009636443276,8
0.2,2283,88,163688,71.66725043782837,15
0.2,2284,94,163782,71.67702407002189,8
0.2,2285,-193,163589,71.56124234470691,19
0.2,2286,18,163607,71.53782247485789,14
0.2,2287,23,163630,71.51660839160839,10
0.2,2288,21,163651,71.49453910004368,12
0.2,2289,93,163744,71.50393013100437,8
0.2,2290,-48,163696,71.45176778699258,12
0.2,2291,95,163791,71.46204188481676,7
0.2,2292,95,163886,71.47230702136939,6
0.2,2293,96,163982,71.48299912816042,6
0.2,2294,95,164077,71.49324618736384,6
0.2,2295,85,164162,71.49912891986062,18
0.2,2296,95,164257,71.50936003482803,7
0.2,2297,92,164349,71.5182767624021,9
0.2,2298,92,164441,71.52718573292736,10
0.2,2299,-266,164175,71.3804347826087,23
0.2,2300,89,164264,71.38809213385484,14
0.2,2301,22,164286,71.36663770634232,11
0.2,2302,93,164379,71.37603126356926,10
0.2,2303,91,164470,71.38454861111111,12
0.2,2304,24,164494,71.36399132321041,9
0.2,2305,95,164589,71.37424111014744,6
0.2,2306,94,164683,71.3840485478977,8
0.2,2307,95,164778,71.39428076256499,7
0.2,2308,92,164870,71.40320485058467,11
0.2,2309,94,164964,71.41298701298702,7
0.2,2310,21,164985,71.39117265253137,13
0.2,2311,95,165080,71.40138408304499,8
0.2,2312,95,165175,71.41158668396022,7
0.2,2313,94,165269,71.42134831460675,8
0.2,2314,26,165295,71.40172786177106,7
0.2,2315,95,165390,71.4119170984456,6
0.2,2316,95,165485,71.42209753992232,6
0.2,2317,95,165580,71.43226919758412,7
0.2,2318,19,165599,71.40965933592065,13
0.2,2319,91,165690,71.41810344827586,11
0.2,2320,95,165785,71.42826367944852,7
0.2,2321,95,165880,71.4384151593454,7
0.2,2322,95,165975,71.44855789926818,7
0.2,2323,20,165995,71.42641996557659,13
0.2,2324,94,166089,71.43612903225807,8
0.2,2325,96,166185,71.44668959587274,9
0.2,2326,95,166280,71.4568113450795,7
0.2,2327,18,166298,71.43384879725086,15
0.2,2328,96,166394,71.4443967367969,7
0.2,2329,95,166489,71.45450643776825,6
0.2,2330,94,166583,71.46417846417846,8
0.2,2331,94,166677,71.47384219554031,10
0.2,2332,23,166700,71.45306472353194,11
0.2,2333,25,166725,71.4331619537275,9
0.2,2334,93,166818,71.4423982869379,9
0.2,2335,90,166908,71.45034246575342,14
0.2,2336,85,166993,71.45614035087719,16
0.2,2337,95,167088,71.46621043627032,7
0.2,2338,95,167183,71.47627191107311,7
0.2,2339,89,167272,71.48376068376068,12
0.2,2340,93,167365,71.4929517300299,10
0.2,2341,24,167389,71.4726729291204,9
0.2,2342,93,167482,71.48186086214255,8
0.2,2343,-54,167428,71.4283276450512,19
0.2,2344,94,167522,71.43795309168443,8
0.2,2345,90,167612,71.4458653026428,11
0.2,2346,25,167637,71.42607584149978,8
0.2,2347,95,167732,71.43611584327087,6
0.2,2348,22,167754,71.41507024265645,10
0.2,2349,94,167848,71.42468085106383,10
0.2,2350,90,167938,71.43258188005105,12
0.2,2351,93,168031,71.44175170068027,8
0.2,2352,95,168126,71.45176370590735,6
0.2,2353,95,168221,71.46176720475786,7
0.2,2354,25,168246,71.4420382165605,8
0.2,2355,20,168266,71.42020373514431,12
0.2,2356,16,168282,71.39669070852779,16
0.2,2357,96,168378,71.40712468193384,6
0.2,2358,23,168401,71.38660449342942,10
0.2,2359,96,168497,71.39703389830508,6
0.2,2360,93,168590,71.40618382041508,10
0.2,2361,92,168682,71.41490262489415,10
0.2,2362,24,168706,71.39483707151925,9
0.2,2363,95,168801,71.40482233502539,7
0.2,2364,94,168895,71.41437632135306,7
0.2,2365,91,168986,71.42265426880812,10
0.2,2366,95,169081,71.43261512463033,6
0.2,2367,20,169101,71.41089527027027,13
0.2,2368,94,169195,71.42043056141831,7
0.2,2369,94,169289,71.42995780590718,8
0.2,2370,91,169380,71.43821172501055,10
0.2,2371,92,169472,71.4468802698145,9
0.2,2372,93,169565,71.45596291613991,8
0.2,2373,95,169660,71.4658803706824,7
0.2,2374,26,169686,71.44673684210527,8
0.2,2375,95,169781,71.45664983164983,8
0.2,2376,89,169870,71.46403029028187,12
0.2,2377,95,169965,71.47392767031118,6
0.2,2378,92,170057,71.48255569567046,9
0.2,2379,94,170151,71.49201680672269,8
0.2,2380,95,170246,71.50188996220075,8
0.2,2381,95,170341,71.51175482787573,6
0.2,2382,94,170435,71.52119177507343,7
0.2,2383,22,170457,71.50041946308725,11
0.2,2384,92,170549,71.50901467505241,11
0.2,2385,91,170640,71.51718357082984,12
0.2,2386,95,170735,71.52702136573104,7
0.2,2387,25,170760,71.50753768844221,8
0.2,2388,25,170785,71.48807032231059,8
0.2,2389,16,170801,71.46485355648535,17
0.2,2390,95,170896,71.47469677959013,7
0.2,2391,93,170989,71.4836956521739,8
0.2,2392,93,171082,71.49268700376096,9
0.2,2393,16,171098,71.46950710108605,18
0.2,2394,94,171192,71.47891440501044,8
0.2,2395,23,171215,71.45868113522538,10
0.2,2396,94,171309,71.46808510638297,8
0.2,2397,96,171405,71.47831526271894,6
0.2,2398,94,171499,71.4877032096707,7
0.2,2399,21,171520,71.46666666666667,12
0.2,2400,93,171613,71.47563515201999,10
0.2,2401,96,171709,71.48584512905911,6
0.2,2402,95,171804,71.4956304619226,7
0.2,2403,94,171898,71.50499168053244,8
0.2,2404,95,171993,71.51476091476091,7
0.2,2405,92,172085,71.52327514546965,9
0.2,2406,-45,172040,71.47486497714998,9
0.2,2407,19,172059,71.453073089701,13
0.2,2408,91,172150,71.46118721461187,11
0.2,2409,95,172245,71.47095435684648,6
0.2,2410,94,172339,71.48029863127333,7
0.2,2411,92,172431,71.48880597014926,11
0.2,2412,95,172526,71.49854952341484,6
0.2,2413,95,172621,71.50828500414251,6
0.2,2414,95,172716,71.51801242236024,6
0.2,2415,19,172735,71.49627483443709,14
0.2,2416,26,172761,71.47745138601572,7
0.2,2417,92,172853,71.4859387923904,10
0.2,2418,94,172947,71.49524596940884,8
0.2,2419,91,173038,71.50330578512397,12
0.2,2420,91,173129,71.5113589425857,11
0.2,2421,22,173151,71.49091659785302,12
0.2,2422,94,173245,71.50020635575733,7
0.2,2423,94,173339,71.50948844884489,8
0.2,2424,91,173430,71.51752577319587,10
0.2,2425,-51,173379,71.46702390766694,15
0.2,2426,94,173473,71.47630819942316,7
0.2,2427,24,173497,71.45675453047775,9
0.2,2428,91,173588,71.46480032935365,11
0.2,2429,93,173681,71.47366255144033,11
0.2,2430,94,173775,71.48292883587001,8
0.2,2431,94,173869,71.4921875,9
0.2,2432,94,173963,71.50143855322646,8
0.2,2433,94,174057,71.51068200493016,8
0.2,2434,95,174152,71.52032854209446,6
0.2,2435,20,174172,71.4991789819376,13
0.2,2436,25,174197,71.48009848173984,8
0.2,2437,22,174219,71.45980311730926,10
0.2,2438,96,174315,71.46986469864699,6
0.2,2439,95,174410,71.47950819672131,6
0.2,2440,92,174502,71.48791478902089,10
0.2,2441,93,174595,71.496723996724,9
0.2,2442,93,174688,71.50552599263202,8
0.2,2443,17,174705,71.48322422258593,17
0.2,2444,23,174728,71.46339468302658,10
0.2,2445,92,174820,71.47179067865903,13
0.2,2446,95,174915,71.48140580302412,6
0.2,2447,95,175010,71.49101307189542,7
0.2,2448,24,175034,71.47162106982442,9
0.2,2449,94,175128,71.48081632653061,8
0.2,2450,95,175223,71.4904120767034,7
0.2,2451,27,175250,71.47226753670473,6
0.2,2452,93,175343,71.48104362005708,8
0.2,2453,92,175435,71.48940505297473,10
0.2,2454,92,175527,71.49775967413441,9
0.2,2455,-47,175480,71.44951140065146,11
0.2,2456,24,175504,71.43019943019944,10
0.2,2457,94,175598,71.43938161106591,8
0.2,2458,92,175690,71.44774298495324,10
0.2,2459,95,175785,71.45731707317073,6
0.2,2460,87,175872,71.46363266964649,16
0.2,2461,93,175965,71.47238017871649,9
0.2,2462,95,176060,71.48193260251726,8
0.2,2463,93,176153,71.49066558441558,8
0.2,2464,91,176244,71.49858012170385,11
0.2,2465,92,176336,71.50689375506894,11
0.2,2466,92,176428,71.515200648561,12
0.2,2467,93,176521,71.52390599675851,9
0.2,2468,96,176617,71.5338193600648,6
0.2,2469,96,176713,71.54372469635628,6
0.2,2470,95,176808,71.5532173209227,7
0.2,2471,90,176898,71.56067961165049,16
0.2,2472,89,176987,71.56773150020219,13
0.2,2473,92,177079,71.57599029911076,9
0.2,2474,94,177173,71.5850505050505,8
0.2,2475,91,177264,71.59289176090469,11
0.2,2476,27,177291,71.57488897860316,6
0.2,2477,96,177387,71.58474576271186,6
0.2,2478,21,177408,71.56434045986285,12
0.2,2479,94,177502,71.5733870967742,8
0.2,2480,91,177593,71.58121725110843,10
0.2,2481,95,177688,71.59065269943594,6
0.2,2482,92,177780,71.59887233185663,10
0.2,2483,93,177873,71.60748792270532,8
0.2,2484,89,177962,71.61448692152918,12
0.2,2485,94,178056,71.62349155269509,8
0.2,2486,-45,178011,71.57659831121833,9
0.2,2487,94,178105,71.58561093247589,8
0.2,2488,94,178199,71.5946163117718,8
0.2,2489,95,178294,71.60401606425702,7
0.2,2490,92,178386,71.61220393416299,10
0.2,2491,95,178481,71.62158908507223,6
0.2,2492,27,178508,71.60369033293222,6
0.2,2493,96,178604,71.61347233360064,6
0.2,2494,92,178696,71.62164328657315,10
0.2,2495,95,178791,71.63100961538461,6
0.2,2496,26,178817,71.6127352823388,8
0.2,2497,89,178906,71.61969575660528,13
0.2,2498,88,178994,71.62625050020009,14
0.2,2499,95,179089,71.6356,7
0.2,2500,93,179182,71.64414234306277,8
0.2,2501,95,179277,71.65347721822542,7
0.2,2502,94,179371,71.66240511386336,8
0.2,2503,94,179465,71.67132587859425,9
0.2,2504,22,179487,71.65149700598802,11
0.2,2505,95,179582,71.6608140462889,6
0.2,2506,93,179675,71.66932588751496,11
0.2,2507,18,179693,71.64792663476874,15
0.2,2508,20,179713,71.62734157034676,13
0.2,2509,95,179808,71.63665338645419,6
0.2,2510,24,179832,71.61768219832736,9
0.2,2511,91,179923,71.62539808917198,11
0.2,2512,95,180018,71.63469956227617,6
0.2,2513,93,180111,71.64319809069212,8
0.2,2514,-48,180063,71.59562624254472,12
0.2,2515,19,180082,71.57472178060414,14
0.2,2516,93,180175,71.58323400874056,9
0.2,2517,22,180197,71.56354249404289,11
0.2,2518,-45,180152,71.51726875744343,9
0.2,2519,22,180174,71.49761904761905,12
0.2,2520,90,180264,71.50495834986117,12
0.2,2521,95,180359,71.51427438540841,7
0.2,2522,22,180381,71.49464922711059,11
0.2,2523,92,180473,71.5027733755943,11
0.2,2524,96,180569,71.51247524752475,6
0.2,2525,94,180663,71.52137767220903,7
0.2,2526,95,180758,71.53066877720617,7
0.2,2527,90,180848,71.5379746835443,12
0.2,2528,95,180943,71.54725187821273,6
0.2,2529,94,181037,71.55612648221344,7
0.2,2530,21,181058,71.53615171868826,13
0.2,2531,92,181150,71.54423380726698,11
0.2,2532,95,181245,71.55349388077379,7
0.2,2533,93,181338,71.56195737963694,9
0.2,2534,91,181429,71.56962524654833,11
0.2,2535,94,181523,71.57847003154573,8
0.2,2536,96,181619,71.58809617658652,6
0.2,2537,96,181715,71.5977147360126,7
0.2,2538,93,181808,71.60614415124064,9
0.2,2539,24,181832,71.58740157480315,9
0.2,2540,94,181926,71.59622195985833,8
0.2,2541,94,182020,71.60503540519277,8
0.2,2542,-119,181901,71.53008257963036,14
0.2,2543,96,181997,71.53970125786164,6
0.2,2544,93,182090,71.54813359528487,9
0.2,2545,92,182182,71.55616653574234,11
0.2,2546,91,182273,71.56380054966627,11
0.2,2547,96,182369,71.57339089481947,9
0.2,2548,87,182456,71.57944291879168,16
0.2,2549,96,182552,71.58901960784314,6
0.2,2550,27,182579,71.57154057232458,7
0.2,2551,27,182606,71.55407523510972,6
0.2,2552,92,182698,71.56208382295338,11
0.2,2553,95,182793,71.57126076742365,7
0.2,2554,-52,182741,71.52289628180039,16
0.2,2555,92,182833,71.5309076682316,10
0.2,2556,94,182927,71.53969495502542,7
0.2,2557,93,183020,71.5480844409695,8
0.2,2558,94,183114,71.55685814771395,7
0.2,2559,93,183207,71.565234375,9
0.2,2560,23,183230,71.54627098789535,12
0.2,2561,93,183323,71.55464480874316,8
0.2,2562,94,183417,71.56340226297309,9
0.2,2563,93,183510,71.57176287051482,9
0.2,2564,24,183534,71.553216374269,9
0.2,2565,96,183630,71.56274356975838,7
0.2,2566,92,183722,71.57070510323335,10
0.2,2567,-47,183675,71.52453271028037,11
0.2,2568,90,183765,71.5317244063838,12
0.2,2569,23,183788,71.51284046692606,10
0.2,2570,95,183883,71.5219758848697,7
0.2,2571,95,183978,71.53110419906687,7
0.2,2572,96,184074,71.54061406917995,6
0.2,2573,95,184169,71.54972804972805,7
0.2,2574,95,184264,71.5588349514563,6
0.2,2575,95,184359,71.5679347826087,6
0.2,2576,94,184453,71.57663950329841,8
0.2,2577,94,184547,71.58533747090767,8
0.2,2578,95,184642,71.59441644048081,7
0.2,2579,90,184732,71.6015503875969,12
0.2,2580,19,184751,71.58117008911275,15
0.2,2581,23,184774,71.56235476374903,10
0.2,2582,93,184867,71.57065427797136,8
0.2,2583,94,184961,71.57933436532508,7
0.2,2584,95,185056,71.58839458413927,8
0.2,2585,96,185152,71.59783449342613,6
0.2,2586,22,185174,71.57866254348666,11
0.2,2587,95,185269,71.58771251931994,8
0.2,2588,92,185361,71.59559675550406,10
0.2,2589,90,185451,71.6027027027027,14
0.2,2590,89,185540,71.6094172134311,12
0.2,2591,92,185632,71.61728395061728,10
0.2,2592,96,185728,71.6266872348631,6
0.2,2593,96,185824,71.6360832690825,6
0.2,2594,95,185919,71.64508670520232,7
0.2,2595,93,186012,71.653312788906,8
0.2,2596,96,186108,71.66268771659607,6
0.2,2597,90,186198,71.66974595842956,12
0.2,2598,22,186220,71.65063485956136,11
0.2,2599,17,186237,71.62961538461539,16
0.2,2600,94,186331,71.63821607074202,7
0.2,2601,91,186422,71.6456571867794,14
0.2,2602,87,186509,71.65155589704187,15
0.2,2603,95,186604,71.6605222734255,7
0.2,2604,93,186697,71.66871401151631,8
0.2,2605,91,186788,71.67613200306984,11
0.2,2606,95,186883,71.68507863444572,7
0.2,2607,23,186906,71.66641104294479,10
0.2,2608,93,186999,71.67458796473744,9
0.2,2609,94,187093,71.68314176245211,7
0.2,2610,93,187186,71.69130601302183,8
0.2,2611,91,187277,71.69869831546707,11
0.2,2612,17,187294,71.6777650210486,17
0.2,2613,92,187386,71.68553940321347,11
0.2,2614,1,187387,71.6585086042065,37
0.2,2615,93,187480,71.66666666666667,9
0.2,2616,93,187573,71.6748184944593,9
0.2,2617,90,187663,71.68181818181819,11
0.2,2618,24,187687,71.66361206567392,9
0.2,2619,95,187782,71.67251908396946,6
0.2,2620,96,187878,71.68180083937429,6
0.2,2621,94,187972,71.69031273836765,7
0.2,2622,94,188066,71.69881814715974,8
0.2,2623,94,188160,71.70731707317073,8
0.2,2624,92,188252,71.71504761904762,9
0.2,2625,95,188347,71.72391469916222,6
0.2,2626,96,188443,71.73315569090217,6
0.2,2627,91,188534,71.74048706240487,11
0.2,2628,94,188628,71.7489539748954,8
0.2,2629,96,188724,71.75817490494296,7
0.2,2630,94,188818,71.76662865830482,8
0.2,2631,95,188913,71.77545592705167,7
0.2,2632,-46,188867,71.73072540827953,10
0.2,2633,91,188958,71.73804100227791,11
0.2,2634,90,189048,71.7449715370019,13
0.2,2635,95,189143,71.75379362670714,9
0.2,2636,-120,189023,71.68107698141827,17
0.2,2637,92,189115,71.68877937831691,11
0.2,2638,92,189207,71.69647593785525,9
0.2,2639,93,189300,71.70454545454545,9
0.2,2640,22,189322,71.68572510412723,12
0.2,2641,94,189416,71.69417108251325,9
0.2,2642,95,189511,71.70298902762013,6
0.2,2643,95,189606,71.71180030257186,8
0.2,2644,93,189699,71.71984877126654,10
0.2,2645,96,189795,71.72902494331066,6
0.2,2646,27,189822,71.71212693615414,6
0.2,2647,94,189916,71.72054380664653,7
0.2,2648,24,189940,71.70252925632315,9
0.2,2649,89,190029,71.70905660377359,15
0.2,2650,19,190048,71.68917389664277,14
0.2,2651,93,190141,71.697209653092,9
0.2,2652,93,190234,71.70523935167735,11
0.2,2653,20,190254,71.68575734740016,13
0.2,2654,91,190345,71.69303201506591,10
0.2,2655,93,190438,71.70105421686748,8
0.2,2656,94,190532,71.70944674444863,8
0.2,2657,94,190626,71.71783295711062,8
0.2,2658,92,190718,71.72546069951109,10
0.2,2659,93,190811,71.73345864661654,9
0.2,2660,92,190903,71.74107478391582,11
0.2,2661,86,190989,71.74643125469572,15
0.2,2662,94,191083,71.75478783327075,8
0.2,2663,96,191179,71.76388888888889,6
0.2,2664,92,191271,71.77148217636022,11
0.2,2665,96,191367,71.78057014253564,6
0.2,2666,92,191459,71.78815148106487,12
0.2,2667,22,191481,71.76949025487257,11
0.2,2668,95,191576,71.77819408017984,6
0.2,2669,25,191601,71.76067415730337,8
0.2,2670,94,191695,71.76900037439161,8
0.2,2671,93,191788,71.77694610778443,8
0.2,2672,92,191880,71.78451178451178,9
0.2,2673,95,191975,71.79319371727749,7
0.2,2674,91,192066,71.8003738317757,11
0.2,2675,94,192160,71.80866965620329,7
0.2,2676,92,192252,71.81621217781098,10
0.2,2677,93,192345,71.82412247946229,9
0.2,2678,95,192440,71.832773422919,7
0.2,2679,94,192534,71.8410447761194,8
0.2,2680,93,192627,71.84893696381947,8
0.2,2681,95,192722,71.85756897837435,7
0.2,2682,95,192817,71.86619455833022,7
0.2,2683,94,192911,71.87444113263786,8
0.2,2684,94,193005,71.88268156424581,8
0.2,2685,93,193098,71.89054355919583,10
0.2,2686,95,193193,71.89914402679568,7
0.2,2687,94,193287,71.90736607142857,9
0.2,2688,94,193381,71.91558200074377,8
0.2,2689,92,193473,71.92304832713755,15
0.2,2690,91,193564,71.93013749535488,10
0.2,2691,93,193657,71.93796433878157,8
0.2,2692,93,193750,71.94578536947643,9
0.2,2693,94,193844,71.9539717891611,8
0.2,2694,95,193939,71.96252319109462,7
0.2,2695,91,194030,71.96958456973294,11
0.2,2696,95,194125,71.97812384130515,7
0.2,2697,94,194219,71.98628613787992,8
0.2,2698,93,194312,71.9940718784735,9
0.2,2699,96,194408,72.00296296296297,6
0.2,2700,23,194431,71.98482043687522,10
0.2,2701,95,194526,71.99333826794967,6
0.2,2702,92,194618,72.00073991860896,11
0.2,2703,93,194711,72.00850591715977,9
0.2,2704,23,194734,71.99038817005545,9
0.2,2705,-47,194687,71.94641537324465,10
0.2,2706,88,194775,71.95234577022534,15
0.2,2707,96,194871,71.96122599704579,7
0.2,2708,94,194965,71.96936138796605,7
0.2,2709,93,195058,71.97712177121771,10
0.2,2710,91,195149,71.98413869420878,10
0.2,2711,95,195244,71.99262536873157,7
0.2,2712,93,195337,72.00036859565057,8
0.2,2713,96,195433,72.00921149594694,6
0.2,2714,92,195525,72.01657458563535,10
0.2,2715,94,195619,72.02466863033874,8
0.2,2716,95,195714,72.03312476996688,6
0.2,2717,93,195807,72.04083885209712,10
0.2,2718,88,195895,72.04670834865759,13
0.2,2719,96,195991,72.05551470588236,6
0.2,2720,94,196085,72.0635795663359,8
0.2,2721,21,196106,72.04481998530493,13
0.2,2722,95,196201,72.0532500918105,6
0.2,2723,91,196292,72.06020558002938,11
0.2,2724,94,196386,72.06825688073394,8
0.2,2725,94,196480,72.07630227439472,7
0.2,2726,90,196570,72.08287495416208,14
0.2,2727,93,196663,72.09054252199414,8
0.2,2728,93,196756,72.09820447050201,8
0.2,2729,95,196851,72.1065934065934,7
0.2,2730,94,196945,72.11461003295496,7
0.2,2731,93,197038,72.12225475841873,11
0.2,2732,93,197131,72.12989388949872,8
0.2,2733,96,197227,72.13862472567666,6
0.2,2734,18,197245,72.11882998171846,15
0.2,2735,96,197341,72.12755847953217,6
0.2,2736,90,197431,72.13408841797589,12
0.2,2737,94,197525,72.14207450693937,8
0.2,2738,93,197618,72.14968966776196,11
0.2,2739,22,197640,72.13138686131387,12
0.2,2740,96,197736,72.14009485589202,6
0.2,2741,94,197830,72.14806710430342,7
0.2,2742,92,197922,72.15530441122858,10
0.2,2743,-65,197857,72.10532069970846,29
0.2,2744,94,197951,72.11329690346084,8
0.2,2745,95,198046,72.12163146394757,7
0.2,2746,95,198141,72.12995995631599,7
0.2,2747,92,198233,72.13719068413391,10
0.2,2748,92,198325,72.14441615132776,10
0.2,2749,92,198417,72.15163636363637,10
0.2,2750,26,198443,72.13486005089058,7
0.2,2751,20,198463,72.11591569767442,13
0.2,2752,-46,198417,72.07301126044315,10
0.2,2753,22,198439,72.05482933914307,11
0.2,2754,93,198532,72.06243194192378,9
0.2,2755,27,198559,72.04608127721335,6
0.2,2756,95,198654,72.0544069640914,6
0.2,2757,95,198749,72.06272661348804,8
0.2,2758,94,198843,72.070677781805,10
0.2,2759,95,198938,72.07898550724637,7
0.2,2760,96,199034,72.08764940239044,6
0.2,2761,22,199056,72.06951484431572,11
0.2,2762,94,199150,72.07745204487875,7
0.2,2763,23,199173,72.05969609261939,10
0.2,2764,92,199265,72.06690777576854,9
0.2,2765,20,199285,72.04808387563268,15
0.2,2766,93,199378,72.05565594506686,9
0.2,2767,92,199470,72.0628612716763,11
0.2,2768,93,199563,72.07042253521126,8
0.2,2769,94,199657,72.0783393501805,7
0.2,2770,17,199674,72.05846264886323,16
0.2,2771,91,199765,72.06529581529581,11
0.2,2772,24,199789,72.04796249549224,10
0.2,2773,94,199883,72.05587599134823,7
0.2,2774,94,199977,72.06378378378379,8
0.2,2775,91,200068,72.07060518731988,11
0.2,2776,96,200164,72.07922218221101,6
0.2,2777,26,200190,72.06263498920086,7
0.2,2778,95,200285,72.07088880892407,7
0.2,2779,92,200377,72.07805755395684,9
0.2,2780,25,200402,72.0611290902553,8
0.2,2781,95,200497,72.06937455068297,9
0.2,2782,26,200523,72.05282069708947,9
0.2,2783,-50,200473,72.00897988505747,15
0.2,2784,-46,200427,71.96660682226212,10
0.2,2785,91,200518,71.97343862167983,10
0.2,2786,93,200611,71.98098313598852,9
0.2,2787,94,200705,71.98888091822094,7
0.2,2788,-52,200653,71.94442452491933,16
0.2,2789,95,200748,71.95268817204301,6
0.2,2790,94,200842,71.96058760300967,8
0.2,2791,94,200936,71.96848137535817,8
0.2,2792,22,200958,71.95059076262083,11
0.2,2793,26,200984,71.93414459556192,7
0.2,2794,94,201078,71.94203935599285,8
0.2,2795,93,201171,71.94957081545064,9
0.2,2796,94,201265,71.95745441544511,8
0.2,2797,94,201359,71.96533238027162,9
0.2,2798,94,201453,71.97320471596998,8
0.2,2799,23,201476,71.95571428571428,10
0.2,2800,92,201568,71.96287040342735,9
0.2,2801,95,201663,71.97109207708779,6
0.2,2802,94,201757,71.97895112379594,8
0.2,2803,94,201851,71.98680456490727,8
0.2,2804,90,201941,71.99322638146168,12
0.2,2805,93,202034,72.00071275837492,9
0.2,2806,25,202059,71.98396864980405,8
0.2,2807,95,202154,71.99216524216524,6
0.2,2808,22,202176,71.97436810252759,11
0.2,2809,93,202269,71.98185053380783,8
0.2,2810,94,202363,71.98968338669512,8
0.2,2811,93,202456,71.99715504978663,9
0.2,2812,20,202476,71.97867045858514,14
0.2,2813,94,202570,71.9864960909737,8
0.2,2814,25,202595,71.96980461811722,7
0.2,2815,21,202616,71.95170454545455,11
0.2,2816,94,202710,71.95953141640042,8
0.2,2817,92,202802,71.9666430092264,9
0.2,2818,95,202897,71.97481376374601,6
0.2,2819,93,202990,71.98226950354609,8
0.2,2820,88,203078,71.98794753633463,14
0.2,2821,92,203170,71.9950389794472,10
0.2,2822,95,203265,72.00318809776833,7
0.2,2823,95,203360,72.01133144475921,6
0.2,2824,93,203453,72.0187610619469,9
0.2,2825,93,203546,72.02618542108988,9
0.2,2826,95,203641,72.03431199151044,7
0.2,2827,95,203736,72.04243281471004,6
0.2,2828,93,203829,72.04984093319194,9
0.2,2829,93,203922,72.05724381625441,8
0.2,2830,93,204015,72.06464146944542,10
0.2,2831,96,204111,72.07309322033899,6
0.2,2832,90,204201,72.0794211083657,12
0.2,2833,95,204296,72.08750882145378,7
0.2,2834,94,204390,72.0952380952381,7
0.2,2835,93,204483,72.10260930888576,9
0.2,2836,94,204577,72.11032781106803,8
0.2,2837,95,204672,72.11839323467231,7
0.2,2838,94,204766,72.12610073969708,7
0.2,2839,25,204791,72.10950704225353,7
0.2,2840,95,204886,72.11756423794439,6
0.2,2841,95,204981,72.1256157635468,7
0.2,2842,94,205075,72.13330988392543,9
0.2,2843,93,205168,72.14064697609001,9
0.2,2844,92,205260,72.14762741652021,12
0.2,2845,94,205354,72.15530569219958,7
0.2,2846,25,205379,72.13874253600281,8
0.2,2847,94,205473,72.14641853932584,8
0.2,2848,94,205567,72.15408915408915,8
0.2,2849,95,205662,72.1621052631579,6
0.2,2850,92,205754,72.16906348649597,9
0.2,2851,95,205849,72.17706872370266,7
0.2,2852,-46,205803,72.13564668769716,11
0.2,2853,94,205897,72.14330763840225,8
0.2,2854,92,205989,72.15026269702277,10
0.2,2855,88,206077,72.15581232492997,14
0.2,2856,95,206172,72.16380819040953,6
0.2,2857,94,206266,72.17144856543037,7
0.2,2858,95,206361,72.1794333683106,6
0.2,2859,91,206452,72.18601398601399,11
0.2,2860,92,206544,72.19293953163229,9
0.2,2861,95,206639,72.20090845562544,6
0.2,2862,96,206735,72.20922109675166,6
0.2,2863,95,206830,72.21717877094972,7
0.2,2864,89,206919,72.22303664921466,12
0.2,2865,94,207013,72.23063503140266,8
0.2,2866,25,207038,72.21416114405302,8
0.2,2867,95,207133,72.2221059972106,7
0.2,2868,20,207153,72.20390379923319,15
0.2,2869,90,207243,72.21010452961673,13
0.2,2870,93,207336,72.21734587251828,10
0.2,2871,95,207431,72.22527855153203,6
0.2,2872,95,207526,72.23320570831883,7
0.2,2873,24,207550,72.21642310368824,9
0.2,2874,26,207576,72.20034782608695,7
0.2,2875,26,207602,72.18428372739916,7
0.2,2876,93,207695,72.19151894334377,9
0.2,2877,92,207787,72.19840166782488,11
0.2,2878,91,207878,72.20493226814867,11
0.2,2879,90,207968,72.21111111111111,14
0.2,2880,-126,207842,72.14231169732732,21
0.2,2881,91,207933,72.14885496183206,11
0.2,2882,95,208028,72.15678113076656,7
0.2,2883,96,208124,72.16504854368932,6
0.2,2884,95,208219,72.17296360485268,7
0.2,2885,93,208312,72.18018018018019,8
0.2,2886,89,208401,72.18600623484586,12
0.2,2887,92,208493,72.19286703601108,10
0.2,2888,96,208589,72.20110764970578,6
0.2,2889,93,208682,72.2083044982699,9
0.2,2890,26,208708,72.1923209961951,7
0.2,2891,96,208804,72.20055325034578,6
0.2,2892,91,208895,72.20705150362944,11
0.2,2893,93,208988,72.21423635107118,8
0.2,2894,91,209079,72.22072538860104,10
0.2,2895,92,209171,72.22755524861878,10
0.2,2896,89,209260,72.23334483948912,12
0.2,2897,96,209356,72.2415458937198,6
0.2,2898,88,209444,72.24698171783373,14
0.2,2899,95,209539,72.2548275862069,7
0.2,2900,95,209634,72.26266804550156,7
0.2,2901,25,209659,72.24638180565127,8
0.2,2902,94,209753,72.25387530141234,8
0.2,2903,92,209845,72.26067493112947,9
0.2,2904,24,209869,72.24406196213425,9
0.2,2905,93,209962,72.25120440467997,8
0.2,2906,89,210051,72.25696594427245,14
0.2,2907,95,210146,72.26478679504814,7
0.2,2908,23,210169,72.24785149535923,11
0.2,2909,94,210263,72.2553264604811,8
0.2,2910,95,210358,72.26313981449674,7
0.2,2911,21,210379,72.24553571428571,12
0.2,2912,92,210471,72.25231719876416,9
0.2,2913,95,210566,72.26012354152368,7
0.2,2914,94,210660,72.26758147512865,9
0.2,2915,21,210681,72.25,13
0.2,2916,24,210705,72.23345903325334,9
0.2,2917,96,210801,72.24160383824537,6
0.2,2918,20,210821,72.2237067488866,14
0.2,2919,93,210914,72.23082191780821,9
0.2,2920,95,211009,72.23861691201644,6
0.2,2921,96,211105,72.24674880219028,6
0.2,2922,92,211197,72.2535066712282,10
0.2,2923,96,211293,72.26162790697674,7
0.2,2924,95,211388,72.2694017094017,7
0.2,2925,94,211482,72.27682843472317,7
0.2,2926,95,211577,72.28459173214895,7
0.2,2927,91,211668,72.29098360655738,11
0.2,2928,-121,211547,72.2249914646637,19
0.2,2929,95,211642,72.23276450511945,7
0.2,2930,95,211737,72.24053224155578,6
0.2,2931,90,211827,72.24658935879945,11
0.2,2932,92,211919,72.25332424139107,10
0.2,2933,24,211943,72.23687798227675,9
0.2,2934,95,212038,72.24463373083475,6
0.2,2935,-54,211984,72.2016348773842,18
0.2,2936,94,212078,72.20905686074225,8
0.2,2937,95,212173,72.21681415929204,7
0.2,2938,23,212196,72.20006805035726,10
0.2,2939,93,212289,72.20714285714286,9
0.2,2940,-53,212236,72.16456987419245,18
0.2,2941,94,212330,72.17199184228416,8
0.2,2942,95,212425,72.17974855589534,6
0.2,2943,95,212520,72.1875,9
0.2,2944,94,212614,72.19490662139219,7
0.2,2945,94,212708,72.20230821452817,8
0.2,2946,96,212804,72.21038344078724,6
0.2,2947,92,212896,72.21709633649932,9
0.2,2948,23,212919,72.20040691759918,10
0.2,2949,95,213014,72.20813559322033,7
0.2,2950,93,213107,72.21518129447645,11
0.2,2951,92,213199,72.22188346883469,9
0.2,2952,92,213291,72.22858110396207,11
0.2,2953,86,213377,72.23324306025728,15
0.2,2954,23,213400,72.2165820642978,9
0.2,2955,95,213495,72.22428958051421,7
0.2,2956,91,213586,72.23063916131214,10
0.2,2957,95,213681,72.23833671399595,6
0.2,2958,92,213773,72.24501520784048,9
0.2,2959,95,213868,72.2527027027027,6
0.2,2960,95,213963,72.26038500506586,7
0.2,2961,91,214054,72.26671168129643,10
0.2,2962,93,214147,72.27370907863651,8
0.2,2963,23,214170,72.25708502024291,10
0.2,2964,91,214261,72.26340640809444,10
0.2,2965,22,214283,72.2464598786244,11
0.2,2966,94,214377,72.25379170879677,8
0.2,2967,95,214472,72.26145552560646,7
0.2,2968,96,214568,72.26945099360054,6
0.2,2969,94,214662,72.27676767676768,8
0.2,2970,22,214684,72.25984516997644,12
0.2,2971,93,214777,72.26682368775235,8
0.2,2972,92,214869,72.27346115035319,10
0.2,2973,95,214964,72.28110289172831,7
0.2,2974,95,215059,72.28873949579832,6
0.2,2975,94,215153,72.29603494623656,8
0.2,2976,93,215246,72.30298958683238,9
0.2,2977,22,215268,72.28609805238415,12
0.2,2978,94,215362,72.29338704263175,7
0.2,2979,90,215452,72.29932885906041,11
0.2,2980,95,215547,72.3069439785307,8
0.2,2981,24,215571,72.2907444668008,8
0.2,2982,24,215595,72.27455581629232,8
0.2,2983,94,215689,72.281836461126,8
0.2,2984,21,215710,72.26465661641541,13
0.2,2985,24,215734,72.24849296718017,9
0.2,2986,89,215823,72.25410110478741,12
0.2,2987,93,215916,72.26104417670683,9
0.2,2988,92,216008,72.26764804282368,11
0.2,2989,93,216101,72.27458193979933,9
0.2,2990,24,216125,72.2584419926446,10
0.2,2991,93,216218,72.2653743315508,8
0.2,2992,93,216311,72.27230203808887,8
0.2,2993,92,216403,72.27889111556446,9
0.2,2994,22,216425,72.26210350584307,11
0.2,2995,95,216520,72.26969292389853,7
0.2,2996,94,216614,72.27694361027694,8
0.2,2997,95,216709,72.28452301534357,7
0.2,2998,95,216804,72.29209736578859,7
0.2,2999,94,216898,72.29933333333334,7
0.2,3000,93,216991,72.30623125624791,9
0.2,3001,95,217086,72.31379080612925,7
0.2,3002,95,217181,72.32134532134532,7
0.2,3003,94,217275,72.32856191744341,10
0.2,3004,93,217368,72.33544093178037,9
0.2,3005,95,217463,72.34298070525615,8
0.2,3006,96,217559,72.35084802128367,7
0.2,3007,96,217655,72.35871010638297,6
0.2,3008,91,217746,72.36490528414755,11
0.2,3009,86,217832,72.36943521594685,16
0.2,3010,95,217927,72.37695117901029,7
0.2,3011,91,218018,72.38313413014608,10
0.2,3012,94,218112,72.39030866246266,10
0.2,3013,93,218205,72.39714664897147,9
0.2,3014,95,218300,72.40464344941957,7
0.2,3015,92,218392,72.41114058355437,9
0.2,3016,89,218481,72.41663904540934,14
0.2,3017,95,218576,72.42412193505633,6
0.2,3018,93,218669,72.4309373964889,9
0.2,3019,92,218761,72.43741721854305,10
0.2,3020,95,218856,72.44488579940418,7
0.2,3021,91,218947,72.45102581072138,13
0.2,3022,90,219037,72.45683096261992,13
0.2,3023,95,219132,72.46428571428571,7
0.2,3024,91,219223,72.4704132231405,11
0.2,3025,25,219248,72.45472571050892,8
0.2,3026,21,219269,72.4377271225636,12
0.2,3027,96,219365,72.44550858652576,6
0.2,3028,17,219382,72.42720369758996,16
0.2,3029,92,219474,72.43366336633663,11
0.2,3030,23,219497,72.41735400857803,10
0.2,3031,23,219520,72.40105540897098,10
0.2,3032,91,219611,72.40718760303331,12
0.2,3033,93,219704,72.41397495056032,9
0.2,3034,-117,219587,72.3515650741351,12
0.2,3035,95,219682,72.35902503293808,7
0.2,3036,20,219702,72.34178465591044,13
0.2,3037,95,219797,72.34924292297565,7
0.2,3038,13,219810,72.32971372161896,21
0.2,3039,23,219833,72.31348684210526,10
0.2,3040,94,219927,72.32061821769155,8
0.2,3041,95,220022,72.32807363576595,6
0.2,3042,95,220117,72.3355241537956,8
0.2,3043,23,220140,72.31931668856767,11
0.2,3044,94,220234,72.32643678160919,7
0.2,3045,25,220259,72.31089954038083,8
0.2,3046,95,220354,72.31834591401379,7
0.2,3047,91,220445,72.3244750656168,11
0.2,3048,93,220538,72.33125614955723,8
0.2,3049,94,220632,72.3383606557377,9
0.2,3050,24,220656,72.32251720747296,9
0.2,3051,25,220681,72.3070117955439,9
0.2,3052,90,220771,72.3128070750082,11
0.2,3053,95,220866,72.32023575638507,6
0.2,3054,89,220955,72.32569558101473,12
0.2,3055,95,221050,72.33311518324608,7
0.2,3056,90,221140,72.33889434085705,12
0.2,3057,20,221160,72.32177894048398,12
0.2,3058,94,221254,72.3288656423668,8
0.2,3059,93,221347,72.33562091503268,9
0.2,3060,89,221436,72.34106501143417,12
0.2,3061,93,221529,72.34781188765513,8
0.2,3062,21,221550,72.33104799216454,12
0.2,3063,88,221638,72.33616187989556,15
0.2,3064,93,221731,72.34290375203915,8
0.2,3065,24,221755,72.32713633398565,11
0.2,3066,94,221849,72.33420280404304,8
0.2,3067,85,221934,72.33833116036506,16
0.2,3068,92,222026,72.34473769957641,10
0.2,3069,21,222047,72.32801302931595,12
0.2,3070,94,222141,72.3350700097688,8
0.2,3071,27,222168,72.3203125,6
0.2,3072,92,222260,72.32671656361862,9
0.2,3073,96,222356,72.33441769681197,6
0.2,3074,94,222450,72.34146341463415,7
0.2,3075,91,222541,72.34752925877763,11
0.2,3076,95,222636,72.35489112772181,9
0.2,3077,93,222729,72.3615984405458,8
0.2,3078,96,222825,72.36927573887625,6
0.2,3079,95,222920,72.37662337662337,7
0.2,3080,95,223015,72.38396624472574,8
0.2,3081,93,223108,72.39065541855938,9
0.2,3082,95,223203,72.39798897178073,7
0.2,3083,94,223297,72.40499351491569,7
0.2,3084,-47,223250,72.36628849270664,11
0.2,3085,90,223340,72.37200259235256,12
0.2,3086,91,223431,72.37803692905733,10
0.2,3087,93,223524,72.38471502590673,9
0.2,3088,94,223618,72.39171252832632,8
0.2,3089,20,223638,72.3747572815534,14
0.2,3090,25,223663,72.35943060498221,8
0.2,3091,21,223684,72.34282018111254,12
0.2,3092,92,223776,72.34917555771096,9
0.2,3093,95,223871,72.35649644473173,7
0.2,3094,89,223960,72.36187399030695,14
0.2,3095,94,224054,72.36886304909561,8
0.2,3096,92,224146,72.37520180820148,9
0.2,3097,23,224169,72.35926404131698,10
0.2,3098,94,224263,72.36624717650855,9
0.2,3099,91,224354,72.37225806451613,10
0.2,3100,94,224448,72.37923250564334,7
0.2,3101,91,224539,72.38523533204385,10
0.2,3102,94,224633,72.39220109571383,7
0.2,3103,92,224725,72.39851804123711,10
0.2,3104,93,224818,72.40515297906602,9
0.2,3105,94,224912,72.41210560206052,8
0.2,3106,90,225002,72.41776633408432,12
0.2,3107,94,225096,72.42471042471043,7
0.2,3108,23,225119,72.40881312319074,10
0.2,3109,25,225144,72.39356913183279,7
0.2,3110,96,225240,72.40115718418515,6
0.2,3111,95,225335,72.40841902313625,7
0.2,3112,20,225355,72.39158368133633,13
0.2,3113,95,225450,72.39884393063583,6
0.2,3114,96,225546,72.40642054574639,6
0.2,3115,91,225637,72.41238767650835,10
0.2,3116,93,225730,72.41899262111004,9
0.2,3117,96,225826,72.4265554842848,6
0.2,3118,-49,225777,72.387624238538,13
0.2,3119,87,225864,72.3923076923077,15
0.2,3120,93,225957,72.39891060557514,9
0.2,3121,94,226051,72.40582959641256,8
0.2,3122,95,226146,72.41306436119116,6
0.2,3123,93,226239,72.4196542893726,8
0.2,3124,26,226265,72.4048,7
0.2,3125,95,226360,72.41202815099169,7
0.2,3126,95,226455,72.41925167892549,7
0.2,3127,93,226548,72.42583120204604,9
0.2,3128,95,226643,72.43304570150208,7
0.2,3129,92,226735,72.43929712460064,9
0.2,3130,96,226831,72.44682210156499,7
0.2,3131,92,226923,72.45306513409962,10
0.2,3132,96,227019,72.46058091286307,6
0.2,3133,92,227111,72.46681557115507,9
0.2,3134,96,227207,72.47432216905901,6
0.2,3135,91,227298,72.48022959183673,11
0.2,3136,16,227314,72.46222505578578,17
0.2,3137,18,227332,72.44486934353091,14
0.2,3138,95,227427,72.45205479452055,6
0.2,3139,95,227522,72.4592356687898,7
0.2,3140,95,227617,72.46641197070997,6
0.2,3141,17,227634,72.44875875238701,15
0.2,3142,88,227722,72.45370664969774,18
0.2,3143,94,227816,72.46055979643766,9
0.2,3144,95,227911,72.46772655007949,6
0.2,3145,25,227936,72.45263827082009,8
0.2,3146,95,228031,72.45980298697172,7
0.2,3147,95,228126,72.46696315120711,6
0.2,3148,95,228221,72.47411876786282,6
0.2,3149,95,228316,72.48126984126984,6
0.2,3150,95,228411,72.48841637575373,6
0.2,3151,23,228434,72.47271573604061,10
0.2,3152,89,228523,72.4779575007929,12
0.2,3153,96,228619,72.4854153455929,6
0.2,3154,92,228711,72.49160063391442,10
0.2,3155,95,228806,72.49873257287706,6
0.2,3156,89,228895,72.50395945517897,14
0.2,3157,92,228987,72.51013299556682,9
0.2,3158,95,229082,72.51725229503008,6
0.2,3159,93,229175,72.52373417721519,9
0.2,3160,91,229266,72.52957924707371,10
0.2,3161,94,229360,72.53636938646426,7
0.2,3162,90,229450,72.5418906101802,12
0.2,3163,95,229545,72.54898862199747,6
0.2,3164,92,229637,72.55513428120064,9
0.2,3165,22,229659,72.53916614024006,11
0.2,3166,94,229753,72.54594253236502,8
0.2,3167,95,229848,72.5530303030303,7
0.2,3168,92,229940,72.55916692963079,10
0.2,3169,95,230035,72.56624605678233,6
0.2,3170,92,230127,72.57237464522233,11
0.2,3171,21,230148,72.5561160151324,12
0.2,3172,90,230238,72.56161361487551,12
0.2,3173,93,230331,72.56805293005671,11
0.2,3174,95,230426,72.57511811023622,6
0.2,3175,20,230446,72.55856423173803,13
0.2,3176,94,230540,72.56531318854265,9
0.2,3177,91,230631,72.5711139081183,11
0.2,3178,93,230724,72.57754010695187,9
0.2,3179,94,230818,72.58427672955975,7
0.2,3180,95,230913,72.59132348318138,7
0.2,3181,25,230938,72.57636706473916,8
0.2,3182,95,231033,72.58341187558906,7
0.2,3183,92,231125,72.58951005025126,10
0.2,3184,94,231219,72.59623233908948,7
0.2,3185,90,231309,72.60169491525424,11
0.2,3186,94,231403,72.60840916222152,8
0.2,3187,18,231421,72.59127979924718,15
0.2,3188,94,231515,72.59799310128567,7
0.2,3189,95,231610,72.60501567398119,7
0.2,3190,23,231633,72.58947038545911,10
0.2,3191,94,231727,72.59617794486215,8
0.2,3192,-45,231682,72.55934857500783,9
0.2,3193,84,231766,72.56293049467752,17
0.2,3194,95,231861,72.5699530516432,6
0.2,3195,96,231957,72.57728410513141,6
0.2,3196,95,232052,72.58429777916797,6
0.2,3197,11,232063,72.5650406504065,24
0.2,3198,96,232159,72.5723663644889,6
0.2,3199,24,232183,72.5571875,9
0.2,3200,95,232278,72.56419868791002,7
0.2,3201,91,232369,72.56995627732667,11
0.2,3202,93,232462,72.57633468623166,9
0.2,3203,92,232554,72.58239700374531,9
0.2,3204,96,232650,72.58970358814352,6
0.2,3205,96,232746,72.59700561447286,6
0.2,3206,89,232835,72.60212036170876,12
0.2,3207,92,232927,72.60816708229426,10
0.2,3208,95,233022,72.61514490495482,7
0.2,3209,23,233045,72.59968847352025,10
0.2,3210,96,233141,72.60697601993148,6
0.2,3211,94,233235,72.61363636363636,8
0.2,3212,93,233328,72.61998132586368,8
0.2,3213,22,233350,72.60423148724331,12
0.2,3214,93,233443,72.61057542768273,8
0.2,3215,24,233467,72.59546019900498,10
0.2,3216,90,233557,72.60087037612682,12
0.2,3217,94,233651,72.60752019888129,8
0.2,3218,95,233746,72.61447654551102,7
0.2,3219,19,233765,72.59782608695652,13
0.2,3220,96,233861,72.60509158646383,6
0.2,3221,94,233955,72.61173184357541,7
0.2,3222,26,233981,72.59726962457339,7
0.2,3223,26,234007,72.58281637717121,9
0.2,3224,95,234102,72.58976744186046,7
0.2,3225,24,234126,72.57470551766895,10
0.2,3226,95,234221,72.58165478772854,6
0.2,3227,92,234313,72.58767038413879,11
0.2,3228,87,234400,72.59213378755032,14
0.2,3229,95,234495,72.59907120743034,6
0.2,3230,91,234586,72.6047663262148,13
0.2,3231,95,234681,72.61169554455445,6
0.2,3232,89,234770,72.61676461490876,14
0.2,3233,94,234864,72.62337662337663,8
0.2,3234,93,234957,72.62967542503864,9
0.2,3235,96,235053,72.63689740420271,6
0.2,3236,95,235148,72.64380599320359,7
0.2,3237,26,235174,72.62940086473131,7
0.2,3238,93,235267,72.63569002778635,10
0.2,3239,95,235362,72.64259259259259,6
0.2,3240,94,235456,72.6491823511262,8
0.2,3241,91,235547,72.65484268969772,11
0.2,3242,26,235573,72.6404563675609,7
0.2,3243,96,235669,72.64765721331689,6
0.2,3244,-44,235625,72.61171032357473,8
0.2,3245,93,235718,72.61799137399876,9
0.2,3246,94,235812,72.62457653218355,7
0.2,3247,89,235901,72.62961822660098,12
0.2,3248,94,235995,72.63619575253924,8
0.2,3249,90,236085,72.64153846153846,12
0.2,3250,95,236180,72.64841587203938,6
0.2,3251,96,236276,72.65559655596556,6
0.2,3252,90,236366,72.66092837380879,11
0.2,3253,93,236459,72.66717885679164,9
0.2,3254,19,236478,72.65069124423964,14
0.2,3255,93,236571,72.65694103194103,10
0.2,3256,90,236661,72.66226588885478,12
0.2,3257,94,236755,72.66881522406385,7
0.2,3258,87,236842,72.6732126419147,15
0.2,3259,93,236935,72.67944785276073,9
0.2,3260,91,237026,72.68506593069611,11
0.2,3261,91,237117,72.69068056407112,12
0.2,3262,91,237208,72.69629175605272,10
0.2,3263,95,237303,72.703125,6
0.2,3264,88,237391,72.70781010719755,13
0.2,3265,22,237413,72.69228413962033,10
0.2,3266,96,237509,72.69941842669115,6
0.2,3267,94,237603,72.70593635250918,8
0.2,3268,23,237626,72.69073111043133,10
0.2,3269,93,237719,72.69694189602447,8
0.2,3270,20,237739,72.68083154998472,13
0.2,3271,93,237832,72.68704156479218,9
0.2,3272,-51,237781,72.64925145126794,17
0.2,3273,-46,237735,72.61301160659744,10
0.2,3274,93,237828,72.61923664122138,8
0.2,3275,94,237922,72.62576312576313,9
0.2,3276,90,238012,72.63106499847422,13
0.2,3277,95,238107,72.6378889566809,6
0.2,3278,93,238200,72.64409881061299,11
0.2,3279,91,238291,72.64969512195123,11
0.2,3280,95,238386,72.65650716245047,8
0.2,3281,94,238480,72.66301035953687,7
0.2,3282,91,238571,72.66859579652757,12
0.2,3283,95,238666,72.6753958587089,6
0.2,3284,94,238760,72.68188736681887,7
0.2,3285,95,238855,72.68867924528301,7
0.2,3286,95,238950,72.69546699117737,6
0.2,3287,23,238973,72.68035279805353,10
0.2,3288,93,239066,72.68653086044391,10
0.2,3289,94,239160,72.69300911854103,7
0.2,3290,90,239250,72.6982680036463,11
0.2,3291,21,239271,72.6825637910085,13
0.2,3292,90,239361,72.68782265411478,11
0.2,3293,93,239454,72.69398907103825,10
0.2,3294,18,239472,72.6773899848255,19
0.2,3295,95,239567,72.68416262135922,6
0.2,3296,27,239594,72.67030633909614,6
0.2,3297,95,239689,72.67707701637356,6
0.2,3298,94,239783,72.68354046680813,8
0.2,3299,96,239879,72.69060606060606,7
0.2,3300,94,239973,72.69706149651621,8
0.2,3301,19,239992,72.68079951544519,14
0.2,3302,95,240087,72.68755676657584,7
0.2,3303,92,240179,72.693401937046,9
0.2,3304,17,240196,72.67655068078669,16
0.2,3305,8,240204,72.65698729582577,27
0.2,3306,90,240294,72.66223162987602,11
0.2,3307,90,240384,72.66747279322854,11
0.2,3308,93,240477,72.67361740707162,9
0.2,3309,95,240572,72.68036253776435,7
0.2,3310,20,240592,72.66445182724253,14
0.2,3311,94,240686,72.67089371980677,8
0.2,3312,27,240713,72.65710836100212,6
0.2,3313,92,240805,72.66294508147254,10
0.2,3314,94,240899,72.66938159879336,10
0.2,3315,84,240983,72.67279855247286,19
0.2,3316,93,241076,72.67892674103105,8
0.2,3317,95,241171,72.68565400843882,7
0.2,3318,95,241266,72.69237722205483,8
0.2,3319,92,241358,72.69819277108434,10
0.2,3320,91,241449,72.70370370370371,12
0.2,3321,93,241542,72.7098133654425,8
0.2,3322,95,241637,72.71652121576888,6
0.2,3323,96,241733,72.72352587244283,6
0.2,3324,89,241822,72.72842105263157,14
0.2,3325,95,241917,72.73511725796753,6
0.2,3326,25,241942,72.72076946197775,8
0.2,3327,93,242035,72.72686298076923,9
0.2,3328,92,242127,72.73265244818263,10
0.2,3329,93,242220,72.73873873873873,9
0.2,3330,93,242313,72.74482137496247,9
0.2,3331,19,242332,72.72869147659064,13
0.2,3332,22,242354,72.71347134713471,11
0.2,3333,88,242442,72.71805638872226,13
0.2,3334,93,242535,72.72413793103448,9
0.2,3335,91,242626,72.72961630695444,11
0.2,3336,23,242649,72.71471381480372,10
0.2,3337,95,242744,72.72139005392451,7
0.2,3338,26,242770,72.70739742437856,7
0.2,3339,93,242863,72.71347305389222,9
0.2,3340,94,242957,72.71984435797665,8
0.2,3341,95,243052,72.72651107121484,7
0.2,3342,95,243147,72.73317379599162,6
0.2,3343,94,243241,72.73953349282297,7
0.2,3344,93,243334,72.7455904334828,10
0.2,3345,93,243427,72.7516437537358,9
0.2,3346,95,243522,72.75829100687183,8
0.2,3347,95,243617,72.76493428912784,6
0.2,3348,25,243642,72.75067184234099,9
0.2,3349,93,243735,72.75671641791045,8
0.2,3350,24,243759,72.74216651745748,8
0.2,3351,92,243851,72.74791169451073,10
0.2,3352,93,243944,72.75395168505815,8
0.2,3353,96,244040,72.76088252832439,6
0.2,3354,-47,243993,72.72518628912071,11
0.2,3355,26,244019,72.71126340882003,6
0.2,3356,92,244111,72.71700923443551,9
0.2,3357,95,244206,72.72364502680166,7
0.2,3358,87,244293,72.72789520690682,17
0.2,3359,93,244386,72.73392857142858,9
0.2,3360,95,244481,72.74055340672419,7
0.2,3361,23,244504,72.72575847709696,10
0.2,3362,93,244597,72.73178709485579,9
0.2,3363,95,244692,72.73840665873959,7
0.2,3364,92,244784,72.74413075780089,10
0.2,3365,91,244875,72.74955436720143,10
0.2,3366,91,244966,72.75497475497475,14
0.2,3367,92,245058,72.7606888361045,10
0.2,3368,93,245151,72.766696349065,8
0.2,3369,94,245245,72.77299703264094,7
0.2,3370,87,245332,72.77721744289528,15
0.2,3371,93,245425,72.7832147093713,8
0.2,3372,-50,245375,72.74681292617848,13
0.2,3373,90,245465,72.75192649673977,13
0.2,3374,92,245557,72.75762962962963,10
0.2,3375,90,245647,72.76273696682465,13
0.2,3376,95,245742,72.7693218833284,6
0.2,3377,92,245834,72.77501480165779,11
0.2,3378,94,245928,72.78129624149156,7
0.2,3379,94,246022,72.78757396449704,7
0.2,3380,23,246045,72.77284826974268,9
0.2,3381,94,246139,72.77912477823773,8
0.2,3382,26,246165,72.7652970736033,7
0.2,3383,21,246186,72.75,12
0.2,3384,94,246280,72.75627769571639,7
0.2,3385,92,246372,72.76196101594802,9
0.2,3386,95,246467,72.76852671981104,6
0.2,3387,-121,246346,72.71133412042504,16
0.2,3388,95,246441,72.7179108881676,7
0.2,3389,93,246534,72.72389380530973,9
0.2,3390,24,246558,72.70952521380124,9
0.2,3391,95,246653,72.7160966981132,7
0.2,3392,22,246675,72.70114942528735,13
0.2,3393,88,246763,72.70565704183853,14
0.2,3394,91,246854,72.71104565537556,10
0.2,3395,91,246945,72.71643109540636,11
0.2,3396,93,247038,72.72240211951723,8
0.2,3397,95,247133,72.72895821071218,6
0.2,3398,91,247224,72.73433362753751,12
0.2,3399,21,247245,72.71911764705882,13
0.2,3400,89,247334,72.72390473390179,13
0.2,3401,26,247360,72.71017048794826,7
0.2,3402,95,247455,72.71672054069938,8
0.2,3403,-197,247258,72.63748531139835,23
0.2,3404,94,247352,72.64375917767988,7
0.2,3405,15,247367,72.62683499706401,19
0.2,3406,26,247393,72.61314939829762,7
0.2,3407,94,247487,72.6194248826291,9
0.2,3408,94,247581,72.62569668524495,8
0.2,3409,94,247675,72.63196480938416,7
0.2,3410,94,247769,72.63822925828202,8
0.2,3411,92,247861,72.64390386869871,10
0.2,3412,25,247886,72.62994433050102,8
0.2,3413,95,247981,72.63649677797305,6
0.2,3414,93,248074,72.64245973645681,8
0.2,3415,95,248169,72.64900468384074,7
0.2,3416,23,248192,72.63447468539654,10
0.2,3417,92,248284,72.64014043300176,12
0.2,3418,94,248378,72.64638783269962,8
0.2,3419,22,248400,72.63157894736842,10
0.2,3420,26,248426,72.61794796843029,7
0.2,3421,96,248522,72.62478082992402,6
0.2,3422,93,248615,72.63073327490505,9
0.2,3423,96,248711,72.63755841121495,6
0.2,3424,92,248803,72.64321167883212,10
0.2,3425,96,248899,72.65002918855808,6
0.2,3426,95,248994,72.65655091917128,6
0.2,3427,-49,248945,72.6210618436406,13
0.2,3428,95,249040,72.6275882181394,6
0.2,3429,96,249136,72.63440233236152,6
0.2,3430,93,249229,72.64033809385019,9
0.2,3431,94,249323,72.64656177156178,8
0.2,3432,-45,249278,72.61229245557821,9
0.2,3433,94,249372,72.61852067559697,8
0.2,3434,96,249468,72.62532751091703,6
0.2,3435,91,249559,72.63067520372526,12
0.2,3436,93,249652,72.63660168751818,9
0.2,3437,94,249746,72.64281559045956,9
0.2,3438,92,249838,72.64844431520791,10
0.2,3439,92,249930,72.65406976744185,9
0.2,3440,96,250026,72.66085440278988,6
0.2,3441,95,250121,72.66734456711214,7
0.2,3442,26,250147,72.6537902991577,6
0.2,3443,-50,250097,72.61817653890824,14
0.2,3444,24,250121,72.60406386066764,9
0.2,3445,94,250215,72.61027278003482,8
0.2,3446,93,250308,72.61618798955614,8
0.2,3447,96,250404,72.62296983758701,6
0.2,3448,92,250496,72.62858799652074,10
0.2,3449,94,250590,72.63478260869566,7
0.2,3450,95,250685,72.64126340191248,7
0.2,3451,90,250775,72.646292004635,11
0.2,3452,26,250801,72.63278308717058,7
0.2,3453,94,250895,72.63896931094384,8
0.2,3454,27,250922,72.62575976845152,6
0.2,3455,87,251009,72.62991898148148,14
0.2,3456,-47,250962,72.59531385594445,11
0.2,3457,23,250985,72.58097165991903,12
0.2,3458,94,251079,72.58716392020816,7
0.2,3459,95,251174,72.59364161849712,6
0.2,3460,18,251192,72.57786766830395,14
0.2,3461,23,251215,72.56354708261121,10
0.2,3462,95,251310,72.57002598902686,7
0.2,3463,94,251404,72.57621247113164,9
0.2,3464,95,251499,72.58268398268399,6
0.2,3465,89,251588,72.58742065781881,12
0.2,3466,91,251679,72.59273146812806,10
0.2,3467,95,251774,72.59919261822375,6
0.2,3468,94,251868,72.60536177572787,8
0.2,3469,92,251960,72.61095100864553,10
0.2,3470,95,252055,72.6174013252665,6
0.2,3471,95,252150,72.62384792626727,7
0.2,3472,95,252245,72.63029081485747,7
0.2,3473,96,252341,72.6370178468624,6
0.2,3474,93,252434,72.64287769784173,8
0.2,3475,95,252529,72.64930955120829,8
0.2,3476,96,252625,72.65602530917458,6
0.2,3477,93,252718,72.66187464059804,9
0.2,3478,94,252812,72.66800804828974,8
0.2,3479,89,252901,72.6727011494253,12
0.2,3480,-119,252782,72.61763860959495,13
0.2,3481,95,252877,72.62406662837449,6
0.2,3482,91,252968,72.62934252081538,11
0.2,3483,95,253063,72.6357634902411,7
0.2,3484,95,253158,72.64218077474892,6
0.2,3485,87,253245,72.64629948364887,15
0.2,3486,22,253267,72.63177516489819,12
0.2,3487,92,253359,72.63732798165138,9
0.2,3488,94,253453,72.64345084551448,7
0.2,3489,96,253549,72.65014326647564,6
0.2,3490,88,253637,72.65454024634775,15
0.2,3491,96,253733,72.66122565864833,6
0.2,3492,95,253828,72.6676209561981,8
0.2,3493,92,253920,72.67315397824842,9
0.2,3494,88,254008,72.67753934191703,14
0.2,3495,93,254101,72.683352402746,9
0.2,3496,26,254127,72.67000285959394,8
0.2,3497,20,254147,72.65494568324758,12
0.2,3498,95,254242,72.66133180908831,7
0.2,3499,91,254333,72.66657142857143,10
0.2,3500,93,254426,72.67237932019422,9
0.2,3501,87,254513,72.67647058823529,15
0.2,3502,96,254609,72.68312874678847,6
0.2,3503,-50,254559,72.64811643835617,14
0.2,3504,94,254653,72.65420827389444,8
0.2,3505,17,254670,72.63833428408442,16
0.2,3506,95,254765,72.64471057884232,8
0.2,3507,18,254783,72.62913340935006,14
0.2,3508,92,254875,72.6346537475064,10
0.2,3509,89,254964,72.63931623931624,13
0.2,3510,15,254979,72.62289945884363,18
0.2,3511,95,255074,72.62927107061503,7
0.2,3512,94,255168,72.63535439795046,9
0.2,3513,90,255258,72.64029595902106,11
0.2,3514,90,255348,72.6452347083926,11
0.2,3515,93,255441,72.65102389078498,8
0.2,3516,25,255466,72.63747512084163,9
0.2,3517,94,255560,72.6435474701535,7
0.2,3518,18,255578,72.6280193236715,15
0.2,3519,93,255671,72.63380681818182,9
0.2,3520,93,255764,72.63959102527691,8
0.2,3521,-120,255644,72.58489494605338,15
0.2,3522,96,255740,72.59154130002838,6
0.2,3523,21,255761,72.57690124858115,12
0.2,3524,93,255854,72.58269503546099,8
0.2,3525,92,255946,72.5882019285309,9
0.2,3526,93,256039,72.59398922597109,8
0.2,3527,93,256132,72.59977324263039,8
0.2,3528,94,256226,72.60583734769057,7
0.2,3529,96,256322,72.61246458923513,6
0.2,3530,-192,256130,72.53752478051544,18
0.2,3531,91,256221,72.54275198187996,11
0.2,3532,94,256315,72.5488253608831,9
0.2,3533,-58,256257,72.51188455008489,21
0.2,3534,95,256352,72.51824611032532,7
0.2,3535,94,256446,72.52432126696833,9
0.2,3536,95,256541,72.53067571388182,6
0.2,3537,16,256557,72.51469756924816,17
0.2,3538,21,256578,72.50014128284826,11
0.2,3539,93,256671,72.50593220338983,9
0.2,3540,90,256761,72.51087263484891,12
0.2,3541,94,256855,72.51693958215698,8
0.2,3542,22,256877,72.50268134349422,11
0.2,3543,95,256972,72.50902934537245,6
0.2,3544,94,257066,72.5150916784203,9
0.2,3545,88,257154,72.51945854483925,16
0.2,3546,95,257249,72.52579644770228,7
0.2,3547,95,257344,72.53213077790305,6
0.2,3548,-52,257292,72.49704142011835,17
0.2,3549,95,257387,72.50338028169014,7
0.2,3550,91,257478,72.50858912982258,12
0.2,3551,90,257568,72.51351351351352,15
0.2,3552,23,257591,72.49957782155924,10
0.2,3553,24,257615,72.48593134496342,8
0.2,3554,92,257707,72.49142053445851,10
0.2,3555,95,257802,72.49775028121485,7
0.2,3556,95,257897,72.5040764689345,8
0.2,3557,93,257990,72.5098369870714,9
0.2,3558,94,258084,72.51587524585558,8
0.2,3559,95,258179,72.52219101123596,7
0.2,3560,95,258274,72.52850322942993,6
0.2,3561,95,258369,72.53481190342504,7
0.2,3562,94,258463,72.54083637384227,8
0.2,3563,96,258559,72.54741863075196,6
0.2,3564,94,258653,72.55343618513324,8
0.2,3565,95,258748,72.55973079080202,6
0.2,3566,95,258843,72.56602186711523,8
0.2,3567,89,258932,72.57062780269058,14
0.2,3568,95,259027,72.57691230036424,6
0.2,3569,96,259123,72.58347338935575,6
0.2,3570,26,259149,72.57042845141417,7
0.2,3571,87,259236,72.57446808510639,15
0.2,3572,94,259330,72.58046459557795,7
0.2,3573,-50,259280,72.54616675993285,14
0.2,3574,93,259373,72.55188811188812,8
0.2,3575,94,259467,72.55788590604027,7
0.2,3576,95,259562,72.56415991053956,6
0.2,3577,90,259652,72.56903297931805,12
0.2,3578,95,259747,72.57530036322996,8
0.2,3579,26,259773,72.5622905027933,8
0.2,3580,95,259868,72.56855626919855,7
0.2,3581,90,259958,72.57342266890005,13
0.2,3582,17,259975,72.55791236394083,16
0.2,3583,90,260065,72.56277901785714,12
0.2,3584,96,260161,72.56931659693166,7
0.2,3585,92,260253,72.57473508087006,10
0.2,3586,95,260348,72.58098689712853,6
0.2,3587,93,260441,72.58667781493868,8
0.2,3588,93,260534,72.59236556143773,9
0.2,3589,-50,260484,72.55821727019499,15
0.2,3590,17,260501,72.54274575327207,16
0.2,3591,94,260595,72.54871937639199,9
0.2,3592,95,260690,72.55496799332035,6
0.2,3593,94,260784,72.56093489148581,9
0.2,3594,93,260877,72.56662030598054,8
0.2,3595,94,260971,72.5725806451613,7
0.2,3596,95,261066,72.57881567973311,6
0.2,3597,-50,261016,72.54474708171206,13
0.2,3598,21,261037,72.53042511808836,11
0.2,3599,95,261132,72.53666666666666,8
0.2,3600,94,261226,72.5426270480422,8
0.2,3601,96,261322,72.54913936701833,6
0.2,3602,94,261416,72.55509297807383,8
0.2,3603,94,261510,72.56104328523863,9
0.2,3604,92,261602,72.56643550624133,10
0.2,3605,95,261697,72.5726566833056,7
0.2,3606,96,261793,72.57915164957028,6
0.2,3607,94,261887,72.585088691796,8
0.2,3608,95,261982,72.59129952895539,7
0.2,3609,95,262077,72.59750692520775,8
0.2,3610,94,262171,72.6034339518139,8
0.2,3611,94,262265,72.609357696567,8
0.2,3612,94,262359,72.61527816219208,7
0.2,3613,93,262452,72.62091864969562,10
0.2,3614,23,262475,72.60719225449516,11
0.2,3615,95,262570,72.61338495575221,7
0.2,3616,-191,262379,72.54050317943047,18
0.2,3617,92,262471,72.54588170259812,10
0.2,3618,22,262493,72.53191489361703,11
0.2,3619,94,262587,72.5378453038674,8
0.2,3620,95,262682,72.54404860535763,7
0.2,3621,95,262777,72.55024848150194,6
0.2,3622,96,262873,72.55672094948937,6
0.2,3623,93,262966,72.56236203090508,8
0.2,3624,20,262986,72.54786206896551,13
0.2,3625,96,263082,72.55432984004412,6
0.2,3626,95,263177,72.56051833471189,6
0.2,3627,95,263272,72.56670341786108,6
0.2,3628,93,263365,72.572333976302,9
0.2,3629,20,263385,72.55785123966942,14
0.2,3630,16,263401,72.54227485541173,18
0.2,3631,95,263496,72.54845814977973,7
0.2,3632,94,263590,72.55436278557666,7
0.2,3633,92,263682,72.55971381397909,9
0.2,3634,89,263771,72.56423658872077,12
0.2,3635,92,263863,72.56958195819583,10
0.2,3636,93,263956,72.57519934011547,9
0.2,3637,96,264052,72.58163826278175,6
0.2,3638,24,264076,72.56828799120638,9
0.2,3639,94,264170,72.57417582417582,8
0.2,3640,87,264257,72.57813787421038,15
0.2,3641,95,264352,72.58429434376716,7
0.2,3642,93,264445,72.58989843535548,8
0.2,3643,23,264468,72.57628979143799,11
0.2,3644,95,264563,72.58244170096022,7
0.2,3645,95,264658,72.58859023587493,8
0.2,3646,-130,264528,72.53304085549767,24
0.2,3647,91,264619,72.53810307017544,11
0.2,3648,92,264711,72.54343655796109,10
0.2,3649,93,264804,72.54904109589042,10
0.2,3650,93,264897,72.55464256368118,9
0.2,3651,94,264991,72.5605147864184,8
0.2,3652,27,265018,72.54804270462634,6
0.2,3653,88,265106,72.55227148330597,13
0.2,3654,92,265198,72.55759233926129,9
0.2,3655,95,265293,72.56373085339169,7
0.2,3656,94,265387,72.56959256220946,8
0.2,3657,92,265479,72.57490431930016,10
0.2,3658,95,265574,72.58103306914458,7
0.2,3659,95,265669,72.58715846994535,7
0.2,3660,95,265764,72.59328052444687,7
0.2,3661,95,265859,72.59939923539049,7
0.2,3662,24,265883,72.58613158613159,9
0.2,3663,94,265977,72.59197598253274,8
0.2,3664,93,266070,72.59754433833561,9
0.2,3665,96,266166,72.60392798690671,6
0.2,3666,93,266259,72.60949004635943,9
0.2,3667,95,266354,72.61559432933478,7
0.2,3668,95,266449,72.62169528481876,6
0.2,3669,95,266544,72.62779291553133,6
0.2,3670,22,266566,72.61400163443203,11
0.2,3671,20,266586,72.59967320261438,12
0.2,3672,94,266680,72.60549959161449,8
0.2,3673,95,266775,72.61159499183451,8
0.2,3674,26,266801,72.59891156462585,9
0.2,3675,95,266896,72.6050054406964,6
0.2,3676,95,266991,72.61109600217569,7
0.2,3677,91,267082,72.61609570418706,11
0.2,3678,95,267177,72.62217994020114,7
0.2,3679,95,267272,72.62826086956522,7
0.2,3680,95,267367,72.63433849497419,7
0.2,3681,93,267460,72.63986963606736,10
0.2,3682,93,267553,72.64539777355417,9
0.2,3683,23,267576,72.63192182410424,11
0.2,3684,95,267671,72.63799185888737,6
0.2,3685,94,267765,72.64378730330982,8
0.2,3686,93,267858,72.6493083807974,9
0.2,3687,24,267882,72.63611713665944,9
0.2,3688,94,267976,72.64190837625372,8
0.2,3689,92,268068,72.64715447154471,10
0.2,3690,24,268092,72.63397453264697,8
0.2,3691,92,268184,72.63921993499459,10
0.2,3692,96,268280,72.64554562686163,6
0.2,3693,19,268299,72.6310232809962,14
0.2,3694,95,268394,72.63707713125845,7
0.2,3695,94,268488,72.64285714285714,8
0.2,3696,95,268583,72.64890451717609,6
0.2,3697,22,268605,72.63520822065982,12
0.2,3698,91,268696,72.64017301973506,10
0.2,3699,20,268716,72.62594594594594,12
0.2,3700,94,268810,72.6317211564442,8
0.2,3701,96,268906,72.63803349540788,6
0.2,3702,92,268998,72.64326221982176,9
0.2,3703,95,269093,72.6492980561555,7
0.2,3704,94,269187,72.65506072874494,8
0.2,3705,91,269278,72.66001079330815,11
0.2,3706,-126,269152,72.6064202859455,21
0.2,3707,23,269175,72.59304207119742,10
0.2,3708,94,269269,72.59881369641413,8
0.2,3709,20,269289,72.58463611859838,13
0.2,3710,89,269378,72.58905955268122,12
0.2,3711,19,269397,72.57462284482759,14
0.2,3712,23,269420,72.56127120926475,10
0.2,3713,92,269512,72.56650511577814,11
0.2,3714,96,269608,72.5728129205922,7
0.2,3715,-45,269563,72.54117330462863,9
0.2,3716,94,269657,72.5469464622007,8
0.2,3717,95,269752,72.5529854760624,7
0.2,3718,91,269843,72.55794568432374,11
0.2,3719,91,269934,72.56290322580645,10
0.2,3720,94,270028,72.56866433754367,10
0.2,3721,20,270048,72.55454056958624,12
0.2,3722,20,270068,72.54042438893366,12
0.2,3723,93,270161,72.54591836734694,10
0.2,3724,95,270256,72.55194630872484,8
0.2,3725,19,270275,72.53757380568975,14
0.2,3726,-50,270225,72.50469546552186,15
0.2,3727,95,270320,72.5107296137339,6
0.2,3728,-49,270271,72.47814427460445,13
0.2,3729,95,270366,72.48418230563003,7
0.2,3730,95,270461,72.4902170999732,7
0.2,3731,22,270483,72.47668810289389,10
0.2,3732,21,270504,72.46289847307796,12
0.2,3733,20,270524,72.44884841992501,12
0.2,3734,91,270615,72.45381526104417,11
0.2,3735,95,270710,72.45985010706639,7
0.2,3736,85,270795,72.46320578003747,16
0.2,3737,94,270889,72.46896736222578,8
0.2,3738,92,270981,72.47419096014977,9
0.2,3739,87,271068,72.47807486631017,15
0.2,3740,21,271089,72.46431435445068,11
0.2,3741,90,271179,72.46900053447354,14
0.2,3742,92,271271,72.47421854127705,11
0.2,3743,91,271362,72.47916666666667,10
0.2,3744,93,271455,72.48464619492657,8
0.2,3745,89,271544,72.48905499199145,14
0.2,3746,89,271633,72.49346143581532,12
0.2,3747,92,271725,72.4986659551761,10
0.2,3748,96,271821,72.5049346492398,6
0.2,3749,14,271835,72.48933333333333,20
0.2,3750,95,271930,72.49533457744602,7
0.2,3751,94,272024,72.50106609808103,8
0.2,3752,26,272050,72.4886757260858,7
0.2,3753,92,272142,72.49387320191795,11
0.2,3754,93,272235,72.49933422103861,10
0.2,3755,91,272326,72.50425985090521,10
0.2,3756,94,272420,72.50998136811286,8
0.2,3757,20,272440,72.49600851516765,13
0.2,3758,93,272533,72.50146315509444,9
0.2,3759,93,272626,72.50691489361702,9
0.2,3760,93,272719,72.51236373304972,10
0.2,3761,96,272815,72.51860712387028,7
0.2,3762,91,272906,72.52351846930641,10
0.2,3763,22,272928,72.51009564293305,11
0.2,3764,95,273023,72.51606905710491,6
0.2,3765,95,273118,72.52203929899098,7
0.2,3766,90,273208,72.52667905495089,12
0.2,3767,94,273302,72.5323779193206,10
0.2,3768,93,273395,72.53780843725126,9
0.2,3769,96,273491,72.54403183023872,7
0.2,3770,93,273584,72.54945637761867,8
0.2,3771,95,273679,72.55540827147402,7
0.2,3772,91,273770,72.56029684601113,11
0.2,3773,96,273866,72.56650768415474,6
0.2,3774,92,273958,72.57165562913907,10
0.2,3775,93,274051,72.5770656779661,8
0.2,3776,21,274072,72.56341011384697,12
0.2,3777,94,274166,72.56908417151932,7
0.2,3778,22,274188,72.55570256681662,11
0.2,3779,95,274283,72.56164021164021,6
0.2,3780,18,274301,72.5472097328749,18
0.2,3781,23,274324,72.53410893707033,10
0.2,3782,95,274419,72.5400475812847,7
0.2,3783,94,274513,72.54571881606765,8
0.2,3784,83,274596,72.54848084544254,18
0.2,3785,95,274691,72.55441098784998,6
0.2,3786,92,274783,72.55954581462899,11
0.2,3787,91,274874,72.56441393875396,11
0.2,3788,22,274896,72.55106888361045,10
0.2,3789,23,274919,72.53799472295515,9
0.2,3790,95,275014,72.5439198100765,7
0.2,3791,91,275105,72.54878691983123,13
0.2,3792,95,275200,72.55470603743738,7
0.2,3793,93,275293,72.56009488666315,10
0.2,3794,94,275387,72.56574440052701,8
0.2,3795,96,275483,72.57191780821918,6
0.2,3796,94,275577,72.57756123255201,7
0.2,3797,93,275670,72.58293838862559,8
0.2,3798,94,275764,72.58857594103712,10
0.2,3799,95,275859,72.59447368421053,7
0.2,3800,27,275886,72.58247829518548,6
0.2,3801,-51,275835,72.54997369805366,14
0.2,3802,93,275928,72.5553510386537,8
0.2,3803,95,276023,72.5612513144059,6
0.2,3804,93,276116,72.56662286465178,8
0.2,3805,94,276210,72.57225433526011,11
0.2,3806,-49,276161,72.54032046230628,12
0.2,3807,94,276255,72.54595588235294,9
0.2,3808,94,276349,72.55158834339721,8
0.2,3809,94,276443,72.55721784776902,7
0.2,3810,23,276466,72.54421411702965,10
0.2,3811,93,276559,72.54958027282267,9
0.2,3812,94,276653,72.5552058746394,8
0.2,3813,92,276745,72.5603041426324,10
0.2,3814,90,276835,72.56487549148099,11
0.2,3815,91,276926,72.56970649895179,10
0.2,3816,95,277021,72.5755829185224,6
0.2,3817,93,277114,72.5809324253536,10
0.2,3818,25,277139,72.56847342236188,8
0.2,3819,92,277231,72.57356020942409,9
0.2,3820,22,277253,72.56032452237635,12
0.2,3821,90,277343,72.56488749345893,12
0.2,3822,21,277364,72.5513994245357,12
0.2,3823,27,277391,72.53948744769875,6
0.2,3824,-47,277344,72.50823529411765,11
0.2,3825,94,277438,72.5138525875588,8
0.2,3826,95,277533,72.51972824666841,7
0.2,3827,95,277628,72.52560083594567,7
0.2,3828,93,277721,72.5309480282058,8
0.2,3829,23,277744,72.51801566579634,10
0.2,3830,95,277839,72.52388410336727,8
0.2,3831,95,277934,72.52974947807934,7
0.2,3832,21,277955,72.51630576571876,12
0.2,3833,24,277979,72.50365153886281,11
0.2,3834,22,278001,72.49048239895697,10
0.2,3835,91,278092,72.49530761209593,10
0.2,3836,94,278186,72.5009121709669,8
0.2,3837,92,278278,72.50599270453361,11
0.2,3838,93,278371,72.511331075801,8
0.2,3839,93,278464,72.51666666666667,9
0.2,3840,-52,278412,72.48424889351732,15
0.2,3841,95,278507,72.4901093180635,7
0.2,3842,93,278600,72.49544626593807,9
0.2,3843,91,278691,72.50026014568158,11
0.2,3844,87,278778,72.50403120936281,14
0.2,3845,89,278867,72.50832033281331,13
0.2,3846,91,278958,72.51312711203535,12
0.2,3847,94,279052,72.51871101871102,7
0.2,3848,92,279144,72.52377240841777,10
0.2,3849,93,279237,72.52909090909091,9
0.2,3850,92,279329,72.53414697481173,10
0.2,3851,24,279353,72.52154724818276,9
0.2,3852,96,279449,72.52764079937711,6
0.2,3853,93,279542,72.53295277633627,8
0.2,3854,95,279637,72.53878080415045,6
0.2,3855,95,279732,72.54460580912863,6
0.2,3856,92,279824,72.54964998703656,10
0.2,3857,18,279842,72.53551062726801,15
0.2,3858,95,279937,72.54133195128271,8
0.2,3859,91,280028,72.5461139896373,11
0.2,3860,92,280120,72.55115255115255,10
0.2,3861,95,280215,72.55696530295184,7
0.2,3862,24,280239,72.54439554750194,9
0.2,3863,95,280334,72.55020703933748,6
0.2,3864,-49,280285,72.51875808538163,13
0.2,3865,27,280312,72.5069839627522,7
0.2,3866,96,280408,72.51305921903284,6
0.2,3867,91,280499,72.5178386763185,11
0.2,3868,10,280509,72.50168002067717,24
0.2,3869,21,280530,72.48837209302326,11
0.2,3870,95,280625,72.4941875484371,6
0.2,3871,93,280718,72.49948347107438,10
0.2,3872,95,280813,72.50529305447974,6
0.2,3873,20,280833,72.49173980382034,13
0.2,3874,96,280929,72.4978064516129,6
0.2,3875,-118,280811,72.44865841073272,13
0.2,3876,90,280901,72.45318545266959,12
0.2,3877,95,280996,72.45899948427024,7
0.2,3878,-49,280947,72.4276875483372,13
0.2,3879,91,281038,72.43247422680412,11
0.2,3880,96,281134,72.43854676629735,6
0.2,3881,25,281159,72.42632663575476,8
0.2,3882,95,281254,72.43214009786247,6
0.2,3883,21,281275,72.41889804325437,12
0.2,3884,95,281370,72.42471042471043,6
0.2,3885,94,281464,72.43026248069995,8
0.2,3886,93,281557,72.43555441214303,8
0.2,3887,93,281650,72.44084362139918,8
0.2,3888,92,281742,72.44587297505785,9
0.2,3889,90,281832,72.45038560411311,12
0.2,3890,86,281918,72.4538679002827,15
0.2,3891,95,282013,72.45966084275437,8
0.2,3892,94,282107,72.46519393783714,7
0.2,3893,93,282200,72.47046738572162,9
0.2,3894,91,282291,72.4752246469833,11
0.2,3895,93,282384,72.48049281314168,10
0.2,3896,93,282477,72.48575827559661,9
0.2,3897,96,282573,72.49179066187789,6
0.2,3898,83,282656,72.49448576558092,19
0.2,3899,95,282751,72.50025641025641,7
0.2,3900,92,282843,72.50525506280441,9
0.2,3901,95,282938,72.51101998974885,6
0.2,3902,92,283030,72.5160133230848,10
0.2,3903,91,283121,72.52074795081967,10
0.2,3904,22,283143,72.50781049935979,12
0.2,3905,91,283234,72.51254480286738,14
0.2,3906,95,283329,72.51830048630663,7
0.2,3907,91,283420,72.52302968270214,11
0.2,3908,95,283515,72.5287797390637,7
0.2,3909,93,283608,72.53401534526854,9
0.2,3910,95,283703,72.53975965226284,6
0.2,3911,96,283799,72.54575664621677,6
0.2,3912,94,283893,72.5512394582162,8
0.2,3913,91,283984,72.55595298926929,10
0.2,3914,93,284077,72.56117496807153,9
0.2,3915,92,284169,72.5661389172625,11
0.2,3916,95,284264,72.57186622415114,6
0.2,3917,26,284290,72.55997958141909,7
0.2,3918,93,284383,72.56519520285786,9
0.2,3919,93,284476,72.57040816326531,10
0.2,3920,-47,284429,72.53991328742667,12
0.2,3921,95,284524,72.54563997960224,7
0.2,3922,25,284549,72.53352026510323,8
0.2,3923,25,284574,72.52140672782875,8
0.2,3924,96,284670,72.52738853503185,6
0.2,3925,95,284765,72.53311258278146,7
0.2,3926,26,284791,72.52126305067482,7
0.2,3927,95,284886,72.52698574338086,6
0.2,3928,94,284980,72.53245100534487,7
0.2,3929,92,285072,72.53740458015267,10
0.2,3930,95,285167,72.54311879928771,7
0.2,3931,95,285262,72.54883011190233,6
0.2,3932,93,285355,72.55403000254259,9
0.2,3933,27,285382,72.54245043213015,7
0.2,3934,91,285473,72.54714104193138,11
0.2,3935,93,285566,72.55233739837398,8
0.2,3936,26,285592,72.54051308102616,6
0.2,3937,95,285687,72.54621635347893,6
0.2,3938,-52,285635,72.51459761360752,16
0.2,3939,93,285728,72.51979695431471,9
0.2,3940,92,285820,72.52473991372749,9
0.2,3941,93,285913,72.52993404363268,8
0.2,3942,96,286009,72.53588638092823,6
0.2,3943,95,286104,72.54158215010142,7
0.2,3944,-58,286046,72.5084917617237,22
0.2,3945,26,286072,72.49670552458186,8
0.2,3946,95,286167,72.50240689130986,6
0.2,3947,93,286260,72.50759878419453,10
0.2,3948,21,286281,72.49455558369208,12
0.2,3949,94,286375,72.5,8
0.2,3950,95,286470,72.50569476082005,7
0.2,3951,93,286563,72.51088056680162,8
0.2,3952,96,286659,72.51682266632938,6
0.2,3953,93,286752,72.52200303490136,9
0.2,3954,96,286848,72.52793931731985,7
0.2,3955,92,286940,72.53286147623862,10
0.2,3956,95,287035,72.53853929744756,6
0.2,3957,93,287128,72.54370894391107,8
0.2,3958,-52,287076,72.51225056832533,16
0.2,3959,92,287168,72.51717171717172,12
0.2,3960,95,287263,72.52284776571572,6
0.2,3961,93,287356,72.52801615345786,9
0.2,3962,95,287451,72.5336866010598,7
0.2,3963,91,287542,72.53834510595358,10
0.2,3964,23,287565,72.52585119798235,10
0.2,3965,95,287660,72.53151790216843,7
0.2,3966,18,287678,72.5177716158306,14
0.2,3967,23,287701,72.50529233870968,9
0.2,3968,92,287793,72.51020408163265,10
0.2,3969,95,287888,72.51586901763224,7
0.2,3970,93,287981,72.52102744900529,9
0.2,3971,95,288076,72.52668680765358,6
0.2,3972,93,288169,72.53183991945633,10
0.2,3973,95,288264,72.53749370910921,7
0.2,3974,93,288357,72.54264150943396,8
0.2,3975,93,288450,72.54778672032194,8
0.2,3976,91,288541,72.55242645209957,11
0.2,3977,-48,288493,72.52212166918049,11
0.2,3978,92,288585,72.52701683840161,10
0.2,3979,95,288680,72.53266331658291,6
0.2,3980,93,288773,72.53780457171565,9
0.2,3981,92,288865,72.54269211451532,9
0.2,3982,95,288960,72.54833040421792,7
0.2,3983,24,288984,72.53614457831326,8
0.2,3984,26,289010,72.52446675031368,7
0.2,3985,93,289103,72.52960361264425,9
0.2,3986,95,289198,72.53523952846751,6
0.2,3987,95,289293,72.54087261785357,7
0.2,3988,92,289385,72.54575081474054,10
0.2,3989,93,289478,72.55087719298245,10
0.2,3990,95,289573,72.55650212979204,7
0.2,3991,95,289668,72.562124248497,7
0.2,3992,90,289758,72.56649135987979,12
0.2,3993,94,289852,72.57185778668001,8
0.2,3994,89,289941,72.57596996245307,13
0.2,3995,93,290034,72.58108108108108,9
0.2,3996,26,290060,72.56942707030272,8
0.2,3997,96,290156,72.57528764382191,6
0.2,3998,95,290251,72.58089522380595,7
0.2,3999,94,290345,72.58625,8
0.2,4000,-53,290292,72.55486128467884,17
0.2,4001,22,290314,72.54222888555722,11
0.2,4002,92,290406,72.54708968273795,10
0.2,4003,94,290500,72.55244755244755,7
0.2,4004,19,290519,72.5390761548065,14
0.2,4005,95,290614,72.5446829755367,7
0.2,4006,94,290708,72.55003743448964,8
0.2,4007,95,290803,72.55563872255489,6
0.2,4008,88,290891,72.55949114492392,13
0.2,4009,95,290986,72.56508728179551,8
0.2,4010,88,291074,72.56893542757417,13
0.2,4011,96,291170,72.57477567298106,6
0.2,4012,96,291266,72.58061300772489,6
0.2,4013,95,291361,72.58619830592924,7
0.2,4014,94,291455,72.59153175591531,9
0.2,4015,95,291550,72.59711155378486,6
0.2,4016,19,291569,72.58376898182723,15
0.2,4017,96,291665,72.5895968143355,6
0.2,4018,95,291760,72.59517292858921,7
0.2,4019,92,291852,72.6,11
0.2,4020,96,291948,72.60581944789853,6
0.2,4021,95,292043,72.61138736946792,6
0.2,4022,95,292138,72.61695252299279,7
0.2,4023,94,292232,72.62226640159045,9
0.2,4024,95,292327,72.62782608695652,6
0.2,4025,92,292419,72.63263785394933,9
0.2,4026,24,292443,72.62056121182022,9
0.2,4027,95,292538,72.62611717974181,6
0.2,4028,17,292555,72.61231074708364,16
0.2,4029,92,292647,72.61712158808933,9
0.2,4030,92,292739,72.62193004217316,9
0.2,4031,94,292833,72.62723214285714,9
0.2,4032,92,292925,72.6320357054302,9
0.2,4033,24,292949,72.61998016856718,9
0.2,4034,93,293042,72.62503097893432,8
0.2,4035,94,293136,72.63032705649158,10
0.2,4036,94,293230,72.6356205102799,8
0.2,4037,92,293322,72.64041604754829,9
0.2,4038,-47,293275,72.61079475117603,11
0.2,4039,95,293370,72.61633663366337,7
0.2,4040,93,293463,72.62138084632517,8
0.2,4041,91,293554,72.62592775853538,10
0.2,4042,95,293649,72.63146178580263,7
0.2,4043,94,293743,72.63674579624134,7
0.2,4044,94,293837,72.64202719406676,9
0.2,4045,24,293861,72.63000494315374,9
0.2,4046,92,293953,72.6347912033605,10
0.2,4047,91,294044,72.63932806324111,10
0.2,4048,19,294063,72.6260805137071,16
0.2,4049,23,294086,72.61382716049383,10
0.2,4050,95,294181,72.61935324611207,6
0.2,4051,96,294277,72.6251233958539,6
0.2,4052,96,294373,72.63089069824821,6
0.2,4053,26,294399,72.61938825851011,7
0.2,4054,95,294494,72.6249075215783,7
0.2,4055,92,294586,72.62968441814596,9
0.2,4056,96,294682,72.63544491003205,6
0.2,4057,22,294704,72.6229669788073,12
0.2,4058,93,294797,72.6279871889628,8
0.2,4059,90,294887,72.63226600985222,11
0.2,4060,93,294980,72.63728145776902,8
0.2,4061,92,295072,72.64204825209256,9
0.2,4062,92,295164,72.64681269997538,10
0.2,4063,95,295259,72.65231299212599,6
0.2,4064,94,295353,72.65756457564575,8
0.2,4065,95,295448,72.66305951795377,6
0.2,4066,96,295544,72.66879763953774,7
0.2,4067,93,295637,72.67379547689282,11
0.2,4068,95,295732,72.6792823789629,7
0.2,4069,91,295823,72.68378378378378,12
0.2,4070,94,295917,72.68901989683124,7
0.2,4071,-48,295869,72.6593811394892,12
0.2,4072,89,295958,72.6633930763565,13
0.2,4073,96,296054,72.66912125675012,6
0.2,4074,88,296142,72.67288343558282,13
0.2,4075,24,296166,72.66094210009814,9
0.2,4076,95,296261,72.6664213882757,6
0.2,4077,96,296357,72.67214320745464,6
0.2,4078,89,296446,72.67614611424369,13
0.2,4079,95,296541,72.68161764705883,7
0.2,4080,93,296634,72.68659642244548,9
0.2,4081,95,296729,72.69206271435571,7
0.2,4082,95,296824,72.6975263286799,8
0.2,4083,94,296918,72.70274240940255,11
0.2,4084,89,297007,72.70673194614443,12
0.2,4085,94,297101,72.7119432207538,7
0.2,4086,94,297195,72.71715194519207,11
0.2,4087,94,297289,72.72235812133073,7
0.2,4088,94,297383,72.72756175103937,8
0.2,4089,95,297478,72.73300733496332,7
0.2,4090,-45,297433,72.70422879491566,9
0.2,4091,94,297527,72.7094330400782,8
0.2,4092,94,297621,72.71463474224285,8
0.2,4093,90,297711,72.71885686370298,13
0.2,4094,-52,297659,72.68840048840049,16
0.2,4095,95,297754,72.69384765625,7
0.2,4096,22,297776,72.68147424945082,11
0.2,4097,92,297868,72.68618838457785,10
0.2,4098,93,297961,72.69114418150768,9
0.2,4099,-45,297916,72.66243902439024,8
0.2,4100,95,298011,72.66788588149232,7
0.2,4101,92,298103,72.6725987323257,10
0.2,4102,95,298198,72.67804045820131,6
0.2,4103,95,298293,72.68347953216374,6
0.2,4104,94,298387,72.68867235079172,8
0.2,4105,95,298482,72.69410618606916,6
0.2,4106,91,298573,72.69856342829316,11
0.2,4107,96,298669,72.70423563777995,6
0.2,4108,94,298763,72.7094183499635,8
0.2,4109,95,298858,72.71484184914841,6
0.2,4110,22,298880,72.7025054731209,11
0.2,4111,96,298976,72.70817120622569,6
0.2,4112,94,299070,72.71334792122538,8
0.2,4113,26,299096,72.7019931939718,7
0.2,4114,25,299121,72.69040097205347,8
0.2,4115,95,299216,72.6958211856171,6
0.2,4116,94,299310,72.70099587077969,7
0.2,4117,92,299402,72.70568237008257,9
0.2,4118,94,299496,72.71085214857975,9
0.2,4119,92,299588,72.71553398058252,10
0.2,4120,92,299680,72.72021354040281,9
0.2,4121,94,299774,72.72537603105289,7
0.2,4122,94,299868,72.73053601746301,8
0.2,4123,94,299962,72.7356935014549,9
0.2,4124,92,300054,72.74036363636364,10
0.2,4125,92,300146,72.74503150751333,9
0.2,4126,93,300239,72.74993942330991,9
0.2,4127,96,300335,72.75557170542636,6
0.2,4128,95,300430,72.76095906999274,7
0.2,4129,88,300518,72.76464891041162,15
0.2,4130,95,300613,72.77003146937787,8
0.2,4131,95,300708,72.77541142303969,6
0.2,4132,94,300802,72.7805468182918,8
0.2,4133,96,300898,72.78616352201257,7
0.2,4134,89,300987,72.79008464328899,12
0.2,4135,21,301008,72.77756286266924,11
0.2,4136,91,301099,72.78196760937878,13
0.2,4137,24,301123,72.77017883035283,9
0.2,4138,93,301216,72.77506644116936,8
0.2,4139,26,301242,72.76376811594203,7
0.2,4140,91,301333,72.76817193914513,10
0.2,4141,93,301426,72.77305649444713,8
0.2,4142,17,301443,72.75959449674149,15
0.2,4143,20,301463,72.74686293436294,12
0.2,4144,-50,301413,72.71724969843184,13
0.2,4145,94,301507,72.72238301977809,7
0.2,4146,92,301599,72.72703158910055,11
0.2,4147,87,301686,72.73047251687561,15
0.2,4148,92,301778,72.7351168956375,12
0.2,4149,94,301872,72.74024096385543,9
0.2,4150,21,301893,72.7277764394122,15
0.2,4151,94,301987,72.73289980732177,7
0.2,4152,94,302081,72.73802070792199,8
0.2,4153,-44,302037,72.70991815117958,8
0.2,4154,95,302132,72.71528279181709,7
0.2,4155,94,302226,72.7204042348412,7
0.2,4156,91,302317,72.7248015395718,12
0.2,4157,95,302412,72.73015873015873,8
0.2,4158,94,302506,72.73527290213994,7
0.2,4159,95,302601,72.740625,7
0.2,4160,95,302696,72.74597452535448,6
0.2,4161,22,302718,72.73378183565593,10
0.2,4162,95,302813,72.73913043478261,7
0.2,4163,23,302836,72.72718539865514,9
0.2,4164,95,302931,72.73253301320528,7
0.2,4165,95,303026,72.73787806048968,7
0.2,4166,19,303045,72.72498200143988,14
0.2,4167,95,303140,72.73032629558541,6
0.2,4168,93,303233,72.73518829455504,9
0.2,4169,95,303328,72.74052757793766,6
0.2,4170,94,303422,72.74562455046751,7
0.2,4171,91,303513,72.75,10
0.2,4172,92,303605,72.75461298825785,10
0.2,4173,96,303701,72.76018207954002,6
0.2,4174,91,303792,72.7645508982036,11
0.2,4175,93,303885,72.76939655172414,9
0.2,4176,96,303981,72.77495810390232,6
0.2,4177,-45,303936,72.7467687888942,9
0.2,4178,95,304031,72.75209380234506,6
0.2,4179,96,304127,72.75765550239234,6
0.2,4180,95,304222,72.76297536474527,7
0.2,4181,95,304317,72.76829268292683,7
0.2,4182,94,304411,72.77336839588811,8
0.2,4183,92,304503,72.7779636711281,9
0.2,4184,94,304597,72.78303464755078,8
0.2,4185,94,304691,72.78810320114668,8
0.2,4186,93,304784,72.79293049916409,9
0.2,4187,-51,304733,72.76337153772684,14
0.2,4188,89,304822,72.7672475531153,13
0.2,4189,23,304845,72.75536992840095,12
0.2,4190,95,304940,72.7606776425674,7
0.2,4191,89,305029,72.76455152671755,12
0.2,4192,18,305047,72.75149057953732,15
0.2,4193,-47,305000,72.72293752980448,11
0.2,4194,93,305093,72.72777115613826,8
0.2,4195,93,305186,72.732602478551,9
0.2,4196,95,305281,72.73790802954491,6
0.2,4197,96,305377,72.74344926155312,6
0.2,4198,94,305471,72.74851155036913,8
0.2,4199,90,305561,72.75261904761905,12
0.2,4200,91,305652,72.75696262794573,10
0.2,4201,95,305747,72.76225606853879,6
0.2,4202,94,305841,72.76730906495361,7
0.2,4203,94,305935,72.77235965746908,8
0.2,4204,20,305955,72.75980975029726,12
0.2,4205,93,306048,72.76462196861627,10
0.2,4206,89,306137,72.7684811029237,12
0.2,4207,91,306228,72.77281368821293,12
0.2,4208,21,306249,72.76051318602994,11
0.2,4209,25,306274,72.74916864608076,8
0.2,4210,95,306369,72.75445262407979,8
0.2,4211,91,306460,72.7587844254511,11
0.2,4212,94,306554,72.76382625207691,7
0.2,4213,95,306649,72.76910299003322,6
0.2,4214,92,306741,72.77366548042704,9
0.2,4215,95,306836,72.77893738140418,7
0.2,4216,94,306930,72.78396964666825,9
0.2,4217,93,307023,72.78876244665719,9
0.2,4218,96,307119,72.79426404361223,6
0.2,4219,92,307211,72.79881516587677,10
0.2,4220,94,307305,72.80383795309169,7
0.2,4221,21,307326,72.79156797726196,12
0.2,4222,96,307422,72.79706369879233,6
0.2,4223,83,307505,72.79947916666667,19
0.2,4224,91,307596,72.80378698224852,12
0.2,4225,26,307622,72.79271178419309,7
0.2,4226,95,307717,72.7979654601372,7
0.2,4227,94,307811,72.80298013245033,8
0.2,4228,95,307906,72.80822889572003,7
0.2,4229,92,307998,72.81276595744681,10
0.2,4230,94,308092,72.81777357598676,8
0.2,4231,95,308187,72.82301512287334,10
0.2,4232,95,308282,72.82825419324357,6
0.2,4233,94,308376,72.83325460557393,7
0.2,4234,80,308456,72.8349468713105,22
0.2,4235,-47,308409,72.80665722379604,12
0.2,4236,87,308496,72.81000708048147,15
0.2,4237,95,308591,72.81524303916942,8
0.2,4238,95,308686,72.8204765274829,6
0.2,4239,96,308782,72.82594339622642,6
0.2,4240,24,308806,72.81443055883047,8
0.2,4241,92,308898,72.81895332390381,9
0.2,4242,26,308924,72.80791892528872,7
0.2,4243,91,309015,72.812205466541,11
0.2,4244,90,309105,72.81625441696113,11
0.2,4245,93,309198,72.8210080075365,9
0.2,4246,93,309291,72.82575935954792,9
0.2,4247,22,309313,72.81379472693033,10
0.2,4248,92,309405,72.81831019063308,10
0.2,4249,92,309497,72.82282352941176,11
0.2,4250,93,309590,72.82756998353328,8
0.2,4251,95,309685,72.83278457196613,6
0.2,4252,93,309778,72.83752645191629,8
0.2,4253,93,309871,72.84226610249178,9
0.2,4254,22,309893,72.83031727379553,11
0.2,4255,93,309986,72.83505639097744,9
0.2,4256,91,310077,72.83932346723044,12
0.2,4257,94,310171,72.84429309534993,9
0.2,4258,94,310265,72.84926038976286,8
0.2,4259,93,310358,72.85399061032864,8
0.2,4260,95,310453,72.8591879840413,6
0.2,4261,23,310476,72.84748944157673,10
0.2,4262,96,310572,72.85292047853625,6
0.2,4263,23,310595,72.84122889305816,10
0.2,4264,93,310688,72.84595545134819,8
0.2,4265,90,310778,72.84997655883731,14
0.2,4266,94,310872,72.8549332083431,8
0.2,4267,92,310964,72.85941893158387,11
0.2,4268,85,311049,72.86226282501757,17
0.2,4269,94,311143,72.8672131147541,7
0.2,4270,96,311239,72.87262936080543,6
0.2,4271,94,311333,72.87757490636704,8
0.2,4272,92,311425,72.88205008190967,9
0.2,4273,93,311518,72.8867571361722,9
0.2,4274,24,311542,72.87532163742691,8
0.2,4275,94,311636,72.88026192703461,9
0.2,4276,95,311731,72.88543371522096,7
0.2,4277,93,311824,72.8901355773726,8
0.2,4278,91,311915,72.89436784295395,11
0.2,4279,95,312010,72.89953271028037,7
0.2,4280,93,312103,72.90422798411586,8
0.2,4281,23,312126,72.89257356375525,10
0.2,4282,92,312218,72.89703478869951,9
0.2,4283,24,312242,72.88562091503267,8
0.2,4284,-200,312042,72.82193698949825,26
0.2,4285,91,312133,72.82617825478302,10
0.2,4286,92,312225,72.83065080475858,12
0.2,4287,96,312321,72.83605410447761,7
0.2,4288,27,312348,72.82536721846584,6
0.2,4289,-48,312300,72.7972027972028,12
0.2,4290,93,312393,72.80191097646237,10
0.2,4291,92,312485,72.80638397017708,11
0.2,4292,93,312578,72.81108781737713,10
0.2,4293,95,312673,72.81625523986959,6
0.2,4294,92,312765,72.82072176949941,10
0.2,4295,93,312858,72.82541899441341,9
0.2,4296,23,312881,72.81382359785897,10
0.2,4297,96,312977,72.81921824104235,6
0.2,4298,93,313070,72.82391253779949,8
0.2,4299,24,313094,72.81255813953489,9
0.2,4300,93,313187,72.81725180190654,9
0.2,4301,23,313210,72.80567178056718,11
0.2,4302,95,313305,72.81082965372995,6
0.2,4303,25,313330,72.79972118959108,8
0.2,4304,95,313425,72.8048780487805,7
0.2,4305,21,313446,72.79284718996749,12
0.2,4306,22,313468,72.78105409798003,12
0.2,4307,92,313560,72.78551532033426,10
0.2,4308,94,313654,72.79043861684846,8
0.2,4309,23,313677,72.77888631090487,10
0.2,4310,22,313699,72.76710739967525,10
0.2,4311,20,313719,72.75487012987013,14
0.2,4312,92,313811,72.75933225133318,12
0.2,4313,93,313904,72.76402410755679,9
0.2,4314,23,313927,72.75249130938586,10
0.2,4315,92,314019,72.75695088044486,9
0.2,4316,94,314113,72.7618716701413,8
0.2,4317,94,314207,72.76679018063919,8
0.2,4318,25,314232,72.75573049316972,8
0.2,4319,95,314327,72.76087962962963,6
0.2,4320,20,314347,72.74866928951631,13
0.2,4321,93,314440,72.75335492827395,9
0.2,4322,95,314535,72.75850104094378,7
0.2,4323,95,314630,72.763644773358,8
0.2,4324,96,314726,72.76901734104047,6
0.2,4325,95,314821,72.77415626444753,7
0.2,4326,95,314916,72.77929281257222,7
0.2,4327,96,315012,72.78465804066543,6
0.2,4328,90,315102,72.7886347886348,12
0.2,4329,22,315124,72.7769053117783,11
0.2,4330,22,315146,72.76518125144308,11
0.2,4331,95,315241,72.77031394275161,7
0.2,4332,22,315263,72.75859681513963,10
0.2,4333,94,315357,72.7634979233964,8
0.2,4334,93,315450,72.7681660899654,8
0.2,4335,95,315545,72.77329335793358,6
0.2,4336,90,315635,72.77726539082315,12
0.2,4337,94,315729,72.78215767634855,7
0.2,4338,93,315822,72.78681723899516,8
0.2,4339,91,315913,72.79101382488479,10
0.2,4340,93,316006,72.79566920064501,9
0.2,4341,94,316100,72.8005527406725,9
0.2,4342,-50,316050,72.77227722772277,13
0.2,4343,93,316143,72.77693370165746,8
0.2,4344,89,316232,72.780667433832,12
0.2,4345,93,316325,72.78531983433042,9
0.2,4346,90,316415,72.78927996319301,14
0.2,4347,91,316506,72.79346826126955,13
0.2,4348,96,316602,72.79880432283284,6
0.2,4349,95,316697,72.80390804597701,8
0.2,4350,89,316786,72.80763042978626,12
0.2,4351,96,316882,72.81295955882354,6
0.2,4352,95,316977,72.81805651274983,7
0.2,4353,92,317069,72.82246210381258,9
0.2,4354,92,317161,72.8268656716418,10
0.2,4355,26,317187,72.81611570247934,7
0.2,4356,21,317208,72.80422308928162,12
0.2,4357,95,317303,72.80931620009179,7
0.2,4358,95,317398,72.81440697407662,6
0.2,4359,95,317493,72.81949541284403,7
0.2,4360,92,317585,72.82389360238477,11
0.2,4361,92,317677,72.82828977533242,9
0.2,4362,23,317700,72.81686912674765,10
0.2,4363,92,317792,72.82126489459212,9
0.2,4364,93,317885,72.82588774341352,8
0.2,4365,94,317979,72.83073751717819,9
0.2,4366,27,318006,72.82024272956262,6
0.2,4367,95,318101,72.82532051282051,7
0.2,4368,93,318194,72.82993820096132,9
0.2,4369,96,318290,72.83524027459954,6
0.2,4370,95,318385,72.84031114161519,7
0.2,4371,90,318475,72.84423604757548,13
0.2,4372,91,318566,72.8483878344386,11
0.2,4373,96,318662,72.85368084133516,6
0.2,4374,94,318756,72.85851428571429,9
0.2,4375,94,318850,72.86334552102376,8
0.2,4376,95,318945,72.86840301576422,6
0.2,4377,94,319039,72.87322978529009,8
0.2,4378,22,319061,72.86161224023749,10
0.2,4379,96,319157,72.86689497716895,6
0.2,4380,91,319248,72.87103401049988,10
0.2,4381,-55,319193,72.84185303514377,19
0.2,4382,94,319287,72.8466803559206,9
0.2,4383,95,319382,72.85173357664233,7
0.2,4384,95,319477,72.85678449258837,7
0.2,4385,95,319572,72.86183310533515,6
0.2,4386,90,319662,72.86573968543424,12
0.2,4387,90,319752,72.86964448495898,11
0.2,4388,91,319843,72.87377534745956,10
0.2,4389,95,319938,72.87881548974943,7
0.2,4390,21,319959,72.86700068321566,11
0.2,4391,95,320054,72.87204007285975,6
0.2,4392,95,320149,72.87707716822217,7
0.2,4393,94,320243,72.88188438780155,8
0.2,4394,93,320336,72.88646188850967,13
0.2,4395,92,320428,72.89080982711556,10
0.2,4396,96,320524,72.896065499204,6
0.2,4397,96,320620,72.90131878126421,6
0.2,4398,-124,320496,72.85655830870652,20
0.2,4399,92,320588,72.86090909090909,10
0.2,4400,93,320681,72.86548511701886,9
0.2,4401,96,320777,72.87074057246706,6
0.2,4402,18,320795,72.85827844651374,15
0.2,4403,95,320890,72.86330608537693,6
0.2,4404,94,320984,72.86810442678774,7
0.2,4405,22,321006,72.85655923740354,12
0.2,4406,95,321101,72.86158384388473,7
0.2,4407,94,321195,72.86637931034483,8
0.2,4408,95,321290,72.87139941029712,6
0.2,4409,96,321386,72.87664399092971,6
0.2,4410,23,321409,72.86533665835411,12
0.2,4411,95,321504,72.87035358114234,7
0.2,4412,96,321600,72.87559483344664,6
0.2,4413,96,321696,72.8808337109198,6
0.2,4414,94,321790,72.88561721404304,8
0.2,4415,95,321885,72.890625,6
0.2,4416,27,321912,72.88023545392801,6
0.2,4417,92,322004,72.88456315074694,10
0.2,4418,94,322098,72.88934147997284,8
0.2,4419,23,322121,72.87805429864254,10
0.2,4420,95,322216,72.88305813164442,7
0.2,4421,22,322238,72.8715513342379,11
0.2,4422,95,322333,72.8765543748587,6
0.2,4423,24,322357,72.86550632911393,11
0.2,4424,94,322451,72.8702824858757,8
0.2,4425,94,322545,72.87505648441031,7
0.2,4426,95,322640,72.88005421278518,6
0.2,4427,26,322666,72.86946702800361,7
0.2,4428,96,322762,72.87468954617295,6
0.2,4429,-53,322709,72.84627539503386,17
0.2,4430,95,322804,72.85127510719927,7
0.2,4431,93,322897,72.85582129963899,11
0.2,4432,95,322992,72.86081660275208,7
0.2,4433,95,323087,72.86580965268381,6
0.2,4434,85,323172,72.86854565952649,18
0.2,4435,95,323267,72.87353471596032,8
0.2,4436,23,323290,72.86229434302457,10
0.2,4437,94,323384,72.86705723298783,8
0.2,4438,94,323478,72.87181797702185,8
0.2,4439,96,323574,72.87702702702703,6
0.2,4440,91,323665,72.88110785859041,10
0.2,4441,24,323689,72.87010355695632,9
0.2,4442,95,323784,72.87508440243079,7
0.2,4443,22,323806,72.86363636363636,10
0.2,4444,93,323899,72.8681664791901,9
0.2,4445,96,323995,72.87336932073774,6
0.2,4446,95,324090,72.8783449516528,7
0.2,4447,87,324177,72.88151978417267,15
0.2,4448,88,324265,72.88491795909194,14
0.2,4449,95,324360,72.88988764044944,7
0.2,4450,94,324454,72.89463042013031,8
0.2,4451,95,324549,72.89959568733154,7
0.2,4452,91,324640,72.90366045362677,11
0.2,4453,93,324733,72.90817242927706,11
0.2,4454,95,324828,72.91313131313132,8
0.2,4455,93,324921,72.91763913824057,9
0.2,4456,94,325015,72.92236930670855,10
0.2,4457,95,325110,72.92732166890983,6
0.2,4458,96,325206,72.93249607535321,6
0.2,4459,92,325298,72.93677130044843,11
0.2,4460,95,325393,72.94171710378839,7
0.2,4461,93,325486,72.94621246077992,9
0.2,4462,89,325575,72.94980954514901,12
0.2,4463,94,325669,72.95452508960574,8
0.2,4464,89,325758,72.95811870100783,14
0.2,4465,90,325848,72.96193461710703,12
0.2,4466,91,325939,72.96597268860533,10
0.2,4467,93,326032,72.97045658012533,8
0.2,4468,95,326127,72.97538599239203,6
0.2,4469,93,326220,72.97986577181209,9
0.2,4470,25,326245,72.96913442182957,8
0.2,4471,94,326339,72.97383720930233,8
0.2,4472,25,326364,72.96311200536553,8
0.2,4473,93,326457,72.9675905230219,9
0.2,4474,95,326552,72.97251396648045,7
0.2,4475,95,326647,72.97743521000893,6
0.2,4476,93,326740,72.98190752736207,9
0.2,4477,90,326830,72.98570790531487,13
0.2,4478,26,326856,72.97521768251842,7
0.2,4479,-121,326735,72.93191964285714,16
0.2,4480,95,326830,72.93684445436287,7
0.2,4481,91,326921,72.94087460954931,11
0.2,4482,96,327017,72.94601829132277,6
0.2,4483,94,327111,72.9507136485281,9
0.2,4484,95,327206,72.955629877369,6
0.2,4485,22,327228,72.94427106553722,11
0.2,4486,93,327321,72.94874080677513,8
0.2,4487,-46,327275,72.92223707664884,10
0.2,4488,93,327368,72.92670973490755,9
0.2,4489,95,327463,72.93162583518931,8
0.2,4490,94,327557,72.93631707860165,7
0.2,4491,96,327653,72.94145146927872,7
0.2,4492,93,327746,72.94591586912976,8
0.2,4493,95,327841,72.95082331998219,6
0.2,4494,94,327935,72.95550611790878,8
0.2,4495,93,328028,72.95996441281139,9
0.2,4496,95,328123,72.96486546586614,6
0.2,4497,23,328146,72.95375722543352,10
0.2,4498,95,328241,72.95865747943988,9
0.2,4499,95,328336,72.96355555555556,7
0.2,4500,94,328430,72.9682292823817,8
0.2,4501,94,328524,72.9729009329187,8
0.2,4502,92,328616,72.97712636020431,10
0.2,4503,95,328711,72.98201598579041,7
0.2,4504,93,328804,72.98645948945617,9
0.2,4505,93,328897,72.99090102086107,8
0.2,4506,90,328987,72.99467495007765,13
0.2,4507,-52,328935,72.96694764862467,18
0.2,4508,93,329028,72.97139055222888,9
0.2,4509,-46,328982,72.9450110864745,10
0.2,4510,94,329076,72.94967856351141,7
0.2,4511,95,329171,72.95456560283688,6
0.2,4512,92,329263,72.95878573011301,10
0.2,4513,93,329356,72.96322552060256,9
0.2,4514,94,329450,72.96788482834994,8
0.2,4515,95,329545,72.97276350752878,6
0.2,4516,23,329568,72.96170024352446,9
0.2,4517,94,329662,72.96635679504206,7
0.2,4518,91,329753,72.97034742199601,10
0.2,4519,94,329847,72.975,8
0.2,4520,93,329940,72.9794293297943,9
0.2,4521,93,330033,72.98385670057496,9
0.2,4522,95,330128,72.98872429803228,6
0.2,4523,95,330223,72.99358974358974,6
0.2,4524,94,330317,72.9982320441989,7
0.2,4525,94,330411,73.00287229341582,8
0.2,4526,94,330505,73.00751049259996,7
0.2,4527,90,330595,73.01126325088339,12
0.2,4528,94,330689,73.01589754912784,7
0.2,4529,91,330780,73.01986754966887,11
0.2,4530,94,330874,73.0244979033326,8
0.2,4531,93,330967,73.02890556045895,9
0.2,4532,94,331061,73.03353187734392,7
0.2,4533,93,331154,73.03793559770622,9
0.2,4534,95,331249,73.04277839029768,7
0.2,4535,93,331342,73.04717813051147,9
0.2,4536,92,331434,73.05135552126956,11
0.2,4537,93,331527,73.05575143234906,9
0.2,4538,90,331617,73.05948446794449,11
0.2,4539,93,331710,73.06387665198238,9
0.2,4540,94,331804,73.06848711737503,8
0.2,4541,95,331899,73.07331571994716,7
0.2,4542,26,331925,73.06295399515739,7
0.2,4543,95,332020,73.06778169014085,6
0.2,4544,95,332115,73.07260726072607,7
0.2,4545,96,332211,73.07765068191817,6
0.2,4546,96,332307,73.08269188475919,6
0.2,4547,95,332402,73.08751099384345,6
0.2,4548,22,332424,73.07628050120906,10
0.2,4549,94,332518,73.08087912087912,7
0.2,4550,96,332614,73.08591518347616,7
0.2,4551,92,332706,73.09007029876977,10
0.2,4552,92,332798,73.09422358884252,9
0.2,4553,93,332891,73.0985946420729,8
0.2,4554,92,332983,73.10274423710209,9
0.2,4555,93,333076,73.10711150131695,8
0.2,4556,96,333172,73.11213517665131,6
0.2,4557,24,333196,73.1013602457218,9
0.2,4558,94,333290,73.10594428602764,7
0.2,4559,95,333385,73.11074561403508,6
0.2,4560,92,333477,73.11488708616531,10
0.2,4561,90,333567,73.11858833844805,13
0.2,4562,91,333658,73.12250712250712,11
0.2,4563,91,333749,73.12642418930763,12
0.2,4564,94,333843,73.13099671412924,8
0.2,4565,94,333937,73.13556723609285,8
0.2,4566,-45,333892,73.10970002189622,9
0.2,4567,23,333915,73.09873029772329,10
0.2,4568,95,334010,73.10352374699059,7
0.2,4569,91,334101,73.10743982494529,11
0.2,4570,25,334126,73.09691533581274,8
0.2,4571,93,334219,73.10126859142608,8
0.2,4572,96,334315,73.10627596763612,6
0.2,4573,92,334407,73.11040664626148,11
0.2,4574,24,334431,73.09967213114754,10
0.2,4575,95,334526,73.10445804195804,6
0.2,4576,23,334549,73.09351103342802,9
0.2,4577,91,334640,73.09742245522062,10
0.2,4578,94,334734,73.10198733347893,10
0.2,4579,95,334829,73.10676855895197,6
0.2,4580,21,334850,73.09539401877319,12
0.2,4581,95,334945,73.10017459624618,7
0.2,4582,94,335039,73.10473488981017,8
0.2,4583,91,335130,73.1086387434555,11
0.2,4584,25,335155,73.09814612868048,8
0.2,4585,19,335174,73.08634976013956,13
0.2,4586,94,335268,73.0909090909091,7
0.2,4587,95,335363,73.0956843940715,6
0.2,4588,95,335458,73.10045761603836,7
0.2,4589,94,335552,73.10501089324619,8
0.2,4590,95,335647,73.10978000435635,7
0.2,4591,94,335741,73.11432926829268,7
0.2,4592,95,335836,73.11909427389506,7
0.2,4593,25,335861,73.10861993905094,9
0.2,4594,94,335955,73.11316648531012,8
0.2,4595,25,335980,73.10269799825936,8
0.2,4596,90,336070,73.1063737219926,12
0.2,4597,20,336090,73.09482383645063,13
0.2,4598,93,336183,73.09915198956296,9
0.2,4599,94,336277,73.10369565217391,7
0.2,4600,94,336371,73.10823733970877,8
0.2,4601,92,336463,73.11234245980009,11
0.2,4602,89,336552,73.11579404736042,14
0.2,4603,93,336645,73.12011294526499,8
0.2,4604,92,336737,73.12421281216069,11
0.2,4605,93,336830,73.12852800694746,9
0.2,4606,95,336925,73.13327545040157,6
0.2,4607,25,336950,73.12282986111111,8
0.2,4608,18,336968,73.11087003688435,14
0.2,4609,94,337062,73.11540130151843,7
0.2,4610,93,337155,73.11971372804165,8
0.2,4611,23,337178,73.10884648742412,10
0.2,4612,93,337271,73.11315846520702,13
0.2,4613,24,337295,73.1025140875596,10
0.2,4614,93,337388,73.1068255687974,8
0.2,4615,93,337481,73.11113518197574,8
0.2,4616,92,337573,73.11522633744856,10
0.2,4617,91,337664,73.11909917713295,11
0.2,4618,95,337759,73.12383632820956,7
0.2,4619,96,337855,73.12878787878788,6
0.2,4620,94,337949,73.13330447954988,7
0.2,4621,92,338041,73.13738641280831,9
0.2,4622,95,338136,73.14211550940948,7
0.2,4623,91,338227,73.14597750865052,10
0.2,4624,93,338320,73.15027027027027,9
0.2,4625,93,338413,73.15456117596196,8
0.2,4626,27,338440,73.14458612491896,6
0.2,4627,20,338460,73.13310285220398,12
0.2,4628,94,338554,73.13761071505725,9
0.2,4629,90,338644,73.14125269978402,12
0.2,4630,87,338731,73.14424530339019,15
0.2,4631,95,338826,73.14896373056995,7
0.2,4632,95,338921,73.15368012087201,6
0.2,4633,94,339015,73.15817867932671,8
0.2,4634,24,339039,73.14757281553398,8
0.2,4635,26,339065,73.13740293356342,8
0.2,4636,92,339157,73.1414707785206,11
0.2,4637,95,339252,73.14618369987063,7
0.2,4638,92,339344,73.15024789825394,9
0.2,4639,96,339440,73.15517241379311,6
0.2,4640,-131,339309,73.11118293471235,26
0.2,4641,96,339405,73.11611374407583,6
0.2,4642,94,339499,73.12061167348698,7
0.2,4643,96,339595,73.1255383290267,6
0.2,4644,95,339690,73.13024757804091,7
0.2,4645,25,339715,73.1198880757641,8
0.2,4646,95,339810,73.12459651387992,6
0.2,4647,93,339903,73.1288726333907,9
0.2,4648,93,339996,73.13314691331469,11
0.2,4649,90,340086,73.13677419354839,14
0.2,4650,94,340180,73.14125994409804,8
0.2,4651,87,340267,73.14423903697335,14
0.2,4652,91,340358,73.14807650977863,11
0.2,4653,95,340453,73.1527718091964,7
0.2,4654,95,340548,73.15746509129968,7
0.2,4655,93,340641,73.16172680412372,9
0.2,4656,91,340732,73.16555722568177,11
0.2,4657,95,340827,73.17024474023187,6
0.2,4658,94,340921,73.17471560420691,8
0.2,4659,91,341012,73.17854077253219,11
0.2,4660,90,341102,73.18214975327183,12
0.2,4661,86,341188,73.18489918489918,16
0.2,4662,91,341279,73.18871970834226,10
0.2,4663,92,341371,73.19275300171526,9
0.2,4664,95,341466,73.19742765273313,7
0.2,4665,92,341558,73.20145735105015,10
0.2,4666,95,341653,73.20612813370474,8
0.2,4667,94,341747,73.2105826906598,9
0.2,4668,93,341840,73.21482116084815,10
0.2,4669,94,341934,73.21927194860814,7
0.2,4670,91,342025,73.22307856989939,11
0.2,4671,26,342051,73.21297089041096,7
0.2,4672,18,342069,73.20115557457736,15
0.2,4673,93,342162,73.20539152759949,8
0.2,4674,94,342256,73.20983957219251,9
0.2,4675,92,342348,73.21385799828914,10
0.2,4676,92,342440,73.21787470600812,9
0.2,4677,95,342535,73.2225309961522,7
0.2,4678,93,342628,73.22675785424236,9
0.2,4679,87,342715,73.22970085470085,16
0.2,4680,95,342810,73.23435163426618,7
0.2,4681,92,342902,73.23835967535241,10
0.2,4682,25,342927,73.22805893657912,8
0.2,4683,94,343021,73.23249359521776,7
0.2,4684,95,343116,73.23713980789755,7
0.2,4685,93,343209,73.24135723431498,10
0.2,4686,95,343304,73.24599957328782,6
0.2,4687,20,343324,73.23464163822526,13
0.2,4688,25,343349,73.22435487310727,9
0.2,4689,-50,343299,73.19808102345415,15
0.2,4690,93,343392,73.20230228096355,9
0.2,4691,91,343483,73.20609548167093,10
0.2,4692,95,343578,73.21073939910505,6
0.2,4693,77,343655,73.21154665530464,26
0.2,4694,-49,343606,73.18551650692226,13
0.2,4695,94,343700,73.18994889267462,8
0.2,4696,92,343792,73.19395358739621,10
0.2,4697,94,343886,73.19838229033631,7
0.2,4698,91,343977,73.20217067461162,11
0.2,4699,88,344065,73.20531914893617,15
0.2,4700,-121,343944,73.16400765794512,17
0.2,4701,94,344038,73.16843896214377,7
0.2,4702,95,344133,73.17308101211992,6
0.2,4703,17,344150,73.16113945578232,18
0.2,4704,92,344242,73.16514346439958,11
0.2,4705,18,344260,73.15342116447088,16
0.2,4706,95,344355,73.15806246016571,7
0.2,4707,-125,344230,73.11597281223449,20
0.2,4708,92,344322,73.11998301125504,9
0.2,4709,95,344417,73.12462845010616,7
0.2,4710,90,344507,73.12821057100403,12
0.2,4711,23,344530,73.11757215619694,10
0.2,4712,94,344624,73.12200297050711,8
0.2,4713,91,344715,73.12579550275774,10
0.2,4714,94,344809,73.13022269353128,8
0.2,4715,91,344900,73.13401187446989,10
0.2,4716,93,344993,73.13822344710621,9
0.2,4717,95,345088,73.14285714285714,7
0.2,4718,95,345183,73.1474888747616,7
0.2,4719,93,345276,73.15169491525424,8
0.2,4720,94,345370,73.1561109934336,8
0.2,4721,24,345394,73.14570097416349,9
0.2,4722,95,345489,73.15032818124074,6
0.2,4723,93,345582,73.1545300592718,10
0.2,4724,95,345677,73.15915343915344,6
0.2,4725,24,345701,73.14875158696572,9
0.2,4726,95,345796,73.15337423312883,6
0.2,4727,95,345891,73.15799492385787,7
0.2,4728,93,345984,73.16219073799958,8
0.2,4729,93,346077,73.16638477801268,9
0.2,4730,94,346171,73.17078841682519,8
0.2,4731,95,346266,73.17540152155537,6
0.2,4732,21,346287,73.1643777730826,13
0.2,4733,92,346379,73.16835656949725,9
0.2,4734,92,346471,73.17233368532207,10
0.2,4735,94,346565,73.17673141891892,9
0.2,4736,94,346659,73.18112729575681,8
0.2,4737,-125,346534,73.13929928239763,24
0.2,4738,93,346627,73.14349018780334,10
0.2,4739,94,346721,73.14789029535865,9
0.2,4740,94,346815,73.1522885467201,8
0.2,4741,24,346839,73.1419232391396,8
0.2,4742,23,346862,73.13135146531731,10
0.2,4743,95,346957,73.13596121416526,7
0.2,4744,95,347052,73.14056902002108,7
0.2,4745,96,347148,73.14538558786346,6
0.2,4746,96,347244,73.15020012639562,6
0.2,4747,95,347339,73.15480202190396,6
0.2,4748,95,347434,73.15940197936408,6
0.2,4749,96,347530,73.16421052631578,6
0.2,4750,96,347626,73.16901704904231,6
0.2,4751,95,347721,73.17361111111111,8
0.2,4752,96,347817,73.17841363349463,6
0.2,4753,94,347911,73.1827934371056,7
0.2,4754,93,348004,73.1869610935857,8
0.2,4755,92,348096,73.19091673675358,9
0.2,4756,91,348187,73.19466050031532,11
0.2,4757,-48,348139,73.1691887347625,11
0.2,4758,22,348161,73.15843664635428,11
0.2,4759,-51,348110,73.13235294117646,14
0.2,4760,22,348132,73.12161310649023,11
0.2,4761,86,348218,73.12431751364973,15
0.2,4762,-60,348158,73.09636783539786,23
0.2,4763,95,348253,73.10096557514693,7
0.2,4764,96,348349,73.10577124868836,8
0.2,4765,24,348373,73.09546789760806,8
0.2,4766,95,348468,73.10006293266206,6
0.2,4767,-45,348423,73.07529362416108,9
0.2,4768,15,348438,73.06311595722374,19
0.2,4769,93,348531,73.06729559748428,8
0.2,4770,93,348624,73.07147348564243,10
0.2,4771,94,348718,73.07585917854149,8
0.2,4772,95,348813,73.08045254556882,6
0.2,4773,90,348903,73.08399664851278,12
0.2,4774,94,348997,73.08837696335078,7
0.2,4775,93,349090,73.0925460636516,9
0.2,4776,91,349181,73.09629474565627,10
0.2,4777,22,349203,73.0856006697363,10
0.2,4778,96,349299,73.090395480226,6
0.2,4779,94,349393,73.09476987447698,7
0.2,4780,26,349419,73.08491947291361,7
0.2,4781,92,349511,73.08887494772061,10
0.2,4782,-49,349462,73.0633493623249,13
0.2,4783,96,349558,73.06814381270902,6
0.2,4784,95,349653,73.07272727272728,6
0.2,4785,23,349676,73.0622649394066,12
0.2,4786,21,349697,73.05138917902653,11
0.2,4787,93,349790,73.05555555555556,10
0.2,4788,93,349883,73.05972019210691,9
0.2,4789,95,349978,73.0643006263048,6
0.2,4790,92,350070,73.06825297432687,10
0.2,4791,93,350163,73.07241235392321,8
0.2,4792,89,350252,73.07573544752765,13
0.2,4793,94,350346,73.08010012515645,9
0.2,4794,-49,350297,73.05464025026069,14
0.2,4795,96,350393,73.0594245204337,6
0.2,4796,92,350485,73.06337294142172,10
0.2,4797,96,350581,73.06815339724885,6
0.2,4798,20,350601,73.05709522817254,13
0.2,4799,92,350693,73.06104166666667,10
0.2,4800,94,350787,73.06540304103312,9
0.2,4801,93,350880,73.06955435235318,8
0.2,4802,91,350971,73.07328752862794,10
0.2,4803,93,351064,73.0774354704413,9
0.2,4804,94,351158,73.08178980228928,8
0.2,4805,94,351252,73.08614232209737,8
0.2,4806,92,351344,73.09007697108383,10
0.2,4807,23,351367,73.07965890183029,9
0.2,4808,-51,351316,73.05385735080058,15
0.2,4809,18,351334,73.04241164241164,14
0.2,4810,94,351428,73.04676782373727,10
0.2,4811,95,351523,73.05133000831255,6
0.2,4812,95,351618,73.05589029711199,7
0.2,4813,90,351708,73.05941005400913,11
0.2,4814,92,351800,73.06334371754933,9
0.2,4815,94,351894,73.06769102990033,7
0.2,4816,93,351987,73.07182893917376,9
0.2,4817,-52,351935,73.0458696554587,16
0.2,4818,93,352028,73.0500103755966,9
0.2,4819,95,352123,73.05456431535269,9
0.2,4820,23,352146,73.04418170504044,10
0.2,4821,96,352242,73.04894234757361,6
0.2,4822,91,352333,73.05266431681525,10
0.2,4823,93,352426,73.05679933665009,9
0.2,4824,90,352516,73.06031088082902,11
0.2,4825,95,352611,73.06485702445089,6
0.2,4826,21,352632,73.05407085146054,12
0.2,4827,-49,352583,73.0287903893952,13
0.2,4828,93,352676,73.03292607165045,9
0.2,4829,95,352771,73.03747412008282,7
0.2,4830,93,352864,73.04160629269302,9
0.2,4831,95,352959,73.04615066225166,6
0.2,4832,93,353052,73.05027932960894,8
0.2,4833,93,353145,73.05440628878776,8
0.2,4834,92,353237,73.0583247156153,10
0.2,4835,22,353259,73.04776674937965,13
0.2,4836,24,353283,73.03762662807526,9
0.2,4837,93,353376,73.04175279040926,8
0.2,4838,25,353401,73.03182475718124,8
0.2,4839,94,353495,73.03615702479338,7
0.2,4840,92,353587,73.04007436480066,10
0.2,4841,24,353611,73.02994630318051,9
0.2,4842,92,353703,73.03386330786702,10
0.2,4843,14,353717,73.02167630057804,19
0.2,4844,86,353803,73.02435500515996,18
0.2,4845,92,353895,73.0282707387536,10
0.2,4846,-189,353706,72.97421085207344,15
0.2,4847,95,353801,72.97875412541254,7
0.2,4848,96,353897,72.98350175293875,6
0.2,4849,94,353991,72.9878350515464,8
0.2,4850,88,354079,72.99092970521542,13
0.2,4851,93,354172,72.99505358615004,8
0.2,4852,95,354267,72.99958788378322,7
0.2,4853,93,354360,73.00370828182942,8
0.2,4854,95,354455,73.00823892893924,7
0.2,4855,95,354550,73.01276771004942,6
0.2,4856,91,354641,73.01647107267861,12
0.2,4857,93,354734,73.02058460271716,8
0.2,4858,19,354753,73.00946696851204,13
0.2,4859,23,354776,72.9991769547325,10
0.2,4860,94,354870,73.00349722279367,8
0.2,4861,95,354965,73.00802139037434,7
0.2,4862,94,355059,73.01233806292412,9
0.2,4863,94,355153,73.01665296052632,10
0.2,4864,94,355247,73.02096608427544,8
0.2,4865,-48,355199,72.99609535552815,13
0.2,4866,93,355292,73.00020546537908,10
0.2,4867,94,355386,73.00451930977815,8
0.2,4868,20,355406,72.99363318956665,12
0.2,4869,93,355499,72.99774127310062,9
0.2,4870,27,355526,72.98829809074113,6
0.2,4871,94,355620,72.99261083743842,7
0.2,4872,25,355645,72.98276215883439,8
0.2,4873,92,355737,72.98666393106278,10
0.2,4874,-45,355692,72.96246153846154,9
0.2,4875,95,355787,72.96698113207547,6
0.2,4876,92,355879,72.9708837400041,9
0.2,4877,94,355973,72.97519475194751,8
0.2,4878,24,355997,72.96515679442508,9
0.2,4879,93,356090,72.96926229508196,9
0.2,4880,19,356109,72.9582052858021,14
0.2,4881,94,356203,72.96251536255633,8
0.2,4882,94,356297,72.96682367397092,8
0.2,4883,21,356318,72.95618345618345,11
0.2,4884,92,356410,72.96008188331628,10
0.2,4885,95,356505,72.96459271387639,6
0.2,4886,93,356598,72.96869244935543,9
0.2,4887,95,356693,72.97319967266776,8
0.2,4888,95,356788,72.9777050521579,6
0.2,4889,24,356812,72.96768916155419,9
0.2,4890,96,356908,72.97239828255981,6
0.2,4891,21,356929,72.96177432542927,11
0.2,4892,95,357024,72.9662783568363,7
0.2,4893,94,357118,72.97057621577441,7
0.2,4894,94,357212,72.97487231869255,8
0.2,4895,91,357303,72.97855392156863,12
0.2,4896,93,357396,72.98264243414336,9
0.2,4897,96,357492,72.9873417721519,7
0.2,4898,22,357514,72.97693406817717,11
0.2,4899,94,357608,72.98122448979592,8
0.2,4900,92,357700,72.9851050805958,10
0.2,4901,94,357794,72.98939208486333,8
0.2,4902,93,357887,72.99347338364267,8
0.2,4903,94,357981,72.99775693311582,7
0.2,4904,91,358072,73.00142711518858,11
0.2,4905,96,358168,73.0061149612719,6
0.2,4906,21,358189,72.99551660892602,11
0.2,4907,26,358215,72.98594132029339,7
0.2,4908,93,358308,72.99001833367285,8
0.2,4909,94,358402,72.99429735234216,8
0.2,4910,94,358496,72.99857462838526,8
0.2,4911,94,358590,73.00285016286645,7
0.2,4912,80,358670,73.0042743741095,21
0.2,4913,22,358692,72.993894993895,11
0.2,4914,94,358786,72.99816887080367,7
0.2,4915,93,358879,73.00223759153783,8
0.2,4916,95,358974,73.00671140939598,6
0.2,4917,95,359069,73.01118340788939,6
0.2,4918,-53,359016,72.98556617198618,17
0.2,4919,96,359112,72.99024390243902,6
0.2,4920,-50,359062,72.96525096525096,15
0.2,4921,94,359156,72.96952458350265,8
0.2,4922,92,359248,72.97339020922202,11
0.2,4923,94,359342,72.97766043866775,9
0.2,4924,95,359437,72.98213197969544,7
0.2,4925,93,359530,72.98619569630532,9
0.2,4926,-56,359474,72.9600162370611,20
0.2,4927,95,359569,72.96448863636364,7
0.2,4928,93,359662,72.96855345911949,9
0.2,4929,93,359755,72.97261663286004,9
0.2,4930,95,359850,72.97708375583046,7
0.2,4931,90,359940,72.98053527980535,12
0.2,4932,95,360035,72.984998986418,7
0.2,4933,95,360130,72.98946088366436,6
0.2,4934,16,360146,72.97791286727457,16
0.2,4935,89,360235,72.9811588330632,13
0.2,4936,26,360261,72.97164269799474,8
0.2,4937,93,360354,72.97569866342648,9
0.2,4938,96,360450,72.98036039684146,6
0.2,4939,95,360545,72.98481781376518,6
0.2,4940,95,360640,72.9892734264319,7
0.2,4941,-50,360590,72.96438688789964,17
0.2,4942,26,360616,72.95488569694517,9
0.2,4943,95,360711,72.95934466019418,7
0.2,4944,95,360806,72.96380182002022,6
0.2,4945,92,360898,72.9676506267691,10
0.2,4946,96,360994,72.97230644835254,6
0.2,4947,94,361088,72.97655618431689,8
0.2,4948,94,361182,72.98080420286927,8
0.2,4949,24,361206,72.97090909090909,8
0.2,4950,20,361226,72.96021005857402,13
0.2,4951,27,361253,72.95092891760905,6
0.2,4952,25,361278,72.9412477286493,8
0.2,4953,96,361374,72.94590230117078,6
0.2,4954,95,361469,72.95035317860747,7
0.2,4955,94,361563,72.9546004842615,7
0.2,4956,91,361654,72.95824087149485,13
0.2,4957,93,361747,72.96228317870109,8
0.2,4958,93,361840,72.96632385561605,11
0.2,4959,-52,361788,72.94112903225806,20
0.2,4960,25,361813,72.93146543035678,8
0.2,4961,22,361835,72.92120112857718,12
0.2,4962,95,361930,72.92564980858351,7
0.2,4963,94,362024,72.92989524576954,7
0.2,4964,91,362115,72.93353474320242,11
0.2,4965,88,362203,72.93656866693516,13
0.2,4966,95,362298,72.9410106704248,7
0.2,4967,21,362319,72.93055555555556,13
0.2,4968,23,362342,72.92050714429463,10
0.2,4969,93,362435,72.92454728370221,8
0.2,4970,89,362524,72.92778113055724,13
0.2,4971,93,362617,72.93181818181819,9
0.2,4972,94,362711,72.93605469535491,8
0.2,4973,-51,362660,72.91113791716928,16
0.2,4974,19,362679,72.90030150753769,13
0.2,4975,92,362771,72.90413987138264,10
0.2,4976,95,362866,72.9085794655415,7
0.2,4977,93,362959,72.91261550823624,8
0.2,4978,95,363054,72.91705161679052,6
0.2,4979,95,363149,72.9214859437751,7
0.2,4980,24,363173,72.91166432443285,8
0.2,4981,94,363267,72.91589723002811,7
0.2,4982,92,363359,72.91972707204495,10
0.2,4983,93,363452,72.92375601926163,8
0.2,4984,90,363542,72.9271815446339,11
0.2,4985,95,363637,72.93160850381066,7
0.2,4986,22,363659,72.92139562863444,10
0.2,4987,94,363753,72.92562149157979,7
0.2,4988,93,363846,72.92964521948286,9
0.2,4989,92,363938,72.93346693386773,10
0.2,4990,95,364033,72.93788819875776,6
0.2,4991,93,364126,72.94190705128206,9
0.2,4992,90,364216,72.94532345283396,11
0.2,4993,91,364307,72.94893872647177,10
0.2,4994,92,364399,72.95275275275276,10
0.2,4995,24,364423,72.9429543634908,10
0.2,4996,93,364516,72.94696818090854,8
0.2,4997,92,364608,72.95078031212485,11
0.2,4998,22,364630,72.94058811762352,11
0.2,4999,21,364651,72.9302,11
0.2,5000,24,364675,72.92041591681664,9
0.2,5001,93,364768,72.92443022790884,8
0.2,5002,96,364864,72.92904257445532,6
0.2,5003,95,364959,72.93345323741008,6
0.2,5004,94,365053,72.93766233766233,8
0.2,5005,-117,364936,72.89972033559728,11
0.2,5006,93,365029,72.90373477132015,8
0.2,5007,18,365047,72.89277156549521,15
0.2,5008,95,365142,72.89718506687962,7
0.2,5009,93,365235,72.90119760479043,8
0.2,5010,96,365331,72.90580722410697,6
0.2,5011,26,365357,72.8964485235435,7
0.2,5012,94,365451,72.90065828845003,8
0.2,5013,91,365542,72.9042680494615,10
0.2,5014,87,365629,72.90707876370887,14
0.2,5015,87,365716,72.90988835725678,16
0.2,5016,96,365812,72.91449073151286,6
0.2,5017,93,365905,72.91849342367478,8
0.2,5018,20,365925,72.90794979079497,14
0.2,5019,25,365950,72.89840637450199,8
0.2,5020,90,366040,72.90181238797052,14
0.2,5021,92,366132,72.90561529271207,9
0.2,5022,93,366225,72.90961576746965,9
0.2,5023,95,366320,72.9140127388535,6
0.2,5024,95,366415,72.918407960199,6
0.2,5025,95,366510,72.92280143255074,7
0.2,5026,89,366599,72.9259996021484,12
0.2,5027,96,366695,72.93058870326173,6
0.2,5028,95,366790,72.93497713263073,7
0.2,5029,95,366885,72.93936381709742,6
0.2,5030,95,366980,72.94374875770225,6
0.2,5031,91,367071,72.94733704292528,10
0.2,5032,94,367165,72.95151996820981,8
0.2,5033,-56,367109,72.9259038537942,21
0.2,5034,94,367203,72.93008937437935,9
0.2,5035,89,367292,72.93328038125496,13
0.2,5036,95,367387,72.93766130633314,6
0.2,5037,96,367483,72.9422389837237,7
0.2,5038,94,367577,72.94641794006748,9
0.2,5039,86,367663,72.94900793650794,16
0.2,5040,95,367758,72.95338226542353,8
0.2,5041,95,367853,72.95775485918287,9
0.2,5042,93,367946,72.96172912948641,8
0.2,5043,-50,367896,72.93735130848533,14
0.2,5044,23,367919,72.92745292368681,9
0.2,5045,93,368012,72.93143083630598,9
0.2,5046,94,368106,72.9356053100852,8
0.2,5047,95,368201,72.93997622820919,6
0.2,5048,95,368296,72.94434541493365,7
0.2,5049,95,368391,72.94871287128713,7
0.2,5050,95,368486,72.95307859829737,7
0.2,5051,21,368507,72.94279493269993,13
0.2,5052,22,368529,72.9327132396596,11
0.2,5053,21,368550,72.92243767313019,11
0.2,5054,96,368646,72.92700296735904,6
0.2,5055,93,368739,72.93097310126582,9
0.2,5056,95,368834,72.93533715641685,6
0.2,5057,89,368923,72.93851324634242,12
0.2,5058,26,368949,72.92923502668512,7
0.2,5059,95,369044,72.93359683794466,7
0.2,5060,26,369070,72.92432325627347,7
0.2,5061,93,369163,72.92828921374951,9
0.2,5062,95,369258,72.93264862729608,9
0.2,5063,91,369349,72.93621642969984,11
0.2,5064,94,369443,72.94037512339585,9
0.2,5065,22,369465,72.93031977891827,11
0.2,5066,26,369491,72.92105782514308,7
0.2,5067,91,369582,72.92462509865825,12
0.2,5068,21,369603,72.9143815348195,12
0.2,5069,93,369696,72.91834319526627,9
0.2,5070,23,369719,72.90849930980083,10
0.2,5071,93,369812,72.91246056782335,9
0.2,5072,96,369908,72.9170116301991,6
0.2,5073,89,369997,72.92018131651557,13
0.2,5074,25,370022,72.91073891625616,8
0.2,5075,26,370048,72.90149724192277,7
0.2,5076,19,370067,72.89088044120544,15
0.2,5077,95,370162,72.89523434423,6
0.2,5078,93,370255,72.89919275447923,9
0.2,5079,95,370350,72.90354330708661,6
0.2,5080,96,370446,72.90808895886636,6
0.2,5081,94,370540,72.91223927587563,8
0.2,5082,26,370566,72.90301003344482,7
0.2,5083,87,370653,72.90578284815106,15
0.2,5084,93,370746,72.90973451327433,9
0.2,5085,91,370837,72.91329138812426,11
0.2,5086,89,370926,72.91645370552388,12
0.2,5087,24,370950,72.90683962264151,9
0.2,5088,93,371043,72.9107879740617,9
0.2,5089,95,371138,72.91512770137524,6
0.2,5090,91,371229,72.91868002357101,13
0.2,5091,96,371325,72.92321288295365,6
0.2,5092,22,371347,72.91321421559003,12
0.2,5093,91,371438,72.91676482135846,10
0.2,5094,-45,371393,72.8936211972522,10
0.2,5095,23,371416,72.88383045525903,10
0.2,5096,13,371429,72.87208161663723,20
0.2,5097,24,371453,72.86249509611612,9
0.2,5098,95,371548,72.86683663463424,8
0.2,5099,95,371643,72.87117647058824,8
0.2,5100,84,371727,72.87335816506567,18
0.2,5101,93,371820,72.87730301842414,9
0.2,5102,91,371911,72.88085439937292,11
0.2,5103,95,372006,72.8851880877743,7
0.2,5104,93,372099,72.88912830558276,8
0.2,5105,94,372193,72.89326282804544,8
0.2,5106,93,372286,72.89719992167613,12
0.2,5107,95,372381,72.90152701644479,7
0.2,5108,89,372470,72.90467801918183,13
0.2,5109,27,372497,72.89569471624266,6
0.2,5110,93,372590,72.8996282527881,9
0.2,5111,94,372684,72.90375586854461,7
0.2,5112,94,372778,72.90788186974379,8
0.2,5113,91,372869,72.9114196323817,14
0.2,5114,95,372964,72.91573802541545,6
0.2,5115,93,373057,72.91966379984363,9
0.2,5116,95,373152,72.92397889388313,7
0.2,5117,27,373179,72.91500586166471,6
0.2,5118,93,373272,72.91892947841376,8
0.2,5119,95,373367,72.9232421875,7
0.2,5120,26,373393,72.91407928139036,8
0.2,5121,92,373485,72.9178055447091,12
0.2,5122,21,373506,72.90767128635565,12
0.2,5123,24,373530,72.89812646370024,9
0.2,5124,22,373552,72.88819512195121,11
0.2,5125,93,373645,72.89211861100273,9
0.2,5126,96,373741,72.89662570704115,6
0.2,5127,95,373836,72.9009360374415,7
0.2,5128,95,373931,72.9052446870735,6
0.2,5129,91,374022,72.90877192982457,11
0.2,5130,95,374117,72.91307737283181,7
0.2,5131,87,374204,72.91582229150428,14
0.2,5132,93,374297,72.91973504773037,9
0.2,5133,94,374391,72.92384105960265,7
0.2,5134,21,374412,72.91372930866602,11
0.2,5135,23,374435,72.9040109034268,11
0.2,5136,95,374530,72.90831224450068,6
0.2,5137,93,374623,72.91222265472946,9
0.2,5138,23,374646,72.90251021599533,12
0.2,5139,94,374740,72.90661478599222,8
0.2,5140,19,374759,72.8961291577514,14
0.2,5141,-47,374712,72.87281213535589,12
0.2,5142,92,374804,72.87653120746646,9
0.2,5143,89,374893,72.87966562986003,13
0.2,5144,92,374985,72.88338192419825,10
0.2,5145,94,375079,72.88748542557326,8
0.2,5146,26,375105,72.87837575286575,7
0.2,5147,95,375200,72.88267288267288,8
0.2,5148,92,375292,72.88638570596233,10
0.2,5149,96,375388,72.89087378640777,6
0.2,5150,95,375483,72.89516598718696,6
0.2,5151,94,375577,72.89926242236025,8
0.2,5152,95,375672,72.90355132932272,7
0.2,5153,95,375767,72.90783857198292,7
0.2,5154,93,375860,72.9117361784675,9
0.2,5155,94,375954,72.91582622187742,8
0.2,5156,95,376049,72.92010859026566,8
0.2,5157,95,376144,72.92438929817759,6
0.2,5158,-52,376092,72.90017445241325,16
0.2,5159,93,376185,72.90406976744185,9
0.2,5160,94,376279,72.90815733385003,7
0.2,5161,93,376372,72.91204959318094,9
0.2,5162,96,376468,72.9165214022855,6
0.2,5163,87,376555,72.91924864446166,15
0.2,5164,92,376647,72.92294288480154,10
0.2,5165,23,376670,72.91327913279133,11
0.2,5166,91,376761,72.91677956260887,13
0.2,5167,93,376854,72.92066563467492,9
0.2,5168,95,376949,72.92493712516928,6
0.2,5169,-190,376759,72.87408123791103,15
0.2,5170,92,376851,72.87777992651324,11
0.2,5171,24,376875,72.86832946635731,9
0.2,5172,90,376965,72.87164121399574,12
0.2,5173,88,377053,72.8745651333591,17
0.2,5174,23,377076,72.86492753623189,10
0.2,5175,-46,377030,72.8419629057187,10
0.2,5176,94,377124,72.84604983581225,8
0.2,5177,93,377217,72.84994206257242,9
0.2,5178,95,377312,72.85421896118942,6
0.2,5179,96,377408,72.85868725868725,6
0.2,5180,19,377427,72.84829183555298,14
0.2,5181,92,377519,72.85198764955615,10
0.2,5182,94,377613,72.85606791433533,7
0.2,5183,94,377707,72.86014660493827,8
0.2,5184,20,377727,72.84995178399228,13
0.2,5185,93,377820,72.85383725414577,9
0.2,5186,94,377914,72.85791401580876,7
0.2,5187,95,378009,72.86218195836545,8
0.2,5188,17,378026,72.85141645789169,15
0.2,5189,92,378118,72.85510597302505,9
0.2,5190,87,378205,72.85783086110575,14
0.2,5191,95,378300,72.86209553158706,6
0.2,5192,95,378395,72.86635855959946,7
0.2,5193,25,378420,72.85714285714286,8
0.2,5194,96,378516,72.86159769008663,6
0.2,5195,93,378609,72.86547344110855,9
0.2,5196,93,378702,72.86934770059649,8
0.2,5197,92,378794,72.87302808772606,10
0.2,5198,94,378888,72.87709174841315,7
0.2,5199,93,378981,72.88096153846153,8
0.2,5200,95,379076,72.88521438184965,7
0.2,5201,93,379169,72.88908112264514,8
0.2,5202,90,379259,72.89236978666155,13
0.2,5203,21,379280,72.88239815526518,12
0.2,5204,89,379369,72.88549471661864,14
0.2,5205,85,379454,72.88782174414138,17
0.2,5206,95,379549,72.8920683695026,8
0.2,5207,94,379643,72.89612135176651,8
0.2,5208,95,379738,72.90036475331158,7
0.2,5209,95,379833,72.9046065259117,6
0.2,5210,91,379924,72.90807906351948,11
0.2,5211,93,380017,72.91193399846507,10
0.2,5212,25,380042,72.90274314214464,8
0.2,5213,91,380133,72.90621403912543,11
0.2,5214,94,380227,72.91025886864813,9
0.2,5215,24,380251,72.90088190184049,8
0.2,5216,94,380345,72.90492620279855,8
0.2,5217,96,380441,72.90935224223841,6
0.2,5218,93,380534,72.91320176278981,10
0.2,5219,26,380560,72.90421455938697,7
0.2,5220,27,380587,72.89542233288643,7
0.2,5221,94,380681,72.89946380697052,9
0.2,5222,93,380774,72.90331227264025,10
0.2,5223,22,380796,72.89356814701378,12
0.2,5224,92,380888,72.89722488038278,10
0.2,5225,21,380909,72.88729429774206,12
0.2,5226,23,380932,72.87775014348574,10
0.2,5227,92,381024,72.8814078041316,11
0.2,5228,94,381118,72.88544654809715,8
0.2,5229,24,381142,72.87609942638623,9
0.2,5230,88,381230,72.8789906327662,14
0.2,5231,92,381322,72.88264525993884,9
0.2,5232,93,381415,72.8864895853239,9
0.2,5233,93,381508,72.89033244172717,8
0.2,5234,90,381598,72.89360076408786,12
0.2,5235,94,381692,72.89763177998472,7
0.2,5236,95,381787,72.90185220546114,7
0.2,5237,94,381881,72.90588010691104,9
0.2,5238,23,381904,72.89635426608132,9
0.2,5239,19,381923,72.88606870229007,14
0.2,5240,96,382019,72.89047891623736,6
0.2,5241,96,382115,72.8948874475391,8
0.2,5242,27,382142,72.88613389280945,6
0.2,5243,96,382238,72.8905415713196,6
0.2,5244,93,382331,72.89437559580553,9
0.2,5245,-54,382277,72.87018680899733,17
0.2,5246,95,382372,72.87440442157423,6
0.2,5247,93,382465,72.8782393292683,9
0.2,5248,95,382560,72.88245380072395,6
0.2,5249,95,382655,72.88666666666667,6
0.2,5250,91,382746,72.89011616834888,11
0.2,5251,-121,382625,72.85319878141661,16
0.2,5252,94,382719,72.85722444317533,8
0.2,5253,-51,382668,72.83365055196042,15
0.2,5254,21,382689,72.82378686964796,12
0.2,5255,92,382781,72.82743531202435,10
0.2,5256,94,382875,72.83146281148944,8
0.2,5257,96,382971,72.83586915176873,7
0.2,5258,96,383067,72.84027381631489,6
0.2,5259,96,383163,72.84467680608365,6
0.2,5260,95,383258,72.84888804409808,7
0.2,5261,93,383351,72.85271759787153,9
0.2,5262,26,383377,72.84381531445943,7
0.2,5263,91,383468,72.84726443768997,13
0.2,5264,19,383487,72.83703703703704,13
0.2,5265,95,383582,72.84124572730725,7
0.2,5266,92,383674,72.84488323523827,10
0.2,5267,92,383766,72.84851936218679,9
0.2,5268,96,383862,72.85291326627444,6
0.2,5269,95,383957,72.85711574952562,6
0.2,5270,94,384051,72.86112692088788,9
0.2,5271,26,384077,72.85223823975721,7
0.2,5272,94,384171,72.85624881471648,9
0.2,5273,94,384265,72.8602578687903,7
0.2,5274,92,384357,72.86388625592417,9
0.2,5275,94,384451,72.86789234268385,8
0.2,5276,18,384469,72.85749478870571,14
0.2,5277,94,384563,72.86150056839712,8
0.2,5278,26,384589,72.8526236029551,6
0.2,5279,21,384610,72.84280303030303,12
0.2,5280,93,384703,72.84661995834122,9
0.2,5281,25,384728,72.83756152972359,8
0.2,5282,89,384817,72.84062085936021,13
0.2,5283,93,384910,72.8444360333081,10
0.2,5284,95,385005,72.84862819299906,7
0.2,5285,92,385097,72.85225122966327,9
0.2,5286,95,385192,72.85644032532628,7
0.2,5287,93,385285,72.86024962178517,9
0.2,5288,25,385310,72.8512006050293,9
0.2,5289,94,385404,72.85519848771267,8
0.2,5290,91,385495,72.85862785862786,10
0.2,5291,94,385589,72.86262282690853,8
0.2,5292,91,385680,72.86604949933874,10
0.2,5293,95,385775,72.87023044956554,7
0.2,5294,-49,385726,72.84721435316337,13
0.2,5295,90,385816,72.85045317220543,12
0.2,5296,23,385839,72.84104209930149,9
0.2,5297,96,385935,72.84541336353341,6
0.2,5298,95,386030,72.8495942630685,6
0.2,5299,94,386124,72.85358490566038,7
0.2,5300,94,386218,72.85757404263346,9
0.2,5301,95,386313,72.86175028291211,7
0.2,5302,89,386402,72.8647935131058,16
0.2,5303,94,386496,72.86877828054298,7
0.2,5304,20,386516,72.8588124410933,14
0.2,5305,89,386605,72.86185450433472,12
0.2,5306,91,386696,72.86527228189185,11
0.2,5307,88,386784,72.86812358703843,13
0.2,5308,92,386876,72.87172725560369,11
0.2,5309,23,386899,72.8623352165725,10
0.2,5310,93,386992,72.86612690642063,8
0.2,5311,26,387018,72.85730421686748,7
0.2,5312,92,387110,72.8609072087333,10
0.2,5313,95,387205,72.86507339104253,6
0.2,5314,95,387300,72.8692380056444,7
0.2,5315,94,387394,72.8732129420617,7
0.2,5316,84,387478,72.87530562347189,18
0.2,5317,94,387572,72.87927792403158,7
0.2,5318,18,387590,72.86896033088927,18
0.2,5319,21,387611,72.85921052631579,11
0.2,5320,24,387635,72.85002819018982,9
0.2,5321,26,387661,72.84122510334461,7
0.2,5322,94,387755,72.8452000751456,8
0.2,5323,22,387777,72.83564988730278,11
0.2,5324,95,387872,72.83981220657277,6
0.2,5325,93,387965,72.84359744648893,9
0.2,5326,95,388060,72.84775671109442,7
0.2,5327,95,388155,72.85191441441441,7
0.2,5328,16,388171,72.84124601238506,17
0.2,5329,92,388263,72.84484052532834,10
0.2,5330,92,388355,72.84843368973927,9
0.2,5331,95,388450,72.85258814703676,6
0.2,5332,26,388476,72.8438027376711,8
0.2,5333,95,388571,72.84795650543683,7
0.2,5334,95,388666,72.85210871602624,6
0.2,5335,95,388761,72.85625937031485,7
0.2,5336,93,388854,72.86003372681282,8
0.2,5337,93,388947,72.86380666916448,8
0.2,5338,22,388969,72.85427982768309,14
0.2,5339,95,389064,72.85842696629213,6
0.2,5340,26,389090,72.84965362291706,7
0.2,5341,92,389182,72.85323848745789,10
0.2,5342,26,389208,72.84446939921392,7
0.2,5343,95,389303,72.84861526946108,6
0.2,5344,95,389398,72.85275958840037,7
0.2,5345,-50,389348,72.82977927422372,14
0.2,5346,91,389439,72.83317748270058,13
0.2,5347,25,389464,72.82423335826478,8
0.2,5348,79,389543,72.82538792297626,24
0.2,5349,93,389636,72.82915887850467,9
0.2,5350,96,389732,72.83348906746403,6
0.2,5351,96,389828,72.83781763826607,6
0.2,5352,96,389924,72.84214459181767,6
0.2,5353,94,390018,72.8460963765409,7
0.2,5354,22,390040,72.83660130718954,11
0.2,5355,96,390136,72.84092606422703,6
0.2,5356,95,390231,72.84506253500093,6
0.2,5357,90,390321,72.84826427771557,12
0.2,5358,26,390347,72.83952229893637,7
0.2,5359,-53,390294,72.8160447761194,17
0.2,5360,95,390389,72.8201828017161,6
0.2,5361,94,390483,72.82413278627378,7
0.2,5362,96,390579,72.82845422338244,6
0.2,5363,93,390672,72.83221476510067,8
0.2,5364,89,390761,72.83522833178006,15
0.2,5365,91,390852,72.8386134923593,12
0.2,5366,92,390944,72.84218371529718,10
0.2,5367,95,391039,72.84631147540983,8
0.2,5368,94,391133,72.85025144347178,8
0.2,5369,96,391229,72.85456238361266,6
0.2,5370,89,391318,72.85756842301248,13
0.2,5371,94,391412,72.86150409530902,8
0.2,5372,19,391431,72.85147962032384,13
0.2,5373,92,391523,72.85504279866022,9
0.2,5374,87,391610,72.85767441860465,16
0.2,5375,95,391705,72.8617931547619,6
0.2,5376,93,391798,72.86553840431468,8
0.2,5377,93,391891,72.86928226106359,9
0.2,5378,94,391985,72.87321063394683,10
0.2,5379,25,392010,72.864312267658,8
0.2,5380,89,392099,72.86731090875303,12
0.2,5381,93,392192,72.87105165366034,8
0.2,5382,94,392286,72.87497677874791,10
0.2,5383,95,392381,72.87908618127786,7
0.2,5384,93,392474,72.8828226555246,9
0.2,5385,94,392568,72.88674340883773,7
0.2,5386,18,392586,72.87655466864675,15
0.2,5387,95,392681,72.88066072754269,7
0.2,5388,95,392776,72.8847652625719,7
0.2,5389,-51,392725,72.86178107606679,15
0.2,5390,90,392815,72.86496011871638,12
0.2,5391,93,392908,72.8686943620178,10
0.2,5392,-55,392853,72.8449842388281,19
0.2,5393,94,392947,72.84890619206526,8
0.2,5394,91,393038,72.85227062094532,13
0.2,5395,95,393133,72.85637509266122,7
0.2,5396,21,393154,72.84676672225311,12
0.2,5397,25,393179,72.83790292701,8
0.2,5398,27,393206,72.82941285423226,6
0.2,5399,88,393294,72.83222222222223,13
0.2,5400,90,393384,72.83540085169413,12
0.2,5401,-53,393331,72.81210662717513,17
0.2,5402,95,393426,72.81621321488062,7
0.2,5403,25,393451,72.80736491487787,8
0.2,5404,92,393543,72.8109158186864,9
0.2,5405,95,393638,72.81502034776175,6
0.2,5406,90,393728,72.81819863140373,12
0.2,5407,96,393824,72.8224852071006,6
0.2,5408,92,393916,72.82603068959142,9
0.2,5409,95,394011,72.83012939001848,7
0.2,5410,92,394103,72.83367214932545,9
0.2,5411,95,394198,72.83776792313378,7
0.2,5412,91,394289,72.84112322187327,10
0.2,5413,95,394384,72.84521610639084,7
0.2,5414,91,394475,72.84856879039704,10
0.2,5415,21,394496,72.83899556868538,13
0.2,5416,95,394591,72.84308657928743,6
0.2,5417,94,394685,72.84699150978221,8
0.2,5418,95,394780,72.85107953496956,8
0.2,5419,23,394803,72.84188191881918,10
0.2,5420,15,394818,72.83121195351411,18
0.2,5421,95,394913,72.83530062707489,6
0.2,5422,18,394931,72.82518900977318,17
0.2,5423,95,395026,72.82927728613569,7
0.2,5424,23,395049,72.82009216589861,11
0.2,5425,93,395142,72.82381127902691,8
0.2,5426,19,395161,72.81389349548553,15
0.2,5427,96,395257,72.81816507000737,8
0.2,5428,15,395272,72.80751519616872,17
0.2,5429,95,395367,72.81160220994475,7
0.2,5430,93,395460,72.8153194623458,9
0.2,5431,91,395551,72.81866715758468,11
0.2,5432,94,395645,72.82256580158293,8
0.2,5433,96,395741,72.82683106367317,6
0.2,5434,93,395834,72.83054277828887,10
0.2,5435,-50,395784,72.80794701986756,13
0.2,5436,92,395876,72.81147691741769,11
0.2,5437,96,395972,72.81574108127988,7
0.2,5438,94,396066,72.81963596249311,7
0.2,5439,93,396159,72.8233455882353,8
0.2,5440,93,396252,72.82705385039515,10
0.2,5441,25,396277,72.81826534362366,8
0.2,5442,93,396370,72.82197317655705,9
0.2,5443,96,396466,72.82623071271124,6
0.2,5444,23,396489,72.81707988980716,10
0.2,5445,25,396514,72.8082996694822,9
0.2,5446,91,396605,72.81163943455113,13
0.2,5447,95,396700,72.81571218795888,8
0.2,5448,20,396720,72.80601945311066,13
0.2,5449,95,396815,72.81009174311927,6
0.2,5450,95,396910,72.81416253898367,7
0.2,5451,23,396933,72.80502567865004,10
0.2,5452,91,397024,72.80836236933798,10
0.2,5453,96,397120,72.81261459479282,6
0.2,5454,96,397216,72.81686526122823,6
0.2,5455,93,397309,72.82056451612904,8
0.2,5456,20,397329,72.81088510170423,14
0.2,5457,94,397423,72.81476731403444,8
0.2,5458,93,397516,72.81846492031508,8
0.2,5459,17,397533,72.80824175824176,17
0.2,5460,95,397628,72.81230543856437,6
0.2,5461,95,397723,72.81636763090444,6
0.2,5462,22,397745,72.80706571480872,11
0.2,5463,95,397840,72.81112737920937,7
0.2,5464,92,397932,72.8146386093321,9
0.2,5465,26,397958,72.80607391145261,7
0.2,5466,95,398053,72.81013352844339,7
0.2,5467,18,398071,72.80010972933431,14
0.2,5468,90,398161,72.80325470835619,11
0.2,5469,93,398254,72.80694698354662,9
0.2,5470,21,398275,72.79747760921221,12
0.2,5471,96,398371,72.80171783625731,6
0.2,5472,25,398396,72.79298373835191,8
0.2,5473,90,398486,72.79612714651078,11
0.2,5474,96,398582,72.80036529680365,6
0.2,5475,25,398607,72.79163623082542,8
0.2,5476,94,398701,72.7955084900493,8
0.2,5477,96,398797,72.79974443227455,6
0.2,5478,92,398889,72.80324876802337,10
0.2,5479,93,398982,72.80693430656935,9
0.2,5480,94,399076,72.81080094873198,8
0.2,5481,94,399170,72.8146661802262,7
0.2,5482,93,399263,72.81834761991611,8
0.2,5483,95,399358,72.82239241429613,7
0.2,5484,95,399453,72.82643573381951,7
0.2,5485,93,399546,72.83011301494714,8
0.2,5486,94,399640,72.83397120466557,7
0.2,5487,92,399732,72.83746355685132,9
0.2,5488,88,399820,72.84022590635817,13
0.2,5489,96,399916,72.84444444444445,7
0.2,5490,91,400007,72.8477508650519,11
0.2,5491,93,400100,72.85142024763292,9
0.2,5492,95,400195,72.85545239395594,7
0.2,5493,24,400219,72.84655988350929,9
0.2,5494,83,400302,72.8484076433121,18
0.2,5495,26,400328,72.83988355167395,7
0.2,5496,93,400421,72.84355102783336,9
0.2,5497,92,400513,72.84703528555839,10
0.2,5498,96,400609,72.85124568103292,6
0.2,5499,88,400697,72.854,13
0.2,5500,26,400723,72.84548263952009,7
0.2,5501,94,400817,72.84932751726645,8
0.2,5502,87,400904,72.85189896420134,14
0.2,5503,93,400997,72.85555959302326,8
0.2,5504,95,401092,72.85958219800182,7
0.2,5505,95,401187,72.86360334180894,8
0.2,5506,15,401202,72.85309605956056,18
0.2,5507,22,401224,72.84386347131445,12
0.2,5508,94,401318,72.84770375748775,8
0.2,5509,91,401409,72.85099818511797,11
0.2,5510,93,401502,72.85465432770822,8
0.2,5511,95,401597,72.85867198838896,6
0.2,5512,93,401690,72.86232541266098,9
0.2,5513,90,401780,72.86543344214726,11
0.2,5514,93,401873,72.86908431550317,10
0.2,5515,87,401960,72.87164612037708,14
0.2,5516,88,402048,72.87438825448613,17
0.2,5517,93,402141,72.87803552011599,12
0.2,5518,90,402231,72.88113788729842,13
0.2,5519,22,402253,72.87192028985507,11
0.2,5520,95,402348,72.87592827386344,7
0.2,5521,94,402442,72.87975371242304,8
0.2,5522,25,402467,72.8710845554952,8
0.2,5523,95,402562,72.8750905141202,8
0.2,5524,95,402657,72.87909502262444,6
0.2,5525,92,402749,72.88255519363011,9
0.2,5526,95,402844,72.88655690247874,6
0.2,5527,91,402935,72.88983357452966,10
0.2,5528,95,403030,72.89383251944294,7
0.2,5529,93,403123,72.89746835443037,9
0.2,5530,18,403141,72.88754293979389,15
0.2,5531,-49,403092,72.86550976138828,14
0.2,5532,24,403116,72.85667811313935,9
0.2,5533,95,403211,72.86067943621251,6
0.2,5534,89,403300,72.86359530261969,12
0.2,5535,-49,403251,72.8415823699422,13
0.2,5536,93,403344,72.8452230449702,9
0.2,5537,20,403364,72.83568075117371,13
0.2,5538,93,403457,72.83932117710778,9
0.2,5539,18,403475,72.82942238267148,15
0.2,5540,21,403496,72.82006857967876,12
0.2,5541,95,403591,72.82407073258751,7
0.2,5542,94,403685,72.82789103373625,8
0.2,5543,19,403704,72.81818181818181,14
0.2,5544,91,403795,72.8214607754734,11
0.2,5545,93,403888,72.82509917057338,8
0.2,5546,95,403983,72.829096809086,7
0.2,5547,-46,403937,72.80767844268205,10
0.2,5548,90,404027,72.8107767165255,11
0.2,5549,95,404122,72.81477477477478,6
0.2,5550,95,404217,72.81877139254189,7
0.2,5551,93,404310,72.82240634005764,8
0.2,5552,94,404404,72.82622006122817,7
0.2,5553,-120,404284,72.79150162045373,15
0.2,5554,93,404377,72.7951395139514,8
0.2,5555,91,404468,72.79841612670987,11
0.2,5556,96,404564,72.80259132625517,6
0.2,5557,91,404655,72.80586541921555,11
0.2,5558,94,404749,72.80967799964023,8
0.2,5559,92,404841,72.81312949640288,10
0.2,5560,95,404936,72.8171192231613,6
0.2,5561,94,405030,72.82092772384034,8
0.2,5562,96,405126,72.82509437353946,7
0.2,5563,94,405220,72.82890007189073,8
0.2,5564,93,405313,72.83252470799641,9
0.2,5565,91,405404,72.83578871721164,11
0.2,5566,94,405498,72.839590443686,7
0.2,5567,91,405589,72.84285201149426,13
0.2,5568,93,405682,72.84647153887592,8
0.2,5569,93,405775,72.85008976660683,9
0.2,5570,89,405864,72.8529886914378,12
0.2,5571,-55,405809,72.83004307250539,18
0.2,5572,95,405904,72.83402117351517,6
0.2,5573,93,405997,72.83763903839254,9
0.2,5574,93,406090,72.84125560538116,10
0.2,5575,96,406186,72.84540889526542,6
0.2,5576,-49,406137,72.82356105433028,13
0.2,5577,21,406158,72.8142703477949,12
0.2,5578,92,406250,72.81770926689371,10
0.2,5579,94,406344,72.82150537634409,9
0.2,5580,94,406438,72.82530012542556,7
0.2,5581,91,406529,72.82855607309209,11
0.2,5582,92,406621,72.83198996955042,11
0.2,5583,95,406716,72.83595988538681,6
0.2,5584,93,406809,72.83957027752909,9
0.2,5585,91,406900,72.84282133906194,12
0.2,5586,25,406925,72.83425809915876,8
0.2,5587,91,407016,72.83750894774516,10
0.2,5588,94,407110,72.84129540168188,7
0.2,5589,95,407205,72.84525939177102,6
0.2,5590,22,407227,72.83616526560543,12
0.2,5591,96,407323,72.84030758226037,6
0.2,5592,94,407417,72.8440908278205,8
0.2,5593,23,407440,72.83518055058991,10
0.2,5594,93,407533,72.83878462913316,8
0.2,5595,88,407621,72.8414939242316,14
0.2,5596,94,407715,72.84527425406468,9
0.2,5597,94,407809,72.84905323329761,8
0.2,5598,95,407904,72.85300946597607,6
0.2,5599,93,407997,72.85660714285714,9
0.2,5600,26,408023,72.84824138546688,8
0.2,5601,95,408118,72.8521956444127,6
0.2,5602,94,408212,72.85597001606283,8
0.2,5603,95,408307,72.85992148465382,6
0.2,5604,95,408402,72.86387154326495,6
0.2,5605,92,408494,72.86728505173029,9
0.2,5606,95,408589,72.87123238808633,6
0.2,5607,25,408614,72.86269614835949,7
0.2,5608,25,408639,72.85416295239793,8
0.2,5609,24,408663,72.84545454545454,8
0.2,5610,27,408690,72.83728390661202,6
0.2,5611,88,408778,72.8399857448325,14
0.2,5612,20,408798,72.83057188669162,13
0.2,5613,93,408891,72.83416458852868,8
0.2,5614,93,408984,72.83775601068567,9
0.2,5615,-50,408934,72.81588319088318,14
0.2,5616,95,409029,72.81983265088125,7
0.2,5617,21,409050,72.81060875756496,13
0.2,5618,93,409143,72.81420181526963,9
0.2,5619,93,409236,72.81779359430605,10
0.2,5620,92,409328,72.82120619106921,11
0.2,5621,96,409424,72.82532906438989,6
0.2,5622,95,409519,72.82927263026853,7
0.2,5623,92,409611,72.83268136557611,9
0.2,5624,92,409703,72.8360888888889,11
0.2,5625,-49,409654,72.81443298969072,13
0.2,5626,93,409747,72.8180202594633,9
0.2,5627,95,409842,72.82196162046908,7
0.2,5628,-48,409794,72.800497424054,13
0.2,5629,96,409890,72.80461811722913,6
0.2,5630,93,409983,72.80820458177944,8
0.2,5631,93,410076,72.81178977272727,9
0.2,5632,95,410171,72.81572874134564,6
0.2,5633,95,410266,72.81966631167909,6
0.2,5634,89,410355,72.82253771073647,13
0.2,5635,93,410448,72.82611781405252,9
0.2,5636,95,410543,72.8300514458045,8
0.2,5637,88,410631,72.83274210713019,15
0.2,5638,95,410726,72.8366731690016,7
0.2,5639,93,410819,72.84024822695035,8
0.2,5640,86,410905,72.84258110264138,15
0.2,5641,96,411001,72.84668557249202,6
0.2,5642,92,411093,72.85007974481658,9
0.2,5643,20,411113,72.84071580439405,15
0.2,5644,24,411137,72.83206377325067,9
0.2,5645,95,411232,72.83599008147361,7
0.2,5646,25,411257,72.82751903665662,8
0.2,5647,26,411283,72.81922804532577,7
0.2,5648,95,411378,72.82315454062666,7
0.2,5649,93,411471,72.82672566371681,8
0.2,5650,92,411563,72.83011856308617,11
0.2,5651,95,411658,72.83404104741685,6
0.2,5652,93,411751,72.83760834954892,9
0.2,5653,22,411773,72.82861690838345,11
0.2,5654,91,411864,72.8318302387268,11
0.2,5655,19,411883,72.8223125884017,15
0.2,5656,94,411977,72.82605621354075,7
0.2,5657,95,412072,72.8299752562743,7
0.2,5658,96,412168,72.83406962360841,6
0.2,5659,85,412253,72.83621908127209,19
0.2,5660,82,412335,72.83783783783784,20
0.2,5661,22,412357,72.82885906040268,11
0.2,5662,16,412373,72.81882394490553,17
0.2,5663,95,412468,72.82274011299435,7
0.2,5664,25,412493,72.81429832303618,8
0.2,5665,96,412589,72.81839039887045,6
0.2,5666,95,412684,72.82230457031939,7
0.2,5667,95,412779,72.82621736062103,6
0.2,5668,95,412874,72.83012877050626,6
0.2,5669,27,412901,72.82204585537919,6
0.2,5670,25,412926,72.8136131193793,7
0.2,5671,96,413022,72.81770098730607,6
0.2,5672,94,413116,72.82143486691345,9
0.2,5673,95,413211,72.82534367289391,7
0.2,5674,96,413307,72.82942731277534,6
0.2,5675,96,413403,72.83350951374207,6
0.2,5676,93,413496,72.8370618284305,8
0.2,5677,92,413588,72.8404367735118,11
0.2,5678,87,413675,72.84293009332629,16
0.2,5679,91,413766,72.84612676056338,13
0.2,5680,96,413862,72.8502024291498,6
0.2,5681,93,413955,72.85374868004224,9
0.2,5682,95,414050,72.85764560971317,6
0.2,5683,93,414143,72.86118930330753,8
0.2,5684,95,414238,72.8650835532102,6
0.2,5685,94,414332,72.8688005627858,8
0.2,5686,25,414357,72.86038333040267,11
0.2,5687,26,414383,72.85214486638537,7
0.2,5688,87,414470,72.85463174547372,15
0.2,5689,96,414566,72.85869947275923,6
0.2,5690,95,414661,72.86259005447198,7
0.2,5691,23,414684,72.85382993675334,9
0.2,5692,-48,414636,72.83260144036537,12
0.2,5693,92,414728,72.83596768528275,10
0.2,5694,93,414821,72.83950834064969,9
0.2,5695,92,414913,72.84287219101124,12
0.2,5696,95,415008,72.84676145339652,7
0.2,5697,23,415031,72.83801333801334,9
0.2,5698,93,415124,72.84155114932445,9
0.2,5699,95,415219,72.84543859649123,7
0.2,5700,95,415314,72.84932467988072,8
0.2,5701,-47,415267,72.82830585759383,11
0.2,5702,94,415361,72.83201823601613,8
0.2,5703,94,415455,72.83572931276298,8
0.2,5704,93,415548,72.83926380368098,9
0.2,5705,95,415643,72.84314756396775,7
0.2,5706,89,415732,72.845978622744,12
0.2,5707,93,415825,72.84950946040645,8
0.2,5708,95,415920,72.85338938518129,7
0.2,5709,95,416015,72.85726795096322,7
0.2,5710,93,416108,72.86079495710034,10
0.2,5711,93,416201,72.86432072829132,9
0.2,5712,95,416296,72.8681953439524,7
0.2,5713,92,416388,72.87154357717885,10
0.2,5714,-52,416336,72.84969378827647,15
0.2,5715,94,416430,72.85339398180545,8
0.2,5716,94,416524,72.85709288088158,8
0.2,5717,95,416619,72.86096537250786,7
0.2,5718,19,416638,72.8515474733345,13
0.2,5719,94,416732,72.85524475524475,7
0.2,5720,-49,416683,72.83394511449048,13
0.2,5721,94,416777,72.83764418035652,8
0.2,5722,95,416872,72.84151668705225,7
0.2,5723,95,416967,72.84538784067085,7
0.2,5724,94,417061,72.84908296943232,8
0.2,5725,93,417154,72.8526021655606,8
0.2,5726,26,417180,72.84442116291252,7
0.2,5727,93,417273,72.84793994413408,8
0.2,5728,95,417368,72.85180659801013,7
0.2,5729,94,417462,72.85549738219895,9
0.2,5730,26,417488,72.84732158436573,8
0.2,5731,94,417582,72.851011863224,9
0.2,5732,94,417676,72.85470085470085,8
0.2,5733,94,417770,72.85838855946983,7
0.2,5734,84,417854,72.86033129904098,18
0.2,5735,94,417948,72.86401673640168,7
0.2,5736,93,418041,72.8675265818372,8
0.2,5737,93,418134,72.8710352039038,11
0.2,5738,94,418228,72.87471684962537,8
0.2,5739,90,418318,72.87770034843206,13
0.2,5740,93,418411,72.881205364919,9
0.2,5741,20,418431,72.87199582027168,13
0.2,5742,95,418526,72.87584885948111,7
0.2,5743,23,418549,72.86716573816156,9
0.2,5744,94,418643,72.87084421235858,7
0.2,5745,94,418737,72.87452140619561,8
0.2,5746,95,418832,72.87837132416914,7
0.2,5747,23,418855,72.8696938065414,10
0.2,5748,93,418948,72.8731953383197,8
0.2,5749,93,419041,72.87669565217391,9
0.2,5750,95,419136,72.88054251434534,6
0.2,5751,22,419158,72.87169680111266,11
0.2,5752,24,419182,72.86320180775247,8
0.2,5753,95,419277,72.86704900938477,7
0.2,5754,95,419372,72.87089487402258,7
0.2,5755,90,419462,72.87387074357193,12
0.2,5756,93,419555,72.87736668403683,8
0.2,5757,95,419650,72.88120875303925,7
0.2,5758,96,419746,72.88522312901546,6
0.2,5759,96,419842,72.88923611111112,9
0.2,5760,18,419860,72.87970838396112,14
0.2,5761,95,419955,72.88354737938216,6
0.2,5762,94,420049,72.88721152177685,8
0.2,5763,95,420144,72.8910478834143,7
0.2,5764,94,420238,72.8947094535993,8
0.2,5765,91,420329,72.89784946236558,11
0.2,5766,94,420423,72.90150858331889,8
0.2,5767,92,420515,72.90481969486824,10
0.2,5768,95,420610,72.9086496793205,7
0.2,5769,26,420636,72.90051993067591,6
0.2,5770,92,420728,72.90382949228903,9
0.2,5771,94,420822,72.9074844074844,7
0.2,5772,96,420918,72.91148449679542,6
0.2,5773,94,421012,72.91513682022861,7
0.2,5774,94,421106,72.91878787878788,7
0.2,5775,94,421200,72.92243767313019,8
0.2,5776,24,421224,72.91396918815994,8
0.2,5777,91,421315,72.91709934233299,10
0.2,5778,93,421408,72.92057449385707,8
0.2,5779,24,421432,72.9121107266436,9
0.2,5780,96,421528,72.91610448019374,6
0.2,5781,95,421623,72.9199239017641,7
0.2,5782,15,421638,72.9099083520664,17
0.2,5783,96,421734,72.91390041493776,6
0.2,5784,94,421828,72.91754537597234,7
0.2,5785,91,421919,72.92067058416869,11
0.2,5786,24,421943,72.91221703818904,8
0.2,5787,22,421965,72.9034208707671,10
0.2,5788,90,422055,72.90637415788565,12
0.2,5789,87,422142,72.90880829015543,16
0.2,5790,94,422236,72.91245035399758,9
0.2,5791,96,422332,72.91643646408839,6
0.2,5792,-131,422201,72.88123597445193,27
0.2,5793,91,422292,72.88436313427684,11
0.2,5794,93,422385,72.88783433994823,8
0.2,5795,93,422478,72.8913043478261,9
0.2,5796,95,422573,72.89511816456788,7
0.2,5797,96,422669,72.89910313901345,6
0.2,5798,21,422690,72.89015347473702,11
0.2,5799,93,422783,72.89362068965518,9
0.2,5800,87,422870,72.8960524047578,15
0.2,5801,95,422965,72.89986211651154,7
0.2,5802,95,423060,72.90367051525074,8
0.2,5803,91,423151,72.90678842177809,10
0.2,5804,93,423244,72.9102497846684,9
0.2,5805,-47,423197,72.88959696865312,11
0.2,5806,93,423290,72.89306009987945,9
0.2,5807,89,423379,72.89583333333333,12
0.2,5808,23,423402,72.88724393182991,11
0.2,5809,92,423494,72.89053356282272,10
0.2,5810,94,423588,72.89416623644811,8
0.2,5811,92,423680,72.89745354439091,10
0.2,5812,-48,423632,72.87665577154654,12
0.2,5813,27,423659,72.8687650498796,6
0.2,5814,90,423749,72.87171109200344,12
0.2,5815,27,423776,72.86382393397524,6
0.2,5816,95,423871,72.8676293622142,7
0.2,5817,91,423962,72.87074596081128,11
0.2,5818,95,424057,72.87454889156213,7
0.2,5819,94,424151,72.87817869415808,8
0.2,5820,25,424176,72.86995361621715,8
0.2,5821,90,424266,72.87289591205771,12
0.2,5822,94,424360,72.87652412845613,7
0.2,5823,91,424451,72.87963598901099,12
0.2,5824,91,424542,72.88274678111588,11
0.2,5825,23,424565,72.87418468932373,10
0.2,5826,90,424655,72.87712373434015,12
0.2,5827,90,424745,72.88006177076184,14
0.2,5828,95,424840,72.8838565791731,7
0.2,5829,21,424861,72.87495711835335,12
0.2,5830,96,424957,72.87892299777053,7
0.2,5831,93,425050,72.8823731138546,8
0.2,5832,96,425146,72.88633636207783,6
0.2,5833,20,425166,72.87727116900926,13
0.2,5834,22,425188,72.86855184233076,10
0.2,5835,95,425283,72.8723440712817,6
0.2,5836,91,425374,72.87544971732054,10
0.2,5837,89,425463,72.87821171634121,12
0.2,5838,91,425554,72.88131529371468,11
0.2,5839,94,425648,72.88493150684931,9
0.2,5840,95,425743,72.88871768532786,7
0.2,5841,91,425834,72.89181787059226,11
0.2,5842,92,425926,72.89508813965429,10
0.2,5843,92,426018,72.89835728952772,11
0.2,5844,20,426038,72.88930710008555,13
0.2,5845,17,426055,72.87974683544304,17
0.2,5846,95,426150,72.88353001539251,6
0.2,5847,95,426245,72.88731190150479,6
0.2,5848,95,426340,72.8910924944435,7
0.2,5849,92,426432,72.89435897435898,11
0.2,5850,90,426522,72.89728251580927,12
0.2,5851,96,426618,72.90123034859877,6
0.2,5852,96,426714,72.90517683239365,6
0.2,5853,90,426804,72.90809702767339,13
0.2,5854,95,426899,72.91187019641332,6
0.2,5855,94,426993,72.91547131147541,7
0.2,5856,10,427003,72.9047293836435,24
0.2,5857,95,427098,72.90850119494708,7
0.2,5858,94,427192,72.9121010411333,7
0.2,5859,95,427287,72.91587030716724,7
0.2,5860,95,427382,72.91963828698174,6
0.2,5861,93,427475,72.9230638007506,9
0.2,5862,95,427570,72.92682926829268,6
0.2,5863,92,427662,72.9300818553888,9
0.2,5864,94,427756,72.93367433930094,8
0.2,5865,90,427846,72.93658370269348,12
0.2,5866,94,427940,72.94017385375831,8
0.2,5867,24,427964,72.93183367416496,8
0.2,5868,93,428057,72.93525302436531,9
0.2,5869,94,428151,72.9388415672913,8
0.2,5870,95,428246,72.94259921648782,7
0.2,5871,83,428329,72.94431198910081,19
0.2,5872,95,428424,72.94806742720927,7
0.2,5873,95,428519,72.95182158665305,7
0.2,5874,-47,428472,72.93140425531915,11
0.2,5875,95,428567,72.93515997277059,6
0.2,5876,93,428660,72.93857410243321,9
0.2,5877,95,428755,72.94232732221845,7
0.2,5878,93,428848,72.94573907127062,11
0.2,5879,94,428942,72.94931972789115,7
0.2,5880,95,429037,72.95306920591736,7
0.2,5881,88,429125,72.95562733764025,15
0.2,5882,93,429218,72.95903450620432,9
0.2,5883,94,429312,72.96261046906866,8
0.2,5884,8,429320,72.95157179269329,24
0.2,5885,19,429339,72.94240570846075,15
0.2,5886,95,429434,72.9461525394938,6
0.2,5887,96,429530,72.95006793478261,6
0.2,5888,90,429620,72.95296315163864,13
0.2,5889,26,429646,72.94499151103565,7
0.2,5890,89,429735,72.94771685622135,14
0.2,5891,95,429830,72.95145960624576,6
0.2,5892,94,429924,72.95503139317834,7
0.2,5893,96,430020,72.95894129623346,6
0.2,5894,94,430114,72.96251060220526,7
0.2,5895,26,430140,72.95454545454545,7
0.2,5896,12,430152,72.94420891978973,21
0.2,5897,22,430174,72.93557138012886,10
0.2,5898,91,430265,72.93863366672318,10
0.2,5899,91,430356,72.94169491525423,10
0.2,5900,95,430451,72.94543297746145,7
0.2,5901,27,430478,72.93764825482887,6
0.2,5902,23,430501,72.92918854819584,10
0.2,5903,92,430593,72.932418699187,10
0.2,5904,95,430688,72.93615580016935,7
0.2,5905,24,430712,72.92786996274975,9
0.2,5906,95,430807,72.93160656847807,6
0.2,5907,95,430902,72.93534190927556,7
0.2,5908,-54,430848,72.91386021323405,20
0.2,5909,94,430942,72.91742808798647,8
0.2,5910,94,431036,72.92099475554052,9
0.2,5911,23,431059,72.91255074424899,9
0.2,5912,93,431152,72.9159479113817,8
0.2,5913,95,431247,72.91968211024687,7
0.2,5914,92,431339,72.9229078613694,9
0.2,5915,91,431430,72.92596348884382,11
0.2,5916,93,431523,72.9293560926145,12
0.2,5917,95,431618,72.93308550185874,6
0.2,5918,19,431637,72.92397364419665,14
0.2,5919,94,431731,72.92753378378379,7
0.2,5920,92,431823,72.93075494004391,9
0.2,5921,95,431918,72.93448159405607,6
0.2,5922,96,432014,72.93837582306264,7
0.2,5923,25,432039,72.93028359216746,8
0.2,5924,95,432134,72.93400843881857,7
0.2,5925,90,432224,72.93688828889638,11
0.2,5926,95,432319,72.94061076429897,7
0.2,5927,23,432342,72.93218623481782,11
0.2,5928,22,432364,72.92359588463485,13
0.2,5929,23,432387,72.91517706576728,10
0.2,5930,93,432480,72.91856348002024,8
0.2,5931,88,432568,72.92110586648685,13
0.2,5932,90,432658,72.92398449351087,12
0.2,5933,23,432681,72.91557128412538,10
0.2,5934,92,432773,72.91878685762427,12
0.2,5935,95,432868,72.92250673854447,6
0.2,5936,93,432961,72.92588849587334,8
0.2,5937,94,433055,72.92943752105086,8
0.2,5938,89,433144,72.93214345849469,12
0.2,5939,90,433234,72.93501683501684,13
0.2,5940,22,433256,72.92644335970375,11
0.2,5941,96,433352,72.93032648939752,6
0.2,5942,23,433375,72.92192495372707,10
0.2,5943,91,433466,72.9249663526245,10
0.2,5944,24,433490,72.91673675357443,9
0.2,5945,19,433509,72.90766902119071,14
0.2,5946,93,433602,72.91104758701867,8
0.2,5947,95,433697,72.91476126429052,7
0.2,5948,91,433788,72.91780131114473,12
0.2,5949,95,433883,72.92151260504201,6
0.2,5950,25,433908,72.91345992270206,8
0.2,5951,85,433993,72.91549059139786,19
0.2,5952,91,434084,72.9185284730388,11
0.2,5953,94,434178,72.92206919717837,7
0.2,5954,91,434269,72.92510495382032,11
0.2,5955,91,434360,72.92813969106783,12
0.2,5956,95,434455,72.93184488836663,7
0.2,5957,93,434548,72.93521315877811,8
0.2,5958,91,434639,72.93824467192482,11
0.2,5959,94,434733,72.94177852348993,7
0.2,5960,93,434826,72.94514343231002,10
0.2,5961,95,434921,72.94884267024489,8
0.2,5962,92,435013,72.95203756498407,10
0.2,5963,24,435037,72.94382964453386,9
0.2,5964,22,435059,72.93528918692373,11
0.2,5965,92,435151,72.93848474689909,10
0.2,5966,95,435246,72.94218200100553,6
0.2,5967,18,435264,72.93297587131367,17
0.2,5968,22,435286,72.92444295526889,10
0.2,5969,26,435312,72.91658291457287,7
0.2,5970,92,435404,72.91977893150226,12
0.2,5971,93,435497,72.92314132618888,12
0.2,5972,95,435592,72.92683743512472,7
0.2,5973,92,435684,72.93003013056578,10
0.2,5974,95,435779,72.93372384937238,6
0.2,5975,94,435873,72.93724899598394,9
0.2,5976,92,435965,72.94043834699683,10
0.2,5977,95,436060,72.94412847106055,6
0.2,5978,95,436155,72.94781736076267,7
0.2,5979,90,436245,72.95066889632108,12
0.2,5980,95,436340,72.95435545895336,7
0.2,5981,91,436431,72.95737211634905,12
0.2,5982,95,436526,72.96105632625773,6
0.2,5983,21,436547,72.9523729946524,12
0.2,5984,96,436643,72.956223893066,6
0.2,5985,93,436736,72.95957233544938,8
0.2,5986,24,436760,72.95139468849173,9
0.2,5987,95,436855,72.95507682030728,7
0.2,5988,94,436949,72.9585907497078,7
0.2,5989,93,437042,72.96193656093489,8
0.2,5990,93,437135,72.96528125521615,9
0.2,5991,89,437224,72.9679572763685,12
0.2,5992,93,437317,72.9712998498248,9
0.2,5993,93,437410,72.97464130797464,9
0.2,5994,92,437502,72.97781484570476,9
0.2,5995,25,437527,72.96981320880587,8
0.2,5996,94,437621,72.97331999333,7
0.2,5997,96,437717,72.97715905301767,6
0.2,5998,92,437809,72.98033005500916,9
0.2,5999,90,437899,72.98316666666666,13
0.2,6000,92,437991,72.98633561073154,9
0.2,6001,24,438015,72.97817394201932,9
0.2,6002,95,438110,72.98184241212726,7
0.2,6003,95,438205,72.98550966022651,6
0.2,6004,22,438227,72.97701915070775,12
0.2,6005,93,438320,72.98035298035298,8
0.2,6006,94,438414,72.98385217246546,8
0.2,6007,96,438510,72.98768308921439,6
0.2,6008,21,438531,72.97903145282076,13
0.2,6009,96,438627,72.9828618968386,7
0.2,6010,95,438722,72.98652470470803,7
0.2,6011,96,438818,72.99035262807718,6
0.2,6012,93,438911,72.99368035922168,8
0.2,6013,95,439006,72.99733954107083,7
0.2,6014,22,439028,72.98886118038237,10
0.2,6015,92,439120,72.99202127659575,9
0.2,6016,91,439211,72.99501412664118,10
0.2,6017,22,439233,72.98654037886341,11
0.2,6018,91,439324,72.98953314504071,10
0.2,6019,95,439419,72.99318936877076,8
0.2,6020,23,439442,72.984886231523,10
0.2,6021,91,439533,72.98787778146794,10
0.2,6022,95,439628,72.99153245890751,7
0.2,6023,95,439723,72.99518592297477,6
0.2,6024,95,439818,72.99883817427386,7
0.2,6025,95,439913,73.00248921340857,7
0.2,6026,91,440004,73.00547536087606,11
0.2,6027,15,440019,72.99585268745852,20
0.2,6028,92,440111,72.99900481008459,10
0.2,6029,23,440134,72.99071310116086,11
0.2,6030,93,440227,72.9940308406566,9
0.2,6031,90,440317,72.996850132626,12
0.2,6032,22,440339,72.98839714901376,11
0.2,6033,95,440434,72.99204507789194,7
0.2,6034,96,440530,72.99585749792875,6
0.2,6035,20,440550,72.98707753479125,13
0.2,6036,95,440645,72.9907238694716,7
0.2,6037,92,440737,72.99387214309374,10
0.2,6038,95,440832,72.99751614505713,6
0.2,6039,93,440925,73.00082781456953,8
0.2,6040,92,441017,73.00397285217679,9
0.2,6041,26,441043,72.99619331347236,7
0.2,6042,22,441065,72.9877544266093,11
0.2,6043,86,441151,72.98990734612839,15
0.2,6044,25,441176,72.98196856906534,8
0.2,6045,96,441272,72.98577571948395,6
0.2,6046,23,441295,72.97750950884736,11
0.2,6047,96,441391,72.98131613756614,6
0.2,6048,25,441416,72.97338403041825,8
0.2,6049,93,441509,72.97669421487603,9
0.2,6050,94,441603,72.98016856717898,8
0.2,6051,20,441623,72.97141440846,13
0.2,6052,93,441716,72.97472327771354,8
0.2,6053,24,441740,72.96663363065741,11
0.2,6054,95,441835,72.9702725020644,7
0.2,6055,94,441929,72.97374504623514,7
0.2,6056,95,442024,72.9773815420175,6
0.2,6057,95,442119,72.98101683724002,7
0.2,6058,91,442210,72.98399075755076,11
0.2,6059,90,442300,72.98679867986799,11
0.2,6060,95,442395,72.99043062200957,6
0.2,6061,94,442489,72.99389640382712,8
0.2,6062,95,442584,72.997525977239,7
0.2,6063,94,442678,73.00098944591029,8
0.2,6064,95,442773,73.00461665292663,7
0.2,6065,22,442795,72.99620837454665,10
0.2,6066,93,442888,72.99950552167464,10
0.2,6067,94,442982,73.00296638101516,8
0.2,6068,95,443077,73.00659087164277,6
0.2,6069,95,443172,73.01021416803954,7
0.2,6070,27,443199,73.00263548015154,6
0.2,6071,92,443291,73.00576416337286,10
0.2,6072,96,443387,73.0095504692903,6
0.2,6073,92,443479,73.01267698386566,9
0.2,6074,94,443573,73.0161316872428,9
0.2,6075,23,443596,73.00789993416721,10
0.2,6076,24,443620,72.99983544512095,9
0.2,6077,91,443711,73.00279697268839,10
0.2,6078,83,443794,73.00444151998684,21
0.2,6079,88,443882,73.00690789473684,13
0.2,6080,93,443975,73.01019569149811,10
0.2,6081,94,444069,73.01364682670174,9
0.2,6082,22,444091,73.00526056222259,10
0.2,6083,93,444184,73.00854700854701,8
0.2,6084,25,444209,73.00065735414955,8
0.2,6085,26,444235,72.9929346040092,7
0.2,6086,95,444330,72.99655002464269,7
0.2,6087,91,444421,72.99950722733246,11
0.2,6088,90,444511,73.00229922811627,12
0.2,6089,95,444606,73.00591133004926,9
0.2,6090,92,444698,73.00902971597439,9
0.2,6091,94,444792,73.01247537754432,8
0.2,6092,94,444886,73.01591990809125,8
0.2,6093,94,444980,73.01936330817198,9
0.2,6094,94,445074,73.0228055783429,8
0.2,6095,95,445169,73.02641076115485,6
0.2,6096,96,445265,73.03017877644743,6
0.2,6097,19,445284,73.02131846507052,13
0.2,6098,94,445378,73.02475815707493,7
0.2,6099,87,445465,73.02704918032786,14
0.2,6100,95,445560,73.03065071299787,6
0.2,6101,92,445652,73.03375942313995,10
0.2,6102,22,445674,73.02539734556775,11
0.2,6103,94,445768,73.02883355176934,9
0.2,6104,92,445860,73.03194103194103,9
0.2,6105,95,445955,73.03553881428104,9
0.2,6106,95,446050,73.03913541837235,6
0.2,6107,25,446075,73.03127046496398,8
0.2,6108,94,446169,73.03470289736454,8
0.2,6109,26,446195,73.02700490998363,8
0.2,6110,94,446289,73.03043691703486,8
0.2,6111,95,446384,73.03403141361257,6
0.2,6112,95,446479,73.03762473417308,6
0.2,6113,94,446573,73.04105332024861,7
0.2,6114,24,446597,73.03303352412101,9
0.2,6115,96,446693,73.03678875081752,6
0.2,6116,95,446788,73.04037927088442,6
0.2,6117,92,446880,73.04347826086956,10
0.2,6118,95,446975,73.04706651413629,6
0.2,6119,95,447070,73.05065359477125,6
0.2,6120,89,447159,73.05325927136089,13
0.2,6121,95,447254,73.05684416857237,6
0.2,6122,94,447348,73.06026457618815,10
0.2,6123,91,447439,73.06319399085565,10
0.2,6124,95,447534,73.06677551020408,6
0.2,6125,96,447630,73.07051909892263,6
0.2,6126,93,447723,73.07377182960666,9
0.2,6127,91,447814,73.07669712793734,11
0.2,6128,93,447907,73.0799477891989,9
0.2,6129,24,447931,73.07194127243066,9
0.2,6130,96,448027,73.07568096558474,6
0.2,6131,93,448120,73.07893020221788,8
0.2,6132,27,448147,73.07141692483287,6
0.2,6133,95,448242,73.0749918487121,7
0.2,6134,94,448336,73.07840260798696,9
0.2,6135,96,448432,73.08213820078227,6
0.2,6136,95,448527,73.08570963011243,6
0.2,6137,91,448618,73.08862821766047,12
0.2,6138,92,448710,73.091708747353,9
0.2,6139,91,448801,73.09462540716612,10
0.2,6140,95,448896,73.0981924767953,8
0.2,6141,95,448991,73.10175838489091,7
0.2,6142,95,449086,73.10532313202019,6
0.2,6143,23,449109,73.09716796875,10
0.2,6144,25,449134,73.08934092758341,8
0.2,6145,92,449226,73.09241783273674,10
0.2,6146,-49,449177,73.07255571823654,13
0.2,6147,90,449267,73.07530904359142,12
0.2,6148,95,449362,73.07887461375833,7
0.2,6149,92,449454,73.08195121951219,10
0.2,6150,24,449478,73.07397171191676,8
0.2,6151,95,449573,73.07753576072822,7
0.2,6152,93,449666,73.08077360637088,8
0.2,6153,89,449755,73.0833604159896,13
0.2,6154,-47,449708,73.063850528026,11
0.2,6155,96,449804,73.06757634827811,8
0.2,6156,95,449899,73.07113854149748,7
0.2,6157,22,449921,73.06284507957129,11
0.2,6158,93,450014,73.06608215619418,9
0.2,6159,20,450034,73.05746753246753,13
0.2,6160,94,450128,73.06086674241195,8
0.2,6161,22,450150,73.05258033106135,13
0.2,6162,91,450241,73.05549245497323,11
0.2,6163,24,450265,73.0475340687865,9
0.2,6164,21,450286,73.03909164639092,12
0.2,6165,94,450380,73.04249108011678,7
0.2,6166,90,450470,73.04524079779472,12
0.2,6167,89,450559,73.04782749675746,12
0.2,6168,23,450582,73.03971470254498,10
0.2,6169,22,450604,73.03144246353322,11
0.2,6170,92,450696,73.03451628585319,10
0.2,6171,94,450790,73.03791315618925,9
0.2,6172,26,450816,73.03029321237648,7
0.2,6173,20,450836,73.0217039196631,12
0.2,6174,91,450927,73.02461538461539,11
0.2,6175,93,451020,73.02784974093264,9
0.2,6176,94,451114,73.03124494090983,8
0.2,6177,95,451209,73.03480090644221,6
0.2,6178,93,451302,73.03803204402007,9
0.2,6179,95,451397,73.0415857605178,8
0.2,6180,95,451492,73.04513832713153,7
0.2,6181,92,451584,73.04820446457457,10
0.2,6182,-47,451537,73.02878861394146,10
0.2,6183,91,451628,73.03169469598966,10
0.2,6184,96,451724,73.03540824575586,6
0.2,6185,91,451815,73.03831231813773,11
0.2,6186,92,451907,73.04137708097625,10
0.2,6187,91,451998,73.04427925016161,10
0.2,6188,93,452091,73.0475036354823,8
0.2,6189,-45,452046,73.02843295638127,9
0.2,6190,96,452142,73.03214343401712,6
0.2,6191,94,452236,73.03552971576228,8
0.2,6192,91,452327,73.03843048603262,13
0.2,6193,22,452349,73.0301905069422,11
0.2,6194,91,452440,73.03309120258272,11
0.2,6195,95,452535,73.03663653970304,7
0.2,6196,94,452629,73.04001936420849,8
0.2,6197,93,452722,73.0432397547596,8
0.2,6198,94,452816,73.04662042264881,8
0.2,6199,89,452905,73.0491935483871,12
0.2,6200,94,452999,73.05257216577971,9
0.2,6201,95,453094,73.05611093195743,6
0.2,6202,89,453183,73.05868128325004,14
0.2,6203,26,453209,73.0510960670535,6
0.2,6204,96,453305,73.05479452054794,6
0.2,6205,94,453399,73.05816951337415,8
0.2,6206,94,453493,73.0615434187208,7
0.2,6207,92,453585,73.06459407216495,9
0.2,6208,94,453679,73.06796585601546,7
0.2,6209,95,453774,73.07149758454106,8
0.2,6210,95,453869,73.0750281758171,8
0.2,6211,95,453964,73.0785576303928,8
0.2,6212,-118,453846,73.04780299372284,12
0.2,6213,20,453866,73.03926617315739,14
0.2,6214,94,453960,73.04263877715205,10
0.2,6215,95,454055,73.04617117117117,6
0.2,6216,-54,454001,73.02573588547531,20
0.2,6217,94,454095,73.02910903827598,8
0.2,6218,91,454186,73.03199871361956,13
0.2,6219,93,454279,73.03520900321543,10
0.2,6220,94,454373,73.03857900659058,8
0.2,6221,93,454466,73.04178720668595,9
0.2,6222,91,454557,73.04467298730516,12
0.2,6223,95,454652,73.04820051413881,6
0.2,6224,-57,454595,73.02730923694779,21
0.2,6225,93,454688,73.03051718599421,8
0.2,6226,95,454783,73.03404528665489,7
0.2,6227,92,454875,73.03709055876686,10
0.2,6228,93,454968,73.04029539251886,8
0.2,6229,93,455061,73.04349919743179,9
0.2,6230,24,455085,73.03562831006259,9
0.2,6231,95,455180,73.03915275994865,7
0.2,6232,96,455276,73.04283651532168,6
0.2,6233,95,455371,73.04635867821624,7
0.2,6234,92,455463,73.04939855653569,11
0.2,6235,24,455487,73.04153303399615,9
0.2,6236,91,455578,73.04441237774572,11
0.2,6237,94,455672,73.04777172170567,8
0.2,6238,-48,455624,73.0283699310787,12
0.2,6239,94,455718,73.03173076923076,9
0.2,6240,92,455810,73.03477006889922,10
0.2,6241,22,455832,73.02659404037168,12
0.2,6242,94,455926,73.02995354797373,8
0.2,6243,95,456021,73.03347213324791,7
0.2,6244,92,456113,73.0365092073659,10
0.2,6245,94,456207,73.03986551392892,7
0.2,6246,91,456298,73.04274051544742,10
0.2,6247,94,456392,73.04609475032011,8
0.2,6248,95,456487,73.04960793726997,6
0.2,6249,96,456583,73.05328,6
0.2,6250,19,456602,73.0446328587426,14
0.2,6251,96,456698,73.04830454254639,6
0.2,6252,26,456724,73.04078042539581,7
0.2,6253,94,456818,73.04413175567636,8
0.2,6254,95,456913,73.04764188649081,8
0.2,6255,20,456933,73.03916240409207,13
0.2,6256,19,456952,73.03052581109158,15
0.2,6257,93,457045,73.03371684244168,10
0.2,6258,23,457068,73.02572295893913,10
0.2,6259,95,457163,73.02923322683706,7
0.2,6260,93,457256,73.03242293563329,9
0.2,6261,25,457281,73.02475247524752,8
0.2,6262,93,457374,73.02794188088775,8
0.2,6263,94,457468,73.03128991060025,7
0.2,6264,93,457561,73.03447725458899,10
0.2,6265,92,457653,73.03750398978615,11
0.2,6266,94,457747,73.04084889101644,8
0.2,6267,17,457764,73.03190810465858,16
0.2,6268,89,457853,73.0344552560217,12
0.2,6269,95,457948,73.03795853269537,9
0.2,6270,94,458042,73.04130122787434,8
0.2,6271,23,458065,73.03332270408163,10
0.2,6272,88,458153,73.03570859238005,14
0.2,6273,93,458246,73.03889065986611,8
0.2,6274,90,458336,73.04159362549801,11
0.2,6275,22,458358,73.03346080305927,12
0.2,6276,88,458446,73.03584514895651,13
0.2,6277,91,458537,73.03870659445683,10
0.2,6278,92,458629,73.04172638955248,9
0.2,6279,95,458724,73.0452229299363,6
0.2,6280,14,458738,73.03582232128642,21
0.2,6281,95,458833,73.03931868831582,6
0.2,6282,-47,458786,73.02021327391374,10
0.2,6283,94,458880,73.02355187778485,7
0.2,6284,10,458890,73.01352426412092,24
0.2,6285,95,458985,73.01702195354757,7
0.2,6286,95,459080,73.02051853030062,6
0.2,6287,94,459174,73.02385496183206,8
0.2,6288,94,459268,73.02719033232628,8
0.2,6289,92,459360,73.0302066772655,10
0.2,6290,95,459455,73.03369893498649,7
0.2,6291,93,459548,73.0368722186904,9
0.2,6292,93,459641,73.04004449388209,8
0.2,6293,21,459662,73.03177629488401,13
0.2,6294,93,459755,73.03494837172359,8
0.2,6295,89,459844,73.03748411689962,13
0.2,6296,96,459940,73.04113069715737,6
0.2,6297,90,460030,73.04382343601144,13
0.2,6298,21,460051,73.0355612001905,14
0.2,6299,92,460143,73.03857142857143,10
0.2,6300,94,460237,73.04189811141089,8
0.2,6301,93,460330,73.04506505871151,9
0.2,6302,92,460422,73.04807234650167,9
0.2,6303,96,460518,73.05171319796955,6
0.2,6304,22,460540,73.04361617763679,11
0.2,6305,95,460635,73.04709800190295,6
0.2,6306,94,460729,73.05042016806723,7
0.2,6307,19,460748,73.0418516169943,17
0.2,6308,95,460843,73.04533206530354,6
0.2,6309,92,460935,73.04833597464342,9
0.2,6310,94,461029,73.05165583901125,7
0.2,6311,94,461123,73.05497465145754,8
0.2,6312,91,461214,73.05781720259782,12
0.2,6313,90,461304,73.06050047513462,12
0.2,6314,93,461397,73.06365795724466,8
0.2,6315,95,461492,73.06713109563015,7
0.2,6316,91,461583,73.06996992243154,11
0.2,6317,95,461678,73.07344096232985,7
0.2,6318,90,461768,73.07611963918342,12
0.2,6319,92,461860,73.07911392405063,10
0.2,6320,92,461952,73.08210726150925,11
0.2,6321,95,462047,73.08557418538437,7
0.2,6322,91,462138,73.0884074015499,10
0.2,6323,93,462231,73.0915559772296,8
0.2,6324,95,462326,73.09501976284585,7
0.2,6325,27,462353,73.08773316471704,6
0.2,6326,93,462446,73.09088035403825,8
0.2,6327,94,462540,73.09418457648546,9
0.2,6328,92,462632,73.09717174909149,10
0.2,6329,95,462727,73.10063191153239,6
0.2,6330,92,462819,73.10361712209762,9
0.2,6331,24,462843,73.09586228679721,9
0.2,6332,94,462937,73.09916311384809,9
0.2,6333,95,463032,73.10262077676035,7
0.2,6334,92,463124,73.10560378847671,9
0.2,6335,92,463216,73.10858585858585,9
0.2,6336,94,463310,73.11188259428752,8
0.2,6337,13,463323,73.10239823288103,20
0.2,6338,89,463412,73.1049061366146,12
0.2,6339,89,463501,73.10741324921136,13
0.2,6340,95,463596,73.1108657940388,7
0.2,6341,89,463685,73.11337117628509,12
0.2,6342,-51,463634,73.09380419359924,14
0.2,6343,26,463660,73.08638083228247,7
0.2,6344,92,463752,73.08936170212766,11
0.2,6345,88,463840,73.09171131421368,14
0.2,6346,93,463933,73.09484795966598,9
0.2,6347,91,464024,73.09766855702584,12
0.2,6348,95,464119,73.1011182863443,7
0.2,6349,93,464212,73.10425196850393,9
0.2,6350,87,464299,73.10643993071957,14
0.2,6351,96,464395,73.11004408060454,6
0.2,6352,25,464420,73.10247127341414,9
0.2,6353,93,464513,73.10560276990871,11
0.2,6354,95,464608,73.10904799370574,6
0.2,6355,95,464703,73.11249213341725,7
0.2,6356,91,464794,73.11530596193172,13
0.2,6357,96,464890,73.11890531613714,6
0.2,6358,94,464984,73.12218902343136,7
0.2,6359,94,465078,73.1254716981132,7
0.2,6360,93,465171,73.12859613268354,9
0.2,6361,92,465263,73.13156240176045,12
0.2,6362,95,465358,73.13499921420714,7
0.2,6363,90,465448,73.13764927718417,11
0.2,6364,92,465540,73.14061272584446,12
0.2,6365,93,465633,73.14373232799247,9
0.2,6366,-53,465580,73.12392021360138,17
0.2,6367,94,465674,73.12719849246231,8
0.2,6368,95,465769,73.1306327523944,6
0.2,6369,91,465860,73.13343799058084,11
0.2,6370,94,465954,73.13671323183173,7
0.2,6371,24,465978,73.12900188323917,10
0.2,6372,95,466073,73.13243370469166,6
0.2,6373,26,466099,73.12503922183872,7
0.2,6374,15,466114,73.11592156862746,18
0.2,6375,22,466136,73.10790464240904,10
0.2,6376,22,466158,73.09989023051591,10
0.2,6377,95,466253,73.10332392599561,7
0.2,6378,93,466346,73.10644301614673,8
0.2,6379,16,466362,73.0974921630094,17
0.2,6380,94,466456,73.10076790471713,8
0.2,6381,94,466550,73.10404261986838,8
0.2,6382,96,466646,73.10762964123452,6
0.2,6383,94,466740,73.1109022556391,7
0.2,6384,91,466831,73.11370399373531,10
0.2,6385,93,466924,73.11681803946132,9
0.2,6386,94,467018,73.12008767809613,7
0.2,6387,96,467114,73.12366938008766,7
0.2,6388,95,467209,73.12709344185319,7
0.2,6389,91,467300,73.12989045383412,10
0.2,6390,26,467326,73.12251603817869,7
0.2,6391,17,467343,73.11373591989988,16
0.2,6392,94,467437,73.11700297200062,8
0.2,6393,96,467533,73.12058179543322,6
0.2,6394,92,467625,73.12353401094605,12
0.2,6395,94,467719,73.12679799874921,8
0.2,6396,94,467813,73.13006096607785,7
0.2,6397,95,467908,73.13347921225383,7
0.2,6398,84,467992,73.1351773714643,17
0.2,6399,16,468008,73.12625,17
0.2,6400,92,468100,73.12919856272457,9
0.2,6401,95,468195,73.13261480787254,7
0.2,6402,88,468283,73.13493674839918,15
0.2,6403,96,468379,73.13850718301062,6
0.2,6404,18,468397,73.12989851678377,15
0.2,6405,94,468491,73.13315641586013,8
0.2,6406,95,468586,73.13656937724365,7
0.2,6407,93,468679,73.13966916354556,10
0.2,6408,95,468774,73.14308004368856,7
0.2,6409,23,468797,73.13525741029642,10
0.2,6410,93,468890,73.13835595070972,9
0.2,6411,95,468985,73.14176543980038,8
0.2,6412,21,469006,73.13363480430375,12
0.2,6413,92,469098,73.13657623947614,11
0.2,6414,92,469190,73.13951675759938,12
0.2,6415,20,469210,73.13123441396509,12
0.2,6416,27,469237,73.12404550412965,7
0.2,6417,95,469332,73.12745403552509,7
0.2,6418,91,469423,73.13023835488394,10
0.2,6419,88,469511,73.13255451713395,13
0.2,6420,95,469606,73.13596013082075,6
0.2,6421,86,469692,73.13796325132357,17
0.2,6422,26,469718,73.13062431885412,7
0.2,6423,20,469738,73.12235367372354,14
0.2,6424,95,469833,73.12575875486381,7
0.2,6425,94,469927,73.12900715841893,8
0.2,6426,83,470010,73.1305430216275,18
0.2,6427,95,470105,73.13394523957685,7
0.2,6428,95,470200,73.13734639912894,7
0.2,6429,90,470290,73.13996889580093,12
0.2,6430,93,470383,73.14305706733012,9
0.2,6431,93,470476,73.14614427860697,8
0.2,6432,91,470567,73.14891963314162,10
0.2,6433,95,470662,73.1523158221946,7
0.2,6434,21,470683,73.14421134421134,12
0.2,6435,93,470776,73.14729645742698,9
0.2,6436,90,470866,73.1499145564704,12
0.2,6437,96,470962,73.15346380863622,6
0.2,6438,93,471055,73.15654604752291,8
0.2,6439,-47,471008,73.13788819875776,10
0.2,6440,96,471104,73.14143766495886,6
0.2,6441,93,471197,73.1445203352996,9
0.2,6442,85,471282,73.14636039112214,18
0.2,6443,89,471371,73.14882060831782,13
0.2,6444,94,471465,73.15205585725369,8
0.2,6445,91,471556,73.15482469748682,10
0.2,6446,96,471652,73.1583682332868,6
0.2,6447,95,471747,73.16175558312655,7
0.2,6448,92,471839,73.1646766940611,10
0.2,6449,96,471935,73.16821705426356,6
0.2,6450,24,471959,73.16059525654937,10
0.2,6451,-46,471913,73.14212647241166,10
0.2,6452,23,471936,73.13435611343562,10
0.2,6453,89,472025,73.13681437867989,13
0.2,6454,93,472118,73.13989155693261,9
0.2,6455,24,472142,73.13228004956629,11
0.2,6456,94,472236,73.13551184760725,8
0.2,6457,95,472331,73.13889749148343,7
0.2,6458,93,472424,73.14197244155442,9
0.2,6459,93,472517,73.14504643962849,8
0.2,6460,93,472610,73.14811948614765,9
0.2,6461,95,472705,73.15150108325595,7
0.2,6462,95,472800,73.15488163391613,7
0.2,6463,95,472895,73.15826113861387,6
0.2,6464,96,472991,73.16179427687548,6
0.2,6465,95,473086,73.16517166718218,7
0.2,6466,94,473180,73.16839338178444,7
0.2,6467,25,473205,73.16094619666048,8
0.2,6468,95,473300,73.1643221518009,6
0.2,6469,94,473394,73.16754250386398,8
0.2,6470,-47,473347,73.14897233812394,11
0.2,6471,94,473441,73.15219406674908,9
0.2,6472,21,473462,73.14413718523096,11
0.2,6473,95,473557,73.14751312944084,6
0.2,6474,95,473652,73.15088803088803,6
0.2,6475,93,473745,73.15395305744286,10
0.2,6476,95,473840,73.15732592249498,7
0.2,6477,19,473859,73.14896573016362,13
0.2,6478,95,473954,73.1523383238154,7
0.2,6479,26,473980,73.14506172839506,7
0.2,6480,24,474004,73.13747878413825,8
0.2,6481,93,474097,73.1405430422709,9
0.2,6482,96,474193,73.14406910380997,6
0.2,6483,25,474218,73.13664404688464,8
0.2,6484,95,474313,73.14001542020046,7
0.2,6485,24,474337,73.13243909959914,8
0.2,6486,95,474432,73.13581008170186,7
0.2,6487,94,474526,73.13902589395808,7
0.2,6488,93,474619,73.14208660810603,9
0.2,6489,95,474714,73.14545454545454,8
0.2,6490,95,474809,73.1488214450778,6
0.2,6491,93,474902,73.15187923598275,9
0.2,6492,95,474997,73.15524410904051,6
0.2,6493,93,475090,73.15829996920235,8
0.2,6494,93,475183,73.16135488837567,9
0.2,6495,92,475275,73.16425492610837,10
0.2,6496,26,475301,73.15699553640141,8
0.2,6497,93,475394,73.16004924592183,9
0.2,6498,27,475421,73.15294660717034,6
0.2,6499,92,475513,73.15584615384616,10
0.2,6500,94,475607,73.1590524534687,8
0.2,6501,95,475702,73.1624115656721,8
0.2,6502,91,475793,73.16515454405659,11
0.2,6503,94,475887,73.16835793357933,9
0.2,6504,94,475981,73.17156033820139,8
0.2,6505,96,476077,73.17506916692284,6
0.2,6506,92,476169,73.17796219455971,9
0.2,6507,95,476264,73.18131530424094,6
0.2,6508,95,476359,73.18466738362268,6
0.2,6509,14,476373,73.17557603686636,19
0.2,6510,95,476468,73.17892796805407,7
0.2,6511,21,476489,73.17091523341523,11
0.2,6512,24,476513,73.16336557653923,9
0.2,6513,95,476608,73.16671783850168,6
0.2,6514,94,476702,73.16991557943209,8
0.2,6515,95,476797,73.17326580724371,7
0.2,6516,93,476890,73.17630811723186,9
0.2,6517,96,476986,73.17980975759436,6
0.2,6518,89,477075,73.18223653934652,13
0.2,6519,92,477167,73.1851226993865,9
0.2,6520,24,477191,73.17758012574758,8
0.2,6521,94,477285,73.18077276908923,8
0.2,6522,94,477379,73.18396443354285,7
0.2,6523,91,477470,73.18669527896996,12
0.2,6524,92,477562,73.1895785440613,10
0.2,6525,94,477656,73.19276739197058,9
0.2,6526,93,477749,73.19580205301057,9
0.2,6527,-44,477705,73.17784926470588,8
0.2,6528,91,477796,73.18057895542962,11
0.2,6529,89,477885,73.18300153139357,15
0.2,6530,87,477972,73.18511713367019,14
0.2,6531,96,478068,73.18860992039191,6
0.2,6532,95,478163,73.19194856880453,8
0.2,6533,86,478249,73.19390878481788,15
0.2,6534,95,478344,73.19724560061209,6
0.2,6535,24,478368,73.18971848225215,9
0.2,6536,95,478463,73.19305491815818,8
0.2,6537,92,478555,73.19593147751605,11
0.2,6538,27,478582,73.18886679920477,6
0.2,6539,96,478678,73.19235474006116,6
0.2,6540,26,478704,73.18513988686745,7
0.2,6541,96,478800,73.18862733109141,6
0.2,6542,94,478894,73.19180803912579,7
0.2,6543,94,478988,73.19498777506112,8
0.2,6544,93,479081,73.19801375095493,9
0.2,6545,95,479176,73.20134433241674,7
0.2,6546,25,479201,73.19398197647777,9
0.2,6547,93,479294,73.19700671960904,9
0.2,6548,95,479389,73.20033592914949,6
0.2,6549,94,479483,73.20351145038168,8
0.2,6550,25,479508,73.19615325904442,8
0.2,6551,94,479602,73.19932844932845,9
0.2,6552,94,479696,73.20250267053258,8
0.2,6553,95,479791,73.20582850167837,7
0.2,6554,93,479884,73.20884820747521,10
0.2,6555,95,479979,73.21217205613179,6
0.2,6556,22,480001,73.20436175080067,11
0.2,6557,92,480093,73.20722781335773,9
0.2,6558,89,480182,73.20963561518523,15
0.2,6559,95,480277,73.21295731707318,6
0.2,6560,23,480300,73.2053040695016,13
0.2,6561,88,480388,73.20755867113685,14
0.2,6562,96,480484,73.21103154045406,7
0.2,6563,96,480580,73.21450335161487,6
0.2,6564,93,480673,73.21751713632902,8
0.2,6565,94,480767,73.22068230277185,8
0.2,6566,24,480791,73.21318714786051,9
0.2,6567,-47,480744,73.19488428745433,11
0.2,6568,93,480837,73.19789922362612,9
0.2,6569,23,480860,73.19025875190259,11
0.2,6570,95,480955,73.19357784203318,7
0.2,6571,26,480981,73.18639683505782,8
0.2,6572,91,481072,73.18910695268522,11
0.2,6573,94,481166,73.19227258898692,7
0.2,6574,96,481262,73.19574144486693,6
0.2,6575,23,481285,73.18810827250608,10
0.2,6576,94,481379,73.19127261669455,8
0.2,6577,95,481474,73.19458802067497,6
0.2,6578,92,481566,73.19744642042863,10
0.2,6579,96,481662,73.20091185410334,6
0.2,6580,95,481757,73.20422428202401,6
0.2,6581,89,481846,73.20662412640534,12
0.2,6582,92,481938,73.20947896096006,10
0.2,6583,95,482033,73.21278857837181,6
0.2,6584,92,482125,73.21564160971906,11
0.2,6585,95,482220,73.21894928636502,7
0.2,6586,91,482311,73.22164870198877,10
0.2,6587,27,482338,73.21463266545234,6
0.2,6588,91,482429,73.21733191683109,11
0.2,6589,92,482521,73.22018209408195,10
0.2,6590,93,482614,73.22318312850857,9
0.2,6591,93,482707,73.22618325242719,9
0.2,6592,93,482800,73.22918246625208,9
0.2,6593,94,482894,73.23233242341523,7
0.2,6594,96,482990,73.2357846853677,6
0.2,6595,96,483086,73.23923590054578,7
0.2,6596,93,483179,73.24223131726542,8
0.2,6597,94,483273,73.24537738708699,8
0.2,6598,21,483294,73.23746022124564,12
0.2,6599,94,483388,73.24060606060605,7
0.2,6600,95,483483,73.2439024390244,6
0.2,6601,92,483575,73.24674341108755,10
0.2,6602,-46,483529,73.22868393154627,10
0.2,6603,91,483620,73.2313749242883,10
0.2,6604,95,483715,73.23467070401212,7
0.2,6605,93,483808,73.23766273085074,8
0.2,6606,94,483902,73.24080520659906,8
0.2,6607,91,483993,73.24349273607749,11
0.2,6608,95,484088,73.24678468754729,6
0.2,6609,95,484183,73.2500756429652,6
0.2,6610,95,484278,73.25336560278323,7
0.2,6611,95,484373,73.25665456745311,6
0.2,6612,22,484395,73.24890367458038,11
0.2,6613,93,484488,73.25188993045056,9
0.2,6614,21,484509,73.24399092970522,11
0.2,6615,95,484604,73.24727932285369,7
0.2,6616,24,484628,73.2398367840411,8
0.2,6617,93,484721,73.24282260501663,8
0.2,6618,93,484814,73.24580752379514,10
0.2,6619,27,484841,73.23882175226586,6
0.2,6620,93,484934,73.24180637365957,8
0.2,6621,94,485028,73.24494110540623,8
0.2,6622,21,485049,73.23705269515325,12
0.2,6623,96,485145,73.24048913043478,7
0.2,6624,95,485240,73.24377358490565,7
0.2,6625,95,485335,73.24705704799275,7
0.2,6626,95,485430,73.25033952014486,6
0.2,6627,95,485525,73.2536210018105,6
0.2,6628,89,485614,73.25599637954443,12
0.2,6629,93,485707,73.25897435897436,9
0.2,6630,95,485802,73.26225305383804,8
0.2,6631,94,485896,73.26537997587455,8
0.2,6632,95,485991,73.26865671641791,6
0.2,6633,94,486085,73.27178173047935,7
0.2,6634,95,486180,73.27505651846269,6
0.2,6635,94,486274,73.27817962628089,8
0.2,6636,95,486369,73.2814524634624,7
0.2,6637,-48,486321,73.26318168122928,12
0.2,6638,91,486412,73.26585329115831,12
0.2,6639,93,486505,73.26882530120481,9
0.2,6640,92,486597,73.27164583647041,9
0.2,6641,24,486621,73.26422764227642,9
0.2,6642,90,486711,73.26674695167846,11
0.2,6643,20,486731,73.25872968091511,15
0.2,6644,94,486825,73.26185101580135,9
0.2,6645,23,486848,73.2542882937105,10
0.2,6646,94,486942,73.25740935760493,7
0.2,6647,95,487037,73.26067990373045,6
0.2,6648,21,487058,73.25281997292826,11
0.2,6649,93,487151,73.25578947368422,9
0.2,6650,91,487242,73.25845737483085,10
0.2,6651,95,487337,73.26172579675286,7
0.2,6652,94,487431,73.26484292800241,10
0.2,6653,95,487526,73.26810940787496,6
0.2,6654,-54,487472,73.24898572501878,18
0.2,6655,23,487495,73.24143629807692,9
0.2,6656,93,487588,73.24440438636022,9
0.2,6657,24,487612,73.23700811054371,9
0.2,6658,96,487708,73.24042649046403,6
0.2,6659,93,487801,73.24339339339339,9
0.2,6660,-49,487752,73.22504128509233,12
0.2,6661,24,487776,73.21765235664965,9
0.2,6662,92,487868,73.22047125919255,9
0.2,6663,94,487962,73.22358943577431,7
0.2,6664,95,488057,73.22685671417854,6
0.2,6665,94,488151,73.22997299729973,10
0.2,6666,94,488245,73.23308834558271,7
0.2,6667,89,488334,73.23545290941811,12
0.2,6668,93,488427,73.23841655420603,9
0.2,6669,95,488522,73.24167916041979,6
0.2,6670,92,488614,73.24449108079749,9
0.2,6671,92,488706,73.24730215827338,10
0.2,6672,93,488799,73.25026225086168,8
0.2,6673,95,488894,73.25352112676056,7
0.2,6674,21,488915,73.24569288389513,13
0.2,6675,91,489006,73.24835230677053,12
0.2,6676,94,489100,73.25146023663322,8
0.2,6677,95,489195,73.25471698113208,7
0.2,6678,18,489213,73.24644407845486,14
0.2,6679,26,489239,73.23937125748503,6
0.2,6680,-45,489194,73.2216734021853,9
0.2,6681,93,489287,73.22463334331039,9
0.2,6682,26,489313,73.21756696094569,7
0.2,6683,94,489407,73.2206762417714,7
0.2,6684,91,489498,73.22333582647718,11
0.2,6685,94,489592,73.22644331438828,7
0.2,6686,93,489685,73.22940032899656,11
0.2,6687,93,489778,73.23235645933015,10
0.2,6688,90,489868,73.23486320825235,11
0.2,6689,96,489964,73.23826606875934,6
0.2,6690,19,489983,73.23015991630548,15
0.2,6691,95,490078,73.23341303048416,7
0.2,6692,94,490172,73.23651576273718,8
0.2,6693,96,490268,73.23991634299372,6
0.2,6694,94,490362,73.24301717699775,7
0.2,6695,92,490454,73.24581839904421,11
0.2,6696,95,490549,73.24906674630432,7
0.2,6697,94,490643,73.25216482532099,7
0.2,6698,94,490737,73.2552619793999,10
0.2,6699,95,490832,73.25850746268657,6
0.2,6700,93,490925,73.26145351440084,11
0.2,6701,93,491018,73.26439868695911,9
0.2,6702,89,491107,73.26674623302999,13
0.2,6703,91,491198,73.26939140811456,11
0.2,6704,93,491291,73.27233407904549,9
0.2,6705,95,491386,73.27557411273486,6
0.2,6706,88,491474,73.27776949455793,16
0.2,6707,95,491569,73.28100775193798,7
0.2,6708,-49,491520,73.26278133850052,13
0.2,6709,93,491613,73.26572280178837,8
0.2,6710,91,491704,73.26836537028758,10
0.2,6711,-49,491655,73.25014898688916,14
0.2,6712,-49,491606,73.23193803068672,13
0.2,6713,95,491701,73.23518022043491,6
0.2,6714,95,491796,73.23842144452718,7
0.2,6715,-124,491672,73.20905300774271,18
0.2,6716,95,491767,73.21229715646867,7
0.2,6717,92,491859,73.2150937779101,10
0.2,6718,93,491952,73.21803839857121,9
0.2,6719,-119,491833,73.18943452380952,14
0.2,6720,91,491924,73.19208451123345,10
0.2,6721,95,492019,73.19532877119904,6
0.2,6722,24,492043,73.18801130447717,9
0.2,6723,94,492137,73.19110648423558,8
0.2,6724,-49,492088,73.17293680297398,13
0.2,6725,-56,492032,73.15373178709486,20
0.2,6726,91,492123,73.15638471829939,11
0.2,6727,91,492214,73.15903686087991,10
0.2,6728,95,492309,73.1622826571556,7
0.2,6729,-57,492252,73.14294205052006,22
0.2,6730,96,492348,73.14633783984549,6
0.2,6731,95,492443,73.14958407605467,7
0.2,6732,93,492536,73.15253230357939,10
0.2,6733,96,492632,73.15592515592516,7
0.2,6734,94,492726,73.15902004454342,8
0.2,6735,94,492820,73.16211401425178,7
0.2,6736,95,492915,73.16535549948048,6
0.2,6737,95,493010,73.16859602255862,7
0.2,6738,94,493104,73.17168719394569,8
0.2,6739,86,493190,73.17359050445104,15
0.2,6740,93,493283,73.17653167185877,8
0.2,6741,95,493378,73.1797686146544,7
0.2,6742,94,493472,73.18285629541747,7
0.2,6743,95,493567,73.18609134045077,6
0.2,6744,95,493662,73.18932542624167,6
0.2,6745,93,493755,73.19226208123332,9
0.2,6746,92,493847,73.19504965169705,9
0.2,6747,94,493941,73.19813278008299,8
0.2,6748,-46,493895,73.18047118091569,10
0.2,6749,93,493988,73.1834074074074,9
0.2,6750,90,494078,73.18589838542438,12
0.2,6751,24,494102,73.17861374407583,9
0.2,6752,87,494189,73.18066044720865,15
0.2,6753,92,494281,73.1834468463133,9
0.2,6754,92,494373,73.1862324204293,10
0.2,6755,95,494468,73.18946121965661,7
0.2,6756,95,494563,73.19268906319373,8
0.2,6757,23,494586,73.18526191180823,11
0.2,6758,94,494680,73.18834147063176,8
0.2,6759,23,494703,73.18091715976331,10
0.2,6760,89,494792,73.18325691465759,12
0.2,6761,91,494883,73.18589174800356,11
0.2,6762,95,494978,73.18911725565577,6
0.2,6763,93,495071,73.19204612655234,9
0.2,6764,95,495166,73.19526977087952,7
0.2,6765,25,495191,73.18814661543009,9
0.2,6766,93,495284,73.19107433131373,10
0.2,6767,20,495304,73.18321513002364,13
0.2,6768,96,495400,73.18658590633771,6
0.2,6769,17,495417,73.17828655834565,17
0.2,6770,95,495512,73.18150937823069,7
0.2,6771,94,495606,73.18458357944478,7
0.2,6772,88,495694,73.18677100250997,15
0.2,6773,95,495789,73.18999114260407,7
0.2,6774,94,495883,73.1930627306273,8
0.2,6775,93,495976,73.19598583234946,9
0.2,6776,24,496000,73.18872657518075,8
0.2,6777,94,496094,73.19179699026262,7
0.2,6778,26,496120,73.18483552146334,7
0.2,6779,91,496211,73.18746312684365,11
0.2,6780,18,496229,73.17932458339477,16
0.2,6781,24,496253,73.17207313476851,8
0.2,6782,94,496347,73.1751437417072,8
0.2,6783,24,496371,73.16789504716981,8
0.2,6784,93,496464,73.17081798084008,8
0.2,6785,95,496559,73.17403477748306,8
0.2,6786,-123,496436,73.14513039634596,18
0.2,6787,84,496520,73.1467295226871,17
0.2,6788,94,496614,73.14980114891736,7
0.2,6789,22,496636,73.14226804123712,12
0.2,6790,20,496656,73.13444264467678,13
0.2,6791,95,496751,73.13766195524146,7
0.2,6792,88,496839,73.13984984542911,14
0.2,6793,92,496931,73.14262584633501,10
0.2,6794,22,496953,73.13509933774834,11
0.2,6795,92,497045,73.13787522071807,10
0.2,6796,95,497140,73.14109165808445,6
0.2,6797,92,497232,73.14386584289497,9
0.2,6798,94,497326,73.14693337255478,7
0.2,6799,91,497417,73.14955882352942,10
0.2,6800,93,497510,73.15247757682694,8
0.2,6801,95,497605,73.15568950308733,7
0.2,6802,94,497699,73.15875349110686,7
0.2,6803,95,497794,73.16196355085243,6
0.2,6804,21,497815,73.15429831006612,13
0.2,6805,95,497910,73.15750808110491,7
0.2,6806,95,498005,73.16071690906419,7
0.2,6807,27,498032,73.1539365452409,6
0.2,6808,24,498056,73.14671757967396,8
0.2,6809,96,498152,73.15007342143906,6
0.2,6810,93,498245,73.15298781383056,10
0.2,6811,94,498339,73.15604815032296,8
0.2,6812,91,498430,73.15866725377954,11
0.2,6813,95,498525,73.16187261520399,7
0.2,6814,94,498619,73.16493030080704,7
0.2,6815,20,498639,73.15713028169014,12
0.2,6816,89,498728,73.15945430541294,12
0.2,6817,93,498821,73.16236432971546,9
0.2,6818,88,498909,73.16454025516938,13
0.2,6819,95,499004,73.16774193548387,8
0.2,6820,94,499098,73.17079607095734,8
0.2,6821,93,499191,73.17370272647318,8
0.2,6822,96,499287,73.1770482192584,6
0.2,6823,89,499376,73.17936694021103,14
0.2,6824,92,499468,73.18212454212454,11
0.2,6825,95,499563,73.18532083211251,7
0.2,6826,95,499658,73.18851618573312,7
0.2,6827,95,499753,73.19171060339778,8
0.2,6828,24,499777,73.18450724849905,9
0.2,6829,94,499871,73.18755490483163,8
0.2,6830,92,499963,73.19030888596106,10
0.2,6831,95,500058,73.19350117096019,6
0.2,6832,19,500077,73.18557002780624,14
0.2,6833,95,500172,73.18876207199298,6
0.2,6834,94,500266,73.19180687637161,9
0.2,6835,94,500360,73.19485078993563,8
0.2,6836,92,500452,73.19760128711422,11
0.2,6837,90,500542,73.20005849663644,12
0.2,6838,92,500634,73.20280742798654,9
0.2,6839,94,500728,73.20584795321638,8
0.2,6840,95,500823,73.20903376699313,7
0.2,6841,94,500917,73.21207249342298,7
0.2,6842,-56,500861,73.19319012129183,20
0.2,6843,91,500952,73.1957919345412,13
0.2,6844,94,501046,73.19883126369614,7
0.2,6845,93,501139,73.20172363423897,8
0.2,6846,91,501230,73.20432306119469,10
0.2,6847,93,501323,73.20721378504673,9
0.2,6848,20,501343,73.19944517447803,13
0.2,6849,24,501367,73.19226277372263,9
0.2,6850,94,501461,73.19529995621077,8
0.2,6851,91,501552,73.19789842381786,10
0.2,6852,25,501577,73.19086531446082,8
0.2,6853,22,501599,73.18339655675518,11
0.2,6854,95,501694,73.18657913931438,8
0.2,6855,95,501789,73.18976079346558,7
0.2,6856,95,501884,73.19294151961499,7
0.2,6857,91,501975,73.19553805774278,11
0.2,6858,95,502070,73.198717014142,7
0.2,6859,95,502165,73.20189504373178,7
0.2,6860,92,502257,73.20463489287276,9
0.2,6861,94,502351,73.2076654036724,9
0.2,6862,89,502440,73.20996648695906,13
0.2,6863,27,502467,73.20323426573427,6
0.2,6864,95,502562,73.20640932265113,7
0.2,6865,94,502656,73.20943780949607,8
0.2,6866,6,502662,73.19965050240279,27
0.2,6867,24,502686,73.1924868957484,9
0.2,6868,24,502710,73.18532537487262,8
0.2,6869,94,502804,73.18835516739446,9
0.2,6870,26,502830,73.18148741085723,7
0.2,6871,93,502923,73.18437136204889,8
0.2,6872,88,503011,73.18652698966972,14
0.2,6873,96,503107,73.1898457957521,7
0.2,6874,93,503200,73.19272727272727,9
0.2,6875,95,503295,73.1958987783595,6
0.2,6876,94,503389,73.19892394939654,7
0.2,6877,95,503484,73.20209363186973,7
0.2,6878,22,503506,73.19465038523042,12
0.2,6879,95,503601,73.19781976744186,7
0.2,6880,22,503623,73.19037930533352,11
0.2,6881,22,503645,73.18294100552166,12
0.2,6882,95,503740,73.18611070754032,7
0.2,6883,94,503834,73.18913422428821,8
0.2,6884,94,503928,73.1921568627451,7
0.2,6885,25,503953,73.18515829218704,8
0.2,6886,89,504042,73.18745462465515,14
0.2,6887,-45,503997,73.17029616724739,9
0.2,6888,21,504018,73.16272318188416,11
0.2,6889,93,504111,73.1656023222061,10
0.2,6890,95,504206,73.16877086054274,6
0.2,6891,24,504230,73.16163668020894,8
0.2,6892,93,504323,73.16451472508342,10
0.2,6893,22,504345,73.15709312445605,11
0.2,6894,94,504439,73.16011602610587,9
0.2,6895,94,504533,73.16313805104409,9
0.2,6896,94,504627,73.16615919965203,7
0.2,6897,91,504718,73.16874456364164,12
0.2,6898,92,504810,73.17147412668503,9
0.2,6899,17,504827,73.16333333333333,17
0.2,6900,92,504919,73.16606288943632,9
0.2,6901,95,505014,73.16922631121415,9
0.2,6902,23,505037,73.16195856873823,9
0.2,6903,94,505131,73.16497682502897,9
0.2,6904,90,505221,73.16741491672701,12
0.2,6905,-51,505170,73.14943527367507,15
0.2,6906,21,505191,73.1418850441581,12
0.2,6907,91,505282,73.14447017950202,11
0.2,6908,92,505374,73.14719930525402,10
0.2,6909,21,505395,73.1396526772793,12
0.2,6910,92,505487,73.14238171031688,9
0.2,6911,93,505580,73.14525462962963,9
0.2,6912,21,505601,73.13771155793432,11
0.2,6913,91,505692,73.1402950535146,11
0.2,6914,22,505714,73.13289949385394,10
0.2,6915,22,505736,73.1255060728745,10
0.2,6916,95,505831,73.12866849790372,7
0.2,6917,23,505854,73.12142237640937,10
0.2,6918,22,505876,73.11403381991617,10
0.2,6919,92,505968,73.11676300578034,9
0.2,6920,95,506063,73.1199248663488,7
0.2,6921,93,506156,73.1227968795146,9
0.2,6922,86,506242,73.12465694063268,18
0.2,6923,93,506335,73.12752744078567,8
0.2,6924,95,506430,73.13068592057762,8
0.2,6925,95,506525,73.13384348830493,6
0.2,6926,26,506551,73.12703912227515,7
0.2,6927,-45,506506,73.10998845265588,8
0.2,6928,10,506516,73.10088035791601,23
0.2,6929,95,506611,73.1040404040404,6
0.2,6930,95,506706,73.10719953830616,7
0.2,6931,-50,506656,73.08944027697635,15
0.2,6932,94,506750,73.09245636809462,9
0.2,6933,16,506766,73.08422267089703,16
0.2,6934,95,506861,73.0873828406633,8
0.2,6935,93,506954,73.09025374855824,10
0.2,6936,-47,506907,73.07294219403201,11
0.2,6937,24,506931,73.06586912654944,10
0.2,6938,95,507026,73.06903011961377,7
0.2,6939,23,507049,73.06181556195965,9
0.2,6940,96,507145,73.06512029966864,6
0.2,6941,94,507239,73.06813598386633,8
0.2,6942,-45,507194,73.05113063517211,9
0.2,6943,86,507280,73.05299539170507,16
0.2,6944,93,507373,73.05586753059755,12
0.2,6945,94,507467,73.05888281025051,7
0.2,6946,96,507563,73.06218511587736,6
0.2,6947,94,507657,73.06519861830742,7
0.2,6948,95,507752,73.06835515901568,7
0.2,6949,24,507776,73.06129496402878,9
0.2,6950,92,507868,73.06401956553015,9
0.2,6951,94,507962,73.06703107019563,7
0.2,6952,92,508054,73.06975406299439,9
0.2,6953,94,508148,73.07276387690538,10
0.2,6954,27,508175,73.06613946800863,6
0.2,6955,23,508198,73.05894192064405,10
0.2,6956,94,508292,73.06195199080064,7
0.2,6957,19,508311,73.0541822362748,16
0.2,6958,93,508404,73.05704842649806,9
0.2,6959,92,508496,73.05977011494252,12
0.2,6960,23,508519,73.05257865249246,10
0.2,6961,90,508609,73.05501292731974,12
0.2,6962,12,508621,73.04624443487003,21
0.2,6963,93,508714,73.0491097070649,10
0.2,6964,89,508803,73.05139985642498,13
0.2,6965,91,508894,73.05397645707723,11
0.2,6966,93,508987,73.05683938567533,8
0.2,6967,89,509076,73.05912743972445,13
0.2,6968,95,509171,73.06227579279667,6
0.2,6969,25,509196,73.05538020086084,8
0.2,6970,93,509289,73.05824128532491,8
0.2,6971,95,509384,73.061388410786,7
0.2,6972,96,509480,73.06467804388355,6
0.2,6973,94,509574,73.06767995411529,7
0.2,6974,93,509667,73.07053763440861,9
0.2,6975,94,509761,73.0735378440367,9
0.2,6976,20,509781,73.06593091586642,12
0.2,6977,22,509803,73.05861278303239,11
0.2,6978,21,509824,73.05115346038114,13
0.2,6979,92,509916,73.05386819484241,9
0.2,6980,92,510008,73.05658215155422,10
0.2,6981,94,510102,73.05958178172443,9
0.2,6982,92,510194,73.06229414291852,9
0.2,6983,94,510288,73.06529209621993,8
0.2,6984,94,510382,73.06828919112384,8
0.2,6985,96,510478,73.0715717148583,6
0.2,6986,94,510572,73.0745670530986,8
0.2,6987,94,510666,73.07756153405839,8
0.2,6988,90,510756,73.07998283016168,11
0.2,6989,19,510775,73.0722460658083,14
0.2,6990,95,510870,73.0753826348162,7
0.2,6991,94,510964,73.0783752860412,8
0.2,6992,95,511059,73.08151008151007,8
0.2,6993,90,511149,73.08392908207034,11
0.2,6994,94,511243,73.08691922802001,8
0.2,6995,94,511337,73.08990851915381,7
0.2,6996,92,511429,73.09261111905103,9
0.2,6997,94,511523,73.09559874249786,8
0.2,6998,92,511615,73.09829975710817,12
0.2,6999,90,511705,73.10071428571429,13
0.2,7000,93,511798,73.10355663476646,8
0.2,7001,95,511893,73.10668380462725,7
0.2,7002,94,511987,73.10966728544909,7
0.2,7003,94,512081,73.11264991433467,8
0.2,7004,93,512174,73.11548893647395,10
0.2,7005,93,512267,73.11832714815873,9
0.2,7006,95,512362,73.12144997859284,7
0.2,7007,20,512382,73.1138698630137,14
0.2,7008,95,512477,73.11699243829362,6
0.2,7009,96,512573,73.12025677603424,6
0.2,7010,-49,512524,73.10283839680503,13
0.2,7011,95,512619,73.10596120935539,7
0.2,7012,93,512712,73.10879794667046,10
0.2,7013,26,512738,73.10208155118335,8
0.2,7014,93,512831,73.10491803278688,8
0.2,7015,22,512853,73.09763397947549,11
0.2,7016,95,512948,73.1007553085364,7
0.2,7017,90,513038,73.10316329438587,11
0.2,7018,94,513132,73.10614047585126,8
0.2,7019,94,513226,73.10911680911681,8
0.2,7020,96,513322,73.11237715425153,6
0.2,7021,95,513417,73.11549416120764,7
0.2,7022,19,513436,73.10778869429019,15
0.2,7023,91,513527,73.11033599088839,12
0.2,7024,94,513621,73.11330960854093,7
0.2,7025,95,513716,73.11642470822659,6
0.2,7026,86,513802,73.11825814714672,15
0.2,7027,94,513896,73.12122936824132,8
0.2,7028,23,513919,73.11409873381704,10
0.2,7029,91,514010,73.11664295874822,11
0.2,7030,93,514103,73.1194709145214,9
0.2,7031,93,514196,73.12229806598407,9
0.2,7032,95,514291,73.12540878714631,6
0.2,7033,91,514382,73.12794995735001,11
0.2,7034,95,514477,73.13105899076048,7
0.2,7035,90,514567,73.13345650938032,11
0.2,7036,-53,514514,73.11553218701151,16
0.2,7037,96,514610,73.11878374538222,6
0.2,7038,94,514704,73.12175024861486,8
0.2,7039,-47,514657,73.1046875,10
0.2,7040,83,514740,73.10609288453345,19
0.2,7041,95,514835,73.10920193126952,7
0.2,7042,89,514924,73.11145818543234,14
0.2,7043,95,515019,73.11456558773425,7
0.2,7044,93,515112,73.11738821859475,11
0.2,7045,23,515135,73.11027533352257,10
0.2,7046,94,515229,73.11323967645806,9
0.2,7047,92,515321,73.11591940976163,10
0.2,7048,93,515414,73.11874024684353,9
0.2,7049,24,515438,73.1117730496454,9
0.2,7050,91,515529,73.11431002694653,11
0.2,7051,95,515624,73.11741349971639,7
0.2,7052,91,515715,73.11994895789026,11
0.2,7053,94,515809,73.12290898780833,8
0.2,7054,21,515830,73.11552090715804,12
0.2,7055,93,515923,73.11833900226758,9
0.2,7056,94,516017,73.12129800198385,8
0.2,7057,95,516112,73.12439784641542,6
0.2,7058,22,516134,73.11715540444823,11
0.2,7059,94,516228,73.1201133144476,7
0.2,7060,26,516254,73.11344002265967,7
0.2,7061,93,516347,73.11625601812517,11
0.2,7062,26,516373,73.10958516211241,9
0.2,7063,95,516468,73.11268403171007,7
0.2,7064,95,516563,73.11578202406228,6
0.2,7065,95,516658,73.11887913954146,7
0.2,7066,-50,516608,73.10145747842083,16
0.2,7067,92,516700,73.10413129598189,9
0.2,7068,95,516795,73.10722874522563,6
0.2,7069,95,516890,73.11032531824611,7
0.2,7070,90,516980,73.11271390185264,12
0.2,7071,93,517073,73.11552601809954,8
0.2,7072,93,517166,73.11833733917716,9
0.2,7073,95,517261,73.12143059089624,6
0.2,7074,89,517350,73.12367491166077,14
0.2,7075,26,517376,73.11701526286038,7
0.2,7076,-47,517329,73.10004239084358,10
0.2,7077,87,517416,73.10200621644532,14
0.2,7078,24,517440,73.09506992513067,9
0.2,7079,91,517531,73.0975988700565,11
0.2,7080,95,517626,73.10069199265641,7
0.2,7081,93,517719,73.10350183563965,9
0.2,7082,95,517814,73.10659325144712,6
0.2,7083,91,517905,73.10911914172783,10
0.2,7084,93,517998,73.11192660550459,9
0.2,7085,-51,517947,73.09441151566469,16
0.2,7086,95,518042,73.09750246931,6
0.2,7087,94,518136,73.10045146726863,7
0.2,7088,94,518230,73.10339963323459,8
0.2,7089,93,518323,73.10620592383638,9
0.2,7090,93,518416,73.10901142293048,8
0.2,7091,95,518511,73.11209813874788,7
0.2,7092,93,518604,73.11490201607218,8
0.2,7093,93,518697,73.11770510290387,9
0.2,7094,91,518788,73.12022551092319,12
0.2,7095,94,518882,73.12316798196167,8
0.2,7096,-48,518834,73.10610116950825,14
0.2,7097,94,518928,73.1090448013525,8
0.2,7098,96,519024,73.11226933370898,6
0.2,7099,91,519115,73.11478873239436,11
0.2,7100,92,519207,73.11744824672581,9
0.2,7101,93,519300,73.12024781751619,8
0.2,7102,95,519395,73.12332817119527,6
0.2,7103,94,519489,73.12626689189189,9
0.2,7104,93,519582,73.12906403940887,8
0.2,7105,94,519676,73.13200112580918,8
0.2,7106,21,519697,73.1246658224286,12
0.2,7107,93,519790,73.1274620146314,9
0.2,7108,88,519878,73.1295540863694,17
0.2,7109,95,519973,73.13263009845288,6
0.2,7110,92,520065,73.13528336380256,10
0.2,7111,90,520155,73.13765466816648,12
0.2,7112,93,520248,73.14044706874736,8
0.2,7113,23,520271,73.133398931684,10
0.2,7114,94,520365,73.13633169360506,9
0.2,7115,90,520455,73.13870151770658,12
0.2,7116,91,520546,73.14121118448784,11
0.2,7117,96,520642,73.14442259061533,6
0.2,7118,94,520736,73.14735215620172,9
0.2,7119,95,520831,73.15042134831461,6
0.2,7120,96,520927,73.15363010813088,6
0.2,7121,94,521021,73.15655714686886,9
0.2,7122,94,521115,73.15948336375124,7
0.2,7123,96,521211,73.16268950028073,6
0.2,7124,95,521306,73.16575438596492,6
0.2,7125,95,521401,73.16881841145103,7
0.2,7126,93,521494,73.17160095411815,8
0.2,7127,96,521590,73.17480359147025,6
0.2,7128,94,521684,73.17772478608501,7
0.2,7129,95,521779,73.18078541374474,7
0.2,7130,94,521873,73.18370495021736,8
0.2,7131,95,521968,73.18676388109927,7
0.2,7132,88,522056,73.18884060002804,15
0.2,7133,96,522152,73.19203812727783,6
0.2,7134,89,522241,73.19425367904695,13
0.2,7135,94,522335,73.19716928251121,7
0.2,7136,92,522427,73.1998038391481,9
0.2,7137,94,522521,73.20271784813673,8
0.2,7138,92,522613,73.20535088948031,10
0.2,7139,95,522708,73.20840336134454,7
0.2,7140,22,522730,73.2012323204033,12
0.2,7141,94,522824,73.20414449733968,8
0.2,7142,92,522916,73.20677586448271,10
0.2,7143,93,523009,73.20954647256438,8
0.2,7144,-50,522959,73.19230230930721,16
0.2,7145,95,523054,73.19535404422054,7
0.2,7146,23,523077,73.18833076815447,10
0.2,7147,91,523168,73.19082260772244,10
0.2,7148,95,523263,73.19387326898867,7
0.2,7149,-119,523144,73.16699300699301,14
0.2,7150,94,523238,73.16990630681023,7
0.2,7151,92,523330,73.17253914988814,9
0.2,7152,94,523424,73.17545085977912,7
0.2,7153,26,523450,73.16885658372938,8
0.2,7154,95,523545,73.17190775681341,6
0.2,7155,88,523633,73.17397987702627,14
0.2,7156,96,523729,73.17716920497415,7
0.2,7157,88,523817,73.1792400111763,13
0.2,7158,90,523907,73.18158960748708,12
0.2,7159,91,523998,73.1840782122905,12
0.2,7160,94,524092,73.1869850579528,10
0.2,7161,20,524112,73.179558782463,13
0.2,7162,93,524205,73.18232584112802,9
0.2,7163,93,524298,73.18509212730318,11
0.2,7164,86,524384,73.18688066992324,16
0.2,7165,93,524477,73.18964554842312,8
0.2,7166,23,524500,73.1826426677829,10
0.2,7167,24,524524,73.17578125,9
0.2,7168,92,524616,73.17840703026921,10
0.2,7169,19,524635,73.17085076708507,15
0.2,7170,95,524730,73.17389485427417,7
0.2,7171,93,524823,73.1766592303402,9
0.2,7172,95,524918,73.17970165899902,6
0.2,7173,91,525009,73.18218567047673,10
0.2,7174,93,525102,73.18494773519164,10
0.2,7175,93,525195,73.18770903010034,9
0.2,7176,95,525290,73.19074822349171,8
0.2,7177,92,525382,73.19336862635832,10
0.2,7178,92,525474,73.19598829920602,13
0.2,7179,95,525569,73.19902506963788,6
0.2,7180,89,525658,73.20122545606462,12
0.2,7181,95,525753,73.20426065162907,6
0.2,7182,92,525845,73.20687734929695,10
0.2,7183,93,525938,73.20963251670379,8
0.2,7184,90,526028,73.21196938065414,12
0.2,7185,25,526053,73.20526022822155,9
0.2,7186,92,526145,73.20787533045777,11
0.2,7187,22,526167,73.20075125208682,11
0.2,7188,92,526259,73.20336625399916,10
0.2,7189,94,526353,73.20625869262865,8
0.2,7190,95,526448,73.20928938951467,6
0.2,7191,92,526540,73.2119021134594,10
0.2,7192,94,526634,73.21479215904351,10
0.2,7193,94,526728,73.21768140116764,8
0.2,7194,92,526820,73.22029186935372,9
0.2,7195,93,526913,73.22304057809895,9
0.2,7196,93,527006,73.2257885229957,8
0.2,7197,-54,526952,73.20811336482356,17
0.2,7198,27,526979,73.20169467981664,6
0.2,7199,95,527074,73.20472222222222,7
0.2,7200,92,527166,73.20733231495626,10
0.2,7201,93,527259,73.21008053318522,10
0.2,7202,95,527354,73.21310565042343,7
0.2,7203,94,527448,73.21599111604664,7
0.2,7204,94,527542,73.21887578070785,8
0.2,7205,22,527564,73.21176797113516,11
0.2,7206,95,527659,73.21479117524629,7
0.2,7207,95,527754,73.21781354051055,8
0.2,7208,-49,527705,73.20086003606603,13
0.2,7209,94,527799,73.20374479889043,8
0.2,7210,94,527893,73.2066287616142,9
0.2,7211,93,527986,73.20937326677759,9
0.2,7212,89,528075,73.21156245667545,13
0.2,7213,-46,528029,73.19503742722485,10
0.2,7214,95,528124,73.1980595980596,6
0.2,7215,25,528149,73.19138026607538,8
0.2,7216,20,528169,73.1840099764445,12
0.2,7217,89,528258,73.18620116375727,13
0.2,7218,91,528349,73.18866879069124,10
0.2,7219,20,528369,73.18130193905817,12
0.2,7220,-120,528249,73.1545492314084,15
0.2,7221,94,528343,73.15743561340349,8
0.2,7222,94,528437,73.16032119617887,10
0.2,7223,91,528528,73.16279069767442,11
0.2,7224,92,528620,73.16539792387543,10
0.2,7225,91,528711,73.16786603930252,10
0.2,7226,93,528804,73.1706102117061,9
0.2,7227,92,528896,73.1732152739347,9
0.2,7228,94,528990,73.17609627887674,7
0.2,7229,87,529077,73.17800829875519,14
0.2,7230,94,529171,73.18088784400499,7
0.2,7231,24,529195,73.17408738938053,10
0.2,7232,90,529285,73.17641365961565,13
0.2,7233,-44,529241,73.16021564832734,8
0.2,7234,22,529263,73.15314443676573,10
0.2,7235,27,529290,73.14676616915423,6
0.2,7236,94,529384,73.1496476440514,7
0.2,7237,20,529404,73.14230450400663,12
0.2,7238,92,529496,73.14490951788922,11
0.2,7239,95,529591,73.14792817679557,9
0.2,7240,93,529684,73.15066979698936,9
0.2,7241,94,529778,73.15354874344104,8
0.2,7242,-50,529728,73.1365456302637,13
0.2,7243,95,529823,73.13956377691883,7
0.2,7244,-46,529777,73.12311939268461,12
0.2,7245,93,529870,73.12586254485234,9
0.2,7246,94,529964,73.12874292810818,8
0.2,7247,90,530054,73.1310706401766,11
0.2,7248,93,530147,73.13381156021521,9
0.2,7249,23,530170,73.12689655172414,11
0.2,7250,92,530262,73.12949937939595,10
0.2,7251,94,530356,73.13237727523442,8
0.2,7252,-53,530303,73.1149869019716,16
0.2,7253,22,530325,73.10794044665012,10
0.2,7254,22,530347,73.10089593383873,11
0.2,7255,94,530441,73.10377618522602,7
0.2,7256,96,530537,73.10693123880391,6
0.2,7257,95,530632,73.10994764397905,6
0.2,7258,94,530726,73.11282545805207,9
0.2,7259,96,530822,73.1159779614325,6
0.2,7260,96,530918,73.11912959647431,6
0.2,7261,94,531012,73.12200495731203,8
0.2,7262,94,531106,73.12487952636651,8
0.2,7263,-46,531060,73.10848017621146,10
0.2,7264,24,531084,73.10172057811424,10
0.2,7265,89,531173,73.10390861546931,13
0.2,7266,95,531268,73.10692170083941,8
0.2,7267,94,531362,73.10979636763896,7
0.2,7268,94,531456,73.11267024349979,8
0.2,7269,95,531551,73.11568088033012,6
0.2,7270,94,531645,73.11855315637465,7
0.2,7271,95,531740,73.12156215621562,7
0.2,7272,94,531834,73.12443283376874,9
0.2,7273,95,531929,73.12744019796536,6
0.2,7274,95,532024,73.13044673539518,7
0.2,7275,93,532117,73.13317757009345,8
0.2,7276,92,532209,73.13577023498695,9
0.2,7277,-44,532165,73.11967573509206,8
0.2,7278,92,532257,73.12226954251958,9
0.2,7279,94,532351,73.12513736263736,8
0.2,7280,95,532446,73.12814173877214,7
0.2,7281,91,532537,73.13059599011261,10
0.2,7282,94,532631,73.13346148565152,7
0.2,7283,23,532654,73.12657880285558,10
0.2,7284,96,532750,73.12971859986273,7
0.2,7285,95,532845,73.132720285479,6
0.2,7286,89,532934,73.13489776313983,12
0.2,7287,92,533026,73.13748627881449,9
0.2,7288,95,533121,73.1404856633283,7
0.2,7289,95,533216,73.1434842249657,7
0.2,7290,92,533308,73.14607049787409,10
0.2,7291,26,533334,73.13960504662644,7
0.2,7292,94,533428,73.14246537775949,9
0.2,7293,96,533524,73.1455991225665,6
0.2,7294,95,533619,73.14859492803289,7
0.2,7295,96,533715,73.1517269736842,6
0.2,7296,90,533805,73.15403590516651,12
0.2,7297,95,533900,73.15702932310222,6
0.2,7298,92,533992,73.1596109056035,9
0.2,7299,24,534016,73.15287671232876,9
0.2,7300,95,534111,73.15586905903301,7
0.2,7301,92,534203,73.15844973979732,10
0.2,7302,-50,534153,73.14158564973299,14
0.2,7303,22,534175,73.13458378970427,11
0.2,7304,93,534268,73.13730321697467,9
0.2,7305,95,534363,73.14029564741308,7
0.2,7306,18,534381,73.13274941836595,14
0.2,7307,27,534408,73.1264367816092,6
0.2,7308,87,534495,73.12833492953892,14
0.2,7309,95,534590,73.1313269493844,7
0.2,7310,19,534609,73.12392285597045,13
0.2,7311,93,534702,73.12664113785559,9
0.2,7312,91,534793,73.12908519075619,10
0.2,7313,94,534887,73.13193874760732,9
0.2,7314,96,534983,73.13506493506493,6
0.2,7315,96,535079,73.13819026790596,6
0.2,7316,94,535173,73.1410414104141,9
0.2,7317,95,535268,73.14402842306642,7
0.2,7318,21,535289,73.13690394862687,12
0.2,7319,94,535383,73.13975409836065,8
0.2,7320,91,535474,73.1421936893867,11
0.2,7321,23,535497,73.1353455340071,10
0.2,7322,95,535592,73.13833128499249,7
0.2,7323,92,535684,73.1409066084107,9
0.2,7324,94,535778,73.1437542662116,7
0.2,7325,96,535874,73.14687414687414,6
0.2,7326,92,535966,73.14944724989763,11
0.2,7327,93,536059,73.15215611353712,8
0.2,7328,94,536153,73.15500068222131,7
0.2,7329,96,536249,73.1581173260573,6
0.2,7330,95,536344,73.16109671259036,6
0.2,7331,22,536366,73.15411893071467,10
0.2,7332,96,536462,73.15723441974635,6
0.2,7333,89,536551,73.15939460049087,13
0.2,7334,93,536644,73.16209952283572,8
0.2,7335,93,536737,73.16480370774264,8
0.2,7336,93,536830,73.16750715551315,9
0.2,7337,21,536851,73.1603979285909,12
0.2,7338,89,536940,73.16255620656766,12
0.2,7339,94,537034,73.16539509536784,8
0.2,7340,91,537125,73.16782454706443,12
0.2,7341,21,537146,73.16071915009535,14
0.2,7342,92,537238,73.16328476099687,10
0.2,7343,94,537332,73.1661220043573,8
0.2,7344,23,537355,73.15929203539822,10
0.2,7345,94,537449,73.16212904982304,9
0.2,7346,93,537542,73.16482918197904,8
0.2,7347,94,537636,73.16766467065868,8
0.2,7348,91,537727,73.1700911688665,11
0.2,7349,94,537821,73.17292517006803,7
0.2,7350,93,537914,73.17562236430417,10
0.2,7351,93,538007,73.17831882480958,8
0.2,7352,93,538100,73.18101455188358,9
0.2,7353,95,538195,73.18398150666305,7
0.2,7354,94,538289,73.18681169272604,8
0.2,7355,95,538384,73.18977705274605,8
0.2,7356,95,538479,73.19274160663313,7
0.2,7357,94,538573,73.19556944821963,8
0.2,7358,89,538662,73.19771708112515,12
0.2,7359,95,538757,73.20067934782608,6
0.2,7360,16,538773,73.19290857220486,17
0.2,7361,20,538793,73.18568323825048,13
0.2,7362,95,538888,73.18864593236452,6
0.2,7363,93,538981,73.19133623030962,9
0.2,7364,96,539077,73.19443312966735,6
0.2,7365,21,539098,73.18734727124627,14
0.2,7366,93,539191,73.19003664992535,8
0.2,7367,95,539286,73.19299674267101,6
0.2,7368,90,539376,73.19527751390962,12
0.2,7369,95,539471,73.19823609226594,7
0.2,7370,-51,539420,73.18138651471985,15
0.2,7371,22,539442,73.17444384156266,13
0.2,7372,92,539534,73.17699715176997,11
0.2,7373,93,539627,73.17968538106862,9
0.2,7374,23,539650,73.1728813559322,10
0.2,7375,93,539743,73.1755694143167,9
0.2,7376,95,539838,73.17852785685238,6
0.2,7377,96,539934,73.18162103551097,6
0.2,7378,93,540027,73.18430681664182,8
0.2,7379,94,540121,73.18712737127372,8
0.2,7380,26,540147,73.1807343178431,7
0.2,7381,22,540169,73.17380113790301,11
0.2,7382,21,540190,73.16673438981444,15
0.2,7383,92,540282,73.1692849404117,9
0.2,7384,22,540304,73.16235612728504,11
0.2,7385,92,540396,73.16490658001625,12
0.2,7386,94,540490,73.16772708812779,8
0.2,7387,94,540584,73.17054683270167,9
0.2,7388,95,540679,73.17350115035865,6
0.2,7389,95,540774,73.17645466847091,7
0.2,7390,92,540866,73.17900148829658,9
0.2,7391,95,540961,73.18195346320347,6
0.2,7392,95,541056,73.18490463952388,7
0.2,7393,93,541149,73.18758452799567,9
0.2,7394,95,541244,73.19053414469236,7
0.2,7395,95,541339,73.1934829637642,6
0.2,7396,89,541428,73.19561984588347,13
0.2,7397,88,541516,73.19762097864287,13
0.2,7398,94,541610,73.20043249087715,9
0.2,7399,95,541705,73.20337837837837,7
0.2,7400,94,541799,73.20618835292528,9
0.2,7401,94,541893,73.2089975682248,9
0.2,7402,21,541914,73.20194515736864,12
0.2,7403,95,542009,73.20488924905456,7
0.2,7404,24,542033,73.19824442943957,9
0.2,7405,92,542125,73.20078314879827,9
0.2,7406,90,542215,73.20305116781422,11
0.2,7407,94,542309,73.20585853131749,8
0.2,7408,95,542404,73.20880010797678,7
0.2,7409,93,542497,73.2114709851552,9
0.2,7410,94,542591,73.21427607610309,9
0.2,7411,90,542681,73.21654074473827,11
0.2,7412,20,542701,73.20936193174154,13
0.2,7413,95,542796,73.21230105206367,6
0.2,7414,95,542891,73.21523937963588,7
0.2,7415,94,542985,73.21804207119742,9
0.2,7416,22,543007,73.21113657813132,11
0.2,7417,-46,542961,73.19506605554058,11
0.2,7418,95,543056,73.1980051219841,6
0.2,7419,93,543149,73.20067385444744,9
0.2,7420,95,543244,73.2036113731303,7
0.2,7421,93,543337,73.20627863109674,8
0.2,7422,26,543363,73.19991917014684,7
0.2,7423,93,543456,73.20258620689656,8
0.2,7424,96,543552,73.20565656565657,6
0.2,7425,95,543647,73.2085914354969,6
0.2,7426,95,543742,73.2115255150128,7
0.2,7427,95,543837,73.21445880452343,7
0.2,7428,89,543926,73.21658365863507,13
0.2,7429,94,544020,73.21938088829071,7
0.2,7430,94,544114,73.22217736509218,8
0.2,7431,95,544209,73.22510764262648,9
0.2,7432,95,544304,73.22803713170994,7
0.2,7433,91,544395,73.23042776432607,10
0.2,7434,92,544487,73.2329522528581,9
0.2,7435,24,544511,73.22633136094674,10
0.2,7436,95,544606,73.22925910985613,7
0.2,7437,95,544701,73.23218607152461,8
0.2,7438,-121,544580,73.20607608549537,16
0.2,7439,26,544606,73.1997311827957,7
0.2,7440,95,544701,73.20266093267034,6
0.2,7441,96,544797,73.20572426766998,6
0.2,7442,93,544890,73.20838371624345,8
0.2,7443,92,544982,73.21090811391724,10
0.2,7444,95,545077,73.21383478844862,6
0.2,7445,95,545172,73.21676067687349,7
0.2,7446,95,545267,73.21968577950852,7
0.2,7447,89,545356,73.2218045112782,12
0.2,7448,95,545451,73.22472815142972,7
0.2,7449,92,545543,73.22724832214764,10
0.2,7450,92,545635,73.22976781640048,10
0.2,7451,27,545662,73.223564143854,6
0.2,7452,95,545757,73.22648597880048,6
0.2,7453,94,545851,73.2292728736249,9
0.2,7454,95,545946,73.23219315895372,7
0.2,7455,93,546039,73.23484442060087,9
0.2,7456,95,546134,73.23776317553975,8
0.2,7457,94,546228,73.24054706355591,8
0.2,7458,25,546253,73.23407963533985,8
0.2,7459,93,546346,73.23672922252011,9
0.2,7460,94,546440,73.23951212974133,7
0.2,7461,95,546535,73.24242830340391,6
0.2,7462,93,546628,73.24507570682032,8
0.2,7463,94,546722,73.2478563772776,9
0.2,7464,88,546810,73.24983255190891,14
0.2,7465,92,546902,73.25234395928207,11
0.2,7466,95,546997,73.2552564617651,7
0.2,7467,94,547091,73.25803427959293,7
0.2,7468,93,547184,73.26067746686303,10
0.2,7469,93,547277,73.26331994645248,9
0.2,7470,92,547369,73.26582786775532,10
0.2,7471,95,547464,73.26873661670236,7
0.2,7472,23,547487,73.262009902315,12
0.2,7473,94,547581,73.26478458656676,7
0.2,7474,93,547674,73.26742474916388,9
0.2,7475,94,547768,73.27019796682718,8
0.2,7476,95,547863,73.27310418617093,7
0.2,7477,95,547958,73.27600962824285,7
0.2,7478,92,548050,73.27851317020992,10
0.2,7479,16,548066,73.27085561497326,18
0.2,7480,93,548159,73.27349284854967,9
0.2,7481,89,548248,73.27559476075916,13
0.2,7482,95,548343,73.27849792863825,7
0.2,7483,95,548438,73.28140032068413,7
0.2,7484,96,548534,73.28443553774216,6
0.2,7485,93,548627,73.28706919583222,9
0.2,7486,95,548722,73.28996928008549,6
0.2,7487,24,548746,73.28338675213675,9
0.2,7488,90,548836,73.28561890773133,12
0.2,7489,94,548930,73.28838451268358,8
0.2,7490,93,549023,73.29101588572954,10
0.2,7491,95,549118,73.29391350774159,6
0.2,7492,92,549210,73.29640998265047,10
0.2,7493,91,549301,73.29877235121431,10
0.2,7494,93,549394,73.30140093395597,10
0.2,7495,93,549487,73.3040288153682,10
0.2,7496,22,549509,73.29718554088302,11
0.2,7497,95,549604,73.30008002133903,7
0.2,7498,94,549698,73.30284037871716,9
0.2,7499,93,549791,73.30546666666666,9
0.2,7500,93,549884,73.30809225436609,9
0.2,7501,90,549974,73.31031724873367,12
0.2,7502,95,550069,73.31320805011329,6
0.2,7503,26,550095,73.30690298507463,7
0.2,7504,94,550189,73.30966022651566,8
0.2,7505,95,550284,73.31254996003197,7
0.2,7506,94,550378,73.31530571466631,9
0.2,7507,89,550467,73.31739477890251,12
0.2,7508,92,550559,73.31988280729792,10
0.2,7509,95,550654,73.32276964047936,7
0.2,7510,24,550678,73.3162029024098,9
0.2,7511,95,550773,73.31908945686901,7
0.2,7512,27,550800,73.31292426460801,6
0.2,7513,95,550895,73.31581048709076,7
0.2,7514,96,550991,73.31882900864937,6
0.2,7515,25,551016,73.3124002128792,8
0.2,7516,-45,550971,73.29666090195556,9
0.2,7517,95,551066,73.29954775206171,7
0.2,7518,26,551092,73.29325708205879,7
0.2,7519,-48,551044,73.27712765957448,13
0.2,7520,93,551137,73.27975003324026,10
0.2,7521,95,551232,73.28263759638394,7
0.2,7522,-47,551185,73.26664894324072,12
0.2,7523,91,551276,73.26900584795321,11
0.2,7524,95,551371,73.27189368770765,7
0.2,7525,95,551466,73.27478076003189,7
0.2,7526,90,551556,73.27700278995616,12
0.2,7527,94,551650,73.2797555791711,9
0.2,7528,92,551742,73.28224199760925,10
0.2,7529,95,551837,73.28512616201859,7
0.2,7530,21,551858,73.27818350816625,11
0.2,7531,91,551949,73.28053637812002,10
0.2,7532,95,552044,73.28341962033718,6
0.2,7533,95,552139,73.28630209715955,7
0.2,7534,26,552165,73.28002654280027,8
0.2,7535,93,552258,73.28264331210191,10
0.2,7536,88,552346,73.28459599310071,15
0.2,7537,95,552441,73.28747678429292,6
0.2,7538,95,552536,73.29035681124817,7
0.2,7539,93,552629,73.29297082228116,8
0.2,7540,95,552724,73.29584935684922,7
0.2,7541,93,552817,73.2984619464333,10
0.2,7542,96,552913,73.30147156303858,6
0.2,7543,94,553007,73.30421527041358,8
0.2,7544,92,553099,73.3066931742876,9
0.2,7545,93,553192,73.309302941956,9
0.2,7546,93,553285,73.31191201802041,9
0.2,7547,96,553381,73.3149178590355,6
0.2,7548,95,553476,73.31779043581932,6
0.2,7549,-195,553281,73.28225165562914,21
0.2,7550,89,553370,73.28433320090055,14
0.2,7551,95,553465,73.28720868644068,6
0.2,7552,95,553560,73.29008341056534,7
0.2,7553,95,553655,73.29295737357691,6
0.2,7554,93,553748,73.29556585043018,8
0.2,7555,95,553843,73.29843832715723,6
0.2,7556,93,553936,73.30104538838164,9
0.2,7557,-56,553880,73.2839375496163,20
0.2,7558,90,553970,73.28614896150285,13
0.2,7559,94,554064,73.28888888888889,8
0.2,7560,92,554156,73.29136357624652,9
0.2,7561,95,554251,73.29423432954245,7
0.2,7562,93,554344,73.29683987835514,11
0.2,7563,25,554369,73.2904547858276,8
0.2,7564,26,554395,73.28420356906808,7
0.2,7565,96,554491,73.28720592122654,6
0.2,7566,89,554580,73.2892824104665,13
0.2,7567,94,554674,73.29201902748414,9
0.2,7568,95,554769,73.294887039239,6
0.2,7569,92,554861,73.29735799207397,9
0.2,7570,93,554954,73.29996037511557,8
0.2,7571,94,555048,73.3026941362916,7
0.2,7572,96,555144,73.30569127162288,6
0.2,7573,91,555235,73.30802746237127,10
0.2,7574,94,555329,73.3107590759076,7
0.2,7575,22,555351,73.30398627243929,11
0.2,7576,95,555446,73.30684967665303,7
0.2,7577,21,555467,73.29994721562417,12
0.2,7578,95,555562,73.30281039715003,7
0.2,7579,94,555656,73.30554089709763,8
0.2,7580,25,555681,73.29916897506925,8
0.2,7581,23,555704,73.29253495120021,10
0.2,7582,92,555796,73.29500197810893,10
0.2,7583,96,555892,73.29799578059071,6
0.2,7584,94,555986,73.30072511535926,8
0.2,7585,94,556080,73.30345373055628,8
0.2,7586,91,556171,73.30578621325952,10
0.2,7587,93,556264,73.30838165524513,9
0.2,7588,93,556357,73.31097641322967,9
0.2,7589,24,556381,73.30447957839262,10
0.2,7590,22,556403,73.29772098537742,11
0.2,7591,96,556499,73.30071127502634,6
0.2,7592,89,556588,73.30277887527987,12
0.2,7593,94,556682,73.30550434553595,9
0.2,7594,95,556777,73.3083607636603,9
0.2,7595,92,556869,73.3108214849921,12
0.2,7596,24,556893,73.30433065683823,8
0.2,7597,27,556920,73.29823637799421,6
0.2,7598,19,556939,73.2910909330175,14
0.2,7599,94,557033,73.29381578947368,8
0.2,7600,96,557129,73.29680305222998,6
0.2,7601,91,557220,73.2991318074191,12
0.2,7602,95,557315,73.30198605813494,6
0.2,7603,89,557404,73.30405049973697,12
0.2,7604,90,557494,73.30624589086128,11
0.2,7605,96,557590,73.309229555614,6
0.2,7606,94,557684,73.31194952017879,8
0.2,7607,90,557774,73.31414300736067,14
0.2,7608,91,557865,73.31646734130635,11
0.2,7609,91,557956,73.31879106438896,10
0.2,7610,-126,557830,73.29260281171987,21
0.2,7611,89,557919,73.29466631634261,13
0.2,7612,95,558014,73.29751740443977,6
0.2,7613,94,558108,73.30023640661939,9
0.2,7614,95,558203,73.30308601444517,6
0.2,7615,95,558298,73.30593487394958,6
0.2,7616,92,558390,73.30838912957857,9
0.2,7617,90,558480,73.31058020477816,13
0.2,7618,96,558576,73.31355820973882,7
0.2,7619,91,558667,73.31587926509187,11
0.2,7620,96,558763,73.31885579320299,6
0.2,7621,95,558858,73.32170034111782,7
0.2,7622,96,558954,73.32467532467533,6
0.2,7623,90,559044,73.32686253934942,11
0.2,7624,95,559139,73.32970491803279,8
0.2,7625,93,559232,73.33228429058484,9
0.2,7626,81,559313,73.33328962894979,21
0.2,7627,92,559405,73.3357367593078,9
0.2,7628,26,559431,73.32953204876131,8
0.2,7629,95,559526,73.33237221494102,7
0.2,7630,95,559621,73.33521163674486,7
0.2,7631,24,559645,73.32874737945492,9
0.2,7632,95,559740,73.33158653216297,6
0.2,7633,95,559835,73.33442494105319,6
0.2,7634,95,559930,73.33726260641781,7
0.2,7635,26,559956,73.33106338397066,7
0.2,7636,93,560049,73.33363886342805,9
0.2,7637,94,560143,73.33634459282534,7
0.2,7638,26,560169,73.33014792512108,7
0.2,7639,95,560264,73.33298429319372,7
0.2,7640,92,560356,73.33542730009161,11
0.2,7641,95,560451,73.33826223501701,7
0.2,7642,93,560544,73.34083475075232,9
0.2,7643,21,560565,73.3339874411303,11
0.2,7644,96,560661,73.33695225637672,6
0.2,7645,24,560685,73.33049960763798,8
0.2,7646,93,560778,73.33307179285994,8
0.2,7647,94,560872,73.3357740585774,8
0.2,7648,92,560964,73.33821414563995,11
0.2,7649,24,560988,73.33176470588235,9
0.2,7650,92,561080,73.33420467912691,12
0.2,7651,96,561176,73.33716675378986,6
0.2,7652,95,561271,73.33999738664576,6
0.2,7653,22,561293,73.33328978311994,11
0.2,7654,94,561387,73.33598954931418,8
0.2,7655,94,561481,73.33868861024034,8
0.2,7656,20,561501,73.33172260676506,13
0.2,7657,26,561527,73.32554191694959,7
0.2,7658,92,561619,73.3279801540671,10
0.2,7659,95,561714,73.3308093994778,6
0.2,7660,91,561805,73.33311578122961,10
0.2,7661,-45,561760,73.31767162620726,9
0.2,7662,26,561786,73.31149680281874,7
0.2,7663,96,561882,73.31445720250522,6
0.2,7664,-48,561834,73.2986301369863,12
0.2,7665,93,561927,73.3012001043569,9
0.2,7666,96,562023,73.3041606886657,7
0.2,7667,93,562116,73.30672926447575,8
0.2,7668,24,562140,73.30029990872343,9
0.2,7669,23,562163,73.29374185136896,10
0.2,7670,-50,562113,73.27766914352758,15
0.2,7671,95,562208,73.28050052137644,7
0.2,7672,24,562232,73.27407793561841,8
0.2,7673,-49,562183,73.25814438363305,13
0.2,7674,25,562208,73.25185667752443,8
0.2,7675,26,562234,73.24570088587807,8
0.2,7676,95,562329,73.24853458382181,7
0.2,7677,21,562350,73.24172961708778,12
0.2,7678,93,562443,73.24430264357338,9
0.2,7679,27,562470,73.23828125,6
0.2,7680,96,562566,73.24124462960552,6
0.2,7681,93,562659,73.2438167143973,9
0.2,7682,27,562686,73.23779773525966,6
0.2,7683,90,562776,73.23997917751171,11
0.2,7684,21,562797,73.23318152244633,12
0.2,7685,95,562892,73.2360135310955,7
0.2,7686,96,562988,73.23897489267594,6
0.2,7687,23,563011,73.23244016649323,11
0.2,7688,94,563105,73.23514111067759,7
0.2,7689,89,563194,73.2371911573472,12
0.2,7690,92,563286,73.23963073722533,9
0.2,7691,94,563380,73.24232969318773,8
0.2,7692,89,563469,73.24437800597946,14
0.2,7693,94,563563,73.24707564335846,8
0.2,7694,25,563588,73.2408057179987,9
0.2,7695,93,563681,73.24337318087318,8
0.2,7696,95,563776,73.24619981811095,7
0.2,7697,94,563870,73.24889581709535,9
0.2,7698,21,563891,73.24210936485258,14
0.2,7699,26,563917,73.23597402597403,7
0.2,7700,96,564013,73.23893000908973,6
0.2,7701,95,564108,73.24175538821085,6
0.2,7702,90,564198,73.24393093599896,12
0.2,7703,96,564294,73.24688473520249,6
0.2,7704,92,564386,73.24931862426996,10
0.2,7705,93,564479,73.25188165066182,9
0.2,7706,92,564571,73.25431425976385,9
0.2,7707,95,564666,73.25713544369486,6
0.2,7708,24,564690,73.25074588143728,9
0.2,7709,93,564783,73.2533073929961,10
0.2,7710,95,564878,73.25612760990792,7
0.2,7711,94,564972,73.25881742738589,8
0.2,7712,94,565066,73.26150654738753,7
0.2,7713,88,565154,73.26341716359865,13
0.2,7714,92,565246,73.26584575502268,10
0.2,7715,91,565337,73.26814411612234,10
0.2,7716,-120,565217,73.2430996501231,15
0.2,7717,17,565234,73.23581238662867,16
0.2,7718,91,565325,73.23811374530379,11
0.2,7719,94,565419,73.2408031088083,8
0.2,7720,94,565513,73.24349177567673,8
0.2,7721,94,565607,73.24617974617975,9
0.2,7722,94,565701,73.24886702058785,8
0.2,7723,96,565797,73.25181253236664,6
0.2,7724,21,565818,73.24504854368932,11
0.2,7725,26,565844,73.23893347139528,8
0.2,7726,95,565939,73.24174970881326,7
0.2,7727,93,566032,73.24430641821947,9
0.2,7728,24,566056,73.23793504981239,10
0.2,7729,95,566151,73.24075032341527,7
0.2,7730,93,566244,73.24330616996508,9
0.2,7731,23,566267,73.23680807035696,11
0.2,7732,92,566359,73.23923444976077,11
0.2,7733,93,566452,73.2417895009051,8
0.2,7734,94,566546,73.24447317388494,8
0.2,7735,20,566566,73.2375904860393,13
0.2,7736,95,566661,73.24040325707638,7
0.2,7737,95,566756,73.2432153011114,8
0.2,7738,95,566851,73.24602661842616,7
0.2,7739,94,566945,73.24870801033592,7
0.2,7740,-49,566896,73.23291564397364,13
0.2,7741,90,566986,73.23508137432188,12
0.2,7742,89,567075,73.237117396358,12
0.2,7743,94,567169,73.23979855371901,7
0.2,7744,93,567262,73.24234990316333,8
0.2,7745,92,567354,73.24477149496515,11
0.2,7746,95,567449,73.24757970827417,6
0.2,7747,94,567543,73.25025813113061,8
0.2,7748,26,567569,73.24416053684347,7
0.2,7749,94,567663,73.24683870967742,7
0.2,7750,91,567754,73.2491291446265,10
0.2,7751,94,567848,73.25180598555211,9
0.2,7752,24,567872,73.24545337288791,8
0.2,7753,95,567967,73.24825896311582,11
0.2,7754,93,568060,73.250805931657,9
0.2,7755,-51,568009,73.23478597215059,15
0.2,7756,90,568099,73.23694727343045,13
0.2,7757,95,568194,73.23975251353441,7
0.2,7758,94,568288,73.24242814795721,8
0.2,7759,95,568383,73.24523195876289,8
0.2,7760,93,568476,73.24777734827985,9
0.2,7761,94,568570,73.2504509147127,7
0.2,7762,24,568594,73.24410665979647,9
0.2,7763,92,568686,73.24652241112828,10
0.2,7764,92,568778,73.24893754024468,10
0.2,7765,92,568870,73.25135204738604,10
0.2,7766,94,568964,73.2540234324707,7
0.2,7767,87,569051,73.2557929969104,14
0.2,7768,93,569144,73.25833440597245,8
0.2,7769,-44,569100,73.24324324324324,8
0.2,7770,91,569191,73.24552824604298,10
0.2,7771,94,569285,73.2481986618631,8
0.2,7772,92,569377,73.25061108966936,9
0.2,7773,95,569472,73.2534087985593,8
0.2,7774,-46,569426,73.23807073954984,10
0.2,7775,-48,569378,73.22247942386831,12
0.2,7776,23,569401,73.21602160216021,10
0.2,7777,94,569495,73.21869375160709,8
0.2,7778,27,569522,73.21275228178429,6
0.2,7779,89,569611,73.21478149100257,12
0.2,7780,26,569637,73.20871353296492,7
0.2,7781,94,569731,73.21138524800823,8
0.2,7782,25,569756,73.20519080046255,8
0.2,7783,90,569846,73.2073484069887,11
0.2,7784,94,569940,73.21001926782273,8
0.2,7785,92,570032,73.21243257128178,9
0.2,7786,94,570126,73.2151020932323,9
0.2,7787,91,570217,73.217385721623,10
0.2,7788,26,570243,73.21132366157401,7
0.2,7789,96,570339,73.21424903722722,6
0.2,7790,92,570431,73.21666024900526,9
0.2,7791,23,570454,73.21021560574948,11
0.2,7792,94,570548,73.21288335685873,7
0.2,7793,93,570641,73.21542211957916,9
0.2,7794,19,570660,73.20846696600385,17
0.2,7795,92,570752,73.2108773730118,9
0.2,7796,87,570839,73.21264588944466,14
0.2,7797,95,570934,73.21543985637344,7
0.2,7798,19,570953,73.20848826772664,13
0.2,7799,93,571046,73.21102564102564,9
0.2,7800,94,571140,73.21369055249328,7
0.2,7801,93,571233,73.21622660856191,8
0.2,7802,95,571328,73.21901832628477,7
0.2,7803,95,571423,73.22180932854947,7
0.2,7804,95,571518,73.224599615631,6
0.2,7805,-52,571466,73.20855751985653,15
0.2,7806,23,571489,73.20212629691302,10
0.2,7807,20,571509,73.1953125,13
0.2,7808,94,571603,73.19797669355872,9
0.2,7809,21,571624,73.19129321382843,12
0.2,7810,96,571720,73.19421328895147,7
0.2,7811,92,571812,73.19662058371736,12
0.2,7812,92,571904,73.19902726225521,10
0.2,7813,95,571999,73.20181725108779,7
0.2,7814,86,572085,73.20345489443378,16
0.2,7815,22,572107,73.19690378710338,11
0.2,7816,95,572202,73.19969297684534,7
0.2,7817,27,572229,73.19378357636224,6
0.2,7818,24,572253,73.18749200665047,9
0.2,7819,95,572348,73.19028132992328,8
0.2,7820,94,572442,73.19294207901802,7
0.2,7821,95,572537,73.19572999232933,7
0.2,7822,95,572632,73.19851719289275,7
0.2,7823,94,572726,73.20117586912066,8
0.2,7824,93,572819,73.20370607028754,8
0.2,7825,95,572914,73.20649118323537,6
0.2,7826,95,573009,73.20927558451514,6
0.2,7827,93,573102,73.2118037812979,8
0.2,7828,95,573197,73.21458679269384,7
0.2,7829,24,573221,73.20830140485313,9
0.2,7830,95,573316,73.21108415272634,7
0.2,7831,96,573412,73.21399387129725,6
0.2,7832,90,573502,73.21613685688753,11
0.2,7833,90,573592,73.21827929537912,11
0.2,7834,95,573687,73.22105934907466,6
0.2,7835,96,573783,73.2239663093415,6
0.2,7836,94,573877,73.2266173280592,7
0.2,7837,95,573972,73.2293952538913,7
0.2,7838,93,574065,73.23191733639494,8
0.2,7839,94,574159,73.23456632653061,8
0.2,7840,92,574251,73.23695957148323,9
0.2,7841,93,574344,73.23947972456006,9
0.2,7842,93,574437,73.24199923498661,11
0.2,7843,95,574532,73.24477307496176,7
0.2,7844,93,574625,73.24729126832378,10
0.2,7845,94,574719,73.24993627326026,7
0.2,7846,95,574814,73.25270804128967,6
0.2,7847,95,574909,73.25547910295617,7
0.2,7848,95,575004,73.25824945852975,6
0.2,7849,-49,574955,73.24267515923567,13
0.2,7850,93,575048,73.24519169532543,9
0.2,7851,23,575071,73.23879266428935,9
0.2,7852,94,575165,73.24143639373487,8
0.2,7853,94,575259,73.2440794499618,8
0.2,7854,91,575350,73.24633991088479,12
0.2,7855,95,575445,73.24910896130346,7
0.2,7856,93,575538,73.2516227567774,9
0.2,7857,-45,575493,73.23657419190634,8
0.2,7858,95,575588,73.23934342791704,6
0.2,7859,92,575680,73.24173027989822,9
0.2,7860,95,575775,73.24449815545096,7
0.2,7861,93,575868,73.24701093869244,9
0.2,7862,93,575961,73.24952308279283,9
0.2,7863,94,576055,73.25216174974568,8
0.2,7864,23,576078,73.24577240940877,11
0.2,7865,94,576172,73.24841088227816,7
0.2,7866,89,576261,73.25041311808822,12
0.2,7867,24,576285,73.24415353329944,9
0.2,7868,95,576380,73.24691828694878,6
0.2,7869,92,576472,73.24930114358322,10
0.2,7870,95,576567,73.25206454071909,8
0.2,7871,96,576663,73.25495426829268,6
0.2,7872,94,576757,73.25758922901055,7
0.2,7873,93,576850,73.26009652019304,9
0.2,7874,95,576945,73.26285714285714,7
0.2,7875,21,576966,73.25622143219908,13
0.2,7876,95,577061,73.25898184588041,8
0.2,7877,93,577154,73.26148768723026,9
0.2,7878,91,577245,73.26373905317934,11
0.2,7879,94,577339,73.26637055837564,7
0.2,7880,93,577432,73.26887450831113,8
0.2,7881,95,577527,73.27163156559249,9
0.2,7882,26,577553,73.26563491056704,7
0.2,7883,93,577646,73.26813800101472,11
0.2,7884,95,577741,73.2708941027267,7
0.2,7885,25,577766,73.26477301547045,9
0.2,7886,91,577857,73.26702168124763,11
0.2,7887,95,577952,73.26977687626776,7
0.2,7888,95,578047,73.27253137279757,7
0.2,7889,95,578142,73.27528517110267,8
0.2,7890,94,578236,73.27791154479787,9
0.2,7891,93,578329,73.28041054232133,8
0.2,7892,94,578423,73.2830356011656,7
0.2,7893,91,578514,73.28527995946288,10
0.2,7894,95,578609,73.2880303989867,6
0.2,7895,92,578701,73.29040020263425,10
0.2,7896,89,578790,73.2923895150057,13
0.2,7897,91,578881,73.29463155229172,10
0.2,7898,94,578975,73.29725281681226,8
0.2,7899,-58,578917,73.2806329113924,22
0.2,7900,-46,578871,73.26553600810024,13
0.2,7901,91,578962,73.26778030878259,10
0.2,7902,93,579055,73.27027710995824,10
0.2,7903,94,579149,73.27289979757084,8
0.2,7904,-44,579105,73.25806451612904,8
0.2,7905,91,579196,73.26030862635973,10
0.2,7906,92,579288,73.26267863918048,11
0.2,7907,92,579380,73.26504805260495,10
0.2,7908,87,579467,73.26678467568593,14
0.2,7909,90,579557,73.26890012642225,11
0.2,7910,96,579653,73.27177347996461,6
0.2,7911,93,579746,73.2742669362993,8
0.2,7912,89,579835,73.27625426513333,12
0.2,7913,92,579927,73.27862016679302,11
0.2,7914,21,579948,73.27201516108654,14
0.2,7915,89,580037,73.27400202122284,12
0.2,7916,95,580132,73.27674624226348,6
0.2,7917,96,580228,73.27961606466279,6
0.2,7918,92,580320,73.28198004798585,11
0.2,7919,95,580415,73.28472222222223,7
0.2,7920,25,580440,73.27862643605606,7
0.2,7921,92,580532,73.28098964907852,10
0.2,7922,90,580622,73.28309983592074,12
0.2,7923,21,580643,73.27650176678445,11
0.2,7924,95,580738,73.2792429022082,6
0.2,7925,95,580833,73.28198334595004,7
0.2,7926,23,580856,73.27564021697994,10
0.2,7927,94,580950,73.27825428859738,7
0.2,7928,94,581044,73.280867700845,9
0.2,7929,22,581066,73.27440100882724,11
0.2,7930,91,581157,73.27663598537384,10
0.2,7931,90,581247,73.27874432677761,12
0.2,7932,27,581274,73.27291062649691,6
0.2,7933,95,581369,73.27564910511721,6
0.2,7934,95,581464,73.27838689350976,7
0.2,7935,95,581559,73.28112399193549,6
0.2,7936,26,581585,73.27516693964974,7
0.2,7937,-49,581536,73.25976316452507,14
0.2,7938,25,581561,73.25368434311626,8
0.2,7939,92,581653,73.25604534005038,10
0.2,7940,95,581748,73.25878352852286,6
0.2,7941,96,581844,73.2616469403173,6
0.2,7942,93,581937,73.26413194007301,9
0.2,7943,92,582029,73.26649043303122,9
0.2,7944,94,582123,73.26910006293267,7
0.2,7945,18,582141,73.26214447520765,14
0.2,7946,94,582235,73.26475399521833,8
0.2,7947,94,582329,73.26736285858078,8
0.2,7948,24,582353,73.26116492640584,8
0.2,7949,93,582446,73.26364779874214,11
0.2,7950,24,582470,73.25745189284366,9
0.2,7951,87,582557,73.25918008048289,16
0.2,7952,94,582651,73.2617880045266,8
0.2,7953,17,582668,73.25471460900177,16
0.2,7954,95,582763,73.25744814582023,6
0.2,7955,95,582858,73.26018099547511,7
0.2,7956,94,582952,73.26278748271962,8
0.2,7957,95,583047,73.26551897461674,6
0.2,7958,93,583140,73.2679984922729,8
0.2,7959,89,583229,73.26997487437185,14
0.2,7960,84,583313,73.2713226981535,18
0.2,7961,92,583405,73.27367495604119,9
0.2,7962,94,583499,73.27627778475448,7
0.2,7963,96,583595,73.27913108990457,6
0.2,7964,95,583690,73.28185812931575,6
0.2,7965,95,583785,73.28458448405725,7
0.2,7966,24,583809,73.27839839337267,9
0.2,7967,91,583900,73.28062248995984,10
0.2,7968,94,583994,73.28322248713766,10
0.2,7969,87,584081,73.28494353826851,15
0.2,7970,94,584175,73.28754234098608,8
0.2,7971,26,584201,73.2816106372303,6
0.2,7972,20,584221,73.2749278816004,14
0.2,7973,95,584316,73.27765237020316,7
0.2,7974,93,584409,73.28012539184952,9
0.2,7975,-52,584357,73.2644182547643,17
0.2,7976,27,584384,73.25861852826877,6
0.2,7977,24,584408,73.25244422160942,8
0.2,7978,92,584500,73.25479383381376,10
0.2,7979,95,584595,73.25751879699249,6
0.2,7980,93,584688,73.2599924821451,10
0.2,7981,92,584780,73.2623402655976,11
0.2,7982,95,584875,73.26506325942628,6
0.2,7983,95,584970,73.26778557114228,7
0.2,7984,95,585065,73.27050720100188,7
0.2,7985,94,585159,73.27310293012772,7
0.2,7986,95,585254,73.27582321272067,7
0.2,7987,95,585349,73.27854281422134,7
0.2,7988,95,585444,73.28126173488546,6
0.2,7989,23,585467,73.27496871088861,10
0.2,7990,94,585561,73.27756225753973,7
0.2,7991,93,585654,73.28003003003003,9
0.2,7992,92,585746,73.28237207556612,9
0.2,7993,92,585838,73.28471353515137,9
0.2,7994,93,585931,73.28717948717949,8
0.2,7995,94,586025,73.28976988494247,7
0.2,7996,95,586120,73.29248468175565,7
0.2,7997,20,586140,73.28582145536384,13
0.2,7998,92,586232,73.28816102012752,10
0.2,7999,93,586325,73.290625,8
0.2,8000,95,586420,73.29333833270842,7
0.2,8001,-50,586370,73.27793051737066,14
0.2,8002,21,586391,73.27139822566538,11
0.2,8003,89,586480,73.27336331834083,12
0.2,8004,91,586571,73.27557776389756,12
0.2,8005,21,586592,73.26904821383962,11
0.2,8006,93,586685,73.2715124266267,8
0.2,8007,17,586702,73.26448551448551,16
0.2,8008,92,586794,73.26682482207517,10
0.2,8009,21,586815,73.26029962546816,12
0.2,8010,94,586909,73.26288852827362,7
0.2,8011,95,587004,73.26560159760359,6
0.2,8012,92,587096,73.267939598153,10
0.2,8013,95,587191,73.27065136011979,7
0.2,8014,95,587286,73.27336244541485,6
0.2,8015,24,587310,73.26721556886227,9
0.2,8016,95,587405,73.26992640638643,7
0.2,8017,95,587500,73.27263656772263,6
0.2,8018,94,587594,73.27522134929542,7
0.2,8019,22,587616,73.26882793017457,10
0.2,8020,-128,587488,73.24373519511283,23
0.2,8021,95,587583,73.24644727000748,7
0.2,8022,94,587677,73.24903402717189,8
0.2,8023,26,587703,73.24314556331007,6
0.2,8024,94,587797,73.24573208722741,8
0.2,8025,93,587890,73.24819337154248,9
0.2,8026,94,587984,73.25077862215025,8
0.2,8027,25,588009,73.24476831091181,8
0.2,8028,95,588104,73.24747789263918,7
0.2,8029,96,588200,73.25031133250312,8
0.2,8030,26,588226,73.24442784211182,7
0.2,8031,93,588319,73.2468874501992,9
0.2,8032,94,588413,73.24947093240384,8
0.2,8033,89,588502,73.25143141647996,13
0.2,8034,94,588596,73.2540136901058,8
0.2,8035,95,588691,73.25671976107516,6
0.2,8036,94,588785,73.25930073410477,8
0.2,8037,90,588875,73.26138342871361,12
0.2,8038,92,588967,73.26371439233735,10
0.2,8039,18,588985,73.2568407960199,14
0.2,8040,96,589081,73.2596691953737,6
0.2,8041,94,589175,73.26224819696593,7
0.2,8042,95,589270,73.26495088897178,8
0.2,8043,93,589363,73.26740427647937,9
0.2,8044,94,589457,73.26998135487881,7
0.2,8045,95,589552,73.2726820780512,6
0.2,8046,24,589576,73.26655896607431,9
0.2,8047,24,589600,73.26043737574552,8
0.2,8048,90,589690,73.26251708286743,13
0.2,8049,18,589708,73.25565217391305,15
0.2,8050,23,589731,73.24941001117874,9
0.2,8051,90,589821,73.25149031296573,13
0.2,8052,95,589916,73.2541909847262,6
0.2,8053,91,590007,73.25639433821704,10
0.2,8054,91,590098,73.25859714463067,11
0.2,8055,16,590114,73.25148957298907,16
0.2,8056,89,590203,73.25344421000372,13
0.2,8057,91,590294,73.25564656242244,11
0.2,8058,91,590385,73.2578483682839,11
0.2,8059,93,590478,73.26029776674937,9
0.2,8060,95,590573,73.26299466567423,7
0.2,8061,96,590669,73.2658149342595,6
0.2,8062,93,590762,73.26826243333747,8
0.2,8063,21,590783,73.26178075396825,12
0.2,8064,95,590878,73.26447613143212,6
0.2,8065,93,590971,73.26692288618894,9
0.2,8066,93,591064,73.26936903433743,8
0.2,8067,22,591086,73.26301437778879,11
0.2,8068,93,591179,73.26546040401537,9
0.2,8069,95,591274,73.26815365551425,7
0.2,8070,24,591298,73.26204931235287,9
0.2,8071,17,591315,73.2550792864222,16
0.2,8072,93,591408,73.25752508361204,9
0.2,8073,24,591432,73.2514243249938,9
0.2,8074,23,591455,73.2452012383901,10
0.2,8075,93,591548,73.24764735017335,8
0.2,8076,90,591638,73.24972143122446,12
0.2,8077,-47,591591,73.23483535528597,11
0.2,8078,22,591613,73.22849362544869,11
0.2,8079,92,591705,73.23081683168317,10
0.2,8080,93,591798,73.23326320999877,9
0.2,8081,95,591893,73.23595644642415,6
0.2,8082,94,591987,73.23852530001237,7
0.2,8083,96,592083,73.24134092033647,7
0.2,8084,19,592102,73.23463203463203,14
0.2,8085,95,592197,73.23732376947811,6
0.2,8086,94,592291,73.23989118338073,7
0.2,8087,96,592387,73.24270524233432,7
0.2,8088,92,592479,73.24502410681173,10
0.2,8089,93,592572,73.24746600741656,9
0.2,8090,90,592662,73.24953652206155,11
0.2,8091,93,592755,73.25197726149283,9
0.2,8092,96,592851,73.25478808847151,6
0.2,8093,96,592947,73.25759822090437,6
0.2,8094,95,593042,73.26028412600371,7
0.2,8095,95,593137,73.26296936758894,7
0.2,8096,93,593230,73.26540694084228,9
0.2,8097,94,593324,73.26796739935787,8
0.2,8098,24,593348,73.2618841832325,9
0.2,8099,93,593441,73.26432098765432,8
0.2,8100,93,593534,73.26675719047032,8
0.2,8101,93,593627,73.26919279190324,9
0.2,8102,95,593722,73.27187461434036,7
0.2,8103,93,593815,73.27430898321816,10
0.2,8104,94,593909,73.27686613201728,8
0.2,8105,95,594004,73.27954601529731,6
0.2,8106,-45,593959,73.26495621068213,10
0.2,8107,92,594051,73.26726689689195,10
0.2,8108,22,594073,73.2609446294241,12
0.2,8109,94,594167,73.26350184956843,8
0.2,8110,-50,594117,73.24830477129824,14
0.2,8111,95,594212,73.25098619329388,6
0.2,8112,-49,594163,73.23591766300999,12
0.2,8113,90,594253,73.23798373182154,11
0.2,8114,27,594280,73.23228589032655,6
0.2,8115,92,594372,73.23459832429768,10
0.2,8116,95,594467,73.23727978317112,6
0.2,8117,23,594490,73.23109140182311,10
0.2,8118,93,594583,73.23352629634192,10
0.2,8119,93,594676,73.23596059113301,11
0.2,8120,24,594700,73.22989779583796,9
0.2,8121,93,594793,73.23233193794631,10
0.2,8122,94,594887,73.23488858796011,7
0.2,8123,24,594911,73.22882816346628,9
0.2,8124,93,595004,73.23126153846154,10
0.2,8125,94,595098,73.23381737632292,8
0.2,8126,93,595191,73.23624953857512,10
0.2,8127,93,595284,73.23868110236221,9
0.2,8128,95,595379,73.24135810062738,6
0.2,8129,93,595472,73.24378843788438,8
0.2,8130,92,595564,73.24609519124338,11
0.2,8131,19,595583,73.23942449581898,17
0.2,8132,94,595677,73.24197713021026,7
0.2,8133,91,595768,73.2441603147283,11
0.2,8134,95,595863,73.24683466502766,6
0.2,8135,91,595954,73.24901671583088,12
0.2,8136,93,596047,73.25144402113801,9
0.2,8137,87,596134,73.25313344802163,14
0.2,8138,93,596227,73.25555965106278,9
0.2,8139,93,596320,73.25798525798525,11
0.2,8140,21,596341,73.25156614666503,11
0.2,8141,92,596433,73.25386882829771,10
0.2,8142,93,596526,73.25629374923247,9
0.2,8143,93,596619,73.25871807465619,8
0.2,8144,95,596714,73.26138735420503,7
0.2,8145,94,596808,73.26393321875767,8
0.2,8146,21,596829,73.25751810482386,12
0.2,8147,91,596920,73.25969563082965,10
0.2,8148,92,597012,73.26199533685114,10
0.2,8149,95,597107,73.26466257668712,8
0.2,8150,88,597195,73.26647037173353,14
0.2,8151,95,597290,73.26913640824337,7
0.2,8152,95,597385,73.27180179075187,6
0.2,8153,96,597481,73.27458915869512,6
0.2,8154,94,597575,73.27713059472715,8
0.2,8155,94,597669,73.27967140755273,8
0.2,8156,95,597764,73.28233419149197,6
0.2,8157,15,597779,73.27518999754842,18
0.2,8158,92,597871,73.27748498590513,10
0.2,8159,95,597966,73.28014705882353,10
0.2,8160,90,598056,73.2821958093371,13
0.2,8161,-129,597927,73.25741239892183,24
0.2,8162,95,598022,73.26007595246845,7
0.2,8163,93,598115,73.2624938755512,9
0.2,8164,93,598208,73.26491120636865,8
0.2,8165,92,598300,73.26720548616214,10
0.2,8166,88,598388,73.2690094281866,13
0.2,8167,24,598412,73.26297747306562,10
0.2,8168,95,598507,73.26563838903171,7
0.2,8169,95,598602,73.26829865361077,8
0.2,8170,95,598697,73.27095826704198,7
0.2,8171,93,598790,73.27337249143416,9
0.2,8172,95,598885,73.27603083323137,8
0.2,8173,93,598978,73.27844384634206,8
0.2,8174,91,599069,73.28061162079511,11
0.2,8175,92,599161,73.2829011741683,10
0.2,8176,92,599253,73.2851901675431,9
0.2,8177,92,599345,73.28747860112497,9
0.2,8178,95,599440,73.29013326812569,6
0.2,8179,84,599524,73.29144254278728,17
0.2,8180,94,599618,73.29397384182863,7
0.2,8181,95,599713,73.29662674162796,7
0.2,8182,91,599804,73.29879017475254,10
0.2,8183,91,599895,73.30095307917888,11
0.2,8184,95,599990,73.30360415394013,6
0.2,8185,94,600084,73.30613242120694,8
0.2,8186,83,600167,73.30731647734213,18
0.2,8187,24,600191,73.30129457743038,9
0.2,8188,95,600286,73.30394431554524,7
0.2,8189,89,600375,73.3058608058608,13
0.2,8190,95,600470,73.30850933951898,6
0.2,8191,92,600562,73.310791015625,14
0.2,8192,92,600654,73.31307213474918,10
0.2,8193,26,600680,73.30729802294361,7
0.2,8194,93,600773,73.30970103721782,8
0.2,8195,91,600864,73.31185944363104,10
0.2,8196,95,600959,73.31450530681957,6
0.2,8197,88,601047,73.3162966577214,13
0.2,8198,94,601141,73.31881936821564,7
0.2,8199,22,601163,73.31256097560976,11
0.2,8200,95,601258,73.31520546274845,7
0.2,8201,92,601350,73.31748354059985,9
0.2,8202,95,601445,73.32012678288432,7
0.2,8203,-53,601392,73.30472940029254,16
0.2,8204,92,601484,73.30700792199877,9
0.2,8205,96,601580,73.30977333658299,7
0.2,8206,90,601670,73.31180699402948,11
0.2,8207,94,601764,73.31432748538012,7
0.2,8208,95,601859,73.3169691801681,7
0.2,8209,26,601885,73.31120584652862,7
0.2,8210,91,601976,73.31336012665936,10
0.2,8211,92,602068,73.31563565513882,11
0.2,8212,-49,602019,73.30074272494825,13
0.2,8213,89,602108,73.30265400535671,12
0.2,8214,89,602197,73.3045648204504,13
0.2,8215,-52,602145,73.2893135345667,17
0.2,8216,94,602239,73.29183400267738,9
0.2,8217,94,602333,73.29435385738623,8
0.2,8218,94,602427,73.29687309891715,8
0.2,8219,86,602513,73.29841849148418,16
0.2,8220,95,602608,73.30105826541784,8
0.2,8221,23,602631,73.2949404037947,11
0.2,8222,92,602723,73.29721512829867,11
0.2,8223,95,602818,73.29985408560312,6
0.2,8224,92,602910,73.30212765957447,10
0.2,8225,92,603002,73.3044006807683,9
0.2,8226,93,603095,73.30679470037681,9
0.2,8227,95,603190,73.30943121050073,6
0.2,8228,20,603210,73.30295297119942,12
0.2,8229,95,603305,73.3055893074119,7
0.2,8230,89,603394,73.30749605151257,12
0.2,8231,94,603488,73.31000971817298,8
0.2,8232,94,603582,73.31252277420138,8
0.2,8233,94,603676,73.31503521982026,8
0.2,8234,89,603765,73.31693989071039,13
0.2,8235,95,603860,73.31957260806216,7
0.2,8236,23,603883,73.31346363967464,10
0.2,8237,93,603976,73.31585336246661,10
0.2,8238,93,604069,73.3182425051584,8
0.2,8239,94,604163,73.32075242718446,7
0.2,8240,91,604254,73.322897706589,10
0.2,8241,87,604341,73.32455714632371,18
0.2,8242,89,604430,73.32645881353876,12
0.2,8243,92,604522,73.32872392042698,10
0.2,8244,24,604546,73.32274105518496,9
0.2,8245,23,604569,73.31663837011885,10
0.2,8246,92,604661,73.318903843822,11
0.2,8247,95,604756,73.32153249272551,7
0.2,8248,94,604850,73.32403927748818,8
0.2,8249,94,604944,73.32654545454545,10
0.2,8250,96,605040,73.32929341897952,7
0.2,8251,94,605134,73.33179835191468,9
0.2,8252,95,605229,73.33442384587423,6
0.2,8253,95,605324,73.33704870365884,7
0.2,8254,9,605333,73.32925499697153,23
0.2,8255,95,605428,73.33187984496124,6
0.2,8256,92,605520,73.33414072907836,9
0.2,8257,93,605613,73.33652216032938,8
0.2,8258,94,605707,73.33902409492674,9
0.2,8259,24,605731,73.33305084745763,9
0.2,8260,95,605826,73.3356736472582,7
0.2,8261,93,605919,73.33805374001453,8
0.2,8262,94,606013,73.34055427810722,8
0.2,8263,93,606106,73.34293320425944,8
0.2,8264,-46,606060,73.32849364791288,11
0.2,8265,95,606155,73.33111541253326,8
0.2,8266,96,606251,73.33385750574574,6
0.2,8267,95,606346,73.33647798742139,7
0.2,8268,93,606439,73.33885596807353,9
0.2,8269,89,606528,73.34074969770253,12
0.2,8270,95,606623,73.34336839559909,8
0.2,8271,93,606716,73.34574468085107,8
0.2,8272,95,606811,73.34836214190742,6
0.2,8273,95,606906,73.35097897026832,6
0.2,8274,27,606933,73.34537764350453,6
0.2,8275,92,607025,73.34763170613823,12
0.2,8276,95,607120,73.35024767427812,9
0.2,8277,95,607215,73.35286301038899,7
0.2,8278,95,607310,73.35547771469984,6
0.2,8279,93,607403,73.35785024154589,9
0.2,8280,95,607498,73.36046371211206,8
0.2,8281,95,607593,73.3630765515576,7
0.2,8282,88,607681,73.3648436556803,15
0.2,8283,95,607776,73.36745533558667,6
0.2,8284,23,607799,73.361375980688,10
0.2,8285,95,607894,73.36398744870867,7
0.2,8286,92,607986,73.36623627368166,9
0.2,8287,94,608080,73.36872586872587,8
0.2,8288,95,608175,73.37133550488599,7
0.2,8289,96,608271,73.37406513872135,6
0.2,8290,89,608360,73.37594982511156,14
0.2,8291,93,608453,73.37831644958996,9
0.2,8292,94,608547,73.38080308694079,7
0.2,8293,93,608640,73.38316855558234,9
0.2,8294,24,608664,73.37721518987341,10
0.2,8295,23,608687,73.37114271938283,11
0.2,8296,96,608783,73.37387007352055,6
0.2,8297,92,608875,73.37611472644011,10
0.2,8298,95,608970,73.37872032775033,7
0.2,8299,25,608995,73.37289156626505,8
0.2,8300,88,609083,73.374653656186,13
0.2,8301,21,609104,73.36834497711395,13
0.2,8302,92,609196,73.37058894375527,12
0.2,8303,95,609291,73.3731936416185,7
0.2,8304,94,609385,73.37567730282962,8
0.2,8305,93,609478,73.37803997110522,9
0.2,8306,95,609573,73.38064283134706,6
0.2,8307,96,609669,73.38336543090996,6
0.2,8308,94,609763,73.38584667228307,7
0.2,8309,93,609856,73.38820697954272,10
0.2,8310,96,609952,73.390927686199,6
0.2,8311,91,610043,73.39304619826757,12
0.2,8312,90,610133,73.3950439071334,11
0.2,8313,94,610227,73.39752225162377,8
0.2,8314,95,610322,73.40012026458209,7
0.2,8315,94,610416,73.40259740259741,7
0.2,8316,95,610511,73.40519418059397,7
0.2,8317,21,610532,73.39889396489541,13
0.2,8318,94,610626,73.40137035701406,9
0.2,8319,94,610720,73.40384615384616,8
0.2,8320,24,610744,73.39790890517966,9
0.2,8321,94,610838,73.40038452295121,8
0.2,8322,17,610855,73.39360807401178,16
0.2,8323,-47,610808,73.37914464199903,12
0.2,8324,25,610833,73.37333333333333,8
0.2,8325,94,610927,73.37581071342781,9
0.2,8326,95,611022,73.37840758976823,6
0.2,8327,91,611113,73.38052353506244,11
0.2,8328,95,611208,73.38311922199544,8
0.2,8329,-117,611091,73.36026410564226,12
0.2,8330,94,611185,73.36274156763893,8
0.2,8331,92,611277,73.36497839654345,12
0.2,8332,95,611372,73.36757470298812,6
0.2,8333,91,611463,73.36969042476602,10
0.2,8334,94,611557,73.37216556688662,8
0.2,8335,93,611650,73.37452015355086,9
0.2,8336,94,611744,73.37699412258607,8
0.2,8337,93,611837,73.3793475653634,8
0.2,8338,23,611860,73.37330615181676,10
0.2,8339,92,611952,73.37553956834532,9
0.2,8340,94,612046,73.37801222874955,8
0.2,8341,95,612141,73.38060417166147,6
0.2,8342,96,612237,73.38331535418914,6
0.2,8343,89,612326,73.38518696069032,13
0.2,8344,94,612420,73.38765727980827,7
0.2,8345,93,612513,73.3900071890726,8
0.2,8346,24,612537,73.38409009224871,8
0.2,8347,91,612628,73.386200287494,11
0.2,8348,96,612724,73.38890885135945,6
0.2,8349,95,612819,73.39149700598803,7
0.2,8350,95,612914,73.39408454077356,7
0.2,8351,96,613010,73.39679118773947,6
0.2,8352,92,613102,73.39901831677241,11
0.2,8353,14,613116,73.39190806799138,18
0.2,8354,93,613209,73.39425493716338,10
0.2,8355,24,613233,73.38834370512207,9
0.2,8356,18,613251,73.38171592676798,15
0.2,8357,92,613343,73.3839435271596,10
0.2,8358,93,613436,73.3862902261036,9
0.2,8359,96,613532,73.388995215311,6
0.2,8360,92,613624,73.39122114579595,10
0.2,8361,95,613719,73.39380530973452,6
0.2,8362,96,613815,73.39650842998924,6
0.2,8363,23,613838,73.39048302247728,10
0.2,8364,94,613932,73.39294680215183,8
0.2,8365,27,613959,73.38740138656466,6
0.2,8366,93,614052,73.38974542846898,10
0.2,8367,95,614147,73.39232791586998,7
0.2,8368,92,614239,73.39455132034891,10
0.2,8369,95,614334,73.39713261648745,6
0.2,8370,21,614355,73.39087325289691,12
0.2,8371,20,614375,73.38449593884377,16
0.2,8372,92,614467,73.38671921652931,10
0.2,8373,93,614560,73.38906138046333,9
0.2,8374,95,614655,73.39164179104478,7
0.2,8375,90,614745,73.39362464183381,12
0.2,8376,22,614767,73.3874895547332,10
0.2,8377,96,614863,73.3901885891621,6
0.2,8378,21,614884,73.38393603055258,13
0.2,8379,93,614977,73.386276849642,10
0.2,8380,93,615070,73.38861711013006,9
0.2,8381,24,615094,73.38272488666189,9
0.2,8382,24,615118,73.37683406894907,11
0.2,8383,20,615138,73.37046755725191,17
0.2,8384,27,615165,73.3649373881932,6
0.2,8385,92,615257,73.36715955163368,9
0.2,8386,26,615283,73.36151186359842,7
0.2,8387,23,615306,73.3555078683834,10
0.2,8388,20,615326,73.34914769340803,13
0.2,8389,94,615420,73.35160905840286,8
0.2,8390,93,615513,73.35395066142296,9
0.2,8391,95,615608,73.35653002859867,6
0.2,8392,95,615703,73.35910878112713,8
0.2,8393,89,615792,73.36097212294496,12
0.2,8394,27,615819,73.35544967242406,6
0.2,8395,94,615913,73.35790852787042,8
0.2,8396,90,616003,73.35989043706086,13
0.2,8397,24,616027,73.3540128602048,8
0.2,8398,94,616121,73.35647100845338,8
0.2,8399,22,616143,73.35035714285715,11
0.2,8400,96,616239,73.35305320795143,6
0.2,8401,23,616262,73.34706022375624,10
0.2,8402,-53,616209,73.33202427704391,18
0.2,8403,93,616302,73.3343645882913,9
0.2,8404,93,616395,73.33670434265318,8
0.2,8405,94,616489,73.33916250297406,9
0.2,8406,95,616584,73.34173902700131,8
0.2,8407,92,616676,73.34395813510942,12
0.2,8408,92,616768,73.34617671542395,10
0.2,8409,95,616863,73.3487514863258,6
0.2,8410,95,616958,73.3513256449887,6
0.2,8411,14,616972,73.34427009034712,19
0.2,8412,13,616985,73.33709734934031,19
0.2,8413,23,617008,73.33111480865225,10
0.2,8414,22,617030,73.32501485442661,11
0.2,8415,91,617121,73.3271150190114,11
0.2,8416,92,617213,73.3293334917429,9
0.2,8417,24,617237,73.32347350914706,10
0.2,8418,94,617331,73.3259294453023,7
0.2,8419,95,617426,73.32850356294537,8
0.2,8420,21,617447,73.32228951430946,12
0.2,8421,94,617541,73.32474471621943,9
0.2,8422,95,617636,73.32731805769916,9
0.2,8423,94,617730,73.32977207977208,8
0.2,8424,95,617825,73.33234421364985,6
0.2,8425,94,617919,73.33479705672917,7
0.2,8426,-122,617797,73.31161742019698,17
0.2,8427,95,617892,73.31419079259611,6
0.2,8428,22,617914,73.30810297781468,11
0.2,8429,20,617934,73.30177935943061,15
0.2,8430,93,618027,73.30411576325466,9
0.2,8431,90,618117,73.30609582542695,11
0.2,8432,-53,618064,73.29111822601683,18
0.2,8433,92,618156,73.29333649513872,11
0.2,8434,18,618174,73.28678126852401,15
0.2,8435,92,618266,73.28899952584163,9
0.2,8436,93,618359,73.29133578286121,8
0.2,8437,89,618448,73.2931974401517,12
0.2,8438,95,618543,73.29576964095271,7
0.2,8439,95,618638,73.29834123222749,7
0.2,8440,-123,618515,73.27508589029736,18
0.2,8441,95,618610,73.27765932243544,8
0.2,8442,94,618704,73.28011370365984,8
0.2,8443,24,618728,73.27427759355756,9
0.2,8444,94,618822,73.27673179396092,7
0.2,8445,95,618917,73.2793038124556,7
0.2,8446,92,619009,73.28152006629573,10
0.2,8447,95,619104,73.2840909090909,7
0.2,8448,95,619199,73.28666114333058,6
0.2,8449,94,619293,73.2891124260355,7
0.2,8450,85,619378,73.29049816589753,17
0.2,8451,95,619473,73.2930667297681,6
0.2,8452,-55,619418,73.27788950668402,19
0.2,8453,94,619512,73.28034066713981,7
0.2,8454,95,619607,73.2829095209935,6
0.2,8455,25,619632,73.27719962157049,8
0.2,8456,25,619657,73.27149107248434,8
0.2,8457,93,619750,73.27382359895957,8
0.2,8458,94,619844,73.27627379122828,9
0.2,8459,93,619937,73.27860520094562,9
0.2,8460,95,620032,73.28117243824607,6
0.2,8461,92,620124,73.28338454266131,9
0.2,8462,95,620219,73.28595060853125,6
0.2,8463,95,620314,73.28851606805293,7
0.2,8464,94,620408,73.29096278795038,11
0.2,8465,10,620418,73.2834868887314,23
0.2,8466,93,620511,73.28581551907405,9
0.2,8467,88,620599,73.2875531412376,14
0.2,8468,95,620694,73.29011689691818,7
0.2,8469,95,620789,73.2926800472255,8
0.2,8470,91,620880,73.29477039310589,13
0.2,8471,96,620976,73.29745042492918,6
0.2,8472,93,621069,73.29977575829105,8
0.2,8473,91,621160,73.30186452678782,14
0.2,8474,89,621249,73.30371681415929,13
0.2,8475,92,621341,73.30592260500237,9
0.2,8476,96,621437,73.30859974047422,7
0.2,8477,95,621532,73.31115829205001,6
0.2,8478,91,621623,73.31324448637811,10
0.2,8479,27,621650,73.30778301886792,6
0.2,8480,89,621739,73.30963329796015,13
0.2,8481,93,621832,73.31195472765857,8
0.2,8482,96,621928,73.31462925851703,6
0.2,8483,24,621952,73.3088165959453,9
0.2,8484,91,622043,73.31090159104302,11
0.2,8485,95,622138,73.3134574593448,7
0.2,8486,95,622233,73.31601272534465,6
0.2,8487,24,622257,73.31020263901979,9
0.2,8488,95,622352,73.31275768641771,7
0.2,8489,95,622447,73.31531213191991,8
0.2,8490,18,622465,73.30879755034742,15
0.2,8491,93,622558,73.3111163447951,9
0.2,8492,91,622649,73.31319910514542,10
0.2,8493,96,622745,73.31587002590064,6
0.2,8494,92,622837,73.31806945261918,10
0.2,8495,94,622931,73.32050376647834,8
0.2,8496,27,622958,73.31505237142521,7
0.2,8497,95,623053,73.3176041421511,7
0.2,8498,23,623076,73.31168372749735,11
0.2,8499,95,623171,73.31423529411765,7
0.2,8500,86,623257,73.31572756146336,15
0.2,8501,95,623352,73.31827805222301,6
0.2,8502,94,623446,73.32071033752793,8
0.2,8503,95,623541,73.32325964252117,6
0.2,8504,95,623636,73.32580834803058,7
0.2,8505,92,623728,73.32800376205032,12
0.2,8506,91,623819,73.33008110967438,11
0.2,8507,96,623915,73.33274565115185,6
0.2,8508,95,624010,73.33529204371841,7
0.2,8509,22,624032,73.32925969447709,11
0.2,8510,85,624117,73.3306309481847,18
0.2,8511,94,624211,73.33305921052632,9
0.2,8512,94,624305,73.33548690238459,8
0.2,8513,94,624399,73.33791402396054,8
0.2,8514,21,624420,73.33176746917205,12
0.2,8515,94,624514,73.33419445749178,8
0.2,8516,18,624532,73.32769754608431,14
0.2,8517,94,624626,73.33012444235736,8
0.2,8518,21,624647,73.32398168799155,12
0.2,8519,94,624741,73.32640845070422,7
0.2,8520,94,624835,73.32883464382115,7
0.2,8521,95,624930,73.33137761088946,8
0.2,8522,93,625023,73.3336853220697,9
0.2,8523,93,625116,73.33599249178789,9
0.2,8524,95,625211,73.33853372434018,7
0.2,8525,93,625304,73.34083978418954,8
0.2,8526,-53,625251,73.32602322035886,16
0.2,8527,95,625346,73.32856472795497,6
0.2,8528,91,625437,73.33063665142456,12
0.2,8529,95,625532,73.33317702227433,6
0.2,8530,23,625555,73.3272769898019,10
0.2,8531,93,625648,73.32958274730427,8
0.2,8532,26,625674,73.32403609515997,7
0.2,8533,92,625766,73.32622451370986,10
0.2,8534,92,625858,73.32841241944932,10
0.2,8535,22,625880,73.3223992502343,11
0.2,8536,90,625970,73.32435281714888,13
0.2,8537,95,626065,73.32689154368704,7
0.2,8538,93,626158,73.3291954561424,9
0.2,8539,19,626177,73.32283372365339,14
0.2,8540,21,626198,73.31670764547476,11
0.2,8541,88,626286,73.31842659798642,14
0.2,8542,93,626379,73.32073042256819,10
0.2,8543,94,626473,73.32315074906367,8
0.2,8544,93,626566,73.32545348156818,9
0.2,8545,95,626661,73.32798970278493,7
0.2,8546,23,626684,73.32210132210132,10
0.2,8547,94,626778,73.32452035563874,8
0.2,8548,92,626870,73.32670487776348,10
0.2,8549,94,626964,73.32912280701754,9
0.2,8550,94,627058,73.33154017074027,8
0.2,8551,95,627153,73.33407390084191,6
0.2,8552,96,627249,73.33672395650649,6
0.2,8553,91,627340,73.33878887070377,13
0.2,8554,81,627421,73.33968439509059,24
0.2,8555,21,627442,73.33356708742403,13
0.2,8556,95,627537,73.33609910015193,6
0.2,8557,95,627632,73.3386305211498,6
0.2,8558,95,627727,73.34116135062507,7
0.2,8559,-50,627677,73.32675233644859,13
0.2,8560,91,627768,73.32881672701787,11
0.2,8561,95,627863,73.33134781593085,7
0.2,8562,94,627957,73.3337615321733,7
0.2,8563,93,628050,73.33605791686128,9
0.2,8564,91,628141,73.33812025685931,11
0.2,8565,22,628163,73.33212701377539,10
0.2,8566,-48,628115,73.31796428154547,13
0.2,8567,93,628208,73.3202614379085,9
0.2,8568,96,628304,73.32290815731123,6
0.2,8569,90,628394,73.32485414235705,12
0.2,8570,18,628412,73.318399253296,15
0.2,8571,96,628508,73.3210452636491,6
0.2,8572,27,628535,73.31564213227576,6
0.2,8573,91,628626,73.31770468859342,10
0.2,8574,23,628649,73.31183673469388,10
0.2,8575,91,628740,73.31389925373135,11
0.2,8576,96,628836,73.31654424623994,6
0.2,8577,95,628931,73.31907204476568,6
0.2,8578,14,628945,73.3121575941252,20
0.2,8579,27,628972,73.30675990675991,8
0.2,8580,94,629066,73.30917142524181,8
0.2,8581,20,629086,73.30295968305757,14
0.2,8582,92,629178,73.30513806361412,9
0.2,8583,25,629203,73.29951071761417,8
0.2,8584,95,629298,73.30203843913803,6
0.2,8585,94,629392,73.30444910319125,8
0.2,8586,-50,629342,73.29008967043205,15
0.2,8587,92,629434,73.29226828132278,9
0.2,8588,94,629528,73.29467924088951,8
0.2,8589,93,629621,73.29697322467986,9
0.2,8590,95,629716,73.29949947619602,6
0.2,8591,94,629810,73.30190875232775,7
0.2,8592,25,629835,73.29628767601537,8
0.2,8593,94,629929,73.29869676518501,7
0.2,8594,93,630022,73.30098894706225,8
0.2,8595,94,630116,73.30339692880409,7
0.2,8596,88,630204,73.30510643247645,13
0.2,8597,95,630299,73.30762968132123,8
0.2,8598,92,630391,73.30980346551925,9
0.2,8599,94,630485,73.31220930232558,8
0.2,8600,95,630580,73.31473084525055,6
0.2,8601,93,630673,73.31701929783772,9
0.2,8602,95,630768,73.31953969545508,7
0.2,8603,88,630856,73.3212459321246,13
0.2,8604,91,630947,73.32330040674027,12
0.2,8605,94,631041,73.32570299790844,8
0.2,8606,90,631131,73.32764029278495,12
0.2,8607,96,631227,73.33027416356877,6
0.2,8608,95,631322,73.33279126495528,7
0.2,8609,95,631417,73.33530778164925,6
0.2,8610,94,631511,73.33770758332365,7
0.2,8611,15,631526,73.33093358104969,18
0.2,8612,95,631621,73.33344943689771,6
0.2,8613,-52,631569,73.31889946598561,16
0.2,8614,95,631664,73.32141613464887,7
0.2,8615,22,631686,73.31545961002786,11
0.2,8616,25,631711,73.30985261692004,9
0.2,8617,25,631736,73.30424692504062,8
0.2,8618,95,631831,73.30676412576865,6
0.2,8619,95,631926,73.30928074245939,6
0.2,8620,95,632021,73.31179677531608,7
0.2,8621,95,632116,73.31431222454187,8
0.2,8622,94,632210,73.31671112141946,8
0.2,8623,88,632298,73.31841372912801,15
0.2,8624,94,632392,73.3208115942029,7
0.2,8625,20,632412,73.31463018780431,13
0.2,8626,95,632507,73.31714385070129,7
0.2,8627,94,632601,73.31954102920723,7
0.2,8628,95,632696,73.32205354038706,6
0.2,8629,91,632787,73.32410196987254,10
0.2,8630,24,632811,73.31838720889816,11
0.2,8631,95,632906,73.32089898053754,6
0.2,8632,-49,632857,73.30672998957489,12
0.2,8633,25,632882,73.30113504748668,8
0.2,8634,94,632976,73.30353213665316,8
0.2,8635,95,633071,73.30604446503011,6
0.2,8636,96,633167,73.30867199259002,7
0.2,8637,93,633260,73.31095160916878,9
0.2,8638,90,633350,73.31288343558282,11
0.2,8639,96,633446,73.31550925925926,6
0.2,8640,94,633540,73.31790302048374,8
0.2,8641,92,633632,73.32006479981486,12
0.2,8642,96,633728,73.32268888117552,6
0.2,8643,94,633822,73.3250809810273,7
0.2,8644,22,633844,73.31914401388086,11
0.2,8645,95,633939,73.32165163081194,6
0.2,8646,22,633961,73.31571643344513,12
0.2,8647,94,634055,73.31810823311748,8
0.2,8648,93,634148,73.32038385940571,8
0.2,8649,91,634239,73.32242774566474,11
0.2,8650,22,634261,73.31649520286672,13
0.2,8651,96,634357,73.31911696717522,6
0.2,8652,88,634445,73.3208135906622,14
0.2,8653,16,634461,73.31418996995609,17
0.2,8654,27,634488,73.30883882149047,7
0.2,8655,94,634582,73.31122920517561,9
0.2,8656,96,634678,73.3138500635324,6
0.2,8657,94,634772,73.31623931623932,8
0.2,8658,95,634867,73.3187435038688,6
0.2,8659,-48,634819,73.30473441108545,12
0.2,8660,90,634909,73.30666204826233,11
0.2,8661,95,635004,73.30916647425536,6
0.2,8662,88,635092,73.31086228789103,15
0.2,8663,94,635186,73.31325023084025,9
0.2,8664,93,635279,73.31552221581073,10
0.2,8665,92,635371,73.31767828294484,10
0.2,8666,23,635394,73.31187262028384,10
0.2,8667,93,635487,73.31414397784957,9
0.2,8668,93,635580,73.31641481139692,9
0.2,8669,94,635674,73.31880046136102,7
0.2,8670,27,635701,73.31345865528775,6
0.2,8671,93,635794,73.31572878228782,9
0.2,8672,95,635889,73.31822898650985,7
0.2,8673,95,635984,73.32072861424948,6
0.2,8674,89,636073,73.32253602305475,13
0.2,8675,94,636167,73.3249193176579,8
0.2,8676,95,636262,73.32741731013023,7
0.2,8677,93,636355,73.32968425904586,9
0.2,8678,93,636448,73.33195068556286,10
0.2,8679,96,636544,73.33456221198156,6
0.2,8680,96,636640,73.3371731367354,6
0.2,8681,82,636722,73.33817092835753,20
0.2,8682,-44,636678,73.32465737648278,8
0.2,8683,96,636774,73.32726853984339,6
0.2,8684,93,636867,73.32953367875648,8
0.2,8685,92,636959,73.33168316831683,10
0.2,8686,94,637053,73.33406239208011,8
0.2,8687,96,637149,73.33667127071823,7
0.2,8688,93,637242,73.33893428472781,9
0.2,8689,95,637337,73.34142692750288,6
0.2,8690,94,637431,73.34380393510529,9
0.2,8691,90,637521,73.34572020248504,12
0.2,8692,24,637545,73.34004371333256,8
0.2,8693,93,637638,73.34230503795722,8
0.2,8694,94,637732,73.34468085106383,8
0.2,8695,95,637827,73.34717111315547,7
0.2,8696,-47,637780,73.33333333333333,11
0.2,8697,95,637875,73.3358243274316,6
0.2,8698,93,637968,73.33808483733762,10
0.2,8699,93,638061,73.34034482758621,8
0.2,8700,92,638153,73.34248936903805,10
0.2,8701,93,638246,73.34474833371638,9
0.2,8702,-46,638200,73.33103527519246,10
0.2,8703,94,638294,73.3334099264706,8
0.2,8704,91,638385,73.33543940264217,11
0.2,8705,92,638477,73.33758327590168,11
0.2,8706,94,638571,73.33995635695418,9
0.2,8707,26,638597,73.33451998162609,9
0.2,8708,92,638689,73.3366632219543,11
0.2,8709,26,638715,73.33122847301952,6
0.2,8710,26,638741,73.32579497187464,7
0.2,8711,94,638835,73.32816804407713,9
0.2,8712,95,638930,73.33065534259153,7
0.2,8713,93,639023,73.33291255450999,9
0.2,8714,96,639119,73.33551348250144,6
0.2,8715,93,639212,73.33776961909133,8
0.2,8716,96,639308,73.34036939313984,6
0.2,8717,92,639400,73.34250974994265,10
0.2,8718,94,639494,73.34487899988531,8
0.2,8719,96,639590,73.34747706422019,6
0.2,8720,94,639684,73.3498452012384,7
0.2,8721,86,639770,73.35129557440953,15
0.2,8722,94,639864,73.35366273071192,7
0.2,8723,95,639959,73.35614397065567,7
0.2,8724,89,640048,73.35793696275071,14
0.2,8725,94,640142,73.36030254412101,8
0.2,8726,93,640235,73.3625529964478,9
0.2,8727,95,640330,73.36503208065994,7
0.2,8728,93,640423,73.3672814755413,8
0.2,8729,24,640447,73.36162657502864,9
0.2,8730,93,640540,73.36387584469134,9
0.2,8731,96,640636,73.36646816307834,7
0.2,8732,95,640731,73.36894537959463,8
0.2,8733,95,640826,73.37142202885276,6
0.2,8734,26,640852,73.36599885518031,7
0.2,8735,95,640947,73.36847527472527,6
0.2,8736,95,641042,73.37095112738926,6
0.2,8737,93,641135,73.37319752803845,8
0.2,8738,92,641227,73.37532898500973,9
0.2,8739,95,641322,73.37780320366133,7
0.2,8740,88,641410,73.37947603249056,15
0.2,8741,95,641505,73.38194921070694,7
0.2,8742,91,641596,73.38396431430859,11
0.2,8743,94,641690,73.38632204940531,11
0.2,8744,94,641784,73.38867924528302,9
0.2,8745,20,641804,73.38257489137892,12
0.2,8746,90,641894,73.38447467703213,12
0.2,8747,94,641988,73.38683127572017,8
0.2,8748,27,642015,73.3815293176363,7
0.2,8749,95,642110,73.384,7
0.2,8750,93,642203,73.38624157239173,8
0.2,8751,24,642227,73.38059872029251,10
0.2,8752,95,642322,73.38306866217297,6
0.2,8753,92,642414,73.38519533927348,9
0.2,8754,90,642504,73.38709308966305,11
0.2,8755,91,642595,73.38910461397899,12
0.2,8756,94,642689,73.39145826196186,7
0.2,8757,93,642782,73.39369719113952,10
0.2,8758,93,642875,73.3959356090878,8
0.2,8759,91,642966,73.39794520547945,10
0.2,8760,93,643059,73.40018262755393,9
0.2,8761,-57,643002,73.38530015978087,21
0.2,8762,96,643098,73.38788086271825,6
0.2,8763,96,643194,73.39046097672296,6
0.2,8764,-53,643141,73.37604107244724,17
0.2,8765,24,643165,73.37040839607575,8
0.2,8766,95,643260,73.37287555606251,6
0.2,8767,24,643284,73.36724452554745,9
0.2,8768,95,643379,73.36971148363554,6
0.2,8769,94,643473,73.3720638540479,7
0.2,8770,19,643492,73.36586478166686,16
0.2,8771,93,643585,73.36810305517555,9
0.2,8772,95,643680,73.37056879060755,7
0.2,8773,92,643772,73.37269204467745,11
0.2,8774,90,643862,73.3745868945869,11
0.2,8775,96,643958,73.37716499544212,6
0.2,8776,25,643983,73.37165318445938,10
0.2,8777,-49,643934,73.35771246297563,13
0.2,8778,95,644029,73.3601776967764,7
0.2,8779,89,644118,73.3619589977221,13
0.2,8780,26,644144,73.35656531146795,7
0.2,8781,92,644236,73.35868822591665,10
0.2,8782,93,644329,73.36092451326427,8
0.2,8783,96,644425,73.36350182149363,7
0.2,8784,94,644519,73.36585088218554,9
0.2,8785,92,644611,73.36797177327567,10
0.2,8786,94,644705,73.37031979059975,7
0.2,8787,95,644800,73.37278106508876,6
0.2,8788,92,644892,73.3749004437365,9
0.2,8789,25,644917,73.36939704209328,8
0.2,8790,20,644937,73.36332612899557,12
0.2,8791,95,645032,73.36578707916287,7
0.2,8792,94,645126,73.36813374274992,8
0.2,8793,93,645219,73.3703661587446,10
0.2,8794,91,645310,73.37237066515065,10
0.2,8795,23,645333,73.36664392905867,10
0.2,8796,96,645429,73.3692167784472,6
0.2,8797,90,645519,73.3711070697886,12
0.2,8798,91,645610,73.3731105807478,11
0.2,8799,95,645705,73.37556818181818,6
0.2,8800,87,645792,73.37711623679128,15
0.2,8801,93,645885,73.37934560327199,10
0.2,8802,91,645976,73.38134726797682,11
0.2,8803,95,646071,73.38380281690141,6
0.2,8804,95,646166,73.3862578080636,6
0.2,8805,93,646259,73.38848512377925,9
0.2,8806,95,646354,73.39093902577495,6
0.2,8807,26,646380,73.38555858310627,7
0.2,8808,94,646474,73.38789873992508,9
0.2,8809,95,646569,73.39035187287173,7
0.2,8810,21,646590,73.38440585631596,12
0.2,8811,91,646681,73.38640490240581,10
0.2,8812,96,646777,73.38897083853398,6
0.2,8813,95,646872,73.39142273655548,8
0.2,8814,23,646895,73.38570618264322,9
0.2,8815,91,646986,73.38770417422867,11
0.2,8816,94,647080,73.39004196438698,8
0.2,8817,95,647175,73.392492628714,6
0.2,8818,94,647269,73.39482934573081,7
0.2,8819,25,647294,73.38934240362812,8
0.2,8820,90,647384,73.39122548463892,11
0.2,8821,93,647477,73.3934481976876,8
0.2,8822,95,647572,73.39589708715856,7
0.2,8823,92,647664,73.39800543970988,9
0.2,8824,96,647760,73.40056657223796,6
0.2,8825,92,647852,73.40267391796964,10
0.2,8826,95,647947,73.40512065254333,7
0.2,8827,95,648042,73.40756683280472,7
0.2,8828,90,648132,73.4094461433911,11
0.2,8829,93,648225,73.41166477916195,9
0.2,8830,95,648320,73.41410938738535,6
0.2,8831,91,648411,73.41610054347827,10
0.2,8832,27,648438,73.41084569229028,7
0.2,8833,92,648530,73.4129499660403,9
0.2,8834,-50,648480,73.39898132427844,13
0.2,8835,91,648571,73.40097329108194,11
0.2,8836,93,648664,73.40319112821093,12
0.2,8837,94,648758,73.40552161122426,8
0.2,8838,91,648849,73.40751216200928,10
0.2,8839,86,648935,73.40893665158372,16
0.2,8840,22,648957,73.40312181879878,10
0.2,8841,20,648977,73.39708210812033,13
0.2,8842,88,649065,73.39873346149497,16
0.2,8843,95,649160,73.40117593848937,6
0.2,8844,95,649255,73.40361786319954,7
0.2,8845,95,649350,73.40605923581279,6
0.2,8846,95,649445,73.40850005651633,7
0.2,8847,93,649538,73.41071428571429,8
0.2,8848,-47,649491,73.39710701774212,10
0.2,8849,27,649518,73.39186440677966,6
0.2,8850,23,649541,73.38617105411818,10
0.2,8851,96,649637,73.38872571170357,6
0.2,8852,94,649731,73.39105388004066,7
0.2,8853,94,649825,73.39338152247572,7
0.2,8854,21,649846,73.38746470920384,13
0.2,8855,94,649940,73.38979223125564,7
0.2,8856,93,650033,73.39200632268262,8
0.2,8857,26,650059,73.38665613005193,7
0.2,8858,94,650153,73.38898295518682,7
0.2,8859,96,650249,73.39153498871332,7
0.2,8860,92,650341,73.39363502990633,10
0.2,8861,94,650435,73.39596027984653,8
0.2,8862,-51,650384,73.38192485614351,14
0.2,8863,24,650408,73.37635379061372,9
0.2,8864,93,650501,73.3785673998872,9
0.2,8865,94,650595,73.38089330024813,8
0.2,8866,27,650622,73.37566256907635,6
0.2,8867,25,650647,73.37020748759585,8
0.2,8868,26,650673,73.36486638854437,7
0.2,8869,95,650768,73.36730552423901,7
0.2,8870,95,650863,73.36974411002141,7
0.2,8871,93,650956,73.37195671776375,9
0.2,8872,93,651049,73.37416882677786,9
0.2,8873,90,651139,73.37604237097138,12
0.2,8874,96,651235,73.37859154929578,6
0.2,8875,94,651329,73.38091482649843,7
0.2,8876,94,651423,73.3832375802636,10
0.2,8877,93,651516,73.38544717278667,9
0.2,8878,95,651611,73.38788151818899,6
0.2,8879,20,651631,73.38186936936937,14
0.2,8880,95,651726,73.38430356941785,7
0.2,8881,96,651822,73.38684980860167,6
0.2,8882,96,651918,73.38939547450185,7
0.2,8883,90,652008,73.39126519585773,12
0.2,8884,91,652099,73.39324704558244,11
0.2,8885,91,652190,73.395228449246,11
0.2,8886,95,652285,73.39765950264432,7
0.2,8887,96,652381,73.40020252025202,6
0.2,8888,94,652475,73.4025199685004,8
0.2,8889,95,652570,73.40494938132733,6
0.2,8890,91,652661,73.4069283545158,10
0.2,8891,96,652757,73.40946918578497,6
0.2,8892,93,652850,73.41167210165298,9
0.2,8893,93,652943,73.41387452214977,9
0.2,8894,95,653038,73.41630129286116,7
0.2,8895,90,653128,73.4181654676259,13
0.2,8896,95,653223,73.4205912105204,7
0.2,8897,94,653317,73.42290402337603,7
0.2,8898,94,653411,73.42521631644004,8
0.2,8899,96,653507,73.42775280898877,6
0.2,8900,94,653601,73.43006403774856,8
0.2,8901,93,653694,73.43226241294091,9
0.2,8902,90,653784,73.43412332921487,11
0.2,8903,88,653872,73.43575920934411,14
0.2,8904,94,653966,73.43806850084222,8
0.2,8905,22,653988,73.43229283629015,11
0.2,8906,95,654083,73.43471426967554,6
0.2,8907,95,654178,73.43713515940728,7
0.2,8908,95,654273,73.43955550566842,9
0.2,8909,95,654368,73.44197530864197,6
0.2,8910,94,654462,73.44428234766019,8
0.2,8911,94,654556,73.44658886894075,8
0.2,8912,94,654650,73.44889487265792,7
0.2,8913,95,654745,73.45131254206865,6
0.2,8914,20,654765,73.44531688166012,13
0.2,8915,19,654784,73.43921040825482,14
0.2,8916,92,654876,73.44129191432096,10
0.2,8917,24,654900,73.43574792554385,9
0.2,8918,91,654991,73.43771723287364,10
0.2,8919,95,655086,73.44013452914798,7
0.2,8920,93,655179,73.44232709337518,8
0.2,8921,95,655274,73.44474333109169,6
0.2,8922,95,655369,73.447159027233,6
0.2,8923,95,655464,73.44957418198118,6
0.2,8924,94,655558,73.45187675070028,8
0.2,8925,20,655578,73.44588841586376,13
0.2,8926,95,655673,73.44830290131063,6
0.2,8927,95,655768,73.45071684587813,7
0.2,8928,92,655860,73.45279426587524,12
0.2,8929,95,655955,73.4552071668533,7
0.2,8930,22,655977,73.4494457507558,11
0.2,8931,81,656058,73.45029108822212,21
0.2,8932,95,656153,73.45270345908429,7
0.2,8933,94,656247,73.45500335795836,7
0.2,8934,94,656341,73.45730274202575,8
0.2,8935,92,656433,73.45937779767233,9
0.2,8936,95,656528,73.46178807205997,7
0.2,8937,95,656623,73.46419780711568,7
0.2,8938,22,656645,73.45844054144759,13
0.2,8939,93,656738,73.4606263982103,10
0.2,8940,95,656833,73.46303545464713,8
0.2,8941,95,656928,73.46544397226572,8
0.2,8942,96,657024,73.4679637705468,6
0.2,8943,93,657117,73.47014758497316,9
0.2,8944,94,657211,73.47244270542203,9
0.2,8945,95,657306,73.4748490945674,7
0.2,8946,95,657401,73.47725494579188,7
0.2,8947,92,657493,73.47932498882432,10
0.2,8948,18,657511,73.47312548888144,17
0.2,8949,95,657606,73.47553072625698,6
0.2,8950,93,657699,73.47771198748742,9
0.2,8951,-56,657643,73.46324843610367,20
0.2,8952,96,657739,73.46576566514018,6
0.2,8953,93,657832,73.4679472861291,10
0.2,8954,95,657927,73.47035175879397,6
0.2,8955,90,658017,73.47219740955784,12
0.2,8956,92,658109,73.47426593725578,12
0.2,8957,93,658202,73.47644563518642,8
0.2,8958,24,658226,73.47092309409533,9
0.2,8959,95,658321,73.47332589285715,7
0.2,8960,93,658414,73.47550496596362,9
0.2,8961,26,658440,73.47020754295916,8
0.2,8962,95,658535,73.47260961731563,7
0.2,8963,24,658559,73.46709058456047,9
0.2,8964,94,658653,73.46938092582265,9
0.2,8965,91,658744,73.47133615882221,11
0.2,8966,92,658836,73.4734024757444,10
0.2,8967,94,658930,73.47569134701159,8
0.2,8968,96,659026,73.47820269818263,7
0.2,8969,91,659117,73.48015607580825,11
0.2,8970,92,659209,73.48222048823989,9
0.2,8971,95,659304,73.48461881408828,7
0.2,8972,23,659327,73.47899253315502,10
0.2,8973,92,659419,73.48105638511255,11
0.2,8974,85,659504,73.48233983286909,16
0.2,8975,93,659597,73.48451426024955,10
0.2,8976,94,659691,73.48679959897515,7
0.2,8977,95,659786,73.48919581198486,7
0.2,8978,90,659876,73.49103463637375,11
0.2,8979,95,659971,73.49342984409799,7
0.2,8980,94,660065,73.49571317225254,8
0.2,8981,96,660161,73.49821865954131,6
0.2,8982,84,660245,73.4993877323834,18
0.2,8983,96,660341,73.50189225289404,6
0.2,8984,96,660437,73.50439621591542,6
0.2,8985,95,660532,73.50678833741375,7
0.2,8986,17,660549,73.50050072326694,15
0.2,8987,95,660644,73.5028927458834,7
0.2,8988,24,660668,73.49738569362555,9
0.2,8989,-120,660548,73.47586206896551,14
0.2,8990,94,660642,73.47814481147815,7
0.2,8991,91,660733,73.48009341637011,11
0.2,8992,21,660754,73.47425775603247,12
0.2,8993,24,660778,73.46875694907716,9
0.2,8994,95,660873,73.47115063924403,6
0.2,8995,92,660965,73.47321031569587,9
0.2,8996,-53,660912,73.45915305101701,17
0.2,8997,87,660999,73.4606579239831,14
0.2,8998,82,661081,73.46160684520503,19
0.2,8999,95,661176,73.464,7
0.2,9000,95,661271,73.46639262304188,7
0.2,9001,92,661363,73.46845145523217,10
0.2,9002,94,661457,73.47073197822948,8
0.2,9003,93,661550,73.4729009329187,10
0.2,9004,12,661562,73.46607440310939,20
0.2,9005,94,661656,73.46835443037975,10
0.2,9006,93,661749,73.47052292661263,8
0.2,9007,95,661844,73.47291296625222,7
0.2,9008,94,661938,73.47519147519148,7
0.2,9009,92,662030,73.47724750277469,9
0.2,9010,95,662125,73.4796360004439,7
0.2,9011,95,662220,73.48202396804261,6
0.2,9012,95,662315,73.48441140574725,6
0.2,9013,94,662409,73.48668737519414,8
0.2,9014,86,662495,73.48807542983916,17
0.2,9015,22,662517,73.48236468500444,11
0.2,9016,93,662610,73.48452922257957,10
0.2,9017,95,662705,73.48691505877134,7
0.2,9018,9,662714,73.47976494068078,24
0.2,9019,91,662805,73.48170731707317,10
0.2,9020,90,662895,73.48353841037579,12
0.2,9021,94,662989,73.48581245843494,8
0.2,9022,93,663082,73.48797517455392,10
0.2,9023,96,663178,73.49046985815603,6
0.2,9024,93,663271,73.49263157894737,9
0.2,9025,25,663296,73.48725902947042,8
0.2,9026,94,663390,73.48953140578266,8
0.2,9027,93,663483,73.49169251218431,9
0.2,9028,93,663576,73.4938531398826,10
0.2,9029,96,663672,73.49634551495016,6
0.2,9030,93,663765,73.49850514893146,8
0.2,9031,92,663857,73.50055358724535,10
0.2,9032,90,663947,73.50238016162957,11
0.2,9033,94,664041,73.50464910338721,8
0.2,9034,26,664067,73.49939125622579,7
0.2,9035,90,664157,73.50121735281098,12
0.2,9036,27,664184,73.4960717052119,6
0.2,9037,94,664278,73.49834034078336,8
0.2,9038,87,664365,73.49983405243943,14
0.2,9039,93,664458,73.50199115044248,10
0.2,9040,93,664551,73.50414777126424,10
0.2,9041,94,664645,73.50641451006415,7
0.2,9042,95,664740,73.50879133031074,7
0.2,9043,95,664835,73.51116762494472,6
0.2,9044,93,664928,73.51332227750139,8
0.2,9045,92,665020,73.51536590758346,9
0.2,9046,19,665039,73.50934011274455,14
0.2,9047,25,665064,73.50397877984085,9
0.2,9048,93,665157,73.50613327439495,9
0.2,9049,94,665251,73.50839779005526,8
0.2,9050,95,665346,73.51077229035465,7
0.2,9051,91,665437,73.51270437472382,13
0.2,9052,95,665532,73.51507787473766,7
0.2,9053,23,665555,73.50949856417053,11
0.2,9054,95,665650,73.51187189398122,7
0.2,9055,86,665736,73.51325088339223,16
0.2,9056,93,665829,73.51540245114276,9
0.2,9057,94,665923,73.51766394347538,8
0.2,9058,93,666016,73.51981454906722,8
0.2,9059,95,666111,73.52218543046358,7
0.2,9060,93,666204,73.52433506235515,11
0.2,9061,92,666296,73.52637386890311,9
0.2,9062,90,666386,73.52819154805252,11
0.2,9063,80,666466,73.52890556045895,21
0.2,9064,92,666558,73.53094318808604,10
0.2,9065,94,666652,73.5332009706596,8
0.2,9066,23,666675,73.52762766074777,11
0.2,9067,21,666696,73.52183502426114,13
0.2,9068,90,666786,73.52365200132319,12
0.2,9069,-50,666736,73.51003307607498,14
0.2,9070,96,666832,73.51251240216074,6
0.2,9071,93,666925,73.51466049382717,10
0.2,9072,83,667008,73.51570594070319,19
0.2,9073,24,667032,73.51024906325766,9
0.2,9074,21,667053,73.50446280991736,12
0.2,9075,96,667149,73.50694138386955,6
0.2,9076,94,667243,73.50919907458412,8
0.2,9077,90,667333,73.51101564221194,11
0.2,9078,94,667427,73.51327238682674,8
0.2,9079,95,667522,73.51563876651983,6
0.2,9080,92,667614,73.5176742649488,10
0.2,9081,96,667710,73.52014974675181,7
0.2,9082,95,667805,73.52251458769129,7
0.2,9083,91,667896,73.52443857331572,11
0.2,9084,94,667990,73.52669235002752,8
0.2,9085,92,668082,73.52872551177636,9
0.2,9086,92,668174,73.5307582260372,10
0.2,9087,94,668268,73.53301056338029,8
0.2,9088,95,668363,73.53537242820993,7
0.2,9089,95,668458,73.53773377337734,7
0.2,9090,95,668553,73.54009459905402,9
0.2,9091,96,668649,73.54256489221294,6
0.2,9092,95,668744,73.54492466732651,6
0.2,9093,-55,668689,73.53078953155926,19
0.2,9094,93,668782,73.53293018141837,9
0.2,9095,89,668871,73.53463060686016,12
0.2,9096,95,668966,73.53699021655491,6
0.2,9097,94,669060,73.53923939327325,7
0.2,9098,94,669154,73.5414880756127,9
0.2,9099,94,669248,73.54373626373626,8
0.2,9100,95,669343,73.54609383584221,7
0.2,9101,95,669438,73.5484508899143,6
0.2,9102,95,669533,73.55080742612326,6
0.2,9103,96,669629,73.55327328646749,6
0.2,9104,94,669723,73.55551894563426,9
0.2,9105,20,669743,73.54963760158138,12
0.2,9106,-53,669690,73.53574173712529,17
0.2,9107,91,669781,73.53765920070268,11
0.2,9108,91,669872,73.53957624327587,10
0.2,9109,95,669967,73.54193194291987,6
0.2,9110,92,670059,73.54395785314455,10
0.2,9111,92,670151,73.54598331870062,9
0.2,9112,96,670247,73.5484472731263,7
0.2,9113,93,670340,73.55058152293175,9
0.2,9114,93,670433,73.55271530444323,8
0.2,9115,24,670457,73.54727950855639,9
0.2,9116,94,670551,73.54952286936492,7
0.2,9117,95,670646,73.55187541127441,7
0.2,9118,93,670739,73.55400811492488,8
0.2,9119,95,670834,73.55635964912281,6
0.2,9120,92,670926,73.55838175638637,10
0.2,9121,94,671020,73.560622670467,9
0.2,9122,24,671044,73.55519017866929,9
0.2,9123,24,671068,73.54975887768522,8
0.2,9124,94,671162,73.552,7
0.2,9125,96,671258,73.55445978522901,6
0.2,9126,16,671274,73.54815382929769,17
0.2,9127,94,671368,73.55039439088519,8
0.2,9128,94,671462,73.55263446160588,8
0.2,9129,94,671556,73.55487404162103,9
0.2,9130,91,671647,73.55678458000219,12
0.2,9131,20,671667,73.55091984231275,12
0.2,9132,23,671690,73.54538486806088,10
0.2,9133,95,671785,73.54773374206262,9
0.2,9134,21,671806,73.54198139025725,12
0.2,9135,91,671897,73.54389229422067,11
0.2,9136,95,671992,73.54624056035898,7
0.2,9137,94,672086,73.54847887940468,8
0.2,9138,91,672177,73.5503884451253,11
0.2,9139,95,672272,73.55273522975929,7
0.2,9140,92,672364,73.55475330926595,11
0.2,9141,22,672386,73.54911397943557,10
0.2,9142,-50,672336,73.53560100623427,14
0.2,9143,90,672426,73.53740157480316,12
0.2,9144,95,672521,73.53974849644615,6
0.2,9145,20,672541,73.53389459873169,13
0.2,9146,95,672636,73.53624139061988,7
0.2,9147,93,672729,73.53836904241365,8
0.2,9148,21,672750,73.53262651655919,12
0.2,9149,19,672769,73.52666666666667,16
0.2,9150,94,672863,73.52890394492405,8
0.2,9151,94,672957,73.53114073426573,8
0.2,9152,96,673053,73.5335955424451,6
0.2,9153,95,673148,73.53594057242735,7
0.2,9154,91,673239,73.53784817039869,11
0.2,9155,95,673334,73.54019222367846,6
0.2,9156,95,673429,73.54253576498853,7
0.2,9157,22,673451,73.53690762175147,11
0.2,9158,90,673541,73.53870509880991,12
0.2,9159,95,673636,73.54104803493449,6
0.2,9160,93,673729,73.54317214277917,9
0.2,9161,23,673752,73.53765553372627,10
0.2,9162,96,673848,73.54010695187166,6
0.2,9163,95,673943,73.54244871235268,7
0.2,9164,26,673969,73.53726132024005,7
0.2,9165,93,674062,73.53938468252237,9
0.2,9166,91,674153,73.5412894076579,10
0.2,9167,22,674175,73.53566753926701,11
0.2,9168,96,674271,73.53811757007307,6
0.2,9169,95,674366,73.54045801526718,7
0.2,9170,95,674461,73.54279795005998,7
0.2,9171,94,674555,73.54502834714349,7
0.2,9172,95,674650,73.54736727352011,7
0.2,9173,92,674742,73.54937867887509,12
0.2,9174,95,674837,73.5517166212534,6
0.2,9175,26,674863,73.54653443766347,8
0.2,9176,95,674958,73.54887218045113,6
0.2,9177,90,675048,73.5506646328176,12
0.2,9178,93,675141,73.5527835276174,11
0.2,9179,23,675164,73.54727668845315,11
0.2,9180,21,675185,73.54155320771157,12
0.2,9181,92,675277,73.5435634937922,10
0.2,9182,93,675370,73.54568223891974,8
0.2,9183,94,675464,73.5479094076655,8
0.2,9184,96,675560,73.55035383777899,6
0.2,9185,96,675656,73.55279773568473,6
0.2,9186,21,675677,73.54707739196691,12
0.2,9187,15,675692,73.54070526774053,18
0.2,9188,89,675781,73.54238763739254,15
0.2,9189,96,675877,73.54483133841131,6
0.2,9190,21,675898,73.53911435099553,12
0.2,9191,93,675991,73.5412315056571,9
0.2,9192,93,676084,73.54334819971717,8
0.2,9193,95,676179,73.54568196649988,7
0.2,9194,-119,676060,73.5247417074497,15
0.2,9195,95,676155,73.52707698999565,9
0.2,9196,23,676178,73.52158312493204,10
0.2,9197,94,676272,73.52380952380952,7
0.2,9198,25,676297,73.51853462332862,8
0.2,9199,95,676392,73.5208695652174,7
0.2,9200,93,676485,73.52298663188783,9
0.2,9201,18,676503,73.51695283633993,14
0.2,9202,84,676587,73.5180919265457,17
0.2,9203,23,676610,73.51260321599305,13
0.2,9204,96,676706,73.51504617055947,6
0.2,9205,93,676799,73.51716271996524,9
0.2,9206,92,676891,73.51917019658956,10
0.2,9207,93,676984,73.5212858384014,9
0.2,9208,89,677073,73.52296666304701,13
0.2,9209,93,677166,73.52508143322476,10
0.2,9210,95,677261,73.52741287590923,7
0.2,9211,94,677355,73.52963525835867,9
0.2,9212,91,677446,73.53153153153153,10
0.2,9213,94,677540,73.53375298458867,8
0.2,9214,88,677628,73.53532284319046,14
0.2,9215,94,677722,73.53754340277777,7
0.2,9216,93,677815,73.53965498535315,9
0.2,9217,96,677911,73.54209155999132,6
0.2,9218,96,678007,73.54452760603102,6
0.2,9219,95,678102,73.5468546637744,6
0.2,9220,95,678197,73.54918121678777,7
0.2,9221,91,678288,73.55107351984385,13
0.2,9222,93,678381,73.55318226173696,9
0.2,9223,92,678473,73.55518213356461,11
0.2,9224,93,678566,73.55728997289972,8
0.2,9225,95,678661,73.55961413396922,6
0.2,9226,20,678681,73.55380947220115,13
0.2,9227,96,678777,73.55624187256177,6
0.2,9228,95,678872,73.55856539170007,6
0.2,9229,96,678968,73.56099674972914,6
0.2,9230,22,678990,73.55541111472213,10
0.2,9231,-47,678943,73.54235268630849,11
0.2,9232,91,679034,73.54424347449367,11
0.2,9233,95,679129,73.54656703487113,6
0.2,9234,90,679219,73.54834867352463,12
0.2,9235,94,679313,73.5505630142919,8
0.2,9236,96,679409,73.55299339612428,6
0.2,9237,94,679503,73.5552067547088,8
0.2,9238,94,679597,73.55741963415954,8
0.2,9239,20,679617,73.55162337662338,12
0.2,9240,93,679710,73.5537279515204,9
0.2,9241,91,679801,73.55561566760441,16
0.2,9242,95,679896,73.55793573515092,7
0.2,9243,94,679990,73.5601471224578,8
0.2,9244,94,680084,73.5623580313683,8
0.2,9245,-53,680031,73.54866969500324,17
0.2,9246,93,680124,73.55077322374824,11
0.2,9247,95,680219,73.55309256055364,6
0.2,9248,93,680312,73.55519515623311,10
0.2,9249,95,680407,73.55751351351351,7
0.2,9250,95,680502,73.55983136958167,7
0.2,9251,95,680597,73.56214872460009,7
0.2,9252,25,680622,73.55690046471415,8
0.2,9253,-51,680571,73.543440674303,15
0.2,9254,92,680663,73.54543490005402,10
0.2,9255,91,680754,73.54732065687122,12
0.2,9256,90,680844,73.5490979799071,12
0.2,9257,90,680934,73.55087491898898,11
0.2,9258,95,681029,73.55319148936171,7
0.2,9259,93,681122,73.55529157667387,9
0.2,9260,25,681147,73.55004859086492,8
0.2,9261,95,681242,73.55236450010797,8
0.2,9262,88,681330,73.5539242146173,13
0.2,9263,94,681424,73.55613126079447,7
0.2,9264,93,681517,73.55822989746358,8
0.2,9265,94,681611,73.56043600259011,7
0.2,9266,93,681704,73.56253372180856,9
0.2,9267,94,681798,73.56473888649116,8
0.2,9268,92,681890,73.56672780235192,10
0.2,9269,24,681914,73.561380798274,9
0.2,9270,23,681937,73.55592708445691,11
0.2,9271,18,681955,73.54993528904228,15
0.2,9272,92,682047,73.55192494338402,10
0.2,9273,94,682141,73.5541298253181,8
0.2,9274,95,682236,73.55644204851752,7
0.2,9275,23,682259,73.55099180681329,10
0.2,9276,20,682279,73.5452193597068,14
0.2,9277,19,682298,73.53934037508084,14
0.2,9278,93,682391,73.5414376549197,9
0.2,9279,96,682487,73.54385775862069,6
0.2,9280,20,682507,73.53808856804224,14
0.2,9281,94,682601,73.54029304029304,8
0.2,9282,26,682627,73.53517181945492,8
0.2,9283,16,682643,73.52897457992245,17
0.2,9284,95,682738,73.53128702207862,7
0.2,9285,20,682758,73.5255222916218,12
0.2,9286,94,682852,73.52772693011737,7
0.2,9287,90,682942,73.52950043066322,14
0.2,9288,95,683037,73.53181182043276,8
0.2,9289,95,683132,73.53412271259418,7
0.2,9290,95,683227,73.53643310730814,6
0.2,9291,25,683252,73.5312096427034,9
0.2,9292,24,683276,73.52587969439362,10
0.2,9293,95,683371,73.52819023025607,6
0.2,9294,93,683464,73.53028509951586,9
0.2,9295,95,683559,73.53259466437177,6
0.2,9296,93,683652,73.53468860922878,8
0.2,9297,90,683742,73.53645945364595,11
0.2,9298,92,683834,73.53844499408538,10
0.2,9299,91,683925,73.54032258064517,11
0.2,9300,26,683951,73.53521126760563,7
0.2,9301,20,683971,73.52945603096109,13
0.2,9302,93,684064,73.5315489627002,8
0.2,9303,95,684159,73.53385640584695,7
0.2,9304,24,684183,73.52853304674906,9
0.2,9305,90,684273,73.53030303030303,12
0.2,9306,95,684368,73.53260986354357,9
0.2,9307,93,684461,73.53470133218737,8
0.2,9308,95,684556,73.53700719733591,7
0.2,9309,95,684651,73.53931256713211,7
0.2,9310,95,684746,73.54161744173558,6
0.2,9311,90,684836,73.54338487972508,11
0.2,9312,26,684862,73.53827982390207,7
0.2,9313,95,684957,73.54058406699592,7
0.2,9314,24,684981,73.5352657004831,8
0.2,9315,90,685071,73.53703306139974,12
0.2,9316,95,685166,73.53933669636149,7
0.2,9317,96,685262,73.54174715604206,6
0.2,9318,93,685355,73.54383517544801,9
0.2,9319,95,685450,73.54613733905579,7
0.2,9320,24,685474,73.54082180023603,8
0.2,9321,94,685568,73.54301652006008,9
0.2,9322,23,685591,73.53759519467982,10
0.2,9323,93,685684,73.53968253968254,9
0.2,9324,92,685776,73.54166219839142,11
0.2,9325,94,685870,73.54385588676817,7
0.2,9326,92,685962,73.54583467352846,10
0.2,9327,95,686057,73.54813464837049,7
0.2,9328,92,686149,73.55011255225641,11
0.2,9329,24,686173,73.54480171489818,8
0.2,9330,94,686267,73.54699389132998,8
0.2,9331,-122,686145,73.52603943420489,18
0.2,9332,91,686236,73.52791171113255,10
0.2,9333,19,686255,73.52206985215342,14
0.2,9334,94,686349,73.52426352437065,7
0.2,9335,92,686441,73.52624250214224,9
0.2,9336,24,686465,73.52093820284888,9
0.2,9337,17,686482,73.51488541443564,17
0.2,9338,93,686575,73.51697183852662,12
0.2,9339,94,686669,73.51916488222697,8
0.2,9340,96,686765,73.52157156621347,6
0.2,9341,95,686860,73.52387069150075,7
0.2,9342,95,686955,73.52616932462806,7
0.2,9343,21,686976,73.52054794520548,11
0.2,9344,95,687071,73.52284644194756,6
0.2,9345,93,687164,73.52493045153007,9
0.2,9346,96,687260,73.52733497378838,6
0.2,9347,88,687348,73.52888318356868,13
0.2,9348,94,687442,73.53107284201519,8
0.2,9349,95,687537,73.53336898395722,7
0.2,9350,90,687627,73.53512993262753,11
0.2,9351,94,687721,73.53731822070145,8
0.2,9352,95,687816,73.53961295840907,8
0.2,9353,92,687908,73.54158648706436,9
0.2,9354,94,688002,73.54377338321753,8
0.2,9355,92,688094,73.54574604531851,11
0.2,9356,94,688188,73.54793202949664,8
0.2,9357,93,688281,73.55001068604403,8
0.2,9358,-196,688085,73.5212095309328,23
0.2,9359,26,688111,73.51613247863249,7
0.2,9360,95,688206,73.51842751842752,7
0.2,9361,95,688301,73.5207220679342,8
0.2,9362,91,688392,73.52258891380967,10
0.2,9363,26,688418,73.517513882956,7
0.2,9364,93,688511,73.51959423384945,8
0.2,9365,91,688602,73.5214606021781,10
0.2,9366,95,688697,73.52375360307462,7
0.2,9367,94,688791,73.52593936806149,7
0.2,9368,93,688884,73.52801793147614,8
0.2,9369,94,688978,73.53020277481323,8
0.2,9370,94,689072,73.53238715185145,8
0.2,9371,94,689166,73.53457106274007,7
0.2,9372,94,689260,73.53675450762829,10
0.2,9373,94,689354,73.53893748666525,8
0.2,9374,93,689447,73.54101333333334,9
0.2,9375,19,689466,73.53519624573379,14
0.2,9376,90,689556,73.53695211688174,11
0.2,9377,20,689576,73.53124333546599,13
0.2,9378,95,689671,73.5335323595266,6
0.2,9379,95,689766,73.53582089552239,6
0.2,9380,95,689861,73.53810894360943,7
0.2,9381,95,689956,73.54039650394373,7
0.2,9382,93,690049,73.54247042523713,9
0.2,9383,93,690142,73.54454390451833,8
0.2,9384,94,690236,73.54672349493873,7
0.2,9385,91,690327,73.54858299595142,11
0.2,9386,92,690419,73.55054863108555,10
0.2,9387,95,690514,73.55283340434598,7
0.2,9388,24,690538,73.54755565022899,9
0.2,9389,89,690627,73.54920127795528,12
0.2,9390,94,690721,73.55137897987434,8
0.2,9391,25,690746,73.54620954003407,9
0.2,9392,91,690837,73.5480677099968,11
0.2,9393,94,690931,73.55024483713008,7
0.2,9394,94,691025,73.5524215007983,8
0.2,9395,91,691116,73.55427841634739,12
0.2,9396,89,691205,73.55592210279876,13
0.2,9397,90,691295,73.55767184507341,12
0.2,9398,92,691387,73.5596340036174,10
0.2,9399,94,691481,73.5618085106383,8
0.2,9400,96,691577,73.56419529837251,6
0.2,9401,95,691672,73.56647521803872,7
0.2,9402,95,691767,73.5687546527704,7
0.2,9403,25,691792,73.56358996171842,8
0.2,9404,95,691887,73.5658692185008,7
0.2,9405,93,691980,73.56793536040826,10
0.2,9406,95,692075,73.57021367067078,7
0.2,9407,95,692170,73.57249149659864,7
0.2,9408,95,692265,73.57476883834626,7
0.2,9409,16,692281,73.56865037194474,19
0.2,9410,91,692372,73.57050260333652,11
0.2,9411,94,692466,73.57267318317042,8
0.2,9412,92,692558,73.57463082970361,11
0.2,9413,92,692650,73.57658806033567,9
0.2,9414,90,692740,73.57833244822092,12
0.2,9415,95,692835,73.58060747663552,6
0.2,9416,93,692928,73.58266964001274,8
0.2,9417,96,693024,73.5850499044383,6
0.2,9418,26,693050,73.57999787663233,7
0.2,9419,87,693137,73.58142250530786,17
0.2,9420,95,693232,73.58369599830166,7
0.2,9421,90,693322,73.58543833580981,11
0.2,9422,95,693417,73.58771092008914,7
0.2,9423,93,693510,73.58977079796264,9
0.2,9424,95,693605,73.59204244031831,9
0.2,9425,91,693696,73.59388924252069,11
0.2,9426,95,693791,73.59615996605496,6
0.2,9427,95,693886,73.59843020789138,7
0.2,9428,92,693978,73.60038180082724,11
0.2,9429,93,694071,73.60243902439025,11
0.2,9430,86,694157,73.60375357862368,16
0.2,9431,94,694251,73.60591603053435,10
0.2,9432,90,694341,73.60765398070603,14
0.2,9433,-46,694295,73.59497562009751,10
0.2,9434,96,694391,73.59735029146793,6
0.2,9435,95,694486,73.5996184824078,7
0.2,9436,95,694581,73.60188619264596,6
0.2,9437,93,694674,73.60394151303242,10
0.2,9438,96,694770,73.60631422820214,6
0.2,9439,91,694861,73.60815677966102,12
0.2,9440,95,694956,73.61042262472196,7
0.2,9441,92,695048,73.61237026053801,9
0.2,9442,23,695071,73.60701048395637,10
0.2,9443,90,695161,73.60874629394324,13
0.2,9444,-53,695108,73.59534145050291,16
0.2,9445,95,695203,73.59760745289012,7
0.2,9446,93,695296,73.59966126812745,8
0.2,9447,93,695389,73.60171464860288,8
0.2,9448,89,695478,73.60334426923484,13
0.2,9449,94,695572,73.60550264550264,7
0.2,9450,91,695663,73.60734313829225,13
0.2,9451,95,695758,73.60960643250105,7
0.2,9452,93,695851,73.61165767481224,8
0.2,9453,90,695941,73.61339115718215,12
0.2,9454,91,696032,73.61523003701745,12
0.2,9455,95,696127,73.61749153976311,7
0.2,9456,22,696149,73.61203341440203,10
0.2,9457,92,696241,73.61397758511313,10
0.2,9458,89,696330,73.61560418648905,12
0.2,9459,24,696354,73.61035940803383,10
0.2,9460,22,696376,73.60490434414967,11
0.2,9461,26,696402,73.5998731769182,7
0.2,9462,96,696498,73.60224030434323,6
0.2,9463,95,696593,73.6045012679628,7
0.2,9464,22,696615,73.59904912836767,10
0.2,9465,93,696708,73.60109866892034,8
0.2,9466,91,696799,73.60293651631984,11
0.2,9467,92,696891,73.60487959442332,9
0.2,9468,95,696986,73.60713908543669,6
0.2,9469,95,697081,73.60939809926083,6
0.2,9470,95,697176,73.61165663604687,6
0.2,9471,92,697268,73.61359797297297,11
0.2,9472,21,697289,73.6080439142827,12
0.2,9473,21,697310,73.60249102807684,12
0.2,9474,22,697332,73.59704485488126,11
0.2,9475,18,697350,73.59117771211481,15
0.2,9476,94,697444,73.59333122296086,8
0.2,9477,94,697538,73.59548427938384,8
0.2,9478,94,697632,73.59763688152759,8
0.2,9479,93,697725,73.5996835443038,10
0.2,9480,24,697749,73.59445206201877,9
0.2,9481,23,697772,73.5891162202067,10
0.2,9482,-53,697719,73.57576716229042,17
0.2,9483,94,697813,73.57792070856179,8
0.2,9484,91,697904,73.57975751186083,10
0.2,9485,96,698000,73.5821210204512,6
0.2,9486,-50,697950,73.56909455043744,14
0.2,9487,93,698043,73.57114249578414,8
0.2,9488,93,698136,73.57319000948466,9
0.2,9489,95,698231,73.5754478398314,8
0.2,9490,22,698253,73.57001369718681,10
0.2,9491,13,698266,73.56363253265908,21
0.2,9492,95,698361,73.56589065627304,6
0.2,9493,94,698455,73.56804297451022,7
0.2,9494,95,698550,73.57030015797788,7
0.2,9495,93,698643,73.57234625105308,8
0.2,9496,93,698736,73.57439191323576,8
0.2,9497,20,698756,73.56875131606654,13
0.2,9498,95,698851,73.571007474471,7
0.2,9499,92,698943,73.57294736842105,9
0.2,9500,91,699034,73.57478160193664,10
0.2,9501,95,699129,73.57703641338665,7
0.2,9502,94,699223,73.57918552036199,8
0.2,9503,22,699245,73.57375841750842,10
0.2,9504,87,699332,73.57517096265124,19
0.2,9505,-50,699282,73.56217126025668,13
0.2,9506,27,699309,73.55727358788262,6
0.2,9507,95,699404,73.55952881783762,6
0.2,9508,90,699494,73.56125775581029,12
0.2,9509,88,699582,73.56277602523659,15
0.2,9510,95,699677,73.56502996530334,6
0.2,9511,94,699771,73.56717830109335,8
0.2,9512,95,699866,73.56943130453064,6
0.2,9513,94,699960,73.57157872608786,8
0.2,9514,93,700053,73.57362059905412,10
0.2,9515,95,700148,73.57587221521648,7
0.2,9516,95,700243,73.57812335820111,6
0.2,9517,96,700339,73.58047909224626,6
0.2,9518,95,700434,73.58272927828554,6
0.2,9519,95,700529,73.58497899159664,7
0.2,9520,93,700622,73.58701817036025,9
0.2,9521,92,700714,73.58895190086116,9
0.2,9522,96,700810,73.59130526094718,6
0.2,9523,94,700904,73.59344813103738,8
0.2,9524,95,700999,73.59569553805774,6
0.2,9525,92,701091,73.5976275456645,10
0.2,9526,91,701182,73.59945418284875,10
0.2,9527,94,701276,73.60159529806884,8
0.2,9528,92,701368,73.60352607828733,9
0.2,9529,94,701462,73.60566631689402,7
0.2,9530,24,701486,73.60046165145316,8
0.2,9531,93,701579,73.60249685270668,11
0.2,9532,24,701603,73.59729361166474,9
0.2,9533,92,701695,73.59922383050136,10
0.2,9534,91,701786,73.60104876769796,10
0.2,9535,95,701881,73.6032927852349,7
0.2,9536,94,701975,73.6054314774038,8
0.2,9537,20,701995,73.59981128119102,13
0.2,9538,94,702089,73.60194988992556,8
0.2,9539,95,702184,73.6041928721174,7
0.2,9540,92,702276,73.60612095168221,9
0.2,9541,93,702369,73.60815342695452,9
0.2,9542,-127,702242,73.58713192916274,24
0.2,9543,94,702336,73.58927074601844,7
0.2,9544,94,702430,73.59140911471975,7
0.2,9545,90,702520,73.59312801173266,12
0.2,9546,95,702615,73.5953702733843,6
0.2,9547,96,702711,73.5977167993297,6
0.2,9548,93,702804,73.59974866478166,9
0.2,9549,95,702899,73.60198952879581,6
0.2,9550,90,702989,73.6037064181761,12
0.2,9551,95,703084,73.60594639865997,7
0.2,9552,94,703178,73.6080812310269,9
0.2,9553,91,703269,73.60990161189031,11
0.2,9554,95,703364,73.61214024071167,7
0.2,9555,20,703384,73.60652992884052,13
0.2,9556,94,703478,73.60866380663388,7
0.2,9557,94,703572,73.61079723791588,8
0.2,9558,93,703665,73.61282560937336,8
0.2,9559,18,703683,73.60700836820084,17
0.2,9560,22,703705,73.60161071017676,10
0.2,9561,94,703799,73.60374398661368,9
0.2,9562,96,703895,73.60608595628987,6
0.2,9563,94,703989,73.60821831869511,8
0.2,9564,94,704083,73.61035023523262,8
0.2,9565,93,704176,73.6123771691407,9
0.2,9566,95,704271,73.61461273126372,7
0.2,9567,93,704364,73.61663879598662,9
0.2,9568,94,704458,73.61876894137319,7
0.2,9569,95,704553,73.62100313479624,6
0.2,9570,95,704648,73.623236861352,6
0.2,9571,92,704740,73.62515670706226,10
0.2,9572,94,704834,73.62728507260002,8
0.2,9573,22,704856,73.6218926258617,11
0.2,9574,24,704880,73.61671018276762,9
0.2,9575,95,704975,73.61894319131162,10
0.2,9576,93,705068,73.62096689986426,8
0.2,9577,92,705160,73.6228857799123,11
0.2,9578,86,705246,73.62417788913248,15
0.2,9579,95,705341,73.62640918580375,7
0.2,9580,93,705434,73.62843127022232,8
0.2,9581,94,705528,73.630557294928,8
0.2,9582,96,705624,73.63289157883753,6
0.2,9583,91,705715,73.63470367278798,10
0.2,9584,93,705808,73.63672404799165,8
0.2,9585,95,705903,73.6389526392656,6
0.2,9586,25,705928,73.63387921143214,8
0.2,9587,92,706020,73.63579474342929,10
0.2,9588,26,706046,73.63082698925852,7
0.2,9589,95,706141,73.63305526590199,8
0.2,9590,95,706236,73.63528307788552,8
0.2,9591,91,706327,73.63709341117598,10
0.2,9592,95,706422,73.63932033774627,7
0.2,9593,96,706518,73.64165103189494,6
0.2,9594,24,706542,73.63647733194372,9
0.2,9595,94,706636,73.6385994164235,8
0.2,9596,93,706729,73.64061685943524,8
0.2,9597,94,706823,73.64273807043134,7
0.2,9598,96,706919,73.64506719449943,6
0.2,9599,92,707011,73.64697916666667,10
0.2,9600,94,707105,73.64909905218207,10
0.2,9601,88,707193,73.65059362632785,13
0.2,9602,90,707283,73.65229615745079,11
0.2,9603,91,707374,73.65410245730945,11
0.2,9604,16,707390,73.64809994794378,17
0.2,9605,21,707411,73.64261919633563,13
0.2,9606,88,707499,73.64411366711772,13
0.2,9607,90,707589,73.64581598667777,12
0.2,9608,96,707685,73.64814236653137,6
0.2,9609,19,707704,73.64245577523413,13
0.2,9610,91,707795,73.64426178337322,11
0.2,9611,95,707890,73.6464835622139,7
0.2,9612,93,707983,73.64849682721315,8
0.2,9613,94,708077,73.65061368837112,8
0.2,9614,26,708103,73.64565782631306,7
0.2,9615,95,708198,73.64787853577371,6
0.2,9616,93,708291,73.64989081834251,8
0.2,9617,-118,708173,73.6299646496153,13
0.2,9618,94,708267,73.63208233704127,8
0.2,9619,24,708291,73.62692307692308,9
0.2,9620,95,708386,73.62914457956553,6
0.2,9621,26,708412,73.62419455414674,7
0.2,9622,94,708506,73.62631196092694,9
0.2,9623,95,708601,73.62853283458021,7
0.2,9624,96,708697,73.63085714285714,6
0.2,9625,91,708788,73.63266154165801,10
0.2,9626,88,708876,73.63415394203801,13
0.2,9627,95,708971,73.63637307852098,6
0.2,9628,90,709061,73.63807248935507,11
0.2,9629,19,709080,73.63239875389408,14
0.2,9630,93,709173,73.63440971861696,9
0.2,9631,27,709200,73.62956810631229,6
0.2,9632,93,709293,73.63157894736842,8
0.2,9633,92,709385,73.63348557193274,9
0.2,9634,90,709475,73.63518422418267,13
0.2,9635,94,709569,73.63729763387298,8
0.2,9636,26,709595,73.63235446715782,7
0.2,9637,-46,709549,73.61994189665906,10
0.2,9638,93,709642,73.62195248469759,9
0.2,9639,92,709734,73.62385892116183,10
0.2,9640,93,709827,73.62586868582098,9
0.2,9641,93,709920,73.62787803360298,9
0.2,9642,92,710012,73.62978326247018,12
0.2,9643,94,710106,73.63189547905434,8
0.2,9644,-45,710061,73.61959564541213,8
0.2,9645,88,710149,73.62108646070911,15
0.2,9646,23,710172,73.61583912097025,10
0.2,9647,91,710263,73.61764096185738,10
0.2,9648,92,710355,73.61954606694994,9
0.2,9649,92,710447,73.62145077720207,9
0.2,9650,94,710541,73.62356232514766,9
0.2,9651,95,710636,73.62577704102776,6
0.2,9652,19,710655,73.62011809800062,13
0.2,9653,96,710751,73.62243629583593,6
0.2,9654,95,710846,73.62465044018643,7
0.2,9655,94,710940,73.62676056338029,9
0.2,9656,91,711031,73.62855959407683,11
0.2,9657,93,711124,73.63056533443778,8
0.2,9658,95,711219,73.63277772026089,7
0.2,9659,15,711234,73.62670807453416,18
0.2,9660,93,711327,73.62871338370769,8
0.2,9661,90,711417,73.63040778306768,13
0.2,9662,95,711512,73.63261926937804,7
0.2,9663,20,711532,73.62706953642385,13
0.2,9664,95,711627,73.6292809105018,7
0.2,9665,-46,711581,73.61690461411132,10
0.2,9666,96,711677,73.61922002689562,7
0.2,9667,-119,711558,73.5992966487381,15
0.2,9668,21,711579,73.5938566552901,12
0.2,9669,27,711606,73.58903826266804,6
0.2,9670,96,711702,73.59135559921414,6
0.2,9671,95,711797,73.59356906534326,7
0.2,9672,26,711823,73.58864881629277,8
0.2,9673,20,711843,73.58310936530907,14
0.2,9674,21,711864,73.57767441860464,12
0.2,9675,91,711955,73.57947498966514,10
0.2,9676,92,712047,73.58137852640282,9
0.2,9677,94,712141,73.5834883240339,7
0.2,9678,92,712233,73.5853910527947,11
0.2,9679,95,712328,73.58760330578512,6
0.2,9680,94,712422,73.58971180663154,7
0.2,9681,93,712515,73.59171658748193,10
0.2,9682,95,712610,73.59392750180729,6
0.2,9683,22,712632,73.58859975216852,10
0.2,9684,95,712727,73.59081053175012,7
0.2,9685,95,712822,73.59302085484204,8
0.2,9686,93,712915,73.59502425931662,10
0.2,9687,94,713009,73.59713047068539,8
0.2,9688,92,713101,73.5990298276396,10
0.2,9689,24,713125,73.59391124871001,10
0.2,9690,96,713221,73.59622329996904,6
0.2,9691,91,713312,73.59801898472968,11
0.2,9692,92,713404,73.59991746621273,10
0.2,9693,-50,713354,73.58716731999175,14
0.2,9694,96,713450,73.58947911294482,6
0.2,9695,95,713545,73.59168729372938,7
0.2,9696,90,713635,73.59337939568938,11
0.2,9697,94,713729,73.59548360486698,8
0.2,9698,21,713750,73.5900608310135,11
0.2,9699,21,713771,73.58463917525773,12
0.2,9700,23,713794,73.57942480156684,10
0.2,9701,24,713818,73.57431457431457,9
0.2,9702,93,713911,73.57631660311245,8
0.2,9703,91,714002,73.57811211871393,11
0.2,9704,95,714097,73.58031942297785,7
0.2,9705,96,714193,73.58262930146302,6
0.2,9706,95,714288,73.58483568558772,7
0.2,9707,95,714383,73.58704161516275,7
0.2,9708,93,714476,73.58904109589041,8
0.2,9709,16,714492,73.58311019567456,17
0.2,9710,94,714586,73.58521264545361,7
0.2,9711,92,714678,73.58710873146623,10
0.2,9712,96,714774,73.58941624626789,6
0.2,9713,94,714868,73.59151739757051,9
0.2,9714,95,714963,73.5937210499228,7
0.2,9715,93,715056,73.59571840263483,8
0.2,9716,95,715151,73.59792116908511,7
0.2,9717,92,715243,73.59981477670303,10
0.2,9718,-46,715197,73.58750900298385,11
0.2,9719,96,715293,73.58981481481482,6
0.2,9720,22,715315,73.58450776669066,11
0.2,9721,90,715405,73.58619625591442,11
0.2,9722,95,715500,73.58839864239432,6
0.2,9723,-50,715450,73.57568901686548,15
0.2,9724,95,715545,73.57789203084833,7
0.2,9725,90,715635,73.57958050586058,12
0.2,9726,93,715728,73.58157705356226,9
0.2,9727,92,715820,73.58347039473684,10
0.2,9728,93,715913,73.58546613218213,9
0.2,9729,26,715939,73.58057553956834,7
0.2,9730,95,716034,73.58277669304286,6
0.2,9731,25,716059,73.57778462803124,8
0.2,9732,95,716154,73.57998561594574,7
0.2,9733,23,716177,73.57478939798644,10
0.2,9734,94,716271,73.5768875192604,8
0.2,9735,20,716291,73.57138455217749,12
0.2,9736,25,716316,73.56639622060183,8
0.2,9737,23,716339,73.56120353255288,9
0.2,9738,-54,716285,73.54810555498511,18
0.2,9739,91,716376,73.54989733059548,11
0.2,9740,-47,716329,73.53752181500873,11
0.2,9741,92,716421,73.53941695750359,10
0.2,9742,95,716516,73.54161962434569,7
0.2,9743,91,716607,73.54341133004927,11
0.2,9744,93,716700,73.54540790148795,9
0.2,9745,95,716795,73.54760927560025,6
0.2,9746,25,716820,73.54262850107726,8
0.2,9747,96,716916,73.54493229380385,6
0.2,9748,96,717012,73.54723561390912,6
0.2,9749,25,717037,73.54225641025641,10
0.2,9750,91,717128,73.54404676443441,11
0.2,9751,90,717218,73.54573420836752,12
0.2,9752,95,717313,73.54793396903517,7
0.2,9753,92,717405,73.54982571252819,10
0.2,9754,22,717427,73.54454126089185,11
0.2,9755,95,717522,73.54674046740467,7
0.2,9756,94,717616,73.54883673260224,8
0.2,9757,93,717709,73.55083008813281,9
0.2,9758,19,717728,73.54524029101343,14
0.2,9759,91,717819,73.54702868852459,11
0.2,9760,94,717913,73.54912406515726,7
0.2,9761,-44,717869,73.53708256504815,8
0.2,9762,96,717965,73.53938338625423,6
0.2,9763,26,717991,73.53451454322,6
0.2,9764,96,718087,73.53681515617,6
0.2,9765,94,718181,73.53891050583658,8
0.2,9766,94,718275,73.54100542643596,8
0.2,9767,27,718302,73.53624078624078,6
0.2,9768,95,718397,73.53843791585628,6
0.2,9769,96,718493,73.54073694984646,7
0.2,9770,91,718584,73.54252379490329,10
0.2,9771,94,718678,73.54461727384364,8
0.2,9772,94,718772,73.54671032436305,8
0.2,9773,-122,718650,73.52670349907919,16
0.2,9774,94,718744,73.5287979539642,7
0.2,9775,94,718838,73.53089198036007,7
0.2,9776,24,718862,73.52582591797075,9
0.2,9777,93,718955,73.52781754960114,9
0.2,9778,90,719045,73.52950199406892,12
0.2,9779,86,719131,73.53077709611452,16
0.2,9780,94,719225,73.53286984970862,7
0.2,9781,94,719319,73.53496217542425,7
0.2,9782,93,719412,73.53695185525912,10
0.2,9783,94,719506,73.53904333605887,8
0.2,9784,94,719600,73.54113438937149,8
0.2,9785,95,719695,73.54332720212548,7
0.2,9786,94,719789,73.54541739041586,8
0.2,9787,16,719805,73.53953821005312,17
0.2,9788,24,719829,73.53447747471652,9
0.2,9789,92,719921,73.53636363636363,9
0.2,9790,93,720014,73.53835154733939,9
0.2,9791,93,720107,73.54033905228758,10
0.2,9792,95,720202,73.54253037884203,6
0.2,9793,24,720226,73.53747192158464,10
0.2,9794,96,720322,73.53976518631956,7
0.2,9795,96,720418,73.54205798285014,6
0.2,9796,95,720513,73.54424823925692,6
0.2,9797,95,720608,73.54643804858134,7
0.2,9798,26,720634,73.5415858761098,7
0.2,9799,96,720730,73.54387755102042,6
0.2,9800,93,720823,73.54586266707479,10
0.2,9801,90,720913,73.54754131809835,12
0.2,9802,89,721002,73.549117617056,13
0.2,9803,89,721091,73.55069359445125,14
0.2,9804,92,721183,73.55257521672615,10
0.2,9805,93,721276,73.55455843361207,10
0.2,9806,23,721299,73.54940348730499,10
0.2,9807,95,721394,73.55159053833606,7
0.2,9808,21,721415,73.54623305127944,12
0.2,9809,95,721510,73.54841997961265,7
0.2,9810,93,721603,73.55040260931608,8
0.2,9811,93,721696,73.55238483489605,9
0.2,9812,95,721791,73.55457046774687,8
0.2,9813,94,721885,73.55665375993479,8
0.2,9814,94,721979,73.5587366276108,9
0.2,9815,95,722074,73.56092094539527,7
0.2,9816,95,722169,73.56310481817256,8
0.2,9817,94,722263,73.56518639234059,8
0.2,9818,94,722357,73.5672675425196,8
0.2,9819,94,722451,73.56934826883911,8
0.2,9820,92,722543,73.5712249261786,9
0.2,9821,93,722636,73.57320301364284,9
0.2,9822,95,722731,73.57538430214802,7
0.2,9823,95,722826,73.5775651465798,6
0.2,9824,93,722919,73.57954198473283,9
0.2,9825,93,723012,73.581518420517,9
0.2,9826,95,723107,73.58369797496692,7
0.2,9827,93,723200,73.58567358567359,8
0.2,9828,93,723293,73.58764879438397,8
0.2,9829,91,723384,73.58942014242116,10
0.2,9830,93,723477,73.59139456820263,8
0.2,9831,21,723498,73.58604556550041,13
0.2,9832,93,723591,73.58801993287908,8
0.2,9833,93,723684,73.58999389871873,8
0.2,9834,96,723780,73.59227249618709,6
0.2,9835,95,723875,73.59444896299308,6
0.2,9836,88,723963,73.59591338822811,15
0.2,9837,92,724055,73.59778410245985,11
0.2,9838,93,724148,73.59975607277163,9
0.2,9839,94,724242,73.60182926829269,7
0.2,9840,-53,724189,73.58896453612438,19
0.2,9841,91,724280,73.59073359073359,10
0.2,9842,96,724376,73.59301026109925,6
0.2,9843,95,724471,73.59518488419342,7
0.2,9844,96,724567,73.59746063991874,6
0.2,9845,24,724591,73.59242331911436,9
0.2,9846,94,724685,73.59449578551843,8
0.2,9847,23,724708,73.589358245329,11
0.2,9848,93,724801,73.59132906894101,8
0.2,9849,94,724895,73.59340101522842,8
0.2,9850,22,724917,73.58816363820932,13
0.2,9851,95,725012,73.59033698741372,7
0.2,9852,95,725107,73.59250989546331,7
0.2,9853,94,725201,73.59458088086056,7
0.2,9854,24,725225,73.58954845256216,9
0.2,9855,95,725320,73.59172077922078,7
0.2,9856,95,725415,73.59389266511108,6
0.2,9857,25,725440,73.58896327855548,9
0.2,9858,-48,725392,73.5766304899077,12
0.2,9859,94,725486,73.57870182555781,7
0.2,9860,-50,725436,73.56616975965926,14
0.2,9861,93,725529,73.56814033664571,12
0.2,9862,93,725622,73.57011051404238,8
0.2,9863,96,725718,73.57238442822384,6
0.2,9864,93,725811,73.57435377597567,9
0.2,9865,93,725904,73.57632272450842,9
0.2,9866,94,725998,73.57839262187088,8
0.2,9867,95,726093,73.58056343737333,6
0.2,9868,93,726186,73.58253115817206,9
0.2,9869,23,726209,73.5774062816616,9
0.2,9870,25,726234,73.57248505723838,9
0.2,9871,-48,726186,73.56017017828201,12
0.2,9872,94,726280,73.56224045376278,8
0.2,9873,96,726376,73.56451286206197,6
0.2,9874,23,726399,73.55939240506329,9
0.2,9875,93,726492,73.56136087484812,8
0.2,9876,94,726586,73.56343019135365,8
0.2,9877,92,726678,73.56529661874873,11
0.2,9878,92,726770,73.56716266828626,10
0.2,9879,95,726865,73.56933198380567,6
0.2,9880,94,726959,73.57139965590527,9
0.2,9881,96,727055,73.57366929771301,6
0.2,9882,95,727150,73.5758372963675,6
0.2,9883,94,727244,73.57790368271955,8
0.2,9884,94,727338,73.57996965098634,7
0.2,9885,95,727433,73.58213635444062,6
0.2,9886,96,727529,73.58440376251643,6
0.2,9887,26,727555,73.57959142394822,7
0.2,9888,93,727648,73.58155526342401,8
0.2,9889,95,727743,73.58372093023256,6
0.2,9890,95,727838,73.58588615913456,8
0.2,9891,95,727933,73.58805095026284,7
0.2,9892,17,727950,73.58233094106944,17
0.2,9893,23,727973,73.5772185162725,10
0.2,9894,92,728065,73.57908034360788,10
0.2,9895,93,728158,73.58104284559418,9
0.2,9896,26,728184,73.57623522279479,6
0.2,9897,96,728280,73.57850070721358,6
0.2,9898,17,728297,73.5727851298111,16
0.2,9899,25,728322,73.56787878787878,8
0.2,9900,88,728410,73.56933643066357,18
0.2,9901,94,728504,73.57139971722884,9
0.2,9902,23,728527,73.56629304251237,11
0.2,9903,96,728623,73.56855815831987,6
0.2,9904,92,728715,73.57041898031298,10
0.2,9905,94,728809,73.57248132444983,7
0.2,9906,94,728903,73.57454325224589,8
0.2,9907,95,728998,73.5767056923698,6
0.2,9908,95,729093,73.57886769603391,7
0.2,9909,94,729187,73.58092835519678,8
0.2,9910,92,729279,73.58278680254263,9
0.2,9911,92,729371,73.58464487489911,10
0.2,9912,96,729467,73.58690608292142,6
0.2,9913,93,729560,73.58886423239863,10
0.2,9914,95,729655,73.59102370146243,7
0.2,9915,20,729675,73.58561920129084,12
0.2,9916,95,729770,73.58777856206514,6
0.2,9917,93,729863,73.58973583383747,11
0.2,9918,90,729953,73.59139026111504,11
0.2,9919,95,730048,73.59354838709677,7
0.2,9920,22,730070,73.58834794879549,11
0.2,9921,93,730163,73.59030437411812,8
0.2,9922,96,730259,73.59256273304445,6
0.2,9923,95,730354,73.59471987101975,7
0.2,9924,94,730448,73.5967758186398,8
0.2,9925,94,730542,73.59883135200484,9
0.2,9926,90,730632,73.6004835297673,12
0.2,9927,93,730725,73.60243755036261,9
0.2,9928,95,730820,73.60459260751334,7
0.2,9929,95,730915,73.6067472306143,7
0.2,9930,96,731011,73.60900211459068,6
0.2,9931,94,731105,73.6110551751913,8
0.2,9932,92,731197,73.6129064733716,10
0.2,9933,89,731286,73.61445540567748,12
0.2,9934,96,731382,73.6167086059386,6
0.2,9935,26,731408,73.61191626409018,7
0.2,9936,93,731501,73.61386736439569,8
0.2,9937,26,731527,73.60907627289193,7
0.2,9938,92,731619,73.61092665258074,10
0.2,9939,16,731635,73.60513078470825,17
0.2,9940,92,731727,73.60698118901519,10
0.2,9941,26,731753,73.60219271776303,7
0.2,9942,95,731848,73.60434476516141,7
0.2,9943,95,731943,73.60649637972647,8
0.2,9944,26,731969,73.6017094017094,6
0.2,9945,96,732065,73.60396139151418,6
0.2,9946,-47,732018,73.59183673469387,11
0.2,9947,95,732113,73.59398874145558,6
0.2,9948,96,732209,73.59624082822394,6
0.2,9949,93,732302,73.59819095477387,9
0.2,9950,90,732392,73.59983921213949,12
0.2,9951,19,732411,73.59435289389067,14
0.2,9952,92,732503,73.5962021501055,17
0.2,9953,94,732597,73.59825195901145,7
0.2,9954,95,732692,73.60040180813661,6
0.2,9955,94,732786,73.60245078344717,8
0.2,9956,94,732880,73.60449934719293,9
0.2,9957,92,732972,73.60634665595501,9
0.2,9958,95,733067,73.60849482879807,6
0.2,9959,96,733163,73.61074297188755,6
0.2,9960,90,733253,73.61238831442627,11
0.2,9961,93,733346,73.61433447098976,9
0.2,9962,91,733437,73.61607949412827,12
0.2,9963,21,733458,73.61079887595344,12
0.2,9964,25,733483,73.60592072252885,9
0.2,9965,95,733578,73.60806742925948,6
0.2,9966,94,733672,73.61011337413464,8
0.2,9967,94,733766,73.61215890850723,7
0.2,9968,93,733859,73.61410372153676,9
0.2,9969,92,733951,73.61594784353059,10
0.2,9970,23,733974,73.61087152742955,9
0.2,9971,90,734064,73.61251504211793,11
0.2,9972,96,734160,73.61475985159932,6
0.2,9973,93,734253,73.61670342891517,9
0.2,9974,94,734347,73.61874686716791,7
0.2,9975,91,734438,73.62048917401765,11
0.2,9976,94,734532,73.62253182319334,7
0.2,9977,90,734622,73.6241731809982,13
0.2,9978,94,734716,73.62621505160838,8
0.2,9979,23,734739,73.62114228456913,11
0.2,9980,94,734833,73.62318404969442,8
0.2,9981,95,734928,73.6253255860549,7
0.2,9982,90,735018,73.62696584193128,15
0.2,9983,92,735110,73.62880608974359,10
0.2,9984,21,735131,73.62353530295444,12
0.2,9985,92,735223,73.62537552573603,10
0.2,9986,21,735244,73.62010613797938,13
0.2,9987,96,735340,73.62234681617942,6
0.2,9988,93,735433,73.62428671538693,11
0.2,9989,92,735525,73.62612612612612,9
0.2,9990,92,735617,73.62796516865178,10
0.2,9991,92,735709,73.62980384307446,11
0.2,9992,94,735803,73.63184228960272,7
0.2,9993,21,735824,73.62657594556734,13
0.2,9994,91,735915,73.62831415707853,12
0.2,9995,94,736009,73.63035214085635,8
0.2,9996,95,736104,73.63248974692408,6
0.2,9997,96,736200,73.63472694538908,6
0.2,9998,91,736291,73.63646364636463,10
0.2,9999,95,736386,73.6386,7
