0.05,0,-157,-157,-157.0,55
0.05,1,-9,-166,-83.0,107
0.05,2,25,-141,-47.0,8
0.05,3,80,-61,-15.25,31
0.05,4,93,32,6.4,9
0.05,5,94,126,21.0,8
0.05,6,21,147,21.0,12
0.05,7,81,228,28.5,27
0.05,8,95,323,35.888888888888886,6
0.05,9,88,411,41.1,13
0.05,10,83,494,44.90909090909091,20
0.05,11,82,576,48.0,42
0.05,12,96,672,51.69230769230769,6
0.05,13,-46,626,44.714285714285715,11
0.05,14,94,720,48.0,9
0.05,15,95,815,50.9375,6
0.05,16,90,905,53.23529411764706,56
0.05,17,95,1000,55.55555555555556,6
0.05,18,17,1017,53.526315789473685,27
0.05,19,91,1108,55.4,10
0.05,20,94,1202,57.23809523809524,7
0.05,21,94,1296,58.90909090909091,7
0.05,22,94,1390,60.43478260869565,7
0.05,23,93,1483,61.791666666666664,8
0.05,24,95,1578,63.12,17
0.05,25,94,1672,64.3076923076923,7
0.05,26,95,1767,65.44444444444444,6
0.05,27,93,1860,66.42857142857143,9
0.05,28,91,1951,67.27586206896552,10
0.05,29,94,2045,68.16666666666667,7
0.05,30,94,2139,69.0,7
0.05,31,93,2232,69.75,8
0.05,32,92,2324,70.42424242424242,10
0.05,33,91,2415,71.02941176470588,10
0.05,34,92,2507,71.62857142857143,9
0.05,35,93,2600,72.22222222222223,8
0.05,36,93,2693,72.78378378378379,8
0.05,37,92,2785,73.28947368421052,10
0.05,38,94,2879,73.82051282051282,7
0.05,39,18,2897,72.425,16
0.05,40,93,2990,72.92682926829268,8
0.05,41,93,3083,73.4047619047619,9
0.05,42,90,3173,73.79069767441861,12
0.05,43,92,3265,74.20454545454545,9
0.05,44,94,3359,74.64444444444445,7
0.05,45,92,3451,75.02173913043478,9
0.05,46,93,3544,75.40425531914893,10
0.05,47,93,3637,75.77083333333333,9
0.05,48,93,3730,76.12244897959184,8
0.05,49,95,3825,76.5,6
0.05,50,92,3917,76.80392156862744,10
0.05,51,93,4010,77.11538461538461,8
0.05,52,92,4102,77.39622641509433,9
0.05,53,95,4197,77.72222222222223,6
0.05,54,93,4290,78.0,8
0.05,55,94,4384,78.28571428571429,8
0.05,56,94,4478,78.56140350877193,7
0.05,57,93,4571,78.8103448275862,8
0.05,58,93,4664,79.05084745762711,8
0.05,59,94,4758,79.3,8
0.05,60,94,4852,79.54098360655738,7
0.05,61,24,4876,78.64516129032258,8
0.05,62,94,4970,78.88888888888889,7
0.05,63,94,5064,79.125,8
0.05,64,96,5160,79.38461538461539,6
0.05,65,93,5253,79.5909090909091,8
0.05,66,93,5346,79.7910447761194,8
0.05,67,24,5370,78.97058823529412,8
0.05,68,92,5462,79.15942028985508,9
0.05,69,92,5554,79.34285714285714,9
0.05,70,93,5647,79.53521126760563,9
0.05,71,94,5741,79.73611111111111,9
0.05,72,93,5834,79.91780821917808,9
0.05,73,94,5928,80.10810810810811,8
0.05,74,93,6021,80.28,8
0.05,75,23,6044,79.52631578947368,10
0.05,76,95,6139,79.72727272727273,6
0.05,77,96,6235,79.93589743589743,6
0.05,78,94,6329,80.11392405063292,7
0.05,79,-51,6278,78.475,14
0.05,80,94,6372,78.66666666666667,7
0.05,81,93,6465,78.84146341463415,8
0.05,82,96,6561,79.04819277108433,6
0.05,83,95,6656,79.23809523809524,6
0.05,84,96,6752,79.43529411764706,6
0.05,85,94,6846,79.6046511627907,7
0.05,86,94,6940,79.77011494252874,8
0.05,87,21,6961,79.10227272727273,11
0.05,88,96,7057,79.29213483146067,6
0.05,89,87,7144,79.37777777777778,14
0.05,90,95,7239,79.54945054945055,7
0.05,91,94,7333,79.70652173913044,8
0.05,92,95,7428,79.87096774193549,6
0.05,93,95,7523,80.03191489361703,6
0.05,94,95,7618,80.18947368421053,6
0.05,95,95,7713,80.34375,7
0.05,96,96,7809,80.50515463917526,6
0.05,97,94,7903,80.64285714285714,7
0.05,98,93,7996,80.76767676767676,8
0.05,99,91,8087,80.87,10
0.05,100,19,8106,80.25742574257426,13
0.05,101,21,8127,79.67647058823529,12
0.05,102,92,8219,79.79611650485437,9
0.05,103,94,8313,79.9326923076923,7
0.05,104,21,8334,79.37142857142857,12
0.05,105,23,8357,78.83962264150944,9
0.05,106,92,8449,78.96261682242991,9
0.05,107,95,8544,79.11111111111111,6
0.05,108,27,8571,78.63302752293578,6
0.05,109,95,8666,78.78181818181818,7
0.05,110,96,8762,78.93693693693693,6
0.05,111,93,8855,79.0625,10
0.05,112,27,8882,78.60176991150442,6
0.05,113,94,8976,78.73684210526316,7
0.05,114,94,9070,78.8695652173913,7
0.05,115,23,9093,78.38793103448276,9
0.05,116,94,9187,78.52136752136752,8
0.05,117,94,9281,78.65254237288136,7
0.05,118,94,9375,78.78151260504201,7
0.05,119,96,9471,78.925,6
0.05,120,25,9496,78.47933884297521,8
0.05,121,92,9588,78.59016393442623,9
0.05,122,90,9678,78.6829268292683,11
0.05,123,96,9774,78.8225806451613,6
0.05,124,95,9869,78.952,7
0.05,125,93,9962,79.06349206349206,8
0.05,126,95,10057,79.18897637795276,7
0.05,127,96,10153,79.3203125,6
0.05,128,94,10247,79.43410852713178,7
0.05,129,94,10341,79.54615384615384,7
0.05,130,94,10435,79.65648854961832,7
0.05,131,92,10527,79.75,9
0.05,132,93,10620,79.84962406015038,8
0.05,133,93,10713,79.94776119402985,8
0.05,134,96,10809,80.06666666666666,6
0.05,135,93,10902,80.16176470588235,8
0.05,136,96,10998,80.27737226277372,6
0.05,137,96,11094,80.3913043478261,6
0.05,138,94,11188,80.48920863309353,7
0.05,139,95,11283,80.59285714285714,6
0.05,140,92,11375,80.67375886524823,9
0.05,141,93,11468,80.7605633802817,8
0.05,142,94,11562,80.85314685314685,7
0.05,143,94,11656,80.94444444444444,7
0.05,144,27,11683,80.57241379310345,6
0.05,145,93,11776,80.65753424657534,8
0.05,146,96,11872,80.76190476190476,6
0.05,147,92,11964,80.83783783783784,9
0.05,148,94,12058,80.9261744966443,7
0.05,149,94,12152,81.01333333333334,7
0.05,150,96,12248,81.11258278145695,6
0.05,151,94,12342,81.19736842105263,7
0.05,152,96,12438,81.29411764705883,6
0.05,153,92,12530,81.36363636363636,9
0.05,154,25,12555,81.0,8
0.05,155,95,12650,81.08974358974359,6
0.05,156,95,12745,81.17834394904459,6
0.05,157,94,12839,81.25949367088607,7
0.05,158,94,12933,81.33962264150944,8
0.05,159,26,12959,80.99375,7
0.05,160,96,13055,81.08695652173913,6
0.05,161,94,13149,81.16666666666667,8
0.05,162,95,13244,81.25153374233129,6
0.05,163,92,13336,81.3170731707317,9
0.05,164,95,13431,81.4,6
0.05,165,96,13527,81.48795180722891,6
0.05,166,96,13623,81.57485029940119,6
0.05,167,94,13717,81.64880952380952,7
0.05,168,96,13813,81.73372781065089,6
0.05,169,94,13907,81.80588235294118,7
0.05,170,94,14001,81.87719298245614,7
0.05,171,96,14097,81.95930232558139,6
0.05,172,96,14193,82.04046242774567,6
0.05,173,26,14219,81.7183908045977,7
0.05,174,88,14307,81.75428571428571,13
0.05,175,94,14401,81.82386363636364,7
0.05,176,25,14426,81.50282485875707,8
0.05,177,94,14520,81.57303370786516,7
0.05,178,92,14612,81.63128491620111,9
0.05,179,96,14708,81.71111111111111,6
0.05,180,94,14802,81.77900552486187,8
0.05,181,94,14896,81.84615384615384,7
0.05,182,92,14988,81.90163934426229,9
0.05,183,95,15083,81.97282608695652,6
0.05,184,94,15177,82.03783783783784,7
0.05,185,23,15200,81.72043010752688,10
0.05,186,94,15294,81.78609625668449,7
0.05,187,94,15388,81.85106382978724,9
0.05,188,95,15483,81.92063492063492,6
0.05,189,94,15577,81.98421052631579,7
0.05,190,94,15671,82.04712041884817,7
0.05,191,94,15765,82.109375,7
0.05,192,93,15858,82.16580310880829,8
0.05,193,92,15950,82.21649484536083,9
0.05,194,93,16043,82.27179487179487,8
0.05,195,94,16137,82.33163265306122,7
0.05,196,95,16232,82.39593908629442,7
0.05,197,95,16327,82.45959595959596,6
0.05,198,90,16417,82.49748743718592,11
0.05,199,94,16511,82.555,7
0.05,200,93,16604,82.60696517412936,8
0.05,201,94,16698,82.66336633663366,7
0.05,202,93,16791,82.71428571428571,8
0.05,203,20,16811,82.40686274509804,12
0.05,204,94,16905,82.46341463414635,7
0.05,205,96,17001,82.52912621359224,6
0.05,206,94,17095,82.58454106280193,7
0.05,207,92,17187,82.6298076923077,9
0.05,208,94,17281,82.6842105263158,7
0.05,209,92,17373,82.72857142857143,9
0.05,210,93,17466,82.77725118483413,8
0.05,211,93,17559,82.8254716981132,8
0.05,212,94,17653,82.87793427230046,8
0.05,213,93,17746,82.92523364485982,8
0.05,214,96,17842,82.9860465116279,6
0.05,215,94,17936,83.03703703703704,8
0.05,216,95,18031,83.09216589861751,6
0.05,217,96,18127,83.15137614678899,6
0.05,218,93,18220,83.19634703196347,8
0.05,219,96,18316,83.25454545454545,6
0.05,220,95,18411,83.3076923076923,6
0.05,221,94,18505,83.35585585585585,7
0.05,222,93,18598,83.39910313901345,8
0.05,223,94,18692,83.44642857142857,7
0.05,224,90,18782,83.47555555555556,11
0.05,225,93,18875,83.51769911504425,8
0.05,226,94,18969,83.56387665198238,7
0.05,227,96,19065,83.61842105263158,6
0.05,228,94,19159,83.66375545851528,7
0.05,229,95,19254,83.71304347826087,6
0.05,230,94,19348,83.75757575757575,7
0.05,231,93,19441,83.79741379310344,8
0.05,232,94,19535,83.8412017167382,7
0.05,233,91,19626,83.87179487179488,11
0.05,234,93,19719,83.91063829787234,8
0.05,235,92,19811,83.94491525423729,9
0.05,236,95,19906,83.9915611814346,6
0.05,237,94,20000,84.03361344537815,7
0.05,238,21,20021,83.76987447698745,11
0.05,239,94,20115,83.8125,7
0.05,240,94,20209,83.85477178423237,7
0.05,241,96,20305,83.90495867768595,6
0.05,242,23,20328,83.65432098765432,10
0.05,243,23,20351,83.40573770491804,9
0.05,244,92,20443,83.44081632653061,9
0.05,245,95,20538,83.48780487804878,6
0.05,246,93,20631,83.52631578947368,8
0.05,247,93,20724,83.56451612903226,8
0.05,248,94,20818,83.60642570281125,7
0.05,249,94,20912,83.648,7
0.05,250,95,21007,83.69322709163346,7
0.05,251,94,21101,83.73412698412699,7
0.05,252,95,21196,83.77865612648222,6
0.05,253,94,21290,83.81889763779527,7
0.05,254,94,21384,83.85882352941177,7
0.05,255,94,21478,83.8984375,7
0.05,256,96,21574,83.94552529182879,6
0.05,257,95,21669,83.98837209302326,6
0.05,258,94,21763,84.02702702702703,7
0.05,259,95,21858,84.06923076923077,6
0.05,260,96,21954,84.11494252873563,6
0.05,261,92,22046,84.14503816793894,9
0.05,262,94,22140,84.18250950570342,7
0.05,263,93,22233,84.2159090909091,8
0.05,264,96,22329,84.26037735849057,6
0.05,265,96,22425,84.30451127819549,6
0.05,266,94,22519,84.34082397003745,7
0.05,267,94,22613,84.3768656716418,7
0.05,268,94,22707,84.41263940520446,7
0.05,269,94,22801,84.44814814814815,7
0.05,270,94,22895,84.48339483394834,7
0.05,271,94,22989,84.51838235294117,7
0.05,272,95,23084,84.55677655677655,6
0.05,273,94,23178,84.5912408759124,7
0.05,274,95,23273,84.6290909090909,6
0.05,275,94,23367,84.66304347826087,7
0.05,276,94,23461,84.69675090252707,7
0.05,277,94,23555,84.73021582733813,8
0.05,278,95,23650,84.76702508960574,8
0.05,279,94,23744,84.8,7
0.05,280,95,23839,84.83629893238434,7
0.05,281,95,23934,84.87234042553192,7
0.05,282,96,24030,84.91166077738517,6
0.05,283,92,24122,84.93661971830986,9
0.05,284,96,24218,84.97543859649123,6
0.05,285,95,24313,85.0104895104895,6
0.05,286,95,24408,85.04529616724739,8
0.05,287,95,24503,85.07986111111111,6
0.05,288,90,24593,85.09688581314879,12
0.05,289,94,24687,85.12758620689655,7
0.05,290,93,24780,85.15463917525773,8
0.05,291,94,24874,85.18493150684931,7
0.05,292,95,24969,85.2184300341297,6
0.05,293,94,25063,85.24829931972789,7
0.05,294,94,25157,85.27796610169491,7
0.05,295,93,25250,85.30405405405405,8
0.05,296,94,25344,85.33333333333333,7
0.05,297,96,25440,85.36912751677852,6
0.05,298,96,25536,85.40468227424749,6
0.05,299,94,25630,85.43333333333334,7
0.05,300,93,25723,85.45847176079734,8
0.05,301,96,25819,85.49337748344371,6
0.05,302,94,25913,85.52145214521452,7
0.05,303,95,26008,85.55263157894737,6
0.05,304,92,26100,85.57377049180327,10
0.05,305,95,26195,85.60457516339869,7
0.05,306,94,26289,85.63192182410424,8
0.05,307,93,26382,85.65584415584415,8
0.05,308,93,26475,85.67961165048544,8
0.05,309,94,26569,85.70645161290322,8
0.05,310,89,26658,85.71704180064309,12
0.05,311,96,26754,85.75,6
0.05,312,94,26848,85.77635782747603,7
0.05,313,19,26867,85.56369426751593,13
0.05,314,93,26960,85.58730158730158,8
0.05,315,93,27053,85.61075949367088,8
0.05,316,23,27076,85.41324921135647,9
0.05,317,95,27171,85.44339622641509,6
0.05,318,96,27267,85.47648902821317,6
0.05,319,24,27291,85.284375,8
0.05,320,95,27386,85.31464174454828,6
0.05,321,96,27482,85.34782608695652,6
0.05,322,23,27505,85.15479876160991,10
0.05,323,94,27599,85.1820987654321,7
0.05,324,93,27692,85.20615384615385,8
0.05,325,94,27786,85.23312883435582,8
0.05,326,94,27880,85.25993883792049,7
0.05,327,95,27975,85.28963414634147,6
0.05,328,94,28069,85.3161094224924,8
0.05,329,93,28162,85.33939393939394,8
0.05,330,93,28255,85.36253776435045,8
0.05,331,93,28348,85.3855421686747,8
0.05,332,93,28441,85.4084084084084,8
0.05,333,94,28535,85.43413173652695,7
0.05,334,95,28630,85.46268656716418,6
0.05,335,93,28723,85.48511904761905,8
0.05,336,95,28818,85.513353115727,6
0.05,337,94,28912,85.53846153846153,7
0.05,338,94,29006,85.56342182890856,9
0.05,339,94,29100,85.58823529411765,7
0.05,340,95,29195,85.6158357771261,6
0.05,341,92,29287,85.63450292397661,9
0.05,342,94,29381,85.65889212827989,7
0.05,343,96,29477,85.68895348837209,6
0.05,344,94,29571,85.71304347826087,7
0.05,345,95,29666,85.73988439306359,6
0.05,346,94,29760,85.76368876080691,7
0.05,347,95,29855,85.79022988505747,6
0.05,348,94,29949,85.81375358166189,7
0.05,349,93,30042,85.83428571428571,8
0.05,350,95,30137,85.86039886039886,6
0.05,351,94,30231,85.88352272727273,7
0.05,352,23,30254,85.70538243626062,9
0.05,353,95,30349,85.7316384180791,6
0.05,354,90,30439,85.74366197183099,11
0.05,355,94,30533,85.76685393258427,8
0.05,356,93,30626,85.78711484593838,8
0.05,357,96,30722,85.81564245810056,6
0.05,358,93,30815,85.83565459610028,8
0.05,359,94,30909,85.85833333333333,7
0.05,360,96,31005,85.88642659279779,6
0.05,361,96,31101,85.91436464088397,6
0.05,362,94,31195,85.9366391184573,7
0.05,363,94,31289,85.95879120879121,7
0.05,364,94,31383,85.98082191780821,7
0.05,365,96,31479,86.00819672131148,6
0.05,366,96,31575,86.03542234332426,6
0.05,367,93,31668,86.05434782608695,8
0.05,368,92,31760,86.07046070460704,9
0.05,369,90,31850,86.08108108108108,11
0.05,370,94,31944,86.10242587601078,7
0.05,371,95,32039,86.1263440860215,6
0.05,372,95,32134,86.15013404825737,7
0.05,373,95,32229,86.17379679144385,6
0.05,374,94,32323,86.19466666666666,7
0.05,375,95,32418,86.21808510638297,7
0.05,376,96,32514,86.24403183023873,6
0.05,377,21,32535,86.07142857142857,13
0.05,378,94,32629,86.09234828496042,7
0.05,379,94,32723,86.11315789473684,7
0.05,380,96,32819,86.13910761154855,6
0.05,381,94,32913,86.15968586387434,7
0.05,382,93,33006,86.177545691906,8
0.05,383,96,33102,86.203125,7
0.05,384,94,33196,86.22337662337662,7
0.05,385,94,33290,86.24352331606218,7
0.05,386,92,33382,86.25839793281654,10
0.05,387,93,33475,86.27577319587628,8
0.05,388,95,33570,86.29820051413881,6
0.05,389,92,33662,86.31282051282051,9
0.05,390,94,33756,86.33248081841433,7
0.05,391,27,33783,86.1811224489796,6
0.05,392,90,33873,86.19083969465649,11
0.05,393,94,33967,86.21065989847716,7
0.05,394,95,34062,86.23291139240506,6
0.05,395,94,34156,86.25252525252525,7
0.05,396,94,34250,86.272040302267,7
0.05,397,95,34345,86.29396984924622,6
0.05,398,94,34439,86.31328320802005,7
0.05,399,93,34532,86.33,8
0.05,400,94,34626,86.34912718204488,7
0.05,401,95,34721,86.37064676616916,6
0.05,402,94,34815,86.38957816377172,7
0.05,403,20,34835,86.22524752475248,12
0.05,404,93,34928,86.24197530864197,8
0.05,405,96,35024,86.26600985221675,6
0.05,406,95,35119,86.28746928746929,6
0.05,407,90,35209,86.29656862745098,11
0.05,408,95,35304,86.31784841075795,6
0.05,409,92,35396,86.33170731707317,9
0.05,410,93,35489,86.34793187347933,9
0.05,411,96,35585,86.37135922330097,6
0.05,412,94,35679,86.38983050847457,8
0.05,413,94,35773,86.40821256038647,7
0.05,414,22,35795,86.25301204819277,11
0.05,415,94,35889,86.27163461538461,7
0.05,416,92,35981,86.28537170263789,9
0.05,417,96,36077,86.30861244019138,6
0.05,418,96,36173,86.33174224343675,6
0.05,419,93,36266,86.34761904761905,8
0.05,420,96,36362,86.37054631828978,6
0.05,421,92,36454,86.38388625592417,9
0.05,422,95,36549,86.40425531914893,6
0.05,423,94,36643,86.42216981132076,7
0.05,424,92,36735,86.43529411764706,9
0.05,425,95,36830,86.45539906103286,6
0.05,426,91,36921,86.46604215456675,10
0.05,427,95,37016,86.48598130841121,6
0.05,428,90,37106,86.49417249417249,11
0.05,429,91,37197,86.5046511627907,10
0.05,430,95,37292,86.52436194895591,7
0.05,431,88,37380,86.52777777777777,13
0.05,432,96,37476,86.54965357967667,6
0.05,433,94,37570,86.5668202764977,7
0.05,434,94,37664,86.58390804597701,7
0.05,435,95,37759,86.60321100917432,6
0.05,436,96,37855,86.62471395881006,6
0.05,437,94,37949,86.64155251141553,7
0.05,438,94,38043,86.65831435079727,7
0.05,439,93,38136,86.67272727272727,9
0.05,440,94,38230,86.68934240362812,7
0.05,441,94,38324,86.70588235294117,8
0.05,442,95,38419,86.72460496613995,6
0.05,443,95,38514,86.74324324324324,7
0.05,444,95,38609,86.76179775280899,6
0.05,445,94,38703,86.77802690582959,7
0.05,446,95,38798,86.79642058165548,6
0.05,447,95,38893,86.81473214285714,6
0.05,448,22,38915,86.67037861915368,10
0.05,449,25,38940,86.53333333333333,8
0.05,450,93,39033,86.54767184035477,8
0.05,451,95,39128,86.56637168141593,6
0.05,452,94,39222,86.58278145695364,8
0.05,453,95,39317,86.60132158590308,6
0.05,454,91,39408,86.61098901098902,10
0.05,455,93,39501,86.625,8
0.05,456,95,39596,86.6433260393873,6
0.05,457,93,39689,86.65720524017468,8
0.05,458,94,39783,86.67320261437908,7
0.05,459,96,39879,86.69347826086957,6
0.05,460,94,39973,86.70932754880694,7
0.05,461,93,40066,86.72294372294373,8
0.05,462,95,40161,86.74082073434126,6
0.05,463,-45,40116,86.45689655172414,8
0.05,464,93,40209,86.47096774193548,8
0.05,465,94,40303,86.48712446351931,7
0.05,466,95,40398,86.50535331905782,6
0.05,467,96,40494,86.52564102564102,6
0.05,468,96,40590,86.54584221748401,6
0.05,469,93,40683,86.5595744680851,8
0.05,470,95,40778,86.57749469214437,6
0.05,471,95,40873,86.59533898305085,6
0.05,472,95,40968,86.61310782241014,6
0.05,473,94,41062,86.62869198312237,7
0.05,474,94,41156,86.64421052631579,7
0.05,475,91,41247,86.65336134453781,10
0.05,476,95,41342,86.67085953878407,6
0.05,477,93,41435,86.68410041841004,8
0.05,478,94,41529,86.69937369519833,8
0.05,479,95,41624,86.71666666666667,7
0.05,480,94,41718,86.73180873180873,7
0.05,481,91,41809,86.74066390041494,10
0.05,482,95,41904,86.75776397515529,6
0.05,483,94,41998,86.77272727272727,7
0.05,484,96,42094,86.79175257731958,6
0.05,485,94,42188,86.80658436213992,7
0.05,486,96,42284,86.82546201232033,6
0.05,487,93,42377,86.83811475409836,8
0.05,488,23,42400,86.70756646216769,9
0.05,489,91,42491,86.71632653061225,10
0.05,490,93,42584,86.72912423625255,8
0.05,491,95,42679,86.7459349593496,7
0.05,492,96,42775,86.76470588235294,6
0.05,493,94,42869,86.77935222672065,7
0.05,494,96,42965,86.79797979797979,6
0.05,495,95,43060,86.81451612903226,6
0.05,496,96,43156,86.83299798792757,6
0.05,497,95,43251,86.84939759036145,7
0.05,498,27,43278,86.72945891783567,6
0.05,499,95,43373,86.746,6
0.05,500,95,43468,86.7624750499002,6
0.05,501,94,43562,86.77689243027888,7
0.05,502,24,43586,86.6520874751491,8
0.05,503,95,43681,86.6686507936508,6
0.05,504,23,43704,86.54257425742574,10
0.05,505,95,43799,86.5592885375494,6
0.05,506,95,43894,86.5759368836292,7
0.05,507,92,43986,86.58661417322834,9
0.05,508,94,44080,86.60117878192534,8
0.05,509,92,44172,86.61176470588235,9
0.05,510,94,44266,86.62622309197651,7
0.05,511,96,44362,86.64453125,6
0.05,512,94,44456,86.6588693957115,8
0.05,513,94,44550,86.67315175097276,7
0.05,514,94,44644,86.6873786407767,7
0.05,515,96,44740,86.70542635658914,6
0.05,516,91,44831,86.7137330754352,10
0.05,517,95,44926,86.72972972972973,6
0.05,518,92,45018,86.73988439306359,9
0.05,519,23,45041,86.61730769230769,9
0.05,520,24,45065,86.49712092130518,8
0.05,521,94,45159,86.51149425287356,7
0.05,522,95,45254,86.52772466539197,7
0.05,523,94,45348,86.54198473282443,7
0.05,524,93,45441,86.55428571428571,8
0.05,525,25,45466,86.43726235741445,8
0.05,526,94,45560,86.45161290322581,7
0.05,527,94,45654,86.4659090909091,7
0.05,528,94,45748,86.48015122873346,8
0.05,529,92,45840,86.49056603773585,9
0.05,530,93,45933,86.50282485875707,8
0.05,531,95,46028,86.5187969924812,6
0.05,532,93,46121,86.53095684803002,8
0.05,533,94,46215,86.54494382022472,7
0.05,534,96,46311,86.5626168224299,7
0.05,535,94,46405,86.57649253731343,7
0.05,536,95,46500,86.59217877094972,6
0.05,537,94,46594,86.60594795539033,7
0.05,538,94,46688,86.61966604823748,7
0.05,539,93,46781,86.63148148148149,8
0.05,540,93,46874,86.64325323475046,8
0.05,541,94,46968,86.65682656826569,7
0.05,542,94,47062,86.67034990791898,7
0.05,543,95,47157,86.68566176470588,6
0.05,544,96,47253,86.70275229357799,6
0.05,545,94,47347,86.71611721611721,7
0.05,546,25,47372,86.60329067641682,8
0.05,547,93,47465,86.61496350364963,8
0.05,548,95,47560,86.63023679417122,6
0.05,549,94,47654,86.64363636363636,7
0.05,550,23,47677,86.52813067150635,9
0.05,551,91,47768,86.53623188405797,10
0.05,552,93,47861,86.54792043399638,8
0.05,553,94,47955,86.56137184115524,7
0.05,554,27,47982,86.45405405405405,6
0.05,555,95,48077,86.46942446043165,7
0.05,556,91,48168,86.47755834829444,10
0.05,557,96,48264,86.49462365591398,6
0.05,558,94,48358,86.50805008944543,8
0.05,559,96,48454,86.525,6
0.05,560,91,48545,86.53297682709447,10
0.05,561,95,48640,86.54804270462634,6
0.05,562,94,48734,86.56127886323269,7
0.05,563,94,48828,86.57446808510639,7
0.05,564,96,48924,86.59115044247788,6
0.05,565,95,49019,86.60600706713781,6
0.05,566,95,49114,86.62081128747795,6
0.05,567,92,49206,86.63028169014085,9
0.05,568,95,49301,86.64499121265378,6
0.05,569,94,49395,86.65789473684211,7
0.05,570,95,49490,86.67250437828372,6
0.05,571,94,49584,86.68531468531468,7
0.05,572,96,49680,86.70157068062828,6
0.05,573,93,49773,86.71254355400697,8
0.05,574,94,49867,86.72521739130435,7
0.05,575,95,49962,86.73958333333333,7
0.05,576,92,50054,86.74870017331023,9
0.05,577,93,50147,86.75951557093425,8
0.05,578,96,50243,86.77547495682211,6
0.05,579,94,50337,86.78793103448275,7
0.05,580,91,50428,86.79518072289157,10
0.05,581,94,50522,86.80756013745705,7
0.05,582,92,50614,86.8164665523156,9
0.05,583,96,50710,86.83219178082192,6
0.05,584,95,50805,86.84615384615384,6
0.05,585,96,50901,86.8617747440273,7
0.05,586,94,50995,86.87393526405451,7
0.05,587,94,51089,86.8860544217687,7
0.05,588,95,51184,86.89983022071307,6
0.05,589,95,51279,86.9135593220339,6
0.05,590,93,51372,86.9238578680203,8
0.05,591,96,51468,86.9391891891892,6
0.05,592,94,51562,86.95109612141653,7
0.05,593,94,51656,86.96296296296296,7
0.05,594,96,51752,86.9781512605042,6
0.05,595,93,51845,86.98825503355705,8
0.05,596,96,51941,87.0033500837521,6
0.05,597,95,52036,87.01672240802675,6
0.05,598,26,52062,86.91485809682804,6
0.05,599,95,52157,86.92833333333333,6
0.05,600,92,52249,86.93677204658901,9
0.05,601,92,52341,86.94518272425249,9
0.05,602,94,52435,86.95688225538971,7
0.05,603,93,52528,86.96688741721854,8
0.05,604,93,52621,86.97685950413224,8
0.05,605,94,52715,86.98844884488449,8
0.05,606,93,52808,86.998352553542,8
0.05,607,95,52903,87.01151315789474,6
0.05,608,93,52996,87.02134646962233,8
0.05,609,25,53021,86.91967213114754,8
0.05,610,94,53115,86.93126022913258,7
0.05,611,22,53137,86.82516339869281,11
0.05,612,95,53232,86.83849918433931,6
0.05,613,93,53325,86.8485342019544,8
0.05,614,95,53420,86.86178861788618,6
0.05,615,94,53514,86.87337662337663,7
0.05,616,95,53609,86.88654781199352,6
0.05,617,96,53705,86.90129449838187,6
0.05,618,94,53799,86.91276252019387,8
0.05,619,95,53894,86.9258064516129,6
0.05,620,96,53990,86.94041867954911,6
0.05,621,94,54084,86.95176848874598,7
0.05,622,91,54175,86.95826645264847,10
0.05,623,95,54270,86.97115384615384,7
0.05,624,24,54294,86.8704,8
0.05,625,93,54387,86.88019169329074,9
0.05,626,95,54482,86.89314194577352,6
0.05,627,95,54577,86.90605095541402,6
0.05,628,96,54673,86.92050874403816,6
0.05,629,95,54768,86.93333333333334,7
0.05,630,91,54859,86.93977812995246,10
0.05,631,94,54953,86.95094936708861,7
0.05,632,93,55046,86.96050552922591,8
0.05,633,94,55140,86.97160883280758,7
0.05,634,94,55234,86.98267716535433,7
0.05,635,95,55329,86.99528301886792,6
0.05,636,96,55425,87.0094191522763,6
0.05,637,94,55519,87.02037617554859,7
0.05,638,95,55614,87.03286384976526,6
0.05,639,94,55708,87.04375,8
0.05,640,92,55800,87.05148205928238,9
0.05,641,95,55895,87.06386292834891,6
0.05,642,94,55989,87.0746500777605,7
0.05,643,94,56083,87.08540372670808,7
0.05,644,96,56179,87.09922480620155,6
0.05,645,94,56273,87.10990712074303,7
0.05,646,92,56365,87.11746522411129,9
0.05,647,94,56459,87.12808641975309,7
0.05,648,95,56554,87.1402157164869,6
0.05,649,92,56646,87.14769230769231,9
0.05,650,96,56742,87.16129032258064,6
0.05,651,96,56838,87.17484662576688,6
0.05,652,94,56932,87.18529862174579,7
0.05,653,94,57026,87.19571865443424,7
0.05,654,93,57119,87.20458015267175,8
0.05,655,96,57215,87.21798780487805,7
0.05,656,96,57311,87.23135464231355,6
0.05,657,95,57406,87.24316109422493,6
0.05,658,94,57500,87.25341426403642,7
0.05,659,94,57594,87.26363636363637,7
0.05,660,94,57688,87.27382753403933,7
0.05,661,96,57784,87.2870090634441,6
0.05,662,96,57880,87.3001508295626,6
0.05,663,94,57974,87.31024096385542,8
0.05,664,93,58067,87.3187969924812,8
0.05,665,23,58090,87.22222222222223,9
0.05,666,95,58185,87.23388305847077,6
0.05,667,95,58280,87.24550898203593,6
0.05,668,93,58373,87.254110612855,8
0.05,669,93,58466,87.26268656716418,8
0.05,670,94,58560,87.27272727272727,7
0.05,671,92,58652,87.2797619047619,9
0.05,672,94,58746,87.28974739970282,7
0.05,673,94,58840,87.29970326409496,7
0.05,674,95,58935,87.31111111111112,6
0.05,675,25,58960,87.2189349112426,8
0.05,676,94,59054,87.22895125553914,7
0.05,677,94,59148,87.23893805309734,7
0.05,678,92,59240,87.2459499263623,9
0.05,679,94,59334,87.25588235294117,7
0.05,680,93,59427,87.26431718061674,8
0.05,681,95,59522,87.27565982404693,6
0.05,682,95,59617,87.28696925329429,6
0.05,683,95,59712,87.29824561403508,6
0.05,684,92,59804,87.30510948905109,10
0.05,685,94,59898,87.31486880466473,7
0.05,686,92,59990,87.3216885007278,9
0.05,687,25,60015,87.2311046511628,8
0.05,688,94,60109,87.24092888243831,7
0.05,689,89,60198,87.24347826086957,13
0.05,690,23,60221,87.150506512301,9
0.05,691,96,60317,87.16329479768787,6
0.05,692,94,60411,87.17316017316017,7
0.05,693,94,60505,87.18299711815563,7
0.05,694,96,60601,87.19568345323741,6
0.05,695,94,60695,87.20545977011494,7
0.05,696,95,60790,87.21664275466284,6
0.05,697,90,60880,87.22063037249283,11
0.05,698,95,60975,87.23175965665236,6
0.05,699,96,61071,87.24428571428571,6
0.05,700,96,61167,87.25677603423681,6
0.05,701,95,61262,87.26780626780626,6
0.05,702,94,61356,87.2773826458037,7
0.05,703,93,61449,87.28551136363636,8
0.05,704,92,61541,87.29219858156029,9
0.05,705,92,61633,87.29886685552408,9
0.05,706,94,61727,87.3083451202263,7
0.05,707,94,61821,87.3177966101695,8
0.05,708,95,61916,87.32863187588153,6
0.05,709,94,62010,87.33802816901408,7
0.05,710,93,62103,87.34599156118144,8
0.05,711,93,62196,87.35393258426966,9
0.05,712,94,62290,87.36325385694249,7
0.05,713,92,62382,87.36974789915966,9
0.05,714,21,62403,87.27692307692308,11
0.05,715,95,62498,87.2877094972067,6
0.05,716,96,62594,87.29986052998605,6
0.05,717,95,62689,87.31058495821728,6
0.05,718,96,62785,87.32267037552155,6
0.05,719,24,62809,87.23472222222222,8
0.05,720,18,62827,87.13869625520111,14
0.05,721,94,62921,87.14819944598338,7
0.05,722,96,63017,87.16044260027662,6
0.05,723,94,63111,87.16988950276243,7
0.05,724,95,63206,87.18068965517242,7
0.05,725,90,63296,87.18457300275482,11
0.05,726,87,63383,87.18431911966988,14
0.05,727,96,63479,87.19642857142857,6
0.05,728,94,63573,87.20576131687243,7
0.05,729,23,63596,87.11780821917809,9
0.05,730,94,63690,87.12722298221614,7
0.05,731,96,63786,87.13934426229508,6
0.05,732,92,63878,87.14597544338335,9
0.05,733,94,63972,87.15531335149863,7
0.05,734,95,64067,87.16598639455782,6
0.05,735,94,64161,87.17527173913044,7
0.05,736,93,64254,87.1831750339213,8
0.05,737,95,64349,87.19376693766938,6
0.05,738,95,64444,87.2043301759134,7
0.05,739,94,64538,87.21351351351352,7
0.05,740,94,64632,87.22267206477733,7
0.05,741,27,64659,87.14150943396227,6
0.05,742,94,64753,87.15074024226111,7
0.05,743,96,64849,87.16263440860214,6
0.05,744,94,64943,87.17181208053691,7
0.05,745,92,65035,87.17828418230563,9
0.05,746,95,65130,87.18875502008032,6
0.05,747,95,65225,87.19919786096257,6
0.05,748,95,65320,87.20961281708945,6
0.05,749,92,65412,87.216,9
0.05,750,23,65435,87.13049267643143,9
0.05,751,94,65529,87.13962765957447,7
0.05,752,94,65623,87.14873837981408,7
0.05,753,94,65717,87.157824933687,8
0.05,754,94,65811,87.16688741721855,7
0.05,755,94,65905,87.17592592592592,7
0.05,756,96,66001,87.18758256274769,6
0.05,757,95,66096,87.19788918205805,6
0.05,758,94,66190,87.2068511198946,7
0.05,759,94,66284,87.21578947368421,8
0.05,760,93,66377,87.2233902759527,8
0.05,761,95,66472,87.23359580052494,6
0.05,762,94,66566,87.24246395806028,8
0.05,763,91,66657,87.24738219895288,10
0.05,764,95,66752,87.25751633986928,6
0.05,765,93,66845,87.26501305483029,8
0.05,766,93,66938,87.27249022164277,8
0.05,767,90,67028,87.27604166666667,11
0.05,768,96,67124,87.28738621586476,6
0.05,769,95,67219,87.2974025974026,6
0.05,770,94,67313,87.30609597924773,7
0.05,771,95,67408,87.3160621761658,6
0.05,772,95,67503,87.32600258732212,6
0.05,773,95,67598,87.3359173126615,6
0.05,774,93,67691,87.34322580645161,8
0.05,775,95,67786,87.35309278350516,6
0.05,776,94,67880,87.36164736164736,7
0.05,777,94,67974,87.37017994858611,7
0.05,778,94,68068,87.37869062901156,7
0.05,779,96,68164,87.38974358974359,6
0.05,780,92,68256,87.39564660691421,9
0.05,781,95,68351,87.40537084398977,6
0.05,782,92,68443,87.41123882503193,9
0.05,783,95,68538,87.42091836734694,6
0.05,784,96,68634,87.43184713375796,6
0.05,785,91,68725,87.43638676844783,10
0.05,786,89,68814,87.43837357052097,12
0.05,787,92,68906,87.44416243654823,9
0.05,788,94,69000,87.45247148288973,8
0.05,789,95,69095,87.4620253164557,6
0.05,790,96,69191,87.47281921618205,6
0.05,791,94,69285,87.48106060606061,7
0.05,792,90,69375,87.48423707440101,11
0.05,793,95,69470,87.49370277078086,6
0.05,794,94,69564,87.50188679245284,7
0.05,795,94,69658,87.51005025125629,7
0.05,796,94,69752,87.51819322459222,7
0.05,797,94,69846,87.52631578947368,7
0.05,798,95,69941,87.53566958698373,6
0.05,799,95,70036,87.545,6
0.05,800,94,70130,87.55305867665419,7
0.05,801,94,70224,87.56109725685785,7
0.05,802,89,70313,87.56288916562889,12
0.05,803,94,70407,87.57089552238806,7
0.05,804,96,70503,87.58136645962733,6
0.05,805,96,70599,87.59181141439205,6
0.05,806,96,70695,87.60223048327137,6
0.05,807,96,70791,87.61262376237623,6
0.05,808,88,70879,87.61310259579729,13
0.05,809,25,70904,87.5358024691358,8
0.05,810,96,71000,87.5462392108508,6
0.05,811,96,71096,87.55665024630542,6
0.05,812,95,71191,87.56580565805658,6
0.05,813,94,71285,87.57371007371007,7
0.05,814,96,71381,87.5840490797546,7
0.05,815,96,71477,87.59436274509804,6
0.05,816,94,71571,87.60220318237454,7
0.05,817,95,71666,87.61124694376528,6
0.05,818,94,71760,87.61904761904762,7
0.05,819,91,71851,87.62317073170732,10
0.05,820,25,71876,87.5468940316687,8
0.05,821,96,71972,87.55717761557177,6
0.05,822,94,72066,87.56500607533414,7
0.05,823,23,72089,87.4866504854369,10
0.05,824,94,72183,87.49454545454546,7
0.05,825,94,72277,87.50242130750605,7
0.05,826,94,72371,87.51027811366384,7
0.05,827,23,72394,87.43236714975845,10
0.05,828,95,72489,87.44149577804583,6
0.05,829,93,72582,87.44819277108434,8
0.05,830,94,72676,87.4560770156438,7
0.05,831,90,72766,87.45913461538461,11
0.05,832,95,72861,87.46818727490997,6
0.05,833,95,72956,87.47721822541966,6
0.05,834,94,73050,87.48502994011976,7
0.05,835,27,73077,87.41267942583733,6
0.05,836,93,73170,87.41935483870968,8
0.05,837,94,73264,87.4272076372315,7
0.05,838,89,73353,87.42908224076281,12
0.05,839,94,73447,87.43690476190476,7
0.05,840,94,73541,87.44470868014268,7
0.05,841,93,73634,87.45130641330167,8
0.05,842,95,73729,87.46026097271648,7
0.05,843,93,73822,87.46682464454976,8
0.05,844,93,73915,87.4733727810651,8
0.05,845,95,74010,87.48226950354609,6
0.05,846,94,74104,87.48996458087368,8
0.05,847,93,74197,87.49646226415095,8
0.05,848,90,74287,87.49941107184924,11
0.05,849,94,74381,87.5070588235294,7
0.05,850,25,74406,87.43360752056404,8
0.05,851,94,74500,87.44131455399061,7
0.05,852,95,74595,87.45017584994139,6
0.05,853,95,74690,87.45901639344262,6
0.05,854,94,74784,87.46666666666667,7
0.05,855,94,74878,87.47429906542057,7
0.05,856,96,74974,87.48424737456243,6
0.05,857,23,74997,87.4090909090909,9
0.05,858,94,75091,87.41676367869616,7
0.05,859,94,75185,87.42441860465117,7
0.05,860,94,75279,87.43205574912892,7
0.05,861,25,75304,87.35962877030163,8
0.05,862,94,75398,87.36732329084589,7
0.05,863,92,75490,87.37268518518519,9
0.05,864,95,75585,87.38150289017341,6
0.05,865,20,75605,87.30369515011547,12
0.05,866,96,75701,87.31372549019608,6
0.05,867,95,75796,87.3225806451613,6
0.05,868,91,75887,87.32681242807826,10
0.05,869,94,75981,87.3344827586207,7
0.05,870,93,76074,87.34098737083812,9
0.05,871,95,76169,87.34977064220183,6
0.05,872,19,76188,87.27147766323024,13
0.05,873,94,76282,87.27917620137299,7
0.05,874,95,76377,87.288,6
0.05,875,95,76472,87.29680365296804,6
0.05,876,94,76566,87.30444697833524,7
0.05,877,92,76658,87.30979498861048,9
0.05,878,92,76750,87.3151308304892,9
0.05,879,21,76771,87.23977272727272,12
0.05,880,90,76861,87.24290578887627,11
0.05,881,94,76955,87.25056689342404,8
0.05,882,93,77048,87.25707814269536,8
0.05,883,93,77141,87.26357466063348,9
0.05,884,96,77237,87.27344632768362,6
0.05,885,96,77333,87.28329571106094,6
0.05,886,94,77427,87.29086809470124,7
0.05,887,94,77521,87.29842342342343,7
0.05,888,95,77616,87.30708661417323,6
0.05,889,94,77710,87.31460674157303,7
0.05,890,95,77805,87.32323232323232,6
0.05,891,96,77901,87.3329596412556,6
0.05,892,96,77997,87.34266517357223,6
0.05,893,95,78092,87.35123042505593,7
0.05,894,94,78186,87.35865921787709,7
0.05,895,92,78278,87.36383928571429,9
0.05,896,93,78371,87.3701226309922,8
0.05,897,95,78466,87.37861915367483,6
0.05,898,95,78561,87.38709677419355,6
0.05,899,96,78657,87.39666666666666,6
0.05,900,94,78751,87.40399556048834,7
0.05,901,93,78844,87.41019955654102,8
0.05,902,93,78937,87.41638981173865,8
0.05,903,96,79033,87.42588495575221,6
0.05,904,94,79127,87.43314917127071,7
0.05,905,96,79223,87.44260485651215,6
0.05,906,22,79245,87.37045203969129,10
0.05,907,95,79340,87.37885462555066,7
0.05,908,95,79435,87.38723872387239,6
0.05,909,96,79531,87.3967032967033,6
0.05,910,96,79627,87.40614709110868,6
0.05,911,93,79720,87.41228070175438,8
0.05,912,92,79812,87.41730558598029,9
0.05,913,95,79907,87.42560175054705,6
0.05,914,95,80002,87.43387978142077,6
0.05,915,96,80098,87.44323144104804,6
0.05,916,93,80191,87.44929116684843,8
0.05,917,23,80214,87.37908496732027,10
0.05,918,90,80304,87.38193688792165,11
0.05,919,92,80396,87.38695652173914,9
0.05,920,96,80492,87.39630836047775,6
0.05,921,93,80585,87.40238611713666,8
0.05,922,25,80610,87.33477789815818,8
0.05,923,93,80703,87.3409090909091,8
0.05,924,96,80799,87.35027027027027,6
0.05,925,94,80893,87.3574514038877,7
0.05,926,96,80989,87.36677454153183,6
0.05,927,96,81085,87.37607758620689,6
0.05,928,93,81178,87.3821313240043,8
0.05,929,94,81272,87.38924731182796,8
0.05,930,94,81366,87.39634801288936,7
0.05,931,96,81462,87.40557939914163,6
0.05,932,95,81557,87.41371918542336,6
0.05,933,94,81651,87.42077087794432,7
0.05,934,95,81746,87.42887700534759,6
0.05,935,96,81842,87.4380341880342,6
0.05,936,96,81938,87.44717182497332,6
0.05,937,96,82034,87.45628997867804,6
0.05,938,94,82128,87.46325878594249,7
0.05,939,93,82221,87.46914893617021,8
0.05,940,94,82315,87.47608926673752,7
0.05,941,95,82410,87.48407643312102,8
0.05,942,93,82503,87.4899257688229,8
0.05,943,96,82599,87.4989406779661,6
0.05,944,94,82693,87.5058201058201,7
0.05,945,93,82786,87.51162790697674,8
0.05,946,92,82878,87.51636747624076,10
0.05,947,25,82903,87.45042194092827,8
0.05,948,96,82999,87.45943097997892,6
0.05,949,94,83093,87.46631578947368,7
0.05,950,94,83187,87.47318611987382,7
0.05,951,90,83277,87.47584033613445,11
0.05,952,96,83373,87.48478488982161,6
0.05,953,95,83468,87.49266247379455,7
0.05,954,93,83561,87.49842931937172,8
0.05,955,92,83653,87.50313807531381,9
0.05,956,94,83747,87.50992685475444,7
0.05,957,94,83841,87.51670146137788,7
0.05,958,94,83935,87.52346193952033,7
0.05,959,93,84028,87.52916666666667,8
0.05,960,94,84122,87.53590010405827,8
0.05,961,93,84215,87.54158004158005,8
0.05,962,96,84311,87.5503634475597,6
0.05,963,95,84406,87.55809128630706,6
0.05,964,95,84501,87.5658031088083,6
0.05,965,95,84596,87.5734989648033,7
0.05,966,94,84690,87.58014477766288,7
0.05,967,92,84782,87.58471074380165,9
0.05,968,94,84876,87.59133126934985,7
0.05,969,94,84970,87.5979381443299,7
0.05,970,96,85066,87.60659114315139,6
0.05,971,95,85161,87.6141975308642,6
0.05,972,94,85255,87.62076053442959,7
0.05,973,25,85280,87.5564681724846,8
0.05,974,95,85375,87.56410256410257,6
0.05,975,94,85469,87.57069672131148,7
0.05,976,95,85564,87.5783009211873,6
0.05,977,94,85658,87.58486707566462,7
0.05,978,94,85752,87.59141981613892,8
0.05,979,92,85844,87.59591836734694,9
0.05,980,94,85938,87.60244648318043,8
0.05,981,95,86033,87.60997963340122,7
0.05,982,96,86129,87.61851475076297,6
0.05,983,94,86223,87.625,7
0.05,984,94,86317,87.63147208121828,7
0.05,985,95,86412,87.63894523326572,6
0.05,986,95,86507,87.64640324214793,6
0.05,987,94,86601,87.65283400809717,7
0.05,988,92,86693,87.6572295247725,9
0.05,989,90,86783,87.65959595959596,11
0.05,990,96,86879,87.66801210898083,6
0.05,991,88,86967,87.66834677419355,13
0.05,992,96,87063,87.67673716012085,6
0.05,993,95,87158,87.6841046277666,6
0.05,994,94,87252,87.69045226130653,7
0.05,995,96,87348,87.6987951807229,6
0.05,996,89,87437,87.7001003009027,12
0.05,997,93,87530,87.70541082164328,9
0.05,998,93,87623,87.71071071071071,8
0.05,999,19,87642,87.642,13
0.05,1000,96,87738,87.65034965034965,6
0.05,1001,94,87832,87.6566866267465,7
0.05,1002,91,87923,87.66001994017947,10
0.05,1003,94,88017,87.66633466135458,7
0.05,1004,91,88108,87.66965174129353,10
0.05,1005,94,88202,87.67594433399603,7
0.05,1006,92,88294,87.68023833167825,9
0.05,1007,95,88389,87.6875,6
0.05,1008,94,88483,87.69375619425173,7
0.05,1009,94,88577,87.7,7
0.05,1010,96,88673,87.7082096933729,6
0.05,1011,93,88766,87.71343873517786,8
0.05,1012,94,88860,87.71964461994077,7
0.05,1013,95,88955,87.7268244575937,6
0.05,1014,94,89049,87.73300492610838,7
0.05,1015,93,89142,87.73818897637796,8
0.05,1016,95,89237,87.74532940019665,6
0.05,1017,24,89261,87.6827111984283,8
0.05,1018,96,89357,87.69087340529931,6
0.05,1019,95,89452,87.69803921568628,6
0.05,1020,95,89547,87.70519098922625,7
0.05,1021,94,89641,87.71135029354207,7
0.05,1022,95,89736,87.71847507331378,7
0.05,1023,95,89831,87.7255859375,6
0.05,1024,96,89927,87.73365853658537,6
0.05,1025,95,90022,87.74074074074075,7
0.05,1026,96,90118,87.74878286270692,6
0.05,1027,94,90212,87.75486381322958,7
0.05,1028,95,90307,87.76190476190476,6
0.05,1029,94,90401,87.76796116504855,8
0.05,1030,94,90495,87.77400581959263,7
0.05,1031,95,90590,87.78100775193798,6
0.05,1032,90,90680,87.78315585672797,11
0.05,1033,94,90774,87.78916827852998,7
0.05,1034,93,90867,87.79420289855072,8
0.05,1035,92,90959,87.79826254826254,9
0.05,1036,89,91048,87.79942140790743,13
0.05,1037,93,91141,87.80443159922929,8
0.05,1038,94,91235,87.81039461020212,7
0.05,1039,96,91331,87.81826923076923,6
0.05,1040,93,91424,87.82324687800192,8
0.05,1041,96,91520,87.83109404990402,6
0.05,1042,95,91615,87.83796740172579,6
0.05,1043,23,91638,87.77586206896552,9
0.05,1044,88,91726,87.77607655502392,13
0.05,1045,95,91821,87.782982791587,6
0.05,1046,95,91916,87.7898758357211,6
0.05,1047,94,92010,87.79580152671755,7
0.05,1048,94,92104,87.80171591992374,7
0.05,1049,92,92196,87.80571428571429,9
0.05,1050,96,92292,87.81351094196003,6
0.05,1051,91,92383,87.81653992395437,10
0.05,1052,92,92475,87.82051282051282,10
0.05,1053,96,92571,87.82827324478178,6
0.05,1054,94,92665,87.83412322274881,7
0.05,1055,94,92759,87.83996212121212,7
0.05,1056,93,92852,87.84484389782403,8
0.05,1057,96,92948,87.85255198487712,6
0.05,1058,93,93041,87.85741265344664,8
0.05,1059,92,93133,87.86132075471698,9
0.05,1060,94,93227,87.86710650329877,7
0.05,1061,24,93251,87.80696798493409,8
0.05,1062,95,93346,87.8137347130762,6
0.05,1063,95,93441,87.82048872180451,6
0.05,1064,94,93535,87.82629107981221,7
0.05,1065,94,93629,87.83208255159475,7
0.05,1066,93,93722,87.8369259606373,8
0.05,1067,20,93742,87.77340823970037,12
0.05,1068,94,93836,87.77923292797007,7
0.05,1069,93,93929,87.78411214953272,8
0.05,1070,91,94020,87.78711484593838,10
0.05,1071,94,94114,87.79291044776119,7
0.05,1072,93,94207,87.7977632805219,8
0.05,1073,90,94297,87.7998137802607,13
0.05,1074,94,94391,87.80558139534884,7
0.05,1075,95,94486,87.81226765799256,7
0.05,1076,94,94580,87.8180129990715,7
0.05,1077,94,94674,87.82374768089053,7
0.05,1078,21,94695,87.76181649675625,11
0.05,1079,95,94790,87.76851851851852,6
0.05,1080,95,94885,87.77520814061054,6
0.05,1081,93,94978,87.78003696857671,8
0.05,1082,94,95072,87.78578024007386,7
0.05,1083,23,95095,87.7260147601476,9
0.05,1084,94,95189,87.73179723502304,7
0.05,1085,95,95284,87.73848987108656,6
0.05,1086,94,95378,87.7442502299908,7
0.05,1087,96,95474,87.75183823529412,6
0.05,1088,92,95566,87.75573921028466,10
0.05,1089,96,95662,87.76330275229358,6
0.05,1090,95,95757,87.76993583868011,6
0.05,1091,95,95852,87.77655677655677,6
0.05,1092,95,95947,87.78316559926807,6
0.05,1093,94,96041,87.78884826325411,7
0.05,1094,94,96135,87.79452054794521,7
0.05,1095,94,96229,87.80018248175182,7
0.05,1096,94,96323,87.80583409298086,7
0.05,1097,96,96419,87.81329690346084,6
0.05,1098,95,96514,87.81983621474068,6
0.05,1099,94,96608,87.82545454545455,7
0.05,1100,94,96702,87.83106267029973,7
0.05,1101,95,96797,87.83756805807623,6
0.05,1102,95,96892,87.84406165004533,6
0.05,1103,96,96988,87.85144927536231,6
0.05,1104,95,97083,87.8579185520362,6
0.05,1105,93,97176,87.8625678119349,8
0.05,1106,92,97268,87.86630532971996,9
0.05,1107,96,97364,87.87364620938628,6
0.05,1108,94,97458,87.87917042380523,7
0.05,1109,94,97552,87.88468468468469,7
0.05,1110,-52,97500,87.75877587758775,15
0.05,1111,92,97592,87.76258992805755,9
0.05,1112,94,97686,87.76819407008087,7
0.05,1113,21,97707,87.70825852782765,11
0.05,1114,94,97801,87.71390134529148,7
0.05,1115,94,97895,87.7195340501792,7
0.05,1116,96,97991,87.72694717994628,6
0.05,1117,96,98087,87.73434704830053,6
0.05,1118,90,98177,87.73637176050045,11
0.05,1119,93,98270,87.74107142857143,8
0.05,1120,95,98365,87.74754683318466,6
0.05,1121,94,98459,87.75311942959001,7
0.05,1122,96,98555,87.76046304541407,6
0.05,1123,96,98651,87.76779359430606,6
0.05,1124,94,98745,87.77333333333333,7
0.05,1125,96,98841,87.78063943161634,6
0.05,1126,96,98937,87.78793256433008,6
0.05,1127,94,99031,87.79343971631205,7
0.05,1128,94,99125,87.79893711248893,7
0.05,1129,94,99219,87.80442477876106,7
0.05,1130,94,99313,87.80990274093722,8
0.05,1131,92,99405,87.81360424028269,9
0.05,1132,95,99500,87.81994704324802,6
0.05,1133,90,99590,87.82186948853615,12
0.05,1134,94,99684,87.8273127753304,7
0.05,1135,94,99778,87.83274647887323,7
0.05,1136,96,99874,87.83992963940193,6
0.05,1137,96,99970,87.84710017574693,6
0.05,1138,92,100062,87.85074626865672,9
0.05,1139,94,100156,87.8561403508772,7
0.05,1140,93,100249,87.86064855390009,9
0.05,1141,92,100341,87.86427320490368,9
0.05,1142,95,100436,87.87051618547682,6
0.05,1143,92,100528,87.87412587412588,9
0.05,1144,93,100621,87.87860262008734,8
0.05,1145,94,100715,87.88394415357766,7
0.05,1146,95,100810,87.89014821272886,6
0.05,1147,25,100835,87.83536585365853,8
0.05,1148,93,100928,87.83986074847694,8
0.05,1149,94,101022,87.84521739130435,7
0.05,1150,94,101116,87.85056472632493,7
0.05,1151,93,101209,87.85503472222223,8
0.05,1152,93,101302,87.8594969644406,8
0.05,1153,94,101396,87.86481802426343,7
0.05,1154,95,101491,87.87099567099567,6
0.05,1155,94,101585,87.87629757785467,7
0.05,1156,93,101678,87.88072601555747,8
0.05,1157,94,101772,87.88601036269431,7
0.05,1158,96,101868,87.89301121656601,6
0.05,1159,96,101964,87.9,6
0.05,1160,96,102060,87.90697674418605,6
0.05,1161,96,102156,87.91394148020655,6
0.05,1162,21,102177,87.85640584694755,12
0.05,1163,94,102271,87.86168384879726,7
0.05,1164,95,102366,87.86781115879829,7
0.05,1165,92,102458,87.8713550600343,9
0.05,1166,94,102552,87.87660668380462,7
0.05,1167,94,102646,87.8818493150685,7
0.05,1168,92,102738,87.88537211291703,10
0.05,1169,95,102833,87.891452991453,7
0.05,1170,92,102925,87.89496157130658,9
0.05,1171,96,103021,87.9018771331058,6
0.05,1172,94,103115,87.9070758738278,7
0.05,1173,95,103210,87.91311754684838,6
0.05,1174,94,103304,87.91829787234043,7
0.05,1175,95,103399,87.92431972789116,6
0.05,1176,25,103424,87.87085811384877,8
0.05,1177,95,103519,87.87691001697793,6
0.05,1178,24,103543,87.82273112807464,8
0.05,1179,94,103637,87.82796610169491,8
0.05,1180,90,103727,87.82980524978832,11
0.05,1181,95,103822,87.83587140439933,8
0.05,1182,94,103916,87.84108199492815,7
0.05,1183,94,104010,87.84628378378379,7
0.05,1184,93,104103,87.85063291139241,8
0.05,1185,94,104197,87.85581787521079,7
0.05,1186,24,104221,87.80202190395956,9
0.05,1187,93,104314,87.8063973063973,8
0.05,1188,23,104337,87.75189234650968,9
0.05,1189,95,104432,87.75798319327731,6
0.05,1190,96,104528,87.7649034424853,6
0.05,1191,91,104619,87.76761744966443,10
0.05,1192,92,104711,87.77116512992455,10
0.05,1193,94,104805,87.77638190954774,7
0.05,1194,96,104901,87.78326359832636,6
0.05,1195,94,104995,87.78846153846153,7
0.05,1196,95,105090,87.79448621553885,6
0.05,1197,95,105185,87.80050083472455,6
0.05,1198,94,105279,87.80567139282735,7
0.05,1199,94,105373,87.81083333333333,7
0.05,1200,96,105469,87.81765195670275,6
0.05,1201,93,105562,87.82196339434276,8
0.05,1202,96,105658,87.82876142975894,6
0.05,1203,92,105750,87.83222591362126,9
0.05,1204,95,105845,87.83817427385893,6
0.05,1205,23,105868,87.78441127694859,9
0.05,1206,96,105964,87.79121789560895,6
0.05,1207,19,105983,87.7342715231788,13
0.05,1208,94,106077,87.73945409429281,7
0.05,1209,94,106171,87.74462809917355,7
0.05,1210,94,106265,87.74979355904212,7
0.05,1211,95,106360,87.75577557755776,6
0.05,1212,92,106452,87.75927452596868,9
0.05,1213,94,106546,87.76441515650741,7
0.05,1214,95,106641,87.77037037037037,6
0.05,1215,94,106735,87.77549342105263,7
0.05,1216,95,106830,87.78142974527526,6
0.05,1217,92,106922,87.78489326765188,9
0.05,1218,92,107014,87.78835110746513,9
0.05,1219,91,107105,87.79098360655738,10
0.05,1220,95,107200,87.7968877968878,6
0.05,1221,93,107293,87.80114566284779,8
0.05,1222,88,107381,87.80130825838103,13
0.05,1223,95,107476,87.80718954248366,6
0.05,1224,96,107572,87.81387755102041,6
0.05,1225,91,107663,87.81647634584013,10
0.05,1226,93,107756,87.82070089649552,8
0.05,1227,93,107849,87.82491856677524,8
0.05,1228,93,107942,87.82912937347437,8
0.05,1229,94,108036,87.83414634146341,7
0.05,1230,93,108129,87.83834281072299,8
0.05,1231,94,108223,87.84334415584415,7
0.05,1232,95,108318,87.84914841849148,6
0.05,1233,92,108410,87.85251215559157,10
0.05,1234,96,108506,87.8591093117409,6
0.05,1235,94,108600,87.86407766990291,7
0.05,1236,94,108694,87.86903799514955,7
0.05,1237,96,108790,87.87560581583199,6
0.05,1238,94,108884,87.88054882970137,8
0.05,1239,94,108978,87.88548387096775,7
0.05,1240,96,109074,87.89202256244964,6
0.05,1241,94,109168,87.89694041867955,7
0.05,1242,94,109262,87.90185036202735,7
0.05,1243,92,109354,87.90514469453376,9
0.05,1244,95,109449,87.91084337349398,7
0.05,1245,94,109543,87.91573033707866,7
0.05,1246,95,109638,87.92141138732958,7
0.05,1247,93,109731,87.92548076923077,9
0.05,1248,96,109827,87.93194555644516,6
0.05,1249,95,109922,87.9376,6
0.05,1250,94,110016,87.94244604316546,8
0.05,1251,95,110111,87.94808306709265,6
0.05,1252,93,110204,87.95211492418197,8
0.05,1253,94,110298,87.95693779904306,7
0.05,1254,92,110390,87.9601593625498,10
0.05,1255,21,110411,87.90684713375796,11
0.05,1256,94,110505,87.91169451073986,7
0.05,1257,95,110600,87.91732909379968,6
0.05,1258,93,110693,87.92136616362193,8
0.05,1259,96,110789,87.92777777777778,6
0.05,1260,90,110879,87.92942109436954,11
0.05,1261,94,110973,87.93423137876387,8
0.05,1262,96,111069,87.94061757719714,6
0.05,1263,92,111161,87.94382911392405,9
0.05,1264,95,111256,87.9494071146245,6
0.05,1265,94,111350,87.95418641390205,7
0.05,1266,95,111445,87.95974743488556,6
0.05,1267,92,111537,87.96293375394322,9
0.05,1268,94,111631,87.96769109535067,7
0.05,1269,95,111726,87.9732283464567,6
0.05,1270,93,111819,87.9771833202203,8
0.05,1271,92,111911,87.98034591194968,9
0.05,1272,96,112007,87.98664571877455,6
0.05,1273,93,112100,87.9905808477237,8
0.05,1274,94,112194,87.99529411764706,7
0.05,1275,94,112288,88.0,7
0.05,1276,24,112312,87.94988253719656,9
0.05,1277,27,112339,87.90219092331769,6
0.05,1278,92,112431,87.90539483971853,9
0.05,1279,93,112524,87.909375,8
0.05,1280,92,112616,87.91256830601093,9
0.05,1281,96,112712,87.9188767550702,6
0.05,1282,96,112808,87.92517537022603,6
0.05,1283,95,112903,87.93068535825545,6
0.05,1284,95,112998,87.93618677042801,6
0.05,1285,95,113093,87.94167962674962,6
0.05,1286,92,113185,87.94483294483294,9
0.05,1287,95,113280,87.95031055900621,6
0.05,1288,92,113372,87.95345228859581,9
0.05,1289,23,113395,87.90310077519379,10
0.05,1290,96,113491,87.90937257939582,6
0.05,1291,96,113587,87.9156346749226,6
0.05,1292,94,113681,87.92034029389018,7
0.05,1293,92,113773,87.92349304482225,9
0.05,1294,93,113866,87.92741312741313,8
0.05,1295,94,113960,87.9320987654321,7
0.05,1296,94,114054,87.93677717810331,7
0.05,1297,95,114149,87.942218798151,7
0.05,1298,92,114241,87.94534257120863,10
0.05,1299,94,114335,87.95,7
0.05,1300,94,114429,87.95465026902383,7
0.05,1301,94,114523,87.95929339477726,7
0.05,1302,94,114617,87.96392939370683,7
0.05,1303,95,114712,87.96932515337423,6
0.05,1304,96,114808,87.97547892720307,6
0.05,1305,94,114902,87.9800918836141,7
0.05,1306,94,114996,87.98469778117827,7
0.05,1307,92,115088,87.98776758409785,9
0.05,1308,94,115182,87.99236058059587,7
0.05,1309,-48,115134,87.88854961832061,11
0.05,1310,95,115229,87.89397406559878,6
0.05,1311,-53,115176,87.78658536585365,16
0.05,1312,95,115271,87.79207920792079,6
0.05,1313,90,115361,87.7937595129376,11
0.05,1314,94,115455,87.79847908745248,7
0.05,1315,93,115548,87.80243161094225,8
0.05,1316,94,115642,87.80713743356112,7
0.05,1317,94,115736,87.81183611532626,7
0.05,1318,94,115830,87.81652767247915,7
0.05,1319,23,115853,87.76742424242424,10
0.05,1320,94,115947,87.77214231642695,7
0.05,1321,94,116041,87.7768532526475,7
0.05,1322,96,116137,87.78306878306879,6
0.05,1323,95,116232,87.78851963746223,6
0.05,1324,95,116327,87.79396226415095,7
0.05,1325,95,116422,87.79939668174963,6
0.05,1326,92,116514,87.80256217030897,9
0.05,1327,94,116608,87.80722891566265,7
0.05,1328,94,116702,87.81188863807374,7
0.05,1329,95,116797,87.81729323308271,6
0.05,1330,92,116889,87.82043576258452,9
0.05,1331,94,116983,87.82507507507508,7
0.05,1332,93,117076,87.82895723930983,9
0.05,1333,94,117170,87.83358320839581,7
0.05,1334,23,117193,87.78501872659176,9
0.05,1335,94,117287,87.78967065868264,7
0.05,1336,95,117382,87.79506357516829,6
0.05,1337,95,117477,87.80044843049328,6
0.05,1338,94,117571,87.8050784167289,7
0.05,1339,94,117665,87.80970149253731,7
0.05,1340,96,117761,87.81580909768829,6
0.05,1341,24,117785,87.76825633383011,8
0.05,1342,95,117880,87.77364110201043,7
0.05,1343,96,117976,87.7797619047619,6
0.05,1344,94,118070,87.78438661710037,7
0.05,1345,94,118164,87.7890044576523,7
0.05,1346,92,118256,87.79213066072754,9
0.05,1347,96,118352,87.79821958456974,6
0.05,1348,93,118445,87.80207561156412,8
0.05,1349,92,118537,87.80518518518518,9
0.05,1350,95,118632,87.81051073279052,6
0.05,1351,96,118728,87.81656804733728,6
0.05,1352,95,118823,87.8218773096822,6
0.05,1353,95,118918,87.8271787296898,6
0.05,1354,95,119013,87.83247232472324,6
0.05,1355,23,119036,87.78466076696165,9
0.05,1356,94,119130,87.78924097273398,7
0.05,1357,94,119224,87.79381443298969,8
0.05,1358,94,119318,87.79838116261958,7
0.05,1359,95,119413,87.80367647058823,6
0.05,1360,94,119507,87.80822924320353,7
0.05,1361,21,119528,87.75917767988253,11
0.05,1362,92,119620,87.76228906823184,9
0.05,1363,94,119714,87.76686217008798,7
0.05,1364,21,119735,87.71794871794872,11
0.05,1365,89,119824,87.71888726207906,12
0.05,1366,92,119916,87.72201901975129,9
0.05,1367,23,119939,87.67470760233918,9
0.05,1368,23,119962,87.62746530314098,9
0.05,1369,94,120056,87.63211678832117,7
0.05,1370,89,120145,87.6331145149526,12
0.05,1371,94,120239,87.63775510204081,7
0.05,1372,92,120331,87.6409322651129,9
0.05,1373,94,120425,87.64556040756914,7
0.05,1374,94,120519,87.65018181818182,7
0.05,1375,93,120612,87.65406976744185,8
0.05,1376,95,120707,87.65940450254176,6
0.05,1377,94,120801,87.66400580551525,7
0.05,1378,94,120895,87.6686004350979,7
0.05,1379,16,120911,87.61666666666666,17
0.05,1380,93,121004,87.62056480811006,8
0.05,1381,92,121096,87.62373371924747,9
0.05,1382,96,121192,87.6297903109183,6
0.05,1383,94,121286,87.63439306358381,7
0.05,1384,93,121379,87.63826714801444,9
0.05,1385,93,121472,87.64213564213564,8
0.05,1386,95,121567,87.64744051910598,8
0.05,1387,95,121662,87.65273775216139,6
0.05,1388,94,121756,87.65730741540676,7
0.05,1389,95,121851,87.66258992805756,6
0.05,1390,94,121945,87.66714593817397,7
0.05,1391,95,122040,87.67241379310344,6
0.05,1392,95,122135,87.67767408470927,6
0.05,1393,93,122228,87.68149210903874,8
0.05,1394,94,122322,87.68602150537635,8
0.05,1395,94,122416,87.69054441260745,8
0.05,1396,91,122507,87.69291338582677,10
0.05,1397,94,122601,87.69742489270386,7
0.05,1398,90,122691,87.69907076483203,11
0.05,1399,-49,122642,87.60142857142857,12
0.05,1400,95,122737,87.60670949321913,6
0.05,1401,94,122831,87.61126961483595,7
0.05,1402,94,122925,87.61582323592302,7
0.05,1403,94,123019,87.62037037037037,8
0.05,1404,96,123115,87.62633451957295,6
0.05,1405,27,123142,87.5832147937411,6
0.05,1406,94,123236,87.58777540867094,7
0.05,1407,93,123329,87.59161931818181,8
0.05,1408,94,123423,87.59616749467708,7
0.05,1409,95,123518,87.60141843971631,6
0.05,1410,17,123535,87.55138199858257,16
0.05,1411,23,123558,87.5056657223796,9
0.05,1412,95,123653,87.51096956829441,7
0.05,1413,95,123748,87.51626591230551,6
0.05,1414,95,123843,87.52155477031802,6
0.05,1415,96,123939,87.52754237288136,6
0.05,1416,93,124032,87.53140437544107,8
0.05,1417,95,124127,87.53667136812412,6
0.05,1418,94,124221,87.54122621564483,7
0.05,1419,93,124314,87.54507042253522,10
0.05,1420,93,124407,87.54890921885996,8
0.05,1421,23,124430,87.50351617440225,9
0.05,1422,90,124520,87.50527055516514,11
0.05,1423,24,124544,87.46067415730337,8
0.05,1424,95,124639,87.4659649122807,6
0.05,1425,91,124730,87.46844319775596,10
0.05,1426,94,124824,87.47302032235459,8
0.05,1427,94,124918,87.47759103641457,7
0.05,1428,94,125012,87.48215535339398,7
0.05,1429,21,125033,87.43566433566434,11
0.05,1430,95,125128,87.4409503843466,6
0.05,1431,91,125219,87.44343575418995,10
0.05,1432,95,125314,87.44870900209351,6
0.05,1433,93,125407,87.45258019525802,8
0.05,1434,96,125503,87.45853658536585,6
0.05,1435,93,125596,87.46239554317549,8
0.05,1436,94,125690,87.46694502435629,7
0.05,1437,94,125784,87.47148817802504,7
0.05,1438,96,125880,87.4774148714385,6
0.05,1439,92,125972,87.48055555555555,10
0.05,1440,93,126065,87.48438584316447,8
0.05,1441,91,126156,87.4868238557559,10
0.05,1442,92,126248,87.4899514899515,9
0.05,1443,94,126342,87.49445983379502,7
0.05,1444,94,126436,87.49896193771626,7
0.05,1445,96,126532,87.50484094052558,6
0.05,1446,94,126626,87.50932964754665,7
0.05,1447,96,126722,87.51519337016575,6
0.05,1448,95,126817,87.52035886818496,6
0.05,1449,92,126909,87.52344827586207,9
0.05,1450,92,127001,87.52653342522399,9
0.05,1451,96,127097,87.53236914600551,6
0.05,1452,94,127191,87.53682037164488,7
0.05,1453,93,127284,87.54057771664374,8
0.05,1454,93,127377,87.54432989690721,8
0.05,1455,93,127470,87.54807692307692,8
0.05,1456,95,127565,87.55319148936171,6
0.05,1457,94,127659,87.55761316872427,8
0.05,1458,94,127753,87.5620287868403,7
0.05,1459,96,127849,87.56780821917808,6
0.05,1460,21,127870,87.52224503764545,11
0.05,1461,89,127959,87.52325581395348,12
0.05,1462,92,128051,87.52631578947368,9
0.05,1463,94,128145,87.53073770491804,7
0.05,1464,93,128238,87.53447098976109,8
0.05,1465,96,128334,87.54024556616643,6
0.05,1466,94,128428,87.54464894342195,7
0.05,1467,89,128517,87.54564032697547,12
0.05,1468,96,128613,87.55139550714772,6
0.05,1469,96,128709,87.55714285714286,6
0.05,1470,94,128803,87.56152277362338,7
0.05,1471,22,128825,87.51698369565217,10
0.05,1472,94,128919,87.5213849287169,8
0.05,1473,94,129013,87.52578018995929,7
0.05,1474,94,129107,87.53016949152543,7
0.05,1475,94,129201,87.53455284552845,7
0.05,1476,25,129226,87.49221394719025,8
0.05,1477,22,129248,87.44790257104195,10
0.05,1478,96,129344,87.45368492224476,6
0.05,1479,94,129438,87.4581081081081,7
0.05,1480,95,129533,87.46320054017556,6
0.05,1481,94,129627,87.46761133603239,7
0.05,1482,93,129720,87.47134187457856,9
0.05,1483,96,129816,87.47708894878706,6
0.05,1484,96,129912,87.48282828282828,6
0.05,1485,93,130005,87.48654104979812,8
0.05,1486,95,130100,87.4915938130464,6
0.05,1487,24,130124,87.4489247311828,8
0.05,1488,93,130217,87.45265278710544,8
0.05,1489,96,130313,87.45838926174497,6
0.05,1490,93,130406,87.46210596914823,8
0.05,1491,93,130499,87.46581769436997,8
0.05,1492,-119,130380,87.32752846617548,13
0.05,1493,94,130474,87.33199464524766,7
0.05,1494,94,130568,87.33645484949832,7
0.05,1495,27,130595,87.2961229946524,6
0.05,1496,93,130688,87.2999331997328,8
0.05,1497,92,130780,87.30307076101468,9
0.05,1498,96,130876,87.30887258172115,6
0.05,1499,94,130970,87.31333333333333,7
0.05,1500,95,131065,87.3184543637575,6
0.05,1501,92,131157,87.32157123834887,9
0.05,1502,96,131253,87.32734530938124,6
0.05,1503,20,131273,87.28257978723404,12
0.05,1504,95,131368,87.28770764119601,6
0.05,1505,94,131462,87.29216467463479,7
0.05,1506,93,131555,87.29595222295953,8
0.05,1507,94,131649,87.30039787798408,7
0.05,1508,94,131743,87.30483764082173,7
0.05,1509,94,131837,87.30927152317881,7
0.05,1510,92,131929,87.31237590999338,9
0.05,1511,94,132023,87.31679894179894,7
0.05,1512,90,132113,87.31857237276934,11
0.05,1513,27,132140,87.2787318361955,6
0.05,1514,96,132236,87.28448844884488,6
0.05,1515,94,132330,87.28891820580475,7
0.05,1516,89,132419,87.29004614370469,12
0.05,1517,96,132515,87.2957839262187,6
0.05,1518,93,132608,87.29953917050692,8
0.05,1519,94,132702,87.30394736842105,7
0.05,1520,94,132796,87.30834976988824,7
0.05,1521,94,132890,87.31274638633377,7
0.05,1522,20,132910,87.26854891661195,12
0.05,1523,94,133004,87.27296587926509,7
0.05,1524,94,133098,87.27737704918033,7
0.05,1525,95,133193,87.2824377457405,6
0.05,1526,94,133287,87.28683693516699,7
0.05,1527,95,133382,87.29188481675392,6
0.05,1528,96,133478,87.297580117724,6
0.05,1529,94,133572,87.30196078431372,7
0.05,1530,96,133668,87.30764206401045,6
0.05,1531,94,133762,87.31201044386422,7
0.05,1532,93,133855,87.31572080887149,8
0.05,1533,94,133949,87.32007822685789,7
0.05,1534,92,134041,87.32312703583062,9
0.05,1535,95,134136,87.328125,6
0.05,1536,24,134160,87.28692257644762,8
0.05,1537,92,134252,87.28998699609883,9
0.05,1538,95,134347,87.2949967511371,7
0.05,1539,94,134441,87.29935064935064,7
0.05,1540,94,134535,87.30369889682025,8
0.05,1541,25,134560,87.2632944228275,7
0.05,1542,95,134655,87.26830848995463,7
0.05,1543,94,134749,87.27266839378238,7
0.05,1544,25,134774,87.23236245954692,8
0.05,1545,94,134868,87.23673997412678,7
0.05,1546,94,134962,87.24111182934712,7
0.05,1547,94,135056,87.24547803617571,9
0.05,1548,94,135150,87.24983860555197,7
0.05,1549,94,135244,87.2541935483871,7
0.05,1550,94,135338,87.25854287556415,7
0.05,1551,92,135430,87.26159793814433,9
0.05,1552,96,135526,87.26722472633612,6
0.05,1553,93,135619,87.27091377091377,8
0.05,1554,94,135713,87.27524115755627,8
0.05,1555,23,135736,87.23393316195373,10
0.05,1556,94,135830,87.23827874116891,7
0.05,1557,94,135924,87.2426187419769,8
0.05,1558,95,136019,87.24759461193072,6
0.05,1559,26,136045,87.20833333333333,7
0.05,1560,94,136139,87.21268417680973,7
0.05,1561,95,136234,87.21766965428937,6
0.05,1562,95,136329,87.22264875239924,6
0.05,1563,92,136421,87.22570332480818,9
0.05,1564,90,136511,87.22747603833866,11
0.05,1565,94,136605,87.23180076628353,7
0.05,1566,94,136699,87.23611997447351,7
0.05,1567,96,136795,87.24170918367346,6
0.05,1568,94,136889,87.24601657106437,7
0.05,1569,95,136984,87.25095541401274,6
0.05,1570,92,137076,87.25397835773393,9
0.05,1571,94,137170,87.25826972010178,7
0.05,1572,95,137265,87.26319135410044,6
0.05,1573,94,137359,87.26747141041932,7
0.05,1574,23,137382,87.22666666666667,9
0.05,1575,94,137476,87.23096446700508,7
0.05,1576,92,137568,87.23398858592263,9
0.05,1577,96,137664,87.23954372623574,6
0.05,1578,94,137758,87.24382520582647,7
0.05,1579,94,137852,87.24810126582278,7
0.05,1580,94,137946,87.25237191650854,7
0.05,1581,93,138039,87.25600505689002,8
0.05,1582,95,138134,87.26089703095388,7
0.05,1583,21,138155,87.21906565656566,11
0.05,1584,94,138249,87.22334384858044,7
0.05,1585,94,138343,87.22761664564943,8
0.05,1586,94,138437,87.23188405797102,7
0.05,1587,96,138533,87.23740554156171,6
0.05,1588,91,138624,87.23977344241662,10
0.05,1589,96,138720,87.24528301886792,6
0.05,1590,92,138812,87.24827152734129,10
0.05,1591,94,138906,87.25251256281408,7
0.05,1592,92,138998,87.25549278091651,9
0.05,1593,92,139090,87.25846925972397,9
0.05,1594,94,139184,87.26269592476488,7
0.05,1595,88,139272,87.26315789473684,13
0.05,1596,94,139366,87.26737633061991,7
0.05,1597,95,139461,87.27221526908636,6
0.05,1598,95,139556,87.27704815509694,6
0.05,1599,94,139650,87.28125,7
0.05,1600,95,139745,87.28607120549657,6
0.05,1601,95,139840,87.29088639200998,6
0.05,1602,93,139933,87.29444791016843,8
0.05,1603,24,139957,87.25498753117208,8
0.05,1604,94,140051,87.25919003115264,7
0.05,1605,93,140144,87.26276463262765,8
0.05,1606,90,140234,87.26446795270691,11
0.05,1607,23,140257,87.22450248756219,10
0.05,1608,95,140352,87.22933499067744,6
0.05,1609,90,140442,87.23105590062112,11
0.05,1610,94,140536,87.23525760397268,7
0.05,1611,93,140629,87.23883374689827,8
0.05,1612,95,140724,87.24364538127712,7
0.05,1613,23,140747,87.20384138785626,9
0.05,1614,95,140842,87.20866873065016,6
0.05,1615,94,140936,87.2128712871287,7
0.05,1616,93,141029,87.21645021645021,9
0.05,1617,27,141056,87.17923362175526,6
0.05,1618,94,141150,87.183446571958,7
0.05,1619,95,141245,87.18827160493827,6
0.05,1620,93,141338,87.19185687847008,8
0.05,1621,93,141431,87.19543773119605,8
0.05,1622,95,141526,87.20024645717807,6
0.05,1623,94,141620,87.20443349753694,7
0.05,1624,93,141713,87.208,8
0.05,1625,96,141809,87.21340713407135,6
0.05,1626,95,141904,87.21819299323909,6
0.05,1627,94,141998,87.22235872235872,7
0.05,1628,94,142092,87.22651933701657,7
0.05,1629,94,142186,87.23067484662576,7
0.05,1630,95,142281,87.23543838136113,6
0.05,1631,94,142375,87.23958333333333,7
0.05,1632,95,142470,87.24433557868953,8
0.05,1633,96,142566,87.24969400244798,6
0.05,1634,23,142589,87.21039755351681,9
0.05,1635,93,142682,87.21393643031784,8
0.05,1636,94,142776,87.2180818570556,7
0.05,1637,92,142868,87.22100122100122,9
0.05,1638,96,142964,87.22635753508237,6
0.05,1639,23,142987,87.18719512195122,10
0.05,1640,96,143083,87.19256550883607,6
0.05,1641,93,143176,87.19610231425091,8
0.05,1642,94,143270,87.20024345709069,7
0.05,1643,96,143366,87.20559610705597,6
0.05,1644,89,143455,87.20668693009118,12
0.05,1645,96,143551,87.2120291616039,7
0.05,1646,96,143647,87.2173649058895,6
0.05,1647,95,143742,87.22208737864078,7
0.05,1648,94,143836,87.22619769557308,8
0.05,1649,93,143929,87.22969696969697,8
0.05,1650,95,144024,87.2344033918837,6
0.05,1651,93,144117,87.23789346246973,9
0.05,1652,95,144212,87.24258923169994,8
0.05,1653,95,144307,87.24727932285369,6
0.05,1654,93,144400,87.25075528700906,8
0.05,1655,92,144492,87.2536231884058,9
0.05,1656,96,144588,87.25890162945082,6
0.05,1657,96,144684,87.26417370325693,6
0.05,1658,94,144778,87.26823387582881,7
0.05,1659,95,144873,87.27289156626506,7
0.05,1660,92,144965,87.27573750752559,9
0.05,1661,94,145059,87.2797833935018,7
0.05,1662,92,145151,87.28262176788935,9
0.05,1663,95,145246,87.28725961538461,6
0.05,1664,94,145340,87.29129129129129,7
0.05,1665,25,145365,87.25390156062424,8
0.05,1666,94,145459,87.25794841031794,7
0.05,1667,94,145553,87.26199040767386,7
0.05,1668,93,145646,87.26542840023967,8
0.05,1669,93,145739,87.2688622754491,8
0.05,1670,94,145833,87.27289048473968,7
0.05,1671,92,145925,87.27571770334929,9
0.05,1672,93,146018,87.27913927077107,8
0.05,1673,96,146114,87.28434886499403,6
0.05,1674,96,146210,87.28955223880597,6
0.05,1675,95,146305,87.29415274463007,6
0.05,1676,96,146401,87.29934406678592,6
0.05,1677,92,146493,87.30214541120381,9
0.05,1678,94,146587,87.30613460393091,7
0.05,1679,93,146680,87.30952380952381,8
0.05,1680,95,146775,87.31409875074361,6
0.05,1681,94,146869,87.31807372175982,7
0.05,1682,94,146963,87.3220439691028,7
0.05,1683,95,147058,87.32660332541568,7
0.05,1684,90,147148,87.32818991097923,12
0.05,1685,95,147243,87.33274021352314,6
0.05,1686,94,147337,87.33669235328986,7
0.05,1687,94,147431,87.34063981042654,7
0.05,1688,92,147523,87.3433984606276,9
0.05,1689,92,147615,87.34615384615384,9
0.05,1690,94,147709,87.35008870490834,8
0.05,1691,92,147801,87.35283687943263,9
0.05,1692,-48,147753,87.27288836385115,12
0.05,1693,93,147846,87.27626918536009,8
0.05,1694,94,147940,87.28023598820059,7
0.05,1695,94,148034,87.28419811320755,8
0.05,1696,95,148129,87.28874484384207,6
0.05,1697,94,148223,87.2926972909305,7
0.05,1698,96,148319,87.29782224838141,6
0.05,1699,93,148412,87.30117647058823,8
0.05,1700,92,148504,87.30393885949441,10
0.05,1701,94,148598,87.30787309048179,7
0.05,1702,23,148621,87.27011156782149,9
0.05,1703,95,148716,87.27464788732394,6
0.05,1704,92,148808,87.27741935483871,9
0.05,1705,96,148904,87.28253223915593,6
0.05,1706,95,148999,87.28705330990041,7
0.05,1707,21,149020,87.24824355971897,11
0.05,1708,94,149114,87.25219426565243,8
0.05,1709,92,149206,87.25497076023392,9
0.05,1710,92,149298,87.25774400935126,9
0.05,1711,94,149392,87.26168224299066,7
0.05,1712,96,149488,87.266783420899,6
0.05,1713,94,149582,87.27071178529755,7
0.05,1714,95,149677,87.27521865889213,6
0.05,1715,96,149773,87.28030303030303,6
0.05,1716,21,149794,87.2417006406523,11
0.05,1717,95,149889,87.24621653084982,6
0.05,1718,92,149981,87.24898196625945,9
0.05,1719,93,150074,87.25232558139535,8
0.05,1720,95,150169,87.25682742591516,6
0.05,1721,24,150193,87.22009291521486,8
0.05,1722,94,150287,87.22402785838653,7
0.05,1723,93,150380,87.22737819025522,9
0.05,1724,90,150470,87.22898550724638,11
0.05,1725,96,150566,87.23406720741599,6
0.05,1726,89,150655,87.23508975101332,12
0.05,1727,94,150749,87.23900462962963,7
0.05,1728,95,150844,87.2434933487565,6
0.05,1729,95,150939,87.24797687861272,6
0.05,1730,96,151035,87.2530329289428,6
0.05,1731,94,151129,87.25692840646651,7
0.05,1732,92,151221,87.2596653202539,9
0.05,1733,93,151314,87.26297577854672,8
0.05,1734,-50,151264,87.18386167146974,13
0.05,1735,95,151359,87.18836405529954,7
0.05,1736,92,151451,87.19113413932067,9
0.05,1737,92,151543,87.19390103567319,9
0.05,1738,93,151636,87.19723979298448,8
0.05,1739,95,151731,87.20172413793104,6
0.05,1740,27,151758,87.1671453187823,6
0.05,1741,94,151852,87.17106773823191,7
0.05,1742,95,151947,87.17555938037866,6
0.05,1743,95,152042,87.18004587155963,6
0.05,1744,94,152136,87.1839541547278,7
0.05,1745,95,152231,87.18843069873998,7
0.05,1746,94,152325,87.19232970807099,7
0.05,1747,93,152418,87.19565217391305,8
0.05,1748,93,152511,87.19897084048027,8
0.05,1749,93,152604,87.20228571428571,8
0.05,1750,94,152698,87.20616790405482,7
0.05,1751,95,152793,87.21061643835617,7
0.05,1752,94,152887,87.21448944666287,7
0.05,1753,92,152979,87.21721778791334,9
0.05,1754,94,153073,87.22108262108262,7
0.05,1755,95,153168,87.2255125284738,6
0.05,1756,94,153262,87.22936824132043,7
0.05,1757,96,153358,87.23435722411831,6
0.05,1758,96,153454,87.23934053439454,6
0.05,1759,96,153550,87.24431818181819,6
0.05,1760,93,153643,87.24758659852357,8
0.05,1761,94,153737,87.25141884222475,8
0.05,1762,93,153830,87.25467952353942,8
0.05,1763,93,153923,87.2579365079365,8
0.05,1764,95,154018,87.26232294617564,6
0.05,1765,95,154113,87.26670441676104,6
0.05,1766,94,154207,87.27051499717035,7
0.05,1767,95,154302,87.27488687782805,6
0.05,1768,90,154392,87.27642736009045,11
0.05,1769,92,154484,87.27909604519775,9
0.05,1770,96,154580,87.2840203274986,6
0.05,1771,95,154675,87.28837471783295,6
0.05,1772,19,154694,87.24985899605188,13
0.05,1773,90,154784,87.25140924464488,11
0.05,1774,96,154880,87.25633802816901,6
0.05,1775,96,154976,87.26126126126127,6
0.05,1776,96,155072,87.26617895329207,6
0.05,1777,93,155165,87.26940382452193,9
0.05,1778,25,155190,87.23440134907251,8
0.05,1779,95,155285,87.23876404494382,6
0.05,1780,94,155379,87.24256035934869,7
0.05,1781,92,155471,87.24523007856341,9
0.05,1782,94,155565,87.24901850813237,7
0.05,1783,95,155660,87.25336322869956,6
0.05,1784,94,155754,87.25714285714285,7
0.05,1785,95,155849,87.26147816349383,7
0.05,1786,96,155945,87.26636821488528,6
0.05,1787,94,156039,87.27013422818791,7
0.05,1788,96,156135,87.2750139742873,6
0.05,1789,94,156229,87.27877094972067,8
0.05,1790,24,156253,87.24343941931882,8
0.05,1791,94,156347,87.24720982142857,8
0.05,1792,92,156439,87.24986056887897,9
0.05,1793,91,156530,87.25195094760312,10
0.05,1794,93,156623,87.25515320334262,8
0.05,1795,94,156717,87.25890868596882,7
0.05,1796,94,156811,87.26265998887034,7
0.05,1797,94,156905,87.26640711902114,8
0.05,1798,95,157000,87.27070594774875,6
0.05,1799,94,157094,87.27444444444444,7
0.05,1800,94,157188,87.27817878956135,7
0.05,1801,95,157283,87.28246392896781,6
0.05,1802,94,157377,87.28618968386023,7
0.05,1803,92,157469,87.28880266075387,9
0.05,1804,91,157560,87.29085872576178,10
0.05,1805,94,157654,87.29457364341086,8
0.05,1806,95,157749,87.29883785279469,6
0.05,1807,94,157843,87.30254424778761,7
0.05,1808,95,157938,87.30679933665009,7
0.05,1809,92,158030,87.30939226519337,10
0.05,1810,95,158125,87.31363887355053,6
0.05,1811,95,158220,87.31788079470199,6
0.05,1812,94,158314,87.32156646442361,7
0.05,1813,22,158336,87.28555678059537,10
0.05,1814,94,158430,87.2892561983471,7
0.05,1815,23,158453,87.25385462555066,11
0.05,1816,93,158546,87.25701706108971,8
0.05,1817,94,158640,87.26072607260726,7
0.05,1818,94,158734,87.26443100604727,7
0.05,1819,94,158828,87.26813186813187,7
0.05,1820,96,158924,87.27292696320703,6
0.05,1821,94,159018,87.27661909989023,7
0.05,1822,95,159113,87.28085573230938,6
0.05,1823,96,159209,87.28563596491227,6
0.05,1824,96,159305,87.2904109589041,6
0.05,1825,94,159399,87.29408543263965,7
0.05,1826,96,159495,87.29885057471265,6
0.05,1827,93,159588,87.3019693654267,8
0.05,1828,94,159682,87.30563149261891,7
0.05,1829,94,159776,87.30928961748634,7
0.05,1830,94,159870,87.31294374658657,7
0.05,1831,93,159963,87.3160480349345,8
0.05,1832,95,160058,87.3202400436443,6
0.05,1833,93,160151,87.32333696837513,8
0.05,1834,95,160246,87.3275204359673,6
0.05,1835,95,160341,87.33169934640523,6
0.05,1836,94,160435,87.33532934131736,7
0.05,1837,94,160529,87.33895538628944,8
0.05,1838,95,160624,87.3431212615552,6
0.05,1839,96,160720,87.34782608695652,6
0.05,1840,93,160813,87.35089625203693,8
0.05,1841,25,160838,87.31704668838219,7
0.05,1842,93,160931,87.32013022246338,8
0.05,1843,94,161025,87.32375271149675,8
0.05,1844,23,161048,87.28888888888889,10
0.05,1845,94,161142,87.29252437703141,8
0.05,1846,94,161236,87.29615592853276,7
0.05,1847,95,161331,87.30032467532467,6
0.05,1848,96,161427,87.30502974580854,6
0.05,1849,95,161522,87.30918918918918,8
0.05,1850,94,161616,87.31280388978931,7
0.05,1851,93,161709,87.3158747300216,8
0.05,1852,94,161803,87.31948192120885,7
0.05,1853,95,161898,87.32362459546925,6
0.05,1854,94,161992,87.32722371967655,7
0.05,1855,94,162086,87.33081896551724,7
0.05,1856,91,162177,87.33279483037157,10
0.05,1857,95,162272,87.33692142088267,6
0.05,1858,95,162367,87.3410435718128,7
0.05,1859,95,162462,87.34516129032258,6
0.05,1860,93,162555,87.3481998925309,8
0.05,1861,96,162651,87.35284640171858,6
0.05,1862,94,162745,87.35641438539989,7
0.05,1863,95,162840,87.36051502145922,6
0.05,1864,94,162934,87.36407506702413,7
0.05,1865,92,163026,87.36655948553054,9
0.05,1866,93,163119,87.36957686127477,8
0.05,1867,95,163214,87.37366167023555,6
0.05,1868,95,163309,87.37774210807919,6
0.05,1869,92,163401,87.38021390374331,9
0.05,1870,96,163497,87.38482095136291,6
0.05,1871,95,163592,87.38888888888889,6
0.05,1872,93,163685,87.3918846769888,8
0.05,1873,93,163778,87.3948772678762,8
0.05,1874,95,163873,87.39893333333333,6
0.05,1875,24,163897,87.36513859275053,8
0.05,1876,95,163992,87.36920618007458,7
0.05,1877,21,164013,87.33386581469648,11
0.05,1878,94,164107,87.33741351782864,8
0.05,1879,93,164200,87.34042553191489,8
0.05,1880,94,164294,87.34396597554492,7
0.05,1881,96,164390,87.34856535600426,6
0.05,1882,94,164484,87.35209771640999,7
0.05,1883,94,164578,87.3556263269639,7
0.05,1884,92,164670,87.35809018567639,9
0.05,1885,94,164764,87.36161187698833,7
0.05,1886,93,164857,87.36459989401166,9
0.05,1887,94,164951,87.36811440677967,7
0.05,1888,95,165046,87.3721545791424,6
0.05,1889,95,165141,87.37619047619047,6
0.05,1890,94,165235,87.37969328397674,7
0.05,1891,94,165329,87.38319238900634,7
0.05,1892,92,165421,87.38563127311146,9
0.05,1893,93,165514,87.38859556494192,8
0.05,1894,94,165608,87.39208443271768,8
0.05,1895,95,165703,87.3960970464135,7
0.05,1896,93,165796,87.39905113336847,8
0.05,1897,95,165891,87.40305584826133,6
0.05,1898,94,165985,87.40652975250131,7
0.05,1899,27,166012,87.37473684210526,6
0.05,1900,94,166106,87.37822198842714,7
0.05,1901,92,166198,87.38065194532072,9
0.05,1902,91,166289,87.38255386232265,11
0.05,1903,96,166385,87.38707983193277,6
0.05,1904,94,166479,87.39055118110237,8
0.05,1905,94,166573,87.39401888772298,7
0.05,1906,93,166666,87.39695857367593,8
0.05,1907,91,166757,87.39884696016772,10
0.05,1908,94,166851,87.40230487166056,7
0.05,1909,95,166946,87.40628272251308,6
0.05,1910,94,167040,87.40973312401884,7
0.05,1911,91,167131,87.4116108786611,10
0.05,1912,92,167223,87.41400940930475,9
0.05,1913,94,167317,87.41745036572622,7
0.05,1914,93,167410,87.42036553524804,8
0.05,1915,92,167502,87.42275574112735,9
0.05,1916,94,167596,87.42618675013041,7
0.05,1917,95,167691,87.43013555787279,6
0.05,1918,95,167786,87.43408025013028,6
0.05,1919,90,167876,87.43541666666667,11
0.05,1920,94,167970,87.43883394065591,7
0.05,1921,95,168065,87.44276795005203,6
0.05,1922,21,168086,87.40821632865314,12
0.05,1923,95,168181,87.41216216216216,6
0.05,1924,93,168274,87.41506493506493,8
0.05,1925,94,168368,87.41848390446522,7
0.05,1926,94,168462,87.42189932537623,7
0.05,1927,25,168487,87.38952282157676,8
0.05,1928,93,168580,87.3924313115604,8
0.05,1929,91,168671,87.39430051813471,10
0.05,1930,94,168765,87.39772138788193,7
0.05,1931,96,168861,87.40217391304348,6
0.05,1932,94,168955,87.40558717020176,7
0.05,1933,96,169051,87.4100310237849,6
0.05,1934,94,169145,87.41343669250647,8
0.05,1935,94,169239,87.41683884297521,7
0.05,1936,95,169334,87.4207537429014,6
0.05,1937,93,169427,87.42363261093911,8
0.05,1938,95,169522,87.42753996905621,6
0.05,1939,95,169617,87.43144329896907,7
0.05,1940,94,169711,87.4348274085523,7
0.05,1941,95,169806,87.43872296601442,6
0.05,1942,95,169901,87.4426145136387,6
0.05,1943,90,169991,87.44393004115226,11
0.05,1944,94,170085,87.44730077120822,8
0.05,1945,94,170179,87.45066803699898,7
0.05,1946,94,170273,87.45403184386235,7
0.05,1947,92,170365,87.45636550308008,9
0.05,1948,95,170460,87.46023601847101,6
0.05,1949,93,170553,87.46307692307693,8
0.05,1950,92,170645,87.46540235776524,9
0.05,1951,27,170672,87.43442622950819,6
0.05,1952,93,170765,87.43727598566308,8
0.05,1953,94,170859,87.44063459570113,7
0.05,1954,94,170953,87.44398976982097,7
0.05,1955,94,171047,87.44734151329243,7
0.05,1956,96,171143,87.4517118037813,6
0.05,1957,94,171237,87.45505617977528,7
0.05,1958,96,171333,87.4594180704441,6
0.05,1959,93,171426,87.46224489795918,8
0.05,1960,96,171522,87.46659867414584,6
0.05,1961,93,171615,87.46941896024465,8
0.05,1962,91,171706,87.47121752419766,10
0.05,1963,96,171802,87.4755600814664,6
0.05,1964,-48,171754,87.40661577608142,11
0.05,1965,22,171776,87.37334689725331,10
0.05,1966,93,171869,87.37620742247077,8
0.05,1967,95,171964,87.380081300813,6
0.05,1968,93,172057,87.38293550025394,8
0.05,1969,27,172084,87.35228426395939,6
0.05,1970,94,172178,87.3556570268899,7
0.05,1971,92,172270,87.3580121703854,9
0.05,1972,94,172364,87.3613786112519,7
0.05,1973,94,172458,87.36474164133739,7
0.05,1974,95,172553,87.3686075949367,8
0.05,1975,95,172648,87.37246963562752,6
0.05,1976,95,172743,87.3763277693475,6
0.05,1977,95,172838,87.38018200202224,6
0.05,1978,95,172933,87.38403233956544,6
0.05,1979,93,173026,87.38686868686868,8
0.05,1980,94,173120,87.3902069661787,7
0.05,1981,88,173208,87.39051463168516,13
0.05,1982,96,173304,87.3948562783661,6
0.05,1983,92,173396,87.39717741935483,9
0.05,1984,94,173490,87.40050377833754,7
0.05,1985,95,173585,87.4043303121853,6
0.05,1986,95,173680,87.40815299446402,6
0.05,1987,93,173773,87.41096579476861,8
0.05,1988,94,173867,87.41427853192559,7
0.05,1989,94,173961,87.41758793969849,7
0.05,1990,94,174055,87.42089402310397,7
0.05,1991,91,174146,87.4226907630522,10
0.05,1992,96,174242,87.42699448068238,6
0.05,1993,94,174336,87.43029087261786,7
0.05,1994,27,174363,87.4,6
0.05,1995,90,174453,87.40130260521042,11
0.05,1996,-44,174409,87.33550325488233,8
0.05,1997,94,174503,87.33883883883884,7
0.05,1998,95,174598,87.34267133566783,6
0.05,1999,23,174621,87.3105,9
0.05,2000,96,174717,87.31484257871064,6
0.05,2001,93,174810,87.31768231768231,8
0.05,2002,94,174904,87.32101847229156,8
0.05,2003,93,174997,87.32385229540918,8
0.05,2004,92,175089,87.32618453865337,9
0.05,2005,93,175182,87.32901296111665,9
0.05,2006,92,175274,87.33134030891878,9
0.05,2007,95,175369,87.3351593625498,6
0.05,2008,22,175391,87.3026381284221,10
0.05,2009,96,175487,87.30696517412936,6
0.05,2010,95,175582,87.31079065141721,8
0.05,2011,94,175676,87.31411530815109,7
0.05,2012,94,175770,87.31743666169896,7
0.05,2013,96,175866,87.32174776564051,6
0.05,2014,93,175959,87.32456575682382,8
0.05,2015,95,176054,87.32837301587301,6
0.05,2016,95,176149,87.33217649975211,7
0.05,2017,92,176241,87.33448959365708,9
0.05,2018,96,176337,87.33878157503715,6
0.05,2019,93,176430,87.34158415841584,8
0.05,2020,94,176524,87.34487877288471,7
0.05,2021,94,176618,87.34817012858556,7
0.05,2022,23,176641,87.31636183885318,9
0.05,2023,94,176735,87.31966403162055,7
0.05,2024,96,176831,87.32395061728396,6
0.05,2025,92,176923,87.32625863770977,9
0.05,2026,94,177017,87.32955106068081,7
0.05,2027,93,177110,87.33234714003945,8
0.05,2028,96,177206,87.33661902414983,6
0.05,2029,94,177300,87.33990147783251,7
0.05,2030,94,177394,87.34318069916297,7
0.05,2031,94,177488,87.34645669291339,7
0.05,2032,23,177511,87.31480570585342,9
0.05,2033,95,177606,87.31858407079646,6
0.05,2034,95,177701,87.32235872235873,6
0.05,2035,94,177795,87.32563850687623,7
0.05,2036,91,177886,87.32744231713303,10
0.05,2037,24,177910,87.2963689892051,9
0.05,2038,94,178004,87.29965669445806,7
0.05,2039,87,178091,87.29950980392157,14
0.05,2040,94,178185,87.30279274865262,7
0.05,2041,94,178279,87.30607247796279,7
0.05,2042,93,178372,87.30885952031326,8
0.05,2043,93,178465,87.31164383561644,8
0.05,2044,93,178558,87.31442542787286,8
0.05,2045,21,178579,87.28201368523949,11
0.05,2046,23,178602,87.25061064973131,9
0.05,2047,93,178695,87.25341796875,8
0.05,2048,94,178789,87.25671059053197,7
0.05,2049,94,178883,87.26,7
0.05,2050,96,178979,87.2642613359337,6
0.05,2051,94,179073,87.26754385964912,7
0.05,2052,95,179168,87.27131027764247,6
0.05,2053,93,179261,87.27409931840312,9
0.05,2054,95,179356,87.2778588807786,6
0.05,2055,94,179450,87.28112840466926,7
0.05,2056,96,179546,87.28536703937773,6
0.05,2057,96,179642,87.28960155490768,6
0.05,2058,92,179734,87.29188926663429,9
0.05,2059,94,179828,87.29514563106797,7
0.05,2060,95,179923,87.29888403687531,7
0.05,2061,94,180017,87.30213385063045,7
0.05,2062,96,180113,87.30634997576345,6
0.05,2063,94,180207,87.30959302325581,7
0.05,2064,94,180301,87.31283292978208,7
0.05,2065,94,180395,87.3160696999032,7
0.05,2066,94,180489,87.31930333817127,7
0.05,2067,96,180585,87.323500967118,6
0.05,2068,90,180675,87.3247945867569,11
0.05,2069,94,180769,87.3280193236715,7
0.05,2070,93,180862,87.33075808788026,8
0.05,2071,27,180889,87.30164092664093,6
0.05,2072,96,180985,87.30583695127834,6
0.05,2073,94,181079,87.30906460945033,7
0.05,2074,93,181172,87.31180722891567,8
0.05,2075,92,181264,87.3140655105973,9
0.05,2076,94,181358,87.31728454501685,8
0.05,2077,24,181382,87.28681424446583,8
0.05,2078,94,181476,87.29004329004329,7
0.05,2079,96,181572,87.29423076923077,6
0.05,2080,95,181667,87.29793368572801,6
0.05,2081,93,181760,87.30067243035543,9
0.05,2082,94,181854,87.30388862217954,7
0.05,2083,94,181948,87.30710172744722,7
0.05,2084,18,181966,87.27386091127099,14
0.05,2085,95,182061,87.27756471716204,6
0.05,2086,95,182156,87.28126497364639,6
0.05,2087,93,182249,87.28400383141762,8
0.05,2088,88,182337,87.28434657730972,13
0.05,2089,95,182432,87.28803827751196,6
0.05,2090,95,182527,87.29172644667624,7
0.05,2091,94,182621,87.29493307839388,7
0.05,2092,94,182715,87.29813664596273,7
0.05,2093,23,182738,87.26743075453678,9
0.05,2094,92,182830,87.26968973747017,9
0.05,2095,94,182924,87.27290076335878,7
0.05,2096,94,183018,87.2761087267525,7
0.05,2097,95,183113,87.27979027645377,6
0.05,2098,94,183207,87.28299190090519,8
0.05,2099,92,183299,87.2852380952381,9
0.05,2100,92,183391,87.2874821513565,9
0.05,2101,94,183485,87.290675547098,7
0.05,2102,94,183579,87.29386590584879,7
0.05,2103,94,183673,87.29705323193916,7
0.05,2104,95,183768,87.30071258907364,6
0.05,2105,21,183789,87.26923076923077,11
0.05,2106,94,183883,87.27242524916943,7
0.05,2107,95,183978,87.27609108159393,6
0.05,2108,93,184071,87.27880512091038,9
0.05,2109,94,184165,87.28199052132702,7
0.05,2110,96,184261,87.28612032212222,7
0.05,2111,96,184357,87.29024621212122,6
0.05,2112,95,184452,87.2938949361098,6
0.05,2113,94,184546,87.29706717123936,7
0.05,2114,94,184640,87.30023640661939,7
0.05,2115,92,184732,87.30245746691871,9
0.05,2116,93,184825,87.30514879546529,8
0.05,2117,95,184920,87.30878186968839,6
0.05,2118,94,185014,87.31193959414819,7
0.05,2119,94,185108,87.31509433962265,7
0.05,2120,95,185203,87.31871758604431,6
0.05,2121,95,185298,87.32233741753063,6
0.05,2122,-49,185249,87.25812529439473,12
0.05,2123,94,185343,87.26129943502825,7
0.05,2124,95,185438,87.26494117647059,6
0.05,2125,27,185465,87.23659454374412,6
0.05,2126,23,185488,87.20639398213446,9
0.05,2127,94,185582,87.20958646616542,8
0.05,2128,96,185678,87.21371535932363,6
0.05,2129,94,185772,87.21690140845071,7
0.05,2130,95,185867,87.22055373064289,7
0.05,2131,96,185963,87.22467166979362,6
0.05,2132,94,186057,87.22784810126582,7
0.05,2133,95,186152,87.2314901593252,6
0.05,2134,96,186248,87.23559718969555,6
0.05,2135,95,186343,87.23923220973782,6
0.05,2136,92,186435,87.24145999064109,9
0.05,2137,25,186460,87.21234798877455,8
0.05,2138,94,186554,87.21552127162225,7
0.05,2139,94,186648,87.21869158878505,7
0.05,2140,94,186742,87.2218589444185,8
0.05,2141,92,186834,87.22408963585434,9
0.05,2142,92,186926,87.2263182454503,10
0.05,2143,94,187020,87.2294776119403,7
0.05,2144,92,187112,87.23170163170163,9
0.05,2145,96,187208,87.23578751164958,6
0.05,2146,95,187303,87.23940381928271,6
0.05,2147,94,187397,87.2425512104283,7
0.05,2148,94,187491,87.24569567240577,7
0.05,2149,94,187585,87.24883720930232,7
0.05,2150,92,187677,87.2510460251046,9
0.05,2151,95,187772,87.2546468401487,6
0.05,2152,92,187864,87.25685090571295,9
0.05,2153,26,187890,87.2284122562674,7
0.05,2154,95,187985,87.23201856148492,7
0.05,2155,92,188077,87.23423005565863,9
0.05,2156,93,188170,87.23690310616597,9
0.05,2157,24,188194,87.20759962928638,9
0.05,2158,92,188286,87.20981936081519,9
0.05,2159,94,188380,87.21296296296296,7
0.05,2160,95,188475,87.21656640444239,6
0.05,2161,95,188570,87.22016651248843,6
0.05,2162,94,188664,87.22330097087378,7
0.05,2163,94,188758,87.2264325323475,7
0.05,2164,96,188854,87.23048498845266,6
0.05,2165,91,188945,87.23222530009234,10
0.05,2166,96,189041,87.23627134287032,6
0.05,2167,94,189135,87.23939114391143,7
0.05,2168,23,189158,87.20977408944213,10
0.05,2169,95,189253,87.21336405529954,6
0.05,2170,25,189278,87.1847075080608,8
0.05,2171,96,189374,87.18876611418048,6
0.05,2172,94,189468,87.19190059825127,7
0.05,2173,94,189562,87.19503219871206,8
0.05,2174,93,189655,87.19770114942528,8
0.05,2175,90,189745,87.19898897058823,11
0.05,2176,23,189768,87.16949931097841,9
0.05,2177,94,189862,87.17263544536272,7
0.05,2178,91,189953,87.17439192290041,11
0.05,2179,94,190047,87.17752293577982,8
0.05,2180,95,190142,87.1811095827602,6
0.05,2181,94,190236,87.18423464711275,7
0.05,2182,94,190330,87.1873568483738,7
0.05,2183,94,190424,87.19047619047619,7
0.05,2184,95,190519,87.19405034324943,6
0.05,2185,95,190614,87.19762122598353,7
0.05,2186,94,190708,87.20073159579333,7
0.05,2187,93,190801,87.20338208409507,8
0.05,2188,23,190824,87.17405207857469,9
0.05,2189,93,190917,87.17671232876712,8
0.05,2190,95,191012,87.18028297581013,6
0.05,2191,27,191039,87.15282846715328,6
0.05,2192,21,191060,87.12266301869585,11
0.05,2193,96,191156,87.12670920692798,6
0.05,2194,96,191252,87.13075170842825,6
0.05,2195,93,191345,87.13342440801458,8
0.05,2196,94,191439,87.13654984069186,7
0.05,2197,96,191535,87.14058234758872,6
0.05,2198,94,191629,87.14370168258299,7
0.05,2199,94,191723,87.14681818181818,7
0.05,2200,96,191819,87.15084052703317,6
0.05,2201,96,191915,87.15485921889191,6
0.05,2202,95,192010,87.15842033590559,6
0.05,2203,93,192103,87.16107078039927,8
0.05,2204,89,192192,87.16190476190476,12
0.05,2205,95,192287,87.16545784224841,7
0.05,2206,-49,192238,87.10376076121432,12
0.05,2207,93,192331,87.1064311594203,8
0.05,2208,92,192423,87.10864644635582,9
0.05,2209,94,192517,87.11176470588235,7
0.05,2210,94,192611,87.11488014473089,7
0.05,2211,93,192704,87.11754068716094,8
0.05,2212,93,192797,87.12019882512426,8
0.05,2213,24,192821,87.09168925022584,8
0.05,2214,96,192917,87.09571106094808,6
0.05,2215,24,192941,87.06723826714801,8
0.05,2216,94,193035,87.0703653585927,7
0.05,2217,-115,192920,86.97926059513075,10
0.05,2218,95,193015,86.98287516899504,7
0.05,2219,91,193106,86.98468468468468,10
0.05,2220,94,193200,86.98784331382261,7
0.05,2221,94,193294,86.99099909990998,7
0.05,2222,94,193388,86.99415204678363,7
0.05,2223,96,193484,86.99820143884892,6
0.05,2224,94,193578,87.00134831460674,7
0.05,2225,93,193671,87.00404312668464,8
0.05,2226,94,193765,87.00718455321059,7
0.05,2227,91,193856,87.00897666068222,10
0.05,2228,94,193950,87.0121130551817,7
0.05,2229,92,194042,87.01434977578475,10
0.05,2230,94,194136,87.01748095024652,7
0.05,2231,94,194230,87.02060931899642,7
0.05,2232,95,194325,87.02418271383789,6
0.05,2233,89,194414,87.02506714413607,12
0.05,2234,94,194508,87.0281879194631,7
0.05,2235,94,194602,87.03130590339893,7
0.05,2236,93,194695,87.03397407241842,8
0.05,2237,95,194790,87.03753351206434,7
0.05,2238,94,194884,87.04064314426083,7
0.05,2239,95,194979,87.04419642857142,6
0.05,2240,96,195075,87.04819277108433,6
0.05,2241,94,195169,87.05129348795718,7
0.05,2242,95,195264,87.05483727151137,6
0.05,2243,91,195355,87.0565953654189,10
0.05,2244,96,195451,87.06057906458797,6
0.05,2245,95,195546,87.06411398040962,7
0.05,2246,94,195640,87.06720071206053,7
0.05,2247,96,195736,87.0711743772242,6
0.05,2248,93,195829,87.0738105824811,9
0.05,2249,94,195923,87.07688888888889,7
0.05,2250,95,196018,87.08040870724123,6
0.05,2251,96,196114,87.08436944937833,6
0.05,2252,92,196206,87.08655126498003,9
0.05,2253,95,196301,87.09006211180125,6
0.05,2254,94,196395,87.09312638580931,7
0.05,2255,94,196489,87.09618794326241,7
0.05,2256,95,196584,87.09968985378822,6
0.05,2257,19,196603,87.06953055801594,14
0.05,2258,94,196697,87.07259849490926,7
0.05,2259,95,196792,87.07610619469027,6
0.05,2260,25,196817,87.04865103936311,7
0.05,2261,90,196907,87.04995579133511,11
0.05,2262,96,197003,87.05391073795846,6
0.05,2263,93,197096,87.0565371024735,8
0.05,2264,96,197192,87.06048565121412,6
0.05,2265,95,197287,87.0639894086496,6
0.05,2266,94,197381,87.06704896338773,7
0.05,2267,93,197474,87.06966490299824,8
0.05,2268,94,197568,87.07271925958572,7
0.05,2269,92,197660,87.0748898678414,10
0.05,2270,93,197753,87.07749889916336,8
0.05,2271,96,197849,87.08142605633803,6
0.05,2272,19,197868,87.05147382314122,13
0.05,2273,93,197961,87.05408970976254,8
0.05,2274,95,198056,87.05758241758242,7
0.05,2275,96,198152,87.06151142355009,6
0.05,2276,93,198245,87.0641194554238,8
0.05,2277,26,198271,87.03731343283582,7
0.05,2278,96,198367,87.04124616059676,6
0.05,2279,93,198460,87.04385964912281,8
0.05,2280,96,198556,87.04778605874617,6
0.05,2281,92,198648,87.04995617879054,9
0.05,2282,96,198744,87.053876478318,6
0.05,2283,92,198836,87.05604203152365,9
0.05,2284,89,198925,87.05689277899343,13
0.05,2285,95,199020,87.06036745406824,6
0.05,2286,94,199114,87.063401836467,7
0.05,2287,94,199208,87.06643356643356,7
0.05,2288,96,199304,87.07033639143731,6
0.05,2289,93,199397,87.07292576419214,8
0.05,2290,92,199489,87.0750763858577,9
0.05,2291,94,199583,87.0780977312391,7
0.05,2292,96,199679,87.0819886611426,6
0.05,2293,95,199774,87.08544027898867,6
0.05,2294,94,199868,87.08845315904139,7
0.05,2295,94,199962,87.09146341463415,7
0.05,2296,95,200057,87.09490639965172,6
0.05,2297,23,200080,87.06701479547432,9
0.05,2298,92,200172,87.06916050456721,10
0.05,2299,95,200267,87.07260869565218,6
0.05,2300,95,200362,87.0760538896132,6
0.05,2301,94,200456,87.07906168549087,7
0.05,2302,95,200551,87.0825010855406,6
0.05,2303,-53,200498,87.02170138888889,16
0.05,2304,94,200592,87.02472885032537,7
0.05,2305,94,200686,87.02775368603643,7
0.05,2306,94,200780,87.03077589943649,7
0.05,2307,94,200874,87.03379549393414,7
0.05,2308,96,200970,87.0376786487657,6
0.05,2309,92,201062,87.03982683982684,9
0.05,2310,95,201157,87.04327131112073,7
0.05,2311,91,201248,87.04498269896193,10
0.05,2312,94,201342,87.0479896238651,7
0.05,2313,18,201360,87.0181503889369,14
0.05,2314,96,201456,87.02203023758099,6
0.05,2315,25,201481,86.99525043177893,8
0.05,2316,96,201577,86.99913681484678,6
0.05,2317,94,201671,87.00215703192407,7
0.05,2318,94,201765,87.00517464424321,7
0.05,2319,25,201790,86.97844827586206,8
0.05,2320,93,201883,86.98104265402844,9
0.05,2321,95,201978,86.98449612403101,6
0.05,2322,95,202073,86.98794662074903,6
0.05,2323,94,202167,86.99096385542168,7
0.05,2324,86,202253,86.9905376344086,15
0.05,2325,25,202278,86.96388650042992,8
0.05,2326,94,202372,86.96691018478728,7
0.05,2327,90,202462,86.96821305841924,11
0.05,2328,93,202555,86.97080291970804,8
0.05,2329,96,202651,86.97467811158798,6
0.05,2330,25,202676,86.94809094809095,8
0.05,2331,21,202697,86.91981132075472,11
0.05,2332,93,202790,86.9224174882126,9
0.05,2333,94,202884,86.92544987146529,7
0.05,2334,93,202977,86.92805139186295,8
0.05,2335,94,203071,86.93107876712328,7
0.05,2336,96,203167,86.9349593495935,6
0.05,2337,94,203261,86.93798118049615,7
0.05,2338,94,203355,86.94100042753314,7
0.05,2339,95,203450,86.94444444444444,6
0.05,2340,95,203545,86.94788551900898,6
0.05,2341,95,203640,86.95132365499573,7
0.05,2342,95,203735,86.9547588561673,7
0.05,2343,92,203827,86.95691126279864,9
0.05,2344,90,203917,86.95820895522388,11
0.05,2345,93,204010,86.96078431372548,8
0.05,2346,94,204104,86.96378355347252,7
0.05,2347,90,204194,86.96507666098807,11
0.05,2348,95,204289,86.96849723286505,7
0.05,2349,27,204316,86.94297872340425,6
0.05,2350,96,204412,86.94683113568693,6
0.05,2351,90,204502,86.94812925170068,11
0.05,2352,92,204594,86.95027624309392,11
0.05,2353,92,204686,86.95242141036533,9
0.05,2354,94,204780,86.95541401273886,8
0.05,2355,93,204873,86.95797962648557,8
0.05,2356,93,204966,86.96054306321595,8
0.05,2357,92,205058,86.9626802374894,9
0.05,2358,26,205084,86.9368376430691,7
0.05,2359,92,205176,86.93898305084745,9
0.05,2360,92,205268,86.9411266412537,9
0.05,2361,95,205363,86.94453852667232,7
0.05,2362,96,205459,86.94837071519255,6
0.05,2363,96,205555,86.95219966159053,6
0.05,2364,93,205648,86.95475687103594,8
0.05,2365,94,205742,86.95773457311918,7
0.05,2366,94,205836,86.96070975918884,7
0.05,2367,92,205928,86.96283783783784,10
0.05,2368,94,206022,86.96580835795694,7
0.05,2369,91,206113,86.96751054852321,10
0.05,2370,94,206207,86.97047659215521,7
0.05,2371,95,206302,86.97386172006745,7
0.05,2372,94,206396,86.97682258744206,7
0.05,2373,96,206492,86.98062342038753,6
0.05,2374,90,206582,86.98189473684211,11
0.05,2375,94,206676,86.98484848484848,8
0.05,2376,94,206770,86.98779974758098,8
0.05,2377,94,206864,86.99074852817493,7
0.05,2378,95,206959,86.99411517444304,6
0.05,2379,95,207054,86.99747899159664,6
0.05,2380,94,207148,87.00041999160017,7
0.05,2381,92,207240,87.00251889168766,9
0.05,2382,96,207336,87.00629458665547,6
0.05,2383,92,207428,87.00838926174497,9
0.05,2384,92,207520,87.01048218029351,9
0.05,2385,96,207616,87.01424979044425,6
0.05,2386,84,207700,87.01298701298701,17
0.05,2387,92,207792,87.01507537688443,9
0.05,2388,95,207887,87.01841774801171,6
0.05,2389,94,207981,87.02133891213388,7
0.05,2390,93,208074,87.02383939774153,8
0.05,2391,96,208170,87.02759197324414,6
0.05,2392,94,208264,87.03050564145424,7
0.05,2393,94,208358,87.03341687552214,7
0.05,2394,95,208453,87.03674321503132,6
0.05,2395,94,208547,87.03964941569282,7
0.05,2396,94,208641,87.04255319148936,7
0.05,2397,91,208732,87.0442035029191,10
0.05,2398,94,208826,87.04710295956649,7
0.05,2399,94,208920,87.05,7
0.05,2400,94,209014,87.05289462723864,7
0.05,2401,95,209109,87.05620316402998,6
0.05,2402,96,209205,87.05992509363296,6
0.05,2403,96,209301,87.06364392678869,6
0.05,2404,94,209395,87.06652806652806,8
0.05,2405,94,209489,87.0694098088113,7
0.05,2406,94,209583,87.07228915662651,7
0.05,2407,93,209676,87.07475083056478,8
0.05,2408,95,209771,87.0780406807804,6
0.05,2409,96,209867,87.08174273858921,6
0.05,2410,93,209960,87.08419742845292,9
0.05,2411,90,210050,87.08540630182421,11
0.05,2412,94,210144,87.08827186075425,7
0.05,2413,95,210239,87.09154929577464,7
0.05,2414,91,210330,87.09316770186335,10
0.05,2415,95,210425,87.09644039735099,6
0.05,2416,90,210515,87.09764170459248,11
0.05,2417,95,210610,87.10090984284533,6
0.05,2418,94,210704,87.10376188507648,7
0.05,2419,92,210796,87.10578512396694,9
0.05,2420,93,210889,87.10821974390748,10
0.05,2421,94,210983,87.11106523534269,7
0.05,2422,93,211076,87.11349566652909,8
0.05,2423,94,211170,87.11633663366337,7
0.05,2424,91,211261,87.1179381443299,10
0.05,2425,91,211352,87.11953833470734,10
0.05,2426,93,211445,87.12196126905644,8
0.05,2427,94,211539,87.12479406919275,8
0.05,2428,89,211628,87.12556607657473,12
0.05,2429,94,211722,87.1283950617284,7
0.05,2430,92,211814,87.13039901275195,9
0.05,2431,93,211907,87.1328125,8
0.05,2432,94,212001,87.13563501849569,7
0.05,2433,95,212096,87.13886606409203,6
0.05,2434,94,212190,87.14168377823408,7
0.05,2435,94,212284,87.14449917898193,7
0.05,2436,93,212377,87.14690192860074,8
0.05,2437,95,212472,87.1501230516817,6
0.05,2438,92,212564,87.15211152111522,10
0.05,2439,96,212660,87.15573770491804,6
0.05,2440,94,212754,87.15854158131913,7
0.05,2441,94,212848,87.16134316134315,8
0.05,2442,94,212942,87.16414244781006,7
0.05,2443,89,213031,87.16489361702128,12
0.05,2444,94,213125,87.1676891615542,7
0.05,2445,91,213216,87.16925592804579,10
0.05,2446,94,213310,87.17204740498569,7
0.05,2447,92,213402,87.17401960784314,9
0.05,2448,96,213498,87.177623519804,6
0.05,2449,91,213589,87.17918367346938,10
0.05,2450,94,213683,87.18196654426765,7
0.05,2451,93,213776,87.18433931484502,8
0.05,2452,92,213868,87.18630248675092,9
0.05,2453,95,213963,87.18948655256723,6
0.05,2454,96,214059,87.19307535641548,6
0.05,2455,94,214153,87.19584690553746,7
0.05,2456,90,214243,87.1969881969882,11
0.05,2457,94,214337,87.19975589910496,7
0.05,2458,94,214431,87.20252135014233,7
0.05,2459,96,214527,87.2060975609756,6
0.05,2460,92,214619,87.2080455099553,9
0.05,2461,90,214709,87.20917952883835,11
0.05,2462,93,214802,87.21153065367439,9
0.05,2463,94,214896,87.21428571428571,8
0.05,2464,94,214990,87.21703853955376,7
0.05,2465,94,215084,87.21978913219789,8
0.05,2466,94,215178,87.22253749493312,7
0.05,2467,93,215271,87.22487844408428,9
0.05,2468,96,215367,87.228432563791,6
0.05,2469,94,215461,87.23117408906883,7
0.05,2470,92,215553,87.23310400647512,9
0.05,2471,91,215644,87.23462783171522,10
0.05,2472,93,215737,87.23695915891629,8
0.05,2473,92,215829,87.23888439773646,9
0.05,2474,95,215924,87.2420202020202,6
0.05,2475,93,216017,87.24434571890146,9
0.05,2476,25,216042,87.21921679450949,7
0.05,2477,93,216135,87.22154963680387,8
0.05,2478,93,216228,87.22388059701493,8
0.05,2479,93,216321,87.22620967741935,8
0.05,2480,94,216415,87.22893994357113,7
0.05,2481,94,216509,87.23166800966962,7
0.05,2482,94,216603,87.23439387837294,7
0.05,2483,93,216696,87.23671497584542,8
0.05,2484,96,216792,87.24024144869216,6
0.05,2485,94,216886,87.24296057924377,7
0.05,2486,96,216982,87.2464817048653,6
0.05,2487,96,217078,87.25,6
0.05,2488,92,217170,87.25190839694656,9
0.05,2489,93,217263,87.25421686746988,10
0.05,2490,91,217354,87.25572059413891,10
0.05,2491,94,217448,87.25842696629213,7
0.05,2492,94,217542,87.26113116726835,7
0.05,2493,87,217629,87.26102646351244,14
0.05,2494,93,217722,87.2633266533066,8
0.05,2495,93,217815,87.265625,8
0.05,2496,94,217909,87.26832198638365,8
0.05,2497,96,218005,87.27181745396317,6
0.05,2498,91,218096,87.27330932372949,10
0.05,2499,94,218190,87.276,7
0.05,2500,95,218285,87.27908836465414,6
0.05,2501,94,218379,87.28177458033574,9
0.05,2502,91,218470,87.28326008789453,11
0.05,2503,94,218564,87.28594249201278,8
0.05,2504,92,218656,87.2878243512974,9
0.05,2505,96,218752,87.29130087789305,6
0.05,2506,94,218846,87.29397686477861,7
0.05,2507,94,218940,87.29665071770334,7
0.05,2508,92,219032,87.298525308888,9
0.05,2509,96,219128,87.30199203187252,6
0.05,2510,95,219223,87.30505774591796,6
0.05,2511,96,219319,87.30851910828025,6
0.05,2512,94,219413,87.31118185435734,7
0.05,2513,92,219505,87.31304693715195,9
0.05,2514,93,219598,87.31530815109343,9
0.05,2515,94,219692,87.31796502384738,7
0.05,2516,95,219787,87.32101708382996,7
0.05,2517,90,219877,87.3220810166799,11
0.05,2518,95,219972,87.32512901945216,7
0.05,2519,92,220064,87.32698412698413,9
0.05,2520,96,220160,87.33042443474811,6
0.05,2521,95,220255,87.33346550356859,6
0.05,2522,96,220351,87.33690051525961,6
0.05,2523,94,220445,87.33954041204437,7
0.05,2524,94,220539,87.34217821782178,7
0.05,2525,93,220632,87.34441805225653,8
0.05,2526,91,220723,87.34586466165413,10
0.05,2527,93,220816,87.34810126582279,8
0.05,2528,94,220910,87.35073151443258,8
0.05,2529,93,221003,87.35296442687748,11
0.05,2530,94,221097,87.35559067562228,7
0.05,2531,94,221191,87.35821484992101,8
0.05,2532,94,221285,87.36083695223056,7
0.05,2533,95,221380,87.36385161799527,6
0.05,2534,91,221471,87.36528599605522,10
0.05,2535,92,221563,87.36711356466877,9
0.05,2536,93,221656,87.36933385888845,8
0.05,2537,96,221752,87.37273443656423,6
0.05,2538,95,221847,87.37573847971642,6
0.05,2539,93,221940,87.37795275590551,8
0.05,2540,95,222035,87.38095238095238,7
0.05,2541,93,222128,87.38316286388671,8
0.05,2542,95,222223,87.38615808100668,8
0.05,2543,94,222317,87.38875786163523,7
0.05,2544,-47,222270,87.33595284872298,11
0.05,2545,93,222363,87.3381775333857,8
0.05,2546,95,222458,87.34118570867687,6
0.05,2547,93,222551,87.3434065934066,8
0.05,2548,91,222642,87.34484111416242,11
0.05,2549,92,222734,87.34666666666666,9
0.05,2550,93,222827,87.34888279106232,8
0.05,2551,96,222923,87.35227272727273,6
0.05,2552,93,223016,87.35448491970232,8
0.05,2553,21,223037,87.32850430696946,11
0.05,2554,94,223131,87.33111545988258,7
0.05,2555,93,223224,87.33333333333333,8
0.05,2556,92,223316,87.3351583887368,9
0.05,2557,96,223412,87.33854573885849,6
0.05,2558,96,223508,87.34193044157874,6
0.05,2559,93,223601,87.344140625,9
0.05,2560,95,223696,87.34713002733308,7
0.05,2561,95,223791,87.35011709601874,6
0.05,2562,95,223886,87.35310183378853,6
0.05,2563,26,223912,87.32917316692668,7
0.05,2564,96,224008,87.33255360623782,6
0.05,2565,95,224103,87.33554169914264,6
0.05,2566,96,224199,87.33891702376314,6
0.05,2567,94,224293,87.3415109034268,8
0.05,2568,92,224385,87.34332425068119,10
0.05,2569,94,224479,87.34591439688715,7
0.05,2570,94,224573,87.34850252819915,7
0.05,2571,92,224665,87.35031104199066,9
0.05,2572,95,224760,87.35328410415858,7
0.05,2573,90,224850,87.35431235431236,11
0.05,2574,95,224945,87.35728155339805,6
0.05,2575,95,225040,87.36024844720497,6
0.05,2576,94,225134,87.36282499029879,7
0.05,2577,91,225225,87.36423584173778,10
0.05,2578,94,225319,87.36680884063591,7
0.05,2579,94,225413,87.36937984496124,7
0.05,2580,92,225505,87.37117396358,10
0.05,2581,94,225599,87.37374128582495,7
0.05,2582,95,225694,87.37669376693766,6
0.05,2583,96,225790,87.38003095975232,6
0.05,2584,92,225882,87.38181818181818,9
0.05,2585,93,225975,87.38399071925754,8
0.05,2586,95,226070,87.38693467336684,7
0.05,2587,96,226166,87.3902627511592,6
0.05,2588,92,226258,87.39204325994592,9
0.05,2589,94,226352,87.3945945945946,7
0.05,2590,96,226448,87.39791586260131,6
0.05,2591,91,226539,87.39930555555556,10
0.05,2592,95,226634,87.40223679136136,6
0.05,2593,94,226728,87.4047802621434,7
0.05,2594,95,226823,87.40770712909442,6
0.05,2595,92,226915,87.40947611710324,9
0.05,2596,95,227010,87.41239892183289,7
0.05,2597,92,227102,87.41416474210932,9
0.05,2598,96,227198,87.41746825702194,6
0.05,2599,88,227286,87.4176923076923,13
0.05,2600,93,227379,87.41983852364476,8
0.05,2601,93,227472,87.42198308993082,9
0.05,2602,96,227568,87.4252785247791,6
0.05,2603,96,227664,87.42857142857143,6
0.05,2604,94,227758,87.43109404990403,7
0.05,2605,92,227850,87.43284727551803,9
0.05,2606,94,227944,87.43536632144227,7
0.05,2607,92,228036,87.43711656441718,9
0.05,2608,95,228131,87.44001533154466,6
0.05,2609,95,228226,87.44291187739464,7
0.05,2610,95,228321,87.44580620451934,6
0.05,2611,96,228417,87.4490811638591,6
0.05,2612,94,228511,87.45158821278224,7
0.05,2613,92,228603,87.45332823259372,9
0.05,2614,93,228696,87.45544933078394,8
0.05,2615,96,228792,87.45871559633028,6
0.05,2616,95,228887,87.46159724875812,7
0.05,2617,93,228980,87.46371275783041,8
0.05,2618,96,229076,87.46697212676594,6
0.05,2619,94,229170,87.46946564885496,8
0.05,2620,96,229266,87.47272033574971,6
0.05,2621,27,229293,87.44965675057209,6
0.05,2622,92,229385,87.45139153640869,9
0.05,2623,94,229479,87.45388719512195,8
0.05,2624,96,229575,87.45714285714286,6
0.05,2625,94,229669,87.45963442498096,8
0.05,2626,95,229764,87.46250475827941,6
0.05,2627,96,229860,87.46575342465754,6
0.05,2628,95,229955,87.46861924686192,6
0.05,2629,94,230049,87.47110266159696,8
0.05,2630,95,230144,87.47396427213987,6
0.05,2631,95,230239,87.47682370820668,6
0.05,2632,86,230325,87.47626281807824,15
0.05,2633,92,230417,87.47798025816249,9
0.05,2634,92,230509,87.47969639468691,11
0.05,2635,94,230603,87.48216995447648,8
0.05,2636,94,230697,87.48464163822526,8
0.05,2637,95,230792,87.48749052312358,7
0.05,2638,94,230886,87.48995831754452,7
0.05,2639,94,230980,87.49242424242425,7
0.05,2640,95,231075,87.49526694433926,6
0.05,2641,94,231169,87.49772899318698,7
0.05,2642,94,231263,87.5001891789633,7
0.05,2643,94,231357,87.50264750378214,9
0.05,2644,94,231451,87.50510396975426,7
0.05,2645,94,231545,87.50755857898714,7
0.05,2646,96,231641,87.51076690593125,6
0.05,2647,94,231735,87.5132175226586,8
0.05,2648,94,231829,87.51566628916572,7
0.05,2649,93,231922,87.5177358490566,8
0.05,2650,93,232015,87.51980384760468,8
0.05,2651,92,232107,87.52149321266968,9
0.05,2652,95,232202,87.52431209950998,6
0.05,2653,92,232294,87.525998492841,9
0.05,2654,94,232388,87.52843691148776,7
0.05,2655,94,232482,87.5308734939759,7
0.05,2656,26,232508,87.50771546857358,6
0.05,2657,94,232602,87.51015801354401,7
0.05,2658,25,232627,87.48664911620911,8
0.05,2659,92,232719,87.48834586466165,9
0.05,2660,93,232812,87.49041713641488,8
0.05,2661,93,232905,87.49248685199099,8
0.05,2662,94,232999,87.49493052947803,7
0.05,2663,94,233093,87.49737237237237,7
0.05,2664,93,233186,87.49943714821764,8
0.05,2665,92,233278,87.50112528132033,9
0.05,2666,91,233369,87.50243719535058,10
0.05,2667,95,233464,87.50524737631184,6
0.05,2668,96,233560,87.50843012364182,6
0.05,2669,94,233654,87.51086142322097,8
0.05,2670,95,233749,87.51366529389742,6
0.05,2671,94,233843,87.51609281437126,7
0.05,2672,96,233939,87.51926674148896,6
0.05,2673,95,234034,87.52206432311144,6
0.05,2674,95,234129,87.5248598130841,6
0.05,2675,93,234222,87.52690582959642,8
0.05,2676,96,234318,87.53007097497198,6
0.05,2677,92,234410,87.53174010455564,9
0.05,2678,95,234505,87.53452780888391,6
0.05,2679,92,234597,87.53619402985075,9
0.05,2680,93,234690,87.53823200298396,8
0.05,2681,93,234783,87.54026845637584,8
0.05,2682,95,234878,87.54304882594111,6
0.05,2683,93,234971,87.54508196721312,8
0.05,2684,93,235064,87.54711359404097,8
0.05,2685,94,235158,87.54951600893521,7
0.05,2686,95,235253,87.55228879791589,7
0.05,2687,94,235347,87.5546875,7
0.05,2688,87,235434,87.55448121978431,14
0.05,2689,94,235528,87.55687732342007,7
0.05,2690,93,235621,87.55890003716091,8
0.05,2691,90,235711,87.55980683506687,11
0.05,2692,27,235738,87.53731897512068,6
0.05,2693,96,235834,87.54046028210838,6
0.05,2694,92,235926,87.54211502782931,9
0.05,2695,94,236020,87.54451038575668,7
0.05,2696,96,236116,87.54764553207268,6
0.05,2697,92,236208,87.54929577464789,9
0.05,2698,95,236303,87.5520563171545,6
0.05,2699,95,236398,87.55481481481482,6
0.05,2700,96,236494,87.55794150314698,6
0.05,2701,94,236588,87.56032568467802,7
0.05,2702,94,236682,87.56270810210877,8
0.05,2703,94,236776,87.56508875739645,7
0.05,2704,93,236869,87.56709796672828,8
0.05,2705,94,236963,87.56947524020694,7
0.05,2706,96,237059,87.57258958256372,6
0.05,2707,94,237153,87.57496307237814,7
0.05,2708,96,237249,87.578073089701,6
0.05,2709,95,237344,87.58081180811809,6
0.05,2710,-53,237291,87.5289561047584,17
0.05,2711,96,237387,87.53207964601769,6
0.05,2712,92,237479,87.53372650202728,9
0.05,2713,94,237573,87.53610906411201,7
0.05,2714,94,237667,87.53848987108655,7
0.05,2715,94,237761,87.54086892488954,7
0.05,2716,92,237853,87.5425101214575,9
0.05,2717,94,237947,87.5448859455482,8
0.05,2718,96,238043,87.54799558661273,6
0.05,2719,94,238137,87.55036764705882,7
0.05,2720,96,238233,87.55347298787211,6
0.05,2721,94,238327,87.5558412931668,7
0.05,2722,96,238423,87.55894234300403,6
0.05,2723,94,238517,87.56130690161527,7
0.05,2724,91,238608,87.56256880733945,10
0.05,2725,95,238703,87.5652971386647,7
0.05,2726,26,238729,87.54272093876054,8
0.05,2727,93,238822,87.54472140762464,8
0.05,2728,92,238914,87.54635397581532,9
0.05,2729,94,239008,87.54871794871795,7
0.05,2730,93,239101,87.55071402416698,8
0.05,2731,93,239194,87.55270863836017,8
0.05,2732,95,239289,87.55543358946213,7
0.05,2733,96,239385,87.55852231163131,6
0.05,2734,95,239480,87.56124314442413,7
0.05,2735,94,239574,87.56359649122807,7
0.05,2736,94,239668,87.56594811837779,7
0.05,2737,95,239763,87.56866325785245,7
0.05,2738,94,239857,87.57101131799926,7
0.05,2739,93,239950,87.57299270072993,8
0.05,2740,92,240042,87.57460780736957,9
0.05,2741,96,240138,87.57768052516411,6
0.05,2742,94,240232,87.58002187386073,7
0.05,2743,94,240326,87.58236151603498,7
0.05,2744,94,240420,87.5846994535519,7
0.05,2745,94,240514,87.58703568827386,8
0.05,2746,88,240602,87.58718602111394,13
0.05,2747,94,240696,87.58951965065502,7
0.05,2748,95,240791,87.59221535103674,6
0.05,2749,93,240884,87.59418181818182,8
0.05,2750,94,240978,87.59651035986914,7
0.05,2751,95,241073,87.59920058139535,6
0.05,2752,94,241167,87.60152560842717,7
0.05,2753,24,241191,87.57843137254902,8
0.05,2754,94,241285,87.58076225045372,7
0.05,2755,92,241377,87.58236574746009,9
0.05,2756,94,241471,87.58469350743562,7
0.05,2757,92,241563,87.58629441624366,10
0.05,2758,96,241659,87.58934396520479,6
0.05,2759,94,241753,87.59166666666667,7
0.05,2760,96,241849,87.59471206084751,6
0.05,2761,92,241941,87.59630702389573,9
0.05,2762,93,242034,87.59826275787188,8
0.05,2763,95,242129,87.60094066570188,6
0.05,2764,96,242225,87.60397830018083,6
0.05,2765,94,242319,87.6062906724512,7
0.05,2766,96,242415,87.6093241778099,6
0.05,2767,96,242511,87.61235549132948,6
0.05,2768,94,242605,87.61466233297219,7
0.05,2769,92,242697,87.61624548736462,9
0.05,2770,94,242791,87.61854926019488,7
0.05,2771,93,242884,87.62049062049061,8
0.05,2772,90,242974,87.62134871979805,11
0.05,2773,93,243067,87.62328767123287,8
0.05,2774,94,243161,87.62558558558558,8
0.05,2775,94,243255,87.6278818443804,7
0.05,2776,95,243350,87.63053655023407,6
0.05,2777,96,243446,87.63354931605471,6
0.05,2778,95,243541,87.63620007196833,6
0.05,2779,95,243636,87.63884892086331,6
0.05,2780,90,243726,87.63969795037757,11
0.05,2781,91,243817,87.64090582314881,10
0.05,2782,95,243912,87.64355012576357,7
0.05,2783,92,244004,87.64511494252874,9
0.05,2784,91,244095,87.6463195691203,10
0.05,2785,94,244189,87.64860014357502,7
0.05,2786,96,244285,87.65159669895945,6
0.05,2787,92,244377,87.65315638450502,9
0.05,2788,96,244473,87.65614915740409,7
0.05,2789,94,244567,87.6584229390681,7
0.05,2790,94,244661,87.6606950913651,7
0.05,2791,96,244757,87.66368194842407,6
0.05,2792,94,244851,87.66595059076262,7
0.05,2793,94,244945,87.6682176091625,7
0.05,2794,94,245039,87.67048300536672,7
0.05,2795,93,245132,87.67238912732475,8
0.05,2796,95,245227,87.67500893814801,6
0.05,2797,24,245251,87.65225160829164,8
0.05,2798,94,245345,87.65451947123972,7
0.05,2799,94,245439,87.65678571428572,7
0.05,2800,93,245532,87.65869332381293,8
0.05,2801,94,245626,87.66095645967167,7
0.05,2802,92,245718,87.66250445950767,9
0.05,2803,94,245812,87.66476462196862,7
0.05,2804,94,245906,87.66702317290553,7
0.05,2805,95,246001,87.6696364932288,6
0.05,2806,95,246096,87.67224795154969,6
0.05,2807,94,246190,87.67450142450143,7
0.05,2808,90,246280,87.67532929868281,11
0.05,2809,96,246376,87.67829181494662,6
0.05,2810,94,246470,87.6805407328353,8
0.05,2811,95,246565,87.68314366998578,6
0.05,2812,94,246659,87.68538926413082,7
0.05,2813,94,246753,87.68763326226012,7
0.05,2814,95,246848,87.69023090586145,7
0.05,2815,94,246942,87.6924715909091,7
0.05,2816,96,247038,87.6954206602769,6
0.05,2817,94,247132,87.69765791341376,7
0.05,2818,95,247227,87.70024831500533,7
0.05,2819,94,247321,87.70248226950355,8
0.05,2820,96,247417,87.70542360864941,6
0.05,2821,94,247511,87.70765414599575,7
0.05,2822,95,247606,87.7102373361672,6
0.05,2823,94,247700,87.71246458923513,7
0.05,2824,92,247792,87.71398230088495,9
0.05,2825,95,247887,87.71656050955414,6
0.05,2826,94,247981,87.71878316236293,7
0.05,2827,94,248075,87.72100424328147,8
0.05,2828,26,248101,87.69918699186992,8
0.05,2829,96,248197,87.70212014134276,6
0.05,2830,94,248291,87.70434475450371,7
0.05,2831,96,248387,87.70727401129943,6
0.05,2832,89,248476,87.70773032121426,12
0.05,2833,91,248567,87.70889202540579,11
0.05,2834,93,248660,87.71075837742504,8
0.05,2835,92,248752,87.71227080394922,9
0.05,2836,94,248846,87.71448713429679,7
0.05,2837,95,248941,87.71705426356588,6
0.05,2838,27,248968,87.6956674885523,6
0.05,2839,91,249059,87.6968309859155,10
0.05,2840,93,249152,87.69869764167547,8
0.05,2841,93,249245,87.70056298381421,8
0.05,2842,91,249336,87.70172353148082,10
0.05,2843,90,249426,87.70253164556962,12
0.05,2844,90,249516,87.70333919156415,11
0.05,2845,96,249612,87.70625439212931,6
0.05,2846,96,249708,87.70916754478398,6
0.05,2847,94,249802,87.71137640449439,7
0.05,2848,93,249895,87.71323271323271,8
0.05,2849,94,249989,87.71543859649123,7
0.05,2850,95,250084,87.71799368642581,6
0.05,2851,96,250180,87.72089761570828,6
0.05,2852,94,250274,87.72309849281459,8
0.05,2853,93,250367,87.7249474421864,9
0.05,2854,93,250460,87.72679509632223,8
0.05,2855,95,250555,87.72934173669468,6
0.05,2856,94,250649,87.73153657682884,7
0.05,2857,91,250740,87.73268019594121,11
0.05,2858,96,250836,87.73557187827912,6
0.05,2859,93,250929,87.73741258741259,8
0.05,2860,95,251024,87.73995106606081,6
0.05,2861,27,251051,87.71872816212439,6
0.05,2862,94,251145,87.72092210967517,7
0.05,2863,95,251240,87.72346368715084,6
0.05,2864,94,251334,87.72565445026179,7
0.05,2865,91,251425,87.7267969295185,11
0.05,2866,92,251517,87.72828740844088,9
0.05,2867,93,251610,87.73012552301255,8
0.05,2868,92,251702,87.73161380271871,9
0.05,2869,84,251786,87.73031358885018,17
0.05,2870,95,251881,87.73284569836294,7
0.05,2871,92,251973,87.73433147632312,10
0.05,2872,93,252066,87.73616428820048,8
0.05,2873,94,252160,87.7383437717467,8
0.05,2874,27,252187,87.71721739130435,6
0.05,2875,93,252280,87.71905424200278,8
0.05,2876,95,252375,87.72158498435871,7
0.05,2877,95,252470,87.72411396803335,6
0.05,2878,94,252564,87.72629385203196,7
0.05,2879,96,252660,87.72916666666667,6
0.05,2880,93,252753,87.7309961818813,8
0.05,2881,95,252848,87.73351839000694,6
0.05,2882,90,252938,87.73430454387791,11
0.05,2883,94,253032,87.73647711511789,7
0.05,2884,94,253126,87.73864818024263,7
0.05,2885,94,253220,87.74081774081775,7
0.05,2886,93,253313,87.74263941808105,8
0.05,2887,96,253409,87.74549861495845,6
0.05,2888,96,253505,87.74835583246798,6
0.05,2889,94,253599,87.75051903114186,7
0.05,2890,94,253693,87.75268073331027,7
0.05,2891,95,253788,87.7551867219917,6
0.05,2892,94,253882,87.75734531628068,7
0.05,2893,90,253972,87.7581202487906,11
0.05,2894,94,254066,87.76027633851469,7
0.05,2895,-44,254022,87.71477900552486,8
0.05,2896,90,254112,87.71556782878841,11
0.05,2897,91,254203,87.71670117322292,11
0.05,2898,96,254299,87.7195584684374,6
0.05,2899,94,254393,87.72172413793103,7
0.05,2900,93,254486,87.72354360565322,8
0.05,2901,94,254580,87.72570640937285,7
0.05,2902,94,254674,87.72786772304512,7
0.05,2903,17,254691,87.70351239669421,16
0.05,2904,93,254784,87.70533562822719,8
0.05,2905,95,254879,87.70784583620096,6
0.05,2906,96,254975,87.71069831441349,6
0.05,2907,95,255070,87.71320495185695,6
0.05,2908,95,255165,87.7157098659333,6
0.05,2909,95,255260,87.71821305841924,7
0.05,2910,96,255356,87.72105805565099,6
0.05,2911,92,255448,87.72252747252747,9
0.05,2912,94,255542,87.72468245794714,7
0.05,2913,93,255635,87.72649279341113,8
0.05,2914,96,255731,87.72933104631218,6
0.05,2915,94,255825,87.73148148148148,8
0.05,2916,94,255919,87.73363044223517,7
0.05,2917,91,256010,87.73474982864975,10
0.05,2918,95,256105,87.73723878040425,8
0.05,2919,92,256197,87.73869863013698,9
0.05,2920,92,256289,87.74015748031496,9
0.05,2921,94,256383,87.74229979466119,7
0.05,2922,95,256478,87.74478275744099,6
0.05,2923,90,256568,87.74555403556772,11
0.05,2924,94,256662,87.7476923076923,7
0.05,2925,94,256756,87.74982911825018,8
0.05,2926,94,256850,87.75196446873932,7
0.05,2927,90,256940,87.75273224043715,11
0.05,2928,94,257034,87.75486514168658,7
0.05,2929,96,257130,87.75767918088737,6
0.05,2930,93,257223,87.75946775844422,8
0.05,2931,93,257316,87.7612551159618,8
0.05,2932,94,257410,87.76338220252302,7
0.05,2933,93,257503,87.76516700749829,8
0.05,2934,94,257597,87.76729131175469,7
0.05,2935,94,257691,87.76941416893733,8
0.05,2936,93,257784,87.77119509703779,9
0.05,2937,89,257873,87.77161334240981,12
0.05,2938,23,257896,87.74957468526709,9
0.05,2939,94,257990,87.75170068027211,7
0.05,2940,95,258085,87.75416524991499,6
0.05,2941,94,258179,87.756288239293,7
0.05,2942,94,258273,87.75840978593273,7
0.05,2943,94,258367,87.76052989130434,7
0.05,2944,94,258461,87.76264855687606,7
0.05,2945,95,258556,87.76510522742701,6
0.05,2946,94,258650,87.76722090261282,7
0.05,2947,94,258744,87.76933514246947,7
0.05,2948,93,258837,87.77110885045778,8
0.05,2949,89,258926,87.77152542372882,12
0.05,2950,94,259020,87.77363605557439,7
0.05,2951,92,259112,87.77506775067751,9
0.05,2952,94,259206,87.77717575347104,7
0.05,2953,94,259300,87.77928232904536,7
0.05,2954,92,259392,87.78071065989847,9
0.05,2955,95,259487,87.78315290933695,6
0.05,2956,92,259579,87.7845789651674,10
0.05,2957,93,259672,87.78634212305612,8
0.05,2958,93,259765,87.78810408921933,8
0.05,2959,96,259861,87.79087837837838,6
0.05,2960,90,259951,87.79162445119891,11
0.05,2961,95,260046,87.79405806887239,6
0.05,2962,95,260141,87.79649004387446,7
0.05,2963,94,260235,87.79858299595142,7
0.05,2964,90,260325,87.79932546374367,11
0.05,2965,96,260421,87.80209035738368,6
0.05,2966,93,260514,87.80384226491405,8
0.05,2967,94,260608,87.80592991913747,7
0.05,2968,94,260702,87.80801616705962,7
0.05,2969,95,260797,87.81043771043771,6
0.05,2970,96,260893,87.81319421070347,6
0.05,2971,89,260982,87.8135935397039,13
0.05,2972,96,261078,87.81634712411706,6
0.05,2973,95,261173,87.81876260928043,6
0.05,2974,26,261199,87.7979831932773,7
0.05,2975,92,261291,87.79939516129032,9
0.05,2976,92,261383,87.80080618071885,9
0.05,2977,91,261474,87.80188045668234,10
0.05,2978,92,261566,87.80328969452836,9
0.05,2979,96,261662,87.80604026845637,6
0.05,2980,94,261756,87.80811808118081,7
0.05,2981,95,261851,87.81052984574112,6
0.05,2982,96,261947,87.81327522628227,6
0.05,2983,92,262039,87.8146782841823,10
0.05,2984,92,262131,87.81608040201004,10
0.05,2985,92,262223,87.81748158070998,10
0.05,2986,95,262318,87.81988617341814,6
0.05,2987,95,262413,87.82228915662651,6
0.05,2988,95,262508,87.82469053195048,6
0.05,2989,94,262602,87.82675585284281,8
0.05,2990,94,262696,87.82881979271147,8
0.05,2991,93,262789,87.83054812834224,8
0.05,2992,95,262884,87.8329435349148,7
0.05,2993,94,262978,87.83500334001336,7
0.05,2994,93,263071,87.83672787979967,8
0.05,2995,94,263165,87.83878504672897,7
0.05,2996,96,263261,87.84150817484151,6
0.05,2997,90,263351,87.8422281521014,11
0.05,2998,96,263447,87.84494831610537,6
0.05,2999,92,263539,87.84633333333333,9
0.05,3000,92,263631,87.84771742752416,9
0.05,3001,93,263724,87.84943371085943,8
0.05,3002,92,263816,87.85081585081585,9
0.05,3003,93,263909,87.85252996005326,8
0.05,3004,95,264004,87.85490848585691,6
0.05,3005,91,264095,87.85595475715236,10
0.05,3006,96,264191,87.8586631193881,6
0.05,3007,95,264286,87.86103723404256,7
0.05,3008,94,264380,87.86307743436357,7
0.05,3009,95,264475,87.86544850498339,6
0.05,3010,94,264569,87.86748588508802,7
0.05,3011,91,264660,87.86852589641434,10
0.05,3012,95,264755,87.87089279787587,6
0.05,3013,96,264851,87.8735899137359,6
0.05,3014,87,264938,87.87330016583748,15
0.05,3015,96,265034,87.87599469496021,6
0.05,3016,91,265125,87.87703016241299,10
0.05,3017,93,265218,87.87872763419483,10
0.05,3018,92,265310,87.88009274594236,10
0.05,3019,94,265404,87.88211920529801,7
0.05,3020,94,265498,87.88414432307184,7
0.05,3021,95,265593,87.88649900727995,6
0.05,3022,94,265687,87.88852133642078,7
0.05,3023,94,265781,87.89054232804233,9
0.05,3024,92,265873,87.89190082644627,9
0.05,3025,96,265969,87.89458030403172,6
0.05,3026,92,266061,87.89593657086223,9
0.05,3027,95,266156,87.89828269484808,7
0.05,3028,94,266250,87.90029712776494,7
0.05,3029,94,266344,87.90231023102311,7
0.05,3030,95,266439,87.90465193005609,6
0.05,3031,95,266534,87.90699208443272,6
0.05,3032,92,266626,87.90834157599737,9
0.05,3033,88,266714,87.90837178642057,13
0.05,3034,95,266809,87.91070840197693,6
0.05,3035,93,266902,87.91238471673255,9
0.05,3036,93,266995,87.91405992756009,8
0.05,3037,95,267090,87.91639236339697,6
0.05,3038,94,267184,87.91839420862125,7
0.05,3039,94,267278,87.9203947368421,7
0.05,3040,93,267371,87.92206511016113,9
0.05,3041,94,267465,87.9240631163708,7
0.05,3042,94,267559,87.92605980939862,7
0.05,3043,94,267653,87.92805519053877,7
0.05,3044,91,267744,87.92906403940887,10
0.05,3045,94,267838,87.93105712409718,7
0.05,3046,94,267932,87.93304890055792,7
0.05,3047,94,268026,87.93503937007874,7
0.05,3048,92,268118,87.93637258117415,9
0.05,3049,92,268210,87.9377049180328,9
0.05,3050,92,268302,87.93903638151426,9
0.05,3051,94,268396,87.94102228047183,8
0.05,3052,94,268490,87.94300687848019,7
0.05,3053,95,268585,87.945317616241,6
0.05,3054,94,268679,87.94729950900164,8
0.05,3055,92,268771,87.94862565445027,10
0.05,3056,93,268864,87.95027805037618,8
0.05,3057,95,268959,87.95258338783519,6
0.05,3058,27,268986,87.93265773128473,6
0.05,3059,93,269079,87.9343137254902,8
0.05,3060,95,269174,87.93662201894806,6
0.05,3061,96,269270,87.93925538863488,6
0.05,3062,88,269358,87.93927522037218,13
0.05,3063,92,269450,87.94060052219321,9
0.05,3064,96,269546,87.94323001631321,6
0.05,3065,94,269640,87.94520547945206,7
0.05,3066,93,269733,87.94685360286925,8
0.05,3067,94,269827,87.94882659713168,7
0.05,3068,89,269916,87.94916911045944,12
0.05,3069,94,270010,87.95114006514657,7
0.05,3070,94,270104,87.95310973624227,7
0.05,3071,94,270198,87.955078125,8
0.05,3072,93,270291,87.95671981776765,8
0.05,3073,93,270384,87.9583604424203,8
0.05,3074,95,270479,87.96065040650406,7
0.05,3075,93,270572,87.96228868660599,8
0.05,3076,94,270666,87.96425089372765,7
0.05,3077,94,270760,87.96621182586095,8
0.05,3078,96,270856,87.96882104579409,6
0.05,3079,94,270950,87.97077922077922,7
0.05,3080,94,271044,87.97273612463486,7
0.05,3081,93,271137,87.97436729396496,8
0.05,3082,92,271229,87.97567304573468,9
0.05,3083,93,271322,87.97730220492866,9
0.05,3084,95,271417,87.97957860615884,7
0.05,3085,94,271511,87.98152948801037,7
0.05,3086,96,271607,87.98412698412699,6
0.05,3087,96,271703,87.98672279792746,6
0.05,3088,93,271796,87.98834574295888,8
0.05,3089,94,271890,87.99029126213593,7
0.05,3090,94,271984,87.99223552248463,7
0.05,3091,96,272080,87.99482535575679,6
0.05,3092,94,272174,87.99676689298416,7
0.05,3093,95,272269,87.99903038138332,7
0.05,3094,95,272364,88.00129240710824,6
0.05,3095,93,272457,88.00290697674419,8
0.05,3096,96,272553,88.0054891830804,6
0.05,3097,24,272577,87.98482892188508,9
0.05,3098,94,272671,87.98676992578251,7
0.05,3099,94,272765,87.98870967741935,7
0.05,3100,25,272790,87.96839729119638,8
0.05,3101,27,272817,87.94874274661508,6
0.05,3102,94,272911,87.95069287786013,7
0.05,3103,92,273003,87.9519974226804,9
0.05,3104,94,273097,87.95394524959742,7
0.05,3105,90,273187,87.95460399227302,11
0.05,3106,94,273281,87.9565497264242,7
0.05,3107,92,273373,87.95785070785071,9
0.05,3108,95,273468,87.96011579285944,6
0.05,3109,96,273564,87.96270096463023,6
0.05,3110,92,273656,87.96399871423979,9
0.05,3111,92,273748,87.96529562982005,9
0.05,3112,94,273842,87.96723417924831,8
0.05,3113,94,273936,87.96917148362235,7
0.05,3114,93,274029,87.97078651685393,8
0.05,3115,93,274122,87.97240051347882,8
0.05,3116,92,274214,87.97369265319217,9
0.05,3117,94,274308,87.97562540089801,7
0.05,3118,94,274402,87.97755690926579,7
0.05,3119,94,274496,87.97948717948718,7
0.05,3120,94,274590,87.98141621275232,8
0.05,3121,92,274682,87.98270339525945,11
0.05,3122,94,274776,87.98463016330452,7
0.05,3123,94,274870,87.9865556978233,7
0.05,3124,93,274963,87.98816,10
0.05,3125,94,275057,87.99008317338452,7
0.05,3126,90,275147,87.99072593540134,11
0.05,3127,94,275241,87.99264705882354,7
0.05,3128,95,275336,87.99488654522212,7
0.05,3129,94,275430,87.99680511182109,7
0.05,3130,91,275521,87.99776429255829,10
0.05,3131,94,275615,87.99968071519795,7
0.05,3132,95,275710,88.00191509735079,6
0.05,3133,91,275801,88.00287172941927,10
0.05,3134,94,275895,88.00478468899522,7
0.05,3135,93,275988,88.0063775510204,8
0.05,3136,92,276080,88.00765062161301,9
0.05,3137,94,276174,88.00956022944551,7
0.05,3138,94,276268,88.0114686205798,8
0.05,3139,93,276361,88.01305732484076,8
0.05,3140,91,276452,88.01400827761859,10
0.05,3141,93,276545,88.015595162317,8
0.05,3142,96,276641,88.01813553929367,6
0.05,3143,93,276734,88.01972010178118,8
0.05,3144,26,276760,88.0,8
0.05,3145,91,276851,88.00095359186268,10
0.05,3146,93,276944,88.00254210359073,9
0.05,3147,94,277038,88.00444726810673,7
0.05,3148,93,277131,88.00603366147983,9
0.05,3149,92,277223,88.00730158730158,9
0.05,3150,94,277317,88.00920342748334,8
0.05,3151,92,277409,88.01046954314721,9
0.05,3152,94,277503,88.01236917221694,7
0.05,3153,96,277599,88.01490171211161,6
0.05,3154,94,277693,88.01679873217115,7
0.05,3155,94,277787,88.01869455006337,7
0.05,3156,25,277812,87.99873297434273,7
0.05,3157,94,277906,88.00063331222293,7
0.05,3158,92,277998,88.00189933523266,9
0.05,3159,94,278092,88.00379746835443,7
0.05,3160,92,278184,88.00506168933882,9
0.05,3161,94,278278,88.00695762175837,7
0.05,3162,92,278370,88.00822004426178,9
0.05,3163,94,278464,88.01011378002528,7
0.05,3164,94,278558,88.01200631911533,7
0.05,3165,95,278653,88.0142135186355,6
0.05,3166,93,278746,88.01578781180929,8
0.05,3167,94,278840,88.01767676767676,7
0.05,3168,94,278934,88.01956453139792,7
0.05,3169,96,279030,88.02208201892745,6
0.05,3170,94,279124,88.02396720277515,7
0.05,3171,94,279218,88.02585119798235,7
0.05,3172,95,279313,88.02804916482823,6
0.05,3173,96,279409,88.03056080655324,6
0.05,3174,95,279504,88.0327559055118,7
0.05,3175,94,279598,88.03463476070529,8
0.05,3176,90,279688,88.0352533836953,11
0.05,3177,94,279782,88.03713027061045,7
0.05,3178,95,279877,88.03932054105064,6
0.05,3179,94,279971,88.04119496855346,7
0.05,3180,95,280066,88.04338258409305,6
0.05,3181,96,280162,88.04588309239472,6
0.05,3182,92,280254,88.04712535344015,10
0.05,3183,90,280344,88.04773869346734,11
0.05,3184,94,280438,88.04960753532183,7
0.05,3185,96,280534,88.05210295040804,6
0.05,3186,95,280629,88.0542830247882,6
0.05,3187,92,280721,88.05552070263488,9
0.05,3188,96,280817,88.05801191596112,6
0.05,3189,95,280912,88.06018808777429,7
0.05,3190,95,281007,88.062362895644,6
0.05,3191,94,281101,88.06422305764411,7
0.05,3192,93,281194,88.06576886940182,8
0.05,3193,93,281287,88.06731371321227,8
0.05,3194,94,281381,88.06917057902973,7
0.05,3195,94,281475,88.07102628285357,7
0.05,3196,94,281569,88.07288082577416,8
0.05,3197,-44,281525,88.03158223889932,8
0.05,3198,93,281618,88.03313535479838,9
0.05,3199,91,281709,88.0340625,10
0.05,3200,93,281802,88.03561387066541,8
0.05,3201,96,281898,88.03810118675828,6
0.05,3202,94,281992,88.03996253512332,7
0.05,3203,92,282084,88.04119850187266,10
0.05,3204,92,282176,88.04243369734789,9
0.05,3205,93,282269,88.04398003742982,8
0.05,3206,22,282291,88.02338634237606,11
0.05,3207,24,282315,88.0034289276808,8
0.05,3208,94,282409,88.0052976004986,7
0.05,3209,94,282503,88.00716510903426,8
0.05,3210,92,282595,88.00840859545313,9
0.05,3211,95,282690,88.01058530510585,6
0.05,3212,95,282785,88.01276065981948,6
0.05,3213,92,282877,88.01400124455508,9
0.05,3214,94,282971,88.01586314152411,7
0.05,3215,92,283063,88.01710199004975,9
0.05,3216,95,283158,88.01927261423687,6
0.05,3217,94,283252,88.0211311373524,9
0.05,3218,94,283346,88.02298850574712,7
0.05,3219,94,283440,88.0248447204969,7
0.05,3220,95,283535,88.02701024526544,6
0.05,3221,93,283628,88.02855369335816,9
0.05,3222,94,283722,88.03040645361465,8
0.05,3223,91,283813,88.03132754342431,10
0.05,3224,95,283908,88.03348837209302,7
0.05,3225,92,284000,88.03471791692499,9
0.05,3226,94,284094,88.03656647040594,7
0.05,3227,92,284186,88.03779429987608,9
0.05,3228,94,284280,88.0396407556519,7
0.05,3229,94,284374,88.04148606811145,7
0.05,3230,96,284470,88.04394924172082,6
0.05,3231,96,284566,88.04641089108911,6
0.05,3232,96,284662,88.04887101763069,6
0.05,3233,94,284756,88.05071119356833,8
0.05,3234,95,284851,88.05285935085007,6
0.05,3235,91,284942,88.05377008652657,10
0.05,3236,93,285035,88.05529811553907,8
0.05,3237,94,285129,88.05713403335392,8
0.05,3238,94,285223,88.05896881753628,8
0.05,3239,91,285314,88.05987654320988,10
0.05,3240,95,285409,88.0620178957112,6
0.05,3241,93,285502,88.06354102405922,8
0.05,3242,96,285598,88.06598828245451,6
0.05,3243,94,285692,88.06781750924785,7
0.05,3244,86,285778,88.06718027734976,15
0.05,3245,94,285872,88.0690080098583,7
0.05,3246,96,285968,88.07145056975669,6
0.05,3247,96,286064,88.07389162561576,6
0.05,3248,96,286160,88.07633117882425,6
0.05,3249,95,286255,88.07846153846154,6
0.05,3250,95,286350,88.08059058751154,6
0.05,3251,93,286443,88.08210332103322,9
0.05,3252,95,286538,88.08422994159238,6
0.05,3253,92,286630,88.08543331284572,9
0.05,3254,92,286722,88.08663594470046,9
0.05,3255,94,286816,88.08845208845209,7
0.05,3256,94,286910,88.09026711697881,7
0.05,3257,92,287002,88.0914671577655,10
0.05,3258,95,287097,88.0935869898742,6
0.05,3259,95,287192,88.0957055214724,7
0.05,3260,93,287285,88.09720944495554,8
0.05,3261,90,287375,88.09779276517474,11
0.05,3262,93,287468,88.09929512718357,8
0.05,3263,94,287562,88.10110294117646,7
0.05,3264,94,287656,88.10290964777948,7
0.05,3265,92,287748,88.10410287813839,9
0.05,3266,94,287842,88.10590756045302,7
0.05,3267,96,287938,88.10832313341493,6
0.05,3268,94,288032,88.11012542061792,7
0.05,3269,95,288127,88.11223241590214,6
0.05,3270,96,288223,88.11464383980434,7
0.05,3271,95,288318,88.11674816625917,6
0.05,3272,96,288414,88.11915673693859,6
0.05,3273,89,288503,88.11942577886377,12
0.05,3274,94,288597,88.1212213740458,7
0.05,3275,90,288687,88.12179487179488,11
0.05,3276,89,288776,88.12206286237412,13
0.05,3277,94,288870,88.12385600976205,7
0.05,3278,23,288893,88.10399512046355,10
0.05,3279,92,288985,88.10518292682927,9
0.05,3280,92,289077,88.10637000914356,10
0.05,3281,94,289171,88.10816575258988,7
0.05,3282,95,289266,88.110265001523,7
0.05,3283,92,289358,88.11144945188794,9
0.05,3284,96,289454,88.11385083713851,6
0.05,3285,95,289549,88.11594643944005,6
0.05,3286,96,289645,88.11834499543657,7
0.05,3287,94,289739,88.12013381995133,7
0.05,3288,94,289833,88.12192155670417,7
0.05,3289,95,289928,88.12401215805471,6
0.05,3290,93,290021,88.1254937708903,8
0.05,3291,96,290117,88.1278857837181,6
0.05,3292,94,290211,88.12966899483753,7
0.05,3293,94,290305,88.13145112325441,7
0.05,3294,94,290399,88.13323216995448,7
0.05,3295,96,290495,88.13561893203884,6
0.05,3296,94,290589,88.13739763421292,7
0.05,3297,94,290683,88.13917525773196,7
0.05,3298,94,290777,88.14095180357684,8
0.05,3299,93,290870,88.14242424242424,9
0.05,3300,94,290964,88.14419872765829,7
0.05,3301,94,291058,88.14597213809812,7
0.05,3302,94,291152,88.14774447471996,7
0.05,3303,96,291248,88.1501210653753,6
0.05,3304,93,291341,88.15158850226929,8
0.05,3305,91,291432,88.1524500907441,10
0.05,3306,96,291528,88.15482310250982,6
0.05,3307,94,291622,88.15659008464328,8
0.05,3308,96,291718,88.15896041100031,6
0.05,3309,94,291812,88.1607250755287,7
0.05,3310,95,291907,88.16279069767442,6
0.05,3311,95,292002,88.16485507246377,7
0.05,3312,94,292096,88.16661635979474,7
0.05,3313,92,292188,88.16777308388654,9
0.05,3314,92,292280,88.16892911010558,10
0.05,3315,26,292306,88.15018094089264,7
0.05,3316,26,292332,88.13144407597227,8
0.05,3317,93,292425,88.13291139240506,8
0.05,3318,92,292517,88.13407652907502,9
0.05,3319,92,292609,88.13524096385542,10
0.05,3320,91,292700,88.13610358325805,11
0.05,3321,95,292795,88.13816977724262,7
0.05,3322,94,292889,88.13993379476376,7
0.05,3323,92,292981,88.14109506618531,9
0.05,3324,93,293074,88.14255639097745,8
0.05,3325,95,293169,88.14461815995189,6
0.05,3326,95,293264,88.14667868951007,7
0.05,3327,96,293360,88.14903846153847,6
0.05,3328,94,293454,88.1507960348453,7
0.05,3329,93,293547,88.15225225225225,8
0.05,3330,95,293642,88.15430801561092,6
0.05,3331,89,293731,88.1545618247299,12
0.05,3332,93,293824,88.15601560156016,8
0.05,3333,96,293920,88.15836832633474,6
0.05,3334,94,294014,88.16011994002999,7
0.05,3335,94,294108,88.16187050359713,7
0.05,3336,94,294202,88.16362001798022,7
0.05,3337,95,294297,88.16566806470941,6
0.05,3338,94,294391,88.16741539383048,7
0.05,3339,94,294485,88.16916167664671,7
0.05,3340,96,294581,88.1715055372643,6
0.05,3341,88,294669,88.17145421903052,13
0.05,3342,92,294761,88.17259946156148,9
0.05,3343,92,294853,88.17374401913875,9
0.05,3344,93,294946,88.17518684603887,8
0.05,3345,93,295039,88.17662881052003,8
0.05,3346,95,295134,88.17866746340006,6
0.05,3347,95,295229,88.18070489844683,6
0.05,3348,93,295322,88.18214392355927,8
0.05,3349,91,295413,88.18298507462687,11
0.05,3350,93,295506,88.18442256042972,8
0.05,3351,95,295601,88.18645584725537,6
0.05,3352,94,295695,88.18818968088279,7
0.05,3353,93,295788,88.18962432915922,9
0.05,3354,94,295882,88.1913561847988,7
0.05,3355,94,295976,88.19308700834327,7
0.05,3356,96,296072,88.19541257074769,6
0.05,3357,93,296165,88.19684335914235,8
0.05,3358,96,296261,88.19916641857695,6
0.05,3359,92,296353,88.20029761904762,9
0.05,3360,94,296447,88.20202320737876,7
0.05,3361,90,296537,88.20255800118977,11
0.05,3362,94,296631,88.2042818911686,7
0.05,3363,93,296724,88.20570749108205,8
0.05,3364,94,296818,88.2074294205052,7
0.05,3365,92,296910,88.20855614973262,9
0.05,3366,92,297002,88.20968220968221,9
0.05,3367,95,297097,88.21169833729216,8
0.05,3368,96,297193,88.21401009201543,6
0.05,3369,94,297287,88.21572700296736,7
0.05,3370,92,297379,88.21684959952536,10
0.05,3371,94,297473,88.2185646500593,7
0.05,3372,94,297567,88.22027868366439,7
0.05,3373,95,297662,88.22228808535863,7
0.05,3374,95,297757,88.2242962962963,7
0.05,3375,92,297849,88.22541469194313,10
0.05,3376,93,297942,88.22682854604679,8
0.05,3377,96,298038,88.2291296625222,6
0.05,3378,92,298130,88.2302456348032,10
0.05,3379,94,298224,88.2319526627219,7
0.05,3380,93,298317,88.23336291038154,10
0.05,3381,89,298406,88.23358959195743,12
0.05,3382,94,298500,88.23529411764706,7
0.05,3383,96,298596,88.23758865248227,6
0.05,3384,95,298691,88.23958641063516,7
0.05,3385,93,298784,88.24099232132309,8
0.05,3386,94,298878,88.24269264836138,8
0.05,3387,91,298969,88.24350649350649,10
0.05,3388,95,299064,88.24550014753615,6
0.05,3389,96,299160,88.24778761061947,6
0.05,3390,93,299253,88.24918902978473,9
0.05,3391,96,299349,88.25147405660377,6
0.05,3392,95,299444,88.2534630120837,6
0.05,3393,95,299539,88.25545079552151,6
0.05,3394,94,299633,88.25714285714285,7
0.05,3395,96,299729,88.25942285041225,6
0.05,3396,94,299823,88.26111274654106,7
0.05,3397,94,299917,88.26280164802826,7
0.05,3398,94,300011,88.2644895557517,7
0.05,3399,93,300104,88.26588235294118,8
0.05,3400,93,300197,88.2672743310791,9
0.05,3401,96,300293,88.26954732510288,6
0.05,3402,95,300388,88.2715251248898,7
0.05,3403,94,300482,88.27320799059929,7
0.05,3404,90,300572,88.27371512481645,11
0.05,3405,94,300666,88.27539635936583,7
0.05,3406,95,300761,88.27737012034048,6
0.05,3407,27,300788,88.2593896713615,6
0.05,3408,24,300812,88.2405397477266,8
0.05,3409,94,300906,88.24222873900294,8
0.05,3410,95,301001,88.24420990911756,6
0.05,3411,95,301096,88.24618991793669,6
0.05,3412,96,301192,88.24846176384412,6
0.05,3413,94,301286,88.25014645577036,8
0.05,3414,94,301380,88.25183016105417,7
0.05,3415,95,301475,88.2538056206089,6
0.05,3416,96,301571,88.25607257828504,6
0.05,3417,95,301666,88.25804564072557,6
0.05,3418,93,301759,88.2594325826265,9
0.05,3419,96,301855,88.26169590643275,6
0.05,3420,94,301949,88.26337328266588,7
0.05,3421,94,302043,88.26504967855055,7
0.05,3422,93,302136,88.26643295354951,8
0.05,3423,95,302231,88.26839953271028,6
0.05,3424,93,302324,88.26978102189781,8
0.05,3425,93,302417,88.27116170461179,8
0.05,3426,94,302511,88.27283338196673,8
0.05,3427,96,302607,88.27508751458576,6
0.05,3428,94,302701,88.27675707203267,7
0.05,3429,96,302797,88.27900874635569,6
0.05,3430,92,302889,88.28009326726902,9
0.05,3431,93,302982,88.28146853146853,8
0.05,3432,92,303074,88.28255170404894,10
0.05,3433,94,303168,88.28421665695981,7
0.05,3434,94,303262,88.28588064046579,7
0.05,3435,93,303355,88.28725261932479,8
0.05,3436,94,303449,88.28891475123655,7
0.05,3437,94,303543,88.29057591623037,7
0.05,3438,94,303637,88.29223611514975,7
0.05,3439,95,303732,88.29418604651163,6
0.05,3440,94,303826,88.2958442313281,7
0.05,3441,94,303920,88.29750145264381,7
0.05,3442,93,304013,88.29886726691838,8
0.05,3443,96,304109,88.30110336817654,6
0.05,3444,95,304204,88.30304789550073,6
0.05,3445,94,304298,88.3047011027278,7
0.05,3446,95,304393,88.30664345807949,7
0.05,3447,94,304487,88.30829466357308,7
0.05,3448,94,304581,88.30994491156856,7
0.05,3449,94,304675,88.31159420289855,7
0.05,3450,95,304770,88.31353230947552,6
0.05,3451,27,304797,88.29577056778679,6
0.05,3452,93,304890,88.2971329278888,9
0.05,3453,94,304984,88.29878401852925,7
0.05,3454,95,305079,88.30072358900145,6
0.05,3455,93,305172,88.30208333333333,8
0.05,3456,93,305265,88.30344229100376,8
0.05,3457,94,305359,88.3050896471949,7
0.05,3458,96,305455,88.30731425267419,6
0.05,3459,95,305550,88.3092485549133,6
0.05,3460,94,305644,88.31089280554752,7
0.05,3461,92,305736,88.31195840554592,9
0.05,3462,92,305828,88.31302339012417,10
0.05,3463,95,305923,88.31495381062355,6
0.05,3464,94,306017,88.31659451659452,7
0.05,3465,94,306111,88.31823427582228,7
0.05,3466,27,306138,88.30054802422843,6
0.05,3467,93,306231,88.30190311418686,8
0.05,3468,96,306327,88.30412222542519,6
0.05,3469,95,306422,88.30605187319885,6
0.05,3470,95,306517,88.307980409104,6
0.05,3471,94,306611,88.3096198156682,7
0.05,3472,91,306702,88.31039447163835,10
0.05,3473,94,306796,88.31203223949338,7
0.05,3474,94,306890,88.3136690647482,7
0.05,3475,93,306983,88.3150172612198,8
0.05,3476,93,307076,88.3163646821973,8
0.05,3477,96,307172,88.31857389304197,6
0.05,3478,94,307266,88.32020695602185,7
0.05,3479,94,307360,88.32183908045977,7
0.05,3480,95,307455,88.32375754093651,6
0.05,3481,95,307550,88.32567489948306,6
0.05,3482,94,307644,88.32730404823428,7
0.05,3483,91,307735,88.3280711825488,10
0.05,3484,95,307830,88.3299856527977,6
0.05,3485,93,307923,88.33132530120481,8
0.05,3486,88,308011,88.33123028391167,13
0.05,3487,96,308107,88.33342889908256,6
0.05,3488,90,308197,88.33390656348524,11
0.05,3489,96,308293,88.33610315186246,6
0.05,3490,94,308387,88.33772558006302,7
0.05,3491,94,308481,88.33934707903781,7
0.05,3492,95,308576,88.34125393644432,6
0.05,3493,94,308670,88.34287349742415,8
0.05,3494,93,308763,88.3442060085837,9
0.05,3495,91,308854,88.34496567505721,12
0.05,3496,96,308950,88.34715470403202,6
0.05,3497,94,309044,88.34877072612922,7
0.05,3498,91,309135,88.3495284366962,10
0.05,3499,94,309229,88.35114285714286,7
0.05,3500,92,309321,88.3521850899743,9
0.05,3501,94,309415,88.35379782981154,7
0.05,3502,27,309442,88.33628318584071,6
0.05,3503,96,309538,88.33847031963471,6
0.05,3504,26,309564,88.3206847360913,7
0.05,3505,93,309657,88.3220193953223,8
0.05,3506,94,309751,88.32363843741089,8
0.05,3507,94,309845,88.32525655644241,7
0.05,3508,96,309941,88.32744371615846,6
0.05,3509,94,310035,88.32905982905983,7
0.05,3510,94,310129,88.33067502136143,7
0.05,3511,95,310224,88.33257403189066,6
0.05,3512,93,310317,88.33390264731,9
0.05,3513,96,310413,88.33608423449061,6
0.05,3514,96,310509,88.33826458036984,6
0.05,3515,95,310604,88.34015927189989,6
0.05,3516,95,310699,88.34205288598237,6
0.05,3517,94,310793,88.34366117111995,7
0.05,3518,94,310887,88.34526854219949,7
0.05,3519,94,310981,88.346875,7
0.05,3520,91,311072,88.34762851462652,10
0.05,3521,90,311162,88.3480976717774,11
0.05,3522,91,311253,88.34885041158104,10
0.05,3523,94,311347,88.35045402951192,7
0.05,3524,94,311441,88.35205673758865,7
0.05,3525,91,311532,88.35280771412366,10
0.05,3526,95,311627,88.35469237312164,6
0.05,3527,27,311654,88.33730158730158,6
0.05,3528,96,311750,88.33947293850949,6
0.05,3529,90,311840,88.33994334277621,11
0.05,3530,96,311936,88.3421127159445,6
0.05,3531,94,312030,88.34371460928652,8
0.05,3532,95,312125,88.34559864138126,6
0.05,3533,93,312218,88.3469156762875,8
0.05,3534,86,312304,88.34625176803395,15
0.05,3535,94,312398,88.34785067873302,7
0.05,3536,89,312487,88.34803505795873,12
0.05,3537,92,312579,88.34906726964387,9
0.05,3538,96,312675,88.35122916077988,6
0.05,3539,96,312771,88.35338983050848,6
0.05,3540,93,312864,88.35470206156452,8
0.05,3541,94,312958,88.35629587803501,7
0.05,3542,92,313050,88.35732430143946,10
0.05,3543,93,313143,88.35863431151242,8
0.05,3544,93,313236,88.35994358251058,8
0.05,3545,93,313329,88.36125211505922,8
0.05,3546,87,313416,88.36086833944178,15
0.05,3547,93,313509,88.36217587373169,8
0.05,3548,94,313603,88.36376444068752,7
0.05,3549,94,313697,88.36535211267605,7
0.05,3550,96,313793,88.3675021120811,6
0.05,3551,96,313889,88.36965090090091,6
0.05,3552,94,313983,88.37123557556994,7
0.05,3553,95,314078,88.37310073157006,7
0.05,3554,95,314173,88.37496483825598,6
0.05,3555,26,314199,88.357424071991,7
0.05,3556,95,314294,88.35929153781277,6
0.05,3557,91,314385,88.36003372681282,10
0.05,3558,94,314479,88.36161843214386,7
0.05,3559,93,314572,88.3629213483146,8
0.05,3560,94,314666,88.36450435270991,7
0.05,3561,95,314761,88.36636720943291,6
0.05,3562,92,314853,88.36738703339883,11
0.05,3563,95,314948,88.36924803591471,6
0.05,3564,94,315042,88.37082748948107,7
0.05,3565,93,315135,88.37212563095906,8
0.05,3566,94,315229,88.37370339220634,7
0.05,3567,96,315325,88.37584080717488,6
0.05,3568,93,315418,88.3771364527879,8
0.05,3569,93,315511,88.37843137254902,8
0.05,3570,94,315605,88.38000560067208,7
0.05,3571,94,315699,88.38157894736842,7
0.05,3572,91,315790,88.38231178281556,10
0.05,3573,92,315882,88.38332400671517,9
0.05,3574,90,315972,88.38377622377622,11
0.05,3575,96,316068,88.38590604026845,6
0.05,3576,95,316163,88.38775510204081,7
0.05,3577,93,316256,88.38904415874791,8
0.05,3578,94,316350,88.39061190276614,7
0.05,3579,94,316444,88.39217877094973,7
0.05,3580,93,316537,88.3934655124267,8
0.05,3581,91,316628,88.39419318816304,10
0.05,3582,89,316717,88.39436226625733,12
0.05,3583,93,316810,88.39564732142857,8
0.05,3584,96,316906,88.39776847977684,6
0.05,3585,94,317000,88.39933073061907,7
0.05,3586,95,317095,88.40117089489824,6
0.05,3587,95,317190,88.40301003344482,6
0.05,3588,93,317283,88.40429088882698,8
0.05,3589,94,317377,88.4058495821727,7
0.05,3590,96,317473,88.40796435533278,6
0.05,3591,90,317563,88.40840757238307,12
0.05,3592,20,317583,88.38936821597551,12
0.05,3593,92,317675,88.39037284362827,9
0.05,3594,93,317768,88.39165507649513,8
0.05,3595,94,317862,88.3932146829811,7
0.05,3596,96,317958,88.395329441201,6
0.05,3597,95,318053,88.39716509171762,6
0.05,3598,95,318148,88.39899972214504,6
0.05,3599,96,318244,88.4011111111111,6
0.05,3600,93,318337,88.40238822549291,8
0.05,3601,96,318433,88.40449750138812,6
0.05,3602,21,318454,88.38578961976131,11
0.05,3603,23,318477,88.36764705882354,10
0.05,3604,94,318571,88.36920943134535,7
0.05,3605,94,318665,88.37077093732668,7
0.05,3606,95,318760,88.37260881619073,7
0.05,3607,95,318855,88.37444567627495,6
0.05,3608,94,318949,88.37600443336105,7
0.05,3609,95,319044,88.37783933518006,6
0.05,3610,94,319138,88.37939628911658,7
0.05,3611,95,319233,88.3812292358804,7
0.05,3612,93,319326,88.38250761140327,8
0.05,3613,93,319419,88.38378527946874,9
0.05,3614,89,319508,88.38395573997234,12
0.05,3615,93,319601,88.38523230088495,8
0.05,3616,92,319693,88.38623168371579,9
0.05,3617,94,319787,88.38778330569376,7
0.05,3618,87,319874,88.38739983420834,14
0.05,3619,94,319968,88.3889502762431,7
0.05,3620,96,320064,88.3910521955261,6
0.05,3621,94,320158,88.39260077305356,8
0.05,3622,93,320251,88.39387248136903,8
0.05,3623,94,320345,88.39541942604856,7
0.05,3624,95,320440,88.39724137931034,6
0.05,3625,94,320534,88.39878654164369,7
0.05,3626,94,320628,88.40033085194375,7
0.05,3627,94,320722,88.4018743109151,7
0.05,3628,95,320817,88.40369247726646,6
0.05,3629,95,320912,88.40550964187328,6
0.05,3630,94,321006,88.40705039933903,8
0.05,3631,93,321099,88.40831497797357,8
0.05,3632,93,321192,88.40957886044592,8
0.05,3633,88,321280,88.40946615299944,13
0.05,3634,95,321375,88.41127922971114,6
0.05,3635,94,321469,88.41281628162817,7
0.05,3636,96,321565,88.41490239208139,6
0.05,3637,95,321660,88.41671247938427,6
0.05,3638,94,321754,88.41824677109096,7
0.05,3639,94,321848,88.41978021978022,8
0.05,3640,91,321939,88.42048887668223,10
0.05,3641,90,322029,88.42092257001647,11
0.05,3642,94,322123,88.42245402141093,7
0.05,3643,92,322215,88.4234357848518,9
0.05,3644,93,322308,88.42469135802469,8
0.05,3645,94,322402,88.42622051563357,7
0.05,3646,92,322494,88.42720043871675,9
0.05,3647,94,322588,88.42872807017544,7
0.05,3648,94,322682,88.4302548643464,7
0.05,3649,92,322774,88.43123287671233,9
0.05,3650,93,322867,88.43248425089017,8
0.05,3651,94,322961,88.43400876232201,7
0.05,3652,92,323053,88.43498494388174,9
0.05,3653,93,323146,88.43623426382047,8
0.05,3654,94,323240,88.43775649794802,7
0.05,3655,95,323335,88.43955142231947,6
0.05,3656,94,323429,88.44107191687175,7
0.05,3657,93,323522,88.44231820667031,8
0.05,3658,92,323614,88.44329051653457,9
0.05,3659,96,323710,88.44535519125684,6
0.05,3660,95,323805,88.44714558863699,7
0.05,3661,95,323900,88.44893500819225,6
0.05,3662,94,323994,88.45045045045045,7
0.05,3663,93,324087,88.45169213973799,8
0.05,3664,95,324182,88.45347885402455,7
0.05,3665,94,324276,88.45499181669395,7
0.05,3666,91,324367,88.4556858467412,10
0.05,3667,93,324460,88.45692475463468,9
0.05,3668,92,324552,88.45789043336059,9
0.05,3669,95,324647,88.45967302452316,6
0.05,3670,94,324741,88.46118223917189,7
0.05,3671,94,324835,88.46269063180829,7
0.05,3672,92,324927,88.46365368908249,9
0.05,3673,92,325019,88.46461622210126,9
0.05,3674,94,325113,88.46612244897959,7
0.05,3675,92,325205,88.4670837867247,9
0.05,3676,93,325298,88.46831656241501,8
0.05,3677,96,325394,88.47036432843937,6
0.05,3678,96,325490,88.4724109812449,6
0.05,3679,95,325585,88.4741847826087,6
0.05,3680,19,325604,88.45531105677804,13
0.05,3681,26,325630,88.43834872351982,8
0.05,3682,95,325725,88.44013032853653,6
0.05,3683,93,325818,88.4413680781759,9
0.05,3684,90,325908,88.44179104477612,11
0.05,3685,93,326001,88.44302767227347,9
0.05,3686,94,326095,88.44453485218335,7
0.05,3687,93,326188,88.44577006507592,8
0.05,3688,94,326282,88.44727568446733,7
0.05,3689,96,326378,88.44932249322493,6
0.05,3690,94,326472,88.45082633432673,7
0.05,3691,95,326567,88.45260021668473,6
0.05,3692,94,326661,88.45410235580829,7
0.05,3693,25,326686,88.4369247428262,8
0.05,3694,94,326780,88.4384303112314,8
0.05,3695,95,326875,88.44020562770562,6
0.05,3696,94,326969,88.44170949418448,7
0.05,3697,95,327064,88.4434829637642,6
0.05,3698,94,327158,88.44498513111652,7
0.05,3699,95,327253,88.44675675675676,6
0.05,3700,94,327347,88.44825722777628,7
0.05,3701,96,327443,88.45029713668288,6
0.05,3702,92,327535,88.45125573859033,9
0.05,3703,96,327631,88.45329373650108,6
0.05,3704,94,327725,88.45479082321188,7
0.05,3705,96,327821,88.45682676740421,6
0.05,3706,89,327910,88.45697329376854,13
0.05,3707,93,328003,88.4581984897519,8
0.05,3708,95,328098,88.45996225397681,6
0.05,3709,92,328190,88.46091644204851,9
0.05,3710,92,328282,88.46187011587173,10
0.05,3711,96,328378,88.46390086206897,6
0.05,3712,93,328471,88.46512254241853,8
0.05,3713,92,328563,88.46607431340873,9
0.05,3714,27,328590,88.44952893674294,6
0.05,3715,95,328685,88.45129171151775,6
0.05,3716,94,328779,88.45278450363196,8
0.05,3717,94,328873,88.45427649273803,8
0.05,3718,96,328969,88.45630545845657,6
0.05,3719,94,329063,88.45779569892473,7
0.05,3720,94,329157,88.45928513840366,7
0.05,3721,95,329252,88.46104245029554,6
0.05,3722,92,329344,88.46199301638464,9
0.05,3723,96,329440,88.4640171858217,6
0.05,3724,94,329534,88.4655033557047,7
0.05,3725,92,329626,88.46645195920559,9
0.05,3726,95,329721,88.46820499060907,6
0.05,3727,94,329815,88.46968884120172,7
0.05,3728,94,329909,88.47117189595066,7
0.05,3729,94,330003,88.47265415549597,8
0.05,3730,95,330098,88.47440364513535,6
0.05,3731,94,330192,88.47588424437299,7
0.05,3732,95,330287,88.47763193142245,6
0.05,3733,96,330383,88.4796464916979,6
0.05,3734,95,330478,88.4813922356091,6
0.05,3735,91,330569,88.48206638115632,10
0.05,3736,96,330665,88.48407813754348,6
0.05,3737,92,330757,88.48501872659176,9
0.05,3738,94,330851,88.48649371489704,7
0.05,3739,93,330944,88.48770053475936,8
0.05,3740,26,330970,88.47099705960973,8
0.05,3741,93,331063,88.4722073757349,8
0.05,3742,94,331157,88.47368421052632,7
0.05,3743,96,331253,88.47569444444444,6
0.05,3744,94,331347,88.47716955941254,7
0.05,3745,95,331442,88.47891083822745,6
0.05,3746,93,331535,88.48011742727515,8
0.05,3747,95,331630,88.48185699039487,6
0.05,3748,95,331725,88.48359562550013,6
0.05,3749,92,331817,88.48453333333333,9
0.05,3750,96,331913,88.48653692348707,6
0.05,3751,93,332006,88.48773987206823,8
0.05,3752,-44,331962,88.45243804956036,8
0.05,3753,94,332056,88.453915823122,7
0.05,3754,94,332150,88.45539280958722,7
0.05,3755,96,332246,88.45740149094782,6
0.05,3756,96,332342,88.45940910300772,6
0.05,3757,94,332436,88.46088344864289,7
0.05,3758,94,332530,88.46235700984305,7
0.05,3759,95,332625,88.46409574468085,6
0.05,3760,95,332720,88.46583355490561,7
0.05,3761,96,332816,88.46783625730994,6
0.05,3762,92,332908,88.46877491363274,9
0.05,3763,91,332999,88.46944739638683,11
0.05,3764,94,333093,88.47091633466135,7
0.05,3765,95,333188,88.47265002655337,7
0.05,3766,91,333279,88.47332094504911,10
0.05,3767,95,333374,88.47505307855626,6
0.05,3768,95,333469,88.4767842929159,6
0.05,3769,94,333563,88.47824933687002,7
0.05,3770,94,333657,88.47971360381861,7
0.05,3771,96,333753,88.48170731707317,6
0.05,3772,94,333847,88.48316989133316,7
0.05,3773,92,333939,88.48410174880763,9
0.05,3774,96,334035,88.48609271523179,6
0.05,3775,96,334131,88.48808262711864,6
0.05,3776,96,334227,88.4900714853058,6
0.05,3777,94,334321,88.4915299100053,8
0.05,3778,96,334417,88.49351680338714,6
0.05,3779,93,334510,88.494708994709,8
0.05,3780,94,334604,88.49616503570483,7
0.05,3781,95,334699,88.49788471708091,6
0.05,3782,94,334793,88.49933914882368,7
0.05,3783,94,334887,88.50079281183932,7
0.05,3784,96,334983,88.50277410832233,6
0.05,3785,95,335078,88.50449022715267,6
0.05,3786,93,335171,88.50567731713758,8
0.05,3787,95,335266,88.50739176346357,6
0.05,3788,95,335361,88.50910530482977,6
0.05,3789,95,335456,88.51081794195251,6
0.05,3790,95,335551,88.51252967554736,6
0.05,3791,93,335644,88.51371308016877,8
0.05,3792,94,335738,88.51515950435012,7
0.05,3793,92,335830,88.51607801792304,9
0.05,3794,96,335926,88.51805006587615,6
0.05,3795,92,336018,88.51896733403582,9
0.05,3796,91,336109,88.51962075322623,10
0.05,3797,94,336203,88.52106371774619,7
0.05,3798,91,336294,88.52171624111608,10
0.05,3799,95,336389,88.52342105263158,6
0.05,3800,92,336481,88.52433570113128,9
0.05,3801,95,336576,88.52603892688059,7
0.05,3802,92,336668,88.52695240599526,9
0.05,3803,93,336761,88.52812828601472,8
0.05,3804,89,336850,88.52825229960578,12
0.05,3805,94,336944,88.52968996321597,7
0.05,3806,92,337036,88.53060152350932,9
0.05,3807,90,337126,88.53098739495799,11
0.05,3808,93,337219,88.53216067209242,8
0.05,3809,94,337313,88.53359580052494,8
0.05,3810,91,337404,88.53424298084492,10
0.05,3811,95,337499,88.53593913955929,6
0.05,3812,93,337592,88.5371098872279,8
0.05,3813,94,337686,88.53854221289984,7
0.05,3814,95,337781,88.54023591087811,6
0.05,3815,90,337871,88.54061844863732,11
0.05,3816,94,337965,88.54204872936862,7
0.05,3817,95,338060,88.54374017810372,7
0.05,3818,95,338155,88.54543074103168,6
0.05,3819,95,338250,88.54712041884817,6
0.05,3820,94,338344,88.54854750065428,8
0.05,3821,94,338438,88.54997383568812,7
0.05,3822,92,338530,88.55087627517656,9
0.05,3823,94,338624,88.55230125523012,7
0.05,3824,24,338648,88.53542483660131,8
0.05,3825,94,338742,88.53685311029795,7
0.05,3826,94,338836,88.53828063757513,7
0.05,3827,92,338928,88.53918495297806,9
0.05,3828,95,339023,88.54087229041525,6
0.05,3829,96,339119,88.54281984334203,6
0.05,3830,15,339134,88.52362307491516,17
0.05,3831,96,339230,88.52557411273486,6
0.05,3832,94,339324,88.52700234803027,7
0.05,3833,93,339417,88.52816901408451,8
0.05,3834,95,339512,88.52985658409388,7
0.05,3835,96,339608,88.5318039624609,6
0.05,3836,93,339701,88.53296846494658,8
0.05,3837,96,339797,88.53491401771755,6
0.05,3838,90,339887,88.53529564990883,11
0.05,3839,94,339981,88.53671875,7
0.05,3840,94,340075,88.53814110908617,9
0.05,3841,92,340167,88.53904216553879,9
0.05,3842,92,340259,88.5399427530575,10
0.05,3843,87,340346,88.53954214360041,15
0.05,3844,92,340438,88.5404421326398,9
0.05,3845,93,340531,88.54160166406656,8
0.05,3846,93,340624,88.54276059266961,9
0.05,3847,96,340720,88.54469854469855,6
0.05,3848,92,340812,88.54559625876851,9
0.05,3849,91,340903,88.54623376623377,11
0.05,3850,92,340995,88.54713061542456,9
0.05,3851,94,341089,88.54854620976116,7
0.05,3852,94,341183,88.54996106929666,7
0.05,3853,26,341209,88.53373118837571,7
0.05,3854,94,341303,88.53514915693904,7
0.05,3855,92,341395,88.53604771784232,9
0.05,3856,94,341489,88.53746435053151,7
0.05,3857,94,341583,88.53888024883359,8
0.05,3858,91,341674,88.53951800984711,11
0.05,3859,96,341770,88.54145077720207,6
0.05,3860,95,341865,88.54312354312354,6
0.05,3861,90,341955,88.54350077679959,11
0.05,3862,96,342051,88.54543101216672,6
0.05,3863,93,342144,88.54658385093168,9
0.05,3864,95,342239,88.54825355756792,6
0.05,3865,94,342333,88.54966373512674,7
0.05,3866,94,342427,88.55107318334626,7
0.05,3867,27,342454,88.53516028955532,6
0.05,3868,96,342550,88.53708968725769,6
0.05,3869,96,342646,88.5390180878553,6
0.05,3870,94,342740,88.54042882975975,7
0.05,3871,94,342834,88.54183884297521,8
0.05,3872,92,342926,88.54273173250711,9
0.05,3873,90,343016,88.5431078988126,11
0.05,3874,95,343111,88.54477419354839,6
0.05,3875,94,343205,88.54618163054695,7
0.05,3876,93,343298,88.54733041011092,8
0.05,3877,93,343391,88.54847859721507,9
0.05,3878,90,343481,88.54885279711266,11
0.05,3879,92,343573,88.54974226804124,9
0.05,3880,96,343669,88.55166194279825,6
0.05,3881,94,343763,88.55306543019063,7
0.05,3882,93,343856,88.55421066185939,8
0.05,3883,95,343951,88.55587023686921,6
0.05,3884,93,344044,88.55701415701415,8
0.05,3885,96,344140,88.55892949047865,6
0.05,3886,90,344230,88.55930023154103,12
0.05,3887,92,344322,88.56018518518519,9
0.05,3888,93,344415,88.56132681923374,8
0.05,3889,94,344509,88.56272493573265,7
0.05,3890,95,344604,88.56437933693138,6
0.05,3891,96,344700,88.56628982528264,6
0.05,3892,93,344793,88.56742871821217,8
0.05,3893,95,344888,88.56908063687725,6
0.05,3894,93,344981,88.57021822849808,10
0.05,3895,96,345077,88.57212525667352,6
0.05,3896,96,345173,88.57403130613292,6
0.05,3897,95,345268,88.57567983581323,6
0.05,3898,95,345363,88.57732751987689,7
0.05,3899,96,345459,88.57923076923078,6
0.05,3900,93,345552,88.5803640092284,8
0.05,3901,93,345645,88.5814966683752,8
0.05,3902,95,345740,88.58314117345631,7
0.05,3903,95,345835,88.58478483606558,7
0.05,3904,95,345930,88.58642765685019,7
0.05,3905,93,346023,88.58755760368663,8
0.05,3906,94,346117,88.5889429229588,7
0.05,3907,93,346210,88.59007164790174,8
0.05,3908,95,346305,88.59171143514965,6
0.05,3909,95,346400,88.59335038363172,6
0.05,3910,94,346494,88.59473280490923,7
0.05,3911,-46,346448,88.560327198364,10
0.05,3912,94,346542,88.56171735241503,7
0.05,3913,93,346635,88.56285130301482,8
0.05,3914,94,346729,88.56424010217114,7
0.05,3915,94,346823,88.56562819203269,7
0.05,3916,95,346918,88.5672708705642,6
0.05,3917,91,347009,88.56789178152118,10
0.05,3918,90,347099,88.56825720847155,11
0.05,3919,94,347193,88.56964285714285,7
0.05,3920,92,347285,88.57051772507013,9
0.05,3921,94,347379,88.57190209077001,7
0.05,3922,94,347473,88.57328575070099,7
0.05,3923,92,347565,88.57415902140673,9
0.05,3924,96,347661,88.57605095541402,6
0.05,3925,94,347755,88.57743250127356,8
0.05,3926,92,347847,88.57830404889228,9
0.05,3927,95,347942,88.57993890020367,6
0.05,3928,92,348034,88.58080936625096,9
0.05,3929,94,348128,88.5821882951654,8
0.05,3930,94,348222,88.58356652251335,7
0.05,3931,96,348318,88.58545269582909,6
0.05,3932,95,348413,88.58708365115687,6
0.05,3933,94,348507,88.5884595831215,7
0.05,3934,94,348601,88.58983481575603,7
0.05,3935,92,348693,88.5907012195122,9
0.05,3936,94,348787,88.59207518415037,8
0.05,3937,92,348879,88.5929405789741,9
0.05,3938,93,348972,88.5940594059406,8
0.05,3939,96,349068,88.59593908629442,6
0.05,3940,92,349160,88.59680284191829,9
0.05,3941,95,349255,88.59842719431761,6
0.05,3942,94,349349,88.5997971088004,7
0.05,3943,96,349445,88.60167342799188,6
0.05,3944,94,349539,88.60304182509506,8
0.05,3945,93,349632,88.60415610745058,8
0.05,3946,92,349724,88.6050164682037,10
0.05,3947,92,349816,88.60587639311044,9
0.05,3948,94,349910,88.60724233983287,7
0.05,3949,93,350003,88.60835443037975,8
0.05,3950,96,350099,88.61022525942799,6
0.05,3951,95,350194,88.61184210526316,6
0.05,3952,90,350284,88.61219327093347,11
0.05,3953,94,350378,88.61355589276681,7
0.05,3954,94,350472,88.61491782553729,7
0.05,3955,95,350567,88.6165318503539,6
0.05,3956,92,350659,88.6173869092747,9
0.05,3957,94,350753,88.61874684183931,8
0.05,3958,94,350847,88.62010608739581,7
0.05,3959,94,350941,88.62146464646464,7
0.05,3960,95,351036,88.62307498106539,6
0.05,3961,92,351128,88.62392730943968,9
0.05,3962,96,351224,88.6257885440323,6
0.05,3963,96,351320,88.627648839556,6
0.05,3964,93,351413,88.62875157629256,8
0.05,3965,92,351505,88.62960161371659,9
0.05,3966,94,351599,88.63095538190068,8
0.05,3967,92,351691,88.63180443548387,9
0.05,3968,95,351786,88.6334089191232,6
0.05,3969,93,351879,88.63450881612091,8
0.05,3970,94,351973,88.63585998489046,7
0.05,3971,93,352066,88.63695871097684,8
0.05,3972,93,352159,88.63805688396677,8
0.05,3973,96,352255,88.63990941117262,6
0.05,3974,96,352351,88.64176100628931,6
0.05,3975,92,352443,88.64260563380282,9
0.05,3976,96,352539,88.64445561981393,6
0.05,3977,94,352633,88.6458019105078,7
0.05,3978,94,352727,88.64714752450364,7
0.05,3979,94,352821,88.64849246231155,7
0.05,3980,93,352914,88.64958553127354,8
0.05,3981,95,353009,88.6511803114013,6
0.05,3982,94,353103,88.65252322370073,7
0.05,3983,90,353193,88.65286144578313,11
0.05,3984,95,353288,88.65445420326223,7
0.05,3985,92,353380,88.6552935273457,9
0.05,3986,89,353469,88.6553799849511,12
0.05,3987,95,353564,88.65697091273822,6
0.05,3988,92,353656,88.65780897468036,9
0.05,3989,92,353748,88.65864661654135,9
0.05,3990,93,353841,88.6597344024054,8
0.05,3991,90,353931,88.66007014028057,11
0.05,3992,94,354025,88.66140746306036,7
0.05,3993,94,354119,88.66274411617427,7
0.05,3994,94,354213,88.66408010012516,7
0.05,3995,94,354307,88.66541541541541,7
0.05,3996,92,354399,88.66624968726545,10
0.05,3997,27,354426,88.65082541270635,6
0.05,3998,90,354516,88.65116279069767,12
0.05,3999,91,354607,88.65175,10
0.05,4000,93,354700,88.6528367908023,8
0.05,4001,96,354796,88.65467266366817,6
0.05,4002,93,354889,88.65575818136398,8
0.05,4003,94,354983,88.6570929070929,7
0.05,4004,96,355079,88.6589263420724,6
0.05,4005,94,355173,88.66025961058412,7
0.05,4006,94,355267,88.66159221362615,8
0.05,4007,95,355362,88.66317365269461,6
0.05,4008,94,355456,88.66450486405587,8
0.05,4009,94,355550,88.66583541147132,7
0.05,4010,96,355646,88.66766392420843,6
0.05,4011,92,355738,88.66849451645065,9
0.05,4012,91,355829,88.66907550461002,10
0.05,4013,94,355923,88.67040358744394,7
0.05,4014,92,356015,88.67123287671232,9
0.05,4015,93,356108,88.67231075697211,8
0.05,4016,94,356202,88.67363704256908,7
0.05,4017,94,356296,88.67496266799402,7
0.05,4018,95,356391,88.67653645185369,6
0.05,4019,93,356484,88.6776119402985,8
0.05,4020,94,356578,88.67893558816215,7
0.05,4021,94,356672,88.68025857782197,7
0.05,4022,22,356694,88.66368381804624,10
0.05,4023,94,356788,88.66500994035785,7
0.05,4024,94,356882,88.6663354037267,7
0.05,4025,94,356976,88.66766020864381,7
0.05,4026,94,357070,88.6689843555997,7
0.05,4027,95,357165,88.67055610724925,6
0.05,4028,93,357258,88.67163067758749,9
0.05,4029,93,357351,88.6727047146402,8
0.05,4030,92,357443,88.67353014140411,9
0.05,4031,-44,357399,88.640625,8
0.05,4032,95,357494,88.64220183486239,6
0.05,4033,95,357589,88.64377788795241,6
0.05,4034,94,357683,88.6451053283767,7
0.05,4035,92,357775,88.64593657086223,9
0.05,4036,94,357869,88.64726281892494,8
0.05,4037,92,357961,88.64809311540367,9
0.05,4038,95,358056,88.6496657588512,6
0.05,4039,95,358151,88.65123762376237,6
0.05,4040,93,358244,88.6523137837169,9
0.05,4041,94,358338,88.65363681345869,7
0.05,4042,91,358429,88.65421716547118,10
0.05,4043,93,358522,88.65529179030662,8
0.05,4044,92,358614,88.65611866501854,9
0.05,4045,95,358709,88.65768660405338,7
0.05,4046,95,358804,88.65925376822338,6
0.05,4047,95,358899,88.66082015810277,6
0.05,4048,92,358991,88.66164485058039,9
0.05,4049,93,359084,88.66271604938271,8
0.05,4050,94,359178,88.66403357195755,7
0.05,4051,96,359274,88.66584402764067,6
0.05,4052,95,359369,88.66740685911671,6
0.05,4053,95,359464,88.6689689195856,6
0.05,4054,94,359558,88.67028360049322,7
0.05,4055,96,359654,88.67209072978304,6
0.05,4056,94,359748,88.67340399309835,9
0.05,4057,94,359842,88.67471660916708,7
0.05,4058,95,359937,88.67627494456762,6
0.05,4059,95,360032,88.67783251231528,6
0.05,4060,93,360125,88.6788968234425,8
0.05,4061,96,360221,88.68069916297391,6
0.05,4062,92,360313,88.68151612109278,9
0.05,4063,94,360407,88.6828248031496,7
0.05,4064,95,360502,88.68437884378844,6
0.05,4065,95,360597,88.68593212001967,7
0.05,4066,93,360690,88.68699286943693,8
0.05,4067,96,360786,88.68879056047197,6
0.05,4068,95,360881,88.69034160727452,6
0.05,4069,91,360972,88.69090909090909,11
0.05,4070,94,361066,88.69221321542618,7
0.05,4071,93,361159,88.69327111984283,8
0.05,4072,95,361254,88.69481954333415,6
0.05,4073,94,361348,88.69612174766814,7
0.05,4074,95,361443,88.69766871165645,6
0.05,4075,94,361537,88.69896957801767,7
0.05,4076,93,361630,88.70002452783909,8
0.05,4077,95,361725,88.70156939676312,6
0.05,4078,93,361818,88.7026231919588,8
0.05,4079,96,361914,88.70441176470588,6
0.05,4080,94,362008,88.70570938495467,7
0.05,4081,95,362103,88.70725134737873,6
0.05,4082,94,362197,88.70854763654175,7
0.05,4083,91,362288,88.70910871694417,10
0.05,4084,94,362382,88.71040391676867,7
0.05,4085,96,362478,88.71218795888399,6
0.05,4086,92,362570,88.71299241497431,9
0.05,4087,94,362664,88.71428571428571,7
0.05,4088,94,362758,88.71557838102225,7
0.05,4089,-44,362714,88.68312958435207,8
0.05,4090,91,362805,88.68369591786849,10
0.05,4091,94,362899,88.68499511241447,7
0.05,4092,93,362992,88.68604935255314,8
0.05,4093,92,363084,88.68685881778212,9
0.05,4094,95,363179,88.68840048840049,7
0.05,4095,95,363274,88.68994140625,6
0.05,4096,96,363370,88.69172565291677,6
0.05,4097,90,363460,88.6920448999512,11
0.05,4098,94,363554,88.69333983898512,7
0.05,4099,94,363648,88.69463414634146,7
0.05,4100,89,363737,88.69470860765666,12
0.05,4101,94,363831,88.69600195026817,7
0.05,4102,96,363927,88.69778211065075,6
0.05,4103,95,364022,88.69931773879142,7
0.05,4104,93,364115,88.70036540803898,8
0.05,4105,94,364209,88.70165611300536,7
0.05,4106,95,364304,88.70318967616265,6
0.05,4107,92,364396,88.70399221032132,9
0.05,4108,94,364490,88.7052810902896,7
0.05,4109,94,364584,88.7065693430657,8
0.05,4110,88,364672,88.70639747020189,14
0.05,4111,94,364766,88.70768482490273,7
0.05,4112,27,364793,88.69268174082178,6
0.05,4113,94,364887,88.69397180359748,7
0.05,4114,95,364982,88.6955042527339,6
0.05,4115,91,365073,88.6960641399417,10
0.05,4116,84,365157,88.69492348797668,17
0.05,4117,25,365182,88.67945604662458,7
0.05,4118,96,365278,88.6812333090556,6
0.05,4119,93,365371,88.68228155339806,8
0.05,4120,92,365463,88.68308662945887,10
0.05,4121,96,365559,88.6848617176128,6
0.05,4122,95,365654,88.686393402862,6
0.05,4123,91,365745,88.68695441319107,10
0.05,4124,92,365837,88.68775757575757,9
0.05,4125,94,365931,88.68904507998062,7
0.05,4126,95,366026,88.69057426702204,6
0.05,4127,94,366120,88.69186046511628,7
0.05,4128,96,366216,88.69363041898765,6
0.05,4129,94,366310,88.69491525423729,7
0.05,4130,94,366404,88.6961994674413,7
0.05,4131,92,366496,88.6969990319458,9
0.05,4132,90,366586,88.69731429954028,11
0.05,4133,26,366612,88.68214804063861,6
0.05,4134,27,366639,88.66723095525998,6
0.05,4135,94,366733,88.66852030947776,7
0.05,4136,93,366826,88.66956731931351,8
0.05,4137,93,366919,88.67061382310295,8
0.05,4138,96,367015,88.67238463396956,6
0.05,4139,93,367108,88.67342995169082,8
0.05,4140,95,367203,88.6749577396764,6
0.05,4141,93,367296,88.67600193143409,8
0.05,4142,89,367385,88.67608013516775,12
0.05,4143,94,367479,88.67736486486487,7
0.05,4144,93,367572,88.67840772014475,9
0.05,4145,94,367666,88.67969126869272,7
0.05,4146,94,367760,88.68097419821558,7
0.05,4147,96,367856,88.68273866923819,6
0.05,4148,95,367951,88.68426126777537,7
0.05,4149,94,368045,88.6855421686747,7
0.05,4150,95,368140,88.68706335822694,6
0.05,4151,93,368233,88.6881021194605,8
0.05,4152,94,368327,88.68938117023838,7
0.05,4153,94,368421,88.69065960519981,7
0.05,4154,94,368515,88.69193742478942,7
0.05,4155,92,368607,88.69273339749759,9
0.05,4156,94,368701,88.69401010343998,7
0.05,4157,96,368797,88.69576719576719,6
0.05,4158,96,368893,88.69752344313537,6
0.05,4159,96,368989,88.69927884615385,6
0.05,4160,95,369084,88.70079307858688,6
0.05,4161,91,369175,88.7013455069678,10
0.05,4162,96,369271,88.70309872687966,6
0.05,4163,94,369365,88.70437079731028,7
0.05,4164,94,369459,88.70564225690276,7
0.05,4165,94,369553,88.70691310609698,7
0.05,4166,94,369647,88.70818334533237,7
0.05,4167,96,369743,88.70993282149712,6
0.05,4168,95,369838,88.71144159270808,6
0.05,4169,94,369932,88.7127098321343,8
0.05,4170,95,370027,88.71421721409735,7
0.05,4171,95,370122,88.71572387344199,6
0.05,4172,92,370214,88.7165109034268,9
0.05,4173,92,370306,88.7172975563009,9
0.05,4174,95,370401,88.71880239520958,6
0.05,4175,94,370495,88.72006704980843,7
0.05,4176,-49,370446,88.68709600191525,14
0.05,4177,23,370469,88.67137386309238,9
0.05,4178,94,370563,88.67264895908112,7
0.05,4179,93,370656,88.67368421052632,9
0.05,4180,94,370750,88.6749581439847,7
0.05,4181,94,370844,88.67623146819703,7
0.05,4182,94,370938,88.67750418360029,7
0.05,4183,95,371033,88.67901529636711,6
0.05,4184,91,371124,88.67956989247311,10
0.05,4185,95,371219,88.68107978977544,6
0.05,4186,94,371313,88.68235013135897,7
0.05,4187,93,371406,88.68338108882521,8
0.05,4188,95,371501,88.68488899498686,8
0.05,4189,90,371591,88.68520286396182,11
0.05,4190,93,371684,88.68623240276784,8
0.05,4191,94,371778,88.6875,7
0.05,4192,94,371872,88.68876699260673,7
0.05,4193,94,371966,88.6900333810205,7
0.05,4194,93,372059,88.69106078665078,8
0.05,4195,94,372153,88.69232602478552,7
0.05,4196,92,372245,88.69311412913986,9
0.05,4197,94,372339,88.69437827536922,7
0.05,4198,96,372435,88.69611812336271,6
0.05,4199,95,372530,88.69761904761904,6
0.05,4200,95,372625,88.69911925731968,6
0.05,4201,94,372719,88.7003807710614,7
0.05,4202,96,372815,88.70211753509398,6
0.05,4203,94,372909,88.70337773549001,7
0.05,4204,94,373003,88.70463733650416,7
0.05,4205,93,373096,88.7056585829767,8
0.05,4206,94,373190,88.70691704302354,7
0.05,4207,94,373284,88.70817490494296,7
0.05,4208,95,373379,88.70966975528628,6
0.05,4209,95,373474,88.71116389548693,6
0.05,4210,91,373565,88.7117074329138,10
0.05,4211,94,373659,88.71296296296296,7
0.05,4212,92,373751,88.71374317588416,9
0.05,4213,96,373847,88.71547223540578,6
0.05,4214,94,373941,88.71672597864769,7
0.05,4215,93,374034,88.71774193548387,9
0.05,4216,92,374126,88.71852027507707,9
0.05,4217,94,374220,88.71977240398293,7
0.05,4218,95,374315,88.72126096231334,7
0.05,4219,94,374409,88.72251184834123,7
0.05,4220,94,374503,88.7237621416726,8
0.05,4221,92,374595,88.72453813358598,9
0.05,4222,93,374688,88.72555055647643,8
0.05,4223,89,374777,88.72561553030303,12
0.05,4224,93,374870,88.72662721893491,8
0.05,4225,94,374964,88.7278750591576,7
0.05,4226,94,375058,88.72912230896617,7
0.05,4227,96,375154,88.73084200567644,6
0.05,4228,91,375245,88.73137857649563,11
0.05,4229,93,375338,88.73238770685579,10
0.05,4230,94,375432,88.73363271094304,8
0.05,4231,95,375527,88.7351134215501,6
0.05,4232,93,375620,88.73612095440586,9
0.05,4233,94,375714,88.73736419461503,7
0.05,4234,92,375806,88.73813459268004,9
0.05,4235,95,375901,88.73961284230406,6
0.05,4236,96,375997,88.7413264101959,6
0.05,4237,21,376018,88.72534214252006,11
0.05,4238,94,376112,88.72658645907053,7
0.05,4239,93,376205,88.72759433962264,8
0.05,4240,94,376299,88.72883753831644,7
0.05,4241,94,376393,88.73008015087223,7
0.05,4242,88,376481,88.7299080839029,14
0.05,4243,94,376575,88.73114985862394,7
0.05,4244,94,376669,88.73239104829211,7
0.05,4245,88,376757,88.73221855864342,14
0.05,4246,94,376851,88.7334589121733,7
0.05,4247,92,376943,88.73422787193974,9
0.05,4248,94,377037,88.73546716874559,8
0.05,4249,94,377131,88.73670588235294,7
0.05,4250,92,377223,88.73747353563867,9
0.05,4251,96,377319,88.73918156161807,6
0.05,4252,92,377411,88.73994827180813,10
0.05,4253,92,377503,88.74071462153267,9
0.05,4254,95,377598,88.7421856639248,6
0.05,4255,94,377692,88.74342105263158,7
0.05,4256,95,377787,88.74489076814658,7
0.05,4257,96,377883,88.74659464537342,6
0.05,4258,92,377975,88.74735853486735,9
0.05,4259,94,378069,88.74859154929578,7
0.05,4260,96,378165,88.75029335836658,6
0.05,4261,90,378255,88.75058657907086,11
0.05,4262,94,378349,88.75181796856674,7
0.05,4263,93,378442,88.75281425891183,8
0.05,4264,95,378537,88.75427901524033,6
0.05,4265,95,378632,88.755743084857,6
0.05,4266,27,378659,88.74127021326458,6
0.05,4267,26,378685,88.72656982193065,7
0.05,4268,94,378779,88.72780510658234,7
0.05,4269,92,378871,88.72857142857143,9
0.05,4270,94,378965,88.72980566612034,7
0.05,4271,21,378986,88.71395131086142,11
0.05,4272,96,379082,88.7156564474608,6
0.05,4273,96,379178,88.7173607861488,7
0.05,4274,96,379274,88.71906432748538,6
0.05,4275,95,379369,88.72053320860617,7
0.05,4276,95,379464,88.72200140285247,7
0.05,4277,93,379557,88.72300140252455,8
0.05,4278,95,379652,88.72446833372284,6
0.05,4279,95,379747,88.72593457943925,6
0.05,4280,96,379843,88.7276337304368,6
0.05,4281,96,379939,88.72933208780944,6
0.05,4282,92,380031,88.73009572729396,10
0.05,4283,93,380124,88.73109243697479,8
0.05,4284,95,380219,88.73255542590432,6
0.05,4285,94,380313,88.73378441437238,7
0.05,4286,90,380403,88.73407977606718,12
0.05,4287,93,380496,88.73507462686567,8
0.05,4288,91,380587,88.73560270459315,10
0.05,4289,92,380679,88.73636363636363,9
0.05,4290,95,380774,88.73782335120019,8
0.05,4291,94,380868,88.73904939422181,7
0.05,4292,93,380961,88.74004192872117,8
0.05,4293,94,381055,88.74126688402421,7
0.05,4294,96,381151,88.7429569266589,6
0.05,4295,91,381242,88.74348230912477,10
0.05,4296,93,381335,88.74447288806144,8
0.05,4297,95,381430,88.74592833876221,7
0.05,4298,95,381525,88.74738311235171,6
0.05,4299,94,381619,88.7486046511628,7
0.05,4300,89,381708,88.74866310160428,12
0.05,4301,94,381802,88.74988377498838,7
0.05,4302,94,381896,88.75110388101325,7
0.05,4303,93,381989,88.75209107806691,8
0.05,4304,89,382078,88.75214866434379,13
0.05,4305,94,382172,88.7533673943335,7
0.05,4306,93,382265,88.7543533782215,8
0.05,4307,94,382359,88.75557103064067,8
0.05,4308,96,382455,88.75725226270596,6
0.05,4309,93,382548,88.75823665893272,9
0.05,4310,93,382641,88.75922059846903,8
0.05,4311,94,382735,88.76043599257885,7
0.05,4312,-44,382691,88.72965453280779,8
0.05,4313,92,382783,88.73041261010663,9
0.05,4314,90,382873,88.73070683661645,11
0.05,4315,91,382964,88.73123262279888,10
0.05,4316,24,382988,88.71623812832986,8
0.05,4317,93,383081,88.71723019916628,8
0.05,4318,94,383175,88.71845334568187,7
0.05,4319,92,383267,88.71921296296296,9
0.05,4320,95,383362,88.7206665123814,6
0.05,4321,96,383458,88.7223507635354,6
0.05,4322,93,383551,88.7233402729586,8
0.05,4323,92,383643,88.7240980573543,9
0.05,4324,90,383733,88.72439306358382,11
0.05,4325,94,383827,88.72561257512714,7
0.05,4326,92,383919,88.72636930899006,9
0.05,4327,95,384014,88.72781885397413,6
0.05,4328,91,384105,88.72834372834373,10
0.05,4329,96,384201,88.73002309468822,6
0.05,4330,96,384297,88.73170168552298,6
0.05,4331,96,384393,88.73337950138504,6
0.05,4332,95,384488,88.73482575582737,6
0.05,4333,86,384574,88.73419473927088,15
0.05,4334,94,384668,88.7354094579008,7
0.05,4335,95,384763,88.73685424354244,6
0.05,4336,94,384857,88.7380677887941,8
0.05,4337,90,384947,88.73835869064085,11
0.05,4338,94,385041,88.73957132979949,7
0.05,4339,94,385135,88.74078341013825,7
0.05,4340,95,385230,88.74222529371113,6
0.05,4341,94,385324,88.74343620451405,7
0.05,4342,95,385419,88.74487681326272,6
0.05,4343,94,385513,88.74608655616943,7
0.05,4344,20,385533,88.73026467203682,12
0.05,4345,95,385628,88.73170731707317,7
0.05,4346,94,385722,88.73291925465838,7
0.05,4347,94,385816,88.73413063477462,7
0.05,4348,95,385911,88.73557139572316,6
0.05,4349,96,386007,88.73724137931035,6
0.05,4350,93,386100,88.73822109859802,8
0.05,4351,95,386195,88.7396599264706,6
0.05,4352,93,386288,88.74063864001837,8
0.05,4353,96,386384,88.74230592558567,6
0.05,4354,95,386479,88.74374282433983,6
0.05,4355,96,386575,88.74540863177226,6
0.05,4356,96,386671,88.74707367454671,6
0.05,4357,94,386765,88.74827902707663,7
0.05,4358,95,386860,88.74971323698095,6
0.05,4359,90,386950,88.75,11
0.05,4360,94,387044,88.75120385232745,7
0.05,4361,90,387134,88.75149014213663,11
0.05,4362,94,387228,88.75269310107724,7
0.05,4363,95,387323,88.75412465627865,6
0.05,4364,94,387417,88.7553264604811,7
0.05,4365,96,387513,88.75698579935867,6
0.05,4366,94,387607,88.75818639798489,7
0.05,4367,96,387703,88.75984432234432,6
0.05,4368,27,387730,88.74570840009156,6
0.05,4369,93,387823,88.7466819221968,8
0.05,4370,94,387917,88.7478837794555,7
0.05,4371,95,388012,88.74931381518756,6
0.05,4372,94,388106,88.75051452092386,7
0.05,4373,96,388202,88.75217192501142,6
0.05,4374,93,388295,88.75314285714286,8
0.05,4375,94,388389,88.75434186471664,7
0.05,4376,94,388483,88.75554032442312,7
0.05,4377,96,388579,88.75719506624029,6
0.05,4378,27,388606,88.74309203014387,6
0.05,4379,94,388700,88.74429223744292,7
0.05,4380,89,388789,88.74435060488473,12
0.05,4381,92,388881,88.74509356458238,9
0.05,4382,93,388974,88.7460643394935,8
0.05,4383,95,389069,88.7474908759124,6
0.05,4384,96,389165,88.74914481185861,6
0.05,4385,92,389257,88.749886000912,9
0.05,4386,95,389352,88.751310690677,6
0.05,4387,93,389445,88.75227894257064,8
0.05,4388,94,389539,88.75347459557986,7
0.05,4389,94,389633,88.75466970387244,7
0.05,4390,94,389727,88.75586426782054,8
0.05,4391,93,389820,88.7568306010929,8
0.05,4392,91,389911,88.75734122467561,10
0.05,4393,94,390005,88.75853436504325,7
0.05,4394,95,390100,88.7599544937429,6
0.05,4395,92,390192,88.7606915377616,9
0.05,4396,93,390285,88.7616556743234,8
0.05,4397,94,390379,88.76284674852205,7
0.05,4398,95,390474,88.76426460559217,6
0.05,4399,23,390497,88.74931818181818,10
0.05,4400,95,390592,88.75073846852987,6
0.05,4401,94,390686,88.7519309404816,7
0.05,4402,94,390780,88.75312287076993,8
0.05,4403,25,390805,88.73864668483198,7
0.05,4404,94,390899,88.73984108967083,7
0.05,4405,94,390993,88.74103495233773,7
0.05,4406,93,391086,88.74200136147039,8
0.05,4407,27,391113,88.7279945553539,6
0.05,4408,96,391209,88.72964391018371,6
0.05,4409,88,391297,88.72947845804988,13
0.05,4410,93,391390,88.73044661074586,8
0.05,4411,93,391483,88.73141432456936,8
0.05,4412,94,391577,88.73260820303648,7
0.05,4413,94,391671,88.73380154055279,7
0.05,4414,92,391763,88.73454133635335,9
0.05,4415,91,391854,88.7350543478261,10
0.05,4416,94,391948,88.73624632103237,7
0.05,4417,94,392042,88.73743775464011,7
0.05,4418,94,392136,88.73862864901561,7
0.05,4419,90,392226,88.73891402714932,11
0.05,4420,95,392321,88.74033024202669,6
0.05,4421,94,392415,88.7415196743555,7
0.05,4422,94,392509,88.74270856884468,7
0.05,4423,92,392601,88.74344484629295,9
0.05,4424,91,392692,88.74395480225989,10
0.05,4425,96,392788,88.74559421599639,6
0.05,4426,95,392883,88.74700700248475,7
0.05,4427,95,392978,88.74841915085817,6
0.05,4428,95,393073,88.74983066154888,6
0.05,4429,93,393166,88.75079006772009,8
0.05,4430,96,393262,88.75242608891898,6
0.05,4431,96,393358,88.75406137184116,6
0.05,4432,91,393449,88.75456801263253,10
0.05,4433,94,393543,88.75575101488498,8
0.05,4434,94,393637,88.75693348365276,7
0.05,4435,92,393729,88.75766456266908,9
0.05,4436,95,393824,88.75907144466983,7
0.05,4437,95,393919,88.76047769265435,6
0.05,4438,95,394014,88.76188330705114,6
0.05,4439,95,394109,88.7632882882883,6
0.05,4440,27,394136,88.74938077009682,6
0.05,4441,93,394229,88.75033768572715,8
0.05,4442,95,394324,88.751744316903,6
0.05,4443,96,394420,88.75337533753375,6
0.05,4444,92,394512,88.7541057367829,9
0.05,4445,95,394607,88.75551057130005,6
0.05,4446,91,394698,88.75601529120756,10
0.05,4447,94,394792,88.75719424460432,7
0.05,4448,95,394887,88.75859743762643,6
0.05,4449,91,394978,88.7591011235955,10
0.05,4450,90,395068,88.75937991462592,11
0.05,4451,96,395164,88.76100628930817,6
0.05,4452,96,395260,88.76263193352796,6
0.05,4453,94,395354,88.76380781320162,7
0.05,4454,92,395446,88.7645342312009,9
0.05,4455,91,395537,88.76503590664272,10
0.05,4456,95,395632,88.76643482162889,6
0.05,4457,94,395726,88.7676087931808,7
0.05,4458,96,395822,88.76923076923077,6
0.05,4459,94,395916,88.77040358744395,7
0.05,4460,95,396011,88.771800044833,6
0.05,4461,96,396107,88.77341999103541,6
0.05,4462,93,396200,88.7743670177011,8
0.05,4463,94,396294,88.77553763440861,7
0.05,4464,93,396387,88.77648376259799,8
0.05,4465,-44,396343,88.74675324675324,8
0.05,4466,96,396439,88.74837698679202,6
0.05,4467,94,396533,88.74955237242614,7
0.05,4468,87,396620,88.74916088610428,15
0.05,4469,96,396716,88.75078299776287,6
0.05,4470,96,396812,88.75240438380675,6
0.05,4471,94,396906,88.75357781753131,7
0.05,4472,94,397000,88.75475072658172,7
0.05,4473,94,397094,88.75592311130978,8
0.05,4474,94,397188,88.75709497206704,8
0.05,4475,95,397283,88.75848972296693,7
0.05,4476,95,397378,88.75988385079295,7
0.05,4477,94,397472,88.76105404198303,7
0.05,4478,90,397562,88.76133065416387,11
0.05,4479,92,397654,88.76205357142857,9
0.05,4480,96,397750,88.76366882392323,6
0.05,4481,95,397845,88.76506024096386,6
0.05,4482,95,397940,88.76645103725184,6
0.05,4483,94,398034,88.76761819803747,7
0.05,4484,93,398127,88.7685618729097,8
0.05,4485,93,398220,88.76950512706198,8
0.05,4486,94,398314,88.77067082683307,7
0.05,4487,94,398408,88.77183600713012,8
0.05,4488,96,398504,88.77344620182669,6
0.05,4489,94,398598,88.77461024498886,7
0.05,4490,92,398690,88.77532843464707,10
0.05,4491,94,398784,88.77649154051647,7
0.05,4492,93,398877,88.77743156020476,9
0.05,4493,95,398972,88.77881619937695,7
0.05,4494,94,399066,88.77997775305896,7
0.05,4495,93,399159,88.78091637010677,8
0.05,4496,93,399252,88.78185456971315,8
0.05,4497,94,399346,88.78301467318808,7
0.05,4498,94,399440,88.78417426094688,7
0.05,4499,94,399534,88.78533333333333,7
0.05,4500,94,399628,88.78649189069095,7
0.05,4501,94,399722,88.78764993336296,8
0.05,4502,94,399816,88.7888074616922,8
0.05,4503,27,399843,88.77508880994671,6
0.05,4504,95,399938,88.7764705882353,6
0.05,4505,96,400034,88.7780736795384,6
0.05,4506,96,400130,88.77967605946306,6
0.05,4507,94,400224,88.78083407275953,8
0.05,4508,92,400316,88.78154801508094,9
0.05,4509,94,400410,88.78270509977827,8
0.05,4510,89,400499,88.78275326978498,12
0.05,4511,92,400591,88.78346631205673,9
0.05,4512,95,400686,88.7848437846222,7
0.05,4513,94,400780,88.78599911386797,7
0.05,4514,92,400872,88.78671096345515,9
0.05,4515,94,400966,88.78786536758193,7
0.05,4516,92,401058,88.78857648882001,9
0.05,4517,92,401150,88.78928729526339,9
0.05,4518,91,401241,88.7897764992255,10
0.05,4519,93,401334,88.79070796460176,8
0.05,4520,93,401427,88.7916390179164,8
0.05,4521,93,401520,88.79256965944272,8
0.05,4522,94,401614,88.79372098164934,7
0.05,4523,96,401710,88.79531388152078,6
0.05,4524,95,401805,88.79668508287293,6
0.05,4525,95,401900,88.79805567830314,7
0.05,4526,94,401994,88.79920477137176,7
0.05,4527,94,402088,88.80035335689045,7
0.05,4528,94,402182,88.8015014351954,7
0.05,4529,94,402276,88.80264900662252,7
0.05,4530,92,402368,88.80335466784375,9
0.05,4531,25,402393,88.78927625772286,8
0.05,4532,93,402486,88.79020516214428,8
0.05,4533,96,402582,88.79179532421702,6
0.05,4534,92,402674,88.79250275633959,9
0.05,4535,91,402765,88.79298941798942,10
0.05,4536,95,402860,88.79435750495922,6
0.05,4537,95,402955,88.79572498898193,6
0.05,4538,92,403047,88.79643093192333,9
0.05,4539,94,403141,88.79757709251102,7
0.05,4540,93,403234,88.79850253248183,8
0.05,4541,95,403329,88.7998678996037,6
0.05,4542,92,403421,88.80057230904688,9
0.05,4543,94,403515,88.80171654929578,7
0.05,4544,94,403609,88.8028602860286,7
0.05,4545,95,403704,88.80422349318081,7
0.05,4546,94,403798,88.80536617550032,7
0.05,4547,94,403892,88.80650835532101,7
0.05,4548,92,403984,88.80721037590679,9
0.05,4549,91,404075,88.8076923076923,10
0.05,4550,91,404166,88.80817402768622,10
0.05,4551,95,404261,88.80953427065026,6
0.05,4552,94,404355,88.81067428069404,7
0.05,4553,94,404449,88.81181379007467,7
0.05,4554,95,404544,88.81317233809001,6
0.05,4555,92,404636,88.81387181738367,9
0.05,4556,95,404731,88.81522931753346,6
0.05,4557,95,404826,88.81658622202721,6
0.05,4558,94,404920,88.81772318490897,8
0.05,4559,92,405012,88.81842105263158,9
0.05,4560,93,405105,88.8193378645034,8
0.05,4561,94,405199,88.82047347654537,7
0.05,4562,92,405291,88.82117028270875,9
0.05,4563,92,405383,88.82186678352322,9
0.05,4564,90,405473,88.82212486308872,11
0.05,4565,93,405566,88.82303985983356,8
0.05,4566,91,405657,88.82351653164002,10
0.05,4567,94,405751,88.82464973730298,8
0.05,4568,95,405846,88.82600131319764,7
0.05,4569,91,405937,88.82647702407002,10
0.05,4570,94,406031,88.82760883832859,7
0.05,4571,94,406125,88.82874015748031,7
0.05,4572,93,406218,88.82965230701946,8
0.05,4573,94,406312,88.83078268473983,7
0.05,4574,95,406407,88.83213114754098,6
0.05,4575,94,406501,88.8332604895105,7
0.05,4576,92,406593,88.83395237054839,9
0.05,4577,95,406688,88.8352992573176,6
0.05,4578,92,406780,88.83599039091504,9
0.05,4579,93,406873,88.83689956331878,8
0.05,4580,96,406969,88.83846321763806,6
0.05,4581,95,407064,88.8398079441292,6
0.05,4582,94,407158,88.84093388610081,7
0.05,4583,27,407185,88.8274432809773,6
0.05,4584,90,407275,88.82769901853871,12
0.05,4585,93,407368,88.82860880941998,8
0.05,4586,91,407459,88.82908218879442,11
0.05,4587,95,407554,88.83042720139494,6
0.05,4588,96,407650,88.83198954020484,6
0.05,4589,93,407743,88.83289760348583,9
0.05,4590,93,407836,88.83380527118275,8
0.05,4591,95,407931,88.8351480836237,6
0.05,4592,96,408027,88.83670803396473,6
0.05,4593,92,408119,88.83739660426643,10
0.05,4594,93,408212,88.83830250272035,8
0.05,4595,94,408306,88.83942558746736,7
0.05,4596,92,408398,88.84011311725038,9
0.05,4597,95,408493,88.84145280556764,6
0.05,4598,94,408587,88.84257447271146,7
0.05,4599,94,408681,88.8436956521739,7
0.05,4600,95,408776,88.84503368832863,6
0.05,4601,87,408863,88.84463276836158,14
0.05,4602,91,408954,88.84510102107322,10
0.05,4603,95,409049,88.84643788010426,6
0.05,4604,91,409140,88.84690553745928,10
0.05,4605,94,409234,88.84802431610942,7
0.05,4606,96,409330,88.84957673106143,6
0.05,4607,94,409424,88.85069444444444,7
0.05,4608,93,409517,88.85159470600998,8
0.05,4609,93,409610,88.85249457700651,8
0.05,4610,93,409703,88.85339405768813,8
0.05,4611,94,409797,88.85450997398092,7
0.05,4612,94,409891,88.85562540646,7
0.05,4613,94,409985,88.85674035543997,7
0.05,4614,92,410077,88.85742145178764,10
0.05,4615,96,410173,88.85896880415945,6
0.05,4616,96,410269,88.86051548624648,6
0.05,4617,96,410365,88.8620614984842,6
0.05,4618,89,410454,88.86209136176662,12
0.05,4619,95,410549,88.86341991341992,6
0.05,4620,95,410644,88.86474789006708,7
0.05,4621,93,410737,88.86564257897014,8
0.05,4622,94,410831,88.8667531905689,7
0.05,4623,93,410924,88.86764705882354,8
0.05,4624,25,410949,88.85383783783784,8
0.05,4625,95,411044,88.8551664504972,7
0.05,4626,94,411138,88.85627836611195,7
0.05,4627,27,411165,88.84291270527225,6
0.05,4628,95,411260,88.84424281702312,6
0.05,4629,92,411352,88.84492440604751,9
0.05,4630,94,411446,88.84603757287843,7
0.05,4631,96,411542,88.84758203799655,6
0.05,4632,92,411634,88.84826246492554,10
0.05,4633,94,411728,88.84937419076392,7
0.05,4634,94,411822,88.85048543689321,7
0.05,4635,25,411847,88.83671268334771,7
0.05,4636,95,411942,88.83804183739487,7
0.05,4637,92,412034,88.83872358775334,9
0.05,4638,93,412127,88.83962060788963,8
0.05,4639,96,412223,88.84116379310345,6
0.05,4640,94,412317,88.84227537168714,7
0.05,4641,94,412411,88.84338647134855,7
0.05,4642,94,412505,88.84449709239716,7
0.05,4643,92,412597,88.84517657192076,9
0.05,4644,93,412690,88.84607104413348,8
0.05,4645,96,412786,88.84761084804133,6
0.05,4646,94,412880,88.84871960404563,7
0.05,4647,26,412906,88.83519793459553,7
0.05,4648,91,412997,88.83566358356636,10
0.05,4649,92,413089,88.83634408602151,9
0.05,4650,95,413184,88.83766931842615,7
0.05,4651,94,413278,88.83877901977644,7
0.05,4652,95,413373,88.8401031592521,7
0.05,4653,92,413465,88.84078212290503,9
0.05,4654,95,413560,88.84210526315789,6
0.05,4655,95,413655,88.84342783505154,6
0.05,4656,92,413747,88.84410564741249,9
0.05,4657,94,413841,88.84521253756978,7
0.05,4658,96,413937,88.84674822923374,6
0.05,4659,92,414029,88.84742489270386,10
0.05,4660,96,414125,88.84895945076164,6
0.05,4661,95,414220,88.85027885027885,6
0.05,4662,94,414314,88.85138322968047,7
0.05,4663,96,414410,88.85291595197256,6
0.05,4664,87,414497,88.85251875669883,15
0.05,4665,96,414593,88.8540505786541,6
0.05,4666,94,414687,88.85515320334262,7
0.05,4667,95,414782,88.85646958011996,6
0.05,4668,92,414874,88.85714285714286,9
0.05,4669,92,414966,88.8578158458244,9
0.05,4670,96,415062,88.85934489402698,6
0.05,4671,94,415156,88.86044520547945,7
0.05,4672,93,415249,88.86133105071688,8
0.05,4673,96,415345,88.86285836542577,6
0.05,4674,92,415437,88.8635294117647,9
0.05,4675,88,415525,88.86334473909324,13
0.05,4676,96,415621,88.86487064357495,6
0.05,4677,96,415717,88.86639589568192,6
0.05,4678,95,415812,88.86770677495191,7
0.05,4679,95,415907,88.8690170940171,6
0.05,4680,94,416001,88.87011322367016,7
0.05,4681,93,416094,88.87099530115336,9
0.05,4682,96,416190,88.87251761691223,6
0.05,4683,94,416284,88.8736122971819,8
0.05,4684,96,416380,88.87513340448238,6
0.05,4685,94,416474,88.87622705932566,7
0.05,4686,95,416569,88.87753360358438,6
0.05,4687,95,416664,88.87883959044369,6
0.05,4688,93,416757,88.87971849008318,8
0.05,4689,92,416849,88.88038379530917,9
0.05,4690,96,416945,88.88190151353656,6
0.05,4691,94,417039,88.88299232736573,7
0.05,4692,94,417133,88.88408267632644,7
0.05,4693,94,417227,88.8851725607158,7
0.05,4694,92,417319,88.88583599574015,9
0.05,4695,95,417414,88.88713798977854,6
0.05,4696,96,417510,88.88865233127528,7
0.05,4697,91,417601,88.88910174542359,10
0.05,4698,95,417696,88.89040221323685,6
0.05,4699,94,417790,88.89148936170213,7
0.05,4700,94,417884,88.89257604764944,7
0.05,4701,93,417977,88.89344959591664,8
0.05,4702,95,418072,88.89474803317032,6
0.05,4703,94,418166,88.89583333333333,7
0.05,4704,94,418260,88.89691817215729,7
0.05,4705,93,418353,88.89779005524862,9
0.05,4706,95,418448,88.89908646696409,6
0.05,4707,94,418542,88.9001699235344,7
0.05,4708,94,418636,88.90125291994055,7
0.05,4709,94,418730,88.90233545647558,7
0.05,4710,92,418822,88.90299299511781,9
0.05,4711,95,418917,88.90428692699491,6
0.05,4712,96,419013,88.9057924888606,6
0.05,4713,89,419102,88.90581247348324,13
0.05,4714,95,419197,88.90710498409332,6
0.05,4715,92,419289,88.90776081424936,9
0.05,4716,95,419384,88.90905236379055,7
0.05,4717,96,419480,88.91055532005088,6
0.05,4718,95,419575,88.91184573002755,7
0.05,4719,94,419669,88.91292372881355,7
0.05,4720,94,419763,88.91400127091718,7
0.05,4721,93,419856,88.9148665819568,8
0.05,4722,94,419950,88.91594325640483,7
0.05,4723,95,420045,88.91723116003386,7
0.05,4724,94,420139,88.91830687830688,7
0.05,4725,94,420233,88.91938214134575,7
0.05,4726,95,420328,88.92066850010578,6
0.05,4727,92,420420,88.92131979695432,9
0.05,4728,94,420514,88.92239374074857,7
0.05,4729,95,420609,88.92367864693446,6
0.05,4730,94,420703,88.92475163813147,7
0.05,4731,94,420797,88.92582417582418,7
0.05,4732,26,420823,88.91252905134165,7
0.05,4733,94,420917,88.91360371778623,8
0.05,4734,96,421013,88.91510031678986,6
0.05,4735,94,421107,88.91617398648648,7
0.05,4736,95,421202,88.91745830694532,6
0.05,4737,91,421293,88.9178978471929,10
0.05,4738,95,421388,88.9191812618696,7
0.05,4739,95,421483,88.92046413502109,6
0.05,4740,95,421578,88.92174646699009,6
0.05,4741,96,421674,88.92323913960354,6
0.05,4742,90,421764,88.92346616065781,11
0.05,4743,92,421856,88.92411467116358,9
0.05,4744,95,421951,88.92539515279242,6
0.05,4745,96,422047,88.92688579856721,6
0.05,4746,93,422140,88.92774383821362,8
0.05,4747,95,422235,88.92902274641955,6
0.05,4748,93,422328,88.92987997473152,8
0.05,4749,95,422423,88.93115789473684,6
0.05,4750,96,422519,88.93264575878763,6
0.05,4751,94,422613,88.93371212121212,7
0.05,4752,94,422707,88.93477803492532,7
0.05,4753,93,422800,88.93563315103071,8
0.05,4754,93,422893,88.93648790746583,8
0.05,4755,95,422988,88.93776282590412,6
0.05,4756,94,423082,88.93882699180156,8
0.05,4757,93,423175,88.93968053804119,8
0.05,4758,94,423269,88.94074385375079,7
0.05,4759,92,423361,88.94138655462184,9
0.05,4760,96,423457,88.94286914513758,6
0.05,4761,93,423550,88.94372112557748,8
0.05,4762,92,423642,88.94436279655679,9
0.05,4763,96,423738,88.94584382871537,6
0.05,4764,93,423831,88.94669464847848,8
0.05,4765,91,423922,88.947125472094,10
0.05,4766,94,424016,88.94818544157751,7
0.05,4767,94,424110,88.94924496644295,7
0.05,4768,90,424200,88.9494652967079,11
0.05,4769,96,424296,88.95094339622642,6
0.05,4770,95,424391,88.95221127646195,6
0.05,4771,95,424486,88.95347862531433,6
0.05,4772,27,424513,88.94049863817305,6
0.05,4773,27,424540,88.92752408881441,6
0.05,4774,94,424634,88.92858638743455,7
0.05,4775,95,424729,88.92985762144053,6
0.05,4776,93,424822,88.9307096504082,8
0.05,4777,25,424847,88.9173294265383,8
0.05,4778,94,424941,88.91839296924043,7
0.05,4779,95,425036,88.91966527196652,6
0.05,4780,96,425132,88.92114620372307,6
0.05,4781,95,425227,88.922417398578,6
0.05,4782,95,425322,88.92368806188584,7
0.05,4783,96,425418,88.92516722408027,6
0.05,4784,93,425511,88.92601880877743,8
0.05,4785,27,425538,88.91307981613038,6
0.05,4786,90,425628,88.91330687278045,11
0.05,4787,93,425721,88.9141604010025,8
0.05,4788,95,425816,88.91543119649197,7
0.05,4789,92,425908,88.9160751565762,10
0.05,4790,92,426000,88.9167188478397,9
0.05,4791,96,426096,88.91819699499165,6
0.05,4792,95,426191,88.91946588775298,7
0.05,4793,92,426283,88.92010846891948,9
0.05,4794,94,426377,88.92116788321168,8
0.05,4795,93,426470,88.92201834862385,8
0.05,4796,94,426564,88.92307692307692,7
0.05,4797,95,426659,88.92434347644853,6
0.05,4798,21,426680,88.91018962283809,11
0.05,4799,92,426772,88.91083333333333,9
0.05,4800,94,426866,88.91189335555093,7
0.05,4801,27,426893,88.89900041649312,6
0.05,4802,94,426987,88.9000624609619,7
0.05,4803,96,427083,88.90154038301415,6
0.05,4804,92,427175,88.90218522372528,9
0.05,4805,92,427267,88.90282979608823,9
0.05,4806,92,427359,88.90347410027044,9
0.05,4807,94,427453,88.90453410981698,7
0.05,4808,96,427549,88.90600956539821,6
0.05,4809,93,427642,88.90686070686071,8
0.05,4810,94,427736,88.90791935148617,8
0.05,4811,94,427830,88.90897755610973,7
0.05,4812,94,427924,88.91003532100561,7
0.05,4813,96,428020,88.911508101371,6
0.05,4814,91,428111,88.91194184839044,10
0.05,4815,94,428205,88.91299833887044,7
0.05,4816,94,428299,88.9140543906996,7
0.05,4817,89,428388,88.91407222914073,12
0.05,4818,96,428484,88.91554264370201,6
0.05,4819,95,428579,88.91680497925311,6
0.05,4820,93,428672,88.91765193943165,8
0.05,4821,94,428766,88.9187059311489,7
0.05,4822,96,428862,88.92017416545718,6
0.05,4823,93,428955,88.92101990049751,8
0.05,4824,92,429047,88.92165803108809,10
0.05,4825,96,429143,88.92312474098632,6
0.05,4826,93,429236,88.92396933913403,8
0.05,4827,94,429330,88.92502071251036,7
0.05,4828,94,429424,88.92607165044522,8
0.05,4829,95,429519,88.92732919254658,7
0.05,4830,94,429613,88.9283792175533,7
0.05,4831,93,429706,88.92922185430463,8
0.05,4832,92,429798,88.9298572315332,9
0.05,4833,94,429892,88.93090608191973,7
0.05,4834,94,429986,88.93195449844882,7
0.05,4835,96,430082,88.93341604631927,6
0.05,4836,94,430176,88.93446351044035,8
0.05,4837,90,430266,88.9346837536172,11
0.05,4838,94,430360,88.9357305228353,7
0.05,4839,91,430451,88.93615702479339,10
0.05,4840,94,430545,88.93720305721958,7
0.05,4841,92,430637,88.93783560512185,9
0.05,4842,96,430733,88.93929382614083,6
0.05,4843,94,430827,88.94033856317094,9
0.05,4844,94,430921,88.94138286893705,7
0.05,4845,96,431017,88.9428394552208,6
0.05,4846,94,431111,88.94388281411182,7
0.05,4847,94,431205,88.94492574257426,7
0.05,4848,93,431298,88.94576201278615,8
0.05,4849,94,431392,88.94680412371135,7
0.05,4850,94,431486,88.94784580498866,7
0.05,4851,95,431581,88.94909315746084,6
0.05,4852,92,431673,88.94972182155368,10
0.05,4853,94,431767,88.9507622579316,7
0.05,4854,94,431861,88.95180226570545,7
0.05,4855,94,431955,88.95284184514003,7
0.05,4856,95,432050,88.95408688490838,6
0.05,4857,90,432140,88.95430218196789,11
0.05,4858,94,432234,88.95534060506277,7
0.05,4859,92,432326,88.9559670781893,9
0.05,4860,96,432422,88.95741616951244,6
0.05,4861,95,432517,88.95865898807075,6
0.05,4862,96,432613,88.96010692987868,6
0.05,4863,94,432707,88.96114309210526,7
0.05,4864,94,432801,88.96217882836588,7
0.05,4865,90,432891,88.96239210850801,11
0.05,4866,92,432983,88.96301623176495,9
0.05,4867,95,433078,88.96425636811833,7
0.05,4868,93,433171,88.96508523310742,8
0.05,4869,92,433263,88.96570841889117,9
0.05,4870,96,433359,88.96715253541367,6
0.05,4871,94,433453,88.9681855500821,7
0.05,4872,93,433546,88.96901292838088,8
0.05,4873,94,433640,88.9700451374641,7
0.05,4874,94,433734,88.97107692307692,8
0.05,4875,95,433829,88.97231337161608,7
0.05,4876,94,433923,88.97334426901784,7
0.05,4877,95,434018,88.97457974579746,6
0.05,4878,95,434113,88.97581471613036,6
0.05,4879,92,434205,88.9764344262295,9
0.05,4880,88,434293,88.97623437820118,13
0.05,4881,94,434387,88.97726341663252,7
0.05,4882,95,434482,88.97849682572189,7
0.05,4883,93,434575,88.97932022932022,8
0.05,4884,94,434669,88.98034800409417,7
0.05,4885,94,434763,88.98137535816619,7
0.05,4886,96,434859,88.9828115408226,6
0.05,4887,94,434953,88.9838379705401,7
0.05,4888,95,435048,88.98506852116998,7
0.05,4889,95,435143,88.98629856850715,7
0.05,4890,94,435237,88.98732365569413,7
0.05,4891,94,435331,88.98834832379394,7
0.05,4892,94,435425,88.98937257306356,7
0.05,4893,94,435519,88.9903964037597,7
0.05,4894,92,435611,88.99101123595506,9
0.05,4895,94,435705,88.99203431372548,7
0.05,4896,96,435801,88.99346538697162,6
0.05,4897,96,435897,88.9948958758677,6
0.05,4898,96,435993,88.99632578077158,6
0.05,4899,93,436086,88.99714285714286,8
0.05,4900,94,436180,88.99816364007346,7
0.05,4901,95,436275,88.99938800489596,6
0.05,4902,94,436369,89.00040791352234,7
0.05,4903,96,436465,89.0018352365416,6
0.05,4904,90,436555,89.00203873598369,11
0.05,4905,92,436647,89.00264981655116,9
0.05,4906,92,436739,89.0032606480538,9
0.05,4907,94,436833,89.00427872860635,7
0.05,4908,91,436924,89.00468527194948,10
0.05,4909,93,437017,89.00549898167006,8
0.05,4910,94,437111,89.00651598452454,7
0.05,4911,93,437204,89.00732899022802,8
0.05,4912,93,437297,89.00814166497048,8
0.05,4913,94,437391,89.0091575091575,7
0.05,4914,91,437482,89.00956256358087,12
0.05,4915,96,437578,89.01098454027665,6
0.05,4916,93,437671,89.01179581045353,8
0.05,4917,91,437762,89.01220008133387,10
0.05,4918,96,437858,89.0136206546046,6
0.05,4919,92,437950,89.01422764227642,9
0.05,4920,94,438044,89.0152408047145,7
0.05,4921,94,438138,89.01625355546525,7
0.05,4922,94,438232,89.01726589477961,8
0.05,4923,93,438325,89.018074735987,9
0.05,4924,94,438419,89.01908629441624,7
0.05,4925,94,438513,89.02009744214372,7
0.05,4926,23,438536,89.00669778770043,10
0.05,4927,94,438630,89.00771103896103,7
0.05,4928,96,438726,89.0091296409008,6
0.05,4929,93,438819,89.00993914807302,8
0.05,4930,96,438915,89.01135672277428,6
0.05,4931,95,439010,89.0125709651257,6
0.05,4932,95,439105,89.01378471518346,6
0.05,4933,94,439199,89.01479529793271,7
0.05,4934,95,439294,89.0160081053698,7
0.05,4935,95,439389,89.01722042139384,6
0.05,4936,94,439483,89.01822969414624,7
0.05,4937,94,439577,89.01923855812069,7
0.05,4938,94,439671,89.0202470135655,7
0.05,4939,93,439764,89.02105263157895,8
0.05,4940,96,439860,89.02246508803886,6
0.05,4941,94,439954,89.02347227842978,7
0.05,4942,95,440049,89.02468136759053,6
0.05,4943,92,440141,89.02528317152104,9
0.05,4944,95,440236,89.02649140546006,7
0.05,4945,92,440328,89.02709260008088,9
0.05,4946,93,440421,89.02789569436023,8
0.05,4947,92,440513,89.02849636216654,9
0.05,4948,94,440607,89.0295009092746,7
0.05,4949,93,440700,89.03030303030303,8
0.05,4950,94,440794,89.03130680670571,7
0.05,4951,94,440888,89.03231017770598,8
0.05,4952,96,440984,89.03371693922875,6
0.05,4953,95,441079,89.03492127573678,6
0.05,4954,94,441173,89.03592330978809,8
0.05,4955,94,441267,89.03692493946731,7
0.05,4956,96,441363,89.03832963485979,6
0.05,4957,96,441459,89.03973376361436,6
0.05,4958,94,441553,89.04073401895543,7
0.05,4959,94,441647,89.04173387096775,8
0.05,4960,94,441741,89.04273331989518,7
0.05,4961,93,441834,89.043530834341,8
0.05,4962,92,441926,89.04412653636913,10
0.05,4963,95,442021,89.04532634971797,6
0.05,4964,94,442115,89.04632426988923,8
0.05,4965,90,442205,89.04651631091421,11
0.05,4966,90,442295,89.04670827461244,11
0.05,4967,93,442388,89.0475040257649,9
0.05,4968,94,442482,89.04850070436707,7
0.05,4969,95,442577,89.04969818913482,7
0.05,4970,93,442670,89.05049285857976,8
0.05,4971,94,442764,89.05148833467418,7
0.05,4972,90,442854,89.0516790669616,11
0.05,4973,95,442949,89.05287494973864,6
0.05,4974,96,443045,89.05427135678391,6
0.05,4975,95,443140,89.05546623794213,6
0.05,4976,94,443234,89.05645971468756,7
0.05,4977,96,443330,89.05785456006429,6
0.05,4978,96,443426,89.05924884514963,6
0.05,4979,93,443519,89.06004016064257,8
0.05,4980,92,443611,89.06063039550291,9
0.05,4981,96,443707,89.06202328382176,6
0.05,4982,94,443801,89.06301424844472,7
0.05,4983,94,443895,89.0640048154093,7
0.05,4984,94,443989,89.06499498495486,8
0.05,4985,95,444084,89.0661853188929,6
0.05,4986,94,444178,89.06717465410067,7
0.05,4987,94,444272,89.0681635926223,7
0.05,4988,91,444363,89.06855081178593,10
0.05,4989,93,444456,89.06933867735471,8
0.05,4990,26,444482,89.05670206371468,8
0.05,4991,94,444576,89.0576923076923,7
0.05,4992,94,444670,89.05868215501702,7
0.05,4993,96,444766,89.06007208650381,6
0.05,4994,93,444859,89.06086086086086,8
0.05,4995,93,444952,89.06164931945557,8
0.05,4996,94,445046,89.06263758254953,7
0.05,4997,93,445139,89.06342537014805,8
0.05,4998,91,445230,89.06381276255252,10
0.05,4999,96,445326,89.0652,6
0.05,5000,95,445421,89.06638672265547,6
0.05,5001,27,445448,89.05397840863654,6
0.05,5002,91,445539,89.05436737957226,10
0.05,5003,93,445632,89.05515587529976,8
0.05,5004,96,445728,89.05654345654345,6
0.05,5005,96,445824,89.0579304834199,6
0.05,5006,21,445845,89.04433792690233,11
0.05,5007,92,445937,89.04492811501598,9
0.05,5008,96,446033,89.04631663006589,6
0.05,5009,96,446129,89.04770459081837,6
0.05,5010,94,446223,89.04869287567352,7
0.05,5011,96,446319,89.0500798084597,6
0.05,5012,95,446414,89.05126670656294,6
0.05,5013,96,446510,89.05265257279618,6
0.05,5014,95,446605,89.05383848454636,6
0.05,5015,25,446630,89.04106858054226,7
0.05,5016,93,446723,89.04185768387482,8
0.05,5017,94,446817,89.042845755281,8
0.05,5018,94,446911,89.04383343295477,8
0.05,5019,92,447003,89.04442231075697,9
0.05,5020,95,447098,89.04560844453296,7
0.05,5021,92,447190,89.04619673436878,9
0.05,5022,94,447284,89.0471829583914,7
0.05,5023,93,447377,89.04796974522293,8
0.05,5024,95,447472,89.04915422885573,6
0.05,5025,94,447566,89.05013927576601,7
0.05,5026,94,447660,89.05112393077383,7
0.05,5027,93,447753,89.05190930787589,8
0.05,5028,94,447847,89.0528932193279,7
0.05,5029,96,447943,89.05427435387674,6
0.05,5030,95,448038,89.05545617173524,6
0.05,5031,95,448133,89.05663751987281,7
0.05,5032,94,448227,89.05761970991456,7
0.05,5033,95,448322,89.05880015891935,6
0.05,5034,94,448416,89.05978152929494,7
0.05,5035,96,448512,89.06115965051629,6
0.05,5036,94,448606,89.06214016279532,7
0.05,5037,94,448700,89.06312028582771,7
0.05,5038,94,448794,89.06410001984521,8
0.05,5039,95,448889,89.06527777777778,7
0.05,5040,93,448982,89.06605832176156,8
0.05,5041,92,449074,89.06664022213407,9
0.05,5042,90,449164,89.06682530239937,12
0.05,5043,96,449260,89.06819984139572,6
0.05,5044,93,449353,89.06897918731417,8
0.05,5045,92,449445,89.06956004756242,9
0.05,5046,96,449541,89.07093322765999,6
0.05,5047,92,449633,89.07151347068145,10
0.05,5048,95,449728,89.07268766092295,6
0.05,5049,95,449823,89.07386138613862,7
0.05,5050,95,449918,89.07503464660464,7
0.05,5051,94,450012,89.07600950118764,7
0.05,5052,96,450108,89.07737977439145,6
0.05,5053,96,450204,89.0787495053423,6
0.05,5054,96,450300,89.08011869436201,6
0.05,5055,95,450395,89.08128955696202,6
0.05,5056,91,450486,89.08166897369982,10
0.05,5057,95,450581,89.08283906682483,6
0.05,5058,95,450676,89.08400869737102,6
0.05,5059,92,450768,89.08458498023715,9
0.05,5060,91,450859,89.0849634459593,10
0.05,5061,93,450952,89.08573686290003,8
0.05,5062,95,451047,89.08690499703732,6
0.05,5063,89,451136,89.086887835703,12
0.05,5064,94,451230,89.08785784797631,7
0.05,5065,94,451324,89.08882747729965,7
0.05,5066,94,451418,89.08979672389974,7
0.05,5067,94,451512,89.09076558800315,7
0.05,5068,96,451608,89.09212862497535,6
0.05,5069,94,451702,89.0930966469428,7
0.05,5070,95,451797,89.09426148688621,6
0.05,5071,87,451884,89.09384858044164,14
0.05,5072,94,451978,89.09481569091267,7
0.05,5073,92,452070,89.09538825384313,9
0.05,5074,96,452166,89.0967487684729,7
0.05,5075,96,452262,89.09810874704492,6
0.05,5076,96,452358,89.0994681898759,6
0.05,5077,94,452452,89.10043324143363,7
0.05,5078,94,452546,89.10139791297499,7
0.05,5079,91,452637,89.10177165354331,10
0.05,5080,90,452727,89.10194843534737,11
0.05,5081,96,452823,89.10330578512396,6
0.05,5082,93,452916,89.10407239819004,8
0.05,5083,92,453008,89.10464201416208,9
0.05,5084,92,453100,89.10521140609636,9
0.05,5085,96,453196,89.10656704679512,6
0.05,5086,90,453286,89.10674267741301,11
0.05,5087,95,453381,89.10790094339623,6
0.05,5088,94,453475,89.1088622519159,7
0.05,5089,94,453569,89.1098231827112,7
0.05,5090,94,453663,89.11078373600472,7
0.05,5091,92,453755,89.11135113904163,9
0.05,5092,27,453782,89.09915570390733,6
0.05,5093,94,453876,89.10011778563015,7
0.05,5094,93,453969,89.100883218842,8
0.05,5095,96,454065,89.10223704866561,6
0.05,5096,93,454158,89.10300176574455,8
0.05,5097,93,454251,89.10376618281678,8
0.05,5098,93,454344,89.10453030005884,8
0.05,5099,96,454440,89.10588235294118,6
0.05,5100,94,454534,89.10684179572633,7
0.05,5101,94,454628,89.1078008624069,7
0.05,5102,94,454722,89.108759553204,7
0.05,5103,95,454817,89.10991379310344,6
0.05,5104,93,454910,89.11067580803135,8
0.05,5105,96,455006,89.11202506854681,6
0.05,5106,96,455102,89.11337380066576,6
0.05,5107,91,455193,89.11374314800314,10
0.05,5108,93,455286,89.1145038167939,8
0.05,5109,92,455378,89.11506849315069,9
0.05,5110,93,455471,89.11582860496968,8
0.05,5111,94,455565,89.11678403755869,7
0.05,5112,93,455658,89.1175435165265,8
0.05,5113,92,455750,89.11810715682441,9
0.05,5114,88,455838,89.11788856304986,13
0.05,5115,95,455933,89.1190383111806,6
0.05,5116,95,456028,89.1201876099277,6
0.05,5117,96,456124,89.12153184837827,6
0.05,5118,94,456218,89.12248486032428,7
0.05,5119,93,456311,89.1232421875,8
0.05,5120,96,456407,89.12458504198399,6
0.05,5121,94,456501,89.12553689964858,7
0.05,5122,96,456597,89.1268787819637,6
0.05,5123,96,456693,89.12822014051523,6
0.05,5124,95,456788,89.12936585365854,6
0.05,5125,94,456882,89.13031603589543,7
0.05,5126,95,456977,89.13146089330992,6
0.05,5127,94,457071,89.13241029641186,7
0.05,5128,96,457167,89.13374926886333,6
0.05,5129,96,457263,89.13508771929824,6
0.05,5130,94,457357,89.13603586045605,7
0.05,5131,91,457448,89.13639906469213,10
0.05,5132,96,457544,89.13773621663745,6
0.05,5133,94,457638,89.13868328788469,7
0.05,5134,25,457663,89.12619279454722,8
0.05,5135,96,457759,89.12753115264798,6
0.05,5136,93,457852,89.12828499124002,8
0.05,5137,94,457946,89.1292331646555,7
0.05,5138,95,458041,89.13037555944736,6
0.05,5139,95,458136,89.13151750972763,6
0.05,5140,91,458227,89.13188095701226,10
0.05,5141,95,458322,89.13302217036173,6
0.05,5142,92,458414,89.13357962278826,9
0.05,5143,94,458508,89.13452566096423,7
0.05,5144,93,458601,89.13527696793003,8
0.05,5145,95,458696,89.13641663427906,8
0.05,5146,94,458790,89.13736156984652,7
0.05,5147,95,458885,89.13850038850039,6
0.05,5148,95,458980,89.1396387648087,6
0.05,5149,94,459074,89.14058252427185,7
0.05,5150,94,459168,89.14152591729761,8
0.05,5151,96,459264,89.14285714285714,6
0.05,5152,96,459360,89.14418785173686,6
0.05,5153,92,459452,89.14474194800155,9
0.05,5154,92,459544,89.14529582929195,9
0.05,5155,95,459639,89.14643134212568,7
0.05,5156,94,459733,89.14737250339344,8
0.05,5157,90,459823,89.14753780535091,12
0.05,5158,93,459916,89.14828455126963,8
0.05,5159,94,460010,89.14922480620154,8
0.05,5160,94,460104,89.1501646967642,7
0.05,5161,92,460196,89.15071677644323,9
0.05,5162,94,460290,89.15165601394538,7
0.05,5163,93,460383,89.15240123934935,8
0.05,5164,95,460478,89.15353339787028,7
0.05,5165,91,460569,89.15389082462254,10
0.05,5166,96,460665,89.15521579252952,6
0.05,5167,96,460761,89.15654024767802,6
0.05,5168,93,460854,89.15728380731282,8
0.05,5169,94,460948,89.15822050290136,8
0.05,5170,96,461044,89.15954360858635,6
0.05,5171,94,461138,89.16047950502707,7
0.05,5172,95,461233,89.16160835105354,6
0.05,5173,93,461326,89.16235021260147,8
0.05,5174,94,461420,89.16328502415459,7
0.05,5175,91,461511,89.16363987635239,10
0.05,5176,94,461605,89.16457407765115,8
0.05,5177,95,461700,89.16570104287369,6
0.05,5178,91,461791,89.16605522301603,11
0.05,5179,94,461885,89.16698841698842,7
0.05,5180,96,461981,89.16830727658753,6
0.05,5181,17,461998,89.15438054805095,15
0.05,5182,91,462089,89.15473663901216,10
0.05,5183,95,462184,89.15586419753086,6
0.05,5184,92,462276,89.15641272902603,9
0.05,5185,96,462372,89.157732356344,6
0.05,5186,94,462466,89.158665895508,7
0.05,5187,94,462560,89.15959907478798,8
0.05,5188,93,462653,89.16033917903258,8
0.05,5189,94,462747,89.16127167630057,7
0.05,5190,89,462836,89.1612406087459,12
0.05,5191,94,462930,89.16217257318952,7
0.05,5192,96,463026,89.1634893125361,6
0.05,5193,95,463121,89.16461301501732,6
0.05,5194,91,463212,89.16496631376323,10
0.05,5195,94,463306,89.16589684372595,8
0.05,5196,96,463402,89.16721185299211,6
0.05,5197,84,463486,89.16621777606773,18
0.05,5198,95,463581,89.16733987305251,6
0.05,5199,92,463673,89.16788461538462,9
0.05,5200,95,463768,89.16900596039223,6
0.05,5201,95,463863,89.17012687427912,6
0.05,5202,95,463958,89.17124735729386,6
0.05,5203,90,464048,89.17140661029977,11
0.05,5204,96,464144,89.17271853986551,6
0.05,5205,93,464237,89.17345370726085,8
0.05,5206,94,464331,89.17438064144422,7
0.05,5207,94,464425,89.17530721966206,7
0.05,5208,96,464521,89.1766173929737,6
0.05,5209,90,464611,89.1767754318618,11
0.05,5210,96,464707,89.17808482057187,6
0.05,5211,92,464799,89.17862624712203,9
0.05,5212,95,464894,89.17974295031652,7
0.05,5213,94,464988,89.18066743383199,7
0.05,5214,94,465082,89.18159156279961,7
0.05,5215,96,465178,89.18289877300613,6
0.05,5216,94,465272,89.18382211999233,7
0.05,5217,91,465363,89.18417018014566,10
0.05,5218,94,465457,89.18509292968001,7
0.05,5219,96,465553,89.18639846743295,6
0.05,5220,94,465647,89.18732043669795,7
0.05,5221,94,465741,89.18824205285331,8
0.05,5222,94,465835,89.18916331610185,7
0.05,5223,94,465929,89.19008422664625,7
0.05,5224,94,466023,89.191004784689,7
0.05,5225,94,466117,89.19192499043245,7
0.05,5226,92,466209,89.19246221541994,9
0.05,5227,96,466305,89.19376434583015,6
0.05,5228,94,466399,89.19468349588831,7
0.05,5229,95,466494,89.19579349904397,6
0.05,5230,94,466588,89.19671190976868,7
0.05,5231,94,466682,89.19762996941895,7
0.05,5232,90,466772,89.19778329829926,11
0.05,5233,93,466865,89.19850974398166,9
0.05,5234,95,466960,89.19961795606494,6
0.05,5235,94,467054,89.20053475935829,7
0.05,5236,90,467144,89.2006874164598,11
0.05,5237,92,467236,89.2012218403971,9
0.05,5238,91,467327,89.20156518419546,10
0.05,5239,96,467423,89.20286259541984,6
0.05,5240,94,467517,89.20377790497997,7
0.05,5241,96,467613,89.20507439908432,6
0.05,5242,95,467708,89.20617966812894,7
0.05,5243,94,467802,89.2070938215103,7
0.05,5244,94,467896,89.20800762631077,7
0.05,5245,94,467990,89.2089210827297,8
0.05,5246,90,468080,89.20907185058128,11
0.05,5247,94,468174,89.20998475609755,8
0.05,5248,25,468199,89.19775195275291,8
0.05,5249,95,468294,89.19885714285714,6
0.05,5250,95,468389,89.19996191201676,6
0.05,5251,96,468485,89.20125666412795,6
0.05,5252,94,468579,89.20217018846374,7
0.05,5253,96,468675,89.20346402740769,6
0.05,5254,94,468769,89.20437678401522,7
0.05,5255,92,468861,89.20490867579909,9
0.05,5256,95,468956,89.2060110329085,6
0.05,5257,90,469046,89.20616203879803,11
0.05,5258,94,469140,89.20707358813462,7
0.05,5259,94,469234,89.20798479087452,7
0.05,5260,94,469328,89.20889564721536,8
0.05,5261,94,469422,89.20980615735462,7
0.05,5262,96,469518,89.21109633288998,6
0.05,5263,95,469613,89.21219604863222,6
0.05,5264,92,469705,89.21272554605888,9
0.05,5265,92,469797,89.21325484238511,10
0.05,5266,94,469891,89.21416366052782,7
0.05,5267,94,469985,89.21507213363705,7
0.05,5268,95,470080,89.21617005124313,6
0.05,5269,92,470172,89.21669829222012,9
0.05,5270,91,470263,89.21703661544299,10
0.05,5271,93,470356,89.21775417298937,8
0.05,5272,93,470449,89.21847145837285,8
0.05,5273,94,470543,89.21937808115283,7
0.05,5274,93,470636,89.22009478672986,8
0.05,5275,93,470729,89.22081122062168,8
0.05,5276,22,470751,89.20807276861854,10
0.05,5277,95,470846,89.20917014020462,6
0.05,5278,95,470941,89.21026709604092,6
0.05,5279,94,471035,89.21117424242425,7
0.05,5280,95,471130,89.2122704033327,7
0.05,5281,95,471225,89.21336614918592,6
0.05,5282,93,471318,89.21408290743895,8
0.05,5283,94,471412,89.21498864496594,7
0.05,5284,94,471506,89.2158940397351,7
0.05,5285,96,471602,89.21717744986758,6
0.05,5286,96,471698,89.2184603745035,6
0.05,5287,93,471791,89.21917549167928,8
0.05,5288,94,471885,89.22007941009643,7
0.05,5289,94,471979,89.22098298676748,7
0.05,5290,93,472072,89.22169722169723,9
0.05,5291,96,472168,89.22297808012094,6
0.05,5292,23,472191,89.21046665407141,9
0.05,5293,94,472285,89.21137136380808,7
0.05,5294,93,472378,89.21208687440982,8
0.05,5295,94,472472,89.2129909365559,7
0.05,5296,95,472567,89.21408344345856,6
0.05,5297,91,472658,89.21442053605134,10
0.05,5298,96,472754,89.21570107567466,6
0.05,5299,94,472848,89.21660377358491,7
0.05,5300,93,472941,89.21731748726656,8
0.05,5301,94,473035,89.21821953979631,8
0.05,5302,96,473131,89.21949839713369,6
0.05,5303,91,473222,89.21983408748115,10
0.05,5304,94,473316,89.22073515551367,8
0.05,5305,94,473410,89.22163588390501,7
0.05,5306,93,473503,89.2223478424722,8
0.05,5307,94,473597,89.22324792765637,7
0.05,5308,93,473690,89.22395931437183,8
0.05,5309,95,473785,89.22504708097928,6
0.05,5310,90,473875,89.22519299566936,12
0.05,5311,96,473971,89.22646837349397,6
0.05,5312,90,474061,89.2266139657444,11
0.05,5313,95,474156,89.22770041400075,6
0.05,5314,94,474250,89.2285983066792,7
0.05,5315,96,474346,89.2298720842739,6
0.05,5316,94,474440,89.23076923076923,7
0.05,5317,95,474535,89.23185408048138,6
0.05,5318,96,474631,89.23312652754277,6
0.05,5319,95,474726,89.23421052631579,6
0.05,5320,94,474820,89.2351061830483,7
0.05,5321,96,474916,89.23637730176625,6
0.05,5322,94,475010,89.2372722149164,7
0.05,5323,92,475102,89.23779113448535,9
0.05,5324,96,475198,89.23906103286384,6
0.05,5325,96,475294,89.24033045437477,6
0.05,5326,92,475386,89.24084850760278,9
0.05,5327,94,475480,89.24174174174175,7
0.05,5328,96,475576,89.24300994558078,6
0.05,5329,95,475671,89.24409005628517,6
0.05,5330,93,475764,89.24479459763647,8
0.05,5331,95,475859,89.24587396849212,6
0.05,5332,96,475955,89.2471404462779,6
0.05,5333,95,476050,89.24821897262842,6
0.05,5334,94,476144,89.24910965323336,7
0.05,5335,95,476239,89.25018740629685,6
0.05,5336,94,476333,89.2510773842983,7
0.05,5337,92,476425,89.2515923566879,10
0.05,5338,96,476521,89.2528563401386,6
0.05,5339,92,476613,89.25337078651685,9
0.05,5340,95,476708,89.25444673282156,6
0.05,5341,94,476802,89.25533508049419,7
0.05,5342,96,476898,89.25659741718135,6
0.05,5343,95,476993,89.25767215568862,6
0.05,5344,95,477088,89.25874649204864,6
0.05,5345,92,477180,89.25925925925925,10
0.05,5346,95,477275,89.26033289695157,6
0.05,5347,92,477367,89.26084517576665,9
0.05,5348,94,477461,89.26173116470369,7
0.05,5349,95,477556,89.26280373831776,6
0.05,5350,95,477651,89.26387591104466,7
0.05,5351,96,477747,89.26513452914799,6
0.05,5352,93,477840,89.26583224360172,8
0.05,5353,86,477926,89.26522226372805,15
0.05,5354,92,478018,89.26573295985061,9
0.05,5355,96,478114,89.26699029126213,6
0.05,5356,91,478205,89.26731379503454,10
0.05,5357,94,478299,89.26819708846584,7
0.05,5358,94,478393,89.26908005224855,7
0.05,5359,96,478489,89.27033582089553,6
0.05,5360,94,478583,89.27121805633277,7
0.05,5361,95,478678,89.27228646027602,6
0.05,5362,94,478772,89.27316800298341,7
0.05,5363,94,478866,89.27404921700224,8
0.05,5364,25,478891,89.26206896551724,8
0.05,5365,93,478984,89.26276556093924,8
0.05,5366,95,479079,89.26383454443824,6
0.05,5367,94,479173,89.26471684053651,7
0.05,5368,96,479269,89.26597131681878,6
0.05,5369,95,479364,89.26703910614525,6
0.05,5370,94,479458,89.26792031279092,7
0.05,5371,94,479552,89.26880119136263,7
0.05,5372,95,479647,89.26986785780755,7
0.05,5373,95,479742,89.27093412727949,6
0.05,5374,96,479838,89.27218604651162,6
0.05,5375,96,479934,89.2734375,6
0.05,5376,92,480026,89.27394457876139,9
0.05,5377,93,480119,89.2746374116772,8
0.05,5378,96,480215,89.27588771147053,6
0.05,5379,90,480305,89.27602230483271,11
0.05,5380,94,480399,89.27690020442297,7
0.05,5381,92,480491,89.27740616871051,10
0.05,5382,93,480584,89.27809771502879,8
0.05,5383,95,480679,89.27916047548291,7
0.05,5384,95,480774,89.28022284122562,6
0.05,5385,94,480868,89.28109914593391,7
0.05,5386,94,480962,89.28197512530166,7
0.05,5387,95,481057,89.28303637713437,6
0.05,5388,94,481151,89.28391167192429,7
0.05,5389,94,481245,89.2847866419295,8
0.05,5390,27,481272,89.27323316638842,6
0.05,5391,88,481360,89.27299703264094,13
0.05,5392,95,481455,89.27405896532542,6
0.05,5393,94,481549,89.27493511308862,7
0.05,5394,94,481643,89.2758109360519,8
0.05,5395,94,481737,89.27668643439584,8
0.05,5396,94,481831,89.27756160830091,8
0.05,5397,92,481923,89.27806595035199,9
0.05,5398,93,482016,89.2787553250602,9
0.05,5399,94,482110,89.27962962962962,8
0.05,5400,94,482204,89.28050361044251,7
0.05,5401,92,482296,89.2810070344317,9
0.05,5402,90,482386,89.28114010734777,13
0.05,5403,93,482479,89.28182827535159,8
0.05,5404,94,482573,89.28270120259019,7
0.05,5405,92,482665,89.28320384757677,9
0.05,5406,94,482759,89.28407619752173,8
0.05,5407,94,482853,89.28494822485207,7
0.05,5408,93,482946,89.28563505268995,8
0.05,5409,92,483038,89.28613678373382,9
0.05,5410,94,483132,89.28700794677509,7
0.05,5411,94,483226,89.28787878787878,7
0.05,5412,94,483320,89.28874930722336,8
0.05,5413,95,483415,89.28980421130403,6
0.05,5414,23,483438,89.27756232686981,10
0.05,5415,96,483534,89.2788035450517,6
0.05,5416,94,483628,89.27967509691712,7
0.05,5417,96,483724,89.28091546696197,6
0.05,5418,95,483819,89.28197084332903,6
0.05,5419,95,483914,89.2830258302583,7
0.05,5420,95,484009,89.28408042796532,6
0.05,5421,95,484104,89.28513463666543,6
0.05,5422,89,484193,89.28508205790153,12
0.05,5423,93,484286,89.28576696165192,8
0.05,5424,95,484381,89.28682027649769,6
0.05,5425,27,484408,89.27534095097678,6
0.05,5426,93,484501,89.27602727105214,8
0.05,5427,96,484597,89.27726602800294,6
0.05,5428,94,484691,89.27813593663659,7
0.05,5429,96,484787,89.2793738489871,6
0.05,5430,91,484878,89.27969066470263,10
0.05,5431,95,484973,89.28074374079529,6
0.05,5432,92,485065,89.28124424811338,9
0.05,5433,95,485160,89.2822966507177,6
0.05,5434,94,485254,89.28316467341307,7
0.05,5435,96,485350,89.28440029433406,6
0.05,5436,92,485442,89.28489976089756,10
0.05,5437,94,485536,89.28576682603898,7
0.05,5438,93,485629,89.28644971502115,8
0.05,5439,92,485721,89.28694852941176,9
0.05,5440,94,485815,89.28781473993752,7
0.05,5441,94,485909,89.28868063212055,7
0.05,5442,96,486005,89.28991365056035,6
0.05,5443,94,486099,89.2907788390889,7
0.05,5444,92,486191,89.29127640036731,9
0.05,5445,94,486285,89.29214102093279,7
0.05,5446,94,486379,89.29300532403158,8
0.05,5447,94,486473,89.29386930983847,7
0.05,5448,92,486565,89.29436593870435,10
0.05,5449,93,486658,89.29504587155964,9
0.05,5450,95,486753,89.29609246009906,6
0.05,5451,96,486849,89.29732208363903,6
0.05,5452,94,486943,89.29818448560425,7
0.05,5453,93,487036,89.2988632196553,9
0.05,5454,93,487129,89.29954170485793,8
0.05,5455,91,487220,89.29985337243401,10
0.05,5456,95,487315,89.30089792926516,6
0.05,5457,94,487409,89.30175888603884,7
0.05,5458,95,487504,89.30280271111926,6
0.05,5459,96,487600,89.3040293040293,6
0.05,5460,93,487693,89.30470609778429,8
0.05,5461,94,487787,89.30556572683999,7
0.05,5462,95,487882,89.30660809079261,8
0.05,5463,92,487974,89.30710102489019,9
0.05,5464,95,488069,89.30814272644099,6
0.05,5465,94,488163,89.30900109769485,7
0.05,5466,94,488257,89.30985915492958,7
0.05,5467,95,488352,89.31089978054133,7
0.05,5468,93,488445,89.31157432803072,8
0.05,5469,82,488527,89.31023765996343,19
0.05,5470,90,488617,89.31036373606288,11
0.05,5471,94,488711,89.31122076023392,7
0.05,5472,96,488807,89.31244290151653,6
0.05,5473,93,488900,89.31311655096822,8
0.05,5474,94,488994,89.31397260273972,7
0.05,5475,93,489087,89.31464572680788,8
0.05,5476,96,489183,89.31586635019171,6
0.05,5477,95,489278,89.31690397955458,7
0.05,5478,96,489374,89.31812374520898,6
0.05,5479,95,489469,89.31916058394161,7
0.05,5480,90,489559,89.31928480204343,11
0.05,5481,94,489653,89.32013863553448,7
0.05,5482,94,489747,89.32099215757796,7
0.05,5483,91,489838,89.32129832239241,10
0.05,5484,92,489930,89.32178669097539,9
0.05,5485,95,490025,89.322821728035,6
0.05,5486,96,490121,89.32403863677784,6
0.05,5487,93,490214,89.32470845481049,8
0.05,5488,94,490308,89.32556021133175,7
0.05,5489,94,490402,89.3264116575592,7
0.05,5490,26,490428,89.31487889273356,7
0.05,5491,27,490455,89.30353241077931,6
0.05,5492,94,490549,89.3043874021482,8
0.05,5493,92,490641,89.3048780487805,9
0.05,5494,93,490734,89.30555050045496,8
0.05,5495,95,490829,89.3065866084425,6
0.05,5496,96,490925,89.30780425686739,6
0.05,5497,91,491016,89.30811204074209,10
0.05,5498,95,491111,89.30914711765776,6
0.05,5499,94,491205,89.31,7
0.05,5500,94,491299,89.31085257225959,7
0.05,5501,91,491390,89.31115957833515,10
0.05,5502,95,491485,89.31219334908232,6
0.05,5503,96,491581,89.31340843023256,6
0.05,5504,93,491674,89.31407811080835,8
0.05,5505,92,491766,89.31456592807847,9
0.05,5506,94,491860,89.31541674232794,7
0.05,5507,20,491880,89.30283224400871,12
0.05,5508,92,491972,89.30332183699402,9
0.05,5509,93,492065,89.30399274047187,8
0.05,5510,90,492155,89.30411903465796,11
0.05,5511,93,492248,89.30478955007257,8
0.05,5512,92,492340,89.3052784327952,9
0.05,5513,92,492432,89.30576713819369,9
0.05,5514,96,492528,89.30698096101541,6
0.05,5515,27,492555,89.29568527918782,6
0.05,5516,93,492648,89.29635671560631,8
0.05,5517,94,492742,89.2972091337441,7
0.05,5518,94,492836,89.2980612429788,7
0.05,5519,92,492928,89.29855072463768,9
0.05,5520,93,493021,89.29922115558776,8
0.05,5521,96,493117,89.30043462513582,6
0.05,5522,92,493209,89.30092341118957,9
0.05,5523,85,493294,89.30014482259233,16
0.05,5524,96,493390,89.30135746606335,6
0.05,5525,95,493485,89.30238870792617,6
0.05,5526,92,493577,89.30287678668356,9
0.05,5527,94,493671,89.30372648335745,7
0.05,5528,96,493767,89.3049376017363,6
0.05,5529,96,493863,89.30614828209765,6
0.05,5530,92,493955,89.30663532815042,9
0.05,5531,92,494047,89.30712219812003,9
0.05,5532,96,494143,89.30833182721851,6
0.05,5533,94,494237,89.30917961691362,7
0.05,5534,94,494331,89.310027100271,7
0.05,5535,94,494425,89.31087427745665,7
0.05,5536,94,494519,89.31172114863645,7
0.05,5537,95,494614,89.31274828457927,6
0.05,5538,22,494636,89.30059577541073,10
0.05,5539,95,494731,89.30162454873646,6
0.05,5540,92,494823,89.3021115322144,9
0.05,5541,93,494916,89.30277878022375,8
0.05,5542,95,495011,89.3038066029226,6
0.05,5543,94,495105,89.30465367965368,8
0.05,5544,95,495200,89.30568079350766,6
0.05,5545,96,495296,89.306887847097,6
0.05,5546,95,495391,89.30791418784929,6
0.05,5547,94,495485,89.30875991348233,7
0.05,5548,89,495574,89.30870427103983,13
0.05,5549,96,495670,89.3099099099099,6
0.05,5550,90,495760,89.31003422806701,11
0.05,5551,94,495854,89.31087896253602,7
0.05,5552,94,495948,89.31172339276067,8
0.05,5553,94,496042,89.3125675189053,7
0.05,5554,94,496136,89.31341134113411,7
0.05,5555,96,496232,89.31461483081354,6
0.05,5556,95,496327,89.31563793413713,7
0.05,5557,95,496422,89.3166606693055,6
0.05,5558,96,496518,89.31786292498651,6
0.05,5559,96,496614,89.31906474820144,6
0.05,5560,94,496708,89.31990649163819,7
0.05,5561,95,496803,89.32092772384034,7
0.05,5562,92,496895,89.32140931152256,9
0.05,5563,94,496989,89.32225017972682,7
0.05,5564,94,497083,89.32309074573226,7
0.05,5565,91,497174,89.32339202299677,10
0.05,5566,94,497268,89.32423208191126,7
0.05,5567,92,497360,89.32471264367815,10
0.05,5568,96,497456,89.32591129466691,6
0.05,5569,95,497551,89.32692998204668,8
0.05,5570,96,497647,89.32812780470293,6
0.05,5571,95,497742,89.32914572864321,7
0.05,5572,94,497836,89.32998385070877,8
0.05,5573,94,497930,89.3308216720488,7
0.05,5574,93,498023,89.3314798206278,8
0.05,5575,95,498118,89.33249641319942,7
0.05,5576,90,498208,89.33261610184687,11
0.05,5577,90,498298,89.33273574757978,11
0.05,5578,96,498394,89.33393081197347,6
0.05,5579,95,498489,89.33494623655913,6
0.05,5580,94,498583,89.33578211790002,7
0.05,5581,94,498677,89.3366176997492,8
0.05,5582,94,498771,89.33745298226759,7
0.05,5583,94,498865,89.33828796561605,7
0.05,5584,94,498959,89.33912264995524,7
0.05,5585,93,499052,89.33977801646975,8
0.05,5586,96,499148,89.34097010918202,6
0.05,5587,91,499239,89.34126700071582,10
0.05,5588,94,499333,89.34210055466095,7
0.05,5589,94,499427,89.34293381037567,8
0.05,5590,93,499520,89.34358790913969,8
0.05,5591,21,499541,89.33136623748211,12
0.05,5592,94,499635,89.33220096549258,7
0.05,5593,91,499726,89.3324991061852,10
0.05,5594,91,499817,89.33279714030384,11
0.05,5595,24,499841,89.3211222301644,8
0.05,5596,94,499935,89.32195819188851,8
0.05,5597,22,499957,89.30993211861379,10
0.05,5598,89,500046,89.3098767637078,13
0.05,5599,94,500140,89.31071428571428,7
0.05,5600,95,500235,89.31173004820567,7
0.05,5601,93,500328,89.3123884327026,9
0.05,5602,94,500422,89.31322505800465,7
0.05,5603,93,500515,89.3138829407566,8
0.05,5604,93,500608,89.31454058876004,9
0.05,5605,95,500703,89.31555476275419,6
0.05,5606,93,500796,89.31621187800963,8
0.05,5607,92,500888,89.3166904422254,9
0.05,5608,94,500982,89.31752540559815,7
0.05,5609,27,501009,89.30641711229947,6
0.05,5610,96,501105,89.3076100516842,6
0.05,5611,95,501200,89.30862437633643,6
0.05,5612,95,501295,89.30963833956886,6
0.05,5613,94,501389,89.31047381546135,7
0.05,5614,92,501481,89.31095280498664,9
0.05,5615,93,501574,89.31160968660969,8
0.05,5616,89,501663,89.31155421043262,12
0.05,5617,96,501759,89.31274474902101,6
0.05,5618,94,501853,89.31357892863498,7
0.05,5619,94,501947,89.3144128113879,7
0.05,5620,94,502041,89.31524639743817,7
0.05,5621,90,502131,89.3153681963714,11
0.05,5622,90,502221,89.31548995198293,11
0.05,5623,94,502315,89.31632290184922,7
0.05,5624,94,502409,89.31715555555556,7
0.05,5625,95,502504,89.31816565943832,6
0.05,5626,93,502597,89.31881997511995,9
0.05,5627,95,502692,89.31982942430703,6
0.05,5628,94,502786,89.32066086338604,7
0.05,5629,95,502881,89.32166962699823,7
0.05,5630,96,502977,89.32285562067129,6
0.05,5631,93,503070,89.32350852272727,8
0.05,5632,95,503165,89.3245162435647,6
0.05,5633,94,503259,89.32534611288605,7
0.05,5634,94,503353,89.32617568766636,8
0.05,5635,92,503445,89.32665010645849,9
0.05,5636,95,503540,89.32765655490509,6
0.05,5637,94,503634,89.32848527846754,7
0.05,5638,88,503722,89.32824968966129,13
0.05,5639,94,503816,89.3290780141844,8
0.05,5640,96,503912,89.3302605920936,6
0.05,5641,94,504006,89.33108826657214,7
0.05,5642,92,504098,89.33156122629806,9
0.05,5643,95,504193,89.33256555634301,6
0.05,5644,92,504285,89.33303808680247,9
0.05,5645,94,504379,89.33386468296139,7
0.05,5646,94,504473,89.33469098636444,8
0.05,5647,96,504569,89.33587110481587,6
0.05,5648,94,504663,89.33669676048858,7
0.05,5649,94,504757,89.3375221238938,7
0.05,5650,96,504853,89.33870111484693,6
0.05,5651,94,504947,89.33952583156405,7
0.05,5652,91,505038,89.33981956483284,10
0.05,5653,93,505131,89.34046692607004,8
0.05,5654,94,505225,89.34129089301503,7
0.05,5655,91,505316,89.34158415841584,10
0.05,5656,94,505410,89.34240763655647,7
0.05,5657,94,505504,89.34323082361259,7
0.05,5658,94,505598,89.34405371973847,7
0.05,5659,95,505693,89.34505300353356,6
0.05,5660,95,505788,89.34605193428723,6
0.05,5661,94,505882,89.34687389614977,7
0.05,5662,94,505976,89.3476955677203,7
0.05,5663,95,506071,89.34869350282486,7
0.05,5664,94,506165,89.3495145631068,8
0.05,5665,95,506260,89.35051182492057,6
0.05,5666,90,506350,89.3506264337392,11
0.05,5667,93,506443,89.35127028934369,8
0.05,5668,92,506535,89.35173751984478,9
0.05,5669,94,506629,89.35255731922399,8
0.05,5670,94,506723,89.35337682948334,7
0.05,5671,94,506817,89.35419605077574,7
0.05,5672,93,506910,89.35483870967742,9
0.05,5673,94,507004,89.35565738456116,7
0.05,5674,93,507097,89.35629955947137,8
0.05,5675,95,507192,89.35729386892177,6
0.05,5676,95,507287,89.3582878280782,6
0.05,5677,94,507381,89.35910531877421,7
0.05,5678,94,507475,89.3599225215707,7
0.05,5679,93,507568,89.36056338028169,8
0.05,5680,93,507661,89.36120401337793,8
0.05,5681,95,507756,89.36219640971488,6
0.05,5682,94,507850,89.36301249340137,7
0.05,5683,95,507945,89.36400422237861,6
0.05,5684,96,508041,89.36517150395778,6
0.05,5685,95,508136,89.36616250439677,6
0.05,5686,92,508228,89.36662563741868,9
0.05,5687,93,508321,89.36726441631505,8
0.05,5688,95,508416,89.36825452627879,6
0.05,5689,93,508509,89.3688927943761,8
0.05,5690,94,508603,89.3697065542084,7
0.05,5691,94,508697,89.37052002810962,7
0.05,5692,96,508793,89.37168452485508,6
0.05,5693,94,508887,89.37249736564804,7
0.05,5694,96,508983,89.37366110623354,6
0.05,5695,94,509077,89.37447331460675,7
0.05,5696,94,509171,89.37528523784448,7
0.05,5697,92,509263,89.37574587574588,9
0.05,5698,95,509358,89.37673276013335,6
0.05,5699,95,509453,89.37771929824561,7
0.05,5700,96,509549,89.37888089808806,6
0.05,5701,95,509644,89.37986671343388,6
0.05,5702,95,509739,89.38085218306155,6
0.05,5703,93,509832,89.38148667601683,10
0.05,5704,96,509928,89.3826468010517,6
0.05,5705,96,510024,89.3838065194532,6
0.05,5706,83,510107,89.38268792710706,18
0.05,5707,92,510199,89.38314646110722,9
0.05,5708,92,510291,89.38360483447188,9
0.05,5709,94,510385,89.38441330998249,7
0.05,5710,96,510481,89.38557170372964,6
0.05,5711,94,510575,89.38637955182072,7
0.05,5712,95,510670,89.38736215648521,6
0.05,5713,90,510760,89.38746937346868,11
0.05,5714,92,510852,89.38792650918636,10
0.05,5715,94,510946,89.38873337998601,7
0.05,5716,96,511042,89.38988980234389,6
0.05,5717,94,511136,89.39069604756908,7
0.05,5718,94,511230,89.39150201084105,7
0.05,5719,96,511326,89.39265734265734,6
0.05,5720,95,511421,89.39363747596575,6
0.05,5721,93,511514,89.39426773855295,8
0.05,5722,93,511607,89.39489778088415,8
0.05,5723,94,511701,89.39570230607967,7
0.05,5724,94,511795,89.39650655021833,7
0.05,5725,94,511889,89.39731051344744,7
0.05,5726,92,511981,89.39776497293522,9
0.05,5727,94,512075,89.39856843575419,7
0.05,5728,92,512167,89.39902251701868,9
0.05,5729,96,512263,89.40017452006981,6
0.05,5730,92,512355,89.40062816262433,9
0.05,5731,94,512449,89.40143056524774,7
0.05,5732,94,512543,89.40223268794698,7
0.05,5733,95,512638,89.40320892919428,6
0.05,5734,95,512733,89.40418482999128,6
0.05,5735,91,512824,89.4044630404463,10
0.05,5736,94,512918,89.40526407530068,7
0.05,5737,95,513013,89.40623910770303,6
0.05,5738,92,513105,89.40669106116049,9
0.05,5739,25,513130,89.39547038327527,8
0.05,5740,94,513224,89.39627242640655,7
0.05,5741,93,513317,89.39690003483106,8
0.05,5742,96,513413,89.39804979975622,6
0.05,5743,92,513505,89.39850278551532,9
0.05,5744,94,513599,89.39930374238469,7
0.05,5745,92,513691,89.39975635224503,9
0.05,5746,96,513787,89.40090481990603,6
0.05,5747,95,513882,89.40187891440502,6
0.05,5748,94,513976,89.40267872673509,7
0.05,5749,96,514072,89.40382608695653,6
0.05,5750,92,514164,89.40427751695357,9
0.05,5751,95,514259,89.40525034770515,6
0.05,5752,94,514353,89.4060490179037,7
0.05,5753,91,514444,89.40632603406326,10
0.05,5754,94,514538,89.40712423979149,7
0.05,5755,94,514632,89.40792216817235,7
0.05,5756,94,514726,89.40871981935035,7
0.05,5757,94,514820,89.40951719346995,7
0.05,5758,95,514915,89.41048793193262,6
0.05,5759,94,515009,89.41128472222222,7
0.05,5760,94,515103,89.41208123589655,7
0.05,5761,93,515196,89.41270392224922,8
0.05,5762,94,515290,89.41349991323963,7
0.05,5763,89,515379,89.41342817487856,13
0.05,5764,94,515473,89.41422376409366,7
0.05,5765,94,515567,89.41501907734998,7
0.05,5766,96,515663,89.41616091555402,6
0.05,5767,92,515755,89.41660887656033,10
0.05,5768,93,515848,89.41723002253424,8
0.05,5769,94,515942,89.41802426343155,7
0.05,5770,94,516036,89.41881822907642,7
0.05,5771,96,516132,89.41995841995842,6
0.05,5772,95,516227,89.4209249956695,6
0.05,5773,94,516321,89.42171804641497,7
0.05,5774,92,516413,89.4221645021645,9
0.05,5775,96,516509,89.42330332409972,6
0.05,5776,94,516603,89.42409555132421,7
0.05,5777,94,516697,89.42488750432676,7
0.05,5778,94,516791,89.4256791832497,7
0.05,5779,96,516887,89.42681660899655,6
0.05,5780,94,516981,89.42760768033212,7
0.05,5781,96,517077,89.42874437910757,6
0.05,5782,96,517173,89.42988068476569,6
0.05,5783,94,517267,89.43067081604426,7
0.05,5784,94,517361,89.43146067415731,7
0.05,5785,93,517454,89.43207742827515,8
0.05,5786,96,517550,89.43321237255918,6
0.05,5787,94,517644,89.43400138217001,7
0.05,5788,93,517737,89.43461737778546,8
0.05,5789,94,517831,89.43540587219344,7
0.05,5790,93,517924,89.43602141253669,8
0.05,5791,96,518020,89.4371546961326,6
0.05,5792,93,518113,89.43776972207837,8
0.05,5793,94,518207,89.43855712806351,7
0.05,5794,94,518301,89.43934426229508,7
0.05,5795,95,518396,89.44030365769497,6
0.05,5796,94,518490,89.44109021907883,7
0.05,5797,95,518585,89.44204898240773,6
0.05,5798,95,518680,89.44300741507156,7
0.05,5799,93,518773,89.44362068965518,10
0.05,5800,96,518869,89.44475090501638,6
0.05,5801,95,518964,89.44570837642192,6
0.05,5802,93,519057,89.44632086851628,8
0.05,5803,90,519147,89.44641626464507,11
0.05,5804,95,519242,89.4473729543497,6
0.05,5805,96,519338,89.44850155012057,6
0.05,5806,94,519432,89.44928534527294,7
0.05,5807,96,519528,89.4504132231405,6
0.05,5808,94,519622,89.45119641934929,7
0.05,5809,94,519716,89.45197934595525,7
0.05,5810,94,519810,89.45276200309758,7
0.05,5811,92,519902,89.4532002752925,9
0.05,5812,96,519998,89.45432650954757,6
0.05,5813,94,520092,89.45510835913312,7
0.05,5814,95,520187,89.45606190885641,8
0.05,5815,95,520282,89.45701513067401,6
0.05,5816,94,520376,89.45779611483583,7
0.05,5817,94,520470,89.45857683052596,7
0.05,5818,94,520564,89.4593572778828,7
0.05,5819,95,520659,89.46030927835052,7
0.05,5820,93,520752,89.46091736814981,8
0.05,5821,94,520846,89.46169701133631,7
0.05,5822,96,520942,89.4628198523098,6
0.05,5823,94,521036,89.4635989010989,7
0.05,5824,94,521130,89.46437768240344,7
0.05,5825,92,521222,89.46481290765534,9
0.05,5826,92,521314,89.46524798352497,9
0.05,5827,94,521408,89.46602608098833,8
0.05,5828,96,521504,89.46714702350317,6
0.05,5829,96,521600,89.46826758147513,6
0.05,5830,92,521692,89.46870176642085,9
0.05,5831,91,521783,89.46896433470508,10
0.05,5832,94,521877,89.46974112806446,7
0.05,5833,95,521972,89.47068906410696,6
0.05,5834,94,522066,89.47146529562983,7
0.05,5835,96,522162,89.47258396161754,6
0.05,5836,93,522255,89.47318828165153,8
0.05,5837,93,522348,89.4737923946557,8
0.05,5838,92,522440,89.474225038534,9
0.05,5839,96,522536,89.47534246575343,6
0.05,5840,96,522632,89.47645951035781,6
0.05,5841,95,522727,89.47740499828826,6
0.05,5842,90,522817,89.4774944377888,11
0.05,5843,94,522911,89.47826830937714,7
0.05,5844,92,523003,89.4786997433704,9
0.05,5845,96,523099,89.47981525829627,6
0.05,5846,96,523195,89.48093039165384,6
0.05,5847,94,523289,89.48170314637483,7
0.05,5848,96,523385,89.48281757565395,6
0.05,5849,88,523473,89.4825641025641,13
0.05,5850,94,523567,89.48333618184925,7
0.05,5851,93,523660,89.48393711551606,8
0.05,5852,94,523754,89.48470869639502,7
0.05,5853,95,523849,89.48565083703451,7
0.05,5854,95,523944,89.4865926558497,6
0.05,5855,93,524037,89.48719262295081,8
0.05,5856,95,524132,89.48813385692334,6
0.05,5857,94,524226,89.48890406282007,7
0.05,5858,94,524320,89.48967400580304,7
0.05,5859,94,524414,89.49044368600683,10
0.05,5860,94,524508,89.49121310356594,7
0.05,5861,94,524602,89.49198225861481,7
0.05,5862,93,524695,89.49258059014157,8
0.05,5863,96,524791,89.49369031377898,6
0.05,5864,93,524884,89.49428815004262,8
0.05,5865,92,524976,89.49471530855779,9
0.05,5866,96,525072,89.49582410090336,6
0.05,5867,93,525165,89.49642126789367,9
0.05,5868,93,525258,89.49701823138524,8
0.05,5869,96,525354,89.49812606473594,6
0.05,5870,91,525445,89.49838187702265,10
0.05,5871,95,525540,89.49931880108991,6
0.05,5872,94,525634,89.50008513536523,7
0.05,5873,94,525728,89.50085120871638,7
0.05,5874,96,525824,89.5019574468085,6
0.05,5875,87,525911,89.50153165418652,14
0.05,5876,96,526007,89.50263740003403,6
0.05,5877,88,526095,89.50238176250426,13
0.05,5878,96,526191,89.50348698758292,6
0.05,5879,93,526284,89.50408163265305,8
0.05,5880,96,526380,89.50518619282435,6
0.05,5881,22,526402,89.49370962257736,12
0.05,5882,95,526497,89.49464558898521,6
0.05,5883,92,526589,89.4950713800136,9
0.05,5884,93,526682,89.49566694987256,9
0.05,5885,93,526775,89.49626231736323,8
0.05,5886,93,526868,89.49685748258875,8
0.05,5887,93,526961,89.49745244565217,8
0.05,5888,94,527055,89.4982170147733,7
0.05,5889,94,527149,89.49898132427843,7
0.05,5890,94,527243,89.49974537429978,7
0.05,5891,96,527339,89.50084860828241,6
0.05,5892,92,527431,89.50127269641948,9
0.05,5893,94,527525,89.50203596878181,7
0.05,5894,94,527619,89.5027989821883,8
0.05,5895,95,527714,89.50373134328358,6
0.05,5896,96,527810,89.50483296591487,6
0.05,5897,95,527905,89.50576466598847,7
0.05,5898,94,527999,89.50652652992032,7
0.05,5899,94,528093,89.50728813559321,7
0.05,5900,94,528187,89.50804948313845,7
0.05,5901,90,528277,89.50813283632667,11
0.05,5902,-46,528231,89.48517702862951,9
0.05,5903,94,528325,89.48594173441734,7
0.05,5904,93,528418,89.4865368331922,9
0.05,5905,93,528511,89.48713173044362,8
0.05,5906,92,528603,89.48755713560183,9
0.05,5907,91,528694,89.48781313473256,10
0.05,5908,91,528785,89.48806904721611,10
0.05,5909,96,528881,89.48917089678511,6
0.05,5910,93,528974,89.48976484520385,8
0.05,5911,95,529069,89.49069688768606,6
0.05,5912,96,529165,89.49179773380686,6
0.05,5913,91,529256,89.4920527561718,10
0.05,5914,92,529348,89.49247675401521,9
0.05,5915,94,529442,89.49323867478026,7
0.05,5916,94,529536,89.49400033800913,7
0.05,5917,94,529630,89.49476174383237,7
0.05,5918,89,529719,89.49467815509377,12
0.05,5919,89,529808,89.49459459459459,12
0.05,5920,94,529902,89.49535551427124,7
0.05,5921,95,529997,89.49628503883822,6
0.05,5922,96,530093,89.49738308289719,6
0.05,5923,94,530187,89.49814314652262,7
0.05,5924,94,530281,89.4989029535865,7
0.05,5925,26,530307,89.4881876476544,6
0.05,5926,95,530402,89.48911759743547,6
0.05,5927,23,530425,89.47790148448043,9
0.05,5928,95,530520,89.47883285545623,6
0.05,5929,92,530612,89.47925801011804,9
0.05,5930,94,530706,89.48002023267577,7
0.05,5931,94,530800,89.4807821982468,7
0.05,5932,91,530891,89.48103826057644,10
0.05,5933,95,530986,89.4819683181665,8
0.05,5934,96,531082,89.48306655433866,6
0.05,5935,91,531173,89.48332210242587,10
0.05,5936,94,531267,89.48408287013643,7
0.05,5937,95,531362,89.48501178848097,6
0.05,5938,94,531456,89.48577201549082,7
0.05,5939,93,531549,89.48636363636363,8
0.05,5940,94,531643,89.48712337990237,7
0.05,5941,94,531737,89.48788286772131,7
0.05,5942,93,531830,89.48847383476358,8
0.05,5943,94,531924,89.4892328398385,7
0.05,5944,93,532017,89.48982338099243,9
0.05,5945,92,532109,89.49024554322233,9
0.05,5946,95,532204,89.49117201950563,6
0.05,5947,92,532296,89.4915938130464,9
0.05,5948,94,532390,89.49235165574046,8
0.05,5949,24,532414,89.48134453781513,8
0.05,5950,90,532504,89.48143169215258,11
0.05,5951,94,532598,89.48219086021506,7
0.05,5952,92,532690,89.48261380816395,9
0.05,5953,92,532782,89.48303661404098,10
0.05,5954,94,532876,89.48379513014274,7
0.05,5955,94,532970,89.48455339153794,7
0.05,5956,92,533062,89.4849756588887,9
0.05,5957,90,533152,89.4850621013763,11
0.05,5958,96,533248,89.48615539520054,6
0.05,5959,95,533343,89.48708053691276,6
0.05,5960,25,533368,89.47626237208522,8
0.05,5961,94,533462,89.4770211338477,7
0.05,5962,95,533557,89.47794734194197,6
0.05,5963,94,533651,89.47870556673374,7
0.05,5964,95,533746,89.47963118189439,6
0.05,5965,96,533842,89.48072410325176,6
0.05,5966,93,533935,89.48131389307859,9
0.05,5967,26,533961,89.47067694369973,7
0.05,5968,96,534057,89.47177081588205,6
0.05,5969,91,534148,89.47202680067002,10
0.05,5970,93,534241,89.47261765198459,8
0.05,5971,27,534268,89.46215673141326,6
0.05,5972,94,534362,89.4629164573916,7
0.05,5973,95,534457,89.46384332105792,6
0.05,5974,96,534553,89.46493723849372,6
0.05,5975,95,534648,89.46586345381526,7
0.05,5976,95,534743,89.46678935921031,6
0.05,5977,94,534837,89.46754767480763,7
0.05,5978,95,534932,89.46847298879412,6
0.05,5979,92,535024,89.46889632107023,9
0.05,5980,95,535119,89.46982110015048,6
0.05,5981,92,535211,89.47024406552993,9
0.05,5982,96,535307,89.47133545044292,6
0.05,5983,93,535400,89.47192513368984,8
0.05,5984,96,535496,89.47301587301587,6
0.05,5985,92,535588,89.47343802205145,9
0.05,5986,95,535683,89.4743611157508,6
0.05,5987,90,535773,89.4744488977956,11
0.05,5988,94,535867,89.4752045416597,8
0.05,5989,96,535963,89.4762938230384,6
0.05,5990,93,536056,89.47688198965115,8
0.05,5991,92,536148,89.47730307076101,9
0.05,5992,93,536241,89.4778908726848,8
0.05,5993,93,536334,89.47847847847848,9
0.05,5994,93,536427,89.4790658882402,8
0.05,5995,92,536519,89.47948632421614,10
0.05,5996,94,536613,89.48024012006003,7
0.05,5997,95,536708,89.4811603867956,7
0.05,5998,91,536799,89.48141356892816,10
0.05,5999,95,536894,89.48233333333333,6
0.05,6000,94,536988,89.48308615230795,7
0.05,6001,95,537083,89.48400533155615,6
0.05,6002,94,537177,89.4847576211894,7
0.05,6003,94,537271,89.48550966022651,7
0.05,6004,94,537365,89.48626144879267,7
0.05,6005,96,537461,89.48734598734599,6
0.05,6006,89,537550,89.48726485766606,12
0.05,6007,91,537641,89.48751664447404,10
0.05,6008,96,537737,89.48860043268431,6
0.05,6009,92,537829,89.48901830282863,9
0.05,6010,94,537923,89.48976875727833,7
0.05,6011,92,538015,89.49018629407851,9
0.05,6012,93,538108,89.49076999833693,8
0.05,6013,96,538204,89.49185234452943,6
0.05,6014,96,538300,89.49293433083957,6
0.05,6015,93,538393,89.49351728723404,8
0.05,6016,95,538488,89.494432441416,6
0.05,6017,94,538582,89.49518112329677,7
0.05,6018,90,538672,89.49526499418508,11
0.05,6019,90,538762,89.4953488372093,11
0.05,6020,94,538856,89.49609699385483,7
0.05,6021,96,538952,89.49717701760213,6
0.05,6022,96,539048,89.49825668271626,6
0.05,6023,94,539142,89.49900398406375,7
0.05,6024,23,539165,89.48796680497925,9
0.05,6025,93,539258,89.4885496183206,8
0.05,6026,96,539354,89.4896299983408,6
0.05,6027,95,539449,89.49054412740544,6
0.05,6028,92,539541,89.49096035826837,9
0.05,6029,95,539636,89.49187396351576,6
0.05,6030,95,539731,89.4927872657934,6
0.05,6031,94,539825,89.49353448275862,8
0.05,6032,92,539917,89.49394994198575,9
0.05,6033,94,540011,89.49469671859462,7
0.05,6034,90,540101,89.49478044739023,11
0.05,6035,96,540197,89.49585818422797,6
0.05,6036,91,540288,89.49610733808183,10
0.05,6037,94,540382,89.49685326266976,7
0.05,6038,95,540477,89.49776453055142,6
0.05,6039,95,540572,89.49867549668875,6
0.05,6040,92,540664,89.49908955470949,9
0.05,6041,91,540755,89.49933796756041,10
0.05,6042,93,540848,89.49991725963925,9
0.05,6043,94,540942,89.50066181336862,7
0.05,6044,88,541030,89.50041356492969,13
0.05,6045,94,541124,89.50115779027456,7
0.05,6046,92,541216,89.50157102695552,9
0.05,6047,94,541310,89.50231481481481,7
0.05,6048,89,541399,89.50223177384692,12
0.05,6049,95,541494,89.50314049586777,7
0.05,6050,95,541589,89.50404891753429,6
0.05,6051,93,541682,89.50462656972901,9
0.05,6052,94,541776,89.50536923839418,8
0.05,6053,92,541868,89.50578130161877,9
0.05,6054,95,541963,89.5066886870355,7
0.05,6055,94,542057,89.50743064729194,7
0.05,6056,96,542153,89.50850255902262,6
0.05,6057,94,542247,89.50924397490921,7
0.05,6058,94,542341,89.50998514606371,7
0.05,6059,25,542366,89.4993399339934,8
0.05,6060,93,542459,89.49991750536215,8
0.05,6061,96,542555,89.50098977235236,6
0.05,6062,96,542651,89.50206168563417,6
0.05,6063,95,542746,89.50296833773088,6
0.05,6064,95,542841,89.50387469084913,6
0.05,6065,95,542936,89.50478074513683,6
0.05,6066,96,543032,89.50585132685018,6
0.05,6067,90,543122,89.50593276203033,11
0.05,6068,94,543216,89.50667325753831,7
0.05,6069,96,543312,89.50774299835255,6
0.05,6070,94,543406,89.50848295173778,7
0.05,6071,94,543500,89.50922266139658,7
0.05,6072,94,543594,89.50996212744937,7
0.05,6073,96,543690,89.51103062232467,6
0.05,6074,89,543779,89.5109465020576,12
0.05,6075,94,543873,89.511685319289,8
0.05,6076,93,543966,89.51225933848939,8
0.05,6077,94,544060,89.51299769661073,7
0.05,6078,94,544154,89.51373581181116,7
0.05,6079,25,544179,89.503125,8
0.05,6080,93,544272,89.50370004933399,8
0.05,6081,95,544367,89.50460374876685,6
0.05,6082,94,544461,89.50534275850731,7
0.05,6083,96,544557,89.50641025641026,6
0.05,6084,95,544652,89.50731306491372,6
0.05,6085,95,544747,89.50821557673349,6
0.05,6086,95,544842,89.50911779201577,6
0.05,6087,94,544936,89.50985545335085,7
0.05,6088,96,545032,89.5109213335523,6
0.05,6089,94,545126,89.51165845648605,7
0.05,6090,95,545221,89.51255951403711,6
0.05,6091,95,545316,89.51346027577151,6
0.05,6092,94,545410,89.51419661907107,7
0.05,6093,93,545503,89.51476862487692,8
0.05,6094,93,545596,89.51534044298606,8
0.05,6095,91,545687,89.51558398950131,10
0.05,6096,93,545780,89.51615548630474,9
0.05,6097,93,545873,89.5167267956707,8
0.05,6098,94,545967,89.51746187899656,8
0.05,6099,95,546062,89.51836065573771,6
0.05,6100,93,546155,89.51893132273398,10
0.05,6101,96,546251,89.51999344477221,6
0.05,6102,95,546346,89.52089136490251,6
0.05,6103,92,546438,89.52129750982962,9
0.05,6104,92,546530,89.52170352170351,9
0.05,6105,94,546624,89.52243694726498,7
0.05,6106,96,546720,89.52349762567546,6
0.05,6107,92,546812,89.52390307793058,9
0.05,6108,92,546904,89.52430839744639,9
0.05,6109,96,547000,89.52536824877251,6
0.05,6110,94,547094,89.52610047455408,7
0.05,6111,89,547183,89.52601439790575,13
0.05,6112,92,547275,89.52641910682152,10
0.05,6113,96,547371,89.52747791952895,6
0.05,6114,95,547466,89.52837285363859,6
0.05,6115,94,547560,89.52910398953564,7
0.05,6116,92,547652,89.52950792872323,9
0.05,6117,94,547746,89.53023864007845,7
0.05,6118,22,547768,89.51920248406603,10
0.05,6119,91,547859,89.51944444444445,10
0.05,6120,94,547953,89.52017644175788,9
0.05,6121,94,548047,89.52090819993467,7
0.05,6122,94,548141,89.52163971909195,7
0.05,6123,90,548231,89.52171783148269,11
0.05,6124,94,548325,89.52244897959184,7
0.05,6125,94,548419,89.52317988899772,7
0.05,6126,91,548510,89.52342092378,10
0.05,6127,93,548603,89.52398825065274,8
0.05,6128,92,548695,89.52439223364334,9
0.05,6129,95,548790,89.5252854812398,7
0.05,6130,94,548884,89.52601533191975,7
0.05,6131,94,548978,89.52674494455316,7
0.05,6132,96,549074,89.52780042393609,6
0.05,6133,95,549169,89.52869253342028,7
0.05,6134,93,549262,89.52925835370823,8
0.05,6135,94,549356,89.52998696219035,7
0.05,6136,90,549446,89.53006354896529,11
0.05,6137,94,549540,89.5307917888563,7
0.05,6138,95,549635,89.5316826844763,6
0.05,6139,92,549727,89.53208469055375,9
0.05,6140,94,549821,89.53281224556261,7
0.05,6141,93,549914,89.53337675024422,8
0.05,6142,93,550007,89.53394107113787,8
0.05,6143,94,550101,89.53466796875,7
0.05,6144,95,550196,89.53555736371034,6
0.05,6145,93,550289,89.53612105434429,8
0.05,6146,96,550385,89.53717260452252,6
0.05,6147,93,550478,89.5377358490566,8
0.05,6148,95,550573,89.53862416653115,6
0.05,6149,93,550666,89.53918699186993,8
0.05,6150,92,550758,89.53958705901479,9
0.05,6151,95,550853,89.54047464239272,7
0.05,6152,90,550943,89.54054932553225,11
0.05,6153,92,551035,89.54094897627559,9
0.05,6154,94,551129,89.54167343623071,7
0.05,6155,90,551219,89.54174788823912,11
0.05,6156,96,551315,89.54279681663148,6
0.05,6157,94,551409,89.54352062357908,7
0.05,6158,95,551504,89.54440655950641,6
0.05,6159,96,551600,89.54545454545455,6
0.05,6160,96,551696,89.54650219120273,6
0.05,6161,96,551792,89.54754949691659,6
0.05,6162,96,551888,89.54859646276164,6
0.05,6163,96,551984,89.54964308890331,6
0.05,6164,94,552078,89.55036496350365,7
0.05,6165,91,552169,89.55060006487187,10
0.05,6166,96,552265,89.5516458569807,6
0.05,6167,94,552359,89.55236705577173,7
0.05,6168,93,552452,89.55292591992219,8
0.05,6169,96,552548,89.55397082658023,6
0.05,6170,94,552642,89.5546912980068,7
0.05,6171,92,552734,89.5550874918989,9
0.05,6172,94,552828,89.55580754900373,8
0.05,6173,93,552921,89.55636540330418,9
0.05,6174,95,553016,89.55724696356275,6
0.05,6175,92,553108,89.55764248704664,9
0.05,6176,94,553202,89.5583616642383,7
0.05,6177,94,553296,89.5590806086112,7
0.05,6178,93,553389,89.55963748179317,9
0.05,6179,94,553483,89.56035598705502,7
0.05,6180,92,553575,89.56075068759101,9
0.05,6181,94,553669,89.56146878032999,7
0.05,6182,93,553762,89.56202490700308,8
0.05,6183,94,553856,89.5627425614489,7
0.05,6184,96,553952,89.56378334680679,6
0.05,6185,96,554048,89.56482379566764,6
0.05,6186,-46,554002,89.54291255859059,9
0.05,6187,96,554098,89.54395604395604,6
0.05,6188,94,554192,89.54467603813217,7
0.05,6189,92,554284,89.54507269789984,9
0.05,6190,94,554378,89.54579227911485,7
0.05,6191,94,554472,89.54651162790698,7
0.05,6192,94,554566,89.54723074438883,7
0.05,6193,95,554661,89.5481110752341,6
0.05,6194,89,554750,89.54802259887006,12
0.05,6195,94,554844,89.54874112330536,7
0.05,6196,93,554937,89.5492980474423,8
0.05,6197,94,555031,89.55001613423686,7
0.05,6198,95,555126,89.55089530569447,6
0.05,6199,94,555220,89.5516129032258,7
0.05,6200,93,555313,89.5521690049992,8
0.05,6201,95,555408,89.55304740406321,7
0.05,6202,96,555504,89.55408673222634,6
0.05,6203,94,555598,89.55480335267569,7
0.05,6204,92,555690,89.55519742143433,9
0.05,6205,96,555786,89.55623590074121,6
0.05,6206,94,555880,89.55695182858064,7
0.05,6207,95,555975,89.55782860824742,7
0.05,6208,94,556069,89.55854404896118,8
0.05,6209,94,556163,89.55925925925926,7
0.05,6210,92,556255,89.55965222991466,9
0.05,6211,95,556350,89.56052801030263,8
0.05,6212,94,556444,89.56124255593112,7
0.05,6213,93,556537,89.56179594464113,8
0.05,6214,94,556631,89.56251005631536,8
0.05,6215,90,556721,89.56258043758044,11
0.05,6216,93,556814,89.56313334405662,8
0.05,6217,93,556907,89.56368607269218,8
0.05,6218,94,557001,89.5643994211288,7
0.05,6219,91,557092,89.56463022508039,11
0.05,6220,94,557186,89.5653431924128,7
0.05,6221,96,557282,89.56637737062037,6
0.05,6222,95,557377,89.56725052225615,6
0.05,6223,95,557472,89.5681233933162,6
0.05,6224,96,557568,89.56915662650603,6
0.05,6225,96,557664,89.5701895277867,6
0.05,6226,94,557758,89.57090091536855,7
0.05,6227,93,557851,89.57145150931278,8
0.05,6228,94,557945,89.57216246588537,8
0.05,6229,94,558039,89.57287319422151,7
0.05,6230,93,558132,89.5734232065479,8
0.05,6231,94,558226,89.57413350449293,8
0.05,6232,93,558319,89.57468313813573,8
0.05,6233,95,558414,89.57555341674687,6
0.05,6234,89,558503,89.57546110665598,13
0.05,6235,95,558598,89.57633098139833,6
0.05,6236,93,558691,89.57687991021325,9
0.05,6237,94,558785,89.57758897082398,7
0.05,6238,94,558879,89.57829780413527,7
0.05,6239,93,558972,89.57884615384616,8
0.05,6240,94,559066,89.57955455856434,7
0.05,6241,94,559160,89.58026273630247,7
0.05,6242,19,559179,89.56895723209995,13
0.05,6243,93,559272,89.5695067264574,8
0.05,6244,94,559366,89.57021617293834,7
0.05,6245,94,559460,89.57092539225104,7
0.05,6246,94,559554,89.57163438450456,7
0.05,6247,92,559646,89.57202304737515,9
0.05,6248,94,559740,89.57273163706193,7
0.05,6249,92,559832,89.57312,10
0.05,6250,91,559923,89.57334826427771,11
0.05,6251,92,560015,89.57373640435061,9
0.05,6252,95,560110,89.5746041899888,6
0.05,6253,94,560204,89.57531180044771,7
0.05,6254,96,560300,89.57633892885691,6
0.05,6255,96,560396,89.57736572890026,6
0.05,6256,94,560490,89.57807255873422,7
0.05,6257,94,560584,89.57877916267178,8
0.05,6258,89,560673,89.57868669116472,12
0.05,6259,95,560768,89.57955271565496,6
0.05,6260,96,560864,89.58057818239898,6
0.05,6261,93,560957,89.58112424145641,8
0.05,6262,93,561050,89.58167012613764,8
0.05,6263,94,561144,89.5823754789272,7
0.05,6264,96,561240,89.58339984038308,6
0.05,6265,94,561334,89.58410469198851,7
0.05,6266,94,561428,89.58480931865326,7
0.05,6267,94,561522,89.585513720485,7
0.05,6268,96,561618,89.58653692773967,6
0.05,6269,94,561712,89.58724082934609,7
0.05,6270,93,561805,89.58778504225802,8
0.05,6271,96,561901,89.58880739795919,6
0.05,6272,91,561992,89.58903236091184,10
0.05,6273,93,562085,89.58957602805228,8
0.05,6274,92,562177,89.58996015936255,9
0.05,6275,93,562270,89.59050350541746,8
0.05,6276,21,562291,89.57957623068344,11
0.05,6277,92,562383,89.57996177126473,9
0.05,6278,93,562476,89.58050645007167,8
0.05,6279,96,562572,89.58152866242038,6
0.05,6280,94,562666,89.58223212864193,7
0.05,6281,95,562761,89.58309455587393,6
0.05,6282,96,562857,89.58411586821582,6
0.05,6283,92,562949,89.58450031826862,9
0.05,6284,93,563042,89.58504375497216,8
0.05,6285,25,563067,89.57476932866687,8
0.05,6286,92,563159,89.57515508191506,9
0.05,6287,94,563253,89.57585877862596,7
0.05,6288,95,563348,89.57672125934171,6
0.05,6289,95,563443,89.57758346581876,6
0.05,6290,94,563537,89.57828644094738,7
0.05,6291,96,563633,89.57930705657978,6
0.05,6292,94,563727,89.5800095344033,7
0.05,6293,95,563822,89.58087067047983,6
0.05,6294,91,563913,89.58109610802224,10
0.05,6295,94,564007,89.58179796696315,7
0.05,6296,95,564102,89.58265840876608,6
0.05,6297,94,564196,89.58335979676087,7
0.05,6298,94,564290,89.58406096205746,8
0.05,6299,91,564381,89.58428571428571,10
0.05,6300,95,564476,89.58514521504523,6
0.05,6301,92,564568,89.58552840368137,9
0.05,6302,94,564662,89.58622877994605,7
0.05,6303,96,564758,89.5872461928934,7
0.05,6304,94,564852,89.587946074544,7
0.05,6305,92,564944,89.58832857595941,9
0.05,6306,92,565036,89.58871095608055,9
0.05,6307,89,565125,89.58861762840837,12
0.05,6308,95,565220,89.58947535267079,6
0.05,6309,93,565313,89.59001584786054,8
0.05,6310,93,565406,89.59055617176358,8
0.05,6311,95,565501,89.59141318124207,6
0.05,6312,94,565595,89.59211151591953,7
0.05,6313,94,565689,89.59280962939499,7
0.05,6314,94,565783,89.59350752177356,7
0.05,6315,96,565879,89.59452184927169,6
0.05,6316,91,565970,89.59474434066804,10
0.05,6317,94,566064,89.5954415954416,7
0.05,6318,96,566160,89.59645513530621,6
0.05,6319,92,566252,89.59683544303797,9
0.05,6320,94,566346,89.59753203607025,7
0.05,6321,95,566441,89.59838658652325,6
0.05,6322,94,566535,89.59908271390162,7
0.05,6323,92,566627,89.59946236559139,9
0.05,6324,95,566722,89.6003162055336,6
0.05,6325,89,566811,89.60022130888397,12
0.05,6326,94,566905,89.60091670617986,7
0.05,6327,94,566999,89.60161188369153,7
0.05,6328,90,567089,89.60167483014695,12
0.05,6329,95,567184,89.60252764612954,6
0.05,6330,94,567278,89.60322223977255,7
0.05,6331,95,567373,89.60407454200885,6
0.05,6332,92,567465,89.60445286594032,9
0.05,6333,94,567559,89.60514682664983,7
0.05,6334,94,567653,89.6058405682715,7
0.05,6335,94,567747,89.6065340909091,7
0.05,6336,93,567840,89.60706959128926,8
0.05,6337,92,567932,89.60744714420953,9
0.05,6338,96,568028,89.60845559236472,6
0.05,6339,96,568124,89.60946372239748,6
0.05,6340,24,568148,89.59911685853966,8
0.05,6341,90,568238,89.59918006937875,11
0.05,6342,95,568333,89.60003153082138,6
0.05,6343,95,568428,89.60088272383355,7
0.05,6344,94,568522,89.60157604412923,8
0.05,6345,93,568615,89.60211156634101,8
0.05,6346,94,568709,89.6028044745549,7
0.05,6347,96,568805,89.60381222432262,6
0.05,6348,95,568900,89.60466215151992,6
0.05,6349,94,568994,89.60535433070866,8
0.05,6350,94,569088,89.60604629192254,7
0.05,6351,95,569183,89.60689546599497,6
0.05,6352,95,569278,89.60774437273729,6
0.05,6353,93,569371,89.60827824992131,8
0.05,6354,95,569466,89.60912667191188,6
0.05,6355,88,569554,89.60887350534928,13
0.05,6356,96,569650,89.60987887368256,6
0.05,6357,92,569742,89.61025479710601,9
0.05,6358,94,569836,89.61094511715679,7
0.05,6359,94,569930,89.61163522012579,7
0.05,6360,25,569955,89.60147775506995,7
0.05,6361,92,570047,89.60185476265325,9
0.05,6362,96,570143,89.6028602860286,6
0.05,6363,91,570234,89.60307982401005,10
0.05,6364,95,570329,89.6039277297722,6
0.05,6365,95,570424,89.6047753691486,6
0.05,6366,95,570519,89.6056227422648,6
0.05,6367,94,570613,89.60631281407035,7
0.05,6368,95,570708,89.60715967969854,6
0.05,6369,95,570803,89.60800627943485,6
0.05,6370,93,570896,89.60853869094333,8
0.05,6371,94,570990,89.60922787193974,8
0.05,6372,94,571084,89.60991683665463,7
0.05,6373,94,571178,89.61060558518983,7
0.05,6374,95,571273,89.61145098039216,6
0.05,6375,96,571369,89.61245294855709,6
0.05,6376,92,571461,89.61282734828289,9
0.05,6377,95,571556,89.61367199749138,6
0.05,6378,95,571651,89.61451638187803,6
0.05,6379,94,571745,89.61520376175548,7
0.05,6380,95,571840,89.61604764143551,6
0.05,6381,93,571933,89.6165778752742,8
0.05,6382,95,572028,89.61742127526242,7
0.05,6383,96,572124,89.61842105263158,6
0.05,6384,94,572218,89.61910728269382,7
0.05,6385,92,572310,89.61948011274663,9
0.05,6386,94,572404,89.62016596211053,7
0.05,6387,96,572500,89.6211646837821,6
0.05,6388,94,572594,89.62185005478166,7
0.05,6389,90,572684,89.62190923317684,12
0.05,6390,94,572778,89.62259427319668,7
0.05,6391,95,572873,89.62343554443054,6
0.05,6392,91,572964,89.62365086813702,11
0.05,6393,96,573060,89.62464810760088,6
0.05,6394,93,573153,89.62517591868648,8
0.05,6395,95,573248,89.6260162601626,6
0.05,6396,95,573343,89.62685633890887,6
0.05,6397,94,573437,89.62753985620506,7
0.05,6398,90,573527,89.62759806219722,11
0.05,6399,96,573623,89.62859375,6
0.05,6400,93,573716,89.6291204499297,8
0.05,6401,94,573810,89.62980318650422,7
0.05,6402,96,573906,89.63079806340778,6
0.05,6403,92,573998,89.63116801998751,9
0.05,6404,90,574088,89.6312256049961,11
0.05,6405,92,574180,89.63159537933187,10
0.05,6406,27,574207,89.62181988450132,6
0.05,6407,91,574298,89.62203495630462,10
0.05,6408,95,574393,89.62287408332033,6
0.05,6409,90,574483,89.62293291731669,11
0.05,6410,93,574576,89.62345967867728,10
0.05,6411,94,574670,89.62414223331254,7
0.05,6412,92,574762,89.62451270856073,9
0.05,6413,95,574857,89.62535079513565,6
0.05,6414,95,574952,89.62618862042089,6
0.05,6415,93,575045,89.6267144638404,8
0.05,6416,96,575141,89.62770765155057,6
0.05,6417,93,575234,89.62823309442194,8
0.05,6418,92,575326,89.6286025860726,9
0.05,6419,94,575420,89.62928348909658,7
0.05,6420,91,575511,89.62949696308986,10
0.05,6421,96,575607,89.63048894425413,6
0.05,6422,94,575701,89.63116923555971,7
0.05,6423,94,575795,89.6318493150685,7
0.05,6424,96,575891,89.63284046692607,6
0.05,6425,94,575985,89.63352007469655,9
0.05,6426,94,576079,89.6341994709818,7
0.05,6427,95,576174,89.63503422526446,7
0.05,6428,96,576270,89.636024265049,6
0.05,6429,96,576366,89.63701399688958,6
0.05,6430,96,576462,89.63800342092988,6
0.05,6431,96,576558,89.63899253731343,6
0.05,6432,96,576654,89.63998134618375,6
0.05,6433,96,576750,89.64096984768418,6
0.05,6434,96,576846,89.64195804195805,6
0.05,6435,25,576871,89.63191423244251,7
0.05,6436,92,576963,89.63228211899954,9
0.05,6437,25,576988,89.62224293258777,8
0.05,6438,95,577083,89.62307811772014,6
0.05,6439,91,577174,89.62329192546584,10
0.05,6440,94,577268,89.6239714330073,7
0.05,6441,96,577364,89.62496119217634,6
0.05,6442,93,577457,89.62548502250505,8
0.05,6443,94,577551,89.62616387337057,8
0.05,6444,93,577644,89.6266873545384,8
0.05,6445,94,577738,89.62736580825317,8
0.05,6446,94,577832,89.62804405149681,7
0.05,6447,96,577928,89.62903225806451,6
0.05,6448,94,578022,89.62971003256318,7
0.05,6449,95,578117,89.63054263565891,7
0.05,6450,92,578209,89.63090993644396,9
0.05,6451,90,578299,89.63096714197148,11
0.05,6452,95,578394,89.63179916317992,7
0.05,6453,93,578487,89.63232104121475,8
0.05,6454,93,578580,89.63284275755228,9
0.05,6455,96,578676,89.63382899628253,6
0.05,6456,92,578768,89.63419544680193,9
0.05,6457,27,578795,89.62449674821926,6
0.05,6458,96,578891,89.62548382102493,6
0.05,6459,93,578984,89.62600619195047,8
0.05,6460,96,579080,89.62699272558427,6
0.05,6461,94,579174,89.62766945218199,7
0.05,6462,95,579269,89.62850069627108,6
0.05,6463,94,579363,89.62917698019803,7
0.05,6464,91,579454,89.62938901778809,10
0.05,6465,93,579547,89.62991030003093,8
0.05,6466,95,579642,89.63074068346992,6
0.05,6467,94,579736,89.63141620284478,7
0.05,6468,95,579831,89.63224609676921,6
0.05,6469,96,579927,89.63323029366306,6
0.05,6470,95,580022,89.63405965074949,6
0.05,6471,93,580115,89.63457972805934,8
0.05,6472,90,580205,89.63463618105979,11
0.05,6473,95,580300,89.63546493666976,6
0.05,6474,91,580391,89.63567567567567,10
0.05,6475,92,580483,89.63604076590488,9
0.05,6476,96,580579,89.63702331326232,6
0.05,6477,95,580674,89.63785118863846,6
0.05,6478,93,580767,89.6383701188455,9
0.05,6479,94,580861,89.63904320987655,7
0.05,6480,88,580949,89.63879031013732,13
0.05,6481,94,581043,89.63946312866399,8
0.05,6482,93,581136,89.6399814900509,8
0.05,6483,95,581231,89.64080814312153,6
0.05,6484,91,581322,89.64101773323053,10
0.05,6485,94,581416,89.64168979340117,7
0.05,6486,93,581509,89.64220749190689,10
0.05,6487,93,581602,89.64272503082614,9
0.05,6488,94,581696,89.64339651718292,7
0.05,6489,93,581789,89.64391371340524,8
0.05,6490,95,581884,89.64473886920351,6
0.05,6491,93,581977,89.64525569932225,9
0.05,6492,94,582071,89.64592638225781,8
0.05,6493,93,582164,89.64644287034186,8
0.05,6494,96,582260,89.64742109314858,6
0.05,6495,92,582352,89.64778325123153,9
0.05,6496,94,582446,89.64845313221487,7
0.05,6497,96,582542,89.64943059402893,6
0.05,6498,90,582632,89.64948453608247,11
0.05,6499,96,582728,89.65046153846154,6
0.05,6500,92,582820,89.65082295031533,9
0.05,6501,94,582914,89.65149184866195,7
0.05,6502,91,583005,89.65169921574658,10
0.05,6503,94,583099,89.65236777367774,7
0.05,6504,96,583195,89.65334358186011,6
0.05,6505,96,583291,89.6543190900707,6
0.05,6506,96,583387,89.65529429844783,6
0.05,6507,96,583483,89.65626920712968,6
0.05,6508,95,583578,89.65709018282378,6
0.05,6509,93,583671,89.65760368663595,8
0.05,6510,94,583765,89.65827061895254,7
0.05,6511,96,583861,89.65924447174447,6
0.05,6512,94,583955,89.6599109473361,7
0.05,6513,96,584051,89.66088424930918,6
0.05,6514,92,584143,89.66124328472755,9
0.05,6515,93,584236,89.66175567833027,8
0.05,6516,96,584332,89.66272824919442,6
0.05,6517,92,584424,89.6630868364529,9
0.05,6518,93,584517,89.66359871145882,8
0.05,6519,96,584613,89.66457055214724,6
0.05,6520,93,584706,89.6650820426315,8
0.05,6521,94,584800,89.66574670346519,8
0.05,6522,93,584893,89.66625785681435,8
0.05,6523,94,584987,89.66692213366034,7
0.05,6524,92,585079,89.66727969348659,10
0.05,6525,93,585172,89.66779037695372,8
0.05,6526,93,585265,89.66830090393749,8
0.05,6527,96,585361,89.66927083333333,6
0.05,6528,96,585457,89.67024046561495,6
0.05,6529,94,585551,89.67090352220521,7
0.05,6530,94,585645,89.67156637574644,7
0.05,6531,93,585738,89.67207593386405,8
0.05,6532,94,585832,89.67273840502067,7
0.05,6533,94,585926,89.67340067340068,7
0.05,6534,95,586021,89.67421576128538,6
0.05,6535,92,586113,89.67457160342717,9
0.05,6536,92,586205,89.67492733669879,9
0.05,6537,92,586297,89.6752829611502,9
0.05,6538,96,586393,89.67625019116073,6
0.05,6539,94,586487,89.67691131498471,7
0.05,6540,94,586581,89.67757223666106,7
0.05,6541,94,586675,89.67823295628249,7
0.05,6542,94,586769,89.67889347394161,7
0.05,6543,94,586863,89.67955378973105,7
0.05,6544,90,586953,89.67960275019098,11
0.05,6545,94,587047,89.68026275588146,8
0.05,6546,91,587138,89.68046433480984,10
0.05,6547,91,587229,89.6806658521686,10
0.05,6548,92,587321,89.6810200030539,9
0.05,6549,93,587414,89.68152671755725,8
0.05,6550,94,587508,89.68218592581286,7
0.05,6551,94,587602,89.68284493284493,7
0.05,6552,95,587697,89.68365634060736,6
0.05,6553,94,587791,89.68431492218492,7
0.05,6554,92,587883,89.68466819221968,9
0.05,6555,96,587979,89.68563148261134,6
0.05,6556,92,588071,89.68598444410554,9
0.05,6557,94,588165,89.68664226898444,7
0.05,6558,90,588255,89.68669004421406,11
0.05,6559,96,588351,89.68765243902439,6
0.05,6560,96,588447,89.68861454046639,6
0.05,6561,95,588542,89.68942395611094,6
0.05,6562,92,588634,89.68977601706537,10
0.05,6563,96,588730,89.69073735527118,6
0.05,6564,96,588826,89.6916984006093,6
0.05,6565,92,588918,89.69204995431008,9
0.05,6566,94,589012,89.69270595401248,7
0.05,6567,95,589107,89.69351400730817,6
0.05,6568,95,589202,89.69432181458365,7
0.05,6569,94,589296,89.69497716894978,8
0.05,6570,94,589390,89.6956323238472,7
0.05,6571,96,589486,89.69659160073037,6
0.05,6572,94,589580,89.69724631066484,8
0.05,6573,94,589674,89.6979008214177,7
0.05,6574,94,589768,89.69855513307985,7
0.05,6575,95,589863,89.69936131386861,6
0.05,6576,96,589959,89.70031929451117,6
0.05,6577,90,590049,89.70036485253877,11
0.05,6578,94,590143,89.70101839185287,7
0.05,6579,95,590238,89.70182370820669,6
0.05,6580,96,590334,89.70278073241148,6
0.05,6581,94,590428,89.70343360680644,7
0.05,6582,90,590518,89.7034786571472,11
0.05,6583,90,590608,89.70352369380316,11
0.05,6584,92,590700,89.70387243735763,10
0.05,6585,95,590795,89.70467658669907,6
0.05,6586,95,590890,89.70548049187794,6
0.05,6587,96,590986,89.70643594414086,6
0.05,6588,92,591078,89.70678403399606,9
0.05,6589,94,591172,89.70743550834598,7
0.05,6590,94,591266,89.70808678500987,7
0.05,6591,94,591360,89.70873786407768,7
0.05,6592,93,591453,89.70923706961929,8
0.05,6593,92,591545,89.70958447073097,9
0.05,6594,93,591638,89.71008339651252,9
0.05,6595,94,591732,89.7107337780473,7
0.05,6596,94,591826,89.71138396240715,8
0.05,6597,93,591919,89.7118823886026,8
0.05,6598,94,592013,89.71253220184876,7
0.05,6599,96,592109,89.71348484848485,6
0.05,6600,94,592203,89.71413422208757,8
0.05,6601,95,592298,89.71493486822175,7
0.05,6602,93,592391,89.71543237922157,8
0.05,6603,93,592484,89.71592973955178,8
0.05,6604,94,592578,89.71657834973504,7
0.05,6605,93,592671,89.71707538601271,9
0.05,6606,92,592763,89.71742091720903,9
0.05,6607,94,592857,89.71806900726392,7
0.05,6608,94,592951,89.71871690119534,7
0.05,6609,94,593045,89.71936459909229,7
0.05,6610,95,593140,89.72016336409015,6
0.05,6611,95,593235,89.72096188747732,6
0.05,6612,94,593329,89.72160895206412,7
0.05,6613,94,593423,89.7222558209858,7
0.05,6614,94,593517,89.72290249433107,7
0.05,6615,90,593607,89.72294437726723,11
0.05,6616,95,593702,89.72374187698352,6
0.05,6617,89,593791,89.72363251737686,12
0.05,6618,95,593886,89.72442967215592,7
0.05,6619,95,593981,89.72522658610272,6
0.05,6620,96,594077,89.7261742939133,6
0.05,6621,94,594171,89.72681969193597,7
0.05,6622,94,594265,89.72746489506267,7
0.05,6623,95,594360,89.72826086956522,7
0.05,6624,92,594452,89.72860377358491,9
0.05,6625,95,594547,89.7293993359493,6
0.05,6626,92,594639,89.72974196468991,9
0.05,6627,96,594735,89.730687990344,6
0.05,6628,94,594829,89.7313320259466,7
0.05,6629,96,594925,89.73227752639518,6
0.05,6630,94,595019,89.73292112803499,7
0.05,6631,94,595113,89.73356453558505,7
0.05,6632,94,595207,89.73420774913312,8
0.05,6633,91,595298,89.73439855290925,10
0.05,6634,94,595392,89.73504144687264,8
0.05,6635,89,595481,89.7349306811332,12
0.05,6636,91,595572,89.73512128973934,10
0.05,6637,95,595667,89.73591443205785,6
0.05,6638,94,595761,89.73655671034794,7
0.05,6639,95,595856,89.73734939759036,6
0.05,6640,96,595952,89.73829242583948,6
0.05,6641,94,596046,89.73893405600722,7
0.05,6642,95,596141,89.73972602739725,8
0.05,6643,95,596236,89.74051776038532,6
0.05,6644,91,596327,89.74070729872085,10
0.05,6645,95,596422,89.74149864580198,6
0.05,6646,92,596514,89.74183842334888,9
0.05,6647,96,596610,89.7427797833935,6
0.05,6648,94,596704,89.74342006316739,7
0.05,6649,96,596800,89.74436090225564,6
0.05,6650,92,596892,89.744700045106,9
0.05,6651,96,596988,89.74564040889958,6
0.05,6652,90,597078,89.7456786412145,11
0.05,6653,92,597170,89.74601743312293,9
0.05,6654,96,597266,89.74695717505635,6
0.05,6655,94,597360,89.74759615384616,8
0.05,6656,94,597454,89.74823494066396,7
0.05,6657,96,597550,89.74917392610394,6
0.05,6658,94,597644,89.74981228412675,7
0.05,6659,95,597739,89.7506006006006,6
0.05,6660,92,597831,89.75093829755292,9
0.05,6661,94,597925,89.75157610327228,7
0.05,6662,95,598020,89.75236380009005,6
0.05,6663,96,598116,89.75330132052821,6
0.05,6664,95,598211,89.75408852213053,6
0.05,6665,94,598305,89.75472547254725,7
0.05,6666,95,598400,89.75551222438878,6
0.05,6667,94,598494,89.75614877024596,7
0.05,6668,94,598588,89.75678512520618,7
0.05,6669,96,598684,89.75772113943029,6
0.05,6670,88,598772,89.75745765252586,13
0.05,6671,94,598866,89.75809352517986,7
0.05,6672,95,598961,89.75887906488836,6
0.05,6673,95,599056,89.75966436919389,6
0.05,6674,93,599149,89.76014981273408,8
0.05,6675,94,599243,89.76078490113841,7
0.05,6676,21,599264,89.7504867455444,11
0.05,6677,92,599356,89.7508235998802,10
0.05,6678,91,599447,89.75101063033388,10
0.05,6679,94,599541,89.75164670658683,7
0.05,6680,94,599635,89.75228259242628,7
0.05,6681,92,599727,89.75261897635438,9
0.05,6682,92,599819,89.75295525961394,9
0.05,6683,94,599913,89.75359066427289,8
0.05,6684,94,600007,89.75422587883321,7
0.05,6685,94,600101,89.75486090338019,7
0.05,6686,94,600195,89.7554957379991,8
0.05,6687,93,600288,89.75598086124401,8
0.05,6688,95,600383,89.7567648377934,7
0.05,6689,93,600476,89.75724962630792,8
0.05,6690,93,600569,89.7577342699148,9
0.05,6691,95,600664,89.75851763299463,7
0.05,6692,93,600757,89.7590019423278,8
0.05,6693,95,600852,89.75978488198386,7
0.05,6694,92,600944,89.76011949215832,9
0.05,6695,94,601038,89.76075268817205,7
0.05,6696,94,601132,89.76138569508736,8
0.05,6697,94,601226,89.76201851298894,7
0.05,6698,95,601321,89.76280041797283,6
0.05,6699,94,601415,89.7634328358209,7
0.05,6700,88,601503,89.76316967616773,13
0.05,6701,93,601596,89.76365264100268,8
0.05,6702,96,601692,89.76458302252723,6
0.05,6703,94,601786,89.76521479713604,7
0.05,6704,96,601882,89.76614466815809,6
0.05,6705,95,601977,89.76692514166417,6
0.05,6706,95,602072,89.76770538243626,6
0.05,6707,94,602166,89.76833631484794,7
0.05,6708,95,602261,89.76911611268446,7
0.05,6709,96,602357,89.77004470938897,6
0.05,6710,95,602452,89.77082402026524,6
0.05,6711,95,602547,89.7716030989273,7
0.05,6712,92,602639,89.77193505139282,9
0.05,6713,95,602734,89.77271373249926,6
0.05,6714,91,602825,89.7728965003723,10
0.05,6715,93,602918,89.77337701012507,9
0.05,6716,94,603012,89.77400625279142,7
0.05,6717,96,603108,89.7749330157785,6
0.05,6718,96,603204,89.77585950290222,6
0.05,6719,96,603300,89.77678571428571,6
0.05,6720,93,603393,89.77726528790359,8
0.05,6721,96,603489,89.778191014579,6
0.05,6722,96,603585,89.77911646586345,6
0.05,6723,93,603678,89.77959547888162,8
0.05,6724,95,603773,89.7803717472119,6
0.05,6725,94,603867,89.78099910793934,7
0.05,6726,91,603958,89.781180318121,10
0.05,6727,92,604050,89.78151010701546,9
0.05,6728,94,604144,89.78213701887353,7
0.05,6729,93,604237,89.78261515601783,8
0.05,6730,96,604333,89.78353885009656,6
0.05,6731,93,604426,89.78401663695782,8
0.05,6732,92,604518,89.78434575969108,9
0.05,6733,91,604609,89.78452628452628,10
0.05,6734,92,604701,89.78485523385301,9
0.05,6735,94,604795,89.7854809976247,7
0.05,6736,96,604891,89.78640344366929,6
0.05,6737,94,604985,89.78702879192639,7
0.05,6738,94,605079,89.78765395459267,7
0.05,6739,94,605173,89.78827893175074,7
0.05,6740,96,605269,89.78920041536864,6
0.05,6741,94,605363,89.78982497775141,8
0.05,6742,94,605457,89.79044935488655,7
0.05,6743,94,605551,89.79107354685647,7
0.05,6744,93,605644,89.79154929577464,8
0.05,6745,91,605735,89.7917284316632,10
0.05,6746,95,605830,89.79250037053505,6
0.05,6747,88,605918,89.79223473621813,13
0.05,6748,95,606013,89.79300637131426,6
0.05,6749,95,606108,89.79377777777778,6
0.05,6750,90,606198,89.79380832469263,11
0.05,6751,87,606285,89.79339454976304,14
0.05,6752,95,606380,89.79416555604917,6
0.05,6753,24,606404,89.78442404501037,8
0.05,6754,93,606497,89.78490007401925,8
0.05,6755,95,606592,89.78567199526347,6
0.05,6756,94,606686,89.78629569335504,7
0.05,6757,94,606780,89.78691920686593,7
0.05,6758,95,606875,89.7876904867584,7
0.05,6759,88,606963,89.78742603550296,13
0.05,6760,95,607058,89.78819701227629,7
0.05,6761,94,607152,89.7888198757764,7
0.05,6762,95,607247,89.78959041845334,6
0.05,6763,93,607340,89.79006505026611,8
0.05,6764,94,607434,89.79068736141907,7
0.05,6765,27,607461,89.78140703517587,6
0.05,6766,96,607557,89.7823259937934,6
0.05,6767,94,607651,89.78294917257683,7
0.05,6768,94,607745,89.78357216723298,7
0.05,6769,92,607837,89.78389955686853,9
0.05,6770,95,607932,89.78466991581746,6
0.05,6771,96,608028,89.78558771411696,6
0.05,6772,93,608121,89.78606230621585,8
0.05,6773,27,608148,89.77679362267493,6
0.05,6774,94,608242,89.77741697416974,8
0.05,6775,94,608336,89.7780401416765,7
0.05,6776,94,608430,89.77866312527667,7
0.05,6777,96,608526,89.77958099734435,6
0.05,6778,92,608618,89.77990854108276,9
0.05,6779,94,608712,89.78053097345133,8
0.05,6780,94,608806,89.78115322223861,7
0.05,6781,96,608902,89.7820701857859,6
0.05,6782,92,608994,89.78239716939407,9
0.05,6783,94,609088,89.78301886792453,7
0.05,6784,96,609184,89.78393515106853,6
0.05,6785,92,609276,89.7842617152962,9
0.05,6786,92,609368,89.78458818329159,9
0.05,6787,23,609391,89.77474955804361,9
0.05,6788,93,609484,89.77522462807482,8
0.05,6789,92,609576,89.77555228276877,9
0.05,6790,94,609670,89.7761743484023,8
0.05,6791,93,609763,89.77664899882214,8
0.05,6792,94,609857,89.77727071985868,7
0.05,6793,96,609953,89.77818663526641,6
0.05,6794,95,610048,89.77895511405445,6
0.05,6795,94,610142,89.77957622130666,7
0.05,6796,96,610238,89.78049139326173,6
0.05,6797,94,610332,89.7811120917917,7
0.05,6798,96,610428,89.78202676864245,6
0.05,6799,91,610519,89.78220588235294,10
0.05,6800,95,610614,89.78297309219232,7
0.05,6801,94,610708,89.78359306086445,7
0.05,6802,95,610803,89.78435984124651,6
0.05,6803,95,610898,89.7851263962375,7
0.05,6804,94,610992,89.78574577516532,8
0.05,6805,95,611087,89.7865119012636,6
0.05,6806,94,611181,89.78713089466726,7
0.05,6807,94,611275,89.78774970622797,7
0.05,6808,96,611371,89.78866206491408,6
0.05,6809,96,611467,89.78957415565345,6
0.05,6810,94,611561,89.79019233592717,7
0.05,6811,23,611584,89.78038755137992,10
0.05,6812,93,611677,89.78086012035814,8
0.05,6813,94,611771,89.78147930730849,8
0.05,6814,95,611866,89.78224504768892,6
0.05,6815,94,611960,89.78286384976526,7
0.05,6816,95,612055,89.78362916238815,6
0.05,6817,94,612149,89.78424757993547,8
0.05,6818,94,612243,89.78486581610207,7
0.05,6819,94,612337,89.78548387096774,7
0.05,6820,96,612433,89.78639495675121,6
0.05,6821,94,612527,89.78701260627382,7
0.05,6822,93,612620,89.78748351165177,10
0.05,6823,95,612715,89.78824736225089,6
0.05,6824,92,612807,89.78857142857143,9
0.05,6825,93,612900,89.78904189862291,8
0.05,6826,94,612994,89.78965870807089,7
0.05,6827,91,613085,89.7898359695372,10
0.05,6828,95,613180,89.790598916386,6
0.05,6829,92,613272,89.7909224011713,9
0.05,6830,95,613367,89.79168496559801,6
0.05,6831,93,613460,89.79215456674473,8
0.05,6832,95,613555,89.79291672764525,6
0.05,6833,93,613648,89.79338601112087,8
0.05,6834,96,613744,89.79429407461595,6
0.05,6835,-47,613697,89.77428320655353,11
0.05,6836,94,613791,89.77490127248794,7
0.05,6837,92,613883,89.77522667446623,9
0.05,6838,94,613977,89.77584442169908,7
0.05,6839,94,614071,89.77646198830409,7
0.05,6840,95,614166,89.77722555181991,6
0.05,6841,95,614261,89.7779888921368,6
0.05,6842,26,614287,89.76866871255298,8
0.05,6843,95,614382,89.76943308007013,6
0.05,6844,94,614476,89.7700511322133,8
0.05,6845,94,614570,89.77066900379783,7
0.05,6846,96,614666,89.77157879363224,6
0.05,6847,92,614758,89.77190420560747,10
0.05,6848,88,614846,89.77164549569281,13
0.05,6849,95,614941,89.77240875912409,7
0.05,6850,93,615034,89.7728798715516,8
0.05,6851,93,615127,89.77335084646819,8
0.05,6852,95,615222,89.77411352692252,7
0.05,6853,92,615314,89.7744382842136,10
0.05,6854,93,615407,89.77490882567469,8
0.05,6855,92,615499,89.7752333722287,9
0.05,6856,96,615595,89.7761411696077,6
0.05,6857,94,615689,89.77675707203267,7
0.05,6858,94,615783,89.77737279486806,7
0.05,6859,93,615876,89.77784256559767,8
0.05,6860,93,615969,89.77831219938784,8
0.05,6861,94,616063,89.7789274264063,7
0.05,6862,90,616153,89.778959638642,11
0.05,6863,93,616246,89.7794289044289,8
0.05,6864,95,616341,89.78018936635105,6
0.05,6865,88,616429,89.77993009030003,13
0.05,6866,94,616523,89.78054463375564,7
0.05,6867,94,616617,89.78115899825276,7
0.05,6868,93,616710,89.78162760227107,8
0.05,6869,94,616804,89.78224163027656,7
0.05,6870,94,616898,89.78285547955174,7
0.05,6871,94,616992,89.78346915017462,7
0.05,6872,94,617086,89.7840826422232,7
0.05,6873,92,617178,89.78440500436427,9
0.05,6874,90,617268,89.78443636363636,11
0.05,6875,94,617362,89.78504944735312,7
0.05,6876,94,617456,89.7856623527701,7
0.05,6877,92,617548,89.78598429776098,10
0.05,6878,96,617644,89.78688762901585,6
0.05,6879,94,617738,89.7875,7
0.05,6880,94,617832,89.7881121929952,7
0.05,6881,94,617926,89.78872420807905,8
0.05,6882,95,618021,89.78948133081505,6
0.05,6883,94,618115,89.79009296920395,7
0.05,6884,93,618208,89.79055918663762,8
0.05,6885,95,618303,89.79131571304096,6
0.05,6886,94,618397,89.79192681864382,7
0.05,6887,92,618489,89.79224738675958,9
0.05,6888,93,618582,89.79271302075773,8
0.05,6889,91,618673,89.79288824383164,10
0.05,6890,96,618769,89.79378900014511,6
0.05,6891,94,618863,89.79439930354033,7
0.05,6892,95,618958,89.79515450456985,6
0.05,6893,94,619052,89.79576443284014,8
0.05,6894,94,619146,89.79637418419145,7
0.05,6895,93,619239,89.79683874709977,8
0.05,6896,96,619335,89.79773814702044,6
0.05,6897,94,619429,89.79834734705712,8
0.05,6898,95,619524,89.79910131903175,6
0.05,6899,95,619619,89.79985507246377,6
0.05,6900,93,619712,89.80031879437763,8
0.05,6901,94,619806,89.8009272674587,7
0.05,6902,94,619900,89.80153556424743,7
0.05,6903,94,619994,89.8021436848204,7
0.05,6904,93,620087,89.80260680666184,9
0.05,6905,96,620183,89.80350419924703,6
0.05,6906,93,620276,89.80396699001014,8
0.05,6907,95,620371,89.80471916618413,6
0.05,6908,93,620464,89.80518164712693,9
0.05,6909,94,620558,89.80578871201158,7
0.05,6910,95,620653,89.80654029807553,6
0.05,6911,93,620746,89.80700231481481,8
0.05,6912,94,620840,89.80760885288586,7
0.05,6913,96,620936,89.80850448365635,6
0.05,6914,96,621032,89.80939985538684,6
0.05,6915,96,621128,89.81029496818971,6
0.05,6916,93,621221,89.81075610813937,8
0.05,6917,95,621316,89.81150621566927,6
0.05,6918,94,621410,89.81211157681746,7
0.05,6919,95,621505,89.8128612716763,6
0.05,6920,94,621599,89.81346626210085,7
0.05,6921,94,621693,89.8140710777232,7
0.05,6922,92,621785,89.81438682652029,9
0.05,6923,96,621881,89.81528018486424,6
0.05,6924,96,621977,89.81617328519856,6
0.05,6925,94,622071,89.81677736066995,7
0.05,6926,94,622165,89.81738126172947,7
0.05,6927,95,622260,89.81812933025404,6
0.05,6928,95,622355,89.81887718285466,6
0.05,6929,94,622449,89.81948051948052,7
0.05,6930,93,622542,89.8199394026836,8
0.05,6931,95,622637,89.82068667051357,6
0.05,6932,95,622732,89.82143372277514,7
0.05,6933,96,622828,89.8223247764638,6
0.05,6934,95,622923,89.82307137707282,7
0.05,6935,94,623017,89.82367358708188,7
0.05,6936,96,623113,89.82456393253568,6
0.05,6937,96,623209,89.8254540213318,6
0.05,6938,91,623300,89.8256232886583,10
0.05,6939,96,623396,89.82651296829971,6
0.05,6940,94,623490,89.82711424866734,7
0.05,6941,96,623586,89.82800345721694,6
0.05,6942,92,623678,89.82831628978828,9
0.05,6943,96,623774,89.82920506912443,7
0.05,6944,93,623867,89.82966162706984,8
0.05,6945,94,623961,89.83026202130722,7
0.05,6946,94,624055,89.83086224269469,7
0.05,6947,91,624146,89.83103051237767,10
0.05,6948,94,624240,89.83163045042453,7
0.05,6949,94,624334,89.83223021582734,7
0.05,6950,95,624429,89.83297367285283,6
0.05,6951,95,624524,89.8337169159954,6
0.05,6952,93,624617,89.83417229972673,9
0.05,6953,94,624711,89.83477135461605,8
0.05,6954,94,624805,89.8353702372394,7
0.05,6955,96,624901,89.8362564692352,6
0.05,6956,96,624997,89.83714244645681,6
0.05,6957,94,625091,89.83774073009485,7
0.05,6958,94,625185,89.83833884178762,7
0.05,6959,27,625212,89.82931034482759,6
0.05,6960,95,625307,89.83005315328258,6
0.05,6961,96,625403,89.83093938523413,6
0.05,6962,94,625497,89.83153813011633,7
0.05,6963,96,625593,89.8324238943136,6
0.05,6964,96,625689,89.83330940416367,6
0.05,6965,93,625782,89.8337639965547,8
0.05,6966,95,625877,89.83450552605139,6
0.05,6967,94,625971,89.83510332950631,7
0.05,6968,95,626066,89.83584445401061,6
0.05,6969,94,626160,89.83644189383071,7
0.05,6970,95,626255,89.83718261368527,6
0.05,6971,95,626350,89.83792312105565,6
0.05,6972,94,626444,89.83852000573641,7
0.05,6973,93,626537,89.83897332950961,8
0.05,6974,94,626631,89.83956989247312,7
0.05,6975,94,626725,89.84016628440367,7
0.05,6976,95,626820,89.84090583345278,7
0.05,6977,92,626912,89.84121524792204,11
0.05,6978,95,627007,89.84195443473277,6
0.05,6979,90,627097,89.8419770773639,11
0.05,6980,95,627192,89.8427159432746,7
0.05,6981,94,627286,89.84331137209969,7
0.05,6982,95,627381,89.84404983531434,6
0.05,6983,27,627408,89.83505154639175,6
0.05,6984,95,627503,89.83579098067287,7
0.05,6985,93,627596,89.83624391640424,8
0.05,6986,92,627688,89.836553599542,9
0.05,6987,95,627783,89.83729250143102,6
0.05,6988,-44,627739,89.81814279582201,8
0.05,6989,91,627830,89.81831187410586,10
0.05,6990,96,627926,89.81919610928337,6
0.05,6991,94,628020,89.81979405034325,7
0.05,6992,94,628114,89.82039182039182,7
0.05,6993,94,628208,89.82098941950242,7
0.05,6994,94,628302,89.82158684774839,8
0.05,6995,93,628395,89.82204116638079,8
0.05,6996,27,628422,89.81306274117479,6
0.05,6997,96,628518,89.81394684195485,6
0.05,6998,92,628610,89.81425917988284,9
0.05,6999,94,628704,89.81485714285714,7
0.05,7000,93,628797,89.81531209827168,8
0.05,7001,94,628891,89.81590974007426,7
0.05,7002,93,628984,89.8163644152506,8
0.05,7003,96,629080,89.81724728726442,6
0.05,7004,92,629172,89.81755888650963,9
0.05,7005,96,629268,89.81844133599772,6
0.05,7006,94,629362,89.8190381047524,8
0.05,7007,94,629456,89.81963470319634,8
0.05,7008,93,629549,89.82008845769725,8
0.05,7009,90,629639,89.82011412268189,11
0.05,7010,93,629732,89.820567679361,9
0.05,7011,92,629824,89.82087849401027,9
0.05,7012,96,629920,89.82175958933409,6
0.05,7013,95,630015,89.82249786142002,7
0.05,7014,91,630106,89.82266571632216,10
0.05,7015,92,630198,89.82297605473204,9
0.05,7016,96,630294,89.82385634886704,6
0.05,7017,96,630390,89.82473639213451,6
0.05,7018,92,630482,89.82504630289215,9
0.05,7019,93,630575,89.82549857549857,8
0.05,7020,89,630664,89.82538099985757,12
0.05,7021,94,630758,89.82597550555397,8
0.05,7022,94,630852,89.82656984194789,7
0.05,7023,94,630946,89.82716400911161,7
0.05,7024,92,631038,89.82747330960854,9
0.05,7025,89,631127,89.82735553657842,12
0.05,7026,25,631152,89.81813006973104,8
0.05,7027,95,631247,89.81886738759249,6
0.05,7028,96,631343,89.81974676340873,7
0.05,7029,94,631437,89.8203413940256,7
0.05,7030,94,631531,89.82093585549708,9
0.05,7031,93,631624,89.82138794084186,8
0.05,7032,91,631715,89.82155552395848,10
0.05,7033,91,631806,89.82172305942565,10
0.05,7034,95,631901,89.8224591329069,6
0.05,7035,93,631994,89.82291074474134,8
0.05,7036,94,632088,89.82350433423333,7
0.05,7037,95,632183,89.82423984086388,6
0.05,7038,94,632277,89.82483307287967,7
0.05,7039,95,632372,89.82556818181818,6
0.05,7040,95,632467,89.82630308194858,8
0.05,7041,93,632560,89.82675376313547,8
0.05,7042,94,632654,89.82734630129207,7
0.05,7043,93,632747,89.8277967064168,8
0.05,7044,93,632840,89.82824698367637,8
0.05,7045,93,632933,89.82869713312517,8
0.05,7046,92,633025,89.8290052504612,9
0.05,7047,84,633109,89.82817820658343,17
0.05,7048,27,633136,89.81926514399206,6
0.05,7049,90,633226,89.81929078014184,11
0.05,7050,93,633319,89.81974188058432,8
0.05,7051,95,633414,89.82047646057856,6
0.05,7052,94,633508,89.82106904863178,7
0.05,7053,95,633603,89.82180323220868,6
0.05,7054,94,633697,89.82239546420978,7
0.05,7055,90,633787,89.82242063492063,11
0.05,7056,94,633881,89.82301261159132,7
0.05,7057,94,633975,89.82360442051572,7
0.05,7058,96,634071,89.8244793880153,6
0.05,7059,90,634161,89.82450424929179,11
0.05,7060,93,634254,89.82495397252514,8
0.05,7061,94,634348,89.82554517133957,7
0.05,7062,94,634442,89.82613620274671,7
0.05,7063,95,634537,89.82686862967158,7
0.05,7064,94,634631,89.8274593064402,7
0.05,7065,91,634722,89.82762524766487,10
0.05,7066,93,634815,89.82807414744588,9
0.05,7067,95,634910,89.82880588568194,7
0.05,7068,94,635004,89.82939595416607,7
0.05,7069,94,635098,89.82998585572842,7
0.05,7070,95,635193,89.83071701315231,6
0.05,7071,94,635287,89.83130656108597,7
0.05,7072,96,635383,89.83217870776191,6
0.05,7073,92,635475,89.83248515691264,9
0.05,7074,96,635571,89.83335689045937,6
0.05,7075,93,635664,89.83380440927077,8
0.05,7076,95,635759,89.8345344072347,6
0.05,7077,95,635854,89.83526419892625,7
0.05,7078,94,635948,89.83585252154259,7
0.05,7079,91,636039,89.83601694915254,10
0.05,7080,94,636133,89.83660499929388,7
0.05,7081,96,636229,89.83747528946625,6
0.05,7082,95,636324,89.83820415078357,6
0.05,7083,95,636419,89.83893280632411,6
0.05,7084,95,636514,89.83966125617502,7
0.05,7085,93,636607,89.84010725373977,8
0.05,7086,92,636699,89.84041202201213,10
0.05,7087,93,636792,89.84085778781038,8
0.05,7088,91,636883,89.84102130060657,10
0.05,7089,96,636979,89.84188998589563,6
0.05,7090,90,637069,89.84191228317586,11
0.05,7091,93,637162,89.84235758601241,8
0.05,7092,96,637258,89.84322571549414,6
0.05,7093,93,637351,89.84367070764026,8
0.05,7094,96,637447,89.84453840732911,6
0.05,7095,94,637541,89.84512401352875,7
0.05,7096,94,637635,89.84570945469918,7
0.05,7097,92,637727,89.84601296139758,9
0.05,7098,96,637823,89.8468798422313,6
0.05,7099,93,637916,89.84732394366198,8
0.05,7100,95,638011,89.84804957048303,6
0.05,7101,96,638107,89.84891579836666,6
0.05,7102,96,638203,89.84978178234549,6
0.05,7103,93,638296,89.85022522522523,8
0.05,7104,94,638390,89.85080928923294,7
0.05,7105,95,638485,89.85153391500141,6
0.05,7106,96,638581,89.85239904319685,6
0.05,7107,95,638676,89.85312324141812,6
0.05,7108,91,638767,89.85328456885638,10
0.05,7109,95,638862,89.85400843881857,6
0.05,7110,95,638957,89.85473210518914,6
0.05,7111,96,639053,89.85559617547807,6
0.05,7112,94,639147,89.85617882749895,7
0.05,7113,94,639241,89.85676131571549,7
0.05,7114,95,639336,89.85748418833451,6
0.05,7115,95,639431,89.85820685778528,6
0.05,7116,93,639524,89.85864830687088,8
0.05,7117,22,639546,89.84911491992132,10
0.05,7118,96,639642,89.84997892962495,6
0.05,7119,94,639736,89.8505617977528,7
0.05,7120,94,639830,89.85114450217667,7
0.05,7121,93,639923,89.85158663296826,8
0.05,7122,95,640018,89.85230942018812,6
0.05,7123,94,640112,89.85289163391353,7
0.05,7124,94,640206,89.85347368421053,7
0.05,7125,93,640299,89.85391523996633,8
0.05,7126,95,640394,89.85463729479444,6
0.05,7127,94,640488,89.85521885521885,7
0.05,7128,95,640583,89.85594052461776,6
0.05,7129,92,640675,89.8562412342216,9
0.05,7130,93,640768,89.85668209227318,8
0.05,7131,19,640787,89.8467470555244,13
0.05,7132,93,640880,89.84718912098697,8
0.05,7133,94,640974,89.84777123633306,7
0.05,7134,93,641067,89.84821303433777,8
0.05,7135,94,641161,89.84879484304933,7
0.05,7136,94,641255,89.84937648872075,7
0.05,7137,96,641351,89.85023816195013,6
0.05,7138,93,641444,89.8506793668581,8
0.05,7139,94,641538,89.85126050420168,7
0.05,7140,94,641632,89.85184147878448,7
0.05,7141,91,641723,89.85200224026883,10
0.05,7142,91,641814,89.85216295674087,11
0.05,7143,92,641906,89.85246360582306,9
0.05,7144,94,642000,89.85304408677396,7
0.05,7145,95,642095,89.85376434368878,6
0.05,7146,94,642189,89.85434448020148,7
0.05,7147,95,642284,89.85506435366536,6
0.05,7148,95,642379,89.85578402573786,6
0.05,7149,94,642473,89.85636363636364,7
0.05,7150,94,642567,89.85694308488323,7
0.05,7151,25,642592,89.84787472035794,8
0.05,7152,95,642687,89.84859499510695,6
0.05,7153,92,642779,89.84889572267264,9
0.05,7154,95,642874,89.84961565338924,6
0.05,7155,95,642969,89.85033538289547,6
0.05,7156,94,643063,89.8509151879279,8
0.05,7157,95,643158,89.85163453478626,7
0.05,7158,93,643251,89.85207431205475,8
0.05,7159,94,643345,89.85265363128492,7
0.05,7160,93,643438,89.85309314341572,8
0.05,7161,94,643532,89.85367215861491,7
0.05,7162,94,643626,89.85425101214575,7
0.05,7163,94,643720,89.85482970407594,7
0.05,7164,96,643816,89.85568736915562,6
0.05,7165,94,643910,89.85626569913481,7
0.05,7166,96,644006,89.85712292451514,6
0.05,7167,94,644100,89.85770089285714,7
0.05,7168,95,644195,89.8584181894267,6
0.05,7169,95,644290,89.85913528591352,6
0.05,7170,95,644385,89.85985218240134,7
0.05,7171,94,644479,89.86042944785277,7
0.05,7172,92,644571,89.86072772898369,9
0.05,7173,93,644664,89.86116531920825,8
0.05,7174,96,644760,89.86202090592334,6
0.05,7175,92,644852,89.8623188405797,9
0.05,7176,95,644947,89.86303469416191,7
0.05,7177,94,645041,89.86361103371412,8
0.05,7178,94,645135,89.86418721270373,7
0.05,7179,26,645161,89.85529247910864,7
0.05,7180,93,645254,89.85573039966579,8
0.05,7181,94,645348,89.8563074352548,8
0.05,7182,93,645441,89.8567450925797,8
0.05,7183,95,645536,89.85746102449889,6
0.05,7184,95,645631,89.85817675713291,6
0.05,7185,91,645722,89.85833565265794,10
0.05,7186,92,645814,89.85863364407959,9
0.05,7187,94,645908,89.85920979410128,8
0.05,7188,95,646003,89.85992488524134,7
0.05,7189,94,646097,89.8605006954103,7
0.05,7190,88,646185,89.86024196912808,13
0.05,7191,91,646276,89.86040044493882,10
0.05,7192,96,646372,89.86125399694147,6
0.05,7193,95,646467,89.86196830692244,6
0.05,7194,87,646554,89.86157053509382,14
0.05,7195,95,646649,89.86228460255698,6
0.05,7196,92,646741,89.86258163123523,9
0.05,7197,96,646837,89.86343428730203,6
0.05,7198,92,646929,89.86373107376025,9
0.05,7199,95,647024,89.86444444444444,6
0.05,7200,94,647118,89.86501874739619,8
0.05,7201,93,647211,89.8654540405443,8
0.05,7202,95,647306,89.86616687491323,6
0.05,7203,95,647401,89.86687951138256,6
0.05,7204,94,647495,89.8674531575295,7
0.05,7205,92,647587,89.86774909797391,10
0.05,7206,96,647683,89.8685999722492,6
0.05,7207,96,647779,89.86945061043285,6
0.05,7208,93,647872,89.86988486613954,8
0.05,7209,93,647965,89.87031900138696,8
0.05,7210,94,648059,89.87089169324643,7
0.05,7211,94,648153,89.87146422628952,8
0.05,7212,94,648247,89.87203660058228,7
0.05,7213,94,648341,89.87260881619073,7
0.05,7214,93,648434,89.87304227304227,8
0.05,7215,93,648527,89.8734756097561,8
0.05,7216,94,648621,89.8740473881114,9
0.05,7217,95,648716,89.87475755056802,6
0.05,7218,94,648810,89.87532899293531,7
0.05,7219,95,648905,89.87603878116343,6
0.05,7220,94,648999,89.87660988782717,7
0.05,7221,92,649091,89.87690390473553,9
0.05,7222,94,649185,89.87747473349025,7
0.05,7223,93,649278,89.87790697674419,8
0.05,7224,95,649373,89.87861591695501,6
0.05,7225,95,649468,89.87932466094658,6
0.05,7226,95,649563,89.88003320880033,6
0.05,7227,94,649657,89.8806032097399,7
0.05,7228,96,649753,89.88144971641998,6
0.05,7229,94,649847,89.8820193637621,7
0.05,7230,95,649942,89.88272714700595,6
0.05,7231,96,650038,89.88357300884955,6
0.05,7232,94,650132,89.88414212636528,7
0.05,7233,96,650228,89.88498755875034,6
0.05,7234,25,650253,89.87601935038009,8
0.05,7235,95,650348,89.8767274737424,7
0.05,7236,94,650442,89.87729722260605,8
0.05,7237,86,650528,89.876761536336,15
0.05,7238,92,650620,89.87705484182898,10
0.05,7239,92,650712,89.87734806629834,9
0.05,7240,96,650808,89.8781936196658,6
0.05,7241,96,650904,89.87903893951948,6
0.05,7242,94,650998,89.87960789728014,7
0.05,7243,93,651091,89.88003865267808,8
0.05,7244,89,651180,89.87991718426501,12
0.05,7245,96,651276,89.88076179961358,6
0.05,7246,94,651370,89.88133020560232,7
0.05,7247,95,651465,89.88203642384106,6
0.05,7248,91,651556,89.88219064698579,10
0.05,7249,96,651652,89.88303448275862,6
0.05,7250,93,651745,89.88346434974487,8
0.05,7251,94,651839,89.88403199117485,7
0.05,7252,93,651932,89.88446160209568,8
0.05,7253,95,652027,89.88516680452165,6
0.05,7254,95,652122,89.88587181254307,7
0.05,7255,96,652218,89.8867144432194,6
0.05,7256,92,652310,89.88700564971751,9
0.05,7257,94,652404,89.88757233397631,7
0.05,7258,94,652498,89.88813886210222,7
0.05,7259,93,652591,89.88856749311294,8
0.05,7260,94,652685,89.88913372813661,7
0.05,7261,95,652780,89.88983751032774,7
0.05,7262,94,652874,89.89040341456699,7
0.05,7263,95,652969,89.89110682819383,6
0.05,7264,93,653062,89.89153475567791,8
0.05,7265,91,653153,89.89168731076245,10
0.05,7266,95,653248,89.89239025732765,6
0.05,7267,96,653344,89.89323059988993,6
0.05,7268,94,653438,89.89379557022974,8
0.05,7269,96,653534,89.89463548830811,6
0.05,7270,96,653630,89.89547517535415,6
0.05,7271,91,653721,89.89562706270627,10
0.05,7272,94,653815,89.89619139282277,7
0.05,7273,95,653910,89.89689304371736,6
0.05,7274,93,654003,89.89731958762887,8
0.05,7275,95,654098,89.89802089059923,6
0.05,7276,94,654192,89.89858458155834,8
0.05,7277,96,654288,89.89942291838418,6
0.05,7278,94,654382,89.89998626184915,7
0.05,7279,94,654476,89.90054945054945,7
0.05,7280,94,654570,89.90111248454883,7
0.05,7281,95,654665,89.90181268882175,6
0.05,7282,91,654756,89.90196347658932,10
0.05,7283,95,654851,89.90266337177376,6
0.05,7284,96,654947,89.9035003431709,6
0.05,7285,93,655040,89.90392533626132,8
0.05,7286,93,655133,89.90435021270756,8
0.05,7287,94,655227,89.90491218441274,7
0.05,7288,93,655320,89.90533680889011,8
0.05,7289,95,655415,89.90603566529492,6
0.05,7290,95,655510,89.90673432999588,7
0.05,7291,90,655600,89.90674712013166,11
0.05,7292,96,655696,89.90758261346497,6
0.05,7293,96,655792,89.9084178777077,6
0.05,7294,91,655883,89.90856751199452,10
0.05,7295,94,655977,89.90912828947368,7
0.05,7296,94,656071,89.90968891325203,7
0.05,7297,94,656165,89.91024938339271,8
0.05,7298,94,656259,89.9108096999589,7
0.05,7299,93,656352,89.91123287671233,8
0.05,7300,91,656443,89.91138200246542,10
0.05,7301,94,656537,89.91194193371679,7
0.05,7302,91,656628,89.91209092153909,10
0.05,7303,93,656721,89.91251369112815,8
0.05,7304,19,656740,89.90280629705681,13
0.05,7305,94,656834,89.90336709553792,7
0.05,7306,94,656928,89.90392774052279,7
0.05,7307,94,657022,89.90448823207444,7
0.05,7308,93,657115,89.90491175263374,8
0.05,7309,94,657209,89.90547195622435,7
0.05,7310,93,657302,89.90589522637123,8
0.05,7311,92,657394,89.90618161925602,9
0.05,7312,94,657488,89.90674141939013,7
0.05,7313,94,657582,89.90730106644791,7
0.05,7314,96,657678,89.90813397129186,6
0.05,7315,92,657770,89.90841990158556,9
0.05,7316,95,657865,89.90911575782424,6
0.05,7317,94,657959,89.90967477452855,7
0.05,7318,92,658051,89.9099603771007,9
0.05,7319,92,658143,89.91024590163934,9
0.05,7320,94,658237,89.9108045348996,7
0.05,7321,94,658331,89.91136301556952,7
0.05,7322,94,658425,89.9119213437116,7
0.05,7323,95,658520,89.91261605679956,6
0.05,7324,96,658616,89.9134470989761,6
0.05,7325,88,658704,89.91318591318591,13
0.05,7326,92,658796,89.9134707247168,9
0.05,7327,93,658889,89.91389192139738,8
0.05,7328,95,658984,89.91458589166325,6
0.05,7329,95,659079,89.91527967257845,6
0.05,7330,94,659173,89.91583685718183,7
0.05,7331,95,659268,89.9165302782324,6
0.05,7332,92,659360,89.91681440065457,9
0.05,7333,96,659456,89.91764385055905,7
0.05,7334,95,659551,89.91833674164963,7
0.05,7335,93,659644,89.91875681570338,8
0.05,7336,95,659739,89.91944936622598,6
0.05,7337,94,659833,89.92000545107659,7
0.05,7338,94,659927,89.9205613843848,8
0.05,7339,95,660022,89.92125340599455,6
0.05,7340,92,660114,89.92153657539845,9
0.05,7341,95,660209,89.9222282756742,6
0.05,7342,94,660303,89.92278360343184,8
0.05,7343,94,660397,89.92333877995642,7
0.05,7344,94,660491,89.92389380530973,7
0.05,7345,95,660586,89.92458480805881,6
0.05,7346,91,660677,89.9247311827957,10
0.05,7347,95,660772,89.92542188350572,6
0.05,7348,94,660866,89.9259763233093,7
0.05,7349,93,660959,89.92639455782313,8
0.05,7350,96,661055,89.92722078628758,6
0.05,7351,93,661148,89.92763873775843,8
0.05,7352,95,661243,89.92832857337142,8
0.05,7353,94,661337,89.92888224095731,7
0.05,7354,95,661432,89.92957171991843,6
0.05,7355,92,661524,89.92985318107667,11
0.05,7356,95,661619,89.93054234062798,7
0.05,7357,92,661711,89.93082359336776,9
0.05,7358,94,661805,89.93137654572632,7
0.05,7359,93,661898,89.93179347826087,8
0.05,7360,93,661991,89.93221029751392,8
0.05,7361,93,662084,89.93262700353165,8
0.05,7362,95,662179,89.93331522477251,6
0.05,7363,94,662273,89.93386746333515,7
0.05,7364,26,662299,89.92518669382213,7
0.05,7365,90,662389,89.9251968503937,11
0.05,7366,94,662483,89.92574996606488,8
0.05,7367,92,662575,89.92603148751357,9
0.05,7368,94,662669,89.92658433980188,8
0.05,7369,93,662762,89.9270013568521,10
0.05,7370,95,662857,89.92768959435627,7
0.05,7371,96,662953,89.92851329354313,6
0.05,7372,94,663047,89.92906550929065,7
0.05,7373,96,663143,89.92988879848114,6
0.05,7374,96,663239,89.93071186440677,6
0.05,7375,94,663333,89.93126355748373,7
0.05,7376,93,663426,89.9316795445303,8
0.05,7377,92,663518,89.93195988072648,10
0.05,7378,94,663612,89.93251118037675,7
0.05,7379,94,663706,89.9330623306233,7
0.05,7380,94,663800,89.9336133315269,7
0.05,7381,94,663894,89.9341641831482,7
0.05,7382,96,663990,89.93498577813897,6
0.05,7383,94,664084,89.93553629469122,7
0.05,7384,21,664105,89.92620176032499,11
0.05,7385,93,664198,89.92661792580557,8
0.05,7386,94,664292,89.92716935156356,7
0.05,7387,93,664385,89.92758527341635,8
0.05,7388,92,664477,89.92786574637975,10
0.05,7389,93,664570,89.92828146143437,8
0.05,7390,94,664664,89.92883236368556,7
0.05,7391,96,664760,89.92965367965368,6
0.05,7392,95,664855,89.93033951034762,6
0.05,7393,94,664949,89.93088991073844,7
0.05,7394,94,665043,89.93144016227181,7
0.05,7395,92,665135,89.93171984856679,9
0.05,7396,95,665230,89.93240502906583,6
0.05,7397,94,665324,89.93295485266289,8
0.05,7398,93,665417,89.93336937423976,8
0.05,7399,95,665512,89.93405405405406,6
0.05,7400,95,665607,89.93473854884475,7
0.05,7401,95,665702,89.93542285868683,6
0.05,7402,94,665796,89.93597190328245,8
0.05,7403,94,665890,89.9365207995678,7
0.05,7404,94,665984,89.93706954760297,7
0.05,7405,91,666075,89.9372130704834,10
0.05,7406,95,666170,89.93789658431214,6
0.05,7407,93,666263,89.93830993520518,8
0.05,7408,96,666359,89.9391280874612,6
0.05,7409,92,666451,89.93940620782726,9
0.05,7410,96,666547,89.94022399136419,6
0.05,7411,95,666642,89.94090663788451,6
0.05,7412,94,666736,89.94145420207744,7
0.05,7413,92,666828,89.94173185864581,9
0.05,7414,96,666924,89.94254888739043,6
0.05,7415,95,667019,89.94323085221143,6
0.05,7416,96,667115,89.94404745854119,6
0.05,7417,93,667208,89.94445942302508,8
0.05,7418,94,667302,89.94500606550749,7
0.05,7419,92,667394,89.94528301886793,9
0.05,7420,94,667488,89.94582940304541,7
0.05,7421,96,667584,89.946645109135,6
0.05,7422,96,667680,89.94746059544659,6
0.05,7423,96,667776,89.94827586206897,6
0.05,7424,95,667871,89.94895622895623,6
0.05,7425,96,667967,89.94977107460275,6
0.05,7426,94,668061,89.95031641308738,7
0.05,7427,94,668155,89.95086160473883,7
0.05,7428,92,668247,89.95113743437878,9
0.05,7429,93,668340,89.95154777927321,8
0.05,7430,94,668434,89.9520925851164,7
0.05,7431,93,668527,89.95250269106566,8
0.05,7432,94,668621,89.95304722184851,7
0.05,7433,92,668713,89.95332257196664,10
0.05,7434,93,668806,89.9537323470074,8
0.05,7435,91,668897,89.9538730500269,10
0.05,7436,96,668993,89.9546860293129,7
0.05,7437,93,669086,89.95509545576768,8
0.05,7438,19,669105,89.94555719854819,13
0.05,7439,91,669196,89.94569892473119,11
0.05,7440,92,669288,89.94597500335976,10
0.05,7441,92,669380,89.9462510077936,9
0.05,7442,94,669474,89.94679564691657,8
0.05,7443,95,669569,89.94747447608812,6
0.05,7444,95,669664,89.94815312290127,6
0.05,7445,95,669759,89.9488315874295,6
0.05,7446,93,669852,89.94924130522358,8
0.05,7447,96,669948,89.95005370569281,6
0.05,7448,-52,669896,89.93099744932206,17
0.05,7449,88,669984,89.93073825503356,13
0.05,7450,27,670011,89.92229230975708,6
0.05,7451,94,670105,89.92283950617283,7
0.05,7452,93,670198,89.92325238159131,8
0.05,7453,94,670292,89.92379930238798,7
0.05,7454,93,670385,89.92421193829645,8
0.05,7455,95,670480,89.92489270386267,6
0.05,7456,96,670576,89.92570738903044,6
0.05,7457,94,670670,89.92625368731564,7
0.05,7458,93,670763,89.92666577289181,9
0.05,7459,93,670856,89.92707774798927,8
0.05,7460,96,670952,89.92789170352499,6
0.05,7461,96,671048,89.92870544090056,6
0.05,7462,92,671140,89.92898298271473,9
0.05,7463,92,671232,89.92926045016077,9
0.05,7464,23,671255,89.92029470864033,10
0.05,7465,92,671347,89.92057326547013,9
0.05,7466,95,671442,89.92125351546807,6
0.05,7467,92,671534,89.92153186930905,9
0.05,7468,91,671625,89.92167626188245,11
0.05,7469,95,671720,89.92235609103079,6
0.05,7470,94,671814,89.92290188729756,7
0.05,7471,93,671907,89.92331370449679,8
0.05,7472,94,672001,89.92385922654891,7
0.05,7473,95,672096,89.92453839978593,6
0.05,7474,94,672190,89.92508361204014,7
0.05,7475,93,672283,89.92549491706795,8
0.05,7476,94,672377,89.92603985555704,7
0.05,7477,94,672471,89.92658464830168,7
0.05,7478,94,672565,89.92712929536034,7
0.05,7479,94,672659,89.92767379679144,7
0.05,7480,95,672754,89.92835182462238,6
0.05,7481,95,672849,89.92902967121091,6
0.05,7482,93,672942,89.9294400641454,8
0.05,7483,95,673037,89.93011758417958,7
0.05,7484,95,673132,89.93079492317969,6
0.05,7485,94,673226,89.9313384985306,7
0.05,7486,95,673321,89.9320154935221,6
0.05,7487,89,673410,89.93189102564102,12
0.05,7488,95,673505,89.93256776605688,6
0.05,7489,94,673599,89.93311081441922,7
0.05,7490,94,673693,89.93365371779468,7
0.05,7491,94,673787,89.93419647624133,7
0.05,7492,94,673881,89.93473908981716,7
0.05,7493,92,673973,89.93501467840939,9
0.05,7494,95,674068,89.93569046030687,6
0.05,7495,95,674163,89.93636606189968,6
0.05,7496,95,674258,89.93704148325997,6
0.05,7497,93,674351,89.93744998666311,10
0.05,7498,93,674444,89.93785838111748,8
0.05,7499,96,674540,89.93866666666666,6
0.05,7500,94,674634,89.93920810558592,7
0.05,7501,90,674724,89.93921620901094,11
0.05,7502,90,674814,89.93922431027589,11
0.05,7503,91,674905,89.9393656716418,10
0.05,7504,96,675001,89.94017321785476,6
0.05,7505,94,675095,89.94071409539035,7
0.05,7506,94,675189,89.94125482882643,7
0.05,7507,90,675279,89.94126265316996,12
0.05,7508,94,675373,89.94180316952989,7
0.05,7509,94,675467,89.94234354194407,7
0.05,7510,95,675562,89.94301690853415,7
0.05,7511,96,675658,89.94382321618744,6
0.05,7512,92,675750,89.9440968987089,9
0.05,7513,94,675844,89.9446366782007,7
0.05,7514,92,675936,89.94491017964071,9
0.05,7515,91,676027,89.94505055880788,10
0.05,7516,96,676123,89.94585605959824,6
0.05,7517,94,676217,89.9463953179037,7
0.05,7518,96,676313,89.9472004255885,6
0.05,7519,90,676403,89.9472074468085,12
0.05,7520,95,676498,89.94787927137348,7
0.05,7521,95,676593,89.94855091730922,6
0.05,7522,95,676688,89.94922238468696,6
0.05,7523,94,676782,89.94976076555024,7
0.05,7524,94,676876,89.95029900332226,7
0.05,7525,94,676970,89.95083709806006,7
0.05,7526,95,677065,89.95150790487578,6
0.05,7527,94,677159,89.95204569606801,7
0.05,7528,90,677249,89.95205206534732,11
0.05,7529,95,677344,89.9527224435591,6
0.05,7530,96,677440,89.95352542822998,6
0.05,7531,90,677530,89.95353159851301,11
0.05,7532,94,677624,89.9540687641046,8
0.05,7533,94,677718,89.95460578709849,7
0.05,7534,-49,677669,89.93616456536165,12
0.05,7535,23,677692,89.92728237791933,10
0.05,7536,93,677785,89.92769006235903,8
0.05,7537,93,677878,89.92809763863093,8
0.05,7538,94,677972,89.92863775036477,7
0.05,7539,-44,677928,89.91087533156498,8
0.05,7540,96,678024,89.91168280068956,6
0.05,7541,92,678116,89.91195969238929,9
0.05,7542,94,678210,89.91250165716558,8
0.05,7543,94,678304,89.91304347826087,7
0.05,7544,94,678398,89.91358515573228,7
0.05,7545,94,678492,89.91412668963689,8
0.05,7546,94,678586,89.9146680800318,7
0.05,7547,94,678680,89.91520932697404,7
0.05,7548,93,678773,89.91561796264406,8
0.05,7549,95,678868,89.91629139072847,6
0.05,7550,96,678964,89.91709707323534,6
0.05,7551,95,679059,89.91777012711864,6
0.05,7552,94,679153,89.9183106050576,7
0.05,7553,94,679247,89.91885093989939,7
0.05,7554,96,679343,89.91965585704831,6
0.05,7555,95,679438,89.9203282159873,7
0.05,7556,96,679534,89.92113272462618,6
0.05,7557,95,679629,89.9218047102408,6
0.05,7558,96,679725,89.92260881068924,6
0.05,7559,95,679820,89.92328042328042,6
0.05,7560,96,679916,89.9240841158577,6
0.05,7561,94,680010,89.92462311557789,7
0.05,7562,93,680103,89.92502975009917,8
0.05,7563,92,680195,89.92530407191961,9
0.05,7564,94,680289,89.92584269662922,8
0.05,7565,92,680381,89.92611683848797,9
0.05,7566,94,680475,89.92665521342673,7
0.05,7567,96,680571,89.92745771670191,6
0.05,7568,94,680665,89.92799577222883,8
0.05,7569,95,680760,89.92866578599735,6
0.05,7570,93,680853,89.92907145687492,8
0.05,7571,95,680948,89.9297411516112,6
0.05,7572,94,681042,89.9302786214182,7
0.05,7573,96,681138,89.93108001056245,6
0.05,7574,95,681233,89.93174917491748,6
0.05,7575,94,681327,89.93228616684266,7
0.05,7576,94,681421,89.93282301702521,8
0.05,7577,24,681445,89.92412245975191,9
0.05,7578,94,681539,89.92466024541497,7
0.05,7579,94,681633,89.92519788918206,7
0.05,7580,95,681728,89.92586729982852,6
0.05,7581,90,681818,89.92587707728832,11
0.05,7582,95,681913,89.92654622181195,6
0.05,7583,94,682007,89.92708333333333,8
0.05,7584,96,682103,89.92788398154252,6
0.05,7585,92,682195,89.92815713155814,9
0.05,7586,94,682289,89.92869381837353,7
0.05,7587,94,682383,89.9292303637322,7
0.05,7588,94,682477,89.92976676769008,7
0.05,7589,95,682572,89.9304347826087,7
0.05,7590,94,682666,89.9309708865762,8
0.05,7591,93,682759,89.9313751317176,8
0.05,7592,94,682853,89.93191097063084,8
0.05,7593,94,682947,89.93244666842244,7
0.05,7594,93,683040,89.93285055957867,9
0.05,7595,93,683133,89.93325434439178,8
0.05,7596,22,683155,89.92431222851125,10
0.05,7597,94,683249,89.9248486443801,7
0.05,7598,94,683343,89.92538491906829,7
0.05,7599,94,683437,89.92592105263158,7
0.05,7600,95,683532,89.92658860676227,6
0.05,7601,94,683626,89.9271244409366,7
0.05,7602,93,683719,89.92752860712876,8
0.05,7603,94,683813,89.92806417674907,8
0.05,7604,96,683909,89.92886259040105,6
0.05,7605,90,683999,89.92887194320274,11
0.05,7606,96,684095,89.92967004075194,6
0.05,7607,94,684189,89.93020504731861,7
0.05,7608,93,684282,89.93060848994611,8
0.05,7609,93,684375,89.93101182654402,8
0.05,7610,94,684469,89.93154644593352,7
0.05,7611,94,684563,89.9320809248555,7
0.05,7612,92,684655,89.9323525548404,9
0.05,7613,93,684748,89.93275545048594,8
0.05,7614,94,684842,89.93328956007879,7
0.05,7615,92,684934,89.93356092436974,9
0.05,7616,92,685026,89.93383221740842,9
0.05,7617,94,685120,89.93436597532161,7
0.05,7618,95,685215,89.93503084394277,6
0.05,7619,91,685306,89.93517060367454,10
0.05,7620,92,685398,89.93544154310457,9
0.05,7621,93,685491,89.9358436106009,8
0.05,7622,96,685587,89.9366391184573,6
0.05,7623,96,685683,89.93743441762854,6
0.05,7624,88,685771,89.93718032786886,13
0.05,7625,96,685867,89.93797534749541,6
0.05,7626,93,685960,89.93837681919497,8
0.05,7627,92,686052,89.93864708966964,9
0.05,7628,94,686146,89.93917944684756,7
0.05,7629,93,686239,89.93958060288335,8
0.05,7630,93,686332,89.93998165378063,8
0.05,7631,93,686425,89.94038259958072,8
0.05,7632,93,686518,89.9407834403249,8
0.05,7633,94,686612,89.94131516898088,7
0.05,7634,89,686701,89.9411918795023,12
0.05,7635,95,686796,89.94185437401781,6
0.05,7636,94,686890,89.94238575356816,7
0.05,7637,96,686986,89.94317884262897,6
0.05,7638,90,687076,89.94318628092682,11
0.05,7639,92,687168,89.9434554973822,9
0.05,7640,93,687261,89.94385551629368,8
0.05,7641,91,687352,89.94399371892175,10
0.05,7642,91,687443,89.94413188538532,10
0.05,7643,91,687534,89.94427001569859,10
0.05,7644,94,687628,89.9448005232178,7
0.05,7645,93,687721,89.94520010462988,8
0.05,7646,94,687815,89.94573035177194,8
0.05,7647,93,687908,89.94612970711297,8
0.05,7648,94,688002,89.94665969407765,8
0.05,7649,94,688096,89.94718954248366,7
0.05,7650,92,688188,89.94745784864723,9
0.05,7651,94,688282,89.94798745426033,8
0.05,7652,27,688309,89.93976218476415,6
0.05,7653,94,688403,89.94029265743403,7
0.05,7654,94,688497,89.94082299150882,7
0.05,7655,93,688590,89.94122257053291,8
0.05,7656,94,688684,89.9417526446389,7
0.05,7657,96,688780,89.94254374510317,6
0.05,7658,96,688876,89.94333463898681,6
0.05,7659,94,688970,89.94386422976501,7
0.05,7660,96,689066,89.94465474481139,6
0.05,7661,94,689160,89.94518402505874,7
0.05,7662,95,689255,89.94584366436122,6
0.05,7663,90,689345,89.94585073068893,11
0.05,7664,96,689441,89.94664057403783,6
0.05,7665,95,689536,89.94729976519697,6
0.05,7666,91,689627,89.94743706795357,10
0.05,7667,95,689722,89.94809598330725,6
0.05,7668,25,689747,89.93962707002217,8
0.05,7669,95,689842,89.94028683181226,6
0.05,7670,93,689935,89.9406856993873,8
0.05,7671,96,690031,89.94147549530761,6
0.05,7672,94,690125,89.94200443112211,7
0.05,7673,94,690219,89.94253322908523,7
0.05,7674,94,690313,89.94306188925081,7
0.05,7675,94,690407,89.94359041167274,7
0.05,7676,96,690503,89.94437931483652,6
0.05,7677,94,690597,89.94490752800209,7
0.05,7678,95,690692,89.94556582888397,6
0.05,7679,95,690787,89.94622395833333,6
0.05,7680,96,690883,89.94701210779846,6
0.05,7681,96,690979,89.94780005206978,6
0.05,7682,95,691074,89.94845763373682,6
0.05,7683,96,691170,89.94924518479958,6
0.05,7684,94,691264,89.94977228366949,7
0.05,7685,96,691360,89.95055945875617,6
0.05,7686,93,691453,89.95095615975023,8
0.05,7687,92,691545,89.95122268470344,9
0.05,7688,96,691641,89.95200936402654,6
0.05,7689,93,691734,89.95240572171652,8
0.05,7690,96,691830,89.95319204264725,6
0.05,7691,95,691925,89.95384815392616,6
0.05,7692,90,692015,89.95385415312622,11
0.05,7693,95,692110,89.95451000779829,6
0.05,7694,96,692206,89.95529564652372,6
0.05,7695,96,692302,89.95608108108108,6
0.05,7696,93,692395,89.95647654930492,8
0.05,7697,91,692486,89.95661210704078,10
0.05,7698,94,692580,89.95713729055721,7
0.05,7699,-46,692534,89.93948051948053,9
0.05,7700,23,692557,89.93078820932347,10
0.05,7701,94,692651,89.93131654115814,7
0.05,7702,94,692745,89.93184473581721,8
0.05,7703,27,692772,89.92367601246106,6
0.05,7704,94,692866,89.92420506164828,7
0.05,7705,94,692960,89.92473397352713,8
0.05,7706,96,693056,89.92552225249773,6
0.05,7707,94,693150,89.92605085625324,7
0.05,7708,95,693245,89.9267090413802,6
0.05,7709,95,693340,89.92736705577173,6
0.05,7710,92,693432,89.9276358448969,9
0.05,7711,96,693528,89.92842323651452,6
0.05,7712,95,693623,89.92908077272138,7
0.05,7713,92,693715,89.92934923515686,10
0.05,7714,96,693811,89.9301360985094,6
0.05,7715,94,693905,89.93066355624676,7
0.05,7716,94,693999,89.93119087728392,7
0.05,7717,93,694092,89.93158849442861,8
0.05,7718,96,694188,89.93237465993005,6
0.05,7719,92,694280,89.93264248704664,9
0.05,7720,93,694373,89.9330397616889,8
0.05,7721,93,694466,89.93343693343694,8
0.05,7722,95,694561,89.93409296905348,6
0.05,7723,27,694588,89.92594510616262,6
0.05,7724,91,694679,89.92608414239483,10
0.05,7725,96,694775,89.92687030805074,6
0.05,7726,96,694871,89.9276562702213,6
0.05,7727,96,694967,89.9284420289855,6
0.05,7728,93,695060,89.92883943589081,8
0.05,7729,93,695153,89.92923673997413,8
0.05,7730,93,695246,89.92963394127538,8
0.05,7731,93,695339,89.93003103983446,8
0.05,7732,95,695434,89.93068666752878,7
0.05,7733,93,695527,89.93108352728213,8
0.05,7734,95,695622,89.93173884938591,6
0.05,7735,94,695716,89.93226473629782,7
0.05,7736,93,695809,89.93266123820602,8
0.05,7737,89,695898,89.93254070819333,12
0.05,7738,92,695990,89.93280785631218,9
0.05,7739,94,696084,89.93333333333334,7
0.05,7740,94,696178,89.93385867458984,7
0.05,7741,93,696271,89.93425471454404,8
0.05,7742,94,696365,89.93477980111068,7
0.05,7743,19,696384,89.92561983471074,13
0.05,7744,95,696479,89.92627501613944,6
0.05,7745,94,696573,89.92680092951201,7
0.05,7746,94,696667,89.92732670711243,7
0.05,7747,85,696752,89.92669075890552,16
0.05,7748,94,696846,89.92721641502129,7
0.05,7749,92,696938,89.92748387096775,9
0.05,7750,95,697033,89.92813830473487,6
0.05,7751,94,697127,89.92866357069144,7
0.05,7752,-49,697078,89.91074422804076,13
0.05,7753,95,697173,89.91140056744906,7
0.05,7754,25,697198,89.9030303030303,8
0.05,7755,94,697292,89.90355853532749,8
0.05,7756,94,697386,89.90408663142968,8
0.05,7757,95,697481,89.90474349059036,7
0.05,7758,93,697574,89.9051424152597,8
0.05,7759,96,697670,89.90592783505154,6
0.05,7760,92,697762,89.90619765494138,9
0.05,7761,95,697857,89.90685390363308,6
0.05,7762,93,697950,89.90725235089528,8
0.05,7763,94,698044,89.90777949510561,7
0.05,7764,93,698137,89.90817772054089,8
0.05,7765,93,698230,89.90857584342004,9
0.05,7766,94,698324,89.90910261362173,7
0.05,7767,93,698417,89.90950051493306,8
0.05,7768,96,698513,89.91028446389497,6
0.05,7769,94,698607,89.91081081081082,7
0.05,7770,96,698703,89.91159438939647,6
0.05,7771,94,698797,89.91212043232115,7
0.05,7772,93,698890,89.91251768943779,8
0.05,7773,93,698983,89.91291484435297,8
0.05,7774,96,699079,89.91369774919615,6
0.05,7775,91,699170,89.91383744855968,10
0.05,7776,93,699263,89.91423428057091,8
0.05,7777,93,699356,89.91463101054255,8
0.05,7778,90,699446,89.91464198483095,11
0.05,7779,93,699539,89.9150385604113,8
0.05,7780,93,699632,89.91543503405732,8
0.05,7781,96,699728,89.91621691081984,6
0.05,7782,96,699824,89.91699858666324,6
0.05,7783,93,699917,89.917394655704,8
0.05,7784,96,700013,89.91817597944765,6
0.05,7785,94,700107,89.91870023118418,7
0.05,7786,91,700198,89.91883909079235,10
0.05,7787,93,700291,89.91923472008217,8
0.05,7788,92,700383,89.9195018615997,9
0.05,7789,95,700478,89.9201540436457,7
0.05,7790,92,700570,89.92042099858811,9
0.05,7791,93,700663,89.92081622176592,8
0.05,7792,94,700757,89.92133966380085,7
0.05,7793,94,700851,89.92186297151655,7
0.05,7794,93,700944,89.92225785760102,8
0.05,7795,94,701038,89.92278091328886,7
0.05,7796,93,701131,89.92317558035141,8
0.05,7797,92,701223,89.92344190818159,9
0.05,7798,92,701315,89.92370816771381,9
0.05,7799,95,701410,89.92435897435898,6
0.05,7800,94,701504,89.92488142545828,8
0.05,7801,27,701531,89.91681620097411,6
0.05,7802,89,701620,89.91669870562605,12
0.05,7803,91,701711,89.9168375192209,10
0.05,7804,94,701805,89.91736066623959,7
0.05,7805,94,701899,89.9178836792211,7
0.05,7806,96,701995,89.91866273856795,6
0.05,7807,91,702086,89.91880122950819,10
0.05,7808,93,702179,89.91919579971827,8
0.05,7809,94,702273,89.91971830985915,7
0.05,7810,92,702365,89.91998463705032,9
0.05,7811,93,702458,89.92037890424987,8
0.05,7812,92,702550,89.92064507871497,9
0.05,7813,95,702645,89.92129511133862,6
0.05,7814,94,702739,89.92181701855407,7
0.05,7815,94,702833,89.92233879222108,7
0.05,7816,95,702928,89.92298835870538,6
0.05,7817,95,703023,89.92363775901765,6
0.05,7818,92,703115,89.92390331244404,9
0.05,7819,94,703209,89.92442455242967,7
0.05,7820,96,703305,89.92520138089759,6
0.05,7821,94,703399,89.92572232165686,7
0.05,7822,92,703491,89.92598747283651,9
0.05,7823,94,703585,89.9265081799591,7
0.05,7824,96,703681,89.92728434504792,6
0.05,7825,95,703776,89.9279325325837,7
0.05,7826,95,703871,89.92858055449086,6
0.05,7827,94,703965,89.92910066428206,7
0.05,7828,91,704056,89.92923745050453,11
0.05,7829,92,704148,89.92950191570881,9
0.05,7830,92,704240,89.92976631336994,9
0.05,7831,93,704333,89.93015832482125,8
0.05,7832,92,704425,89.93042257117324,9
0.05,7833,93,704518,89.93081439877457,8
0.05,7834,94,704612,89.93133375877473,8
0.05,7835,96,704708,89.93210821847882,6
0.05,7836,96,704804,89.93288248054102,6
0.05,7837,94,704898,89.93340137790253,7
0.05,7838,94,704992,89.93392014287537,7
0.05,7839,92,705084,89.93418367346939,9
0.05,7840,95,705179,89.93482974110445,6
0.05,7841,94,705273,89.9353481254782,7
0.05,7842,94,705367,89.93586637766161,7
0.05,7843,95,705462,89.9365119836818,6
0.05,7844,91,705553,89.93664754620778,10
0.05,7845,93,705646,89.93703798113688,9
0.05,7846,96,705742,89.93781062826558,6
0.05,7847,96,705838,89.93858307849133,6
0.05,7848,93,705931,89.9389731175946,9
0.05,7849,95,706026,89.93961783439491,6
0.05,7850,93,706119,89.94000764233856,8
0.05,7851,94,706213,89.940524707081,7
0.05,7852,93,706306,89.94091430026741,8
0.05,7853,93,706399,89.94130379424497,8
0.05,7854,94,706493,89.94182049649905,8
0.05,7855,96,706589,89.9425916496945,6
0.05,7856,94,706683,89.94310805651011,7
0.05,7857,96,706779,89.94387884958005,6
0.05,7858,94,706873,89.944394961191,7
0.05,7859,94,706967,89.94491094147583,7
0.05,7860,92,707059,89.94517236992749,9
0.05,7861,95,707154,89.94581531416942,6
0.05,7862,95,707249,89.94645809487473,7
0.05,7863,91,707340,89.94659206510681,10
0.05,7864,94,707434,89.94710743801653,8
0.05,7865,94,707528,89.94762267988813,7
0.05,7866,90,707618,89.94762933773993,11
0.05,7867,94,707712,89.94814438230809,7
0.05,7868,94,707806,89.94865929597154,7
0.05,7869,95,707901,89.94930114358323,6
0.05,7870,96,707997,89.9500698767628,6
0.05,7871,94,708091,89.9505843495935,7
0.05,7872,96,708187,89.95135272450146,6
0.05,7873,96,708283,89.95212090424181,6
0.05,7874,93,708376,89.95250793650794,8
0.05,7875,95,708471,89.95314880650076,6
0.05,7876,95,708566,89.95378951377428,6
0.05,7877,92,708658,89.95404925107896,9
0.05,7878,95,708753,89.95468968143166,6
0.05,7879,94,708847,89.95520304568528,7
0.05,7880,23,708870,89.94670727065093,9
0.05,7881,94,708964,89.94722151738138,7
0.05,7882,94,709058,89.94773563364201,7
0.05,7883,94,709152,89.9482496194825,7
0.05,7884,93,709245,89.94863665187064,8
0.05,7885,93,709338,89.94902358610196,8
0.05,7886,94,709432,89.94953721313554,8
0.05,7887,94,709526,89.95005070993915,7
0.05,7888,92,709618,89.95031055900621,11
0.05,7889,89,709707,89.95019011406845,14
0.05,7890,96,709803,89.95095678621215,6
0.05,7891,93,709896,89.95134313228586,8
0.05,7892,95,709991,89.95198276954264,7
0.05,7893,94,710085,89.95249556625285,7
0.05,7894,95,710180,89.95313489550348,6
0.05,7895,21,710201,89.9444022289767,11
0.05,7896,96,710297,89.94516905153856,6
0.05,7897,93,710390,89.94555583692073,8
0.05,7898,96,710486,89.94632231928092,6
0.05,7899,96,710582,89.94708860759494,6
0.05,7900,93,710675,89.94747500316416,8
0.05,7901,96,710771,89.94824095165781,6
0.05,7902,95,710866,89.94888017208655,7
0.05,7903,94,710960,89.9493927125506,7
0.05,7904,92,711052,89.94965211891208,9
0.05,7905,94,711146,89.9501644320769,7
0.05,7906,95,711241,89.95080308587328,6
0.05,7907,92,711333,89.951062215478,9
0.05,7908,93,711426,89.95144771778986,8
0.05,7909,95,711521,89.95208596713022,6
0.05,7910,93,711614,89.95247124257364,8
0.05,7911,93,711707,89.9528564206269,8
0.05,7912,96,711803,89.95362062428914,6
0.05,7913,95,711898,89.95425827647207,6
0.05,7914,96,711994,89.95502210991788,6
0.05,7915,95,712089,89.95565942395149,7
0.05,7916,95,712184,89.95629657698623,6
0.05,7917,94,712278,89.95680727456428,7
0.05,7918,96,712374,89.95757040030307,6
0.05,7919,93,712467,89.95795454545454,8
0.05,7920,92,712559,89.95821234692589,9
0.05,7921,95,712654,89.95884877556173,6
0.05,7922,94,712748,89.9593588287265,7
0.05,7923,92,712840,89.95961635537607,9
0.05,7924,92,712932,89.9598738170347,10
0.05,7925,96,713028,89.96063588190765,6
0.05,7926,90,713118,89.96064084773559,11
0.05,7927,94,713212,89.96115035317861,8
0.05,7928,95,713307,89.96178584941354,6
0.05,7929,94,713401,89.96229508196721,8
0.05,7930,92,713493,89.9625520110957,9
0.05,7931,94,713587,89.96306101865859,8
0.05,7932,94,713681,89.96356989789487,7
0.05,7933,93,713774,89.96395260902445,8
0.05,7934,94,713868,89.96446124763705,7
0.05,7935,94,713962,89.96496975806451,8
0.05,7936,93,714055,89.96535214816682,8
0.05,7937,93,714148,89.96573444192492,8
0.05,7938,95,714243,89.96636856027207,6
0.05,7939,93,714336,89.96675062972292,8
0.05,7940,95,714431,89.96738446039542,6
0.05,7941,92,714523,89.96764039284815,9
0.05,7942,90,714613,89.96764446682613,11
0.05,7943,93,714706,89.96802618328299,8
0.05,7944,92,714798,89.96828193832599,9
0.05,7945,93,714891,89.96866347847974,8
0.05,7946,93,714984,89.96904492261231,8
0.05,7947,95,715079,89.96967790639154,6
0.05,7948,96,715175,89.97043653289722,6
0.05,7949,92,715267,89.97069182389937,9
0.05,7950,95,715362,89.9713243617155,6
0.05,7951,93,715455,89.97170523138833,9
0.05,7952,95,715550,89.97233748271093,6
0.05,7953,96,715646,89.97309529796328,6
0.05,7954,95,715741,89.97372721558769,6
0.05,7955,92,715833,89.97398190045249,9
0.05,7956,94,715927,89.97448787231369,7
0.05,7957,91,716018,89.97461673787383,10
0.05,7958,91,716109,89.97474557105164,10
0.05,7959,95,716204,89.9753768844221,6
0.05,7960,91,716295,89.97550558975003,11
0.05,7961,18,716313,89.96646571213263,14
0.05,7962,94,716407,89.96697224664071,7
0.05,7963,94,716501,89.96747865394275,7
0.05,7964,93,716594,89.96785938480853,8
0.05,7965,93,716687,89.96824002008536,9
0.05,7966,94,716781,89.96874607756997,7
0.05,7967,94,716875,89.96925200803213,7
0.05,7968,94,716969,89.96975781151964,7
0.05,7969,95,717064,89.97038895859473,6
0.05,7970,93,717157,89.97076903776188,8
0.05,7971,95,717252,89.97139989964877,6
0.05,7972,94,717346,89.97190517998244,7
0.05,7973,90,717436,89.97190870328568,11
0.05,7974,90,717526,89.97191222570532,11
0.05,7975,93,717619,89.97229187562688,8
0.05,7976,93,717712,89.9726714303623,8
0.05,7977,95,717807,89.9733015793432,6
0.05,7978,96,717903,89.97405689936082,6
0.05,7979,94,717997,89.97456140350877,7
0.05,7980,88,718085,89.97431399573988,13
0.05,7981,94,718179,89.97481834126785,7
0.05,7982,94,718273,89.97532256044094,7
0.05,7983,94,718367,89.97582665330661,7
0.05,7984,92,718459,89.97608015028177,9
0.05,7985,94,718553,89.97658402203857,7
0.05,7986,96,718649,89.97733817453361,6
0.05,7987,90,718739,89.97734101151728,11
0.05,7988,93,718832,89.97771936412568,8
0.05,7989,95,718927,89.97834793491865,6
0.05,7990,95,719022,89.97897634839194,6
0.05,7991,94,719116,89.97947947947948,7
0.05,7992,94,719210,89.9799824846741,7
0.05,7993,94,719304,89.98048536402301,7
0.05,7994,95,719399,89.98111319574734,6
0.05,7995,95,719494,89.98174087043522,6
0.05,7996,92,719586,89.9819932474678,9
0.05,7997,95,719681,89.98262065516379,6
0.05,7998,95,719776,89.98324790598825,7
0.05,7999,91,719867,89.983375,10
0.05,8000,96,719963,89.98412698412699,6
0.05,8001,93,720056,89.98450387403149,8
0.05,8002,92,720148,89.98475571660627,9
0.05,8003,93,720241,89.98513243378311,8
0.05,8004,95,720336,89.98575890068707,6
0.05,8005,94,720430,89.98626030477142,8
0.05,8006,93,720523,89.98663669289371,8
0.05,8007,93,720616,89.98701298701299,8
0.05,8008,94,720710,89.98751404669747,8
0.05,8009,93,720803,89.98789013732834,9
0.05,8010,94,720897,89.98839096242666,7
0.05,8011,93,720990,89.98876684972541,8
0.05,8012,92,721082,89.98901784600025,9
0.05,8013,92,721174,89.98926877963564,9
0.05,8014,96,721270,89.99001871490954,6
0.05,8015,94,721364,89.99051896207585,8
0.05,8016,94,721458,89.99101908444555,8
0.05,8017,92,721550,89.99126964330257,9
0.05,8018,96,721646,89.99201895498192,6
0.05,8019,94,721740,89.9925187032419,7
0.05,8020,93,721833,89.99289365415784,8
0.05,8021,92,721925,89.9931438544004,10
0.05,8022,96,722021,89.99389255889318,6
0.05,8023,94,722115,89.99439182452642,7
0.05,8024,95,722210,89.995015576324,6
0.05,8025,96,722306,89.9957637677548,6
0.05,8026,94,722400,89.99626261367884,7
0.05,8027,95,722495,89.99688589935226,6
0.05,8028,95,722590,89.99750902976709,6
0.05,8029,89,722679,89.99738480697386,12
0.05,8030,94,722773,89.99788320258996,7
0.05,8031,96,722869,89.99863047808765,6
0.05,8032,92,722961,89.99887962156106,9
0.05,8033,94,723055,89.9993776450087,7
0.05,8034,90,723145,89.99937772246422,11
0.05,8035,96,723241,90.00012444001992,6
0.05,8036,96,723337,90.00087097175563,6
0.05,8037,92,723429,90.00111968151282,9
0.05,8038,96,723525,90.00186590371936,6
0.05,8039,92,723617,90.00211442786069,9
0.05,8040,93,723710,90.00248725282925,9
0.05,8041,95,723805,90.00310867943298,6
0.05,8042,93,723898,90.00348128807659,8
0.05,8043,91,723989,90.00360517155644,10
0.05,8044,91,724080,90.00372902423865,10
0.05,8045,92,724172,90.00397713149391,9
0.05,8046,94,724266,90.00447371691314,8
0.05,8047,94,724360,90.00497017892644,7
0.05,8048,94,724454,90.00546651757982,7
0.05,8049,92,724546,90.00571428571429,9
0.05,8050,94,724640,90.00621040864489,7
0.05,8051,91,724731,90.00633383010432,10
0.05,8052,92,724823,90.00658139823668,9
0.05,8053,94,724917,90.00707722870624,7
0.05,8054,91,725008,90.00720049658597,10
0.05,8055,95,725103,90.00782025819265,6
0.05,8056,95,725198,90.00843986595507,6
0.05,8057,90,725288,90.0084388185654,11
0.05,8058,96,725384,90.00918228067998,6
0.05,8059,91,725475,90.00930521091811,10
0.05,8060,94,725569,90.009800272919,7
0.05,8061,93,725662,90.0101711734061,8
0.05,8062,96,725758,90.01091405184175,6
0.05,8063,96,725854,90.01165674603175,6
0.05,8064,96,725950,90.01239925604463,6
0.05,8065,96,726046,90.01314158194891,6
0.05,8066,92,726138,90.01338787653403,9
0.05,8067,96,726234,90.01412989588498,6
0.05,8068,95,726329,90.01474780022308,7
0.05,8069,95,726424,90.01536555142503,6
0.05,8070,93,726517,90.01573534877959,8
0.05,8071,96,726613,90.01647670961349,6
0.05,8072,93,726706,90.01684627771584,8
0.05,8073,96,726802,90.01758731731483,6
0.05,8074,94,726896,90.01808049535603,8
0.05,8075,94,726990,90.018573551263,7
0.05,8076,94,727084,90.0190664850811,7
0.05,8077,92,727176,90.01931171081951,9
0.05,8078,94,727270,90.0198044312415,8
0.05,8079,93,727363,90.02017326732673,9
0.05,8080,95,727458,90.02078950624923,6
0.05,8081,95,727553,90.02140559267508,6
0.05,8082,94,727647,90.02189781021897,7
0.05,8083,94,727741,90.02238990598714,8
0.05,8084,93,727834,90.02275819418676,8
0.05,8085,94,727928,90.02325006183527,7
0.05,8086,93,728021,90.02361815259057,9
0.05,8087,96,728117,90.02435707220573,6
0.05,8088,93,728210,90.02472493509704,8
0.05,8089,96,728306,90.02546353522868,6
0.05,8090,94,728400,90.0259547645532,7
0.05,8091,96,728496,90.02669303015324,6
0.05,8092,94,728590,90.02718398616088,8
0.05,8093,94,728684,90.02767482085495,7
0.05,8094,93,728777,90.02804200123533,8
0.05,8095,94,728871,90.02853260869566,7
0.05,8096,93,728964,90.02889959244165,8
0.05,8097,93,729057,90.02926648555199,8
0.05,8098,95,729152,90.02988023212743,6
0.05,8099,94,729246,90.03037037037036,7
0.05,8100,93,729339,90.03073694605604,8
0.05,8101,96,729435,90.03147371019502,6
0.05,8102,94,729529,90.03196347031964,7
0.05,8103,92,729621,90.03220631786772,9
0.05,8104,90,729711,90.03220234423196,11
0.05,8105,92,729803,90.03244510239328,9
0.05,8106,93,729896,90.03281115085728,8
0.05,8107,27,729923,90.02503700049334,6
0.05,8108,93,730016,90.02540387224072,9
0.05,8109,94,730110,90.02589395807645,7
0.05,8110,-48,730062,90.00887683392924,11
0.05,8111,96,730158,90.00961538461539,6
0.05,8112,92,730250,90.00986071736719,9
0.05,8113,95,730345,90.01047572097609,6
0.05,8114,96,730441,90.01121380160197,6
0.05,8115,94,730535,90.01170527353376,7
0.05,8116,96,730631,90.0124430208205,6
0.05,8117,95,730726,90.0130574033013,6
0.05,8118,94,730820,90.01354846655993,7
0.05,8119,94,730914,90.01403940886699,7
0.05,8120,94,731008,90.01453023026721,7
0.05,8121,95,731103,90.01514405318888,6
0.05,8122,93,731196,90.01551151052567,8
0.05,8123,94,731290,90.01600196947317,7
0.05,8124,95,731385,90.01661538461538,6
0.05,8125,95,731480,90.01722864878168,8
0.05,8126,92,731572,90.01747262212379,9
0.05,8127,92,731664,90.01771653543307,9
0.05,8128,94,731758,90.01820642145405,7
0.05,8129,94,731852,90.01869618696188,7
0.05,8130,96,731948,90.01943180420612,6
0.05,8131,26,731974,90.01155927201181,8
0.05,8132,95,732069,90.01217263002582,7
0.05,8133,94,732163,90.01266289648389,7
0.05,8134,93,732256,90.01303011677935,8
0.05,8135,94,732350,90.01352015732547,7
0.05,8136,92,732442,90.0137642865921,9
0.05,8137,96,732538,90.01449987711969,6
0.05,8138,95,732633,90.01511242167342,6
0.05,8139,96,732729,90.01584766584767,6
0.05,8140,90,732819,90.01584571919912,11
0.05,8141,94,732913,90.01633505281258,8
0.05,8142,93,733006,90.01670146137788,8
0.05,8143,93,733099,90.01706777996071,8
0.05,8144,91,733190,90.0171884591774,10
0.05,8145,96,733286,90.0179229069482,6
0.05,8146,96,733382,90.01865717442003,6
0.05,8147,95,733477,90.01926853215512,6
0.05,8148,93,733570,90.0196343109584,8
0.05,8149,95,733665,90.020245398773,6
0.05,8150,92,733757,90.02048828364617,9
0.05,8151,96,733853,90.02122178606477,6
0.05,8152,94,733947,90.0217098000736,8
0.05,8153,92,734039,90.02195241599215,9
0.05,8154,92,734131,90.02219497240957,9
0.05,8155,94,734225,90.02268268759195,7
0.05,8156,94,734319,90.02317028319236,7
0.05,8157,95,734414,90.02378033831822,6
0.05,8158,92,734506,90.0240225517833,9
0.05,8159,95,734601,90.02463235294118,7
0.05,8160,90,734691,90.02462933464037,11
0.05,8161,93,734784,90.02499387405048,8
0.05,8162,94,734878,90.02548082812692,7
0.05,8163,96,734974,90.02621264086233,6
0.05,8164,94,735068,90.02669932639314,7
0.05,8165,96,735164,90.02743081067842,6
0.05,8166,96,735260,90.028162115832,6
0.05,8167,95,735355,90.0287708129285,6
0.05,8168,94,735449,90.02925694699474,8
0.05,8169,94,735543,90.0297429620563,7
0.05,8170,93,735636,90.03010647411577,8
0.05,8171,92,735728,90.03034752814489,9
0.05,8172,94,735822,90.03083323137159,7
0.05,8173,95,735917,90.03144115488134,6
0.05,8174,92,736009,90.03168195718655,9
0.05,8175,93,736102,90.03204500978474,8
0.05,8176,93,736195,90.03240797358444,8
0.05,8177,93,736288,90.03277084861824,9
0.05,8178,95,736383,90.03337816358967,8
0.05,8179,93,736476,90.03374083129584,8
0.05,8180,96,736572,90.03447011367804,6
0.05,8181,94,736666,90.03495477878269,7
0.05,8182,94,736760,90.03543932543077,7
0.05,8183,94,736854,90.03592375366568,7
0.05,8184,94,736948,90.03640806353084,7
0.05,8185,96,737044,90.03713657463963,6
0.05,8186,90,737134,90.03713203859778,11
0.05,8187,92,737226,90.03737176355642,9
0.05,8188,93,737319,90.03773354499938,9
0.05,8189,91,737410,90.03785103785104,10
0.05,8190,94,737504,90.03833475766085,7
0.05,8191,95,737599,90.0389404296875,6
0.05,8192,93,737692,90.03930184303674,8
0.05,8193,94,737786,90.03978520868928,7
0.05,8194,94,737880,90.04026845637584,7
0.05,8195,95,737975,90.04087359687652,6
0.05,8196,92,738067,90.04111260217152,9
0.05,8197,95,738162,90.04171749207124,6
0.05,8198,94,738256,90.0422002683254,7
0.05,8199,94,738350,90.04268292682927,7
0.05,8200,93,738443,90.04304353127668,8
0.05,8201,93,738536,90.04340404779322,8
0.05,8202,90,738626,90.04339875655248,11
0.05,8203,95,738721,90.04400292540224,6
0.05,8204,93,738814,90.04436319317489,8
0.05,8205,95,738909,90.04496709724592,6
0.05,8206,96,739005,90.04569270135251,6
0.05,8207,96,739101,90.04641812865498,6
0.05,8208,94,739195,90.04689974418321,7
0.05,8209,94,739289,90.04738124238733,7
0.05,8210,94,739383,90.0478626233102,9
0.05,8211,94,739477,90.04834388699464,7
0.05,8212,94,739571,90.0488250334835,7
0.05,8213,93,739664,90.0491843194546,8
0.05,8214,94,739758,90.04966524650031,8
0.05,8215,95,739853,90.05026777020448,7
0.05,8216,95,739948,90.0508701472557,7
0.05,8217,95,740043,90.05147237770747,6
0.05,8218,91,740134,90.05158778440199,10
0.05,8219,96,740230,90.05231143552311,6
0.05,8220,94,740324,90.05279163118843,7
0.05,8221,94,740418,90.05327171004622,7
0.05,8222,94,740512,90.05375167213913,7
0.05,8223,92,740604,90.05398832684826,9
0.05,8224,94,740698,90.05446808510638,7
0.05,8225,95,740793,90.05506929248723,8
0.05,8226,95,740888,90.05567035371338,6
0.05,8227,94,740982,90.05614973262033,7
0.05,8228,94,741076,90.05662899501762,7
0.05,8229,95,741171,90.05722964763062,6
0.05,8230,94,741265,90.05770866237395,8
0.05,8231,94,741359,90.05818756073859,7
0.05,8232,95,741454,90.0587878051743,6
0.05,8233,90,741544,90.05878066553315,11
0.05,8234,95,741639,90.05938069216758,6
0.05,8235,93,741732,90.05973773676541,8
0.05,8236,95,741827,90.06033750151754,6
0.05,8237,94,741921,90.06081573197378,7
0.05,8238,96,742017,90.06153659424687,6
0.05,8239,95,742112,90.0621359223301,6
0.05,8240,96,742208,90.06285644946001,6
0.05,8241,92,742300,90.06309148264984,9
0.05,8242,94,742394,90.06356908892394,7
0.05,8243,94,742488,90.06404657933042,7
0.05,8244,92,742580,90.06428138265616,9
0.05,8245,94,742674,90.06475867087073,7
0.05,8246,93,742767,90.0651145871226,8
0.05,8247,94,742861,90.0655916585839,8
0.05,8248,25,742886,90.05770396411687,7
0.05,8249,94,742980,90.05818181818182,8
0.05,8250,94,743074,90.05865955641741,7
0.05,8251,92,743166,90.05889481337857,10
0.05,8252,95,743261,90.05949351750878,6
0.05,8253,94,743355,90.05997092318876,7
0.05,8254,89,743444,90.05984251968503,12
0.05,8255,94,743538,90.06031976744185,7
0.05,8256,91,743629,90.06043357151508,10
0.05,8257,94,743723,90.06091063211431,7
0.05,8258,95,743818,90.06150865722242,6
0.05,8259,93,743911,90.06186440677966,8
0.05,8260,92,744003,90.06209901948917,9
0.05,8261,95,744098,90.06269668361172,6
0.05,8262,94,744192,90.06317318165316,7
0.05,8263,93,744285,90.06352855759923,8
0.05,8264,94,744379,90.06400483968542,7
0.05,8265,94,744473,90.06448100653279,7
0.05,8266,94,744567,90.06495705818314,8
0.05,8267,92,744659,90.06519109820997,9
0.05,8268,96,744755,90.06590881605999,6
0.05,8269,92,744847,90.06614268440146,9
0.05,8270,93,744940,90.06649740055616,9
0.05,8271,93,745033,90.06685203094777,8
0.05,8272,95,745128,90.06744832587937,6
0.05,8273,95,745223,90.06804447667392,7
0.05,8274,92,745315,90.06827794561933,9
0.05,8275,96,745411,90.06899468342195,6
0.05,8276,90,745501,90.06898634771052,11
0.05,8277,92,745593,90.06921961826528,9
0.05,8278,95,745688,90.06981519507187,6
0.05,8279,92,745780,90.07004830917874,9
0.05,8280,94,745874,90.0705228837097,7
0.05,8281,95,745969,90.0711180874185,6
0.05,8282,24,745993,90.06314137389835,9
0.05,8283,94,746087,90.06361661033317,8
0.05,8284,96,746183,90.06433313216657,6
0.05,8285,94,746277,90.06480811006517,7
0.05,8286,95,746372,90.06540364426209,6
0.05,8287,94,746466,90.06587837837837,8
0.05,8288,93,746559,90.06623235613463,8
0.05,8289,92,746651,90.06646562123039,9
0.05,8290,95,746746,90.06706066819443,6
0.05,8291,94,746840,90.0675349734684,7
0.05,8292,95,746935,90.06812974798022,7
0.05,8293,96,747031,90.06884494815529,6
0.05,8294,90,747121,90.06883664858348,11
0.05,8295,95,747216,90.06943105110896,6
0.05,8296,93,747309,90.06978425937086,9
0.05,8297,95,747404,90.0703784044348,6
0.05,8298,94,747498,90.07085190986867,7
0.05,8299,93,747591,90.07120481927711,8
0.05,8300,92,747683,90.07143717624382,9
0.05,8301,93,747776,90.07178993013731,8
0.05,8302,89,747865,90.07166084547754,12
0.05,8303,96,747961,90.07237475915221,6
0.05,8304,94,748055,90.0728476821192,7
0.05,8305,96,748151,90.07356128100169,6
0.05,8306,96,748247,90.07427470807752,6
0.05,8307,94,748341,90.07474723158401,7
0.05,8308,94,748435,90.07521964135275,7
0.05,8309,90,748525,90.07521058965102,11
0.05,8310,94,748619,90.07568282998436,7
0.05,8311,95,748714,90.07627526467758,6
0.05,8312,96,748810,90.07698785035487,6
0.05,8313,95,748905,90.07757998556652,7
0.05,8314,27,748932,90.0699939867709,7
0.05,8315,96,749028,90.07070707070707,6
0.05,8316,95,749123,90.07129974750511,6
0.05,8317,94,749217,90.07177206059148,7
0.05,8318,94,749311,90.07224426012742,7
0.05,8319,95,749406,90.07283653846154,7
0.05,8320,96,749502,90.0735488523014,6
0.05,8321,94,749596,90.07402066810863,7
0.05,8322,94,749690,90.07449237053947,7
0.05,8323,95,749785,90.07508409418548,6
0.05,8324,94,749879,90.07555555555555,8
0.05,8325,95,749974,90.07614700936824,7
0.05,8326,94,750068,90.07661822985469,7
0.05,8327,94,750162,90.07708933717579,7
0.05,8328,92,750254,90.07732020650738,9
0.05,8329,91,750345,90.07743097238895,10
0.05,8330,93,750438,90.07778177889809,8
0.05,8331,94,750532,90.07825252040327,7
0.05,8332,94,750626,90.07872314892596,8
0.05,8333,96,750722,90.07943364530837,6
0.05,8334,96,750818,90.08014397120576,6
0.05,8335,90,750908,90.08013435700576,11
0.05,8336,94,751002,90.08060453400503,7
0.05,8337,96,751098,90.08131446390021,6
0.05,8338,91,751189,90.08142463125075,10
0.05,8339,94,751283,90.08189448441247,7
0.05,8340,93,751376,90.0822443352116,8
0.05,8341,95,751471,90.0828338527931,6
0.05,8342,94,751565,90.08330336809301,7
0.05,8343,94,751659,90.0837727708533,7
0.05,8344,94,751753,90.08424206111444,7
0.05,8345,27,751780,90.07668344116942,6
0.05,8346,96,751876,90.07739307535641,7
0.05,8347,94,751970,90.0778629611883,7
0.05,8348,95,752065,90.07845250928254,6
0.05,8349,94,752159,90.07892215568862,7
0.05,8350,94,752253,90.079391689618,7
0.05,8351,93,752346,90.07974137931035,8
0.05,8352,95,752441,90.08033042020831,6
0.05,8353,27,752468,90.07277950682308,6
0.05,8354,93,752561,90.07312986235787,8
0.05,8355,94,752655,90.07359980852083,7
0.05,8356,95,752750,90.07418930238124,6
0.05,8357,95,752845,90.07477865518067,6
0.05,8358,93,752938,90.07512860389998,8
0.05,8359,95,753033,90.07571770334928,7
0.05,8360,96,753129,90.07642626480086,6
0.05,8361,94,753223,90.07689547955034,7
0.05,8362,95,753318,90.0774841564032,6
0.05,8363,94,753412,90.0779531324725,7
0.05,8364,92,753504,90.07818290496115,9
0.05,8365,94,753598,90.07865168539325,7
0.05,8366,94,753692,90.07912035377076,7
0.05,8367,93,753785,90.07946940726578,8
0.05,8368,95,753880,90.08005735452264,6
0.05,8369,93,753973,90.08040621266427,8
0.05,8370,94,754067,90.08087444749731,7
0.05,8371,94,754161,90.08134257047301,8
0.05,8372,95,754256,90.08193001313747,6
0.05,8373,91,754347,90.08203964652496,10
0.05,8374,95,754442,90.08262686567164,7
0.05,8375,93,754535,90.08297516714423,8
0.05,8376,96,754631,90.08368150889339,6
0.05,8377,95,754726,90.08426832179518,6
0.05,8378,94,754820,90.08473564864542,7
0.05,8379,96,754916,90.0854415274463,6
0.05,8380,94,755010,90.08590860279203,7
0.05,8381,95,755105,90.08649486995944,6
0.05,8382,94,755199,90.08696170821902,7
0.05,8383,95,755294,90.08754770992367,7
0.05,8384,96,755390,90.08825283243888,6
0.05,8385,93,755483,90.08860004769855,8
0.05,8386,92,755575,90.08882794801478,9
0.05,8387,90,755665,90.08881735813067,11
0.05,8388,94,755759,90.08928358564788,7
0.05,8389,95,755854,90.08986889153755,6
0.05,8390,93,755947,90.09021570730545,8
0.05,8391,94,756041,90.09068160152526,8
0.05,8392,90,756131,90.09067079709281,11
0.05,8393,94,756225,90.09113652609007,8
0.05,8394,94,756319,90.09160214413342,7
0.05,8395,94,756413,90.09206765126251,7
0.05,8396,27,756440,90.08455400738359,6
0.05,8397,94,756534,90.08502024291498,7
0.05,8398,95,756629,90.08560542921776,6
0.05,8399,92,756721,90.08583333333333,10
0.05,8400,96,756817,90.08653731698607,6
0.05,8401,92,756909,90.08676505593907,9
0.05,8402,94,757003,90.08723075092229,7
0.05,8403,95,757098,90.08781532603523,6
0.05,8404,96,757194,90.08851873884592,6
0.05,8405,92,757286,90.08874613371401,9
0.05,8406,96,757382,90.08944926846675,6
0.05,8407,92,757474,90.08967649857279,9
0.05,8408,94,757568,90.0901415150434,7
0.05,8409,94,757662,90.09060642092747,7
0.05,8410,95,757757,90.09119010819165,6
0.05,8411,93,757850,90.09153590109368,8
0.05,8412,95,757945,90.09211933911803,6
0.05,8413,96,758041,90.09282148799619,6
0.05,8414,87,758128,90.09245395127748,16
0.05,8415,95,758223,90.09303707224335,7
0.05,8416,94,758317,90.09350124747534,7
0.05,8417,96,758413,90.09420289855072,6
0.05,8418,94,758507,90.0946668250386,7
0.05,8419,93,758600,90.09501187648456,8
0.05,8420,95,758695,90.09559434746467,7
0.05,8421,96,758791,90.09629541676561,6
0.05,8422,95,758886,90.09687759705568,6
0.05,8423,94,758980,90.09734093067426,7
0.05,8424,96,759076,90.09804154302671,6
0.05,8425,88,759164,90.09779254687871,14
0.05,8426,27,759191,90.09030497211344,6
0.05,8427,94,759285,90.0907688656858,7
0.05,8428,95,759380,90.09135128722268,6
0.05,8429,94,759474,90.09181494661922,7
0.05,8430,93,759567,90.09215988613451,8
0.05,8431,94,759661,90.09262333965845,7
0.05,8432,96,759757,90.09332384679236,6
0.05,8433,96,759853,90.09402418781124,6
0.05,8434,94,759947,90.0944872554831,7
0.05,8435,95,760042,90.09506875296348,6
0.05,8436,94,760136,90.09553158705701,7
0.05,8437,94,760230,90.09599431144821,7
0.05,8438,94,760324,90.09645692617609,7
0.05,8439,93,760417,90.0968009478673,8
0.05,8440,92,760509,90.09702641867078,9
0.05,8441,94,760603,90.09748874674248,7
0.05,8442,91,760694,90.0975956413597,10
0.05,8443,94,760788,90.09805779251539,7
0.05,8444,95,760883,90.09863824748372,7
0.05,8445,93,760976,90.0989817665167,8
0.05,8446,95,761071,90.09956197466556,7
0.05,8447,92,761163,90.09978693181819,9
0.05,8448,94,761257,90.10024855012428,7
0.05,8449,95,761352,90.10082840236686,6
0.05,8450,94,761446,90.10128978819074,8
0.05,8451,94,761540,90.10175106483672,7
0.05,8452,94,761634,90.10221223234355,8
0.05,8453,94,761728,90.10267329074995,7
0.05,8454,94,761822,90.10313424009462,7
0.05,8455,92,761914,90.10335856196784,9
0.05,8456,94,762008,90.10381932127233,7
0.05,8457,93,762101,90.10416174036415,8
0.05,8458,92,762193,90.1043858612129,9
0.05,8459,93,762286,90.1047281323877,8
0.05,8460,96,762382,90.10542489067485,6
0.05,8461,94,762476,90.10588513353817,7
0.05,8462,92,762568,90.10610894481862,10
0.05,8463,96,762664,90.10680529300568,6
0.05,8464,94,762758,90.10726520968694,7
0.05,8465,93,762851,90.10760689818096,8
0.05,8466,96,762947,90.10830282272352,6
0.05,8467,96,763043,90.10899858290033,6
0.05,8468,94,763137,90.10945802337939,7
0.05,8469,96,763233,90.11015348288076,6
0.05,8470,89,763322,90.11002242946523,12
0.05,8471,94,763416,90.11048158640227,8
0.05,8472,96,763512,90.11117667886226,6
0.05,8473,95,763607,90.11175359924475,6
0.05,8474,95,763702,90.11233038348082,6
0.05,8475,96,763798,90.11302501179802,6
0.05,8476,94,763892,90.1134835437065,7
0.05,8477,94,763986,90.11394196744516,7
0.05,8478,26,764012,90.10638046939498,7
0.05,8479,96,764108,90.10707547169811,6
0.05,8480,96,764204,90.10777031010494,6
0.05,8481,90,764294,90.1077576043386,11
0.05,8482,95,764389,90.1083343156902,6
0.05,8483,90,764479,90.10832154644037,11
0.05,8484,94,764573,90.10878020035356,7
0.05,8485,22,764595,90.10075418336083,11
0.05,8486,93,764688,90.10109579356663,9
0.05,8487,95,764783,90.10167295004713,6
0.05,8488,94,764877,90.10213217104489,7
0.05,8489,94,764971,90.10259128386336,7
0.05,8490,90,765061,90.10257920150748,11
0.05,8491,94,765155,90.10303815355628,8
0.05,8492,95,765250,90.10361474155187,6
0.05,8493,94,765344,90.10407346362138,9
0.05,8494,95,765439,90.10464979399647,7
0.05,8495,94,765533,90.10510828625236,7
0.05,8496,94,765627,90.10556667058962,7
0.05,8497,92,765719,90.10578959755236,9
0.05,8498,93,765812,90.10613013295682,8
0.05,8499,96,765908,90.10682352941177,6
0.05,8500,96,766004,90.1075167627338,6
0.05,8501,94,766098,90.10797459421313,7
0.05,8502,94,766192,90.10843231800541,7
0.05,8503,90,766282,90.10841956726246,12
0.05,8504,93,766375,90.108759553204,8
0.05,8505,94,766469,90.10921702327768,7
0.05,8506,95,766564,90.10979193605266,6
0.05,8507,94,766658,90.11024917724495,7
0.05,8508,95,766753,90.11082383358797,6
0.05,8509,94,766847,90.11128084606345,7
0.05,8510,92,766939,90.11150276113266,9
0.05,8511,94,767033,90.11195958646617,7
0.05,8512,92,767125,90.11218136966991,9
0.05,8513,94,767219,90.11263800798685,7
0.05,8514,90,767309,90.11262477980036,11
0.05,8515,96,767405,90.11331611085016,6
0.05,8516,94,767499,90.11377245508982,7
0.05,8517,94,767593,90.11422869218126,7
0.05,8518,94,767687,90.11468482216223,8
0.05,8519,94,767781,90.11514084507043,8
0.05,8520,94,767875,90.11559676094355,7
0.05,8521,94,767969,90.11605256981929,7
0.05,8522,91,768060,90.11615628299894,10
0.05,8523,93,768153,90.11649460347255,8
0.05,8524,92,768245,90.11671554252199,9
0.05,8525,96,768341,90.11740558292283,6
0.05,8526,94,768435,90.11786091239591,7
0.05,8527,92,768527,90.11808161350844,9
0.05,8528,96,768623,90.1187712510259,7
0.05,8529,93,768716,90.11910902696366,8
0.05,8530,96,768812,90.11979838237018,6
0.05,8531,93,768905,90.12013595874356,8
0.05,8532,94,768999,90.1205906480722,7
0.05,8533,94,769093,90.12104523084135,7
0.05,8534,96,769189,90.12173403632103,6
0.05,8535,96,769285,90.12242268041237,7
0.05,8536,94,769379,90.12287688883683,7
0.05,8537,93,769472,90.12321386741625,8
0.05,8538,95,769567,90.12378498653239,6
0.05,8539,92,769659,90.12400468384075,9
0.05,8540,95,769754,90.12457557663038,6
0.05,8541,92,769846,90.12479512994615,9
0.05,8542,96,769942,90.12548285145733,6
0.05,8543,91,770033,90.12558520599251,10
0.05,8544,94,770127,90.12603861907549,7
0.05,8545,93,770220,90.12637491223964,8
0.05,8546,96,770316,90.12706212706213,6
0.05,8547,92,770408,90.1272812353767,9
0.05,8548,91,770499,90.12738331968652,10
0.05,8549,95,770594,90.12795321637427,6
0.05,8550,94,770688,90.12840603438194,7
0.05,8551,93,770781,90.12874181478017,8
0.05,8552,90,770871,90.12872676253946,12
0.05,8553,95,770966,90.12929623567922,6
0.05,8554,94,771060,90.12974868497955,7
0.05,8555,90,771150,90.1297335203366,12
0.05,8556,95,771245,90.13030267617155,6
0.05,8557,94,771339,90.13075484926385,7
0.05,8558,94,771433,90.13120691669587,7
0.05,8559,96,771529,90.13189252336448,6
0.05,8560,92,771621,90.13211073472725,9
0.05,8561,96,771717,90.13279607568325,6
0.05,8562,96,771813,90.13348125656896,6
0.05,8563,96,771909,90.13416627744044,6
0.05,8564,93,772002,90.13450087565674,8
0.05,8565,96,772098,90.13518561755778,6
0.05,8566,93,772191,90.13552001867632,8
0.05,8567,93,772284,90.13585434173669,9
0.05,8568,94,772378,90.13630528649784,8
0.05,8569,95,772473,90.13687281213535,6
0.05,8570,94,772567,90.13732353284331,7
0.05,8571,94,772661,90.13777414839011,7
0.05,8572,95,772756,90.13834130409425,6
0.05,8573,94,772850,90.13879169582458,7
0.05,8574,96,772946,90.13947521865889,6
0.05,8575,94,773040,90.13992537313433,7
0.05,8576,95,773135,90.14049201352454,6
0.05,8577,20,773155,90.13231522499417,12
0.05,8578,95,773250,90.13288262035202,6
0.05,8579,94,773344,90.13333333333334,8
0.05,8580,95,773439,90.13390047779978,6
0.05,8581,96,773535,90.13458401305057,6
0.05,8582,95,773630,90.1351508796458,7
0.05,8583,95,773725,90.13571761416588,7
0.05,8584,92,773817,90.13593476994758,10
0.05,8585,95,773912,90.13650128115538,6
0.05,8586,96,774008,90.13718411552347,6
0.05,8587,93,774101,90.13751746623196,9
0.05,8588,94,774195,90.13796716730702,7
0.05,8589,96,774291,90.13864959254947,6
0.05,8590,94,774385,90.13909905715283,7
0.05,8591,94,774479,90.13954841713222,8
0.05,8592,96,774575,90.14023042010939,6
0.05,8593,91,774666,90.1403304631138,10
0.05,8594,92,774758,90.14054682955206,9
0.05,8595,94,774852,90.14099581200558,7
0.05,8596,92,774944,90.14121205071537,10
0.05,8597,94,775038,90.14166085136078,8
0.05,8598,96,775134,90.14234213280614,6
0.05,8599,94,775228,90.14279069767441,8
0.05,8600,94,775322,90.14323915823742,7
0.05,8601,-47,775275,90.12729597767961,11
0.05,8602,94,775369,90.12774613506916,7
0.05,8603,95,775464,90.12831241283124,6
0.05,8604,94,775558,90.1287623474724,7
0.05,8605,92,775650,90.12897978154776,9
0.05,8606,94,775744,90.12942953410015,7
0.05,8607,96,775840,90.13011152416357,6
0.05,8608,94,775934,90.13056104077128,7
0.05,8609,95,776029,90.13112659698025,6
0.05,8610,94,776123,90.13157589130182,8
0.05,8611,94,776217,90.13202508128194,8
0.05,8612,96,776313,90.13270637408569,6
0.05,8613,93,776406,90.13303923844903,8
0.05,8614,94,776500,90.13348810214741,7
0.05,8615,94,776594,90.13393686165274,7
0.05,8616,94,776688,90.13438551700128,7
0.05,8617,94,776782,90.13483406822928,7
0.05,8618,95,776877,90.13539853811346,6
0.05,8619,94,776971,90.13584686774942,7
0.05,8620,93,777064,90.13617909755249,8
0.05,8621,94,777158,90.13662723266063,7
0.05,8622,94,777252,90.13707526382929,8
0.05,8623,94,777346,90.13752319109462,7
0.05,8624,95,777441,90.13808695652173,7
0.05,8625,94,777535,90.13853466264781,8
0.05,8626,94,777629,90.13898226498203,7
0.05,8627,92,777721,90.1391979601298,9
0.05,8628,89,777810,90.13906594043343,12
0.05,8629,90,777900,90.13904982618772,11
0.05,8630,94,777994,90.13949716139497,7
0.05,8631,96,778090,90.14017608897127,6
0.05,8632,92,778182,90.14039152090814,9
0.05,8633,94,778276,90.14083854528607,7
0.05,8634,96,778372,90.14151708164447,6
0.05,8635,94,778466,90.14196387216303,7
0.05,8636,93,778559,90.14229477827949,8
0.05,8637,93,778652,90.14262560777958,8
0.05,8638,96,778748,90.14330362310453,6
0.05,8639,96,778844,90.14398148148148,6
0.05,8640,94,778938,90.14442772827219,7
0.05,8641,94,779032,90.14487387178893,7
0.05,8642,94,779126,90.14531991206756,7
0.05,8643,94,779220,90.14576584914391,7
0.05,8644,93,779313,90.14609600925391,8
0.05,8645,95,779408,90.14665741383298,6
0.05,8646,96,779504,90.14733433560772,6
0.05,8647,95,779599,90.14789546716004,7
0.05,8648,94,779693,90.14834084865302,7
0.05,8649,94,779787,90.14878612716763,7
0.05,8650,94,779881,90.14923130273957,7
0.05,8651,93,779974,90.14956079519186,8
0.05,8652,94,780068,90.15000577834277,7
0.05,8653,94,780162,90.15045065865496,7
0.05,8654,92,780254,90.15066435586367,9
0.05,8655,94,780348,90.1511090573013,7
0.05,8656,93,780441,90.15143814254361,8
0.05,8657,94,780535,90.15188265188266,8
0.05,8658,93,780628,90.15221157177503,8
0.05,8659,92,780720,90.15242494226328,9
0.05,8660,96,780816,90.1531001039141,6
0.05,8661,94,780910,90.15354421611637,7
0.05,8662,94,781004,90.15398822578783,7
0.05,8663,94,781098,90.15443213296399,7
0.05,8664,92,781190,90.15464512406231,9
0.05,8665,92,781282,90.15485806600508,9
0.05,8666,93,781375,90.15518633898697,8
0.05,8667,91,781466,90.15528380249192,10
0.05,8668,91,781557,90.15538124351136,10
0.05,8669,96,781653,90.1560553633218,6
0.05,8670,94,781747,90.15649867374005,7
0.05,8671,93,781840,90.15682656826569,8
0.05,8672,92,781932,90.15703908682117,9
0.05,8673,93,782025,90.15736684344017,8
0.05,8674,94,782119,90.15780979827089,7
0.05,8675,94,782213,90.15825265099124,7
0.05,8676,93,782306,90.15858015443125,8
0.05,8677,94,782400,90.15902281631712,7
0.05,8678,92,782492,90.15923493490034,10
0.05,8679,95,782587,90.1597926267281,6
0.05,8680,94,782681,90.16023499596821,7
0.05,8681,96,782777,90.1609076249712,6
0.05,8682,96,782873,90.16158009904412,7
0.05,8683,93,782966,90.16190695532013,8
0.05,8684,95,783061,90.16246401842257,6
0.05,8685,93,783154,90.16279069767442,8
0.05,8686,93,783247,90.1631173017152,8
0.05,8687,94,783341,90.16355893186004,7
0.05,8688,94,783435,90.16400046035217,7
0.05,8689,91,783526,90.16409666283084,10
0.05,8690,94,783620,90.1645380278449,7
0.05,8691,94,783714,90.16497929130234,7
0.05,8692,92,783806,90.16519038306683,9
0.05,8693,93,783899,90.16551644812515,8
0.05,8694,94,783993,90.1659574468085,7
0.05,8695,95,784088,90.16651333946642,6
0.05,8696,94,784182,90.16695412211108,7
0.05,8697,94,784276,90.16739480340308,7
0.05,8698,92,784368,90.16760547189332,9
0.05,8699,94,784462,90.16804597701149,7
0.05,8700,96,784558,90.1687162395127,6
0.05,8701,94,784652,90.16915651574351,7
0.05,8702,95,784747,90.16971159370333,6
0.05,8703,94,784841,90.17015165441177,7
0.05,8704,95,784936,90.17070649052269,6
0.05,8705,96,785032,90.17137606248565,6
0.05,8706,95,785127,90.17193063052716,6
0.05,8707,93,785220,90.17225539733579,8
0.05,8708,96,785316,90.17292456079917,6
0.05,8709,96,785412,90.1735935706085,6
0.05,8710,90,785502,90.17357364252095,11
0.05,8711,94,785596,90.17401285583104,7
0.05,8712,94,785690,90.1744519683232,7
0.05,8713,93,785783,90.17477622217122,8
0.05,8714,93,785876,90.17510040160643,8
0.05,8715,94,785970,90.17553923818265,8
0.05,8716,93,786063,90.17586325570724,8
0.05,8717,94,786157,90.17630190410645,8
0.05,8718,96,786253,90.17696983599036,6
0.05,8719,94,786347,90.17740825688074,7
0.05,8720,96,786443,90.17807590872606,6
0.05,8721,96,786539,90.17874340747535,6
0.05,8722,92,786631,90.17895219534564,9
0.05,8723,95,786726,90.17950481430536,6
0.05,8724,94,786820,90.17994269340974,7
0.05,8725,94,786914,90.1803804721522,8
0.05,8726,96,787010,90.18104732439555,6
0.05,8727,94,787104,90.18148487626031,7
0.05,8728,95,787199,90.18203688853248,6
0.05,8729,94,787293,90.18247422680412,9
0.05,8730,94,787387,90.1829114648952,7
0.05,8731,94,787481,90.18334860284013,7
0.05,8732,91,787572,90.18344211611131,10
0.05,8733,94,787666,90.183879093199,7
0.05,8734,93,787759,90.1842014882656,8
0.05,8735,95,787854,90.18475274725274,6
0.05,8736,91,787945,90.18484605699896,10
0.05,8737,93,788038,90.18516823071641,8
0.05,8738,93,788131,90.18549033070146,8
0.05,8739,96,788227,90.18615560640733,6
0.05,8740,95,788322,90.18670632650726,6
0.05,8741,94,788416,90.18714253031342,7
0.05,8742,94,788510,90.18757863433603,7
0.05,8743,92,788602,90.18778591033852,10
0.05,8744,94,788696,90.18822184105203,8
0.05,8745,94,788790,90.18865767207866,7
0.05,8746,96,788886,90.1893220532754,6
0.05,8747,95,788981,90.18987197073616,6
0.05,8748,92,789073,90.19007886615613,9
0.05,8749,94,789167,90.19051428571429,7
0.05,8750,94,789261,90.19094960575934,8
0.05,8751,92,789353,90.1911563071298,9
0.05,8752,95,789448,90.19170570090255,6
0.05,8753,93,789541,90.19202650217044,8
0.05,8754,95,789636,90.19257567104512,6
0.05,8755,90,789726,90.1925536774783,11
0.05,8756,-45,789681,90.17711545049674,9
0.05,8757,96,789777,90.17778031514044,6
0.05,8758,92,789869,90.17798835483502,9
0.05,8759,94,789963,90.17842465753425,7
0.05,8760,95,790058,90.17897500285356,6
0.05,8761,94,790152,90.17941109335769,7
0.05,8762,95,790247,90.1799612005021,6
0.05,8763,91,790338,90.18005476951164,11
0.05,8764,91,790429,90.18014831717056,10
0.05,8765,96,790525,90.18081222906685,6
0.05,8766,93,790618,90.18113379719402,9
0.05,8767,96,790714,90.18179744525547,6
0.05,8768,96,790810,90.18246094195462,6
0.05,8769,94,790904,90.18289623717217,8
0.05,8770,94,790998,90.18333143313191,7
0.05,8771,96,791094,90.18399452804377,7
0.05,8772,90,791184,90.18397355522626,12
0.05,8773,96,791280,90.1846364258035,6
0.05,8774,93,791373,90.18495726495726,8
0.05,8775,93,791466,90.18527803099362,8
0.05,8776,94,791560,90.18571265808363,7
0.05,8777,95,791655,90.18626110731374,6
0.05,8778,93,791748,90.18658161521813,8
0.05,8779,95,791843,90.1871298405467,6
0.05,8780,95,791938,90.187677941009,6
0.05,8781,94,792032,90.18811204736961,7
0.05,8782,93,792125,90.18843219856541,9
0.05,8783,93,792218,90.18875227686704,8
0.05,8784,90,792308,90.18873079112123,11
0.05,8785,90,792398,90.18870931026633,11
0.05,8786,94,792492,90.18914305223626,7
0.05,8787,24,792516,90.18161128812017,8
0.05,8788,94,792610,90.18204573899192,7
0.05,8789,94,792704,90.18248009101251,8
0.05,8790,90,792794,90.18245933340917,11
0.05,8791,93,792887,90.18277979981802,9
0.05,8792,94,792981,90.18321392016377,7
0.05,8793,95,793076,90.18376165567432,6
0.05,8794,96,793172,90.18442296759522,6
0.05,8795,95,793267,90.1849704411096,6
0.05,8796,94,793361,90.18540411503922,7
0.05,8797,90,793451,90.18538304160036,11
0.05,8798,96,793547,90.18604386862144,6
0.05,8799,95,793642,90.18659090909091,6
0.05,8800,95,793737,90.18713782524713,6
0.05,8801,94,793831,90.18757100658941,7
0.05,8802,92,793923,90.1877768942406,9
0.05,8803,95,794018,90.18832348932304,6
0.05,8804,94,794112,90.18875638841567,7
0.05,8805,93,794205,90.1890756302521,8
0.05,8806,92,794297,90.18928125354832,9
0.05,8807,94,794391,90.18971389645776,7
0.05,8808,21,794412,90.18185946191394,11
0.05,8809,95,794507,90.18240635641317,6
0.05,8810,27,794534,90.17523550107819,6
0.05,8811,95,794629,90.17578302315025,6
0.05,8812,-46,794583,90.16033132871894,10
0.05,8813,94,794677,90.16076696165192,8
0.05,8814,95,794772,90.16131593874078,6
0.05,8815,93,794865,90.16163793103448,9
0.05,8816,94,794959,90.16207326755132,8
0.05,8817,95,795054,90.16262190973009,7
0.05,8818,93,795147,90.16294364440412,8
0.05,8819,95,795242,90.16349206349206,6
0.05,8820,89,795331,90.1633601632468,12
0.05,8821,92,795423,90.16356835184766,9
0.05,8822,94,795517,90.16400317352374,7
0.05,8823,96,795613,90.16466455122394,6
0.05,8824,94,795707,90.16509915014164,7
0.05,8825,92,795799,90.16530704736007,9
0.05,8826,96,795895,90.16596805256599,6
0.05,8827,93,795988,90.16628908019936,8
0.05,8828,91,796079,90.16638350889116,10
0.05,8829,95,796174,90.16693091732729,6
0.05,8830,93,796267,90.16725172687124,8
0.05,8831,96,796363,90.16791213768116,6
0.05,8832,96,796459,90.16857239895845,6
0.05,8833,94,796553,90.1690061127462,7
0.05,8834,92,796645,90.16921335597057,9
0.05,8835,93,796738,90.16953372566772,8
0.05,8836,96,796834,90.170193504583,6
0.05,8837,94,796928,90.17062683865127,7
0.05,8838,96,797024,90.17128634460911,6
0.05,8839,93,797117,90.17160633484163,8
0.05,8840,95,797212,90.17215247143989,6
0.05,8841,94,797306,90.17258538792129,7
0.05,8842,92,797398,90.17279203890082,9
0.05,8843,96,797494,90.17345092718227,6
0.05,8844,94,797588,90.17388355002826,7
0.05,8845,94,797682,90.17431607506218,7
0.05,8846,95,797777,90.1748615349836,6
0.05,8847,94,797871,90.1752938517179,7
0.05,8848,92,797963,90.17550005650357,9
0.05,8849,96,798059,90.1761581920904,6
0.05,8850,93,798152,90.17647723421082,8
0.05,8851,95,798247,90.17702214188884,6
0.05,8852,90,798337,90.17700214616514,11
0.05,8853,94,798431,90.17743392816806,7
0.05,8854,94,798525,90.17786561264822,7
0.05,8855,95,798620,90.17841011743451,6
0.05,8856,93,798713,90.1787286891724,8
0.05,8857,94,798807,90.17916008128246,7
0.05,8858,90,798897,90.17913985777176,11
0.05,8859,94,798991,90.17957110609481,8
0.05,8860,92,799083,90.17977654892225,9
0.05,8861,92,799175,90.1799819453848,9
0.05,8862,94,799269,90.18041295272481,8
0.05,8863,94,799363,90.18084386281589,7
0.05,8864,90,799453,90.18082346305697,12
0.05,8865,87,799540,90.18046469659373,14
0.05,8866,96,799636,90.18112101048833,6
0.05,8867,93,799729,90.18143888137122,8
0.05,8868,96,799825,90.18209493742248,6
0.05,8869,95,799920,90.1826381059752,6
0.05,8870,93,800013,90.18295569834291,8
0.05,8871,96,800109,90.18361136158701,6
0.05,8872,90,800199,90.18359066831962,11
0.05,8873,92,800291,90.18379535722335,9
0.05,8874,92,800383,90.184,9
0.05,8875,92,800475,90.18420459666517,9
0.05,8876,94,800569,90.18463444857497,7
0.05,8877,93,800662,90.18495156566794,8
0.05,8878,91,800753,90.18504336073882,10
0.05,8879,93,800846,90.18536036036036,8
0.05,8880,93,800939,90.18567728859362,9
0.05,8881,94,801033,90.18610673271786,8
0.05,8882,92,801125,90.18631093099178,9
0.05,8883,96,801221,90.18696533093201,6
0.05,8884,96,801317,90.18761958356781,6
0.05,8885,94,801411,90.18804861580014,7
0.05,8886,96,801507,90.18870259930235,6
0.05,8887,94,801601,90.18913141314131,8
0.05,8888,94,801695,90.18956013049836,7
0.05,8889,95,801790,90.19010123734533,6
0.05,8890,95,801885,90.19064222247216,6
0.05,8891,94,801979,90.19107062528116,8
0.05,8892,95,802074,90.19161137973687,6
0.05,8893,94,802168,90.19203957724308,8
0.05,8894,93,802261,90.19235525576167,9
0.05,8895,93,802354,90.19267086330935,8
0.05,8896,95,802449,90.19321119478477,7
0.05,8897,93,802542,90.19352663519892,8
0.05,8898,96,802638,90.19417912124958,6
0.05,8899,93,802731,90.19449438202247,8
0.05,8900,93,802824,90.1948095719582,8
0.05,8901,94,802918,90.19523702538756,7
0.05,8902,96,803014,90.19588902617096,6
0.05,8903,94,803108,90.196316262354,7
0.05,8904,92,803200,90.19651880965749,9
0.05,8905,23,803223,90.18897372557826,9
0.05,8906,92,803315,90.18917705175704,9
0.05,8907,94,803409,90.18960484957341,7
0.05,8908,94,803503,90.19003255135256,8
0.05,8909,94,803597,90.19046015712682,7
0.05,8910,91,803688,90.19055100437662,11
0.05,8911,94,803782,90.19097845601436,7
0.05,8912,95,803877,90.19151800740491,6
0.05,8913,26,803903,90.1843168050258,8
0.05,8914,90,803993,90.18429613011777,11
0.05,8915,90,804083,90.18427545984747,11
0.05,8916,94,804177,90.18470337557474,8
0.05,8917,27,804204,90.17761830006728,6
0.05,8918,93,804297,90.17793474604777,8
0.05,8919,94,804391,90.17836322869955,7
0.05,8920,92,804483,90.17856742517655,9
0.05,8921,94,804577,90.17899574086528,7
0.05,8922,90,804667,90.17897568082483,11
0.05,8923,94,804761,90.17940385477364,7
0.05,8924,96,804857,90.18005602240896,6
0.05,8925,92,804949,90.18025991485548,9
0.05,8926,96,805045,90.18091184048393,6
0.05,8927,94,805139,90.18133960573476,7
0.05,8928,94,805233,90.1817672751708,7
0.05,8929,25,805258,90.17446808510638,8
0.05,8930,95,805353,90.17500839771583,8
0.05,8931,93,805446,90.17532467532467,8
0.05,8932,94,805540,90.17575282659801,8
0.05,8933,93,805633,90.17606895007835,9
0.05,8934,93,805726,90.17638500279799,8
0.05,8935,94,805820,90.17681289167413,7
0.05,8936,96,805916,90.17746447353699,6
0.05,8937,94,806010,90.17789214589394,7
0.05,8938,95,806105,90.17843159190066,6
0.05,8939,94,806199,90.17885906040269,8
0.05,8940,94,806293,90.17928643328487,8
0.05,8941,90,806383,90.17926638335943,11
0.05,8942,94,806477,90.17969361511797,7
0.05,8943,93,806570,90.18000894454383,8
0.05,8944,96,806666,90.1806595863611,6
0.05,8945,92,806758,90.18086295551085,9
0.05,8946,95,806853,90.18140158712417,6
0.05,8947,93,806946,90.18171658471167,8
0.05,8948,93,807039,90.18203151190077,8
0.05,8949,94,807133,90.18245810055866,7
0.05,8950,94,807227,90.18288459390013,7
0.05,8951,93,807320,90.18319928507596,8
0.05,8952,90,807410,90.18317882274098,11
0.05,8953,96,807506,90.18382845655573,6
0.05,8954,94,807600,90.18425460636516,7
0.05,8955,96,807696,90.18490397498883,6
0.05,8956,92,807788,90.18510662052026,9
0.05,8957,94,807882,90.18553248492967,7
0.05,8958,96,807978,90.18618149347026,6
0.05,8959,94,808072,90.18660714285714,7
0.05,8960,27,808099,90.1795558531414,6
0.05,8961,94,808193,90.17998214684222,7
0.05,8962,95,808288,90.18051991520696,6
0.05,8963,95,808383,90.18105756358769,6
0.05,8964,96,808479,90.18170663692136,6
0.05,8965,87,808566,90.18135177336605,14
0.05,8966,94,808660,90.18177762908442,7
0.05,8967,96,808756,90.18242640499554,6
0.05,8968,94,808850,90.182852045936,7
0.05,8969,18,808868,90.17480490523968,14
0.05,8970,94,808962,90.17523130085831,7
0.05,8971,93,809055,90.17554614355774,8
0.05,8972,95,809150,90.17608380697648,6
0.05,8973,94,809244,90.17650991753956,8
0.05,8974,95,809339,90.17704735376044,6
0.05,8975,96,809435,90.17769607843137,6
0.05,8976,92,809527,90.17789907541496,9
0.05,8977,94,809621,90.17832479394075,7
0.05,8978,93,809714,90.17863904666444,8
0.05,8979,95,809809,90.17917594654789,6
0.05,8980,92,809901,90.17937868834206,9
0.05,8981,95,809996,90.17991538632822,6
0.05,8982,94,810090,90.1803406434376,7
0.05,8983,95,810185,90.18087711487088,6
0.05,8984,94,810279,90.1813021702838,7
0.05,8985,94,810373,90.18172713109281,7
0.05,8986,92,810465,90.18192945365529,9
0.05,8987,94,810559,90.18235425011126,9
0.05,8988,93,810652,90.18266770497274,8
0.05,8989,94,810746,90.18309232480534,7
0.05,8990,92,810838,90.18329440551663,10
0.05,8991,96,810934,90.18394128113879,6
0.05,8992,91,811025,90.18403202490826,10
0.05,8993,96,811121,90.184678674672,6
0.05,8994,93,811214,90.18499166203446,8
0.05,8995,94,811308,90.18541574032903,7
0.05,8996,96,811404,90.18606202067356,6
0.05,8997,92,811496,90.18626361413648,9
0.05,8998,96,811592,90.18690965662852,6
0.05,8999,95,811687,90.18744444444444,6
0.05,9000,95,811782,90.18797911343184,6
0.05,9001,93,811875,90.18829149077983,8
0.05,9002,95,811970,90.18882594690659,6
0.05,9003,92,812062,90.18902709906708,9
0.05,9004,96,812158,90.18967240421988,6
0.05,9005,95,812253,90.19020652898068,6
0.05,9006,92,812345,90.19040746086377,9
0.05,9007,94,812439,90.19083037300177,7
0.05,9008,93,812532,90.19114219114219,8
0.05,9009,92,812624,90.19134295227525,9
0.05,9010,96,812720,90.19198757074686,6
0.05,9011,94,812814,90.19241011984022,7
0.05,9012,95,812909,90.19294352601797,6
0.05,9013,96,813005,90.19358775238518,6
0.05,9014,94,813099,90.19400998336107,7
0.05,9015,96,813195,90.19465394853593,6
0.05,9016,94,813289,90.19507596761673,7
0.05,9017,96,813385,90.19571967176758,6
0.05,9018,95,813480,90.19625235613704,6
0.05,9019,95,813575,90.19678492239468,6
0.05,9020,94,813669,90.19720651812437,7
0.05,9021,95,813764,90.19773886056306,6
0.05,9022,94,813858,90.19816025712069,7
0.05,9023,93,813951,90.19847074468085,8
0.05,9024,94,814045,90.198891966759,7
0.05,9025,19,814064,90.19100376689563,14
0.05,9026,94,814158,90.19142572283151,7
0.05,9027,94,814252,90.1918475852902,8
0.05,9028,94,814346,90.19226935430281,7
0.05,9029,94,814440,90.19269102990033,8
0.05,9030,90,814530,90.1926696932787,12
0.05,9031,93,814623,90.19298051372897,8
0.05,9032,93,814716,90.19329126536034,8
0.05,9033,95,814811,90.19382333407128,6
0.05,9034,27,814838,90.18682899833979,6
0.05,9035,96,814934,90.18747233289066,6
0.05,9036,27,814961,90.18048024786987,6
0.05,9037,92,815053,90.1806815667183,9
0.05,9038,96,815149,90.18132536785042,6
0.05,9039,94,815243,90.18174778761062,7
0.05,9040,94,815337,90.18217011392545,7
0.05,9041,93,815430,90.18248175182482,8
0.05,9042,96,815526,90.18312506911423,6
0.05,9043,94,815620,90.18354710305175,7
0.05,9044,95,815715,90.18407960199005,6
0.05,9045,91,815806,90.1841697988061,10
0.05,9046,95,815901,90.18470211119708,6
0.05,9047,95,815996,90.18523430592396,6
0.05,9048,95,816091,90.18576638302575,6
0.05,9049,94,816185,90.18618784530386,7
0.05,9050,93,816278,90.18649872942217,8
0.05,9051,93,816371,90.18680954485197,8
0.05,9052,94,816465,90.18723075223683,7
0.05,9053,27,816492,90.18025182239894,6
0.05,9054,93,816585,90.18056322473771,8
0.05,9055,91,816676,90.18065371024736,10
0.05,9056,92,816768,90.18085458761179,9
0.05,9057,94,816862,90.1812762199161,7
0.05,9058,94,816956,90.18169775913456,7
0.05,9059,94,817050,90.18211920529801,7
0.05,9060,89,817139,90.18198874296435,12
0.05,9061,95,817234,90.18252041491944,7
0.05,9062,93,817327,90.18283129206664,8
0.05,9063,93,817420,90.18314210061783,8
0.05,9064,92,817512,90.18334252619967,9
0.05,9065,88,817600,90.18310169865431,14
0.05,9066,96,817696,90.18374324473365,6
0.05,9067,92,817788,90.18394353771504,9
0.05,9068,94,817882,90.1843643180064,7
0.05,9069,91,817973,90.18445424476296,10
0.05,9070,95,818068,90.18498511740712,6
0.05,9071,94,818162,90.18540564373897,7
0.05,9072,93,818255,90.18571586024468,8
0.05,9073,94,818349,90.18613621335685,8
0.05,9074,96,818445,90.18677685950414,6
0.05,9075,95,818540,90.1873071837814,6
0.05,9076,94,818634,90.18772722265065,7
0.05,9077,93,818727,90.18803701255783,8
0.05,9078,95,818822,90.18856702279987,6
0.05,9079,94,818916,90.18898678414097,7
0.05,9080,96,819012,90.18962669309548,6
0.05,9081,95,819107,90.19015635322616,6
0.05,9082,93,819200,90.19046570516349,8
0.05,9083,95,819295,90.1909951563188,6
0.05,9084,93,819388,90.19130434782609,9
0.05,9085,25,819413,90.18412942989214,8
0.05,9086,92,819505,90.18432926158248,9
0.05,9087,95,819600,90.18485915492958,7
0.05,9088,92,819692,90.18505886236109,9
0.05,9089,92,819784,90.18525852585259,10
0.05,9090,95,819879,90.18578814211858,6
0.05,9091,91,819970,90.18587769467663,10
0.05,9092,94,820064,90.18629715165513,7
0.05,9093,96,820160,90.18693644160986,6
0.05,9094,95,820255,90.1874656404618,6
0.05,9095,95,820350,90.18799472295514,6
0.05,9096,93,820443,90.1883038364296,8
0.05,9097,93,820536,90.18861288195208,9
0.05,9098,94,820630,90.18903176173205,7
0.05,9099,93,820723,90.18934065934066,8
0.05,9100,96,820819,90.18997912317327,6
0.05,9101,91,820910,90.19006811689738,10
0.05,9102,92,821002,90.1902669449632,9
0.05,9103,92,821094,90.19046572934974,9
0.05,9104,95,821189,90.19099395936298,6
0.05,9105,93,821282,90.191302437953,8
0.05,9106,95,821377,90.19183046008565,6
0.05,9107,95,821472,90.1923583662714,6
0.05,9108,95,821567,90.19288615654847,6
0.05,9109,91,821658,90.19297475301866,10
0.05,9110,96,821754,90.19361211722094,6
0.05,9111,93,821847,90.19392010535557,8
0.05,9112,27,821874,90.18698562493141,6
0.05,9113,94,821968,90.18740399385561,8
0.05,9114,95,822063,90.18793198025233,6
0.05,9115,93,822156,90.1882404563405,8
0.05,9116,93,822249,90.18854886475815,8
0.05,9117,94,822343,90.18896687870146,8
0.05,9118,94,822437,90.18938480096502,8
0.05,9119,94,822531,90.18980263157894,7
0.05,9120,93,822624,90.19011073347221,9
0.05,9121,94,822718,90.1905283928963,7
0.05,9122,91,822809,90.19061712156089,12
0.05,9123,91,822900,90.19070583077597,10
0.05,9124,95,822995,90.19123287671233,7
0.05,9125,91,823086,90.19132149901381,10
0.05,9126,95,823181,90.19184836200284,6
0.05,9127,94,823275,90.19226555652936,7
0.05,9128,94,823369,90.19268265965604,7
0.05,9129,94,823463,90.19309967141292,8
0.05,9130,94,823557,90.19351659183003,7
0.05,9131,95,823652,90.1940429259746,6
0.05,9132,93,823745,90.19435015876492,8
0.05,9133,95,823840,90.19487628640245,6
0.05,9134,94,823934,90.19529282977558,7
0.05,9135,26,823960,90.18826619964973,7
0.05,9136,93,824053,90.18857393017402,9
0.05,9137,95,824148,90.18910045961917,6
0.05,9138,94,824242,90.18951745267535,7
0.05,9139,94,824336,90.18993435448577,7
0.05,9140,94,824430,90.1903511650804,7
0.05,9141,92,824522,90.19054911397943,9
0.05,9142,95,824617,90.19107513945094,6
0.05,9143,94,824711,90.19149168853893,7
0.05,9144,94,824805,90.19190814652816,7
0.05,9145,94,824899,90.1923245134485,7
0.05,9146,95,824994,90.19285011479174,6
0.05,9147,94,825088,90.19326628771316,7
0.05,9148,92,825180,90.19346376653186,10
0.05,9149,93,825273,90.19377049180328,8
0.05,9150,91,825364,90.1938585946891,10
0.05,9151,94,825458,90.19427447552448,7
0.05,9152,89,825547,90.19414399650388,12
0.05,9153,95,825642,90.19466899715971,6
0.05,9154,95,825737,90.19519388312398,6
0.05,9155,93,825830,90.195500218436,8
0.05,9156,94,825924,90.19591569291252,7
0.05,9157,94,826018,90.19633107665429,8
0.05,9158,95,826113,90.19685555191614,6
0.05,9159,91,826204,90.19694323144105,10
0.05,9160,93,826297,90.19724920860168,9
0.05,9161,96,826393,90.19788255839336,6
0.05,9162,93,826486,90.1981883662556,8
0.05,9163,96,826582,90.19882147533828,6
0.05,9164,95,826677,90.19934533551555,7
0.05,9165,94,826771,90.19975998254418,7
0.05,9166,92,826863,90.19995636522309,9
0.05,9167,95,826958,90.20047993019197,6
0.05,9168,94,827052,90.20089431781001,7
0.05,9169,95,827147,90.20141766630316,6
0.05,9170,95,827242,90.20194090066514,8
0.05,9171,91,827333,90.20202791103358,10
0.05,9172,93,827426,90.20233293360951,8
0.05,9173,95,827521,90.2028558971005,6
0.05,9174,92,827613,90.20305177111716,9
0.05,9175,95,827708,90.20357454228422,6
0.05,9176,95,827803,90.20409719952055,6
0.05,9177,96,827899,90.20472869906298,6
0.05,9178,95,827994,90.20525111667938,6
0.05,9179,91,828085,90.20533769063181,10
0.05,9180,93,828178,90.20564208691863,8
0.05,9181,92,828270,90.20583750816816,9
0.05,9182,94,828364,90.20625068060546,7
0.05,9183,94,828458,90.2066637630662,7
0.05,9184,93,828551,90.20696788241699,8
0.05,9185,93,828644,90.2072719355541,9
0.05,9186,94,828738,90.20768477196037,7
0.05,9187,95,828833,90.20820635611668,6
0.05,9188,95,828928,90.20872782674937,6
0.05,9189,94,829022,90.20914036996736,7
0.05,9190,96,829118,90.2097704275922,6
0.05,9191,95,829213,90.21029155787642,6
0.05,9192,93,829306,90.21059501794844,8
0.05,9193,94,829400,90.21100717859474,8
0.05,9194,94,829494,90.21141924959217,7
0.05,9195,94,829588,90.21183123096999,8
0.05,9196,93,829681,90.21213439164946,8
0.05,9197,95,829776,90.2126549249837,7
0.05,9198,96,829872,90.21328405261441,6
0.05,9199,94,829966,90.21369565217391,7
0.05,9200,96,830062,90.2143245299424,6
0.05,9201,94,830156,90.2147359269724,7
0.05,9202,94,830250,90.21514723459741,7
0.05,9203,93,830343,90.21544980443285,8
0.05,9204,93,830436,90.21575230852797,8
0.05,9205,86,830522,90.21529437323484,15
0.05,9206,94,830616,90.21570544151189,8
0.05,9207,22,830638,90.20829713292788,10
0.05,9208,91,830729,90.20838310348572,10
0.05,9209,94,830823,90.20879478827362,7
0.05,9210,94,830917,90.2092063836717,7
0.05,9211,91,831008,90.2092922275293,10
0.05,9212,92,831100,90.20948659502876,9
0.05,9213,96,831196,90.21011504232689,6
0.05,9214,94,831290,90.21052631578948,7
0.05,9215,94,831384,90.2109375,8
0.05,9216,94,831478,90.21134859498753,7
0.05,9217,93,831571,90.21165111737903,9
0.05,9218,94,831665,90.21206204577503,7
0.05,9219,95,831760,90.21258134490239,6
0.05,9220,94,831854,90.21299208328814,7
0.05,9221,94,831948,90.21340273259597,7
0.05,9222,94,832042,90.21381329285482,7
0.05,9223,95,832137,90.21433217692974,6
0.05,9224,95,832232,90.21485094850948,8
0.05,9225,94,832326,90.21526121829612,7
0.05,9226,94,832420,90.21567139915466,8
0.05,9227,95,832515,90.21618985695709,6
0.05,9228,96,832611,90.21681655650666,6
0.05,9229,94,832705,90.21722643553629,7
0.05,9230,95,832800,90.2177445563861,6
0.05,9231,94,832894,90.21815424610053,7
0.05,9232,24,832918,90.21098234593306,9
0.05,9233,94,833012,90.21139267922894,7
0.05,9234,95,833107,90.21191120736329,7
0.05,9235,93,833200,90.2122130792551,8
0.05,9236,96,833296,90.21283966655841,6
0.05,9237,94,833390,90.21324962113012,7
0.05,9238,94,833484,90.21365948695747,8
0.05,9239,96,833580,90.21428571428571,6
0.05,9240,94,833674,90.21469537928796,7
0.05,9241,93,833767,90.21499675394936,8
0.05,9242,90,833857,90.21497349345451,11
0.05,9243,95,833952,90.21549112938122,6
0.05,9244,96,834048,90.21611681990265,6
0.05,9245,94,834142,90.21652606532555,7
0.05,9246,94,834236,90.21693522223424,7
0.05,9247,94,834330,90.21734429065744,7
0.05,9248,93,834423,90.21764515082711,8
0.05,9249,96,834519,90.21827027027027,6
0.05,9250,93,834612,90.21857096530105,8
0.05,9251,93,834705,90.21887159533074,8
0.05,9252,87,834792,90.2185237220361,14
0.05,9253,93,834885,90.21882429219797,9
0.05,9254,92,834977,90.21901674770395,9
0.05,9255,92,835069,90.21920916162489,9
0.05,9256,94,835163,90.21961758669116,7
0.05,9257,93,835256,90.2199179088356,8
0.05,9258,95,835351,90.22043417215681,7
0.05,9259,92,835443,90.22062634989202,9
0.05,9260,94,835537,90.22103444552424,7
0.05,9261,93,835630,90.22133448499244,8
0.05,9262,93,835723,90.22163445967828,8
0.05,9263,93,835816,90.22193436960276,8
0.05,9264,95,835911,90.22245008094981,6
0.05,9265,93,836004,90.22274983811785,8
0.05,9266,95,836099,90.22326535016727,6
0.05,9267,95,836194,90.22378075097109,7
0.05,9268,93,836287,90.22408026755853,8
0.05,9269,93,836380,90.22437971952534,8
0.05,9270,96,836476,90.22500269658073,6
0.05,9271,95,836571,90.22551768766178,7
0.05,9272,93,836664,90.2258168877386,8
0.05,9273,94,836758,90.2262238516282,7
0.05,9274,94,836852,90.22663072776281,7
0.05,9275,94,836946,90.22703751617077,7
0.05,9276,91,837037,90.22712083647731,10
0.05,9277,94,837131,90.22752748437163,7
0.05,9278,94,837225,90.22793404461687,7
0.05,9279,93,837318,90.22823275862069,8
0.05,9280,87,837405,90.2278849261933,14
0.05,9281,92,837497,90.2280758457229,10
0.05,9282,96,837593,90.2286976193041,6
0.05,9283,95,837688,90.2292115467471,6
0.05,9284,94,837782,90.22961766289714,7
0.05,9285,91,837873,90.22970062459616,10
0.05,9286,96,837969,90.23032195542156,6
0.05,9287,95,838064,90.23083548664944,6
0.05,9288,95,838159,90.23134890730972,6
0.05,9289,94,838253,90.23175457481163,7
0.05,9290,94,838347,90.2321601549887,7
0.05,9291,96,838443,90.23278088678433,6
0.05,9292,92,838535,90.23297105348111,9
0.05,9293,90,838625,90.23294598665805,11
0.05,9294,96,838721,90.23356643356644,6
0.05,9295,94,838815,90.23397160068846,7
0.05,9296,92,838907,90.23416155749166,10
0.05,9297,95,839002,90.23467412346741,6
0.05,9298,96,839098,90.23529411764706,6
0.05,9299,92,839190,90.23548387096774,9
0.05,9300,95,839285,90.23599612944845,6
0.05,9301,94,839379,90.23640077402709,7
0.05,9302,92,839471,90.23659034719982,9
0.05,9303,95,839566,90.23710232158211,7
0.05,9304,94,839660,90.23750671681891,7
0.05,9305,92,839752,90.23769611003654,9
0.05,9306,95,839847,90.23820780058021,6
0.05,9307,92,839939,90.23839707778255,9
0.05,9308,95,840034,90.23890858309163,6
0.05,9309,89,840123,90.23877551020408,12
0.05,9310,94,840217,90.23917946514875,7
0.05,9311,94,840311,90.23958333333333,7
0.05,9312,93,840404,90.23987973800064,9
0.05,9313,94,840498,90.24028344427744,7
0.05,9314,88,840586,90.24004294149222,13
0.05,9315,93,840679,90.24033920137398,8
0.05,9316,94,840773,90.24074272834604,7
0.05,9317,94,840867,90.24114616870573,7
0.05,9318,94,840961,90.24154952248095,7
0.05,9319,92,841053,90.2417381974249,10
0.05,9320,96,841149,90.24235597038944,6
0.05,9321,94,841243,90.24275906457842,8
0.05,9322,94,841337,90.24316207229433,8
0.05,9323,96,841433,90.2437794937795,6
0.05,9324,94,841527,90.24418230563003,7
0.05,9325,87,841614,90.24383444134678,14
0.05,9326,94,841708,90.24423716093064,8
0.05,9327,94,841802,90.2446397941681,7
0.05,9328,94,841896,90.24504234108693,7
0.05,9329,95,841991,90.24555198285101,6
0.05,9330,94,842085,90.24595434572929,7
0.05,9331,95,842180,90.24646378054008,6
0.05,9332,96,842276,90.24708025286617,6
0.05,9333,93,842369,90.24737518748661,8
0.05,9334,94,842463,90.24777718264596,8
0.05,9335,95,842558,90.24828620394173,6
0.05,9336,90,842648,90.24825961229517,11
0.05,9337,95,842743,90.2487684729064,6
0.05,9338,95,842838,90.24927722454224,6
0.05,9339,95,842933,90.24978586723769,6
0.05,9340,92,843025,90.24997323627021,10
0.05,9341,94,843119,90.25037465210876,7
0.05,9342,96,843215,90.25099004602376,6
0.05,9343,96,843311,90.25160530821918,7
0.05,9344,95,843406,90.25211342964153,6
0.05,9345,94,843500,90.25251444468222,7
0.05,9346,94,843594,90.25291537391676,7
0.05,9347,92,843686,90.25310226786479,9
0.05,9348,92,843778,90.25328912183122,9
0.05,9349,95,843873,90.25379679144385,6
0.05,9350,95,843968,90.25430435247567,6
0.05,9351,94,844062,90.25470487596236,7
0.05,9352,94,844156,90.25510531380306,7
0.05,9353,93,844249,90.25539875988882,8
0.05,9354,94,844343,90.25579903794763,8
0.05,9355,94,844437,90.25619923044036,7
0.05,9356,94,844531,90.25659933739446,7
0.05,9357,93,844624,90.2568924983971,8
0.05,9358,95,844719,90.25739929479646,6
0.05,9359,94,844813,90.25779914529915,7
0.05,9360,92,844905,90.25798525798525,10
0.05,9361,92,844997,90.2581713309122,9
0.05,9362,92,845089,90.2583573640927,9
0.05,9363,94,845183,90.258756941478,7
0.05,9364,95,845278,90.25926321409503,6
0.05,9365,95,845373,90.25976937860347,6
0.05,9366,93,845466,90.26006191950465,8
0.05,9367,94,845560,90.2604611443211,7
0.05,9368,95,845655,90.26096701889209,7
0.05,9369,95,845750,90.2614727854856,6
0.05,9370,92,845842,90.26165830754455,9
0.05,9371,94,845936,90.26205719163465,7
0.05,9372,96,846032,90.26266936946548,6
0.05,9373,91,846123,90.26274802645615,10
0.05,9374,91,846214,90.26282666666667,10
0.05,9375,94,846308,90.2632252559727,7
0.05,9376,95,846403,90.26373040418044,6
0.05,9377,95,846498,90.26423544465771,6
0.05,9378,94,846592,90.26463375626399,7
0.05,9379,96,846688,90.26524520255863,6
0.05,9380,87,846775,90.26489713250187,14
0.05,9381,93,846868,90.26518865913451,8
0.05,9382,92,846960,90.26537354790578,9
0.05,9383,95,847055,90.26587809036658,6
0.05,9384,94,847149,90.26627597229621,8
0.05,9385,95,847244,90.26678031110164,6
0.05,9386,94,847338,90.26717801214446,7
0.05,9387,94,847432,90.26757562846187,7
0.05,9388,95,847527,90.26807966769624,6
0.05,9389,96,847623,90.26869009584665,6
0.05,9390,94,847717,90.26908742412948,7
0.05,9391,96,847813,90.26969761499149,6
0.05,9392,95,847908,90.27020121366975,6
0.05,9393,93,848001,90.27049180327869,8
0.05,9394,92,848093,90.27067589143161,9
0.05,9395,95,848188,90.27117922520222,7
0.05,9396,93,848281,90.27146961796318,8
0.05,9397,94,848375,90.27186635454352,8
0.05,9398,94,848469,90.27226300670284,7
0.05,9399,93,848562,90.27255319148937,8
0.05,9400,95,848657,90.27305605786619,6
0.05,9401,92,848749,90.27323973622633,9
0.05,9402,95,848844,90.27374242263107,6
0.05,9403,94,848938,90.27413866439812,7
0.05,9404,90,849028,90.27410951621478,11
0.05,9405,94,849122,90.27450563470126,8
0.05,9406,96,849218,90.27511427660254,6
0.05,9407,95,849313,90.27561649659864,6
0.05,9408,94,849407,90.27601232862153,7
0.05,9409,96,849503,90.27662061636556,6
0.05,9410,27,849530,90.2698969291255,6
0.05,9411,92,849622,90.2700807479813,9
0.05,9412,93,849715,90.27037076383725,8
0.05,9413,94,849809,90.27076694285107,7
0.05,9414,94,849903,90.27116303770579,7
0.05,9415,95,849998,90.27166525063721,6
0.05,9416,93,850091,90.27195497504513,8
0.05,9417,92,850183,90.2721384582714,9
0.05,9418,92,850275,90.27232190253743,9
0.05,9419,94,850369,90.27271762208068,7
0.05,9420,22,850391,90.26547075681987,10
0.05,9421,95,850486,90.26597325408618,8
0.05,9422,95,850581,90.26647564469914,6
0.05,9423,95,850676,90.2669779286927,6
0.05,9424,94,850770,90.26737400530504,7
0.05,9425,94,850864,90.2677699978782,7
0.05,9426,95,850959,90.26827198472472,6
0.05,9427,92,851051,90.26845566397964,9
0.05,9428,94,851145,90.26885141584474,8
0.05,9429,96,851241,90.26945917285259,6
0.05,9430,90,851331,90.26943060120878,11
0.05,9431,93,851424,90.26972010178118,8
0.05,9432,96,851520,90.27032757341249,6
0.05,9433,96,851616,90.27093491626033,6
0.05,9434,91,851707,90.27101218865924,10
0.05,9435,91,851798,90.27108944467994,11
0.05,9436,90,851888,90.27106071844867,11
0.05,9437,95,851983,90.27156177156178,6
0.05,9438,94,852077,90.2719567750821,7
0.05,9439,92,852169,90.27213983050848,10
0.05,9440,90,852259,90.27211100519013,11
0.05,9441,95,852354,90.27261173480196,6
0.05,9442,95,852449,90.27311235836069,6
0.05,9443,96,852545,90.27371876323592,6
0.05,9444,94,852639,90.27411328745367,7
0.05,9445,94,852733,90.2745077281389,8
0.05,9446,93,852826,90.27479623160792,8
0.05,9447,96,852922,90.27540220152413,6
0.05,9448,95,853017,90.27590221187427,7
0.05,9449,92,853109,90.27608465608466,9
0.05,9450,92,853201,90.2762670616866,9
0.05,9451,95,853296,90.27676682183665,6
0.05,9452,91,853387,90.27684333015974,10
0.05,9453,93,853480,90.27713137296382,8
0.05,9454,93,853573,90.27741935483871,8
0.05,9455,94,853667,90.27781302876481,7
0.05,9456,94,853761,90.27820661943534,7
0.05,9457,94,853855,90.27860012687673,7
0.05,9458,90,853945,90.27857067343271,11
0.05,9459,94,854039,90.27896405919661,8
0.05,9460,94,854133,90.27935736180108,7
0.05,9461,27,854160,90.27266962587191,6
0.05,9462,94,854254,90.27306351051463,7
0.05,9463,94,854348,90.27345731191885,7
0.05,9464,93,854441,90.27374537770734,8
0.05,9465,95,854536,90.27424466511727,6
0.05,9466,83,854619,90.27347628604626,19
0.05,9467,92,854711,90.27365863962822,9
0.05,9468,27,854738,90.26697644946668,6
0.05,9469,95,854833,90.2674762407603,7
0.05,9470,95,854928,90.2679759265125,6
0.05,9471,93,855021,90.26826435810811,8
0.05,9472,94,855115,90.26865829198775,7
0.05,9473,93,855208,90.2689465906692,8
0.05,9474,95,855303,90.26944591029024,6
0.05,9475,92,855395,90.26962853524694,9
0.05,9476,89,855484,90.26949456579086,12
0.05,9477,25,855509,90.2626081451783,8
0.05,9478,90,855599,90.26258044097479,11
0.05,9479,94,855693,90.2629746835443,7
0.05,9480,93,855786,90.26326336884294,8
0.05,9481,96,855882,90.26386838219784,6
0.05,9482,93,855975,90.2641569123695,8
0.05,9483,95,856070,90.26465626318009,6
0.05,9484,94,856164,90.26505007907222,7
0.05,9485,22,856186,90.25785367910605,11
0.05,9486,90,856276,90.25782649942026,11
0.05,9487,96,856372,90.25843170320405,6
0.05,9488,96,856468,90.25903677942881,6
0.05,9489,93,856561,90.25932560590095,8
0.05,9490,95,856656,90.25982509746075,6
0.05,9491,94,856750,90.26021913190054,7
0.05,9492,91,856841,90.26029706099231,10
0.05,9493,96,856937,90.2609016220771,6
0.05,9494,96,857033,90.26150605581886,6
0.05,9495,96,857129,90.26211036225779,6
0.05,9496,27,857156,90.25544908918606,6
0.05,9497,94,857250,90.25584333543904,7
0.05,9498,92,857342,90.25602695020528,9
0.05,9499,95,857437,90.25652631578947,7
0.05,9500,94,857531,90.2569203241764,7
0.05,9501,94,857625,90.25731424963166,7
0.05,9502,93,857718,90.25760286225403,8
0.05,9503,92,857810,90.2577861952862,9
0.05,9504,93,857903,90.25807469752762,9
0.05,9505,94,857997,90.25846833578792,8
0.05,9506,95,858092,90.25896707689071,6
0.05,9507,94,858186,90.2593605384939,7
0.05,9508,27,858213,90.25270796087916,6
0.05,9509,95,858308,90.25320715036803,6
0.05,9510,96,858404,90.25381137630113,6
0.05,9511,93,858497,90.2541000841043,8
0.05,9512,96,858593,90.25470408914117,6
0.05,9513,93,858686,90.2549926424217,9
0.05,9514,95,858781,90.25549132947977,6
0.05,9515,94,858875,90.25588482555696,7
0.05,9516,91,858966,90.25596301355469,10
0.05,9517,94,859060,90.2563563773902,7
0.05,9518,89,859149,90.25622439331863,12
0.05,9519,20,859169,90.24884453781513,12
0.05,9520,90,859259,90.24881840142842,11
0.05,9521,25,859284,90.24196597353497,8
0.05,9522,96,859380,90.24257061850257,6
0.05,9523,96,859476,90.24317513649727,6
0.05,9524,94,859570,90.24356955380577,8
0.05,9525,93,859663,90.24385891245014,8
0.05,9526,95,859758,90.2443581400231,6
0.05,9527,96,859854,90.24496221662469,6
0.05,9528,95,859949,90.24546122363311,6
0.05,9529,93,860042,90.24575026232948,8
0.05,9530,95,860137,90.24624908194313,6
0.05,9531,94,860231,90.24664288711708,7
0.05,9532,94,860325,90.24703660967167,7
0.05,9533,87,860412,90.2466960352423,14
0.05,9534,27,860439,90.24006292606188,6
0.05,9535,94,860533,90.2404572147651,7
0.05,9536,95,860628,90.24095627555835,6
0.05,9537,93,860721,90.24124554413923,8
0.05,9538,95,860816,90.24174441765385,6
0.05,9539,93,860909,90.24203354297694,8
0.05,9540,94,861003,90.24242741850959,7
0.05,9541,91,861094,90.2425068119891,11
0.05,9542,94,861188,90.24290055538091,7
0.05,9543,95,861283,90.24339899413243,6
0.05,9544,94,861377,90.24379256155055,7
0.05,9545,93,861470,90.24408129059292,8
0.05,9546,93,861563,90.24436995914947,8
0.05,9547,96,861659,90.24497276916632,6
0.05,9548,90,861749,90.24494711488114,11
0.05,9549,93,861842,90.24523560209424,8
0.05,9550,94,861936,90.24562872997592,7
0.05,9551,94,862030,90.24602177554439,7
0.05,9552,25,862055,90.23919187689731,7
0.05,9553,94,862149,90.23958551392087,8
0.05,9554,94,862243,90.2399790685505,10
0.05,9555,94,862337,90.24037254081206,7
0.05,9556,27,862364,90.23375536256147,6
0.05,9557,94,862458,90.23414940364093,7
0.05,9558,96,862554,90.23475258918297,6
0.05,9559,95,862649,90.2352510460251,6
0.05,9560,94,862743,90.23564480702855,7
0.05,9561,95,862838,90.23614306630412,6
0.05,9562,94,862932,90.23653665167835,7
0.05,9563,96,863028,90.23713927227102,6
0.05,9564,96,863124,90.23774176685833,6
0.05,9565,93,863217,90.23803052477524,8
0.05,9566,92,863309,90.23821469635205,9
0.05,9567,96,863405,90.2388168896321,6
0.05,9568,92,863497,90.23900094053715,9
0.05,9569,92,863589,90.23918495297805,9
0.05,9570,94,863683,90.23957789154738,7
0.05,9571,94,863777,90.23997074801504,7
0.05,9572,92,863869,90.24015460148334,9
0.05,9573,96,863965,90.24075621474827,6
0.05,9574,95,864060,90.24125326370758,6
0.05,9575,93,864153,90.24154135338345,8
0.05,9576,95,864248,90.24203821656052,6
0.05,9577,93,864341,90.24232616412613,8
0.05,9578,94,864435,90.24271844660194,8
0.05,9579,94,864529,90.24311064718162,7
0.05,9580,92,864621,90.24329401941343,9
0.05,9581,94,864715,90.24368607806304,7
0.05,9582,96,864811,90.24428675780027,6
0.05,9583,96,864907,90.24488731218698,6
0.05,9584,94,865001,90.2452790818988,7
0.05,9585,94,865095,90.24567076987273,7
0.05,9586,96,865191,90.24627099196829,6
0.05,9587,26,865217,90.23957029620358,7
0.05,9588,93,865310,90.23985817082074,8
0.05,9589,96,865406,90.24045881126173,6
0.05,9590,91,865497,90.2405380043791,10
0.05,9591,95,865592,90.24103419516264,6
0.05,9592,93,865685,90.24132179714375,8
0.05,9593,95,865780,90.2418178027934,6
0.05,9594,96,865876,90.24241792600313,6
0.05,9595,96,865972,90.24301792413506,6
0.05,9596,96,866068,90.2436177972283,6
0.05,9597,95,866163,90.24411335694937,6
0.05,9598,92,866255,90.24429628086259,9
0.05,9599,95,866350,90.24479166666667,6
0.05,9600,96,866446,90.24539110509322,6
0.05,9601,95,866541,90.24588627369297,6
0.05,9602,95,866636,90.24638133916484,7
0.05,9603,92,866728,90.24656393169512,10
0.05,9604,95,866823,90.24705882352941,6
0.05,9605,25,866848,90.2402665001041,7
0.05,9606,90,866938,90.24024149057979,11
0.05,9607,94,867032,90.240632805995,7
0.05,9608,94,867126,90.24102403996254,7
0.05,9609,91,867217,90.24110301768991,10
0.05,9610,95,867312,90.24159816876495,6
0.05,9611,93,867405,90.24188514357054,8
0.05,9612,95,867500,90.24238011026735,6
0.05,9613,86,867586,90.24193883919284,15
0.05,9614,94,867680,90.24232969318773,8
0.05,9615,93,867773,90.24261647254576,8
0.05,9616,90,867863,90.24259124467089,11
0.05,9617,96,867959,90.24318985236016,6
0.05,9618,92,868051,90.24337249194303,9
0.05,9619,94,868145,90.243762993763,7
0.05,9620,92,868237,90.24394553580709,10
0.05,9621,92,868329,90.24412803990855,9
0.05,9622,95,868424,90.24462225917074,6
0.05,9623,92,868516,90.2448046550291,9
0.05,9624,94,868610,90.2451948051948,7
0.05,9625,92,868702,90.24537710367754,9
0.05,9626,95,868797,90.24587098784669,7
0.05,9627,95,868892,90.24636476942251,6
0.05,9628,96,868988,90.24696230138125,6
0.05,9629,93,869081,90.2472481827622,8
0.05,9630,94,869175,90.24763783615408,8
0.05,9631,95,869270,90.24813122923588,7
0.05,9632,92,869362,90.24831309041835,9
0.05,9633,94,869456,90.24870251193688,7
0.05,9634,94,869550,90.24909185262065,7
0.05,9635,91,869641,90.2491697799917,10
0.05,9636,95,869736,90.24966275811974,6
0.05,9637,95,869831,90.25015563394895,7
0.05,9638,94,869925,90.25054466230937,7
0.05,9639,96,870021,90.25114107883817,6
0.05,9640,92,870113,90.25132247692149,9
0.05,9641,95,870208,90.25181497614602,7
0.05,9642,93,870301,90.25209996888935,8
0.05,9643,96,870397,90.25269597677313,6
0.05,9644,95,870492,90.25318818040435,6
0.05,9645,94,870586,90.25357661206718,7
0.05,9646,94,870680,90.253964963201,7
0.05,9647,92,870772,90.25414593698176,9
0.05,9648,95,870867,90.2546377862991,6
0.05,9649,95,870962,90.25512953367875,6
0.05,9650,94,871056,90.25551756294685,7
0.05,9651,96,871152,90.25611272275177,6
0.05,9652,94,871246,90.25650056977105,7
0.05,9653,94,871340,90.25688833644085,7
0.05,9654,94,871434,90.25727602278612,9
0.05,9655,95,871529,90.25776719138359,6
0.05,9656,95,871624,90.25825825825825,6
0.05,9657,96,871720,90.25885276454753,6
0.05,9658,94,871814,90.25924008696552,7
0.05,9659,94,871908,90.25962732919254,7
0.05,9660,94,872002,90.2600144912535,7
0.05,9661,95,872097,90.26050507141379,6
0.05,9662,96,872193,90.26109903756597,6
0.05,9663,94,872287,90.26148592715232,7
0.05,9664,94,872381,90.26187273667874,7
0.05,9665,94,872475,90.26225946617008,7
0.05,9666,96,872571,90.26285300506879,6
0.05,9667,93,872664,90.26313611915597,8
0.05,9668,93,872757,90.26341917468197,9
0.05,9669,95,872852,90.26390899689763,6
0.05,9670,93,872945,90.2641919139696,8
0.05,9671,96,873041,90.26478494623656,6
0.05,9672,91,873132,90.26486095316861,10
0.05,9673,94,873226,90.26524705395907,7
0.05,9674,91,873317,90.26532299741602,10
0.05,9675,91,873408,90.26539892517569,10
0.05,9676,95,873503,90.26588818848816,6
0.05,9677,93,873596,90.26617069642488,8
0.05,9678,93,873689,90.26645314598616,8
0.05,9679,95,873784,90.26694214876034,6
0.05,9680,94,873878,90.26732775539718,8
0.05,9681,94,873972,90.26771328237967,8
0.05,9682,92,874064,90.26789218217495,9
0.05,9683,95,874159,90.26838083436597,6
0.05,9684,94,874253,90.26876613319567,7
0.05,9685,95,874348,90.26925459425976,7
0.05,9686,94,874442,90.26963972334056,7
0.05,9687,94,874536,90.27002477291495,7
0.05,9688,96,874632,90.27061616265868,6
0.05,9689,93,874725,90.27089783281734,8
0.05,9690,93,874818,90.27117944484573,8
0.05,9691,95,874913,90.2716673545192,6
0.05,9692,95,875008,90.27215516352007,6
0.05,9693,94,875102,90.2725397152878,7
0.05,9694,94,875196,90.27292418772564,8
0.05,9695,94,875290,90.27330858085809,7
0.05,9696,94,875384,90.2736928947097,7
0.05,9697,87,875471,90.27335533099608,14
0.05,9698,94,875565,90.27373956077946,7
0.05,9699,92,875657,90.2739175257732,9
0.05,9700,25,875682,90.26718894959282,8
0.05,9701,96,875778,90.26777983920842,6
0.05,9702,95,875873,90.26826754611976,7
0.05,9703,94,875967,90.26865210222589,7
0.05,9704,94,876061,90.26903657908295,7
0.05,9705,92,876153,90.26921491860705,9
0.05,9706,93,876246,90.26949623982694,8
0.05,9707,94,876340,90.26988051091882,7
0.05,9708,91,876431,90.26995571119579,10
0.05,9709,94,876525,90.27033985581875,7
0.05,9710,92,876617,90.27051796931315,10
0.05,9711,95,876712,90.27100494233937,6
0.05,9712,94,876806,90.27138886029033,7
0.05,9713,93,876899,90.2716697549928,8
0.05,9714,94,876993,90.27205352547607,7
0.05,9715,94,877087,90.27243721696172,7
0.05,9716,94,877181,90.27282082947411,7
0.05,9717,89,877270,90.2726898538794,12
0.05,9718,92,877362,90.27286757896903,9
0.05,9719,94,877456,90.27325102880658,7
0.05,9720,94,877550,90.2736343997531,7
0.05,9721,96,877646,90.27422341082082,6
0.05,9722,93,877739,90.2745037539854,8
0.05,9723,95,877834,90.27498971616619,6
0.05,9724,96,877930,90.27557840616967,6
0.05,9725,91,878021,90.27565288916307,10
0.05,9726,91,878112,90.27572735684178,10
0.05,9727,94,878206,90.27611019736842,7
0.05,9728,94,878300,90.27649295919416,7
0.05,9729,93,878393,90.27677286742035,8
0.05,9730,94,878487,90.27715548247868,8
0.05,9731,96,878583,90.27774352651048,6
0.05,9732,22,878605,90.27072844960443,10
0.05,9733,96,878701,90.27131703307992,6
0.05,9734,92,878793,90.27149460708783,9
0.05,9735,96,878889,90.27208299096138,6
0.05,9736,94,878983,90.27246585190511,7
0.05,9737,91,879074,90.27254056274388,10
0.05,9738,94,879168,90.27292329807989,7
0.05,9739,95,879263,90.27340862422997,6
0.05,9740,94,879357,90.27379119186942,7
0.05,9741,92,879449,90.27396838431534,9
0.05,9742,92,879541,90.27414554038798,9
0.05,9743,96,879637,90.27473316912972,6
0.05,9744,95,879732,90.27521806054386,8
0.05,9745,93,879825,90.27549764005747,8
0.05,9746,96,879921,90.27608494921515,6
0.05,9747,94,880015,90.27646696758309,7
0.05,9748,93,880108,90.27674633295723,8
0.05,9749,96,880204,90.27733333333333,6
0.05,9750,94,880298,90.27771510614296,8
0.05,9751,94,880392,90.27809680065627,7
0.05,9752,94,880486,90.27847841689737,7
0.05,9753,94,880580,90.27885995489031,7
0.05,9754,92,880672,90.27903639159405,9
0.05,9755,90,880762,90.2790077900779,11
0.05,9756,93,880855,90.27928666598339,8
0.05,9757,27,880882,90.27280180364829,6
0.05,9758,96,880978,90.27338866687161,6
0.05,9759,92,881070,90.2735655737705,9
0.05,9760,93,881163,90.2738448929413,8
0.05,9761,94,881257,90.27422659291129,7
0.05,9762,94,881351,90.27460821468812,7
0.05,9763,94,881445,90.27498975829577,7
0.05,9764,27,881472,90.26850998463901,6
0.05,9765,94,881566,90.26889207454434,7
0.05,9766,95,881661,90.26937647179277,6
0.05,9767,96,881757,90.26996314496314,6
0.05,9768,94,881851,90.27034496877879,7
0.05,9769,26,881877,90.26376663254862,6
0.05,9770,92,881969,90.2639443250435,9
0.05,9771,93,882062,90.26422431436758,8
0.05,9772,96,882158,90.26481121457076,6
0.05,9773,92,882250,90.26498874565173,9
0.05,9774,92,882342,90.2651662404092,9
0.05,9775,93,882435,90.26544599018003,8
0.05,9776,92,882527,90.26562340186152,9
0.05,9777,95,882622,90.2661075884639,6
0.05,9778,95,882717,90.26659167604049,7
0.05,9779,93,882810,90.26687116564418,8
0.05,9780,92,882902,90.2670483590635,9
0.05,9781,94,882996,90.26742997342056,7
0.05,9782,93,883089,90.26770929162834,8
0.05,9783,96,883185,90.26829517579722,6
0.05,9784,96,883281,90.26888094021461,6
0.05,9785,95,883376,90.26936439811976,7
0.05,9786,93,883469,90.26964340451619,8
0.05,9787,94,883563,90.27002451982018,8
0.05,9788,94,883657,90.27040555725814,8
0.05,9789,95,883752,90.2708886618999,6
0.05,9790,93,883845,90.27116739863139,8
0.05,9791,92,883937,90.27134395424837,9
0.05,9792,94,884031,90.27172470131727,7
0.05,9793,91,884122,90.27179906064937,10
0.05,9794,95,884217,90.27228177641653,6
0.05,9795,96,884313,90.2728664761127,6
0.05,9796,94,884407,90.2732469123201,7
0.05,9797,95,884502,90.27372933251684,6
0.05,9798,95,884597,90.27421165425044,7
0.05,9799,94,884691,90.2745918367347,7
0.05,9800,94,884785,90.27497194163861,7
0.05,9801,94,884879,90.27535196898592,7
0.05,9802,94,884973,90.27573191880036,7
0.05,9803,90,885063,90.27570379436965,11
0.05,9804,95,885158,90.27618561958185,6
0.05,9805,93,885251,90.27646338976137,9
0.05,9806,19,885270,90.26919547262159,13
0.05,9807,96,885366,90.269779771615,6
0.05,9808,93,885459,90.27005810989907,8
0.05,9809,95,885554,90.27054026503568,6
0.05,9810,92,885646,90.2707165426562,9
0.05,9811,95,885741,90.2711985324093,6
0.05,9812,96,885837,90.27178232956282,6
0.05,9813,94,885931,90.27216221724068,7
0.05,9814,95,886026,90.27264391237901,6
0.05,9815,96,886122,90.27322738386309,6
0.05,9816,94,886216,90.27360700825099,7
0.05,9817,94,886310,90.27398655530658,7
0.05,9818,94,886404,90.27436602505347,8
0.05,9819,94,886498,90.27474541751528,7
0.05,9820,92,886590,90.27492108746563,10
0.05,9821,94,886684,90.27530034616167,7
0.05,9822,95,886779,90.27578132953273,7
0.05,9823,96,886875,90.27636400651465,6
0.05,9824,94,886969,90.27674300254453,7
0.05,9825,94,887063,90.27712192143294,8
0.05,9826,96,887159,90.27770428411519,7
0.05,9827,92,887251,90.27787952787953,9
0.05,9828,95,887346,90.2783599552345,6
0.05,9829,96,887442,90.27894201424212,6
0.05,9830,95,887537,90.27942223578476,7
0.05,9831,92,887629,90.27959723352319,9
0.05,9832,94,887723,90.27997559239296,7
0.05,9833,94,887817,90.2803538743136,7
0.05,9834,94,887911,90.28073207930859,7
0.05,9835,94,888005,90.28111020740138,7
0.05,9836,95,888100,90.28158991562468,6
0.05,9837,85,888185,90.28105305956495,16
0.05,9838,95,888280,90.28153267608496,7
0.05,9839,94,888374,90.28191056910569,7
0.05,9840,94,888468,90.2822883853267,7
0.05,9841,94,888562,90.28266612477138,7
0.05,9842,25,888587,90.276033729554,8
0.05,9843,95,888682,90.2765136123527,6
0.05,9844,93,888775,90.27679024885728,8
0.05,9845,95,888870,90.27726995734308,6
0.05,9846,94,888964,90.27764801462375,7
0.05,9847,94,889058,90.27802599512592,7
0.05,9848,95,889153,90.27850543202355,6
0.05,9849,94,889247,90.27888324873096,7
0.05,9850,27,889274,90.27245964876663,6
0.05,9851,94,889368,90.27283800243606,7
0.05,9852,96,889464,90.27341926316858,6
0.05,9853,95,889559,90.2738989242947,6
0.05,9854,95,889654,90.27437848807712,6
0.05,9855,94,889748,90.27475649350649,7
0.05,9856,94,889842,90.275134422238,7
0.05,9857,94,889936,90.27551227429498,7
0.05,9858,94,890030,90.27589004970078,7
0.05,9859,96,890126,90.2764705882353,6
0.05,9860,93,890219,90.27674678024542,8
0.05,9861,90,890309,90.27671871831272,11
0.05,9862,95,890404,90.2771976072189,6
0.05,9863,96,890500,90.27777777777777,6
0.05,9864,93,890593,90.27805372529143,8
0.05,9865,93,890686,90.278329616866,8
0.05,9866,96,890782,90.2789094963008,6
0.05,9867,95,890877,90.27938792055127,6
0.05,9868,94,890971,90.279764920458,8
0.05,9869,96,891067,90.28034447821682,6
0.05,9870,96,891163,90.28092391854929,6
0.05,9871,96,891259,90.28150324149108,6
0.05,9872,92,891351,90.281677301732,9
0.05,9873,96,891447,90.28225643103099,6
0.05,9874,96,891543,90.28283544303797,6
0.05,9875,96,891639,90.28341433778859,6
0.05,9876,94,891733,90.2837906246836,7
0.05,9877,94,891827,90.28416683539179,7
0.05,9878,95,891922,90.28464419475655,6
0.05,9879,87,892009,90.28431174089069,14
0.05,9880,95,892104,90.28478898896873,7
0.05,9881,95,892199,90.2852661404574,7
0.05,9882,94,892293,90.28564201153496,7
0.05,9883,93,892386,90.28591663294213,8
0.05,9884,94,892480,90.2862923621649,7
0.05,9885,95,892575,90.28676916852115,6
0.05,9886,93,892668,90.28704359259633,8
0.05,9887,90,892758,90.2870145631068,11
0.05,9888,94,892852,90.28739002932551,7
0.05,9889,95,892947,90.28786653185036,6
0.05,9890,94,893041,90.28824183601253,8
0.05,9891,90,893131,90.288212697129,11
0.05,9892,94,893225,90.28858789042758,7
0.05,9893,94,893319,90.28896300788357,7
0.05,9894,95,893414,90.28943911066195,6
0.05,9895,95,893509,90.28991511721908,6
0.05,9896,94,893603,90.2902899868647,7
0.05,9897,94,893697,90.29066478076379,8
0.05,9898,94,893791,90.29103949893928,7
0.05,9899,94,893885,90.29141414141414,7
0.05,9900,91,893976,90.29148570851429,10
0.05,9901,92,894068,90.29165825085842,10
0.05,9902,96,894164,90.29223467636069,6
0.05,9903,91,894255,90.29230613893377,10
0.05,9904,95,894350,90.29278142352348,7
0.05,9905,93,894443,90.29305471431455,8
0.05,9906,94,894537,90.29342888866458,7
0.05,9907,92,894629,90.29360113039968,9
0.05,9908,91,894720,90.29367241901302,11
0.05,9909,92,894812,90.29384460141272,9
0.05,9910,92,894904,90.2940167490667,9
0.05,9911,96,895000,90.29459241323649,6
0.05,9912,95,895095,90.29506708362756,6
0.05,9913,92,895187,90.29523905588057,9
0.05,9914,94,895281,90.29561270801815,7
0.05,9915,91,895372,90.29568374344494,10
0.05,9916,91,895463,90.29575476454573,10
0.05,9917,94,895557,90.29612825166365,8
0.05,9918,94,895651,90.29650166347415,7
0.05,9919,94,895745,90.296875,7
0.05,9920,94,895839,90.29724826126399,7
0.05,9921,94,895933,90.29762144728885,7
0.05,9922,93,896026,90.29789378212234,8
0.05,9923,95,896121,90.29836759371221,6
0.05,9924,93,896214,90.29863979848867,8
0.05,9925,95,896309,90.29911343945194,6
0.05,9926,94,896403,90.29948624962225,7
0.05,9927,96,896499,90.30006043513296,6
0.05,9928,93,896592,90.30033235975425,8
0.05,9929,91,896683,90.30040281973817,10
0.05,9930,94,896777,90.3007753499144,7
0.05,9931,92,896869,90.3009464357632,9
0.05,9932,94,896963,90.30131883620255,7
0.05,9933,89,897052,90.3011878397423,12
0.05,9934,95,897147,90.3016607951686,7
0.05,9935,95,897242,90.30213365539453,6
0.05,9936,94,897336,90.30250578645466,7
0.05,9937,95,897431,90.30297846649225,6
0.05,9938,94,897525,90.30335043766979,7
0.05,9939,96,897621,90.30392354124749,6
0.05,9940,91,897712,90.30399356201589,10
0.05,9941,94,897806,90.30436531884932,7
0.05,9942,96,897902,90.30493814744041,6
0.05,9943,94,897996,90.30530973451327,7
0.05,9944,96,898092,90.30588235294118,6
0.05,9945,88,898180,90.30565051276895,13
0.05,9946,94,898274,90.30602191615563,8
0.05,9947,22,898296,90.29915560916767,10
0.05,9948,90,898386,90.2991255402553,11
0.05,9949,94,898480,90.29949748743718,7
0.05,9950,91,898571,90.29956788262486,10
0.05,9951,91,898662,90.2996382636656,10
0.05,9952,93,898755,90.29990957500252,8
0.05,9953,93,898848,90.3001808318264,9
0.05,9954,94,898942,90.30055248618784,7
0.05,9955,95,899037,90.30102450783447,6
0.05,9956,93,899130,90.3012955709551,8
0.05,9957,94,899224,90.3016670014059,7
0.05,9958,96,899320,90.30223918064063,6
0.05,9959,96,899416,90.30281124497992,6
0.05,9960,93,899509,90.30308201987752,8
0.05,9961,94,899603,90.30345312186309,7
0.05,9962,96,899699,90.30402489210077,6
0.05,9963,89,899788,90.30389401846648,12
0.05,9964,94,899882,90.30426492724536,7
0.05,9965,27,899909,90.29791290387317,6
0.05,9966,88,899997,90.29768235176081,14
0.05,9967,96,900093,90.2982544141252,6
0.05,9968,96,900189,90.29882636172134,6
0.05,9969,94,900283,90.29919759277834,7
0.05,9970,96,900379,90.29976933106008,6
0.05,9971,95,900474,90.30024067388689,6
0.05,9972,96,900570,90.30081219292089,6
0.05,9973,94,900664,90.3011830759976,8
0.05,9974,93,900757,90.3014536340852,9
0.05,9975,96,900853,90.30202485966319,6
0.05,9976,92,900945,90.30219504861181,9
0.05,9977,95,901040,90.30266586490279,6
0.05,9978,96,901136,90.30323679727428,6
0.05,9979,94,901230,90.30360721442885,8
0.05,9980,94,901324,90.30397755735898,7
0.05,9981,94,901418,90.30434782608695,7
0.05,9982,96,901514,90.30491836121406,6
0.05,9983,91,901605,90.30498798076923,10
0.05,9984,95,901700,90.30545818728092,6
0.05,9985,96,901796,90.30602843981575,6
0.05,9986,94,901890,90.30639831781316,7
0.05,9987,18,901908,90.29915899078895,15
0.05,9988,92,902000,90.29932926218841,10
0.05,9989,92,902092,90.2994994994995,9
0.05,9990,94,902186,90.29986988289461,7
0.05,9991,93,902279,90.30014011208968,8
0.05,9992,94,902373,90.30051035725008,7
0.05,9993,94,902467,90.300880528317,7
0.05,9994,93,902560,90.30115057528765,8
0.05,9995,96,902656,90.30172068827531,6
0.05,9996,96,902752,90.30229068720617,6
0.05,9997,96,902848,90.30286057211443,6
0.05,9998,92,902940,90.3030303030303,9
0.05,9999,94,903034,90.3034,7
