0.05,0,-6,-6,-6.0,107
0.05,1,-8,-14,-7.0,110
0.05,2,92,78,26.0,8
0.05,3,55,133,33.25,45
0.05,4,92,225,45.0,8
0.05,5,95,320,53.333333333333336,6
0.05,6,-125,195,27.857142857142858,230
0.05,7,90,285,35.625,11
0.05,8,72,357,39.666666666666664,29
0.05,9,-25,332,33.2,57
0.05,10,-21,311,28.272727272727273,124
0.05,11,-103,208,17.333333333333332,225
0.05,12,-47,161,12.384615384615385,148
0.05,13,75,236,16.857142857142858,25
0.05,14,90,326,21.733333333333334,10
0.05,15,76,402,25.125,25
0.05,16,61,463,27.235294117647058,39
0.05,17,-60,403,22.38888888888889,160
0.05,18,84,487,25.63157894736842,17
0.05,19,-15,472,23.6,48
0.05,20,48,520,24.761904761904763,54
0.05,21,-94,426,19.363636363636363,127
0.05,22,-7,419,18.217391304347824,107
0.05,23,23,442,18.416666666666668,77
0.05,24,37,479,19.16,65
0.05,25,92,571,21.96153846153846,8
0.05,26,94,665,24.62962962962963,7
0.05,27,63,728,26.0,37
0.05,28,93,821,28.310344827586206,8
0.05,29,-224,597,19.9,201
0.05,30,60,657,21.193548387096776,40
0.05,31,16,673,21.03125,16
0.05,32,55,728,22.060606060606062,45
0.05,33,29,757,22.264705882352942,71
0.05,34,45,802,22.914285714285715,55
0.05,35,53,855,23.75,48
0.05,36,-22,833,22.513513513513512,123
0.05,37,95,928,24.42105263157895,6
0.05,38,79,1007,25.82051282051282,21
0.05,39,-47,960,24.0,152
0.05,40,46,1006,24.536585365853657,55
0.05,41,2,1008,24.0,29
0.05,42,9,1017,23.651162790697676,92
0.05,43,-54,963,21.886363636363637,156
0.05,44,66,1029,22.866666666666667,34
0.05,45,0,1029,22.369565217391305,103
0.05,46,52,1081,23.0,49
0.05,47,73,1154,24.041666666666668,28
0.05,48,72,1226,25.020408163265305,29
0.05,49,30,1256,25.12,70
0.05,50,77,1333,26.137254901960784,24
0.05,51,59,1392,26.76923076923077,42
0.05,52,88,1480,27.92452830188679,12
0.05,53,65,1545,28.61111111111111,35
0.05,54,94,1639,29.8,6
0.05,55,88,1727,30.839285714285715,13
0.05,56,47,1774,31.12280701754386,55
0.05,57,86,1860,32.06896551724138,14
0.05,58,-130,1730,29.322033898305083,163
0.05,59,-181,1549,25.816666666666666,214
0.05,60,71,1620,26.557377049180328,30
0.05,61,-15,1605,25.887096774193548,49
0.05,62,78,1683,26.714285714285715,22
0.05,63,-23,1660,25.9375,123
0.05,64,91,1751,26.93846153846154,9
0.05,65,79,1830,27.727272727272727,21
0.05,66,40,1870,27.91044776119403,61
0.05,67,48,1918,28.205882352941178,54
0.05,68,29,1947,28.217391304347824,72
0.05,69,-22,1925,27.5,126
0.05,70,-13,1912,26.929577464788732,113
0.05,71,45,1957,27.180555555555557,55
0.05,72,80,2037,27.904109589041095,20
0.05,73,-43,1994,26.945945945945947,75
0.05,74,32,2026,27.013333333333332,70
0.05,75,61,2087,27.460526315789473,39
0.05,76,61,2148,27.896103896103895,40
0.05,77,-11,2137,27.397435897435898,43
0.05,78,95,2232,28.253164556962027,6
0.05,79,65,2297,28.7125,35
0.05,80,-115,2182,26.938271604938272,220
0.05,81,88,2270,27.682926829268293,12
0.05,82,-8,2262,27.253012048192772,110
0.05,83,60,2322,27.642857142857142,40
0.05,84,88,2410,28.352941176470587,12
0.05,85,34,2444,28.41860465116279,70
0.05,86,53,2497,28.701149425287355,49
0.05,87,-36,2461,27.96590909090909,67
0.05,88,95,2556,28.719101123595507,6
0.05,89,-65,2491,27.677777777777777,96
0.05,90,74,2565,28.186813186813186,26
0.05,91,-3,2562,27.847826086956523,49
0.05,92,-214,2348,25.247311827956988,248
0.05,93,78,2426,25.80851063829787,23
0.05,94,94,2520,26.526315789473685,7
0.05,95,-53,2467,25.697916666666668,157
0.05,96,-10,2457,25.329896907216494,42
0.05,97,77,2534,25.857142857142858,24
0.05,98,65,2599,26.252525252525253,35
0.05,99,-41,2558,25.58,141
0.05,100,65,2623,25.97029702970297,35
0.05,101,45,2668,26.15686274509804,56
0.05,102,26,2694,26.155339805825243,75
0.05,103,77,2771,26.64423076923077,24
0.05,104,-62,2709,25.8,166
0.05,105,95,2804,26.452830188679247,6
0.05,106,-17,2787,26.046728971962615,118
0.05,107,64,2851,26.39814814814815,37
0.05,108,44,2895,26.559633027522935,70
0.05,109,-210,2685,24.40909090909091,251
0.05,110,29,2714,24.45045045045045,72
0.05,111,40,2754,24.589285714285715,61
0.05,112,25,2779,24.5929203539823,88
0.05,113,92,2871,25.18421052631579,9
0.05,114,75,2946,25.617391304347827,26
0.05,115,-88,2858,24.637931034482758,121
0.05,116,93,2951,25.22222222222222,8
0.05,117,33,2984,25.28813559322034,79
0.05,118,12,2996,25.176470588235293,20
0.05,119,-42,2954,24.616666666666667,145
0.05,120,62,3016,24.925619834710744,46
0.05,121,89,3105,25.450819672131146,12
0.05,122,57,3162,25.70731707317073,43
0.05,123,88,3250,26.20967741935484,12
0.05,124,16,3266,26.128,86
0.05,125,59,3325,26.38888888888889,41
0.05,126,76,3401,26.77952755905512,25
0.05,127,-19,3382,26.421875,120
0.05,128,52,3434,26.62015503875969,49
0.05,129,16,3450,26.53846153846154,15
0.05,130,-13,3437,26.236641221374047,114
0.05,131,-88,3349,25.37121212121212,125
0.05,132,-103,3246,24.406015037593985,207
0.05,133,10,3256,24.29850746268657,92
0.05,134,67,3323,24.614814814814814,34
0.05,135,62,3385,24.889705882352942,65
0.05,136,79,3464,25.284671532846716,22
0.05,137,14,3478,25.202898550724637,86
0.05,138,-11,3467,24.942446043165468,112
0.05,139,-86,3381,24.15,199
0.05,140,10,3391,24.04964539007092,90
0.05,141,29,3420,24.08450704225352,72
0.05,142,-225,3195,22.342657342657343,326
0.05,143,62,3257,22.618055555555557,38
0.05,144,13,3270,22.551724137931036,19
0.05,145,-108,3162,21.65753424657534,156
0.05,146,-63,3099,21.081632653061224,95
0.05,147,69,3168,21.405405405405407,32
0.05,148,-197,2971,19.93959731543624,162
0.05,149,-84,2887,19.246666666666666,116
0.05,150,89,2976,19.70860927152318,12
0.05,151,28,3004,19.763157894736842,74
0.05,152,27,3031,19.81045751633987,75
0.05,153,94,3125,20.292207792207794,6
0.05,154,95,3220,20.774193548387096,6
0.05,155,-311,2909,18.647435897435898,347
0.05,156,87,2996,19.0828025477707,14
0.05,157,-8,2988,18.911392405063292,109
0.05,158,-37,2951,18.559748427672957,139
0.05,159,65,3016,18.85,35
0.05,160,94,3110,19.316770186335404,6
0.05,161,95,3205,19.78395061728395,6
0.05,162,39,3244,19.901840490797547,64
0.05,163,46,3290,20.0609756097561,55
0.05,164,72,3362,20.375757575757575,29
0.05,165,-21,3341,20.126506024096386,54
0.05,166,84,3425,20.508982035928145,16
0.05,167,29,3454,20.55952380952381,72
0.05,168,-4,3450,20.414201183431953,104
0.05,169,1,3451,20.3,100
0.05,170,-18,3433,20.076023391812864,121
0.05,171,-4,3429,19.936046511627907,105
0.05,172,-156,3273,18.91907514450867,262
0.05,173,82,3355,19.2816091954023,48
0.05,174,-179,3176,18.14857142857143,210
0.05,175,71,3247,18.448863636363637,30
0.05,176,5,3252,18.372881355932204,95
0.05,177,72,3324,18.674157303370787,28
0.05,178,-57,3267,18.251396648044693,161
0.05,179,61,3328,18.488888888888887,40
0.05,180,63,3391,18.734806629834253,38
0.05,181,-106,3285,18.04945054945055,140
0.05,182,64,3349,18.30054644808743,37
0.05,183,65,3414,18.554347826086957,36
0.05,184,-61,3353,18.124324324324323,97
0.05,185,57,3410,18.333333333333332,44
0.05,186,49,3459,18.497326203208555,52
0.05,187,83,3542,18.840425531914892,17
0.05,188,-33,3509,18.566137566137566,65
0.05,189,40,3549,18.678947368421053,60
0.05,190,-60,3489,18.267015706806284,165
0.05,191,2,3491,18.182291666666668,102
0.05,192,95,3586,18.580310880829014,6
0.05,193,61,3647,18.798969072164947,39
0.05,194,13,3660,18.76923076923077,90
0.05,195,64,3724,19.0,36
0.05,196,90,3814,19.360406091370557,11
0.05,197,32,3846,19.424242424242426,69
0.05,198,24,3870,19.44723618090452,78
0.05,199,85,3955,19.775,15
0.05,200,39,3994,19.870646766169155,117
0.05,201,-19,3975,19.678217821782177,122
0.05,202,6,3981,19.610837438423644,96
0.05,203,-150,3831,18.779411764705884,185
0.05,204,43,3874,18.897560975609757,57
0.05,205,92,3966,19.25242718446602,8
0.05,206,29,3995,19.29951690821256,72
0.05,207,77,4072,19.576923076923077,23
0.05,208,-188,3884,18.583732057416267,151
0.05,209,72,3956,18.83809523809524,28
0.05,210,78,4034,19.118483412322274,22
0.05,211,2,4036,19.037735849056602,30
0.05,212,46,4082,19.164319248826292,54
0.05,213,-308,3774,17.635514018691588,207
0.05,214,12,3786,17.609302325581396,89
0.05,215,54,3840,17.77777777777778,64
0.05,216,36,3876,17.861751152073733,67
0.05,217,63,3939,18.068807339449542,37
0.05,218,-53,3886,17.744292237442924,86
0.05,219,83,3969,18.04090909090909,18
0.05,220,92,4061,18.375565610859727,9
0.05,221,72,4133,18.617117117117118,29
0.05,222,67,4200,18.83408071748879,34
0.05,223,28,4228,18.875,72
0.05,224,61,4289,19.06222222222222,39
0.05,225,23,4312,19.079646017699115,8
0.05,226,95,4407,19.41409691629956,6
0.05,227,-14,4393,19.267543859649123,116
0.05,228,68,4461,19.480349344978166,32
0.05,229,32,4493,19.534782608695654,69
0.05,230,65,4558,19.73160173160173,35
0.05,231,90,4648,20.03448275862069,10
0.05,232,38,4686,20.111587982832617,63
0.05,233,23,4709,20.123931623931625,78
0.05,234,65,4774,20.314893617021276,35
0.05,235,-169,4605,19.51271186440678,271
0.05,236,-57,4548,19.189873417721518,159
0.05,237,91,4639,19.491596638655462,10
0.05,238,82,4721,19.753138075313807,18
0.05,239,-13,4708,19.616666666666667,114
0.05,240,25,4733,19.639004149377595,77
0.05,241,89,4822,19.925619834710744,11
0.05,242,-25,4797,19.74074074074074,56
0.05,243,11,4808,19.704918032786885,90
0.05,244,-34,4774,19.485714285714284,68
0.05,245,92,4866,19.78048780487805,9
0.05,246,77,4943,20.012145748987855,23
0.05,247,-100,4843,19.528225806451612,142
0.05,248,84,4927,19.78714859437751,17
0.05,249,55,4982,19.928,46
0.05,250,89,5071,20.203187250996017,11
0.05,251,-24,5047,20.02777777777778,127
0.05,252,77,5124,20.25296442687747,23
0.05,253,27,5151,20.27952755905512,73
0.05,254,81,5232,20.51764705882353,19
0.05,255,67,5299,20.69921875,34
0.05,256,62,5361,20.859922178988327,38
0.05,257,57,5418,21.0,44
0.05,258,61,5479,21.154440154440156,40
0.05,259,-45,5434,20.9,153
0.05,260,51,5485,21.015325670498083,50
0.05,261,95,5580,21.297709923664122,6
0.05,262,16,5596,21.277566539923953,86
0.05,263,-21,5575,21.117424242424242,122
0.05,264,33,5608,21.162264150943397,68
0.05,265,-67,5541,20.830827067669173,167
0.05,266,67,5608,21.00374531835206,34
0.05,267,11,5619,20.96641791044776,20
0.05,268,90,5709,21.223048327137548,11
0.05,269,55,5764,21.348148148148148,46
0.05,270,-84,5680,20.95940959409594,118
0.05,271,28,5708,20.985294117647058,72
0.05,272,83,5791,21.21245421245421,18
0.05,273,-21,5770,21.05839416058394,123
0.05,274,40,5810,21.12727272727273,61
0.05,275,87,5897,21.365942028985508,13
0.05,276,88,5985,21.60649819494585,13
0.05,277,-22,5963,21.449640287769785,55
0.05,278,-11,5952,21.333333333333332,125
0.05,279,88,6040,21.571428571428573,13
0.05,280,-83,5957,21.199288256227756,115
0.05,281,-49,5908,20.95035460992908,84
0.05,282,-39,5869,20.738515901060072,139
0.05,283,74,5943,20.926056338028168,27
0.05,284,79,6022,21.12982456140351,22
0.05,285,93,6115,21.38111888111888,7
0.05,286,94,6209,21.634146341463413,6
0.05,287,-1,6208,21.555555555555557,102
0.05,288,-124,6084,21.05190311418685,257
0.05,289,90,6174,21.28965517241379,11
0.05,290,-66,6108,20.989690721649485,98
0.05,291,59,6167,21.11986301369863,42
0.05,292,18,6185,21.109215017064848,83
0.05,293,88,6273,21.336734693877553,12
0.05,294,74,6347,21.515254237288136,26
0.05,295,-119,6228,21.04054054054054,152
0.05,296,-362,5866,19.75084175084175,395
0.05,297,-8,5858,19.65771812080537,109
0.05,298,71,5929,19.82943143812709,30
0.05,299,67,5996,19.986666666666668,34
0.05,300,92,6088,20.225913621262457,9
0.05,301,93,6181,20.466887417218544,7
0.05,302,-3,6178,20.38943894389439,105
0.05,303,54,6232,20.5,47
0.05,304,82,6314,20.701639344262293,18
0.05,305,-314,6000,19.607843137254903,360
0.05,306,61,6061,19.742671009771986,39
0.05,307,56,6117,19.86038961038961,45
0.05,308,58,6175,19.983818770226538,42
0.05,309,90,6265,20.20967741935484,10
0.05,310,93,6358,20.443729903536976,8
0.05,311,18,6376,20.435897435897434,83
0.05,312,-34,6342,20.261980830670925,65
0.05,313,63,6405,20.398089171974522,47
0.05,314,65,6470,20.53968253968254,35
0.05,315,39,6509,20.598101265822784,62
0.05,316,67,6576,20.744479495268138,35
0.05,317,87,6663,20.952830188679247,14
0.05,318,76,6739,21.12539184952978,25
0.05,319,48,6787,21.209375,53
0.05,320,89,6876,21.42056074766355,12
0.05,321,89,6965,21.630434782608695,11
0.05,322,3,6968,21.572755417956657,103
0.05,323,22,6990,21.574074074074073,78
0.05,324,54,7044,21.673846153846153,47
0.05,325,52,7096,21.766871165644172,48
0.05,326,66,7162,21.902140672782874,35
0.05,327,59,7221,22.015243902439025,41
0.05,328,95,7316,22.237082066869302,6
0.05,329,-187,7129,21.6030303030303,290
0.05,330,-27,7102,21.45619335347432,59
0.05,331,-8,7094,21.367469879518072,111
0.05,332,93,7187,21.58258258258258,7
0.05,333,61,7248,21.70059880239521,39
0.05,334,10,7258,21.665671641791043,91
0.05,335,81,7339,21.842261904761905,20
0.05,336,53,7392,21.93471810089021,50
0.05,337,40,7432,21.988165680473372,61
0.05,338,92,7524,22.194690265486727,8
0.05,339,-2,7522,22.123529411764707,105
0.05,340,89,7611,22.319648093841643,11
0.05,341,56,7667,22.41812865497076,45
0.05,342,-112,7555,22.026239067055393,213
0.05,343,37,7592,22.069767441860463,63
0.05,344,-51,7541,21.857971014492755,152
0.05,345,45,7586,21.92485549132948,56
0.05,346,85,7671,22.10662824207493,16
0.05,347,93,7764,22.310344827586206,7
0.05,348,-51,7713,22.10028653295129,83
0.05,349,82,7795,22.271428571428572,19
0.05,350,84,7879,22.447293447293447,16
0.05,351,67,7946,22.573863636363637,34
0.05,352,89,8035,22.762039660056658,11
0.05,353,-8,8027,22.675141242937855,108
0.05,354,82,8109,22.84225352112676,18
0.05,355,62,8171,22.952247191011235,38
0.05,356,-107,8064,22.58823529411765,215
0.05,357,-1,8063,22.522346368715084,102
0.05,358,84,8147,22.69359331476323,17
0.05,359,54,8201,22.780555555555555,46
0.05,360,-10,8191,22.689750692520775,43
0.05,361,92,8283,22.88121546961326,8
0.05,362,52,8335,22.961432506887054,49
0.05,363,65,8400,23.076923076923077,35
0.05,364,-27,8373,22.93972602739726,58
0.05,365,-205,8168,22.316939890710383,264
0.05,366,60,8228,22.419618528610354,41
0.05,367,51,8279,22.497282608695652,50
0.05,368,-30,8249,22.355013550135503,62
0.05,369,91,8340,22.54054054054054,9
0.05,370,64,8404,22.652291105121293,37
0.05,371,79,8483,22.803763440860216,22
0.05,372,51,8534,22.87935656836461,49
0.05,373,75,8609,23.018716577540108,25
0.05,374,84,8693,23.181333333333335,17
0.05,375,-59,8634,22.96276595744681,91
0.05,376,-33,8601,22.814323607427056,144
0.05,377,27,8628,22.825396825396826,74
0.05,378,69,8697,22.947229551451187,32
0.05,379,55,8752,23.03157894736842,46
0.05,380,-35,8717,22.879265091863516,136
0.05,381,-83,8634,22.602094240837697,116
0.05,382,61,8695,22.702349869451698,39
0.05,383,69,8764,22.822916666666668,31
0.05,384,16,8780,22.805194805194805,86
0.05,385,82,8862,22.958549222797927,18
0.05,386,81,8943,23.108527131782946,19
0.05,387,93,9036,23.288659793814432,7
0.05,388,-4,9032,23.218508997429307,106
0.05,389,79,9111,23.361538461538462,21
0.05,390,93,9204,23.539641943734015,7
0.05,391,7,9211,23.497448979591837,94
0.05,392,72,9283,23.62086513994911,28
0.05,393,60,9343,23.71319796954315,40
0.05,394,70,9413,23.830379746835444,30
0.05,395,87,9500,23.98989898989899,14
0.05,396,27,9527,23.997481108312343,73
0.05,397,90,9617,24.16331658291457,11
0.05,398,3,9620,24.11027568922306,99
0.05,399,78,9698,24.245,23
0.05,400,24,9722,24.24438902743142,97
0.05,401,90,9812,24.407960199004975,10
0.05,402,42,9854,24.451612903225808,58
0.05,403,87,9941,24.606435643564357,13
0.05,404,84,10025,24.753086419753085,16
0.05,405,55,10080,24.82758620689655,46
0.05,406,-109,9971,24.4987714987715,213
0.05,407,-62,9909,24.28676470588235,180
0.05,408,86,9995,24.43765281173594,14
0.05,409,90,10085,24.597560975609756,11
0.05,410,69,10154,24.70559610705596,32
0.05,411,-5,10149,24.633495145631066,37
0.05,412,86,10235,24.782082324455207,15
0.05,413,67,10302,24.884057971014492,33
0.05,414,85,10387,25.0289156626506,15
0.05,415,-2,10385,24.963942307692307,33
0.05,416,73,10458,25.07913669064748,28
0.05,417,91,10549,25.236842105263158,10
0.05,418,16,10565,25.214797136038186,84
0.05,419,68,10633,25.316666666666666,32
0.05,420,49,10682,25.3729216152019,52
0.05,421,-96,10586,25.085308056872037,196
0.05,422,36,10622,25.11111111111111,64
0.05,423,-49,10573,24.93632075471698,155
0.05,424,93,10666,25.096470588235295,8
0.05,425,-24,10642,24.981220657276996,58
0.05,426,49,10691,25.037470725995316,52
0.05,427,93,10784,25.19626168224299,7
0.05,428,69,10853,25.2983682983683,31
0.05,429,75,10928,25.413953488372094,25
0.05,430,44,10972,25.45707656612529,56
0.05,431,-96,10876,25.175925925925927,198
0.05,432,78,10954,25.297921478060047,22
0.05,433,40,10994,25.331797235023043,60
0.05,434,58,11052,25.406896551724138,42
0.05,435,72,11124,25.513761467889907,29
0.05,436,88,11212,25.65675057208238,12
0.05,437,94,11306,25.812785388127853,6
0.05,438,63,11369,25.89749430523918,37
0.05,439,86,11455,26.03409090909091,15
0.05,440,-37,11418,25.891156462585034,140
0.05,441,-171,11247,25.445701357466064,135
0.05,442,57,11304,25.516930022573362,43
0.05,443,56,11360,25.585585585585587,45
0.05,444,50,11410,25.640449438202246,52
0.05,445,61,11471,25.719730941704036,40
0.05,446,85,11556,25.85234899328859,16
0.05,447,59,11615,25.926339285714285,41
0.05,448,94,11709,26.07795100222717,7
0.05,449,65,11774,26.164444444444445,36
0.05,450,91,11865,26.30820399113082,10
0.05,451,67,11932,26.398230088495577,35
0.05,452,80,12012,26.516556291390728,20
0.05,453,91,12103,26.658590308370044,9
0.05,454,77,12180,26.76923076923077,24
0.05,455,-64,12116,26.57017543859649,167
0.05,456,38,12154,26.595185995623634,64
0.05,457,83,12237,26.71834061135371,18
0.05,458,93,12330,26.862745098039216,8
0.05,459,18,12348,26.843478260869563,14
0.05,460,13,12361,26.81344902386117,87
0.05,461,-203,12158,26.316017316017316,236
0.05,462,4,12162,26.26781857451404,96
0.05,463,64,12226,26.349137931034484,36
0.05,464,-1,12225,26.29032258064516,131
0.05,465,81,12306,26.40772532188841,19
0.05,466,-101,12205,26.134903640256958,138
0.05,467,71,12276,26.23076923076923,29
0.05,468,85,12361,26.356076759061835,16
0.05,469,-160,12201,25.959574468085105,272
0.05,470,10,12211,25.92569002123142,23
0.05,471,-46,12165,25.77330508474576,79
0.05,472,72,12237,25.87103594080338,30
0.05,473,86,12323,25.99789029535865,14
0.05,474,-83,12240,25.768421052631577,195
0.05,475,-52,12188,25.605042016806724,155
0.05,476,-105,12083,25.331236897274632,149
0.05,477,19,12102,25.317991631799163,83
0.05,478,87,12189,25.44676409185804,13
0.05,479,66,12255,25.53125,36
0.05,480,-20,12235,25.436590436590436,121
0.05,481,90,12325,25.570539419087137,11
0.05,482,-124,12201,25.26086956521739,229
0.05,483,61,12262,25.334710743801654,40
0.05,484,-241,12021,24.78556701030928,346
0.05,485,71,12092,24.88065843621399,29
0.05,486,76,12168,24.985626283367555,25
0.05,487,-35,12133,24.862704918032787,67
0.05,488,83,12216,24.98159509202454,17
0.05,489,-11,12205,24.908163265306122,43
0.05,490,-11,12194,24.835030549898168,43
0.05,491,-9,12185,24.766260162601625,116
0.05,492,73,12258,24.864097363083165,27
0.05,493,43,12301,24.90080971659919,57
0.05,494,79,12380,25.01010101010101,21
0.05,495,17,12397,24.993951612903224,83
0.05,496,89,12486,25.122736418511067,11
0.05,497,-40,12446,24.991967871485944,73
0.05,498,53,12499,25.04809619238477,49
0.05,499,39,12538,25.076,62
0.05,500,-95,12443,24.836327345309382,200
0.05,501,66,12509,24.91832669322709,34
0.05,502,6,12515,24.880715705765407,97
0.05,503,85,12600,25.0,15
0.05,504,48,12648,25.045544554455446,52
0.05,505,94,12742,25.181818181818183,7
0.05,506,64,12806,25.25838264299803,36
0.05,507,-9,12797,25.190944881889763,116
0.05,508,35,12832,25.210216110019648,66
0.05,509,-6,12826,25.149019607843137,38
0.05,510,-69,12757,24.964774951076322,171
0.05,511,41,12798,24.99609375,59
0.05,512,9,12807,24.964912280701753,92
0.05,513,-208,12599,24.511673151750973,243
0.05,514,-23,12576,24.419417475728157,137
0.05,515,93,12669,24.552325581395348,8
0.05,516,81,12750,24.661508704061895,20
0.05,517,19,12769,24.65057915057915,13
0.05,518,52,12821,24.703275529865124,49
0.05,519,82,12903,24.81346153846154,19
0.05,520,67,12970,24.89443378119002,33
0.05,521,94,13064,25.026819923371647,31
0.05,522,86,13150,25.1434034416826,15
0.05,523,26,13176,25.14503816793893,75
0.05,524,94,13270,25.276190476190475,7
0.05,525,-25,13245,25.180608365019012,125
0.05,526,-49,13196,25.039848197343453,80
0.05,527,-76,13120,24.848484848484848,178
0.05,528,-14,13106,24.775047258979207,45
0.05,529,84,13190,24.88679245283019,16
0.05,530,92,13282,25.013182674199623,9
0.05,531,93,13375,25.14097744360902,7
0.05,532,-68,13307,24.96622889305816,101
0.05,533,-35,13272,24.853932584269664,137
0.05,534,62,13334,24.92336448598131,39
0.05,535,94,13428,25.05223880597015,7
0.05,536,67,13495,25.130353817504655,34
0.05,537,-44,13451,25.00185873605948,147
0.05,538,-39,13412,24.883116883116884,139
0.05,539,55,13467,24.93888888888889,45
0.05,540,89,13556,25.057301293900185,12
0.05,541,-22,13534,24.970479704797047,54
0.05,542,76,13610,25.064456721915285,25
0.05,543,57,13667,25.123161764705884,46
0.05,544,89,13756,25.240366972477066,11
0.05,545,57,13813,25.2985347985348,43
0.05,546,86,13899,25.409506398537477,14
0.05,547,-12,13887,25.34124087591241,114
0.05,548,53,13940,25.391621129326047,48
0.05,549,49,13989,25.434545454545454,51
0.05,550,95,14084,25.560798548094375,6
0.05,551,-34,14050,25.452898550724637,67
0.05,552,56,14106,25.508137432188065,44
0.05,553,-69,14037,25.337545126353792,172
0.05,554,65,14102,25.409009009009008,35
0.05,555,93,14195,25.530575539568346,8
0.05,556,39,14234,25.55475763016158,73
0.05,557,-117,14117,25.299283154121863,150
0.05,558,-167,13950,24.955277280858677,202
0.05,559,-60,13890,24.803571428571427,161
0.05,560,62,13952,24.8698752228164,39
0.05,561,-48,13904,24.740213523131672,81
0.05,562,-15,13889,24.6696269982238,117
0.05,563,48,13937,24.71099290780142,55
0.05,564,74,14011,24.798230088495576,27
0.05,565,55,14066,24.851590106007066,46
0.05,566,65,14131,24.922398589065256,35
0.05,567,83,14214,25.024647887323944,17
0.05,568,-193,14021,24.641476274165203,157
0.05,569,60,14081,24.703508771929826,40
0.05,570,3,14084,24.665499124343256,28
0.05,571,67,14151,24.73951048951049,33
0.05,572,76,14227,24.82897033158813,24
0.05,573,47,14274,24.86759581881533,54
0.05,574,-24,14250,24.782608695652176,55
0.05,575,-10,14240,24.72222222222222,123
0.05,576,69,14309,24.79896013864818,31
0.05,577,70,14379,24.877162629757784,30
0.05,578,-2,14377,24.830742659758204,113
0.05,579,39,14416,24.855172413793102,61
0.05,580,-138,14278,24.57487091222031,241
0.05,581,41,14319,24.603092783505154,62
0.05,582,28,14347,24.60891938250429,81
0.05,583,85,14432,24.71232876712329,15
0.05,584,-74,14358,24.543589743589745,109
0.05,585,64,14422,24.610921501706486,37
0.05,586,78,14500,24.701873935264054,22
0.05,587,39,14539,24.726190476190474,62
0.05,588,24,14563,24.724957555178268,8
0.05,589,63,14626,24.789830508474576,38
0.05,590,26,14652,24.79187817258883,75
0.05,591,9,14661,24.7652027027027,92
0.05,592,-3,14658,24.718381112984822,38
0.05,593,71,14729,24.796296296296298,30
0.05,594,77,14806,24.88403361344538,23
0.05,595,67,14873,24.95469798657718,34
0.05,596,70,14943,25.030150753768844,30
0.05,597,71,15014,25.107023411371237,30
0.05,598,-30,14984,25.015025041736227,131
0.05,599,9,14993,24.988333333333333,91
0.05,600,-145,14848,24.70549084858569,250
0.05,601,-80,14768,24.53156146179402,142
0.05,602,-78,14690,24.36152570480929,179
0.05,603,90,14780,24.47019867549669,10
0.05,604,-55,14725,24.33884297520661,104
0.05,605,68,14793,24.41089108910891,33
0.05,606,-119,14674,24.174629324546952,153
0.05,607,54,14728,24.223684210526315,48
0.05,608,20,14748,24.216748768472907,80
0.05,609,84,14832,24.314754098360655,17
0.05,610,17,14849,24.30278232405892,86
0.05,611,77,14926,24.38888888888889,24
0.05,612,92,15018,24.499184339314844,8
0.05,613,84,15102,24.596091205211728,17
0.05,614,76,15178,24.679674796747967,24
0.05,615,75,15253,24.761363636363637,26
0.05,616,-5,15248,24.713128038897892,108
0.05,617,63,15311,24.77508090614887,37
0.05,618,91,15402,24.882067851373183,9
0.05,619,79,15481,24.969354838709677,21
0.05,620,47,15528,25.004830917874397,54
0.05,621,5,15533,24.972668810289388,96
0.05,622,53,15586,25.01765650080257,47
0.05,623,31,15617,25.02724358974359,69
0.05,624,-94,15523,24.8368,197
0.05,625,42,15565,24.864217252396166,59
0.05,626,95,15660,24.976076555023923,6
0.05,627,17,15677,24.963375796178344,83
0.05,628,92,15769,25.069952305246424,9
0.05,629,-175,15594,24.752380952380953,278
0.05,630,7,15601,24.724247226624406,94
0.05,631,24,15625,24.723101265822784,76
0.05,632,49,15674,24.761453396524487,51
0.05,633,30,15704,24.769716088328074,71
0.05,634,50,15754,24.80944881889764,50
0.05,635,17,15771,24.797169811320753,15
0.05,636,-177,15594,24.48037676609105,212
0.05,637,-20,15574,24.41065830721003,121
0.05,638,85,15659,24.50547730829421,15
0.05,639,63,15722,24.565625,37
0.05,640,39,15761,24.588143525741028,82
0.05,641,55,15816,24.635514018691588,46
0.05,642,69,15885,24.704510108864696,32
0.05,643,-61,15824,24.571428571428573,93
0.05,644,-63,15761,24.43565891472868,168
0.05,645,-102,15659,24.239938080495357,206
0.05,646,-27,15632,24.160741885625967,131
0.05,647,70,15702,24.23148148148148,30
0.05,648,-22,15680,24.16024653312789,55
0.05,649,80,15760,24.246153846153845,27
0.05,650,-123,15637,24.019969278033795,86
0.05,651,83,15720,24.11042944785276,18
0.05,652,93,15813,24.21592649310873,7
0.05,653,-66,15747,24.077981651376145,171
0.05,654,92,15839,24.181679389312976,8
0.05,655,37,15876,24.201219512195124,64
0.05,656,93,15969,24.30593607305936,8
0.05,657,-35,15934,24.21580547112462,66
0.05,658,90,16024,24.315629742033384,10
0.05,659,42,16066,24.342424242424244,59
0.05,660,-13,16053,24.285930408472012,45
0.05,661,12,16065,24.26737160120846,90
0.05,662,-104,15961,24.07390648567119,207
0.05,663,80,16041,24.158132530120483,20
0.05,664,-105,15936,23.96390977443609,137
0.05,665,28,15964,23.96996996996997,74
0.05,666,68,16032,24.035982008995504,33
0.05,667,18,16050,24.026946107784433,13
0.05,668,-87,15963,23.8609865470852,188
0.05,669,16,15979,23.849253731343282,85
0.05,670,79,16058,23.93144560357675,22
0.05,671,92,16150,24.032738095238095,8
0.05,672,59,16209,24.084695393759286,42
0.05,673,-40,16169,23.98961424332344,141
0.05,674,-58,16111,23.868148148148148,161
0.05,675,40,16151,23.892011834319526,61
0.05,676,62,16213,23.948301329394386,38
0.05,677,54,16267,23.992625368731563,47
0.05,678,-31,16236,23.911634756995582,134
0.05,679,44,16280,23.941176470588236,57
0.05,680,90,16370,24.038179148311308,11
0.05,681,41,16411,24.063049853372434,60
0.05,682,64,16475,24.121522693997072,39
0.05,683,-144,16331,23.875730994152047,179
0.05,684,-158,16173,23.61021897810219,193
0.05,685,49,16222,23.64723032069971,52
0.05,686,61,16283,23.70160116448326,40
0.05,687,-12,16271,23.649709302325583,112
0.05,688,31,16302,23.660377358490567,69
0.05,689,-264,16038,23.243478260869566,300
0.05,690,83,16121,23.329956584659914,17
0.05,691,-515,15606,22.552023121387283,489
0.05,692,23,15629,22.552669552669553,84
0.05,693,95,15724,22.65706051873199,6
0.05,694,83,15807,22.74388489208633,17
0.05,695,32,15839,22.757183908045977,95
0.05,696,-83,15756,22.60545193687231,184
0.05,697,63,15819,22.663323782234958,39
0.05,698,82,15901,22.74821173104435,18
0.05,699,60,15961,22.80142857142857,42
0.05,700,66,16027,22.86305278174037,35
0.05,701,71,16098,22.931623931623932,29
0.05,702,5,16103,22.906116642958747,95
0.05,703,-69,16034,22.775568181818183,106
0.05,704,-152,15882,22.527659574468085,185
0.05,705,29,15911,22.53682719546742,72
0.05,706,45,15956,22.56859971711457,55
0.05,707,88,16044,22.661016949152543,13
0.05,708,-5,16039,22.62200282087447,58
0.05,709,-22,16017,22.559154929577463,125
0.05,710,-71,15946,22.427566807313642,112
0.05,711,71,16017,22.495786516853933,29
0.05,712,27,16044,22.50210378681627,74
0.05,713,-38,16006,22.41736694677871,187
0.05,714,14,16020,22.405594405594407,18
0.05,715,74,16094,22.477653631284916,26
0.05,716,-19,16075,22.419804741980474,120
0.05,717,81,16156,22.501392757660167,19
0.05,718,72,16228,22.570236439499304,29
0.05,719,-90,16138,22.413888888888888,190
0.05,720,-162,15976,22.158113730929266,194
0.05,721,49,16025,22.195290858725762,51
0.05,722,1,16026,22.16597510373444,101
0.05,723,87,16113,22.255524861878452,13
0.05,724,68,16181,22.318620689655173,33
0.05,725,44,16225,22.348484848484848,59
0.05,726,95,16320,22.448418156808803,6
0.05,727,88,16408,22.53846153846154,12
0.05,728,-370,16038,22.0,403
0.05,729,90,16128,22.09315068493151,11
0.05,730,79,16207,22.170998632010942,22
0.05,731,8,16215,22.151639344262296,95
0.05,732,93,16308,22.248294679399727,8
0.05,733,36,16344,22.267029972752045,66
0.05,734,44,16388,22.296598639455784,56
0.05,735,55,16443,22.341032608695652,45
0.05,736,-45,16398,22.24966078697422,147
0.05,737,-74,16324,22.119241192411923,175
0.05,738,80,16404,22.197564276048716,21
0.05,739,54,16458,22.24054054054054,46
0.05,740,80,16538,22.318488529014846,21
0.05,741,58,16596,22.36657681940701,42
0.05,742,-11,16585,22.321668909825032,111
0.05,743,95,16680,22.419354838709676,6
0.05,744,89,16769,22.508724832214764,11
0.05,745,80,16849,22.5857908847185,21
0.05,746,75,16924,22.65595716198126,25
0.05,747,86,17010,22.740641711229948,15
0.05,748,-107,16903,22.567423230974633,141
0.05,749,-103,16800,22.4,151
0.05,750,92,16892,22.492676431424766,8
0.05,751,50,16942,22.529255319148938,51
0.05,752,54,16996,22.57104913678619,46
0.05,753,-38,16958,22.490716180371354,141
0.05,754,62,17020,22.543046357615893,38
0.05,755,40,17060,22.566137566137566,60
0.05,756,55,17115,22.60898282694848,45
0.05,757,2,17117,22.58179419525066,99
0.05,758,82,17199,22.6600790513834,19
0.05,759,19,17218,22.655263157894737,12
0.05,760,-7,17211,22.61629434954008,108
0.05,761,39,17250,22.637795275590552,61
0.05,762,-17,17233,22.58584534731324,48
0.05,763,45,17278,22.615183246073297,55
0.05,764,55,17333,22.657516339869282,45
0.05,765,31,17364,22.66840731070496,71
0.05,766,-24,17340,22.60756192959583,125
0.05,767,90,17430,22.6953125,11
0.05,768,70,17500,22.756827048114435,31
0.05,769,11,17511,22.741558441558443,90
0.05,770,-130,17381,22.543450064850845,234
0.05,771,58,17439,22.58937823834197,42
0.05,772,-2,17437,22.55756791720569,102
0.05,773,14,17451,22.546511627906977,89
0.05,774,90,17541,22.633548387096774,11
0.05,775,59,17600,22.68041237113402,41
0.05,776,-95,17505,22.52895752895753,198
0.05,777,3,17508,22.503856041131105,97
0.05,778,49,17557,22.537869062901155,51
0.05,779,70,17627,22.598717948717947,30
0.05,780,-35,17592,22.52496798975672,136
0.05,781,-439,17153,21.934782608695652,405
0.05,782,-50,17103,21.842911877394634,150
0.05,783,24,17127,21.845663265306122,76
0.05,784,72,17199,21.909554140127387,28
0.05,785,41,17240,21.93384223918575,59
0.05,786,84,17324,22.012706480304956,16
0.05,787,28,17352,22.02030456852792,76
0.05,788,57,17409,22.064638783269963,44
0.05,789,-76,17333,21.940506329113923,110
0.05,790,-40,17293,21.8621997471555,141
0.05,791,8,17301,21.84469696969697,93
0.05,792,76,17377,21.91298865069357,24
0.05,793,-47,17330,21.826196473551637,78
0.05,794,27,17357,21.832704402515724,73
0.05,795,41,17398,21.85678391959799,60
0.05,796,17,17415,21.85069008782936,83
0.05,797,57,17472,21.894736842105264,44
0.05,798,-96,17376,21.74718397997497,127
0.05,799,-147,17229,21.53625,249
0.05,800,92,17321,21.62421972534332,8
0.05,801,41,17362,21.648379052369076,61
0.05,802,71,17433,21.70983810709838,30
0.05,803,39,17472,21.73134328358209,61
0.05,804,95,17567,21.822360248447204,6
0.05,805,-174,17393,21.57940446650124,280
0.05,806,-149,17244,21.36802973977695,183
0.05,807,38,17282,21.388613861386137,63
0.05,808,90,17372,21.473423980222496,10
0.05,809,-56,17316,21.377777777777776,88
0.05,810,65,17381,21.431565967940813,35
0.05,811,-58,17323,21.33374384236453,160
0.05,812,-143,17180,21.131611316113162,175
0.05,813,-44,17136,21.051597051597053,146
0.05,814,-112,17024,20.88834355828221,145
0.05,815,-88,16936,20.754901960784313,190
0.05,816,22,16958,20.756425948592412,81
0.05,817,60,17018,20.804400977995112,41
0.05,818,-135,16883,20.614163614163616,170
0.05,819,76,16959,20.681707317073172,25
0.05,820,89,17048,20.764920828258223,12
0.05,821,-11,17037,20.726277372262775,42
0.05,822,-9,17028,20.690157958687728,110
0.05,823,64,17092,20.74271844660194,37
0.05,824,84,17176,20.81939393939394,16
0.05,825,94,17270,20.907990314769975,7
0.05,826,-19,17251,20.859733978234583,121
0.05,827,-33,17218,20.794685990338163,145
0.05,828,77,17295,20.86248492159228,23
0.05,829,17,17312,20.857831325301206,85
0.05,830,22,17334,20.859205776173287,80
0.05,831,3,17337,20.837740384615383,29
0.05,832,-83,17254,20.713085234093636,188
0.05,833,54,17308,20.752997601918466,46
0.05,834,-19,17289,20.705389221556885,119
0.05,835,92,17381,20.79066985645933,8
0.05,836,72,17453,20.85185185185185,28
0.05,837,15,17468,20.844868735083534,87
0.05,838,87,17555,20.923718712753278,13
0.05,839,59,17614,20.96904761904762,47
0.05,840,32,17646,20.98216409036861,69
0.05,841,76,17722,21.04750593824228,24
0.05,842,88,17810,21.126927639383155,12
0.05,843,83,17893,21.200236966824644,17
0.05,844,-30,17863,21.139644970414203,141
0.05,845,-138,17725,20.951536643026003,101
0.05,846,86,17811,21.028335301062572,14
0.05,847,74,17885,21.090801886792452,27
0.05,848,53,17938,21.128386336866903,47
0.05,849,51,17989,21.163529411764706,49
0.05,850,8,17997,21.148061104582844,94
0.05,851,91,18088,21.230046948356808,10
0.05,852,59,18147,21.27432590855803,41
0.05,853,-22,18125,21.22365339578454,135
0.05,854,58,18183,21.266666666666666,43
0.05,855,58,18241,21.309579439252335,43
0.05,856,-2,18239,21.28238039673279,103
0.05,857,57,18296,21.324009324009324,46
0.05,858,30,18326,21.334109429569267,71
0.05,859,82,18408,21.404651162790696,19
0.05,860,-57,18351,21.313588850174217,169
0.05,861,-181,18170,21.078886310904874,285
0.05,862,41,18211,21.10196987253766,61
0.05,863,-17,18194,21.05787037037037,50
0.05,864,74,18268,21.11907514450867,29
0.05,865,-114,18154,20.963048498845264,219
0.05,866,85,18239,21.03690888119954,16
0.05,867,46,18285,21.06566820276498,55
0.05,868,83,18368,21.13693901035673,18
0.05,869,51,18419,21.171264367816093,49
0.05,870,-211,18208,20.90470723306544,272
0.05,871,-204,18004,20.646788990825687,308
0.05,872,87,18091,20.722794959908363,14
0.05,873,20,18111,20.721967963386728,81
0.05,874,45,18156,20.749714285714287,55
0.05,875,-7,18149,20.718036529680365,109
0.05,876,83,18232,20.789053591790193,18
0.05,877,58,18290,20.831435079726653,42
0.05,878,70,18360,20.887372013651877,31
0.05,879,56,18416,20.927272727272726,44
0.05,880,-110,18306,20.77866061293984,143
0.05,881,95,18401,20.86281179138322,6
0.05,882,93,18494,20.944507361268403,8
0.05,883,-29,18465,20.888009049773757,132
0.05,884,93,18558,20.969491525423727,8
0.05,885,13,18571,20.960496613995485,88
0.05,886,79,18650,21.025930101465615,21
0.05,887,-22,18628,20.97747747747748,125
0.05,888,1,18629,20.955005624296962,118
0.05,889,-91,18538,20.829213483146066,55
0.05,890,23,18561,20.83164983164983,8
0.05,891,67,18628,20.883408071748878,34
0.05,892,3,18631,20.863381858902574,28
0.05,893,2,18633,20.84228187919463,30
0.05,894,86,18719,20.91508379888268,15
0.05,895,36,18755,20.931919642857142,65
0.05,896,85,18840,21.00334448160535,16
0.05,897,76,18916,21.06458797327394,34
0.05,898,12,18928,21.054505005561737,19
0.05,899,74,19002,21.113333333333333,26
0.05,900,46,19048,21.14095449500555,56
0.05,901,58,19106,21.181818181818183,42
0.05,902,46,19152,21.209302325581394,91
0.05,903,72,19224,21.265486725663717,30
0.05,904,24,19248,21.268508287292818,78
0.05,905,65,19313,21.316777041942604,35
0.05,906,-59,19254,21.228224917309813,162
0.05,907,93,19347,21.30726872246696,8
0.05,908,24,19371,21.31023102310231,79
0.05,909,68,19439,21.361538461538462,32
0.05,910,71,19510,21.41602634467618,29
0.05,911,-262,19248,21.105263157894736,300
0.05,912,95,19343,21.186199342825848,6
0.05,913,89,19432,21.260393873085338,12
0.05,914,26,19458,21.2655737704918,75
0.05,915,15,19473,21.25873362445415,85
0.05,916,95,19568,21.3391494002181,6
0.05,917,93,19661,21.417211328976034,8
0.05,918,31,19692,21.427638737758432,69
0.05,919,87,19779,21.49891304347826,14
0.05,920,39,19818,21.517915309446256,61
0.05,921,-8,19810,21.485900216919738,109
0.05,922,93,19903,21.56338028169014,7
0.05,923,87,19990,21.634199134199132,14
0.05,924,70,20060,21.686486486486487,30
0.05,925,74,20134,21.742980561555076,27
0.05,926,76,20210,21.80151024811219,25
0.05,927,-152,20058,21.614224137931036,186
0.05,928,94,20152,21.692142088266955,7
0.05,929,41,20193,21.712903225806453,59
0.05,930,52,20245,21.745435016111706,53
0.05,931,-108,20137,21.606223175965667,211
0.05,932,30,20167,21.615219721329048,70
0.05,933,77,20244,21.674518201284798,24
0.05,934,72,20316,21.728342245989303,29
0.05,935,-82,20234,21.617521367521366,184
0.05,936,82,20316,21.68196371398079,19
0.05,937,94,20410,21.759061833688698,7
0.05,938,-175,20235,21.549520766773163,260
0.05,939,76,20311,21.607446808510637,24
0.05,940,27,20338,21.61317747077577,73
0.05,941,81,20419,21.676220806794056,20
0.05,942,28,20447,21.682926829268293,76
0.05,943,-58,20389,21.598516949152543,89
0.05,944,40,20429,21.617989417989417,61
0.05,945,94,20523,21.69450317124736,7
0.05,946,4,20527,21.67581837381204,97
0.05,947,-38,20489,21.612869198312236,69
0.05,948,35,20524,21.626975763962065,66
0.05,949,41,20565,21.647368421052633,60
0.05,950,62,20627,21.68980021030494,67
0.05,951,86,20713,21.75735294117647,15
0.05,952,80,20793,21.818467995802727,21
0.05,953,57,20850,21.855345911949687,46
0.05,954,-139,20711,21.686910994764396,243
0.05,955,93,20804,21.761506276150627,8
0.05,956,1,20805,21.739811912225704,35
0.05,957,78,20883,21.798538622129435,23
0.05,958,-67,20816,21.70594369134515,150
0.05,959,-131,20685,21.546875,163
0.05,960,15,20700,21.54006243496358,87
0.05,961,26,20726,21.544698544698544,6
0.05,962,-124,20602,21.39356178608515,228
0.05,963,-7,20595,21.36410788381743,40
0.05,964,75,20670,21.419689119170986,25
0.05,965,-86,20584,21.308488612836438,121
0.05,966,82,20666,21.371251292657703,18
0.05,967,63,20729,21.414256198347108,39
0.05,968,82,20811,21.476780185758514,18
0.05,969,83,20894,21.540206185567012,17
0.05,970,77,20971,21.597322348094746,24
0.05,971,38,21009,21.614197530864196,64
0.05,972,64,21073,21.65775950668037,36
0.05,973,-80,20993,21.553388090349078,115
0.05,974,61,21054,21.593846153846155,40
0.05,975,91,21145,21.664959016393443,9
0.05,976,53,21198,21.697031729785056,47
0.05,977,77,21275,21.75357873210634,23
0.05,978,64,21339,21.79673135852911,36
0.05,979,79,21418,21.855102040816327,21
0.05,980,34,21452,21.867482161060142,67
0.05,981,16,21468,21.861507128309572,85
0.05,982,63,21531,21.903357070193287,38
0.05,983,87,21618,21.96951219512195,13
0.05,984,-95,21523,21.850761421319795,128
0.05,985,76,21599,21.905679513184584,24
0.05,986,26,21625,21.90982776089159,6
0.05,987,22,21647,21.90991902834008,80
0.05,988,-80,21567,21.806875631951467,113
0.05,989,24,21591,21.80909090909091,8
0.05,990,86,21677,21.873864783047427,14
0.05,991,3,21680,21.85483870967742,97
0.05,992,93,21773,21.926485397784493,8
0.05,993,60,21833,21.964788732394368,42
0.05,994,91,21924,22.034170854271355,10
0.05,995,88,22012,22.100401606425702,13
0.05,996,-4,22008,22.074222668004012,35
0.05,997,44,22052,22.096192384769537,57
0.05,998,94,22146,22.16816816816817,7
0.05,999,90,22236,22.236,11
0.05,1000,57,22293,22.27072927072927,50
0.05,1001,6,22299,22.25449101796407,101
0.05,1002,38,22337,22.270189431704885,63
0.05,1003,87,22424,22.334661354581673,13
0.05,1004,55,22479,22.367164179104478,46
0.05,1005,-10,22469,22.33499005964215,41
0.05,1006,66,22535,22.378351539225424,35
0.05,1007,66,22601,22.421626984126984,35
0.05,1008,76,22677,22.474727452923688,24
0.05,1009,59,22736,22.51089108910891,41
0.05,1010,40,22776,22.52818991097923,64
0.05,1011,50,22826,22.555335968379445,50
0.05,1012,32,22858,22.56465942744324,69
0.05,1013,17,22875,22.559171597633135,84
0.05,1014,69,22944,22.604926108374386,32
0.05,1015,95,23039,22.676181102362204,6
0.05,1016,-157,22882,22.49950835791544,120
0.05,1017,-9,22873,22.468565815324165,111
0.05,1018,-214,22659,22.236506378802748,246
0.05,1019,-99,22560,22.11764705882353,204
0.05,1020,51,22611,22.145935357492654,50
0.05,1021,88,22699,22.210371819960862,12
0.05,1022,66,22765,22.253176930596286,34
0.05,1023,67,22832,22.296875,34
0.05,1024,-102,22730,22.17560975609756,204
0.05,1025,92,22822,22.243664717348928,9
0.05,1026,-55,22767,22.168451801363194,155
0.05,1027,-273,22494,21.881322957198442,308
0.05,1028,3,22497,21.862973760932945,100
0.05,1029,-33,22464,21.809708737864078,66
0.05,1030,52,22516,21.838991270611057,49
0.05,1031,6,22522,21.823643410852714,96
0.05,1032,-151,22371,21.656340755082283,115
0.05,1033,71,22442,21.704061895551256,98
0.05,1034,0,22442,21.683091787439615,100
0.05,1035,-102,22340,21.563706563706564,204
0.05,1036,94,22434,21.633558341369334,8
0.05,1037,81,22515,21.690751445086704,20
0.05,1038,4,22519,21.673724735322427,98
0.05,1039,-63,22456,21.592307692307692,96
0.05,1040,11,22467,21.582132564841498,20
0.05,1041,-247,22220,21.324376199616122,286
0.05,1042,-278,21942,21.03739213806328,316
0.05,1043,-257,21685,20.771072796934867,292
0.05,1044,-68,21617,20.686124401913876,182
0.05,1045,-65,21552,20.604206500956025,168
0.05,1046,44,21596,20.62655205348615,56
0.05,1047,73,21669,20.676526717557252,27
0.05,1048,-15,21654,20.642516682554813,115
0.05,1049,30,21684,20.65142857142857,72
0.05,1050,64,21748,20.69267364414843,46
0.05,1051,-98,21650,20.579847908745247,200
0.05,1052,70,21720,20.626780626780626,33
0.05,1053,57,21777,20.661290322580644,43
0.05,1054,7,21784,20.648341232227487,93
0.05,1055,94,21878,20.71780303030303,7
0.05,1056,65,21943,20.759697256385998,36
0.05,1057,-38,21905,20.704158790170133,139
0.05,1058,84,21989,20.76392823418319,17
0.05,1059,81,22070,20.82075471698113,20
0.05,1060,77,22147,20.873704052780397,24
0.05,1061,84,22231,20.933145009416197,17
0.05,1062,-34,22197,20.881467544684853,103
0.05,1063,92,22289,20.94830827067669,8
0.05,1064,62,22351,20.986854460093898,38
0.05,1065,60,22411,21.0234521575985,41
0.05,1066,-73,22338,20.935332708528584,106
0.05,1067,70,22408,20.9812734082397,31
0.05,1068,93,22501,21.048643592142188,8
0.05,1069,-1,22500,21.02803738317757,104
0.05,1070,66,22566,21.07002801120448,35
0.05,1071,-40,22526,21.013059701492537,141
0.05,1072,94,22620,21.08108108108108,30
0.05,1073,41,22661,21.099627560521416,59
0.05,1074,93,22754,21.166511627906978,8
0.05,1075,-52,22702,21.098513011152416,155
0.05,1076,-99,22603,20.987000928505108,132
0.05,1077,-33,22570,20.93692022263451,137
0.05,1078,78,22648,20.989805375347544,23
0.05,1079,47,22695,21.01388888888889,54
0.05,1080,72,22767,21.061054579093433,30
0.05,1081,51,22818,21.088724584103513,51
0.05,1082,84,22902,21.14681440443213,16
0.05,1083,69,22971,21.190959409594097,31
0.05,1084,47,23018,21.2147465437788,54
0.05,1085,-20,22998,21.176795580110497,122
0.05,1086,13,23011,21.169273229070836,89
0.05,1087,-21,22990,21.13051470588235,122
0.05,1088,59,23049,21.165289256198346,42
0.05,1089,44,23093,21.186238532110092,58
0.05,1090,-253,22840,20.934922089825847,233
0.05,1091,56,22896,20.967032967032967,46
0.05,1092,94,22990,21.03385178408051,7
0.05,1093,41,23031,21.052102376599635,61
0.05,1094,-9,23022,21.024657534246575,111
0.05,1095,-34,22988,20.974452554744527,65
0.05,1096,-61,22927,20.899726526891524,161
0.05,1097,0,22927,20.880692167577415,101
0.05,1098,88,23015,20.941765241128298,12
0.05,1099,-9,23006,20.914545454545454,110
0.05,1100,-31,22975,20.86739327883742,63
0.05,1101,1,22976,20.849364791288565,100
0.05,1102,81,23057,20.903898458748866,20
0.05,1103,-1,23056,20.884057971014492,104
0.05,1104,-114,22942,20.761990950226245,99
0.05,1105,87,23029,20.821880650994576,14
0.05,1106,80,23109,20.875338753387535,20
0.05,1107,69,23178,20.918772563176894,31
0.05,1108,80,23258,20.97204688908927,20
0.05,1109,44,23302,20.99279279279279,62
0.05,1110,19,23321,20.990999099909992,82
0.05,1111,81,23402,21.044964028776977,19
0.05,1112,-39,23363,20.99101527403414,143
0.05,1113,42,23405,21.00987432675045,58
0.05,1114,18,23423,21.007174887892376,83
0.05,1115,64,23487,21.045698924731184,37
0.05,1116,89,23576,21.106535362578335,12
0.05,1117,-210,23366,20.899821109123433,175
0.05,1118,30,23396,20.907953529937444,70
0.05,1119,-8,23388,20.882142857142856,112
0.05,1120,-196,23192,20.688670829616413,229
0.05,1121,-29,23163,20.644385026737968,156
0.05,1122,14,23177,20.63846838824577,88
0.05,1123,-3,23174,20.61743772241993,106
0.05,1124,40,23214,20.634666666666668,61
0.05,1125,-69,23145,20.5550621669627,170
0.05,1126,73,23218,20.601597160603372,28
0.05,1127,94,23312,20.666666666666668,6
0.05,1128,24,23336,20.6696191319752,78
0.05,1129,88,23424,20.729203539823008,12
0.05,1130,-36,23388,20.679045092838198,137
0.05,1131,46,23434,20.70141342756184,55
0.05,1132,2,23436,20.684907325684026,32
0.05,1133,-15,23421,20.65343915343915,116
0.05,1134,0,23421,20.6352422907489,107
0.05,1135,13,23434,20.628521126760564,89
0.05,1136,95,23529,20.693931398416886,6
0.05,1137,6,23535,20.681019332161686,95
0.05,1138,3,23538,20.665496049165935,99
0.05,1139,53,23591,20.693859649122807,48
0.05,1140,65,23656,20.732690622261174,36
0.05,1141,65,23721,20.771453590192646,36
0.05,1142,47,23768,20.79440069991251,53
0.05,1143,-280,23488,20.53146853146853,250
0.05,1144,-8,23480,20.50655021834061,40
0.05,1145,6,23486,20.49389179755672,95
0.05,1146,-117,23369,20.374019180470793,151
0.05,1147,54,23423,20.403310104529616,47
0.05,1148,45,23468,20.424717145343777,58
0.05,1149,-185,23283,20.24608695652174,221
0.05,1150,-185,23098,20.06776715899218,297
0.05,1151,63,23161,20.10503472222222,37
0.05,1152,-83,23078,20.01561144839549,185
0.05,1153,85,23163,20.071923743500868,16
0.05,1154,45,23208,20.093506493506492,55
0.05,1155,91,23299,20.15484429065744,10
0.05,1156,87,23386,20.212618841832324,13
0.05,1157,-77,23309,20.1286701208981,109
0.05,1158,57,23366,20.160483175150993,44
0.05,1159,75,23441,20.207758620689656,26
0.05,1160,2,23443,20.19207579672696,98
0.05,1161,-164,23279,20.03356282271945,206
0.05,1162,93,23372,20.096302665520206,7
0.05,1163,32,23404,20.106529209621993,69
0.05,1164,-50,23354,20.046351931330474,83
0.05,1165,-152,23202,19.898799313893655,185
0.05,1166,84,23286,19.953727506426734,17
0.05,1167,-8,23278,19.929794520547944,108
0.05,1168,15,23293,19.92557741659538,86
0.05,1169,78,23371,19.975213675213674,23
0.05,1170,94,23465,20.038428693424425,6
0.05,1171,5,23470,20.025597269624573,95
0.05,1172,-92,23378,19.93009377664109,123
0.05,1173,12,23390,19.92333901192504,91
0.05,1174,-122,23268,19.802553191489363,155
0.05,1175,83,23351,19.856292517006803,18
0.05,1176,84,23435,19.910790144435005,16
0.05,1177,93,23528,19.972835314091682,7
0.05,1178,-49,23479,19.914334181509755,84
0.05,1179,73,23552,19.959322033898307,28
0.05,1180,87,23639,20.016088060965284,14
0.05,1181,91,23730,20.076142131979694,11
0.05,1182,66,23796,20.114961961115807,35
0.05,1183,81,23877,20.166385135135137,20
0.05,1184,12,23889,20.159493670886075,91
0.05,1185,-108,23781,20.051433389544687,159
0.05,1186,-187,23594,19.87700084245998,293
0.05,1187,84,23678,19.930976430976433,17
0.05,1188,52,23730,19.957947855340624,50
0.05,1189,93,23823,20.01932773109244,7
0.05,1190,67,23890,20.058774139378674,33
0.05,1191,86,23976,20.114093959731544,14
0.05,1192,61,24037,20.148365465213747,40
0.05,1193,-207,23830,19.958123953098827,173
0.05,1194,-35,23795,19.91213389121339,146
0.05,1195,36,23831,19.92558528428094,64
0.05,1196,83,23914,19.97827903091061,17
0.05,1197,45,23959,19.9991652754591,56
0.05,1198,19,23978,19.998331943286072,96
0.05,1199,90,24068,20.05666666666667,10
0.05,1200,54,24122,20.084929225645297,48
0.05,1201,82,24204,20.136439267886857,19
0.05,1202,70,24274,20.177888611803823,30
0.05,1203,-5,24269,20.156976744186046,106
0.05,1204,73,24342,20.20082987551867,28
0.05,1205,-24,24318,20.16417910447761,125
0.05,1206,50,24368,20.188898094449048,50
0.05,1207,16,24384,20.185430463576157,15
0.05,1208,-18,24366,20.153846153846153,50
0.05,1209,78,24444,20.201652892561984,22
0.05,1210,25,24469,20.205615194054502,76
0.05,1211,74,24543,20.25,26
0.05,1212,56,24599,20.27947238252267,45
0.05,1213,77,24676,20.32619439868204,23
0.05,1214,77,24753,20.372839506172838,23
0.05,1215,66,24819,20.410361842105264,40
0.05,1216,34,24853,20.4215283483977,66
0.05,1217,-228,24625,20.217569786535304,274
0.05,1218,91,24716,20.27563576702215,9
0.05,1219,52,24768,20.301639344262295,48
0.05,1220,85,24853,20.354627354627354,15
0.05,1221,76,24929,20.400163666121113,24
0.05,1222,-57,24872,20.33687653311529,170
0.05,1223,70,24942,20.377450980392158,31
0.05,1224,59,25001,20.408979591836733,42
0.05,1225,-113,24888,20.30016313213703,215
0.05,1226,16,24904,20.296658516707417,85
0.05,1227,10,24914,20.28827361563518,91
0.05,1228,-47,24867,20.23352318958503,150
0.05,1229,25,24892,20.23739837398374,7
0.05,1230,93,24985,20.296506904955322,8
0.05,1231,-41,24944,20.246753246753247,141
0.05,1232,42,24986,20.26439578264396,61
0.05,1233,35,25021,20.276337115072934,66
0.05,1234,19,25040,20.275303643724698,83
0.05,1235,-111,24929,20.169093851132686,216
0.05,1236,62,24991,20.202910266774456,38
0.05,1237,87,25078,20.25686591276252,13
0.05,1238,52,25130,20.282485875706215,49
0.05,1239,81,25211,20.331451612903226,20
0.05,1240,-33,25178,20.288477034649475,66
0.05,1241,90,25268,20.344605475040257,11
0.05,1242,75,25343,20.388576025744168,26
0.05,1243,68,25411,20.426848874598072,32
0.05,1244,59,25470,20.457831325301203,41
0.05,1245,74,25544,20.500802568218297,27
0.05,1246,60,25604,20.532477947072977,70
0.05,1247,80,25684,20.580128205128204,21
0.05,1248,-115,25569,20.471577261809447,149
0.05,1249,56,25625,20.5,47
0.05,1250,-3,25622,20.48121502797762,105
0.05,1251,28,25650,20.487220447284344,73
0.05,1252,75,25725,20.53072625698324,25
0.05,1253,60,25785,20.5622009569378,41
0.05,1254,-27,25758,20.524302788844622,58
0.05,1255,-153,25605,20.386146496815286,255
0.05,1256,20,25625,20.385839299920445,80
0.05,1257,-55,25570,20.325914149443562,158
0.05,1258,77,25647,20.370929308975377,24
0.05,1259,90,25737,20.426190476190477,11
0.05,1260,47,25784,20.447264076130054,55
0.05,1261,9,25793,20.438193343898575,91
0.05,1262,23,25816,20.440221694378465,78
0.05,1263,92,25908,20.496835443037973,9
0.05,1264,78,25986,20.542292490118577,23
0.05,1265,83,26069,20.591627172195892,18
0.05,1266,67,26136,20.628255722178373,33
0.05,1267,-128,26008,20.51104100946372,233
0.05,1268,-167,25841,20.36327817178881,282
0.05,1269,42,25883,20.38031496062992,60
0.05,1270,91,25974,20.435877261998428,9
0.05,1271,51,26025,20.45990566037736,50
0.05,1272,82,26107,20.508248232521602,18
0.05,1273,1,26108,20.49293563579278,37
0.05,1274,85,26193,20.543529411764705,16
0.05,1275,81,26274,20.59090909090909,20
0.05,1276,31,26305,20.599060297572436,69
0.05,1277,89,26394,20.652582159624412,12
0.05,1278,73,26467,20.69351055512119,28
0.05,1279,-13,26454,20.6671875,115
0.05,1280,17,26471,20.66432474629196,83
0.05,1281,93,26564,20.720748829953198,7
0.05,1282,52,26616,20.745128604832423,48
0.05,1283,-35,26581,20.70171339563863,135
0.05,1284,50,26631,20.724513618677044,50
0.05,1285,-78,26553,20.647744945567652,178
0.05,1286,81,26634,20.694638694638694,19
0.05,1287,93,26727,20.750776397515526,8
0.05,1288,67,26794,20.7866563227308,33
0.05,1289,66,26860,20.82170542635659,34
0.05,1290,-55,26805,20.76297443841983,157
0.05,1291,70,26875,20.80108359133127,30
0.05,1292,56,26931,20.828306264501162,46
0.05,1293,-59,26872,20.76661514683153,90
0.05,1294,-131,26741,20.64942084942085,162
0.05,1295,-6,26735,20.628858024691358,107
0.05,1296,41,26776,20.64456437933693,59
0.05,1297,86,26862,20.694915254237287,19
0.05,1298,10,26872,20.68668206312548,90
0.05,1299,-107,26765,20.588461538461537,140
0.05,1300,-75,26690,20.514988470407378,176
0.05,1301,88,26778,20.566820276497698,13
0.05,1302,-103,26675,20.471987720644666,135
0.05,1303,94,26769,20.528374233128833,7
0.05,1304,74,26843,20.569348659003833,26
0.05,1305,73,26916,20.609494640122513,27
0.05,1306,91,27007,20.663351185921957,10
0.05,1307,35,27042,20.674311926605505,66
0.05,1308,68,27110,20.71046600458365,39
0.05,1309,75,27185,20.751908396946565,26
0.05,1310,85,27270,20.80091533180778,15
0.05,1311,41,27311,20.816310975609756,59
0.05,1312,78,27389,20.85986290936786,23
0.05,1313,-335,27054,20.589041095890412,297
0.05,1314,13,27067,20.583269961977187,18
0.05,1315,-98,26969,20.493161094224924,199
0.05,1316,-137,26832,20.373576309794988,237
0.05,1317,-63,26769,20.3103186646434,166
0.05,1318,10,26779,20.302501895375283,22
0.05,1319,5,26784,20.29090909090909,27
0.05,1320,-27,26757,20.255109765329298,139
0.05,1321,68,26825,20.29122541603631,32
0.05,1322,-35,26790,20.249433106575964,68
0.05,1323,49,26839,20.271148036253777,51
0.05,1324,59,26898,20.300377358490564,41
0.05,1325,93,26991,20.355203619909503,8
0.05,1326,-1,26990,20.33911077618689,103
0.05,1327,82,27072,20.3855421686747,19
0.05,1328,39,27111,20.399548532731377,61
0.05,1329,-95,27016,20.312781954887217,128
0.05,1330,69,27085,20.349361382419232,31
0.05,1331,75,27160,20.39039039039039,26
0.05,1332,-87,27073,20.309827456864216,189
0.05,1333,81,27154,20.355322338830586,19
0.05,1334,62,27216,20.386516853932584,38
0.05,1335,7,27223,20.376497005988025,95
0.05,1336,46,27269,20.395661929693343,54
0.05,1337,89,27358,20.446935724962632,11
0.05,1338,93,27451,20.501120238984317,7
0.05,1339,-56,27395,20.44402985074627,89
0.05,1340,72,27467,20.48247576435496,28
0.05,1341,94,27561,20.53725782414307,7
0.05,1342,22,27583,20.538346984363365,78
0.05,1343,41,27624,20.553571428571427,61
0.05,1344,80,27704,20.597769516728626,20
0.05,1345,40,27744,20.61218424962853,61
0.05,1346,79,27823,20.655530809205644,21
0.05,1347,-1,27822,20.63946587537092,103
0.05,1348,30,27852,20.646404744255005,70
0.05,1349,13,27865,20.64074074074074,87
0.05,1350,79,27944,20.683937823834196,22
0.05,1351,35,27979,20.694526627218934,66
0.05,1352,53,28032,20.71840354767184,48
0.05,1353,-48,27984,20.667651403249632,149
0.05,1354,64,28048,20.699630996309963,37
0.05,1355,-58,27990,20.641592920353983,159
0.05,1356,53,28043,20.665438467207075,48
0.05,1357,68,28111,20.700294550810014,32
0.05,1358,89,28200,20.750551876379692,11
0.05,1359,-7,28193,20.73014705882353,107
0.05,1360,15,28208,20.725936811168257,112
0.05,1361,67,28275,20.759911894273127,33
0.05,1362,16,28291,20.75641966250917,85
0.05,1363,60,28351,20.785190615835777,40
0.05,1364,50,28401,20.806593406593407,50
0.05,1365,-118,28283,20.70497803806735,222
0.05,1366,90,28373,20.755669348939282,10
0.05,1367,24,28397,20.758040935672515,78
0.05,1368,57,28454,20.784514243973703,43
0.05,1369,64,28518,20.816058394160585,37
0.05,1370,82,28600,20.86068563092633,19
0.05,1371,95,28695,20.914723032069972,6
0.05,1372,90,28785,20.96504005826657,10
0.05,1373,-7,28778,20.944687045123725,109
0.05,1374,-140,28638,20.827636363636362,175
0.05,1375,95,28733,20.881540697674417,6
0.05,1376,80,28813,20.924473493100944,20
0.05,1377,69,28882,20.959361393323658,32
0.05,1378,84,28966,21.00507614213198,17
0.05,1379,-11,28955,20.981884057971016,111
0.05,1380,26,28981,20.98551774076756,74
0.05,1381,92,29073,21.036903039073806,9
0.05,1382,23,29096,21.03832248734635,79
0.05,1383,5,29101,21.02673410404624,95
0.05,1384,43,29144,21.04259927797834,57
0.05,1385,-131,29013,20.932900432900432,252
0.05,1386,93,29106,20.984859408795963,7
0.05,1387,81,29187,21.028097982708935,19
0.05,1388,94,29281,21.080633549316055,7
0.05,1389,-63,29218,21.020143884892086,95
0.05,1390,82,29300,21.063982746225737,18
0.05,1391,84,29384,21.10919540229885,17
0.05,1392,20,29404,21.108399138549892,81
0.05,1393,-30,29374,21.07173601147776,136
0.05,1394,84,29458,21.1168458781362,16
0.05,1395,-188,29270,20.96704871060172,313
0.05,1396,87,29357,21.014316392269148,13
0.05,1397,17,29374,21.011444921316166,83
0.05,1398,59,29433,21.038598999285202,43
0.05,1399,77,29510,21.07857142857143,23
0.05,1400,83,29593,21.12276945039258,17
0.05,1401,74,29667,21.160485021398003,45
0.05,1402,91,29758,21.210263720598718,10
0.05,1403,93,29851,21.261396011396013,8
0.05,1404,-7,29844,21.241281138790036,109
0.05,1405,-78,29766,21.170697012802275,182
0.05,1406,-20,29746,21.14143567874911,121
0.05,1407,-43,29703,21.095880681818183,146
0.05,1408,89,29792,21.144073811213627,12
0.05,1409,-29,29763,21.108510638297872,132
0.05,1410,-66,29697,21.046775336640682,98
0.05,1411,30,29727,21.05311614730878,71
0.05,1412,-174,29553,20.915074309978767,278
0.05,1413,-32,29521,20.877652050919377,136
0.05,1414,-50,29471,20.827561837455832,87
0.05,1415,31,29502,20.834745762711865,70
0.05,1416,-120,29382,20.735356386732533,222
0.05,1417,75,29457,20.773624823695346,26
0.05,1418,-9,29448,20.752642706131077,109
0.05,1419,70,29518,20.78732394366197,30
0.05,1420,-154,29364,20.664320900774104,191
0.05,1421,72,29436,20.70042194092827,28
0.05,1422,-11,29425,20.67814476458187,113
0.05,1423,85,29510,20.723314606741575,16
0.05,1424,-163,29347,20.59438596491228,265
0.05,1425,-50,29297,20.544880785413746,152
0.05,1426,20,29317,20.544498948843728,82
0.05,1427,-53,29264,20.49299719887955,156
0.05,1428,-32,29232,20.45626312106368,135
0.05,1429,55,29287,20.480419580419582,45
0.05,1430,62,29349,20.50943396226415,39
0.05,1431,51,29400,20.53072625698324,49
0.05,1432,53,29453,20.553384508025122,47
0.05,1433,93,29546,20.603905160390514,7
0.05,1434,57,29603,20.629268292682926,44
0.05,1435,22,29625,20.630222841225628,9
0.05,1436,-74,29551,20.56437021572721,106
0.05,1437,74,29625,20.601529902642557,27
0.05,1438,22,29647,20.60250173731758,79
0.05,1439,59,29706,20.629166666666666,42
0.05,1440,56,29762,20.653712699514227,45
0.05,1441,66,29828,20.68515950069348,34
0.05,1442,80,29908,20.726264726264727,20
0.05,1443,72,29980,20.761772853185594,29
0.05,1444,89,30069,20.80899653979239,12
0.05,1445,64,30133,20.838865836791147,36
0.05,1446,31,30164,20.84588804422944,71
0.05,1447,-13,30151,20.822513812154696,117
0.05,1448,89,30240,20.869565217391305,11
0.05,1449,40,30280,20.882758620689657,62
0.05,1450,93,30373,20.932460372157134,8
0.05,1451,92,30465,20.981404958677686,8
0.05,1452,-129,30336,20.878183069511355,230
0.05,1453,45,30381,20.89477303988996,57
0.05,1454,56,30437,20.918900343642612,44
0.05,1455,74,30511,20.955357142857142,26
0.05,1456,-38,30473,20.914893617021278,158
0.05,1457,19,30492,20.91358024691358,81
0.05,1458,-31,30461,20.877998629198082,131
0.05,1459,37,30498,20.889041095890413,63
0.05,1460,27,30525,20.89322381930185,73
0.05,1461,80,30605,20.933652530779753,20
0.05,1462,94,30699,20.983595352016405,6
0.05,1463,38,30737,20.995218579234972,62
0.05,1464,-39,30698,20.954266211604097,141
0.05,1465,0,30698,20.939972714870397,101
0.05,1466,93,30791,20.989093387866394,8
0.05,1467,61,30852,21.016348773841962,40
0.05,1468,88,30940,21.061946902654867,12
0.05,1469,21,30961,21.061904761904763,80
0.05,1470,-125,30836,20.96261046906866,158
0.05,1471,53,30889,20.984375,48
0.05,1472,65,30954,21.014256619144604,36
0.05,1473,28,30982,21.01899592944369,72
0.05,1474,82,31064,21.060338983050848,18
0.05,1475,19,31083,21.058943089430894,84
0.05,1476,-17,31066,21.033175355450236,117
0.05,1477,-24,31042,21.002706359945872,125
0.05,1478,77,31119,21.040567951318458,24
0.05,1479,-56,31063,20.988513513513514,178
0.05,1480,47,31110,21.00607697501688,54
0.05,1481,-88,31022,20.932523616734144,120
0.05,1482,86,31108,20.9763991908294,14
0.05,1483,72,31180,21.01078167115903,28
0.05,1484,-6,31174,20.992592592592594,109
0.05,1485,82,31256,21.03364737550471,18
0.05,1486,-145,31111,20.921990585070613,179
0.05,1487,73,31184,20.956989247311828,28
0.05,1488,-51,31133,20.908663532572195,151
0.05,1489,56,31189,20.93221476510067,45
0.05,1490,-124,31065,20.835010060362173,246
0.05,1491,-108,30957,20.748659517426272,140
0.05,1492,81,31038,20.78901540522438,19
0.05,1493,-189,30849,20.64859437751004,223
0.05,1494,-52,30797,20.6,84
0.05,1495,68,30865,20.63168449197861,32
0.05,1496,84,30949,20.674014696058784,17
0.05,1497,80,31029,20.71361815754339,20
0.05,1498,38,31067,20.72515010006671,62
0.05,1499,78,31145,20.763333333333332,22
0.05,1500,-48,31097,20.717521652231845,150
0.05,1501,83,31180,20.758988015978694,17
0.05,1502,19,31199,20.75781769793746,82
0.05,1503,56,31255,20.78125,45
0.05,1504,43,31298,20.796013289036544,58
0.05,1505,37,31335,20.806772908366533,64
0.05,1506,90,31425,20.852687458526873,10
0.05,1507,-97,31328,20.774535809018566,202
0.05,1508,83,31411,20.815772034459908,18
0.05,1509,43,31454,20.83046357615894,57
0.05,1510,-5,31449,20.813368630046327,107
0.05,1511,91,31540,20.85978835978836,10
0.05,1512,30,31570,20.865829477858558,70
0.05,1513,93,31663,20.913474240422723,8
0.05,1514,32,31695,20.92079207920792,71
0.05,1515,-15,31680,20.897097625329817,115
0.05,1516,82,31762,20.937376400791035,19
0.05,1517,90,31852,20.982872200263504,11
0.05,1518,-95,31757,20.906517445687953,218
0.05,1519,37,31794,20.917105263157893,64
0.05,1520,93,31887,20.964497041420117,8
0.05,1521,76,31963,21.00065703022339,24
0.05,1522,-103,31860,20.919238345370978,134
0.05,1523,24,31884,20.921259842519685,7
0.05,1524,31,31915,20.927868852459017,70
0.05,1525,72,31987,20.961336828309307,29
0.05,1526,93,32080,21.00851342501637,7
0.05,1527,65,32145,21.037303664921467,38
0.05,1528,23,32168,21.038587311968605,78
0.05,1529,84,32252,21.079738562091503,17
0.05,1530,11,32263,21.0731548007838,91
0.05,1531,-31,32232,21.03916449086162,62
0.05,1532,-192,32040,20.900195694716242,307
0.05,1533,5,32045,20.889830508474578,95
0.05,1534,46,32091,20.906188925081434,55
0.05,1535,46,32137,20.922526041666668,57
0.05,1536,93,32230,20.969420949902407,8
0.05,1537,62,32292,20.996098829648894,39
0.05,1538,87,32379,21.03898635477583,13
0.05,1539,17,32396,21.036363636363635,83
0.05,1540,-43,32353,20.99480856586632,76
0.05,1541,83,32436,21.035019455252918,17
0.05,1542,71,32507,21.067401166558653,30
0.05,1543,68,32575,21.09779792746114,33
0.05,1544,88,32663,21.141100323624595,12
0.05,1545,82,32745,21.18046571798189,19
0.05,1546,93,32838,21.22689075630252,8
0.05,1547,83,32921,21.266795865633075,18
0.05,1548,15,32936,21.262750161394447,86
0.05,1549,-32,32904,21.228387096774192,64
0.05,1550,84,32988,21.268858800773696,17
0.05,1551,66,33054,21.297680412371133,34
0.05,1552,-5,33049,21.280746941403734,48
0.05,1553,71,33120,21.312741312741313,32
0.05,1554,-158,32962,21.19742765273312,211
0.05,1555,-231,32731,21.0353470437018,266
0.05,1556,73,32804,21.068721901091845,40
0.05,1557,32,32836,21.07573812580231,68
0.05,1558,5,32841,21.065426555484287,95
0.05,1559,-62,32779,21.012179487179488,163
0.05,1560,87,32866,21.054452274183216,13
0.05,1561,35,32901,21.06338028169014,65
0.05,1562,57,32958,21.08637236084453,43
0.05,1563,-1,32957,21.07225063938619,33
0.05,1564,14,32971,21.06773162939297,86
0.05,1565,88,33059,21.110472541507026,13
0.05,1566,-131,32928,21.013401403956603,262
0.05,1567,81,33009,21.051658163265305,36
0.05,1568,89,33098,21.094964945825367,12
0.05,1569,-86,33012,21.02675159235669,186
0.05,1570,88,33100,21.069382558879695,12
0.05,1571,87,33187,21.111323155216287,14
0.05,1572,-94,33093,21.03814367450731,196
0.05,1573,1,33094,21.025412960609913,100
0.05,1574,-25,33069,20.996190476190478,135
0.05,1575,82,33151,21.03489847715736,18
0.05,1576,10,33161,21.027901077996194,90
0.05,1577,74,33235,21.06147021546261,27
0.05,1578,-325,32910,20.84230525649145,361
0.05,1579,95,33005,20.889240506329113,6
0.05,1580,-5,33000,20.872865275142313,37
0.05,1581,2,33002,20.860935524652337,99
0.05,1582,68,33070,20.89071383449147,33
0.05,1583,95,33165,20.9375,6
0.05,1584,71,33236,20.969085173501576,30
0.05,1585,85,33321,21.009457755359396,15
0.05,1586,94,33415,21.055450535601764,6
0.05,1587,35,33450,21.064231738035264,65
0.05,1588,18,33468,21.06230333543109,84
0.05,1589,-43,33425,21.02201257861635,146
0.05,1590,-257,33168,20.847265870521685,359
0.05,1591,76,33244,20.881909547738694,24
0.05,1592,61,33305,20.90709353421218,40
0.05,1593,93,33398,20.952321204516938,8
0.05,1594,24,33422,20.95423197492163,81
0.05,1595,-169,33253,20.835213032581454,270
0.05,1596,83,33336,20.87413901064496,18
0.05,1597,14,33350,20.869837296620776,88
0.05,1598,25,33375,20.872420262664164,79
0.05,1599,-27,33348,20.8425,127
0.05,1600,7,33355,20.833853841349157,95
0.05,1601,-33,33322,20.800249687890137,134
0.05,1602,-33,33289,20.766687461010605,140
0.05,1603,-18,33271,20.742518703241895,118
0.05,1604,89,33360,20.785046728971963,12
0.05,1605,-17,33343,20.76151930261519,49
0.05,1606,89,33432,20.803982576228996,12
0.05,1607,70,33502,20.834577114427862,32
0.05,1608,23,33525,20.835922933499067,78
0.05,1609,85,33610,20.875776397515526,16
0.05,1610,86,33696,20.916201117318437,14
0.05,1611,87,33783,20.957196029776675,13
0.05,1612,39,33822,20.968381897086175,63
0.05,1613,77,33899,21.003097893432464,23
0.05,1614,-235,33664,20.844582043343653,204
0.05,1615,59,33723,20.86819306930693,41
0.05,1616,90,33813,20.910946196660483,10
0.05,1617,46,33859,20.926452410383188,54
0.05,1618,92,33951,20.970352069178507,8
0.05,1619,-46,33905,20.929012345679013,149
0.05,1620,23,33928,20.930289944478716,78
0.05,1621,55,33983,20.951294697903823,46
0.05,1622,93,34076,20.995686999383857,8
0.05,1623,-51,34025,20.951354679802957,152
0.05,1624,9,34034,20.944,110
0.05,1625,80,34114,20.980319803198032,20
0.05,1626,92,34206,21.0239704978488,8
0.05,1627,-47,34159,20.982186732186733,79
0.05,1628,-61,34098,20.93186003683241,165
0.05,1629,70,34168,20.96196319018405,31
0.05,1630,74,34242,20.99448191293685,26
0.05,1631,84,34326,21.033088235294116,17
0.05,1632,68,34394,21.061849357011635,33
0.05,1633,95,34489,21.107099143206856,6
0.05,1634,-11,34478,21.087461773700305,112
0.05,1635,86,34564,21.12713936430318,14
0.05,1636,43,34607,21.140500916310323,58
0.05,1637,51,34658,21.158730158730158,49
0.05,1638,73,34731,21.190359975594873,29
0.05,1639,-46,34685,21.149390243902438,148
0.05,1640,91,34776,21.19195612431444,9
0.05,1641,40,34816,21.203410475030452,62
0.05,1642,73,34889,21.234936092513696,28
0.05,1643,60,34949,21.258515815085158,41
0.05,1644,69,35018,21.287537993920974,32
0.05,1645,84,35102,21.325637910085053,16
0.05,1646,35,35137,21.333940497874924,71
0.05,1647,-273,34864,21.155339805825243,311
0.05,1648,-260,34604,20.98483929654336,294
0.05,1649,28,34632,20.98909090909091,73
0.05,1650,87,34719,21.029073288915807,13
0.05,1651,-59,34660,20.980629539951575,162
0.05,1652,51,34711,20.998790078644888,49
0.05,1653,86,34797,21.038089480048367,15
0.05,1654,17,34814,21.035649546827795,84
0.05,1655,-1,34813,21.022342995169083,103
0.05,1656,-16,34797,21.0,119
0.05,1657,59,34856,21.02291917973462,41
0.05,1658,86,34942,21.06208559373116,14
0.05,1659,-219,34723,20.917469879518073,322
0.05,1660,93,34816,20.960866947621916,7
0.05,1661,-143,34673,20.862214199759325,176
0.05,1662,-25,34648,20.834636199639206,56
0.05,1663,76,34724,20.86778846153846,24
0.05,1664,89,34813,20.90870870870871,12
0.05,1665,-27,34786,20.879951980792317,58
0.05,1666,87,34873,20.919616076784642,13
0.05,1667,28,34901,20.92386091127098,75
0.05,1668,90,34991,20.965248651887357,11
0.05,1669,85,35076,21.003592814371256,15
0.05,1670,44,35120,21.017354877318972,58
0.05,1671,75,35195,21.04964114832536,25
0.05,1672,52,35247,21.068141063956965,49
0.05,1673,82,35329,21.104540023894863,19
0.05,1674,-238,35091,20.949850746268655,283
0.05,1675,65,35156,20.97613365155131,36
0.05,1676,41,35197,20.988073941562313,60
0.05,1677,50,35247,21.005363528009536,50
0.05,1678,61,35308,21.029184038117926,40
0.05,1679,92,35400,21.071428571428573,9
0.05,1680,78,35478,21.105294467578823,23
0.05,1681,-30,35448,21.074910820451844,67
0.05,1682,-198,35250,20.944741532976828,230
0.05,1683,90,35340,20.985748218527316,11
0.05,1684,-179,35161,20.86706231454006,215
0.05,1685,-70,35091,20.81316725978648,176
0.05,1686,7,35098,20.804979253112034,94
0.05,1687,81,35179,20.84063981042654,20
0.05,1688,19,35198,20.839550029603316,85
0.05,1689,27,35225,20.84319526627219,85
0.05,1690,59,35284,20.86575990538143,42
0.05,1691,-404,34880,20.61465721040189,447
0.05,1692,-26,34854,20.587123449497934,126
0.05,1693,-97,34757,20.517709563164107,129
0.05,1694,45,34802,20.532153392330383,55
0.05,1695,88,34890,20.57193396226415,12
0.05,1696,-221,34669,20.429581614614026,189
0.05,1697,92,34761,20.47173144876325,8
0.05,1698,2,34763,20.46085932901707,98
0.05,1699,29,34792,20.465882352941176,71
0.05,1700,8,34800,20.458553791887127,93
0.05,1701,65,34865,20.484723854289072,35
0.05,1702,-8,34857,20.46799765120376,109
0.05,1703,84,34941,20.505281690140844,17
0.05,1704,87,35028,20.544281524926685,13
0.05,1705,87,35115,20.583235638921455,14
0.05,1706,-19,35096,20.560046865846516,119
0.05,1707,-12,35084,20.540983606557376,45
0.05,1708,21,35105,20.541252194265653,82
0.05,1709,74,35179,20.57251461988304,87
0.05,1710,75,35254,20.604324956165986,25
0.05,1711,60,35314,20.627336448598133,42
0.05,1712,-5,35309,20.612375948628138,108
0.05,1713,86,35395,20.650525087514584,14
0.05,1714,49,35444,20.667055393586004,52
0.05,1715,75,35519,20.69871794871795,26
0.05,1716,83,35602,20.73500291205591,17
0.05,1717,52,35654,20.753201396973225,49
0.05,1718,85,35739,20.790575916230367,16
0.05,1719,-16,35723,20.769186046511628,119
0.05,1720,71,35794,20.798373038930855,29
0.05,1721,57,35851,20.819396051103368,45
0.05,1722,-59,35792,20.77307022634939,159
0.05,1723,42,35834,20.78538283062645,58
0.05,1724,47,35881,20.800579710144927,53
0.05,1725,51,35932,20.818076477404404,50
0.05,1726,-89,35843,20.754487550665896,196
0.05,1727,53,35896,20.77314814814815,47
0.05,1728,90,35986,20.813186813186814,10
0.05,1729,91,36077,20.853757225433526,9
0.05,1730,-3,36074,20.83997689196996,104
0.05,1731,-194,35880,20.71593533487298,250
0.05,1732,88,35968,20.754760530871323,13
0.05,1733,14,35982,20.750865051903116,89
0.05,1734,32,36014,20.757348703170027,68
0.05,1735,-15,35999,20.736751152073733,116
0.05,1736,-38,35961,20.70293609671848,141
0.05,1737,86,36047,20.740506329113924,36
0.05,1738,81,36128,20.775158136860263,20
0.05,1739,90,36218,20.81494252873563,10
0.05,1740,-129,36089,20.72889144170017,202
0.05,1741,19,36108,20.727898966704938,82
0.05,1742,83,36191,20.76362593230063,18
0.05,1743,-33,36158,20.732798165137616,67
0.05,1744,77,36235,20.76504297994269,23
0.05,1745,-87,36148,20.70332187857961,188
0.05,1746,10,36158,20.6971951917573,91
0.05,1747,54,36212,20.716247139588102,46
0.05,1748,-146,36066,20.62092624356775,179
0.05,1749,-34,36032,20.589714285714287,65
0.05,1750,89,36121,20.628783552255854,12
0.05,1751,47,36168,20.643835616438356,56
0.05,1752,-88,36080,20.58185966913862,131
0.05,1753,35,36115,20.590079817559864,66
0.05,1754,94,36209,20.63190883190883,6
0.05,1755,50,36259,20.64863325740319,53
0.05,1756,-70,36189,20.597040409789415,176
0.05,1757,43,36232,20.609783845278727,57
0.05,1758,80,36312,20.643547470153496,21
0.05,1759,25,36337,20.646022727272726,76
0.05,1760,-38,36299,20.612720045428734,70
0.05,1761,21,36320,20.61293984108967,79
0.05,1762,88,36408,20.651162790697676,12
0.05,1763,-24,36384,20.625850340136054,126
0.05,1764,64,36448,20.65042492917847,36
0.05,1765,93,36541,20.691392978482448,7
0.05,1766,69,36610,20.71873231465761,31
0.05,1767,47,36657,20.733597285067873,55
0.05,1768,38,36695,20.74335782928208,62
0.05,1769,59,36754,20.76497175141243,42
0.05,1770,81,36835,20.79898362507058,20
0.05,1771,58,36893,20.81997742663657,43
0.05,1772,46,36939,20.834179357021995,54
0.05,1773,52,36991,20.85174746335964,48
0.05,1774,84,37075,20.887323943661972,17
0.05,1775,3,37078,20.87725225225225,97
0.05,1776,62,37140,20.900393922341024,39
0.05,1777,62,37202,20.923509561304837,39
0.05,1778,2,37204,20.912872400224845,111
0.05,1779,-20,37184,20.889887640449437,123
0.05,1780,54,37238,20.908478382930937,47
0.05,1781,-53,37185,20.867003367003367,153
0.05,1782,94,37279,20.90802019068985,6
0.05,1783,59,37338,20.929372197309416,41
0.05,1784,20,37358,20.928851540616247,80
0.05,1785,-68,37290,20.87905935050392,168
0.05,1786,19,37309,20.878007834359263,82
0.05,1787,33,37342,20.884787472035793,69
0.05,1788,9,37351,20.878144214645054,91
0.05,1789,-8,37343,20.862011173184356,108
0.05,1790,66,37409,20.88721384701284,34
0.05,1791,28,37437,20.891183035714285,76
0.05,1792,41,37478,20.90239821528165,60
0.05,1793,-55,37423,20.860089186176143,155
0.05,1794,88,37511,20.8974930362117,12
0.05,1795,-16,37495,20.87694877505568,118
0.05,1796,94,37589,20.917640511964386,6
0.05,1797,79,37668,20.949944382647384,22
0.05,1798,34,37702,20.957198443579767,68
0.05,1799,85,37787,20.99277777777778,15
0.05,1800,48,37835,21.00777345918934,53
0.05,1801,38,37873,21.01720310765816,62
0.05,1802,52,37925,21.03438713255685,48
0.05,1803,26,37951,21.037139689578716,75
0.05,1804,9,37960,21.030470914127424,23
0.05,1805,-116,37844,20.954595791805094,219
0.05,1806,7,37851,20.94687327061428,95
0.05,1807,14,37865,20.94303097345133,18
0.05,1808,91,37956,20.981757877280266,10
0.05,1809,66,38022,21.006629834254145,35
0.05,1810,69,38091,21.033130866924353,31
0.05,1811,-60,38031,20.98841059602649,91
0.05,1812,-38,37993,20.95587424158853,140
0.05,1813,84,38077,20.990628445424477,16
0.05,1814,56,38133,21.0099173553719,44
0.05,1815,-42,38091,20.97522026431718,143
0.05,1816,93,38184,21.014859658778207,7
0.05,1817,-11,38173,20.997249724972498,42
0.05,1818,29,38202,21.001649257833975,73
0.05,1819,51,38253,21.018131868131867,49
0.05,1820,91,38344,21.056562328390996,10
0.05,1821,26,38370,21.05927552140505,75
0.05,1822,68,38438,21.085024684585846,34
0.05,1823,-85,38353,21.02686403508772,197
0.05,1824,91,38444,21.065205479452054,10
0.05,1825,-42,38402,21.03066812705367,142
0.05,1826,94,38496,21.070607553366173,6
0.05,1827,84,38580,21.10503282275711,16
0.05,1828,-115,38465,21.030617823947512,220
0.05,1829,-104,38361,20.962295081967213,137
0.05,1830,27,38388,20.965592572364827,76
0.05,1831,87,38475,21.00163755458515,13
0.05,1832,36,38511,21.009819967266775,65
0.05,1833,7,38518,21.00218102508179,25
0.05,1834,9,38527,20.995640326975476,92
0.05,1835,8,38535,20.98856209150327,104
0.05,1836,-53,38482,20.948285247686446,160
0.05,1837,84,38566,20.98258977149075,16
0.05,1838,-11,38555,20.965198477433386,148
0.05,1839,86,38641,21.00054347826087,15
0.05,1840,86,38727,21.03585008147746,15
0.05,1841,0,38727,21.02442996742671,101
0.05,1842,58,38785,21.044492674986436,43
0.05,1843,71,38856,21.071583514099782,30
0.05,1844,66,38922,21.095934959349595,34
0.05,1845,-89,38833,21.036294691224267,123
0.05,1846,84,38917,21.070384407146726,16
0.05,1847,-12,38905,21.05248917748918,114
0.05,1848,93,38998,21.091400757166035,7
0.05,1849,19,39017,21.09027027027027,81
0.05,1850,-60,38957,21.046461372231228,92
0.05,1851,85,39042,21.08099352051836,16
0.05,1852,18,39060,21.079330814894764,13
0.05,1853,-17,39043,21.05879180151025,119
0.05,1854,41,39084,21.06954177897574,60
0.05,1855,-28,39056,21.04310344827586,131
0.05,1856,10,39066,21.037156704361873,91
0.05,1857,14,39080,21.033369214208825,86
0.05,1858,3,39083,21.023668639053255,97
0.05,1859,63,39146,21.046236559139786,38
0.05,1860,50,39196,21.061794734013972,50
0.05,1861,34,39230,21.0687432867884,67
0.05,1862,52,39282,21.085346215780998,49
0.05,1863,74,39356,21.113733905579398,26
0.05,1864,53,39409,21.13083109919571,47
0.05,1865,40,39449,21.140943193997856,60
0.05,1866,-320,39129,20.958221746116767,355
0.05,1867,14,39143,20.954496788008566,86
0.05,1868,71,39214,20.9812734082397,37
0.05,1869,85,39299,21.015508021390374,16
0.05,1870,13,39312,21.011223944414752,89
0.05,1871,25,39337,21.013354700854702,76
0.05,1872,18,39355,21.01174586225307,83
0.05,1873,9,39364,21.005336179295625,92
0.05,1874,12,39376,21.000533333333333,89
0.05,1875,12,39388,20.995735607675908,89
0.05,1876,37,39425,21.004262120404903,64
0.05,1877,29,39454,21.008519701810435,72
0.05,1878,92,39546,21.046301224055348,9
0.05,1879,78,39624,21.07659574468085,23
0.05,1880,-26,39598,21.05156831472621,127
0.05,1881,94,39692,21.090329436769395,6
0.05,1882,46,39738,21.103558151885288,57
0.05,1883,3,39741,21.093949044585987,99
0.05,1884,41,39782,21.104509283819628,60
0.05,1885,33,39815,21.110816542948037,67
0.05,1886,-14,39801,21.09220985691574,114
0.05,1887,-8,39793,21.076800847457626,108
0.05,1888,88,39881,21.112228692429856,12
0.05,1889,61,39942,21.133333333333333,39
0.05,1890,72,40014,21.1602326811211,28
0.05,1891,23,40037,21.16120507399577,8
0.05,1892,-33,40004,21.132593766508187,137
0.05,1893,-228,39776,21.00105596620908,259
0.05,1894,89,39865,21.03693931398417,11
0.05,1895,-8,39857,21.02162447257384,40
0.05,1896,86,39943,21.05587770163416,14
0.05,1897,-43,39900,21.022128556375133,75
0.05,1898,-108,39792,20.954186413902054,213
0.05,1899,95,39887,20.993157894736843,6
0.05,1900,62,39949,21.014729089952656,38
0.05,1901,-8,39941,20.999474237644584,39
0.05,1902,74,40015,21.027325275880187,26
0.05,1903,59,40074,21.047268907563026,41
0.05,1904,-51,40023,21.00944881889764,153
0.05,1905,-112,39911,20.939664218258134,214
0.05,1906,81,39992,20.971158888306242,20
0.05,1907,-126,39866,20.89412997903564,190
0.05,1908,81,39947,20.92561550550026,20
0.05,1909,68,40015,20.95026178010471,32
0.05,1910,47,40062,20.963893249607537,54
0.05,1911,90,40152,21.0,11
0.05,1912,83,40235,21.03240982749608,18
0.05,1913,94,40329,21.070532915360502,6
0.05,1914,54,40383,21.087728459530027,47
0.05,1915,93,40476,21.12526096033403,8
0.05,1916,27,40503,21.128325508607197,76
0.05,1917,28,40531,21.131908237747655,77
0.05,1918,54,40585,21.149035956227202,47
0.05,1919,-4,40581,21.1359375,105
0.05,1920,-51,40530,21.09838625715773,154
0.05,1921,95,40625,21.13683662851197,6
0.05,1922,67,40692,21.160686427457097,33
0.05,1923,-3,40689,21.1481288981289,104
0.05,1924,86,40775,21.181818181818183,14
0.05,1925,64,40839,21.20404984423676,37
0.05,1926,58,40897,21.223144784639334,42
0.05,1927,89,40986,21.258298755186722,12
0.05,1928,6,40992,21.250388802488335,26
0.05,1929,41,41033,21.26062176165803,59
0.05,1930,50,41083,21.27550491973071,70
0.05,1931,82,41165,21.306935817805382,18
0.05,1932,91,41256,21.34299017071909,12
0.05,1933,51,41307,21.358324715615304,49
0.05,1934,48,41355,21.372093023255815,52
0.05,1935,85,41440,21.40495867768595,15
0.05,1936,-6,41434,21.39081053175013,106
0.05,1937,44,41478,21.402476780185758,57
0.05,1938,35,41513,21.40948942753997,67
0.05,1939,66,41579,21.432474226804125,49
0.05,1940,5,41584,21.42400824317362,96
0.05,1941,59,41643,21.443357363542738,42
0.05,1942,-53,41590,21.405043746783324,156
0.05,1943,77,41667,21.433641975308642,24
0.05,1944,86,41753,21.466838046272493,15
0.05,1945,32,41785,21.47225077081192,68
0.05,1946,-39,41746,21.441191576784796,141
0.05,1947,49,41795,21.455338809034906,51
0.05,1948,67,41862,21.47870702924577,33
0.05,1949,22,41884,21.47897435897436,79
0.05,1950,17,41901,21.476678626345464,86
0.05,1951,44,41945,21.488217213114755,57
0.05,1952,-116,41829,21.417818740399387,150
0.05,1953,-16,41813,21.39866939611054,48
0.05,1954,81,41894,21.42915601023018,20
0.05,1955,90,41984,21.464212678936605,10
0.05,1956,-35,41949,21.435360245273376,68
0.05,1957,65,42014,21.457609805924413,36
0.05,1958,90,42104,21.49259826442062,11
0.05,1959,84,42188,21.524489795918367,16
0.05,1960,-50,42138,21.488016318205,83
0.05,1961,-76,42062,21.438328236493373,176
0.05,1962,-6,42056,21.424350483953134,107
0.05,1963,40,42096,21.433808553971488,60
0.05,1964,61,42157,21.453944020356236,40
0.05,1965,84,42241,21.485757884028484,17
0.05,1966,81,42322,21.516014234875446,20
0.05,1967,-197,42125,21.40497967479675,307
0.05,1968,75,42200,21.43219908583037,26
0.05,1969,18,42218,21.430456852791878,14
0.05,1970,81,42299,21.460679857940132,20
0.05,1971,62,42361,21.481237322515213,69
0.05,1972,-62,42299,21.43892549417131,163
0.05,1973,76,42375,21.466565349544073,25
0.05,1974,52,42427,21.482025316455697,51
0.05,1975,-97,42330,21.422064777327936,129
0.05,1976,60,42390,21.441578148710168,42
0.05,1977,34,42424,21.447927199191103,67
0.05,1978,94,42518,21.484588175846387,7
0.05,1979,70,42588,21.509090909090908,31
0.05,1980,87,42675,21.542150429076223,14
0.05,1981,94,42769,21.578708375378405,6
0.05,1982,7,42776,21.57135653050933,100
0.05,1983,-103,42673,21.508568548387096,140
0.05,1984,87,42760,21.54156171284635,14
0.05,1985,88,42848,21.575025176233634,13
0.05,1986,-56,42792,21.53598389531958,101
0.05,1987,93,42885,21.571931589537222,8
0.05,1988,83,42968,21.602815485168428,17
0.05,1989,71,43039,21.627638190954773,29
0.05,1990,86,43125,21.659969864389755,15
0.05,1991,-4,43121,21.647088353413654,105
0.05,1992,69,43190,21.670847967887607,32
0.05,1993,20,43210,21.67001003009027,81
0.05,1994,-27,43183,21.645614035087718,129
0.05,1995,68,43251,21.6688376753507,33
0.05,1996,-103,43148,21.606409614421633,216
0.05,1997,67,43215,21.62912912912913,33
0.05,1998,91,43306,21.663831915957978,9
0.05,1999,-82,43224,21.612,113
0.05,2000,-48,43176,21.57721139430285,152
0.05,2001,88,43264,21.61038961038961,12
0.05,2002,41,43305,21.620069895157265,61
0.05,2003,76,43381,21.647205588822356,24
0.05,2004,19,43400,21.64588528678304,12
0.05,2005,19,43419,21.64456630109671,12
0.05,2006,12,43431,21.639760837070256,91
0.05,2007,-1,43430,21.628486055776893,106
0.05,2008,-110,43320,21.562966650074664,210
0.05,2009,45,43365,21.574626865671643,55
0.05,2010,-7,43358,21.560417702635505,107
0.05,2011,-170,43188,21.46520874751491,248
0.05,2012,46,43234,21.47739692001987,54
0.05,2013,-1,43233,21.466236345580935,106
0.05,2014,9,43242,21.460049627791562,94
0.05,2015,60,43302,21.479166666666668,42
0.05,2016,1,43303,21.469013386217153,100
0.05,2017,64,43367,21.490089197224975,36
0.05,2018,-95,43272,21.432392273402673,126
0.05,2019,19,43291,21.431188118811882,84
0.05,2020,67,43358,21.453735774369125,34
0.05,2021,93,43451,21.4891196834817,8
0.05,2022,63,43514,21.50963914977756,38
0.05,2023,91,43605,21.54397233201581,9
0.05,2024,59,43664,21.56246913580247,42
0.05,2025,14,43678,21.558736426456072,17
0.05,2026,30,43708,21.562900838677848,71
0.05,2027,-3,43705,21.55078895463511,103
0.05,2028,-4,43701,21.538196155741744,104
0.05,2029,-6,43695,21.52463054187192,109
0.05,2030,50,43745,21.53865091088134,50
0.05,2031,94,43839,21.574311023622048,6
0.05,2032,60,43899,21.593212001967537,40
0.05,2033,4,43903,21.58456243854474,96
0.05,2034,90,43993,21.618181818181817,11
0.05,2035,65,44058,21.639489194499017,36
0.05,2036,68,44126,21.662248404516447,33
0.05,2037,46,44172,21.674190382728163,57
0.05,2038,78,44250,21.701814615007358,22
0.05,2039,88,44338,21.734313725490196,13
0.05,2040,-48,44290,21.70014698677119,148
0.05,2041,60,44350,21.71890303623898,40
0.05,2042,-27,44323,21.695056289769948,58
0.05,2043,81,44404,21.724070450097848,19
0.05,2044,-34,44370,21.69682151589242,66
0.05,2045,-30,44340,21.671554252199414,130
0.05,2046,-105,44235,21.609672691744017,141
0.05,2047,-5,44230,21.5966796875,107
0.05,2048,-15,44215,21.578818936066373,117
0.05,2049,19,44234,21.577560975609757,81
0.05,2050,35,44269,21.58410531448074,66
0.05,2051,73,44342,21.60916179337232,28
0.05,2052,87,44429,21.64101315148563,14
0.05,2053,-20,44409,21.620740019474198,53
0.05,2054,36,44445,21.62773722627737,66
0.05,2055,59,44504,21.64591439688716,41
0.05,2056,58,44562,21.663587749149247,44
0.05,2057,69,44631,21.686588921282798,31
0.05,2058,-12,44619,21.670228266148616,113
0.05,2059,-42,44577,21.639320388349514,143
0.05,2060,92,44669,21.67345948568656,9
0.05,2061,52,44721,21.688166828322018,49
0.05,2062,15,44736,21.68492486669898,86
0.05,2063,64,44800,21.705426356589147,37
0.05,2064,-69,44731,21.661501210653753,169
0.05,2065,64,44795,21.681994191674733,37
0.05,2066,-21,44774,21.66134494436381,54
0.05,2067,15,44789,21.658123791102515,88
0.05,2068,63,44852,21.678105364910586,37
0.05,2069,88,44940,21.71014492753623,13
0.05,2070,-208,44732,21.599227426364074,171
0.05,2071,87,44819,21.630791505791507,13
0.05,2072,-32,44787,21.604920405209842,134
0.05,2073,95,44882,21.64030858244937,6
0.05,2074,-51,44831,21.605301204819277,153
0.05,2075,84,44915,21.63535645472062,16
0.05,2076,32,44947,21.640346653827635,69
0.05,2077,76,45023,21.6665062560154,24
0.05,2078,30,45053,21.67051467051467,71
0.05,2079,-95,44958,21.614423076923078,197
0.05,2080,25,44983,21.61604997597309,77
0.05,2081,85,45068,21.646493756003842,15
0.05,2082,-9,45059,21.631781084973596,40
0.05,2083,74,45133,21.656909788867562,26
0.05,2084,58,45191,21.674340527577936,42
0.05,2085,40,45231,21.68312559923298,67
0.05,2086,75,45306,21.708672735984667,26
0.05,2087,67,45373,21.73036398467433,34
0.05,2088,-114,45259,21.665390138822403,145
0.05,2089,88,45347,21.697129186602872,13
0.05,2090,35,45382,21.703491152558584,70
0.05,2091,13,45395,21.699330783938816,88
0.05,2092,88,45483,21.73100812231247,13
0.05,2093,-16,45467,21.712989493791785,116
0.05,2094,94,45561,21.747494033412888,7
0.05,2095,30,45591,21.751431297709924,70
0.05,2096,-61,45530,21.711969480209824,92
0.05,2097,38,45568,21.719733079122975,62
0.05,2098,72,45640,21.743687470223914,29
0.05,2099,-45,45595,21.711904761904762,76
0.05,2100,55,45650,21.727748691099478,45
0.05,2101,29,45679,21.731208372978116,96
0.05,2102,94,45773,21.76557299096529,7
0.05,2103,50,45823,21.778992395437264,53
0.05,2104,94,45917,21.81330166270784,7
0.05,2105,-145,45772,21.7340930674264,249
0.05,2106,82,45854,21.762695775984813,19
0.05,2107,74,45928,21.787476280834916,27
0.05,2108,86,46014,21.817923186344238,15
0.05,2109,-81,45933,21.76919431279621,115
0.05,2110,56,45989,21.78540975840834,44
0.05,2111,74,46063,21.810132575757574,26
0.05,2112,93,46156,21.843823946994796,7
0.05,2113,76,46232,21.869441816461684,25
0.05,2114,15,46247,21.866193853427895,87
0.05,2115,-55,46192,21.829867674858225,87
0.05,2116,-7,46185,21.816249409541804,41
0.05,2117,-8,46177,21.802171860245515,40
0.05,2118,90,46267,21.834355828220858,11
0.05,2119,-8,46259,21.820283018867926,115
0.05,2120,68,46327,21.84205563413484,32
0.05,2121,63,46390,21.861451460885956,38
0.05,2122,-18,46372,21.84267545925577,50
0.05,2123,75,46447,21.867702448210924,25
0.05,2124,-40,46407,21.838588235294118,141
0.05,2125,-43,46364,21.808090310442147,77
0.05,2126,78,46442,21.834508697696286,23
0.05,2127,47,46489,21.846334586466167,56
0.05,2128,78,46567,21.872710192578676,23
0.05,2129,90,46657,21.90469483568075,11
0.05,2130,-20,46637,21.885030502111686,121
0.05,2131,94,46731,21.918855534709195,7
0.05,2132,68,46799,21.940459446788562,32
0.05,2133,85,46884,21.970009372071228,15
0.05,2134,34,46918,21.975644028103044,68
0.05,2135,-12,46906,21.959737827715355,114
0.05,2136,76,46982,21.985025737014507,25
0.05,2137,64,47046,22.00467726847521,37
0.05,2138,-72,46974,21.96072931276297,105
0.05,2139,90,47064,21.992523364485983,10
0.05,2140,51,47115,22.006071929005138,49
0.05,2141,-3,47112,21.99439775910364,106
0.05,2142,52,47164,22.00839944003733,48
0.05,2143,83,47247,22.036847014925375,17
0.05,2144,65,47312,22.056876456876456,36
0.05,2145,41,47353,22.065703634669152,59
0.05,2146,91,47444,22.09781089892874,10
0.05,2147,-60,47384,22.05959031657356,163
0.05,2148,-7,47377,22.046067938576083,108
0.05,2149,-380,46997,21.85906976744186,348
0.05,2150,57,47054,21.87540678754068,45
0.05,2151,7,47061,21.868494423791823,93
0.05,2152,-152,46909,21.787738039944262,259
0.05,2153,90,46999,21.819405756731662,10
0.05,2154,-57,46942,21.782830626450117,159
0.05,2155,-7,46935,21.76948051948052,39
0.05,2156,79,47014,21.796012980992117,21
0.05,2157,48,47062,21.808155699721965,53
0.05,2158,21,47083,21.807781380268644,80
0.05,2159,-220,46863,21.695833333333333,186
0.05,2160,-20,46843,21.676538639518743,122
0.05,2161,90,46933,21.70814061054579,11
0.05,2162,65,46998,21.728155339805824,36
0.05,2163,93,47091,21.76109057301294,7
0.05,2164,49,47140,21.77367205542725,51
0.05,2165,86,47226,21.803324099722992,14
0.05,2166,84,47310,21.832025842178126,16
0.05,2167,65,47375,21.851937269372694,35
0.05,2168,71,47446,21.874596588289535,30
0.05,2169,-19,47427,21.855760368663596,121
0.05,2170,-16,47411,21.838323353293415,48
0.05,2171,45,47456,21.848987108655617,61
0.05,2172,40,47496,21.857340082834792,61
0.05,2173,45,47541,21.867985280588776,56
0.05,2174,-40,47501,21.839540229885056,74
0.05,2175,45,47546,21.850183823529413,56
0.05,2176,-131,47415,21.779972439136426,232
0.05,2177,50,47465,21.792929292929294,50
0.05,2178,-180,47285,21.700321248279028,214
0.05,2179,45,47330,21.711009174311926,55
0.05,2180,71,47401,21.73360843649702,29
