0.2,0,25,25,25.0,9
0.2,1,-65,-40,-20.0,40
0.2,2,-70,-110,-36.666666666666664,54
0.2,3,91,-19,-4.75,10
0.2,4,21,2,0.4,14
0.2,5,8,10,1.6666666666666667,25
0.2,6,85,95,13.571428571428571,17
0.2,7,88,183,22.875,13
0.2,8,83,266,29.555555555555557,18
0.2,9,24,290,29.0,15
0.2,10,89,379,34.45454545454545,12
0.2,11,87,466,38.833333333333336,16
0.2,12,93,559,43.0,13
0.2,13,94,653,46.642857142857146,7
0.2,14,94,747,49.8,7
0.2,15,91,838,52.375,13
0.2,16,94,932,54.8235294117647,7
0.2,17,20,952,52.888888888888886,21
0.2,18,87,1039,54.68421052631579,14
0.2,19,92,1131,56.55,10
0.2,20,94,1225,58.333333333333336,7
0.2,21,91,1316,59.81818181818182,11
0.2,22,94,1410,61.30434782608695,7
0.2,23,25,1435,59.791666666666664,12
0.2,24,92,1527,61.08,9
0.2,25,95,1622,62.38461538461539,6
0.2,26,92,1714,63.48148148148148,10
0.2,27,25,1739,62.107142857142854,7
0.2,28,88,1827,63.0,15
0.2,29,93,1920,64.0,8
0.2,30,92,2012,64.90322580645162,9
0.2,31,94,2106,65.8125,8
0.2,32,91,2197,66.57575757575758,11
0.2,33,94,2291,67.38235294117646,7
0.2,34,92,2383,68.08571428571429,10
0.2,35,94,2477,68.80555555555556,7
0.2,36,94,2571,69.48648648648648,7
0.2,37,92,2663,70.07894736842105,9
0.2,38,84,2747,70.43589743589743,17
0.2,39,94,2841,71.025,7
0.2,40,-125,2716,66.2439024390244,20
0.2,41,87,2803,66.73809523809524,15
0.2,42,95,2898,67.3953488372093,6
0.2,43,17,2915,66.25,16
0.2,44,-50,2865,63.666666666666664,14
0.2,45,90,2955,64.23913043478261,11
0.2,46,25,2980,63.40425531914894,7
0.2,47,94,3074,64.04166666666667,7
0.2,48,95,3169,64.6734693877551,7
0.2,49,92,3261,65.22,12
0.2,50,91,3352,65.72549019607843,10
0.2,51,92,3444,66.23076923076923,10
0.2,52,93,3537,66.73584905660377,8
0.2,53,85,3622,67.07407407407408,18
0.2,54,92,3714,67.52727272727273,9
0.2,55,89,3803,67.91071428571429,14
0.2,56,94,3897,68.36842105263158,7
0.2,57,91,3988,68.75862068965517,10
0.2,58,90,4078,69.11864406779661,12
0.2,59,90,4168,69.46666666666667,11
0.2,60,87,4255,69.75409836065573,15
0.2,61,92,4347,70.11290322580645,9
0.2,62,91,4438,70.44444444444444,10
0.2,63,93,4531,70.796875,9
0.2,64,91,4622,71.1076923076923,11
0.2,65,95,4717,71.46969696969697,6
0.2,66,93,4810,71.7910447761194,8
0.2,67,92,4902,72.08823529411765,9
0.2,68,92,4994,72.3768115942029,10
0.2,69,26,5020,71.71428571428571,7
0.2,70,87,5107,71.92957746478874,14
0.2,71,95,5202,72.25,6
0.2,72,95,5297,72.56164383561644,6
0.2,73,-67,5230,70.67567567567568,33
0.2,74,94,5324,70.98666666666666,7
0.2,75,19,5343,70.30263157894737,13
0.2,76,94,5437,70.6103896103896,8
0.2,77,91,5528,70.87179487179488,10
0.2,78,93,5621,71.15189873417721,8
0.2,79,-137,5484,68.55,31
0.2,80,18,5502,67.92592592592592,14
0.2,81,94,5596,68.2439024390244,7
0.2,82,92,5688,68.53012048192771,11
0.2,83,94,5782,68.83333333333333,7
0.2,84,20,5802,68.25882352941177,13
0.2,85,90,5892,68.51162790697674,11
0.2,86,79,5971,68.63218390804597,23
0.2,87,94,6065,68.92045454545455,7
0.2,88,94,6159,69.20224719101124,7
0.2,89,89,6248,69.42222222222222,14
0.2,90,94,6342,69.6923076923077,8
0.2,91,90,6432,69.91304347826087,12
0.2,92,95,6527,70.18279569892474,6
0.2,93,91,6618,70.40425531914893,11
0.2,94,96,6714,70.67368421052632,6
0.2,95,94,6808,70.91666666666667,8
0.2,96,94,6902,71.15463917525773,7
0.2,97,95,6997,71.39795918367346,7
0.2,98,93,7090,71.61616161616162,8
0.2,99,19,7109,71.09,15
0.2,100,94,7203,71.31683168316832,7
0.2,101,95,7298,71.54901960784314,6
0.2,102,95,7393,71.77669902912622,6
0.2,103,93,7486,71.98076923076923,8
0.2,104,95,7581,72.2,6
0.2,105,23,7604,71.73584905660377,10
0.2,106,96,7700,71.96261682242991,6
0.2,107,94,7794,72.16666666666667,8
0.2,108,96,7890,72.38532110091744,6
0.2,109,90,7980,72.54545454545455,11
0.2,110,90,8070,72.70270270270271,12
0.2,111,92,8162,72.875,10
0.2,112,87,8249,73.0,15
0.2,113,90,8339,73.14912280701755,11
0.2,114,94,8433,73.33043478260869,7
0.2,115,95,8528,73.51724137931035,6
0.2,116,94,8622,73.6923076923077,8
0.2,117,94,8716,73.86440677966101,8
0.2,118,-48,8668,72.84033613445378,12
0.2,119,92,8760,73.0,9
0.2,120,93,8853,73.16528925619835,8
0.2,121,93,8946,73.32786885245902,8
0.2,122,91,9037,73.47154471544715,10
0.2,123,90,9127,73.60483870967742,11
0.2,124,96,9223,73.784,6
0.2,125,90,9313,73.91269841269842,12
0.2,126,94,9407,74.07086614173228,8
0.2,127,95,9502,74.234375,8
0.2,128,25,9527,73.85271317829458,8
0.2,129,96,9623,74.02307692307693,6
0.2,130,96,9719,74.19083969465649,6
0.2,131,92,9811,74.32575757575758,10
0.2,132,94,9905,74.47368421052632,7
0.2,133,92,9997,74.6044776119403,9
0.2,134,94,10091,74.74814814814815,7
0.2,135,23,10114,74.36764705882354,10
0.2,136,21,10135,73.97810218978103,12
0.2,137,93,10228,74.1159420289855,8
0.2,138,92,10320,74.24460431654676,9
0.2,139,91,10411,74.36428571428571,11
0.2,140,95,10506,74.51063829787235,6
0.2,141,25,10531,74.16197183098592,9
0.2,142,18,10549,73.76923076923077,14
0.2,143,96,10645,73.92361111111111,6
0.2,144,88,10733,74.02068965517242,13
0.2,145,92,10825,74.14383561643835,10
0.2,146,93,10918,74.27210884353741,8
0.2,147,92,11010,74.39189189189189,9
0.2,148,90,11100,74.49664429530202,11
0.2,149,95,11195,74.63333333333334,6
0.2,150,90,11285,74.73509933774834,11
0.2,151,27,11312,74.42105263157895,6
0.2,152,25,11337,74.09803921568627,8
0.2,153,93,11430,74.22077922077922,8
0.2,154,95,11525,74.35483870967742,6
0.2,155,26,11551,74.0448717948718,8
0.2,156,94,11645,74.171974522293,7
0.2,157,20,11665,73.82911392405063,13
0.2,158,94,11759,73.95597484276729,8
0.2,159,92,11851,74.06875,9
0.2,160,94,11945,74.19254658385093,7
0.2,161,94,12039,74.31481481481481,8
0.2,162,92,12131,74.42331288343559,9
0.2,163,22,12153,74.10365853658537,12
0.2,164,84,12237,74.16363636363636,18
0.2,165,94,12331,74.28313253012048,8
0.2,166,95,12426,74.40718562874251,6
0.2,167,86,12512,74.47619047619048,15
0.2,168,21,12533,74.15976331360947,11
0.2,169,92,12625,74.26470588235294,9
0.2,170,95,12720,74.3859649122807,6
0.2,171,95,12815,74.50581395348837,6
0.2,172,90,12905,74.59537572254335,12
0.2,173,88,12993,74.67241379310344,13
0.2,174,96,13089,74.79428571428572,6
0.2,175,94,13183,74.9034090909091,8
0.2,176,92,13275,75.0,10
0.2,177,91,13366,75.08988764044943,11
0.2,178,19,13385,74.77653631284916,13
0.2,179,93,13478,74.87777777777778,8
0.2,180,94,13572,74.98342541436465,8
0.2,181,94,13666,75.08791208791209,7
0.2,182,92,13758,75.18032786885246,9
0.2,183,86,13844,75.23913043478261,16
0.2,184,93,13937,75.33513513513513,10
0.2,185,93,14030,75.43010752688173,9
0.2,186,95,14125,75.53475935828877,6
0.2,187,92,14217,75.62234042553192,9
0.2,188,94,14311,75.71957671957672,7
0.2,189,94,14405,75.8157894736842,8
0.2,190,94,14499,75.91099476439791,7
0.2,191,92,14591,75.99479166666667,11
0.2,192,94,14685,76.0880829015544,8
0.2,193,92,14777,76.1701030927835,9
0.2,194,-48,14729,75.53333333333333,11
0.2,195,96,14825,75.63775510204081,6
0.2,196,90,14915,75.71065989847716,13
0.2,197,93,15008,75.79797979797979,8
0.2,198,90,15098,75.86934673366834,11
0.2,199,23,15121,75.605,9
0.2,200,27,15148,75.363184079602,6
0.2,201,94,15242,75.45544554455445,7
0.2,202,21,15263,75.1871921182266,11
0.2,203,93,15356,75.27450980392157,8
0.2,204,18,15374,74.99512195121952,14
0.2,205,91,15465,75.07281553398059,10
0.2,206,95,15560,75.16908212560386,6
0.2,207,92,15652,75.25,10
0.2,208,21,15673,74.99043062200957,11
0.2,209,93,15766,75.07619047619048,8
0.2,210,25,15791,74.8388625592417,10
0.2,211,21,15812,74.58490566037736,11
0.2,212,91,15903,74.66197183098592,10
0.2,213,93,15996,74.74766355140187,8
0.2,214,94,16090,74.83720930232558,7
0.2,215,94,16184,74.92592592592592,7
0.2,216,93,16277,75.00921658986175,8
0.2,217,84,16361,75.05045871559633,18
0.2,218,90,16451,75.11872146118722,12
0.2,219,96,16547,75.21363636363637,7
0.2,220,84,16631,75.25339366515837,17
0.2,221,94,16725,75.33783783783784,7
0.2,222,23,16748,75.10313901345292,9
0.2,223,82,16830,75.13392857142857,21
0.2,224,94,16924,75.21777777777778,8
0.2,225,94,17018,75.30088495575221,7
0.2,226,94,17112,75.38325991189427,7
0.2,227,96,17208,75.47368421052632,6
0.2,228,27,17235,75.26200873362446,6
0.2,229,89,17324,75.32173913043478,12
0.2,230,91,17415,75.3896103896104,10
0.2,231,23,17438,75.16379310344827,10
0.2,232,91,17529,75.23175965665236,10
0.2,233,94,17623,75.3119658119658,7
0.2,234,94,17717,75.39148936170213,7
0.2,235,14,17731,75.13135593220339,19
0.2,236,92,17823,75.20253164556962,11
0.2,237,95,17918,75.28571428571429,6
0.2,238,89,18007,75.34309623430963,12
0.2,239,94,18101,75.42083333333333,7
0.2,240,96,18197,75.50622406639005,6
0.2,241,26,18223,75.30165289256199,6
0.2,242,89,18312,75.35802469135803,12
0.2,243,94,18406,75.43442622950819,7
0.2,244,94,18500,75.51020408163265,7
0.2,245,92,18592,75.57723577235772,10
0.2,246,96,18688,75.65991902834008,6
0.2,247,21,18709,75.43951612903226,11
0.2,248,93,18802,75.51004016064257,9
0.2,249,90,18892,75.568,13
0.2,250,96,18988,75.64940239043824,6
0.2,251,25,19013,75.4484126984127,8
0.2,252,93,19106,75.51778656126483,10
0.2,253,-47,19059,75.03543307086615,10
0.2,254,84,19143,75.07058823529412,18
0.2,255,91,19234,75.1328125,11
0.2,256,91,19325,75.19455252918289,10
0.2,257,21,19346,74.98449612403101,11
0.2,258,91,19437,75.04633204633204,11
0.2,259,90,19527,75.10384615384615,11
0.2,260,93,19620,75.17241379310344,9
0.2,261,95,19715,75.24809160305344,7
0.2,262,87,19802,75.29277566539923,15
0.2,263,95,19897,75.36742424242425,6
0.2,264,92,19989,75.43018867924528,9
0.2,265,92,20081,75.49248120300751,9
0.2,266,91,20172,75.5505617977528,11
0.2,267,96,20268,75.6268656716418,6
0.2,268,95,20363,75.69888475836431,6
0.2,269,96,20459,75.77407407407408,6
0.2,270,94,20553,75.84132841328413,8
0.2,271,21,20574,75.63970588235294,11
0.2,272,25,20599,75.45421245421245,7
0.2,273,-47,20552,75.00729927007299,10
0.2,274,-46,20506,74.56727272727272,9
0.2,275,95,20601,74.6413043478261,6
0.2,276,18,20619,74.43682310469315,16
0.2,277,93,20712,74.50359712230215,9
0.2,278,88,20800,74.55197132616487,14
0.2,279,-46,20754,74.12142857142857,9
0.2,280,23,20777,73.93950177935943,9
0.2,281,92,20869,74.00354609929079,10
0.2,282,93,20962,74.07067137809187,8
0.2,283,91,21053,74.13028169014085,11
0.2,284,94,21147,74.2,7
0.2,285,89,21236,74.25174825174825,12
0.2,286,96,21332,74.32752613240419,7
0.2,287,19,21351,74.13541666666667,17
0.2,288,96,21447,74.21107266435986,6
0.2,289,92,21539,74.27241379310345,9
0.2,290,94,21633,74.34020618556701,7
0.2,291,89,21722,74.39041095890411,12
0.2,292,93,21815,74.45392491467577,8
0.2,293,90,21905,74.50680272108843,12
0.2,294,94,21999,74.5728813559322,9
0.2,295,25,22024,74.4054054054054,8
0.2,296,93,22117,74.46801346801347,9
0.2,297,94,22211,74.53355704697987,7
0.2,298,22,22233,74.35785953177258,11
0.2,299,-48,22185,73.95,11
0.2,300,22,22207,73.77740863787375,10
0.2,301,92,22299,73.83774834437087,9
0.2,302,89,22388,73.88778877887789,13
0.2,303,93,22481,73.95065789473684,9
0.2,304,91,22572,74.00655737704918,10
0.2,305,96,22668,74.07843137254902,6
0.2,306,89,22757,74.1270358306189,12
0.2,307,95,22852,74.1948051948052,6
0.2,308,96,22948,74.26537216828478,6
0.2,309,95,23043,74.33225806451613,6
0.2,310,95,23138,74.39871382636656,6
0.2,311,92,23230,74.4551282051282,10
0.2,312,88,23318,74.49840255591054,15
0.2,313,94,23412,74.56050955414013,7
0.2,314,95,23507,74.62539682539682,6
0.2,315,91,23598,74.67721518987342,10
0.2,316,94,23692,74.73817034700315,8
0.2,317,-127,23565,74.10377358490567,24
0.2,318,94,23659,74.16614420062696,8
0.2,319,92,23751,74.221875,10
0.2,320,89,23840,74.26791277258567,12
0.2,321,24,23864,74.11180124223603,10
0.2,322,94,23958,74.17337461300309,7
0.2,323,90,24048,74.22222222222223,12
0.2,324,95,24143,74.28615384615385,6
0.2,325,92,24235,74.34049079754601,10
0.2,326,96,24331,74.40672782874617,6
0.2,327,93,24424,74.46341463414635,8
0.2,328,24,24448,74.31003039513678,8
0.2,329,93,24541,74.36666666666666,8
0.2,330,21,24562,74.20543806646526,12
0.2,331,95,24657,74.26807228915662,8
0.2,332,88,24745,74.30930930930931,13
0.2,333,94,24839,74.36826347305389,8
0.2,334,93,24932,74.42388059701493,9
0.2,335,96,25028,74.48809523809524,6
0.2,336,89,25117,74.53115727002967,12
0.2,337,94,25211,74.58875739644971,7
0.2,338,92,25303,74.6401179941003,10
0.2,339,94,25397,74.69705882352942,7
0.2,340,20,25417,74.5366568914956,12
0.2,341,19,25436,74.37426900584795,15
0.2,342,-49,25387,74.01457725947522,13
0.2,343,94,25481,74.07267441860465,7
0.2,344,95,25576,74.13333333333334,7
0.2,345,95,25671,74.19364161849711,6
0.2,346,94,25765,74.2507204610951,7
0.2,347,26,25791,74.11206896551724,7
0.2,348,85,25876,74.1432664756447,16
0.2,349,-48,25828,73.79428571428572,12
0.2,350,19,25847,73.63817663817663,13
0.2,351,94,25941,73.69602272727273,7
0.2,352,26,25967,73.56090651558074,7
0.2,353,91,26058,73.61016949152543,10
0.2,354,91,26149,73.65915492957747,11
0.2,355,95,26244,73.71910112359551,6
0.2,356,88,26332,73.75910364145658,13
0.2,357,92,26424,73.81005586592178,9
0.2,358,93,26517,73.86350974930362,8
0.2,359,92,26609,73.91388888888889,9
0.2,360,95,26704,73.97229916897507,6
0.2,361,94,26798,74.02762430939227,8
0.2,362,91,26889,74.07438016528926,12
0.2,363,26,26915,73.9423076923077,6
0.2,364,93,27008,73.9945205479452,9
0.2,365,95,27103,74.05191256830601,6
0.2,366,86,27189,74.08446866485014,15
0.2,367,92,27281,74.13315217391305,9
0.2,368,94,27375,74.1869918699187,8
0.2,369,94,27469,74.24054054054054,7
0.2,370,92,27561,74.28840970350404,11
0.2,371,25,27586,74.15591397849462,8
0.2,372,88,27674,74.19302949061662,14
0.2,373,25,27699,74.06149732620321,8
0.2,374,96,27795,74.12,6
0.2,375,27,27822,73.99468085106383,6
0.2,376,93,27915,74.04509283819628,8
0.2,377,-46,27869,73.72751322751323,10
0.2,378,94,27963,73.78100263852242,7
0.2,379,96,28059,73.83947368421053,6
0.2,380,-50,28009,73.51443569553805,14
0.2,381,86,28095,73.54712041884817,15
0.2,382,96,28191,73.60574412532637,6
0.2,383,92,28283,73.65364583333333,9
0.2,384,94,28377,73.7064935064935,7
0.2,385,92,28469,73.75388601036269,10
0.2,386,94,28563,73.8062015503876,7
0.2,387,90,28653,73.8479381443299,11
0.2,388,91,28744,73.89203084832904,11
0.2,389,96,28840,73.94871794871794,6
0.2,390,15,28855,73.79795396419438,18
0.2,391,91,28946,73.84183673469387,10
0.2,392,95,29041,73.89567430025446,6
0.2,393,24,29065,73.76903553299492,9
0.2,394,91,29156,73.8126582278481,12
0.2,395,25,29181,73.68939393939394,8
0.2,396,91,29272,73.73299748110831,11
0.2,397,22,29294,73.60301507537689,11
0.2,398,96,29390,73.65914786967419,6
0.2,399,94,29484,73.71,8
0.2,400,95,29579,73.76309226932668,8
0.2,401,96,29675,73.81840796019901,6
0.2,402,95,29770,73.87096774193549,6
0.2,403,92,29862,73.91584158415841,9
0.2,404,92,29954,73.96049382716049,9
0.2,405,24,29978,73.83743842364532,8
0.2,406,91,30069,73.87960687960688,10
0.2,407,90,30159,73.91911764705883,11
0.2,408,94,30253,73.96821515892421,7
0.2,409,93,30346,74.01463414634146,8
0.2,410,93,30439,74.06082725060827,8
0.2,411,88,30527,74.09466019417475,13
0.2,412,93,30620,74.14043583535108,10
0.2,413,94,30714,74.18840579710145,8
0.2,414,89,30803,74.22409638554217,15
0.2,415,25,30828,74.10576923076923,8
0.2,416,21,30849,73.97841726618705,11
0.2,417,95,30944,74.02870813397129,6
0.2,418,26,30970,73.91408114558473,7
0.2,419,94,31064,73.96190476190476,8
0.2,420,92,31156,74.00475059382423,9
0.2,421,-71,31085,73.6611374407583,37
0.2,422,90,31175,73.69976359338061,12
0.2,423,92,31267,73.74292452830188,10
0.2,424,92,31359,73.78588235294117,9
0.2,425,90,31449,73.82394366197182,12
0.2,426,94,31543,73.8711943793911,7
0.2,427,94,31637,73.91822429906541,8
0.2,428,91,31728,73.95804195804196,11
0.2,429,92,31820,74.0,9
0.2,430,96,31916,74.05104408352668,6
0.2,431,20,31936,73.92592592592592,12
0.2,432,24,31960,73.81062355658199,8
0.2,433,93,32053,73.85483870967742,8
0.2,434,90,32143,73.8919540229885,12
0.2,435,92,32235,73.93348623853211,9
0.2,436,21,32256,73.81235697940504,11
0.2,437,94,32350,73.85844748858447,7
0.2,438,91,32441,73.89749430523918,10
0.2,439,94,32535,73.94318181818181,7
0.2,440,93,32628,73.98639455782313,8
0.2,441,93,32721,74.02941176470588,8
0.2,442,90,32811,74.06546275395034,11
0.2,443,96,32907,74.11486486486487,6
0.2,444,26,32933,74.00674157303371,7
0.2,445,95,33028,74.05381165919283,7
0.2,446,91,33119,74.0917225950783,11
0.2,447,88,33207,74.12276785714286,15
0.2,448,93,33300,74.16481069042317,8
0.2,449,25,33325,74.05555555555556,7
0.2,450,24,33349,73.94456762749445,8
0.2,451,90,33439,73.98008849557522,11
0.2,452,22,33461,73.86534216335541,10
0.2,453,25,33486,73.75770925110132,8
0.2,454,96,33582,73.80659340659341,6
0.2,455,91,33673,73.84429824561404,10
0.2,456,96,33769,73.89277899343544,6
0.2,457,88,33857,73.9235807860262,14
0.2,458,24,33881,73.81481481481481,8
0.2,459,96,33977,73.86304347826086,6
0.2,460,89,34066,73.89587852494577,12
0.2,461,21,34087,73.78138528138528,12
0.2,462,95,34182,73.82721382289417,7
0.2,463,93,34275,73.86853448275862,8
0.2,464,93,34368,73.90967741935484,8
0.2,465,96,34464,73.95708154506438,6
0.2,466,91,34555,73.99357601713062,10
0.2,467,96,34651,74.0405982905983,6
0.2,468,93,34744,74.08102345415779,8
0.2,469,93,34837,74.12127659574467,8
0.2,470,94,34931,74.16348195329087,8
0.2,471,93,35024,74.20338983050847,9
0.2,472,90,35114,74.23678646934461,11
0.2,473,86,35200,74.26160337552743,15
0.2,474,92,35292,74.29894736842105,9
0.2,475,23,35315,74.19117647058823,9
0.2,476,94,35409,74.23270440251572,7
0.2,477,92,35501,74.26987447698745,10
0.2,478,92,35593,74.30688935281837,10
0.2,479,90,35683,74.33958333333334,11
0.2,480,95,35778,74.38253638253639,8
0.2,481,96,35874,74.42738589211618,6
0.2,482,21,35895,74.3167701863354,11
0.2,483,94,35989,74.35743801652893,7
0.2,484,94,36083,74.3979381443299,7
0.2,485,94,36177,74.43827160493827,7
0.2,486,92,36269,74.47433264887064,11
0.2,487,94,36363,74.51434426229508,8
0.2,488,93,36456,74.5521472392638,8
0.2,489,96,36552,74.59591836734694,6
0.2,490,89,36641,74.62525458248473,12
0.2,491,22,36663,74.51829268292683,10
0.2,492,18,36681,74.40365111561866,15
0.2,493,92,36773,74.43927125506073,9
0.2,494,94,36867,74.47878787878788,7
0.2,495,96,36963,74.52217741935483,6
0.2,496,93,37056,74.55935613682092,8
0.2,497,94,37150,74.59839357429719,7
0.2,498,95,37245,74.63927855711422,7
0.2,499,96,37341,74.682,6
0.2,500,90,37431,74.7125748502994,11
0.2,501,95,37526,74.75298804780877,6
0.2,502,94,37620,74.79125248508946,7
0.2,503,94,37714,74.82936507936508,7
0.2,504,93,37807,74.86534653465347,8
0.2,505,15,37822,74.74703557312253,17
0.2,506,94,37916,74.78500986193293,8
0.2,507,88,38004,74.81102362204724,13
0.2,508,26,38030,74.71512770137525,6
0.2,509,-45,37985,74.48039215686275,8
0.2,510,93,38078,74.51663405088063,9
0.2,511,94,38172,74.5546875,8
0.2,512,92,38264,74.58869395711501,9
0.2,513,96,38360,74.63035019455253,6
0.2,514,96,38456,74.67184466019417,6
0.2,515,94,38550,74.70930232558139,8
0.2,516,93,38643,74.74468085106383,8
0.2,517,89,38732,74.77220077220078,13
0.2,518,91,38823,74.80346820809248,11
0.2,519,90,38913,74.83269230769231,11
0.2,520,96,39009,74.87332053742803,6
0.2,521,87,39096,74.89655172413794,16
0.2,522,25,39121,74.80114722753346,8
0.2,523,26,39147,74.70801526717557,6
0.2,524,95,39242,74.74666666666667,6
0.2,525,89,39331,74.77376425855513,12
0.2,526,94,39425,74.81024667931689,7
0.2,527,95,39520,74.84848484848484,6
0.2,528,95,39615,74.88657844990549,6
0.2,529,93,39708,74.92075471698114,9
0.2,530,95,39803,74.95856873822976,6
0.2,531,21,39824,74.85714285714286,11
0.2,532,23,39847,74.75984990619136,9
0.2,533,95,39942,74.79775280898876,7
0.2,534,-44,39898,74.57570093457944,8
0.2,535,94,39992,74.61194029850746,7
0.2,536,95,40087,74.64990689013035,6
0.2,537,95,40182,74.68773234200744,6
0.2,538,91,40273,74.71799628942486,10
0.2,539,23,40296,74.62222222222222,9
0.2,540,95,40391,74.65988909426987,6
0.2,541,24,40415,74.56642066420665,8
0.2,542,94,40509,74.60220994475138,8
0.2,543,94,40603,74.63786764705883,8
0.2,544,90,40693,74.66605504587156,12
0.2,545,93,40786,74.6996336996337,9
0.2,546,95,40881,74.73674588665448,7
0.2,547,25,40906,74.64598540145985,8
0.2,548,91,40997,74.67577413479053,11
0.2,549,93,41090,74.7090909090909,8
0.2,550,21,41111,74.61161524500908,11
0.2,551,90,41201,74.63949275362319,11
0.2,552,95,41296,74.67631103074142,6
0.2,553,24,41320,74.58483754512635,8
0.2,554,25,41345,74.49549549549549,7
0.2,555,93,41438,74.52877697841727,9
0.2,556,22,41460,74.43447037701975,10
0.2,557,92,41552,74.46594982078852,9
0.2,558,93,41645,74.49910554561717,8
0.2,559,92,41737,74.53035714285714,9
0.2,560,95,41832,74.56684491978609,6
0.2,561,93,41925,74.59964412811388,8
0.2,562,92,42017,74.63055062166963,9
0.2,563,25,42042,74.54255319148936,7
0.2,564,23,42065,74.45132743362832,9
0.2,565,92,42157,74.48233215547704,9
0.2,566,21,42178,74.38800705467372,11
0.2,567,83,42261,74.40316901408451,20
0.2,568,91,42352,74.4323374340949,10
0.2,569,93,42445,74.46491228070175,8
0.2,570,95,42540,74.50087565674255,6
0.2,571,23,42563,74.41083916083916,10
0.2,572,91,42654,74.43979057591623,10
0.2,573,91,42745,74.46864111498257,10
0.2,574,87,42832,74.4904347826087,14
0.2,575,92,42924,74.52083333333333,9
0.2,576,95,43019,74.55632582322357,6
0.2,577,94,43113,74.58996539792388,7
0.2,578,93,43206,74.62176165803109,8
0.2,579,93,43299,74.65344827586208,8
0.2,580,95,43394,74.68846815834767,6
0.2,581,94,43488,74.72164948453609,7
0.2,582,24,43512,74.63464837049743,8
0.2,583,93,43605,74.66609589041096,8
0.2,584,93,43698,74.6974358974359,8
0.2,585,-45,43653,74.49317406143345,10
0.2,586,18,43671,74.396933560477,14
0.2,587,93,43764,74.42857142857143,8
0.2,588,19,43783,74.33446519524618,14
0.2,589,95,43878,74.36949152542373,6
0.2,590,88,43966,74.39255499153977,13
0.2,591,94,44060,74.42567567567568,7
0.2,592,92,44152,74.45531197301855,10
0.2,593,95,44247,74.48989898989899,6
0.2,594,94,44341,74.52268907563025,7
0.2,595,94,44435,74.55536912751678,7
0.2,596,84,44519,74.571189279732,17
0.2,597,96,44615,74.60702341137124,6
0.2,598,85,44700,74.62437395659433,16
0.2,599,83,44783,74.63833333333334,18
0.2,600,87,44870,74.65890183028286,15
0.2,601,17,44887,74.56312292358804,15
0.2,602,94,44981,74.59535655058043,8
0.2,603,94,45075,74.62748344370861,8
0.2,604,94,45169,74.6595041322314,7
0.2,605,96,45265,74.6947194719472,6
0.2,606,90,45355,74.71993410214168,13
0.2,607,94,45449,74.75164473684211,7
0.2,608,92,45541,74.7799671592775,9
0.2,609,96,45637,74.81475409836065,6
0.2,610,94,45731,74.84615384615384,7
0.2,611,92,45823,74.87418300653594,10
0.2,612,93,45916,74.90375203915171,8
0.2,613,94,46010,74.93485342019544,7
0.2,614,93,46103,74.96422764227643,8
0.2,615,94,46197,74.99512987012987,7
0.2,616,93,46290,75.02431118314425,10
0.2,617,96,46386,75.05825242718447,6
0.2,618,92,46478,75.08562197092084,9
0.2,619,22,46500,75.0,12
0.2,620,94,46594,75.03059581320451,7
0.2,621,94,46688,75.06109324758843,7
0.2,622,25,46713,74.98073836276083,9
0.2,623,95,46808,75.01282051282051,6
0.2,624,19,46827,74.9232,15
0.2,625,81,46908,74.93290734824281,20
0.2,626,20,46928,74.84529505582137,12
0.2,627,10,46938,74.74203821656052,24
0.2,628,26,46964,74.66454689984101,6
0.2,629,88,47052,74.68571428571428,14
0.2,630,87,47139,74.70522979397781,14
0.2,631,23,47162,74.62341772151899,9
0.2,632,24,47186,74.5434439178515,10
0.2,633,93,47279,74.57255520504732,9
0.2,634,-53,47226,74.37165354330709,16
0.2,635,87,47313,74.39150943396227,14
0.2,636,18,47331,74.30298273155417,14
0.2,637,95,47426,74.33542319749216,6
0.2,638,24,47450,74.2566510172144,8
0.2,639,86,47536,74.275,15
0.2,640,94,47630,74.30577223088923,7
0.2,641,95,47725,74.3380062305296,6
0.2,642,92,47817,74.36547433903577,9
0.2,643,87,47904,74.38509316770187,14
0.2,644,87,47991,74.4046511627907,14
0.2,645,92,48083,74.43188854489163,9
0.2,646,94,48177,74.46213292117466,7
0.2,647,88,48265,74.48302469135803,15
0.2,648,92,48357,74.5100154083205,9
0.2,649,91,48448,74.53538461538461,12
0.2,650,21,48469,74.4531490015361,12
0.2,651,23,48492,74.37423312883436,11
0.2,652,24,48516,74.29709035222052,9
0.2,653,91,48607,74.32262996941895,10
0.2,654,92,48699,74.34961832061069,9
0.2,655,92,48791,74.3765243902439,9
0.2,656,92,48883,74.40334855403349,9
0.2,657,23,48906,74.32522796352583,10
0.2,658,-54,48852,74.13050075872535,18
0.2,659,90,48942,74.15454545454546,11
0.2,660,96,49038,74.1875945537065,6
0.2,661,25,49063,74.11329305135952,7
0.2,662,95,49158,74.1447963800905,6
0.2,663,-47,49111,73.96234939759036,10
0.2,664,24,49135,73.88721804511279,8
0.2,665,92,49227,73.91441441441441,9
0.2,666,17,49244,73.82908545727136,15
0.2,667,91,49335,73.85479041916167,10
0.2,668,26,49361,73.78325859491778,7
0.2,669,22,49383,73.70597014925373,10
0.2,670,91,49474,73.73174366616989,11
0.2,671,95,49569,73.76339285714286,7
0.2,672,94,49663,73.79346210995543,7
0.2,673,94,49757,73.82344213649851,7
0.2,674,18,49775,73.74074074074075,15
0.2,675,90,49865,73.76479289940828,11
0.2,676,20,49885,73.68537666174298,12
0.2,677,93,49978,73.71386430678466,9
0.2,678,94,50072,73.74374079528718,7
0.2,679,93,50165,73.7720588235294,8
0.2,680,27,50192,73.70337738619676,6
0.2,681,95,50287,73.73460410557185,6
0.2,682,93,50380,73.76281112737921,8
0.2,683,91,50471,73.78801169590643,10
0.2,684,87,50558,73.80729927007299,15
0.2,685,95,50653,73.83819241982508,8
0.2,686,96,50749,73.87045123726347,6
0.2,687,-125,50624,73.5813953488372,19
0.2,688,23,50647,73.50798258345428,10
0.2,689,26,50673,73.43913043478261,7
0.2,690,21,50694,73.36324167872648,12
0.2,691,94,50788,73.39306358381504,8
0.2,692,91,50879,73.41847041847042,10
0.2,693,21,50900,73.342939481268,11
0.2,694,90,50990,73.36690647482014,12
0.2,695,93,51083,73.39511494252874,8
0.2,696,94,51177,73.42467718794835,7
0.2,697,93,51270,73.45272206303724,8
0.2,698,95,51365,73.48354792560801,7
0.2,699,93,51458,73.51142857142857,8
0.2,700,95,51553,73.54208273894436,7
0.2,701,92,51645,73.56837606837607,10
0.2,702,94,51739,73.59743954480797,7
0.2,703,95,51834,73.6278409090909,6
0.2,704,93,51927,73.65531914893617,9
0.2,705,94,52021,73.6841359773371,7
0.2,706,91,52112,73.70862800565772,10
0.2,707,96,52208,73.74011299435028,6
0.2,708,88,52296,73.76022566995769,13
0.2,709,25,52321,73.69154929577465,7
0.2,710,94,52415,73.72011251758087,7
0.2,711,22,52437,73.64747191011236,10
0.2,712,94,52531,73.67601683029453,7
0.2,713,94,52625,73.70448179271709,7
0.2,714,95,52720,73.73426573426573,7
0.2,715,94,52814,73.76256983240224,7
0.2,716,90,52904,73.78521617852162,13
0.2,717,23,52927,73.71448467966574,10
0.2,718,92,53019,73.73991655076495,9
0.2,719,93,53112,73.76666666666667,8
0.2,720,27,53139,73.70180305131761,6
0.2,721,96,53235,73.73268698060942,6
0.2,722,95,53330,73.76210235131397,6
0.2,723,24,53354,73.69337016574586,8
0.2,724,95,53449,73.72275862068966,7
0.2,725,94,53543,73.75068870523415,8
0.2,726,93,53636,73.77716643741402,8
0.2,727,22,53658,73.70604395604396,11
0.2,728,94,53752,73.73388203017832,8
0.2,729,95,53847,73.76301369863013,7
0.2,730,96,53943,73.79343365253078,6
0.2,731,90,54033,73.81557377049181,11
0.2,732,95,54128,73.84447476125511,6
0.2,733,92,54220,73.8692098092643,9
0.2,734,-44,54176,73.70884353741496,8
0.2,735,94,54270,73.73641304347827,8
0.2,736,90,54360,73.7584803256445,11
0.2,737,89,54449,73.77913279132791,12
0.2,738,18,54467,73.70365358592693,14
0.2,739,23,54490,73.63513513513513,9
0.2,740,93,54583,73.6612685560054,8
0.2,741,95,54678,73.6900269541779,6
0.2,742,91,54769,73.71332436069987,11
0.2,743,23,54792,73.64516129032258,9
0.2,744,94,54886,73.67248322147651,7
0.2,745,93,54979,73.69839142091153,9
0.2,746,94,55073,73.72556894243641,7
0.2,747,21,55094,73.65508021390374,12
0.2,748,85,55179,73.67022696929239,17
0.2,749,95,55274,73.69866666666667,6
0.2,750,92,55366,73.72303595206391,9
0.2,751,94,55460,73.75,7
0.2,752,92,55552,73.77423638778221,9
0.2,753,24,55576,73.70822281167109,8
0.2,754,79,55655,73.71523178807946,23
0.2,755,94,55749,73.7420634920635,8
0.2,756,92,55841,73.7661822985469,10
0.2,757,25,55866,73.7018469656992,8
0.2,758,87,55953,73.71936758893281,16
0.2,759,90,56043,73.74078947368422,12
0.2,760,25,56068,73.67674113009198,7
0.2,761,93,56161,73.7020997375328,8
0.2,762,86,56247,73.71821756225425,15
0.2,763,92,56339,73.74214659685863,10
0.2,764,94,56433,73.76862745098039,7
0.2,765,92,56525,73.79242819843343,10
0.2,766,94,56619,73.81877444589308,7
0.2,767,95,56714,73.84635416666667,6
0.2,768,95,56809,73.8738621586476,6
0.2,769,95,56904,73.9012987012987,6
0.2,770,92,56996,73.92477302204928,9
0.2,771,95,57091,73.95207253886011,6
0.2,772,24,57115,73.88745148771022,8
0.2,773,96,57211,73.91602067183463,6
0.2,774,92,57303,73.93935483870968,9
0.2,775,88,57391,73.95747422680412,13
0.2,776,94,57485,73.98326898326899,7
0.2,777,91,57576,74.0051413881748,12
0.2,778,92,57668,74.02824133504492,10
0.2,779,95,57763,74.0551282051282,6
0.2,780,22,57785,73.98847631241998,10
0.2,781,92,57877,74.01150895140665,9
0.2,782,90,57967,74.03192848020434,11
0.2,783,94,58061,74.05739795918367,8
0.2,784,21,58082,73.98980891719745,12
0.2,785,88,58170,74.00763358778626,14
0.2,786,89,58259,74.02668360864041,12
0.2,787,17,58276,73.95431472081218,15
0.2,788,95,58371,73.9809885931559,7
0.2,789,96,58467,74.00886075949367,6
0.2,790,26,58493,73.94816687737041,6
0.2,791,94,58587,73.97348484848484,7
0.2,792,95,58682,74.0,6
0.2,793,94,58776,74.02518891687657,8
0.2,794,92,58868,74.04779874213837,11
0.2,795,89,58957,74.06658291457286,13
0.2,796,96,59053,74.09410288582183,6
0.2,797,86,59139,74.10902255639098,15
0.2,798,94,59233,74.13391739674593,7
0.2,799,22,59255,74.06875,10
0.2,800,92,59347,74.09113607990012,10
0.2,801,86,59433,74.10598503740648,15
0.2,802,26,59459,74.04607721046077,7
0.2,803,93,59552,74.06965174129353,10
0.2,804,89,59641,74.08819875776398,12
0.2,805,-50,59591,73.93424317617865,14
0.2,806,94,59685,73.95910780669145,7
0.2,807,27,59712,73.9009900990099,6
0.2,808,95,59807,73.92707045735476,6
0.2,809,92,59899,73.94938271604939,9
0.2,810,94,59993,73.97410604192355,7
0.2,811,96,60089,74.0012315270936,6
0.2,812,95,60184,74.0270602706027,6
0.2,813,89,60273,74.04545454545455,12
0.2,814,92,60365,74.06748466257669,9
0.2,815,92,60457,74.08946078431373,11
0.2,816,95,60552,74.11505507955937,6
0.2,817,96,60648,74.14180929095355,6
0.2,818,26,60674,74.08302808302808,7
0.2,819,86,60760,74.09756097560975,16
0.2,820,92,60852,74.11936662606577,9
0.2,821,94,60946,74.14355231143553,7
0.2,822,94,61040,74.16767922235724,7
0.2,823,22,61062,74.10436893203884,10
0.2,824,92,61154,74.1260606060606,9
0.2,825,94,61248,74.1501210653753,8
0.2,826,94,61342,74.17412333736397,7
0.2,827,92,61434,74.19565217391305,9
0.2,828,26,61460,74.13751507840772,6
0.2,829,96,61556,74.16385542168675,6
0.2,830,22,61578,74.10108303249098,10
0.2,831,90,61668,74.1201923076923,11
0.2,832,90,61758,74.1392557022809,11
0.2,833,22,61780,74.07673860911271,10
0.2,834,88,61868,74.09341317365269,13
0.2,835,96,61964,74.11961722488039,6
0.2,836,95,62059,74.14456391875747,8
0.2,837,-45,62014,74.00238663484487,8
0.2,838,24,62038,73.94278903456495,8
0.2,839,89,62127,73.96071428571429,12
0.2,840,93,62220,73.9833531510107,8
0.2,841,89,62309,74.00118764845605,12
0.2,842,21,62330,73.93831553973902,12
0.2,843,23,62353,73.87796208530806,10
0.2,844,20,62373,73.81420118343195,12
0.2,845,94,62467,73.83806146572104,7
0.2,846,87,62554,73.85360094451003,16
0.2,847,23,62577,73.79363207547169,9
0.2,848,94,62671,73.81743227326267,9
0.2,849,23,62694,73.75764705882352,9
0.2,850,95,62789,73.78260869565217,6
0.2,851,91,62880,73.80281690140845,11
0.2,852,89,62969,73.82063305978897,12
0.2,853,96,63065,73.84660421545668,6
0.2,854,23,63088,73.78713450292398,10
0.2,855,95,63183,73.81191588785046,6
0.2,856,92,63275,73.83313885647608,11
0.2,857,89,63364,73.85081585081585,12
0.2,858,92,63456,73.87194412107101,9
0.2,859,93,63549,73.89418604651163,8
0.2,860,90,63639,73.91289198606272,11
0.2,861,24,63663,73.85498839907193,9
0.2,862,96,63759,73.88064889918887,6
0.2,863,95,63854,73.9050925925926,6
0.2,864,94,63948,73.92832369942197,7
0.2,865,91,64039,73.94803695150115,10
0.2,866,95,64134,73.97231833910034,6
0.2,867,95,64229,73.99654377880184,6
0.2,868,94,64323,74.01956271576525,7
0.2,869,93,64416,74.04137931034482,9
0.2,870,91,64507,74.06084959816303,10
0.2,871,95,64602,74.0848623853211,7
0.2,872,93,64695,74.106529209622,9
0.2,873,93,64788,74.12814645308924,8
0.2,874,96,64884,74.15314285714285,6
0.2,875,95,64979,74.1769406392694,6
0.2,876,96,65075,74.2018244013683,6
0.2,877,92,65167,74.22209567198178,9
0.2,878,20,65187,74.160409556314,13
0.2,879,92,65279,74.18068181818182,9
0.2,880,91,65370,74.19977298524404,10
0.2,881,20,65390,74.13832199546485,13
0.2,882,96,65486,74.16308040770102,6
0.2,883,94,65580,74.18552036199095,8
0.2,884,94,65674,74.20790960451977,7
0.2,885,17,65691,74.1433408577878,16
0.2,886,92,65783,74.16347237880495,10
0.2,887,90,65873,74.18130630630631,11
0.2,888,96,65969,74.20584926884139,6
0.2,889,95,66064,74.22921348314607,6
0.2,890,95,66159,74.25252525252525,6
0.2,891,92,66251,74.27242152466367,9
0.2,892,96,66347,74.29675251959686,6
0.2,893,95,66442,74.31991051454139,6
0.2,894,94,66536,74.34189944134079,7
0.2,895,92,66628,74.36160714285714,9
0.2,896,93,66721,74.38238573021182,8
0.2,897,93,66814,74.40311804008908,8
0.2,898,92,66906,74.42269187986652,9
0.2,899,94,67000,74.44444444444444,7
0.2,900,96,67096,74.46836847946726,6
0.2,901,90,67186,74.48558758314856,11
0.2,902,94,67280,74.50719822812846,8
0.2,903,92,67372,74.52654867256638,10
0.2,904,90,67462,74.54364640883978,11
0.2,905,25,67487,74.48896247240619,7
0.2,906,24,67511,74.43329658213892,8
0.2,907,95,67606,74.45594713656388,6
0.2,908,21,67627,74.3971397139714,11
0.2,909,25,67652,74.34285714285714,7
0.2,910,95,67747,74.36553238199781,6
0.2,911,91,67838,74.38377192982456,11
0.2,912,91,67929,74.40197152245345,11
0.2,913,94,68023,74.42341356673961,7
0.2,914,95,68118,74.44590163934426,6
0.2,915,24,68142,74.39082969432314,9
0.2,916,91,68233,74.40894220283533,10
0.2,917,91,68324,74.42701525054466,11
0.2,918,94,68418,74.44831338411316,7
0.2,919,91,68509,74.46630434782608,10
0.2,920,27,68536,74.41476655808903,6
0.2,921,95,68631,74.43709327548807,6
0.2,922,92,68723,74.45612134344529,10
0.2,923,-54,68669,74.31709956709956,17
0.2,924,94,68763,74.33837837837838,8
0.2,925,95,68858,74.36069114470843,6
0.2,926,18,68876,74.29989212513485,15
0.2,927,14,68890,74.23491379310344,18
0.2,928,96,68986,74.25834230355221,7
0.2,929,25,69011,74.20537634408602,8
0.2,930,25,69036,74.15252416756177,8
0.2,931,95,69131,74.17489270386267,7
0.2,932,95,69226,74.19721329046088,6
0.2,933,94,69320,74.21841541755889,7
0.2,934,18,69338,74.15828877005347,16
0.2,935,87,69425,74.17200854700855,14
0.2,936,92,69517,74.19103521878336,9
0.2,937,94,69611,74.21215351812367,8
0.2,938,93,69704,74.2321618743344,9
0.2,939,93,69797,74.25212765957447,8
0.2,940,25,69822,74.19978746014878,7
0.2,941,95,69917,74.22186836518047,7
0.2,942,19,69936,74.16330858960764,14
0.2,943,91,70027,74.18114406779661,10
0.2,944,93,70120,74.2010582010582,9
0.2,945,24,70144,74.14799154334038,8
0.2,946,91,70235,74.16578669482577,10
0.2,947,92,70327,74.18459915611814,9
0.2,948,96,70423,74.20758693361434,6
0.2,949,-124,70299,73.99894736842106,19
0.2,950,86,70385,74.01156677181913,16
0.2,951,92,70477,74.03046218487395,10
0.2,952,94,70571,74.0514165792235,7
0.2,953,95,70666,74.07337526205451,7
0.2,954,95,70761,74.09528795811518,6
0.2,955,94,70855,74.11610878661088,7
0.2,956,91,70946,74.1337513061651,10
0.2,957,93,71039,74.15344467640918,10
0.2,958,95,71134,74.17518248175182,8
0.2,959,-46,71088,74.05,10
0.2,960,-45,71043,73.9261186264308,9
0.2,961,22,71065,73.87214137214137,10
0.2,962,88,71153,73.88681204569055,13
0.2,963,92,71245,73.90560165975104,9
0.2,964,95,71340,73.92746113989638,7
0.2,965,88,71428,73.94202898550725,14
0.2,966,88,71516,73.95656670113753,13
0.2,967,94,71610,73.97727272727273,8
0.2,968,91,71701,73.99484004127967,10
0.2,969,94,71795,74.01546391752578,7
0.2,970,85,71880,74.02677651905252,16
0.2,971,90,71970,74.04320987654322,11
0.2,972,27,71997,73.99486125385405,6
0.2,973,91,72088,74.01232032854209,10
0.2,974,21,72109,73.95794871794872,11
0.2,975,85,72194,73.96926229508196,17
0.2,976,92,72286,73.98771750255885,9
0.2,977,93,72379,74.00715746421268,8
0.2,978,95,72474,74.02860061287028,6
0.2,979,93,72567,74.04795918367347,8
0.2,980,95,72662,74.06931702344546,6
0.2,981,95,72757,74.09063136456211,7
0.2,982,95,72852,74.1119023397762,6
0.2,983,94,72946,74.1321138211382,7
0.2,984,94,73040,74.15228426395939,8
0.2,985,93,73133,74.17139959432049,8
0.2,986,89,73222,74.18642350557244,12
0.2,987,94,73316,74.20647773279352,7
0.2,988,93,73409,74.22548028311425,8
0.2,989,90,73499,74.24141414141414,13
0.2,990,91,73590,74.25832492431887,11
0.2,991,93,73683,74.27721774193549,8
0.2,992,93,73776,74.29607250755286,9
0.2,993,94,73870,74.3158953722334,7
0.2,994,21,73891,74.26231155778895,12
0.2,995,21,73912,74.20883534136546,11
0.2,996,94,74006,74.22868605817452,8
0.2,997,22,74028,74.17635270541082,11
0.2,998,95,74123,74.1971971971972,6
0.2,999,26,74149,74.149,6
0.2,1000,91,74240,74.16583416583417,10
0.2,1001,93,74333,74.18463073852296,8
0.2,1002,23,74356,74.13359920239282,9
0.2,1003,92,74448,74.15139442231076,10
0.2,1004,27,74475,74.1044776119403,6
0.2,1005,94,74569,74.12425447316103,7
0.2,1006,95,74664,74.1449851042701,6
0.2,1007,92,74756,74.16269841269842,9
0.2,1008,92,74848,74.18037661050545,10
0.2,1009,92,74940,74.1980198019802,9
0.2,1010,95,75035,74.21859545004945,6
0.2,1011,93,75128,74.23715415019763,8
0.2,1012,94,75222,74.25666337611057,7
0.2,1013,93,75315,74.27514792899409,9
0.2,1014,24,75339,74.2256157635468,8
0.2,1015,17,75356,74.16929133858268,15
0.2,1016,91,75447,74.1858407079646,10
0.2,1017,96,75543,74.20726915520629,6
0.2,1018,26,75569,74.15996074582924,7
0.2,1019,17,75586,74.10392156862746,15
0.2,1020,92,75678,74.12144955925564,9
0.2,1021,92,75770,74.13894324853229,9
0.2,1022,93,75863,74.15738025415445,8
0.2,1023,25,75888,74.109375,8
0.2,1024,90,75978,74.12487804878049,11
0.2,1025,21,75999,74.07309941520468,12
0.2,1026,93,76092,74.09152872444011,8
0.2,1027,89,76181,74.10603112840467,12
0.2,1028,96,76277,74.12730806608357,6
0.2,1029,94,76371,74.14660194174758,7
0.2,1030,24,76395,74.09796314258001,8
0.2,1031,93,76488,74.11627906976744,8
0.2,1032,91,76579,74.1326234269119,12
0.2,1033,93,76672,74.15087040618955,8
0.2,1034,95,76767,74.17101449275363,7
0.2,1035,26,76793,74.12451737451738,6
0.2,1036,94,76887,74.14368370298939,9
0.2,1037,93,76980,74.16184971098266,9
0.2,1038,89,77069,74.17613089509143,12
0.2,1039,21,77090,74.125,11
0.2,1040,88,77178,74.13832853025937,13
0.2,1041,96,77274,74.15930902111324,7
0.2,1042,95,77369,74.17929050814956,6
0.2,1043,96,77465,74.20019157088123,6
0.2,1044,92,77557,74.21722488038277,9
0.2,1045,92,77649,74.23422562141491,9
0.2,1046,91,77740,74.2502387774594,10
0.2,1047,94,77834,74.26908396946565,8
0.2,1048,23,77857,74.22020972354623,10
0.2,1049,92,77949,74.23714285714286,9
0.2,1050,95,78044,74.25689819219791,6
0.2,1051,26,78070,74.21102661596959,8
0.2,1052,93,78163,74.22886989553656,8
0.2,1053,94,78257,74.24762808349146,7
0.2,1054,93,78350,74.26540284360189,8
0.2,1055,95,78445,74.28503787878788,7
0.2,1056,93,78538,74.3027436140019,8
0.2,1057,92,78630,74.3194706994329,9
0.2,1058,92,78722,74.33616619452313,9
0.2,1059,23,78745,74.2877358490566,9
0.2,1060,90,78835,74.30254476908577,11
0.2,1061,95,78930,74.32203389830508,6
0.2,1062,94,79024,74.34054562558796,8
0.2,1063,91,79115,74.3562030075188,11
0.2,1064,92,79207,74.37276995305164,9
0.2,1065,94,79301,74.39118198874296,7
0.2,1066,27,79328,74.34676663542643,6
0.2,1067,86,79414,74.35767790262172,17
0.2,1068,93,79507,74.37511693171189,10
0.2,1069,95,79602,74.39439252336449,6
0.2,1070,95,79697,74.41363211951447,6
0.2,1071,92,79789,74.43003731343283,9
0.2,1072,96,79885,74.45013979496738,7
0.2,1073,93,79978,74.46741154562383,8
0.2,1074,92,80070,74.48372093023256,10
0.2,1075,27,80097,74.43959107806691,6
0.2,1076,89,80186,74.45311049210771,12
0.2,1077,91,80277,74.46846011131726,10
0.2,1078,22,80299,74.41983317886933,10
0.2,1079,87,80386,74.43148148148148,15
0.2,1080,95,80481,74.45050878815911,6
0.2,1081,91,80572,74.46580406654344,10
0.2,1082,90,80662,74.48014773776546,11
0.2,1083,92,80754,74.49630996309963,9
0.2,1084,94,80848,74.51428571428572,7
0.2,1085,90,80938,74.52854511970534,11
0.2,1086,94,81032,74.54645814167434,7
0.2,1087,89,81121,74.55974264705883,13
0.2,1088,96,81217,74.57943067033976,6
0.2,1089,93,81310,74.59633027522936,8
0.2,1090,89,81399,74.6095325389551,14
0.2,1091,92,81491,74.62545787545787,10
0.2,1092,91,81582,74.64043915827996,10
0.2,1093,93,81675,74.65722120658135,8
0.2,1094,94,81769,74.67488584474886,7
0.2,1095,94,81863,74.69251824817518,7
0.2,1096,91,81954,74.7073837739289,11
0.2,1097,95,82049,74.72586520947176,6
0.2,1098,93,82142,74.7424931756142,8
0.2,1099,92,82234,74.75818181818182,10
0.2,1100,18,82252,74.70663033605813,16
0.2,1101,92,82344,74.72232304900182,10
0.2,1102,95,82439,74.74070716228468,7
0.2,1103,86,82525,74.75090579710145,15
0.2,1104,92,82617,74.76651583710407,9
0.2,1105,24,82641,74.72061482820976,8
0.2,1106,94,82735,74.73803071364047,8
0.2,1107,-54,82681,74.62184115523466,18
0.2,1108,93,82774,74.63841298467088,8
0.2,1109,94,82868,74.65585585585586,7
0.2,1110,23,82891,74.60936093609361,11
0.2,1111,20,82911,74.56025179856115,14
0.2,1112,23,82934,74.51392632524708,9
0.2,1113,93,83027,74.53052064631957,8
0.2,1114,23,83050,74.48430493273543,10
0.2,1115,95,83145,74.50268817204301,6
0.2,1116,94,83239,74.52014324082363,7
0.2,1117,94,83333,74.53756708407872,7
0.2,1118,91,83424,74.55227882037534,11
0.2,1119,90,83514,74.56607142857143,11
0.2,1120,-61,83453,74.44513826940232,24
0.2,1121,95,83548,74.46345811051694,7
0.2,1122,21,83569,74.41585040071237,11
0.2,1123,90,83659,74.4297153024911,11
0.2,1124,90,83749,74.44355555555556,12
0.2,1125,92,83841,74.45914742451154,9
0.2,1126,18,83859,74.40905057675243,16
0.2,1127,90,83949,74.42287234042553,11
0.2,1128,91,84040,74.43755535872454,10
0.2,1129,95,84135,74.45575221238938,7
0.2,1130,90,84225,74.46949602122015,14
0.2,1131,93,84318,74.48586572438163,9
0.2,1132,94,84412,74.50308914386584,8
0.2,1133,90,84502,74.51675485008818,11
0.2,1134,96,84598,74.53568281938325,6
0.2,1135,90,84688,74.54929577464789,11
0.2,1136,88,84776,74.56112576956905,13
0.2,1137,-52,84724,74.44991212653778,15
0.2,1138,95,84819,74.46795434591748,6
0.2,1139,94,84913,74.48508771929825,7
0.2,1140,94,85007,74.50219106047327,7
0.2,1141,25,85032,74.45884413309983,7
0.2,1142,95,85127,74.47681539807525,6
0.2,1143,21,85148,74.43006993006993,11
0.2,1144,93,85241,74.44628820960699,8
0.2,1145,96,85337,74.46509598603839,7
0.2,1146,96,85433,74.48387096774194,6
0.2,1147,90,85523,74.49738675958189,11
0.2,1148,90,85613,74.51087902523933,11
0.2,1149,27,85640,74.4695652173913,6
0.2,1150,90,85730,74.48305821025195,12
0.2,1151,24,85754,74.43923611111111,8
0.2,1152,96,85850,74.45793581960105,6
0.2,1153,96,85946,74.47660311958406,6
0.2,1154,-53,85893,74.36623376623376,16
0.2,1155,94,85987,74.38321799307958,8
0.2,1156,22,86009,74.33794295592048,10
0.2,1157,24,86033,74.29447322970638,8
0.2,1158,15,86048,74.24331320103538,17
0.2,1159,94,86142,74.26034482758621,7
0.2,1160,94,86236,74.27734711455642,8
0.2,1161,22,86258,74.23235800344234,10
0.2,1162,88,86346,74.24419604471196,14
0.2,1163,96,86442,74.26288659793815,6
0.2,1164,96,86538,74.28154506437768,7
0.2,1165,93,86631,74.29759862778731,8
0.2,1166,95,86726,74.31533847472151,6
0.2,1167,95,86821,74.33304794520548,6
0.2,1168,94,86915,74.34987168520102,7
0.2,1169,91,87006,74.36410256410257,10
0.2,1170,94,87100,74.38087105038429,7
0.2,1171,90,87190,74.39419795221843,12
0.2,1172,95,87285,74.41176470588235,6
0.2,1173,90,87375,74.42504258943782,11
0.2,1174,94,87469,74.44170212765957,7
0.2,1175,88,87557,74.453231292517,13
0.2,1176,96,87653,74.47153780798641,6
0.2,1177,96,87749,74.48981324278438,6
0.2,1178,90,87839,74.50296861747243,12
0.2,1179,92,87931,74.5177966101695,10
0.2,1180,93,88024,74.53344623200677,8
0.2,1181,88,88112,74.54483925549916,13
0.2,1182,94,88206,74.56128486897718,7
0.2,1183,95,88301,74.57854729729729,6
0.2,1184,26,88327,74.53755274261603,9
0.2,1185,96,88423,74.55564924114671,6
0.2,1186,91,88514,74.56950294860994,10
0.2,1187,-51,88463,74.46380471380472,14
0.2,1188,27,88490,74.42388561816652,6
0.2,1189,22,88512,74.37983193277311,10
0.2,1190,86,88598,74.38958858102436,15
0.2,1191,95,88693,74.40687919463087,7
0.2,1192,91,88784,74.42078792958927,10
0.2,1193,95,88879,74.43802345058627,6
0.2,1194,96,88975,74.4560669456067,6
0.2,1195,93,89068,74.47157190635451,8
0.2,1196,23,89091,74.42857142857143,11
0.2,1197,95,89186,74.4457429048414,6
0.2,1198,93,89279,74.46121768140117,9
0.2,1199,94,89373,74.4775,7
0.2,1200,27,89400,74.43796835970025,6
0.2,1201,-53,89347,74.33194675540766,17
0.2,1202,20,89367,74.28678304239402,13
0.2,1203,89,89456,74.29900332225914,12
0.2,1204,91,89547,74.31286307053942,10
0.2,1205,19,89566,74.26699834162521,13
0.2,1206,93,89659,74.28251864125932,9
0.2,1207,93,89752,74.29801324503312,8
0.2,1208,24,89776,74.25641025641026,8
0.2,1209,96,89872,74.27438016528926,6
0.2,1210,95,89967,74.29149463253509,6
0.2,1211,93,90060,74.3069306930693,8
0.2,1212,93,90153,74.32234130255564,9
0.2,1213,88,90241,74.333607907743,13
0.2,1214,94,90335,74.34979423868313,7
0.2,1215,23,90358,74.30756578947368,9
0.2,1216,90,90448,74.32046014790468,12
0.2,1217,92,90540,74.33497536945812,9
0.2,1218,93,90633,74.35028712059065,8
0.2,1219,23,90656,74.30819672131148,9
0.2,1220,95,90751,74.32514332514333,6
0.2,1221,25,90776,74.2847790507365,7
0.2,1222,94,90870,74.30089942763696,8
0.2,1223,94,90964,74.31699346405229,7
0.2,1224,95,91059,74.33387755102041,6
0.2,1225,94,91153,74.34991843393148,7
0.2,1226,91,91244,74.36348818255908,11
0.2,1227,89,91333,74.37540716612378,12
0.2,1228,-53,91280,74.27176566314077,16
0.2,1229,88,91368,74.28292682926829,13
0.2,1230,95,91463,74.29975629569456,6
0.2,1231,94,91557,74.31574675324676,7
0.2,1232,92,91649,74.3300892133009,9
0.2,1233,93,91742,74.3452188006483,10
0.2,1234,94,91836,74.36113360323887,8
0.2,1235,27,91863,74.32281553398059,6
0.2,1236,81,91944,74.32821341956345,21
0.2,1237,95,92039,74.3449111470113,7
0.2,1238,94,92133,74.36077481840194,7
0.2,1239,93,92226,74.3758064516129,8
0.2,1240,93,92319,74.3908138597905,9
0.2,1241,90,92409,74.40338164251207,11
0.2,1242,24,92433,74.36283185840708,8
0.2,1243,96,92529,74.38022508038586,6
0.2,1244,93,92622,74.39518072289157,8
0.2,1245,90,92712,74.40770465489567,11
0.2,1246,24,92736,74.3672814755413,8
0.2,1247,95,92831,74.3838141025641,6
0.2,1248,92,92923,74.39791833466774,9
0.2,1249,21,92944,74.3552,12
0.2,1250,94,93038,74.37090327737809,7
0.2,1251,23,93061,74.32987220447285,9
0.2,1252,86,93147,74.3391859537111,15
0.2,1253,94,93241,74.3548644338118,7
0.2,1254,21,93262,74.31235059760957,11
0.2,1255,25,93287,74.27308917197452,9
0.2,1256,96,93383,74.2903739061257,6
0.2,1257,95,93478,74.30683624801271,6
0.2,1258,94,93572,74.32247815726767,7
0.2,1259,96,93668,74.33968253968254,6
0.2,1260,83,93751,74.34655035685964,18
0.2,1261,95,93846,74.36291600633915,6
0.2,1262,94,93940,74.3784639746635,8
0.2,1263,93,94033,74.39319620253164,9
0.2,1264,23,94056,74.35256916996047,9
0.2,1265,94,94150,74.36808846761454,7
0.2,1266,94,94244,74.38358326756116,8
0.2,1267,89,94333,74.39511041009463,12
0.2,1268,95,94428,74.41134751773049,8
0.2,1269,93,94521,74.4259842519685,8
0.2,1270,-45,94476,74.33202202989771,8
0.2,1271,92,94568,74.34591194968553,9
0.2,1272,93,94661,74.3605655930872,8
0.2,1273,88,94749,74.3712715855573,14
0.2,1274,93,94842,74.38588235294118,8
0.2,1275,21,94863,74.34404388714734,11
0.2,1276,24,94887,74.3046202036022,8
0.2,1277,95,94982,74.32081377151799,6
0.2,1278,93,95075,74.33541829554339,8
0.2,1279,92,95167,74.34921875,9
0.2,1280,95,95262,74.36533957845434,8
0.2,1281,91,95353,74.37831513260531,11
0.2,1282,95,95448,74.39438815276695,7
0.2,1283,94,95542,74.40965732087227,9
0.2,1284,95,95637,74.42568093385214,7
0.2,1285,23,95660,74.38569206842924,9
0.2,1286,91,95751,74.3986013986014,11
0.2,1287,94,95845,74.4138198757764,7
0.2,1288,90,95935,74.42591155934834,11
0.2,1289,95,96030,74.44186046511628,7
0.2,1290,95,96125,74.4577846630519,7
0.2,1291,94,96219,74.47291021671826,7
0.2,1292,23,96242,74.43310131477185,10
0.2,1293,94,96336,74.44822256568779,7
0.2,1294,93,96429,74.46254826254827,8
0.2,1295,92,96521,74.47608024691358,9
0.2,1296,94,96615,74.491133384734,7
0.2,1297,92,96707,74.50462249614792,10
0.2,1298,93,96800,74.51886066204773,9
0.2,1299,95,96895,74.53461538461538,6
0.2,1300,95,96990,74.55034588777863,6
0.2,1301,93,97083,74.56451612903226,9
0.2,1302,91,97174,74.57712970069072,11
0.2,1303,90,97264,74.58895705521472,11
0.2,1304,96,97360,74.60536398467433,6
0.2,1305,94,97454,74.62021439509954,7
0.2,1306,96,97550,74.63657230298394,6
0.2,1307,94,97644,74.65137614678899,11
0.2,1308,96,97740,74.66768525592055,6
0.2,1309,25,97765,74.62977099236642,8
0.2,1310,93,97858,74.64378337147215,8
0.2,1311,93,97951,74.6577743902439,8
0.2,1312,18,97969,74.61462300076161,16
0.2,1313,14,97983,74.56849315068493,19
0.2,1314,91,98074,74.5809885931559,10
0.2,1315,93,98167,74.59498480243161,8
0.2,1316,95,98262,74.61047835990888,8
0.2,1317,25,98287,74.57283763277694,7
0.2,1318,92,98379,74.58605003790751,9
0.2,1319,96,98475,74.60227272727273,6
0.2,1320,25,98500,74.56472369417108,8
0.2,1321,94,98594,74.57942511346445,7
0.2,1322,92,98686,74.5925925925926,9
0.2,1323,84,98770,74.59969788519638,17
0.2,1324,90,98860,74.61132075471698,12
0.2,1325,26,98886,74.57466063348416,6
0.2,1326,87,98973,74.58402411454408,14
0.2,1327,94,99067,74.59864457831326,7
0.2,1328,94,99161,74.6132430398796,7
0.2,1329,94,99255,74.62781954887218,8
0.2,1330,91,99346,74.64012021036814,10
0.2,1331,94,99440,74.65465465465465,8
0.2,1332,-46,99394,74.56414103525881,10
0.2,1333,95,99489,74.57946026986507,6
0.2,1334,96,99585,74.59550561797752,6
0.2,1335,26,99611,74.55913173652695,6
0.2,1336,95,99706,74.57442034405385,7
0.2,1337,23,99729,74.53587443946188,9
0.2,1338,93,99822,74.54966392830471,8
0.2,1339,95,99917,74.56492537313433,6
0.2,1340,19,99936,74.52348993288591,14
0.2,1341,93,100029,74.53725782414307,8
0.2,1342,91,100120,74.54951600893521,10
0.2,1343,95,100215,74.56473214285714,6
0.2,1344,94,100309,74.57918215613383,7
0.2,1345,92,100401,74.5921248142645,9
0.2,1346,92,100493,74.60504825538233,9
0.2,1347,92,100585,74.6179525222552,9
0.2,1348,92,100677,74.6308376575241,9
0.2,1349,22,100699,74.59185185185186,12
0.2,1350,92,100791,74.60473723168023,11
0.2,1351,21,100812,74.56508875739645,11
0.2,1352,95,100907,74.58019216555802,6
0.2,1353,-46,100861,74.49113737075332,10
0.2,1354,91,100952,74.50332103321033,10
0.2,1355,96,101048,74.51917404129793,6
0.2,1356,90,101138,74.53058216654385,12
0.2,1357,90,101228,74.5419734904271,12
0.2,1358,91,101319,74.5540838852097,10
0.2,1359,22,101341,74.51544117647059,11
0.2,1360,91,101432,74.52755326965466,10
0.2,1361,94,101526,74.54185022026432,7
0.2,1362,91,101617,74.55392516507703,10
0.2,1363,90,101707,74.56524926686217,11
0.2,1364,96,101803,74.58095238095238,6
0.2,1365,94,101897,74.59516837481698,8
0.2,1366,94,101991,74.609363569861,7
0.2,1367,94,102085,74.62353801169591,8
0.2,1368,91,102176,74.6355003652301,10
0.2,1369,85,102261,74.64306569343066,17
0.2,1370,22,102283,74.60466812545587,10
0.2,1371,96,102379,74.62026239067055,6
0.2,1372,95,102474,74.63510560815732,6
0.2,1373,94,102568,74.64919941775837,7
0.2,1374,94,102662,74.66327272727273,7
0.2,1375,93,102755,74.6765988372093,11
0.2,1376,22,102777,74.63834422657952,11
0.2,1377,90,102867,74.64949201741655,12
0.2,1378,92,102959,74.6620739666425,9
0.2,1379,92,103051,74.67463768115942,10
0.2,1380,90,103141,74.68573497465604,13
0.2,1381,95,103236,74.70043415340086,6
0.2,1382,26,103262,74.66522053506868,6
0.2,1383,92,103354,74.67774566473989,9
0.2,1384,93,103447,74.69097472924187,9
0.2,1385,87,103534,74.6998556998557,14
0.2,1386,96,103630,74.71521268925738,7
0.2,1387,94,103724,74.72910662824208,7
0.2,1388,23,103747,74.69186465082794,10
0.2,1389,19,103766,74.65179856115108,13
0.2,1390,94,103860,74.66570812365205,7
0.2,1391,25,103885,74.63002873563218,8
0.2,1392,94,103979,74.64393395549175,7
0.2,1393,27,104006,74.60975609756098,6
0.2,1394,93,104099,74.62293906810037,8
0.2,1395,94,104193,74.63681948424069,7
0.2,1396,24,104217,74.60057265569077,8
0.2,1397,91,104308,74.61230329041487,14
0.2,1398,96,104404,74.62759113652609,6
0.2,1399,94,104498,74.64142857142858,7
0.2,1400,92,104590,74.65381870092791,9
0.2,1401,95,104685,74.66833095577746,6
0.2,1402,25,104710,74.63292943692089,8
0.2,1403,94,104804,74.64672364672364,8
0.2,1404,88,104892,74.65622775800712,14
0.2,1405,92,104984,74.66856330014225,9
0.2,1406,23,105007,74.6318407960199,9
0.2,1407,88,105095,74.64133522727273,13
0.2,1408,93,105188,74.65436479772889,8
0.2,1409,92,105280,74.66666666666667,10
0.2,1410,19,105299,74.62721474131821,13
0.2,1411,17,105316,74.58640226628896,15
0.2,1412,95,105411,74.60084925690022,6
0.2,1413,96,105507,74.61598302687412,6
0.2,1414,92,105599,74.62826855123674,9
0.2,1415,94,105693,74.64194915254237,8
0.2,1416,23,105716,74.60550458715596,10
0.2,1417,94,105810,74.61918194640339,7
0.2,1418,91,105901,74.630725863284,10
0.2,1419,93,105994,74.64366197183098,8
0.2,1420,95,106089,74.65798733286418,6
0.2,1421,93,106182,74.67088607594937,8
0.2,1422,90,106272,74.6816584680253,11
0.2,1423,-48,106224,74.59550561797752,13
0.2,1424,92,106316,74.60771929824561,9
0.2,1425,92,106408,74.61991584852736,10
0.2,1426,26,106434,74.58584442887175,7
0.2,1427,19,106453,74.54691876750701,13
0.2,1428,12,106465,74.50314905528342,20
0.2,1429,89,106554,74.51328671328672,12
0.2,1430,95,106649,74.52760307477288,6
0.2,1431,24,106673,74.49231843575419,9
0.2,1432,95,106768,74.506629448709,6
0.2,1433,94,106862,74.52022315202231,7
0.2,1434,89,106951,74.53031358885018,12
0.2,1435,94,107045,74.54387186629526,7
0.2,1436,94,107139,74.55741127348644,8
0.2,1437,94,107233,74.57093184979138,8
0.2,1438,95,107328,74.58512856150104,8
0.2,1439,93,107421,74.59791666666666,9
0.2,1440,92,107513,74.60999306037473,9
0.2,1441,94,107607,74.62343966712899,7
0.2,1442,94,107701,74.63686763686763,7
0.2,1443,93,107794,74.64958448753463,8
0.2,1444,87,107881,74.65813148788928,14
0.2,1445,95,107976,74.67219917012449,8
0.2,1446,92,108068,74.68417415342087,9
0.2,1447,20,108088,74.646408839779,12
0.2,1448,94,108182,74.65976535541753,7
0.2,1449,92,108274,74.67172413793104,9
0.2,1450,93,108367,74.68435561681599,9
0.2,1451,90,108457,74.69490358126721,11
0.2,1452,94,108551,74.70818995182381,8
0.2,1453,94,108645,74.72145804676754,7
0.2,1454,92,108737,74.73333333333333,9
0.2,1455,91,108828,74.74450549450549,10
0.2,1456,19,108847,74.70624571036376,13
0.2,1457,95,108942,74.7201646090535,6
0.2,1458,93,109035,74.73269362577108,8
0.2,1459,21,109056,74.69589041095891,11
0.2,1460,25,109081,74.66187542778918,9
0.2,1461,93,109174,74.67441860465117,8
0.2,1462,27,109201,74.64183185235817,6
0.2,1463,95,109296,74.65573770491804,7
0.2,1464,90,109386,74.66621160409557,12
0.2,1465,20,109406,74.62892223738062,12
0.2,1466,16,109422,74.58895705521472,16
0.2,1467,95,109517,74.60286103542235,6
0.2,1468,25,109542,74.56909462219197,8
0.2,1469,91,109633,74.58027210884353,11
0.2,1470,93,109726,74.59279401767505,8
0.2,1471,93,109819,74.60529891304348,9
0.2,1472,92,109911,74.61710794297352,9
0.2,1473,94,110005,74.63025780189959,7
0.2,1474,93,110098,74.64271186440678,8
0.2,1475,96,110194,74.65718157181571,6
0.2,1476,90,110284,74.66756939742721,11
0.2,1477,94,110378,74.68064952638701,7
0.2,1478,92,110470,74.69235970250169,9
0.2,1479,-46,110424,74.6108108108108,10
0.2,1480,96,110520,74.62525320729237,6
0.2,1481,92,110612,74.63697705802969,9
0.2,1482,92,110704,74.64868509777479,9
0.2,1483,94,110798,74.66172506738545,7
0.2,1484,90,110888,74.67205387205387,11
0.2,1485,94,110982,74.6850605652759,7
0.2,1486,21,111003,74.64895763281775,12
0.2,1487,93,111096,74.66129032258064,8
0.2,1488,94,111190,74.67427803895232,7
0.2,1489,87,111277,74.68255033557047,16
0.2,1490,93,111370,74.69483568075117,9
0.2,1491,95,111465,74.70844504021447,7
0.2,1492,-51,111414,74.62424648359008,15
0.2,1493,90,111504,74.63453815261045,11
0.2,1494,20,111524,74.59799331103679,12
0.2,1495,95,111619,74.61163101604278,7
0.2,1496,94,111713,74.62458249833,7
0.2,1497,87,111800,74.6328437917223,15
0.2,1498,93,111893,74.6450967311541,9
0.2,1499,96,111989,74.65933333333334,6
0.2,1500,90,112079,74.66955363091273,11
0.2,1501,23,112102,74.63515312916113,9
0.2,1502,93,112195,74.64737192282102,8
0.2,1503,91,112286,74.65824468085107,10
0.2,1504,20,112306,74.62192691029901,12
0.2,1505,96,112402,74.63612217795485,6
0.2,1506,94,112496,74.64897146648971,7
0.2,1507,94,112590,74.66180371352785,8
0.2,1508,94,112684,74.67461895294898,7
0.2,1509,90,112774,74.68476821192053,11
0.2,1510,92,112866,74.69622766379881,9
0.2,1511,93,112959,74.70833333333333,8
0.2,1512,93,113052,74.72042300066094,8
0.2,1513,-48,113004,74.63936591809775,11
0.2,1514,90,113094,74.64950495049504,11
0.2,1515,96,113190,74.66358839050132,6
0.2,1516,93,113283,74.67567567567568,9
0.2,1517,95,113378,74.68906455862978,7
0.2,1518,27,113405,74.65766951942066,6
0.2,1519,95,113500,74.67105263157895,6
0.2,1520,90,113590,74.68113083497698,11
0.2,1521,91,113681,74.69185282522996,10
0.2,1522,93,113774,74.70387393302693,8
0.2,1523,91,113865,74.71456692913385,10
0.2,1524,92,113957,74.72590163934426,9
0.2,1525,90,114047,74.73591087811272,11
0.2,1526,91,114138,74.74656188605108,13
0.2,1527,93,114231,74.75850785340315,9
0.2,1528,88,114319,74.76716808371485,17
0.2,1529,94,114413,74.77973856209151,7
0.2,1530,94,114507,74.79229261920314,7
0.2,1531,94,114601,74.80483028720627,7
0.2,1532,95,114696,74.81800391389433,6
0.2,1533,92,114788,74.82920469361147,10
0.2,1534,90,114878,74.83908794788273,11
0.2,1535,92,114970,74.85026041666667,9
0.2,1536,95,115065,74.86337020169161,6
0.2,1537,91,115156,74.8738621586476,11
0.2,1538,92,115248,74.8849902534113,9
0.2,1539,95,115343,74.89805194805194,6
0.2,1540,94,115437,74.91044776119404,8
0.2,1541,94,115531,74.92282749675746,7
0.2,1542,92,115623,74.93389500972133,9
0.2,1543,94,115717,74.94624352331606,7
0.2,1544,93,115810,74.957928802589,8
0.2,1545,88,115898,74.96636481241914,13
0.2,1546,91,115989,74.97672915319974,10
0.2,1547,92,116081,74.98772609819122,9
0.2,1548,27,116108,74.9567462879277,6
0.2,1549,20,116128,74.92129032258065,12
0.2,1550,-58,116070,74.83558994197293,23
0.2,1551,90,116160,74.84536082474227,11
0.2,1552,95,116255,74.85833869929169,6
0.2,1553,94,116349,74.87065637065638,7
0.2,1554,94,116443,74.8829581993569,7
0.2,1555,21,116464,74.84832904884318,11
0.2,1556,21,116485,74.81374438021837,11
0.2,1557,92,116577,74.82477535301669,9
0.2,1558,95,116672,74.83771648492623,6
0.2,1559,21,116693,74.80320512820512,11
0.2,1560,95,116788,74.81614349775785,7
0.2,1561,90,116878,74.8258642765685,11
0.2,1562,94,116972,74.8381317978247,8
0.2,1563,91,117063,74.84846547314578,10
0.2,1564,23,117086,74.81533546325879,9
0.2,1565,96,117182,74.82886334610473,6
0.2,1566,25,117207,74.79706445437141,8
0.2,1567,24,117231,74.76466836734694,8
0.2,1568,91,117322,74.77501593371574,10
0.2,1569,93,117415,74.78662420382166,9
0.2,1570,21,117436,74.75238701464036,11
0.2,1571,94,117530,74.764631043257,7
0.2,1572,93,117623,74.77622377622377,8
0.2,1573,96,117719,74.78970775095299,6
0.2,1574,91,117810,74.8,10
0.2,1575,94,117904,74.81218274111676,7
0.2,1576,94,117998,74.82435003170578,7
0.2,1577,96,118094,74.83776932826362,6
0.2,1578,90,118184,74.84737175427486,11
0.2,1579,89,118273,74.85632911392405,12
0.2,1580,94,118367,74.86843769765972,7
0.2,1581,94,118461,74.88053097345133,7
0.2,1582,91,118552,74.89071383449148,10
0.2,1583,95,118647,74.9034090909091,7
0.2,1584,24,118671,74.87129337539432,8
0.2,1585,93,118764,74.88272383354351,8
0.2,1586,93,118857,74.89413988657844,8
0.2,1587,-136,118721,74.76133501259446,30
0.2,1588,92,118813,74.77218376337319,9
0.2,1589,94,118907,74.78427672955975,7
0.2,1590,88,118995,74.79258328095537,13
0.2,1591,94,119089,74.80464824120602,7
0.2,1592,92,119181,74.81544256120527,9
0.2,1593,96,119277,74.82873274780427,6
0.2,1594,95,119372,74.84137931034483,6
0.2,1595,-53,119319,74.76127819548873,16
0.2,1596,92,119411,74.77207263619286,9
0.2,1597,93,119504,74.78347934918648,8
0.2,1598,95,119599,74.79612257661039,8
0.2,1599,21,119620,74.7625,11
0.2,1600,94,119714,74.77451592754528,8
0.2,1601,88,119802,74.78277153558052,13
0.2,1602,92,119894,74.79351216469121,10
0.2,1603,91,119985,74.80361596009975,10
0.2,1604,-57,119928,74.7214953271028,20
0.2,1605,92,120020,74.73225404732254,10
0.2,1606,92,120112,74.74299937772247,9
0.2,1607,94,120206,74.7549751243781,7
0.2,1608,95,120301,74.76755748912367,6
0.2,1609,18,120319,74.73229813664597,15
0.2,1610,19,120338,74.69770328988206,14
0.2,1611,96,120434,74.71091811414392,6
0.2,1612,91,120525,74.72101673899566,10
0.2,1613,95,120620,74.73358116480793,6
0.2,1614,94,120714,74.74551083591331,9
0.2,1615,-46,120668,74.67079207920793,10
0.2,1616,91,120759,74.6808905380334,10
0.2,1617,93,120852,74.69221260815821,8
0.2,1618,94,120946,74.7041383570105,7
0.2,1619,20,120966,74.67037037037036,12
0.2,1620,92,121058,74.68106107341147,9
0.2,1621,95,121153,74.69358816276203,6
0.2,1622,92,121245,74.70425138632163,9
0.2,1623,93,121338,74.71551724137932,8
0.2,1624,95,121433,74.728,6
0.2,1625,94,121527,74.73985239852398,7
0.2,1626,95,121622,74.75230485556239,6
0.2,1627,94,121716,74.76412776412776,7
0.2,1628,86,121802,74.77102516881523,16
0.2,1629,95,121897,74.78343558282208,6
0.2,1630,92,121989,74.79399141630901,9
0.2,1631,91,122080,74.80392156862744,10
0.2,1632,95,122175,74.8162890385793,6
0.2,1633,21,122196,74.78335373317013,11
0.2,1634,93,122289,74.79449541284404,10
0.2,1635,96,122385,74.80745721271394,6
0.2,1636,94,122479,74.8191814294441,7
0.2,1637,96,122575,74.83211233211233,6
0.2,1638,92,122667,74.84258694325808,10
0.2,1639,90,122757,74.85182926829269,12
0.2,1640,23,122780,74.82023156611822,9
0.2,1641,95,122875,74.83252131546894,6
0.2,1642,95,122970,74.84479610468655,6
0.2,1643,91,123061,74.85462287104623,10
0.2,1644,96,123157,74.86747720364741,6
0.2,1645,91,123248,74.87727825030376,10
0.2,1646,94,123342,74.88888888888889,7
0.2,1647,91,123433,74.89866504854369,10
0.2,1648,95,123528,74.91085506367496,6
0.2,1649,94,123622,74.92242424242424,8
0.2,1650,91,123713,74.93216232586312,10
0.2,1651,96,123809,74.94491525423729,6
0.2,1652,95,123904,74.95704779189353,7
0.2,1653,20,123924,74.92382103990326,12
0.2,1654,90,124014,74.93293051359517,11
0.2,1655,20,124034,74.89975845410628,13
0.2,1656,91,124125,74.90947495473748,10
0.2,1657,94,124219,74.92098914354644,8
0.2,1658,95,124314,74.93309222423146,6
0.2,1659,94,124408,74.94457831325302,7
0.2,1660,-55,124353,74.86634557495485,22
0.2,1661,21,124374,74.83393501805054,12
0.2,1662,91,124465,74.84365604329525,11
0.2,1663,93,124558,74.8545673076923,8
0.2,1664,95,124653,74.86666666666666,7
0.2,1665,94,124747,74.8781512605042,7
0.2,1666,88,124835,74.88602279544091,13
0.2,1667,94,124929,74.89748201438849,7
0.2,1668,90,125019,74.90653085680047,11
0.2,1669,89,125108,74.91497005988023,12
0.2,1670,86,125194,74.92160383004189,15
0.2,1671,92,125286,74.93181818181819,10
0.2,1672,89,125375,74.94022713687986,12
0.2,1673,26,125401,74.91099163679809,7
0.2,1674,94,125495,74.92238805970149,7
0.2,1675,95,125590,74.93436754176611,6
0.2,1676,93,125683,74.94514013118665,8
0.2,1677,90,125773,74.95411203814065,11
0.2,1678,92,125865,74.96426444312091,9
0.2,1679,93,125958,74.975,8
0.2,1680,95,126053,74.98691255205235,6
0.2,1681,17,126070,74.95243757431629,15
0.2,1682,91,126161,74.96197266785502,10
0.2,1683,89,126250,74.97030878859857,12
0.2,1684,-46,126204,74.89851632047478,10
0.2,1685,96,126300,74.91103202846975,6
0.2,1686,94,126394,74.92234736218138,8
0.2,1687,94,126488,74.93364928909952,8
0.2,1688,90,126578,74.9425695677916,11
0.2,1689,94,126672,74.95384615384616,7
0.2,1690,89,126761,74.96215257244233,12
0.2,1691,91,126852,74.97163120567376,10
0.2,1692,89,126941,74.9799173065564,12
0.2,1693,95,127036,74.99173553719008,6
0.2,1694,94,127130,75.00294985250737,7
0.2,1695,90,127220,75.01179245283019,11
0.2,1696,96,127316,75.0241602828521,6
0.2,1697,92,127408,75.0341578327444,9
0.2,1698,89,127497,75.0423778693349,12
0.2,1699,18,127515,75.00882352941177,14
0.2,1700,94,127609,75.01998824221046,7
0.2,1701,92,127701,75.02996474735605,9
0.2,1702,95,127796,75.0416911332942,8
0.2,1703,25,127821,75.01232394366197,8
0.2,1704,86,127907,75.01876832844574,15
0.2,1705,96,128003,75.03106682297772,6
0.2,1706,88,128091,75.03866432337433,14
0.2,1707,91,128182,75.0480093676815,10
0.2,1708,94,128276,75.05909888823874,7
0.2,1709,89,128365,75.0672514619883,15
0.2,1710,93,128458,75.07773232028053,8
0.2,1711,94,128552,75.08878504672897,8
0.2,1712,91,128643,75.09807355516638,10
0.2,1713,89,128732,75.10618436406068,12
0.2,1714,91,128823,75.11545189504373,11
0.2,1715,87,128910,75.12237762237763,14
0.2,1716,90,129000,75.13104251601631,11
0.2,1717,91,129091,75.14027939464493,10
0.2,1718,94,129185,75.15125072716695,7
0.2,1719,95,129280,75.16279069767442,6
0.2,1720,94,129374,75.17373619988379,7
0.2,1721,92,129466,75.18350754936121,9
0.2,1722,96,129562,75.19558908879861,6
0.2,1723,87,129649,75.2024361948956,14
0.2,1724,18,129667,75.16927536231884,14
0.2,1725,92,129759,75.17902665121669,9
0.2,1726,94,129853,75.18992472495657,8
0.2,1727,91,129944,75.19907407407408,10
0.2,1728,95,130039,75.21052631578948,6
0.2,1729,95,130134,75.22196531791907,7
0.2,1730,24,130158,75.19237435008665,8
0.2,1731,96,130254,75.20438799076213,6
0.2,1732,94,130348,75.21523369878823,7
0.2,1733,94,130442,75.22606689734718,7
0.2,1734,93,130535,75.23631123919309,8
0.2,1735,91,130626,75.24539170506912,10
0.2,1736,92,130718,75.25503742084052,10
0.2,1737,23,130741,75.22497123130034,9
0.2,1738,96,130837,75.23691776883267,6
0.2,1739,23,130860,75.20689655172414,10
0.2,1740,96,130956,75.21883974727169,6
0.2,1741,90,131046,75.22732491389208,11
0.2,1742,19,131065,75.19506597819851,14
0.2,1743,94,131159,75.20584862385321,7
0.2,1744,95,131254,75.21719197707736,6
0.2,1745,25,131279,75.18843069873998,8
0.2,1746,94,131373,75.19919862621637,7
0.2,1747,23,131396,75.16933638443936,10
0.2,1748,94,131490,75.18010291595198,7
0.2,1749,95,131585,75.19142857142857,7
0.2,1750,96,131681,75.20331239291833,6
0.2,1751,92,131773,75.212899543379,9
0.2,1752,95,131868,75.22418710781517,6
0.2,1753,86,131954,75.23033067274801,16
0.2,1754,93,132047,75.24045584045584,8
0.2,1755,96,132143,75.25227790432803,6
0.2,1756,25,132168,75.22367672168468,8
0.2,1757,95,132263,75.2349260523322,7
0.2,1758,94,132357,75.24559408754975,7
0.2,1759,94,132451,75.25625,7
0.2,1760,94,132545,75.26689381033503,7
0.2,1761,21,132566,75.2360953461975,12
0.2,1762,88,132654,75.24333522404991,13
0.2,1763,94,132748,75.25396825396825,7
0.2,1764,92,132840,75.26345609065156,9
0.2,1765,94,132934,75.27406568516422,7
0.2,1766,94,133028,75.28466327108093,7
0.2,1767,93,133121,75.29468325791855,8
0.2,1768,24,133145,75.2656868287168,9
0.2,1769,23,133168,75.2361581920904,9
0.2,1770,-53,133115,75.16374929418407,16
0.2,1771,95,133210,75.17494356659142,7
0.2,1772,95,133305,75.18612521150592,7
0.2,1773,94,133399,75.1967305524239,8
0.2,1774,26,133425,75.16901408450704,7
0.2,1775,96,133521,75.18074324324324,6
0.2,1776,94,133615,75.19133370849747,7
0.2,1777,95,133710,75.20247469066366,8
0.2,1778,88,133798,75.2096683530073,13
0.2,1779,92,133890,75.21910112359551,10
0.2,1780,95,133985,75.23020774845592,8
0.2,1781,95,134080,75.24130190796858,6
0.2,1782,95,134175,75.25238362310712,6
0.2,1783,88,134263,75.25952914798206,13
0.2,1784,93,134356,75.26946778711485,9
0.2,1785,94,134450,75.27995520716685,8
0.2,1786,94,134544,75.29043088975938,7
0.2,1787,95,134639,75.30145413870247,7
0.2,1788,22,134661,75.27166014533259,10
0.2,1789,-56,134605,75.19832402234637,20
0.2,1790,94,134699,75.20882188721384,7
0.2,1791,93,134792,75.21875,8
0.2,1792,19,134811,75.18739542665924,13
0.2,1793,94,134905,75.19788182831661,8
0.2,1794,89,134994,75.20557103064067,12
0.2,1795,92,135086,75.21492204899778,9
0.2,1796,89,135175,75.22259321090706,12
0.2,1797,91,135266,75.2313681868743,10
0.2,1798,94,135360,75.24180100055587,7
0.2,1799,91,135451,75.25055555555555,10
0.2,1800,94,135545,75.26096612992782,7
0.2,1801,91,135636,75.26970033296337,11
0.2,1802,96,135732,75.28119800332779,6
0.2,1803,27,135759,75.25443458980044,6
0.2,1804,93,135852,75.26426592797785,8
0.2,1805,94,135946,75.27464008859357,7
0.2,1806,94,136040,75.28500276701716,7
0.2,1807,88,136128,75.29203539823008,13
0.2,1808,95,136223,75.30292979546711,6
0.2,1809,94,136317,75.31325966850828,7
0.2,1810,91,136408,75.32192159028162,10
0.2,1811,90,136498,75.33002207505518,11
0.2,1812,93,136591,75.33976833976834,8
0.2,1813,22,136613,75.31036383682469,12
0.2,1814,96,136709,75.32176308539945,6
0.2,1815,94,136803,75.33204845814979,7
0.2,1816,94,136897,75.34232250963126,7
0.2,1817,92,136989,75.35148514851485,9
0.2,1818,94,137083,75.36173721825179,7
0.2,1819,96,137179,75.37307692307692,6
0.2,1820,92,137271,75.38220757825371,9
0.2,1821,95,137366,75.39297475301866,6
0.2,1822,92,137458,75.40208447613823,9
0.2,1823,94,137552,75.41228070175438,7
0.2,1824,96,137648,75.42356164383561,6
0.2,1825,21,137669,75.39375684556407,11
0.2,1826,90,137759,75.40175150519978,11
0.2,1827,92,137851,75.41083150984683,9
0.2,1828,87,137938,75.41716785128486,14
0.2,1829,22,137960,75.3879781420765,10
0.2,1830,94,138054,75.39814309120699,7
0.2,1831,93,138147,75.40775109170306,8
0.2,1832,21,138168,75.37806873977087,11
0.2,1833,96,138264,75.38931297709924,7
0.2,1834,92,138356,75.3983651226158,9
0.2,1835,91,138447,75.40686274509804,10
0.2,1836,87,138534,75.41317365269461,15
0.2,1837,-48,138486,75.34602829162132,12
0.2,1838,90,138576,75.35399673735726,12
0.2,1839,96,138672,75.36521739130434,6
0.2,1840,93,138765,75.37479630635524,10
0.2,1841,94,138859,75.38490770901194,7
0.2,1842,92,138951,75.39392295170917,9
0.2,1843,93,139044,75.40347071583514,8
0.2,1844,93,139137,75.4130081300813,8
0.2,1845,94,139231,75.42307692307692,7
0.2,1846,92,139323,75.43205197617759,9
0.2,1847,92,139415,75.44101731601732,9
0.2,1848,96,139511,75.45213628988643,6
0.2,1849,92,139603,75.46108108108108,9
0.2,1850,95,139698,75.47163695299838,6
0.2,1851,85,139783,75.4767818574514,16
0.2,1852,91,139874,75.4851592012952,10
0.2,1853,94,139968,75.49514563106796,7
0.2,1854,93,140061,75.50458221024259,8
0.2,1855,89,140150,75.51185344827586,13
0.2,1856,91,140241,75.52019386106623,10
0.2,1857,91,140332,75.52852529601722,11
0.2,1858,94,140426,75.53846153846153,7
0.2,1859,96,140522,75.5494623655914,6
0.2,1860,94,140616,75.55937667920473,7
0.2,1861,90,140706,75.5671321160043,11
0.2,1862,-44,140662,75.50295222758992,8
0.2,1863,94,140756,75.51287553648069,8
0.2,1864,93,140849,75.52225201072386,8
0.2,1865,92,140941,75.53108252947482,9
0.2,1866,94,141035,75.54097482592394,7
0.2,1867,94,141129,75.55085653104925,7
0.2,1868,93,141222,75.56019261637239,9
0.2,1869,94,141316,75.57005347593582,7
0.2,1870,94,141410,75.57990379476216,7
0.2,1871,96,141506,75.59081196581197,6
0.2,1872,94,141600,75.60064068339562,7
0.2,1873,90,141690,75.60832443970118,12
0.2,1874,92,141782,75.61706666666667,9
0.2,1875,95,141877,75.62739872068231,6
0.2,1876,92,141969,75.63612147043153,9
0.2,1877,23,141992,75.60809371671992,9
0.2,1878,89,142081,75.61522086216073,12
0.2,1879,92,142173,75.62393617021277,9
0.2,1880,95,142268,75.63423710792132,6
0.2,1881,94,142362,75.64399574920297,7
0.2,1882,96,142458,75.65480616038236,6
0.2,1883,92,142550,75.66348195329087,9
0.2,1884,94,142644,75.67320954907161,8
0.2,1885,93,142737,75.68239660657476,8
0.2,1886,19,142756,75.65235824059353,14
0.2,1887,91,142847,75.6604872881356,11
0.2,1888,20,142867,75.63102170460562,12
0.2,1889,94,142961,75.64074074074074,7
0.2,1890,-116,142845,75.53939714436805,12
0.2,1891,89,142934,75.54651162790698,12
0.2,1892,94,143028,75.55625990491284,8
0.2,1893,13,143041,75.52323125659979,20
0.2,1894,88,143129,75.52981530343008,13
0.2,1895,21,143150,75.50105485232068,11
0.2,1896,96,143246,75.51186083289404,6
0.2,1897,89,143335,75.51896733403582,13
0.2,1898,93,143428,75.52817272248552,8
0.2,1899,92,143520,75.53684210526316,10
0.2,1900,96,143616,75.54760652288269,6
0.2,1901,94,143710,75.55730809674027,7
0.2,1902,24,143734,75.5302154492906,8
0.2,1903,92,143826,75.53886554621849,9
0.2,1904,91,143917,75.54698162729659,10
0.2,1905,-115,143802,75.44700944386149,10
0.2,1906,92,143894,75.4556895647614,9
0.2,1907,93,143987,75.46488469601677,8
0.2,1908,24,144011,75.4379256155055,9
0.2,1909,27,144038,75.41256544502617,7
0.2,1910,93,144131,75.421768707483,8
0.2,1911,95,144226,75.43200836820084,7
0.2,1912,95,144321,75.44223732357554,6
0.2,1913,95,144416,75.45245559038662,6
0.2,1914,96,144512,75.46318537859008,6
0.2,1915,90,144602,75.47077244258872,11
0.2,1916,25,144627,75.44444444444444,8
0.2,1917,96,144723,75.45516162669448,6
0.2,1918,95,144818,75.46534653465346,6
0.2,1919,23,144841,75.43802083333334,9
0.2,1920,16,144857,75.40707964601769,16
0.2,1921,96,144953,75.41779396462019,6
0.2,1922,-51,144902,75.35205408216329,14
0.2,1923,91,144993,75.36018711018711,10
0.2,1924,21,145014,75.33194805194805,12
0.2,1925,94,145108,75.34164070612668,7
0.2,1926,90,145198,75.34924753502854,11
0.2,1927,96,145294,75.35995850622406,6
0.2,1928,24,145318,75.33333333333333,8
0.2,1929,90,145408,75.34093264248705,11
0.2,1930,94,145502,75.35059554634904,7
0.2,1931,94,145596,75.36024844720497,7
0.2,1932,95,145691,75.37040869115364,9
0.2,1933,92,145783,75.37900723888315,9
0.2,1934,94,145877,75.38863049095607,7
0.2,1935,95,145972,75.39876033057851,7
0.2,1936,91,146063,75.40681466184822,10
0.2,1937,94,146157,75.41640866873065,8
0.2,1938,94,146251,75.4259927797834,7
0.2,1939,91,146342,75.4340206185567,10
0.2,1940,94,146436,75.4435857805255,7
0.2,1941,94,146530,75.45314109165808,7
0.2,1942,25,146555,75.42717447246525,8
0.2,1943,94,146649,75.43672839506173,7
0.2,1944,94,146743,75.44627249357326,7
0.2,1945,96,146839,75.4568345323741,6
0.2,1946,94,146933,75.4663585002568,8
0.2,1947,89,147022,75.47330595482546,12
0.2,1948,25,147047,75.4474089276552,9
0.2,1949,95,147142,75.4574358974359,7
0.2,1950,94,147236,75.46694003075346,8
0.2,1951,91,147327,75.4748975409836,11
0.2,1952,22,147349,75.44751664106502,11
0.2,1953,94,147443,75.45701125895599,8
0.2,1954,27,147470,75.43222506393862,7
0.2,1955,93,147563,75.44120654396728,9
0.2,1956,89,147652,75.44813490035769,12
0.2,1957,94,147746,75.4576098059244,7
0.2,1958,94,147840,75.46707503828483,7
0.2,1959,95,147935,75.47704081632654,6
0.2,1960,95,148030,75.48699643039265,6
0.2,1961,93,148123,75.49592252803262,8
0.2,1962,88,148211,75.50229240957718,13
0.2,1963,96,148307,75.51272912423626,6
0.2,1964,93,148400,75.52162849872774,8
0.2,1965,91,148491,75.529501525941,10
0.2,1966,96,148587,75.53990849008643,6
0.2,1967,94,148681,75.54928861788618,8
0.2,1968,95,148776,75.55916708989335,7
0.2,1969,94,148870,75.56852791878173,7
0.2,1970,92,148962,75.57686453576865,9
0.2,1971,94,149056,75.58620689655173,7
0.2,1972,92,149148,75.59452610238216,9
0.2,1973,-50,149098,75.53090172239108,13
0.2,1974,93,149191,75.53974683544304,8
0.2,1975,96,149287,75.5501012145749,6
0.2,1976,93,149380,75.55892766818411,8
0.2,1977,94,149474,75.56825075834176,7
0.2,1978,93,149567,75.57705912076807,9
0.2,1979,95,149662,75.58686868686868,8
0.2,1980,95,149757,75.59666834931852,6
0.2,1981,92,149849,75.60494450050454,9
0.2,1982,87,149936,75.61069087241553,15
0.2,1983,94,150030,75.61995967741936,7
0.2,1984,90,150120,75.62720403022671,11
0.2,1985,93,150213,75.63595166163142,8
0.2,1986,92,150305,75.64418721690991,9
0.2,1987,94,150399,75.65342052313883,7
0.2,1988,89,150488,75.66013071895425,14
0.2,1989,95,150583,75.66984924623115,7
0.2,1990,93,150676,75.67855349070818,8
0.2,1991,95,150771,75.6882530120482,7
0.2,1992,95,150866,75.69794279979929,7
0.2,1993,12,150878,75.66599799398195,23
0.2,1994,25,150903,75.6406015037594,7
0.2,1995,95,150998,75.6503006012024,7
0.2,1996,93,151091,75.65898848272408,8
0.2,1997,91,151182,75.66666666666667,11
0.2,1998,93,151275,75.67533766883442,8
0.2,1999,94,151369,75.6845,8
0.2,2000,92,151461,75.69265367316342,10
0.2,2001,94,151555,75.7017982017982,9
0.2,2002,95,151650,75.71143285072391,7
0.2,2003,95,151745,75.72105788423154,7
0.2,2004,88,151833,75.72718204488778,14
0.2,2005,92,151925,75.73529411764706,9
0.2,2006,90,152015,75.74240159441953,11
0.2,2007,25,152040,75.71713147410358,8
0.2,2008,84,152124,75.7212543554007,17
0.2,2009,95,152219,75.73084577114427,6
0.2,2010,23,152242,75.7046245648931,9
0.2,2011,24,152266,75.67892644135189,10
0.2,2012,94,152360,75.68802781917536,7
0.2,2013,96,152456,75.69811320754717,6
0.2,2014,-46,152410,75.6377171215881,10
0.2,2015,23,152433,75.61160714285714,9
0.2,2016,83,152516,75.61527020327219,18
0.2,2017,94,152610,75.62438057482656,7
0.2,2018,96,152706,75.63447251114412,6
0.2,2019,93,152799,75.6430693069307,8
0.2,2020,90,152889,75.65017318159327,11
0.2,2021,25,152914,75.62512363996044,9
0.2,2022,95,153009,75.6347009391992,7
0.2,2023,96,153105,75.6447628458498,6
0.2,2024,95,153200,75.65432098765432,6
0.2,2025,90,153290,75.66140177690029,11
0.2,2026,92,153382,75.6694622594968,11
0.2,2027,80,153462,75.67159763313609,23
0.2,2028,18,153480,75.64317397732873,14
0.2,2029,95,153575,75.65270935960591,6
0.2,2030,95,153670,75.66223535204333,6
0.2,2031,94,153764,75.67125984251969,7
0.2,2032,92,153856,75.67929168716184,9
0.2,2033,27,153883,75.65535889872173,6
0.2,2034,90,153973,75.66240786240786,11
0.2,2035,88,154061,75.66846758349705,13
0.2,2036,95,154156,75.67795778105057,6
0.2,2037,90,154246,75.68498527968596,11
0.2,2038,27,154273,75.66110838646395,6
0.2,2039,95,154368,75.67058823529412,7
0.2,2040,22,154390,75.64429201371877,10
0.2,2041,21,154411,75.6175318315377,11
0.2,2042,91,154502,75.62506118453256,10
0.2,2043,26,154528,75.60078277886497,7
0.2,2044,94,154622,75.60977995110025,7
0.2,2045,94,154716,75.61876832844575,7
0.2,2046,91,154807,75.62628236443577,11
0.2,2047,92,154899,75.63427734375,9
0.2,2048,91,154990,75.64177647632992,10
0.2,2049,88,155078,75.64780487804877,13
0.2,2050,94,155172,75.65675280351049,10
0.2,2051,94,155266,75.66569200779728,7
0.2,2052,90,155356,75.6726741354116,12
0.2,2053,92,155448,75.68062317429406,9
0.2,2054,92,155540,75.68856447688565,9
0.2,2055,95,155635,75.69795719844358,7
0.2,2056,92,155727,75.70588235294117,10
0.2,2057,24,155751,75.6807580174927,8
0.2,2058,93,155844,75.68916949975717,8
0.2,2059,24,155868,75.66407766990291,8
0.2,2060,96,155964,75.67394468704512,6
0.2,2061,95,156059,75.68331716779825,6
0.2,2062,92,156151,75.691226369365,9
0.2,2063,95,156246,75.70058139534883,6
0.2,2064,89,156335,75.70702179176756,12
0.2,2065,95,156430,75.7163601161665,6
0.2,2066,95,156525,75.72568940493468,6
0.2,2067,94,156619,75.73452611218569,7
0.2,2068,95,156714,75.74383760270662,7
0.2,2069,93,156807,75.75217391304348,8
0.2,2070,94,156901,75.7609850313858,7
0.2,2071,92,156993,75.76882239382239,9
0.2,2072,95,157088,75.77809937288953,6
0.2,2073,94,157182,75.78688524590164,7
0.2,2074,19,157201,75.75951807228915,13
0.2,2075,92,157293,75.76734104046243,10
0.2,2076,93,157386,75.77563793933558,8
0.2,2077,94,157480,75.78440808469682,7
0.2,2078,-46,157434,75.72582972582973,10
0.2,2079,92,157526,75.73365384615384,9
0.2,2080,92,157618,75.74147044690052,9
0.2,2081,93,157711,75.74975984630163,8
0.2,2082,22,157733,75.72395583293327,11
0.2,2083,96,157829,75.73368522072937,6
0.2,2084,21,157850,75.70743405275779,11
0.2,2085,93,157943,75.71572387344199,8
0.2,2086,91,158034,75.72304743651173,10
0.2,2087,-52,157982,75.66187739463602,15
0.2,2088,26,158008,75.63810435615127,7
0.2,2089,96,158104,75.64784688995215,6
0.2,2090,86,158190,75.65279770444764,16
0.2,2091,92,158282,75.66061185468452,9
0.2,2092,92,158374,75.66841853798375,9
0.2,2093,93,158467,75.6766953199618,8
0.2,2094,-54,158413,75.61479713603819,17
0.2,2095,95,158508,75.62404580152672,7
0.2,2096,93,158601,75.63233190271816,8
0.2,2097,94,158695,75.64108674928504,7
0.2,2098,92,158787,75.64888041924726,9
0.2,2099,93,158880,75.65714285714286,8
0.2,2100,94,158974,75.66587339362208,7
0.2,2101,90,159064,75.67269267364415,11
0.2,2102,95,159159,75.68188302425106,6
0.2,2103,96,159255,75.69153992395437,6
0.2,2104,92,159347,75.69928741092636,9
0.2,2105,96,159443,75.70892687559355,6
0.2,2106,23,159466,75.68391077361177,11
0.2,2107,94,159560,75.69259962049335,7
0.2,2108,91,159651,75.69985775248934,11
0.2,2109,22,159673,75.67440758293839,10
0.2,2110,88,159761,75.68024632875415,13
0.2,2111,96,159857,75.68986742424242,6
0.2,2112,93,159950,75.6980596308566,8
0.2,2113,94,160044,75.70671712393566,7
0.2,2114,89,160133,75.7130023640662,12
0.2,2115,94,160227,75.72164461247637,8
0.2,2116,95,160322,75.73075106282475,6
0.2,2117,95,160417,75.73984891406988,7
0.2,2118,-121,160296,75.64700330344502,15
0.2,2119,22,160318,75.62169811320754,10
0.2,2120,93,160411,75.62989156058462,8
0.2,2121,92,160503,75.63760603204524,9
0.2,2122,-46,160457,75.58031088082902,10
0.2,2123,94,160551,75.58898305084746,7
0.2,2124,95,160646,75.59811764705883,6
0.2,2125,93,160739,75.6063029162747,8
0.2,2126,92,160831,75.61401034320639,9
0.2,2127,91,160922,75.62124060150376,11
0.2,2128,94,161016,75.62987317989666,7
0.2,2129,96,161112,75.63943661971831,6
0.2,2130,92,161204,75.64711403097138,9
0.2,2131,94,161298,75.65572232645404,7
0.2,2132,94,161392,75.6643225503985,7
0.2,2133,94,161486,75.67291471415183,7
0.2,2134,92,161578,75.68056206088993,9
0.2,2135,92,161670,75.68820224719101,9
0.2,2136,91,161761,75.69536733738886,10
0.2,2137,93,161854,75.70346117867166,8
0.2,2138,94,161948,75.71201496026181,7
0.2,2139,94,162042,75.72056074766355,8
0.2,2140,94,162136,75.72909855207847,7
0.2,2141,92,162228,75.73669467787114,10
0.2,2142,91,162319,75.74381707886141,10
0.2,2143,-44,162275,75.68796641791045,8
0.2,2144,26,162301,75.66480186480186,7
0.2,2145,93,162394,75.67287977632805,9
0.2,2146,89,162483,75.67908709827667,12
0.2,2147,91,162574,75.68621973929237,11
0.2,2148,96,162670,75.69567240577013,6
0.2,2149,93,162763,75.70372093023256,8
0.2,2150,94,162857,75.71222687122268,7
0.2,2151,92,162949,75.71979553903346,9
0.2,2152,94,163043,75.7282861124013,7
0.2,2153,94,163137,75.73676880222841,7
0.2,2154,92,163229,75.74431554524362,10
0.2,2155,95,163324,75.75324675324676,6
0.2,2156,85,163409,75.75753361149745,16
0.2,2157,93,163502,75.7655236329935,8
0.2,2158,92,163594,75.77304307549791,9
0.2,2159,94,163688,75.78148148148148,7
0.2,2160,95,163783,75.79037482646923,6
0.2,2161,94,163877,75.79879740980573,7
0.2,2162,92,163969,75.80628756356911,9
0.2,2163,94,164063,75.81469500924214,7
0.2,2164,93,164156,75.82263279445728,8
0.2,2165,21,164177,75.79732225300093,11
0.2,2166,92,164269,75.80479926165205,9
0.2,2167,91,164360,75.81180811808117,11
0.2,2168,25,164385,75.7883817427386,8
0.2,2169,94,164479,75.79677419354839,7
0.2,2170,91,164570,75.8037770612621,13
0.2,2171,95,164665,75.81261510128914,6
0.2,2172,90,164755,75.81914404049701,11
0.2,2173,22,164777,75.79438822447102,10
0.2,2174,94,164871,75.80275862068966,8
0.2,2175,22,164893,75.77803308823529,10
0.2,2176,91,164984,75.78502526412494,11
0.2,2177,94,165078,75.79338842975207,7
0.2,2178,96,165174,75.8026617714548,6
0.2,2179,20,165194,75.77706422018349,13
0.2,2180,96,165290,75.78633654287025,6
0.2,2181,94,165384,75.79468377635197,7
0.2,2182,96,165480,75.80393953275309,6
0.2,2183,25,165505,75.78067765567765,8
0.2,2184,90,165595,75.78718535469108,11
0.2,2185,95,165690,75.79597438243367,7
0.2,2186,90,165780,75.80246913580247,13
0.2,2187,93,165873,75.81032906764169,9
0.2,2188,85,165958,75.81452718136136,16
0.2,2189,-117,165841,75.72648401826484,12
0.2,2190,25,165866,75.70333181195801,8
0.2,2191,92,165958,75.71076642335767,10
0.2,2192,94,166052,75.71910624715002,7
0.2,2193,89,166141,75.72515952597995,12
0.2,2194,96,166237,75.73439635535307,6
0.2,2195,95,166332,75.7431693989071,7
0.2,2196,94,166426,75.75147928994083,7
0.2,2197,88,166514,75.75705186533212,13
0.2,2198,95,166609,75.76580263756253,6
0.2,2199,22,166631,75.74136363636363,10
0.2,2200,96,166727,75.75056792367106,6
0.2,2201,88,166815,75.75613079019074,13
0.2,2202,94,166909,75.76441216522923,7
0.2,2203,93,167002,75.77223230490019,8
0.2,2204,92,167094,75.7795918367347,9
0.2,2205,89,167183,75.78558476881233,12
0.2,2206,92,167275,75.79293158133213,9
0.2,2207,96,167371,75.80208333333333,6
0.2,2208,96,167467,75.81122679945676,6
0.2,2209,85,167552,75.81538461538462,21
0.2,2210,94,167646,75.8236092265943,8
0.2,2211,87,167733,75.82866184448463,14
0.2,2212,94,167827,75.83687302304564,7
0.2,2213,92,167919,75.84417344173441,9
0.2,2214,91,168010,75.85101580135441,10
0.2,2215,94,168104,75.85920577617328,7
0.2,2216,91,168195,75.8660351826793,10
0.2,2217,94,168289,75.87421100090171,8
0.2,2218,18,168307,75.84812978819288,16
0.2,2219,19,168326,75.82252252252252,13
0.2,2220,94,168420,75.83070688878884,7
0.2,2221,90,168510,75.83708370837084,11
0.2,2222,88,168598,75.842555105713,13
0.2,2223,96,168694,75.85161870503597,6
0.2,2224,91,168785,75.85842696629213,12
0.2,2225,94,168879,75.866576819407,7
0.2,2226,96,168975,75.87561742254154,6
0.2,2227,95,169070,75.88420107719928,6
0.2,2228,94,169164,75.89232839838493,8
0.2,2229,89,169253,75.8982062780269,12
0.2,2230,94,169347,75.90632003585836,7
0.2,2231,95,169442,75.91487455197132,6
0.2,2232,92,169534,75.92207792207792,9
0.2,2233,91,169625,75.92882721575648,10
0.2,2234,18,169643,75.90290827740492,15
0.2,2235,91,169734,75.90966010733453,10
0.2,2236,93,169827,75.91729995529727,8
0.2,2237,21,169848,75.89276139410188,11
0.2,2238,96,169944,75.90174184903975,6
0.2,2239,89,170033,75.90758928571428,12
0.2,2240,92,170125,75.91477019187863,9
0.2,2241,85,170210,75.91882247992864,17
0.2,2242,87,170297,75.92376281765493,15
0.2,2243,96,170393,75.93270944741533,6
0.2,2244,92,170485,75.93986636971047,9
0.2,2245,93,170578,75.94746215494212,8
0.2,2246,91,170669,75.95416110369382,10
0.2,2247,92,170761,75.96129893238434,9
0.2,2248,95,170856,75.96976433970653,6
0.2,2249,94,170950,75.97777777777777,7
0.2,2250,91,171041,75.98445135495335,10
0.2,2251,94,171135,75.9924511545293,7
0.2,2252,92,171227,75.99955614735907,9
0.2,2253,91,171318,76.00621118012423,10
0.2,2254,96,171414,76.01507760532151,6
0.2,2255,92,171506,76.02216312056737,10
0.2,2256,93,171599,76.02968542312804,8
0.2,2257,94,171693,76.03764393268379,8
0.2,2258,23,171716,76.01416555998229,10
0.2,2259,96,171812,76.02300884955753,6
0.2,2260,96,171908,76.03184431667404,6
0.2,2261,94,172002,76.03978779840848,7
0.2,2262,91,172093,76.04639858594786,11
0.2,2263,92,172185,76.05344522968198,9
0.2,2264,92,172277,76.06048565121412,10
0.2,2265,93,172370,76.06796116504854,9
0.2,2266,96,172466,76.07675341861491,6
0.2,2267,93,172559,76.0842151675485,8
0.2,2268,92,172651,76.09122961657118,10
0.2,2269,96,172747,76.1,6
0.2,2270,92,172839,76.10700132100396,9
0.2,2271,95,172934,76.11531690140845,7
0.2,2272,93,173027,76.12274527056753,8
0.2,2273,95,173122,76.13104661389622,7
0.2,2274,92,173214,76.13802197802198,9
0.2,2275,94,173308,76.14586994727593,7
0.2,2276,95,173403,76.15415019762845,6
0.2,2277,91,173494,76.16066725197541,11
0.2,2278,94,173588,76.16849495392717,7
0.2,2279,96,173684,76.17719298245613,6
0.2,2280,94,173778,76.18500657606313,7
0.2,2281,13,173791,76.15731814198072,20
0.2,2282,96,173887,76.16600963644328,6
0.2,2283,96,173983,76.17469352014011,6
0.2,2284,91,174074,76.18118161925602,10
0.2,2285,92,174166,76.18810148731409,10
0.2,2286,92,174258,76.19501530389157,9
0.2,2287,94,174352,76.2027972027972,7
0.2,2288,92,174444,76.20969855832242,9
0.2,2289,92,174536,76.21659388646289,9
0.2,2290,92,174628,76.2234831951113,10
0.2,2291,92,174720,76.2303664921466,10
0.2,2292,96,174816,76.23898822503271,6
0.2,2293,93,174909,76.24629468177855,8
0.2,2294,93,175002,76.25359477124184,8
0.2,2295,96,175098,76.26219512195122,6
0.2,2296,17,175115,76.23639529821506,15
0.2,2297,95,175210,76.24456048738033,7
0.2,2298,92,175302,76.25141365811223,10
0.2,2299,94,175396,76.2591304347826,7
0.2,2300,93,175489,76.26640591047371,9
0.2,2301,18,175507,76.24109470026065,14
0.2,2302,90,175597,76.24706904038212,11
0.2,2303,96,175693,76.25564236111111,6
0.2,2304,94,175787,76.26334056399132,7
0.2,2305,93,175880,76.27059843885516,8
0.2,2306,94,175974,76.27828348504552,7
0.2,2307,94,176068,76.28596187175043,7
0.2,2308,94,176162,76.29363360762235,8
0.2,2309,88,176250,76.2987012987013,13
0.2,2310,94,176344,76.30636088273475,8
0.2,2311,90,176434,76.31228373702422,11
0.2,2312,90,176524,76.31820146995244,11
0.2,2313,23,176547,76.2951598962835,10
0.2,2314,92,176639,76.30194384449244,9
0.2,2315,94,176733,76.30958549222798,7
0.2,2316,94,176827,76.31722054380664,7
0.2,2317,94,176921,76.32484900776531,7
0.2,2318,92,177013,76.33160845191892,9
0.2,2319,91,177104,76.33793103448276,12
0.2,2320,91,177195,76.34424816889272,10
0.2,2321,95,177290,76.35228251507321,6
0.2,2322,94,177384,76.35987946620749,7
0.2,2323,95,177479,76.36790017211705,7
0.2,2324,91,177570,76.3741935483871,10
0.2,2325,92,177662,76.38091143594153,9
0.2,2326,92,177754,76.38762354963472,9
0.2,2327,96,177850,76.39604810996563,6
0.2,2328,92,177942,76.40274796049806,10
0.2,2329,96,178038,76.41115879828327,6
0.2,2330,96,178134,76.41956241956242,6
0.2,2331,95,178229,76.42753001715266,6
0.2,2332,25,178254,76.40548649807116,8
0.2,2333,91,178345,76.41173950299914,10
0.2,2334,92,178437,76.41841541755889,9
0.2,2335,93,178530,76.42551369863014,9
0.2,2336,95,178625,76.43346170303808,6
0.2,2337,92,178717,76.44011976047904,10
0.2,2338,-60,178657,76.38178708849937,24
0.2,2339,87,178744,76.38632478632479,14
0.2,2340,92,178836,76.3929944468176,9
0.2,2341,91,178927,76.39923142613151,10
0.2,2342,95,179022,76.40717029449424,6
0.2,2343,-47,178975,76.35452218430034,10
0.2,2344,96,179071,76.36289978678039,6
0.2,2345,95,179166,76.37084398976982,6
0.2,2346,92,179258,76.3775031955688,9
0.2,2347,95,179353,76.38543441226575,8
0.2,2348,21,179374,76.36185610898255,11
0.2,2349,96,179470,76.37021276595745,6
0.2,2350,93,179563,76.37728626116547,8
0.2,2351,94,179657,76.38477891156462,8
0.2,2352,89,179746,76.39014024649384,12
0.2,2353,91,179837,76.3963466440102,10
0.2,2354,94,179931,76.40382165605095,8
0.2,2355,22,179953,76.38073005093379,10
0.2,2356,89,180042,76.38608400509122,12
0.2,2357,94,180136,76.39355385920271,7
0.2,2358,95,180231,76.40144128868164,7
0.2,2359,92,180323,76.40805084745763,9
0.2,2360,93,180416,76.41507835662854,8
0.2,2361,91,180507,76.4212531752752,10
0.2,2362,96,180603,76.42953872196361,7
0.2,2363,19,180622,76.4052453468697,13
0.2,2364,94,180716,76.41268498942918,7
0.2,2365,93,180809,76.41969568892645,8
0.2,2366,95,180904,76.42754541613857,7
0.2,2367,95,180999,76.43538851351352,6
0.2,2368,91,181090,76.44153651329675,10
0.2,2369,-52,181038,76.3873417721519,16
0.2,2370,94,181132,76.39477013918177,8
0.2,2371,95,181227,76.40261382799325,6
0.2,2372,17,181244,76.37758112094396,16
0.2,2373,90,181334,76.38331929233361,11
0.2,2374,17,181351,76.35831578947368,15
0.2,2375,92,181443,76.36489898989899,9
0.2,2376,96,181539,76.37315944467817,6
0.2,2377,21,181560,76.34987384356602,11
0.2,2378,95,181655,76.35771332492644,6
0.2,2379,95,181750,76.3655462184874,6
0.2,2380,22,181772,76.34271314573708,10
0.2,2381,95,181867,76.35054575986565,6
0.2,2382,92,181959,76.35711288292069,10
0.2,2383,95,182054,76.36493288590604,7
0.2,2384,21,182075,76.34171907756813,11
0.2,2385,95,182170,76.34953897736798,6
0.2,2386,96,182266,76.35777126099707,6
0.2,2387,93,182359,76.36474036850922,8
0.2,2388,89,182448,76.37002930096274,13
0.2,2389,21,182469,76.3468619246862,11
0.2,2390,91,182560,76.3529903805939,10
0.2,2391,94,182654,76.36036789297658,7
0.2,2392,25,182679,76.33890513999164,8
0.2,2393,90,182769,76.34461152882206,11
0.2,2394,94,182863,76.35198329853863,7
0.2,2395,95,182958,76.35976627712854,7
0.2,2396,89,183047,76.36503963287443,12
0.2,2397,94,183141,76.37239366138449,7
0.2,2398,93,183234,76.37932471863276,8
0.2,2399,94,183328,76.38666666666667,9
0.2,2400,95,183423,76.39441899208663,6
0.2,2401,92,183515,76.40091590341382,10
0.2,2402,94,183609,76.40823970037454,7
0.2,2403,25,183634,76.38685524126456,8
0.2,2404,18,183652,76.36257796257796,17
0.2,2405,92,183744,76.36907730673316,9
0.2,2406,93,183837,76.37598670544246,8
0.2,2407,26,183863,76.35506644518273,8
0.2,2408,92,183955,76.36156081361561,9
0.2,2409,85,184040,76.36514522821577,16
0.2,2410,22,184062,76.34259643301534,10
0.2,2411,91,184153,76.34867330016584,10
0.2,2412,89,184242,76.35391628677995,12
0.2,2413,95,184337,76.36164043082022,6
0.2,2414,92,184429,76.36811594202898,9
0.2,2415,91,184520,76.37417218543047,10
0.2,2416,22,184542,76.35167563094745,10
0.2,2417,93,184635,76.35856079404466,8
0.2,2418,93,184728,76.36544026457214,8
0.2,2419,93,184821,76.37231404958678,8
0.2,2420,94,184915,76.3795952085915,8
0.2,2421,-49,184866,76.32782824112304,13
0.2,2422,93,184959,76.33470903838217,8
0.2,2423,95,185054,76.3424092409241,7
0.2,2424,94,185148,76.34969072164948,7
0.2,2425,91,185239,76.35572959604286,12
0.2,2426,92,185331,76.36217552533992,11
0.2,2427,91,185422,76.3682042833608,10
0.2,2428,92,185514,76.37463976945244,11
0.2,2429,91,185605,76.38065843621399,11
0.2,2430,94,185699,76.38790621143562,7
0.2,2431,94,185793,76.3951480263158,8
0.2,2432,93,185886,76.4019728729963,8
0.2,2433,93,185979,76.4087921117502,8
0.2,2434,22,186001,76.3864476386037,10
0.2,2435,94,186095,76.39367816091954,8
0.2,2436,94,186189,76.4009027492819,7
0.2,2437,25,186214,76.37981952420016,9
0.2,2438,21,186235,76.35711357113571,11
0.2,2439,95,186330,76.36475409836065,7
0.2,2440,88,186418,76.36952068824252,14
0.2,2441,90,186508,76.37510237510237,11
0.2,2442,90,186598,76.38067949242735,12
0.2,2443,91,186689,76.3866612111293,10
0.2,2444,90,186779,76.39222903885481,11
0.2,2445,92,186871,76.39860997547015,10
0.2,2446,91,186962,76.40457703310176,10
0.2,2447,95,187057,76.41217320261438,7
0.2,2448,95,187152,76.41976316864026,6
0.2,2449,13,187165,76.39387755102041,19
0.2,2450,95,187260,76.40146878824969,7
0.2,2451,90,187350,76.40701468189233,11
0.2,2452,20,187370,76.38401956787607,12
0.2,2453,96,187466,76.3920130399348,6
0.2,2454,19,187485,76.36863543788188,13
0.2,2455,27,187512,76.3485342019544,6
0.2,2456,96,187608,76.35653235653236,6
0.2,2457,91,187699,76.36248982912937,10
0.2,2458,92,187791,76.36884912566084,9
0.2,2459,90,187881,76.37439024390244,12
0.2,2460,96,187977,76.3823648923202,6
0.2,2461,93,188070,76.38911454102356,8
0.2,2462,91,188161,76.3950466910272,10
0.2,2463,96,188257,76.40300324675324,6
0.2,2464,94,188351,76.41014198782962,7
0.2,2465,-130,188221,76.3264395782644,24
0.2,2466,91,188312,76.33238751520065,10
0.2,2467,94,188406,76.33954619124798,7
0.2,2468,89,188495,76.34467395706764,12
0.2,2469,93,188588,76.35141700404859,8
0.2,2470,91,188679,76.3573452043707,10
0.2,2471,96,188775,76.36529126213593,6
0.2,2472,95,188870,76.37282652648605,7
0.2,2473,91,188961,76.37873888439773,10
0.2,2474,95,189056,76.38626262626262,7
0.2,2475,18,189074,76.3626817447496,14
0.2,2476,95,189169,76.37020589422688,7
0.2,2477,22,189191,76.34826472962067,10
0.2,2478,94,189285,76.35538523598225,7
0.2,2479,96,189381,76.3633064516129,6
0.2,2480,94,189475,76.37041515517936,7
0.2,2481,96,189571,76.37832393231265,6
0.2,2482,91,189662,76.38421264599275,11
0.2,2483,95,189757,76.39170692431561,6
0.2,2484,94,189851,76.39879275653924,7
0.2,2485,23,189874,76.3773129525342,10
0.2,2486,92,189966,76.38359469240048,9
0.2,2487,92,190058,76.38987138263666,9
0.2,2488,94,190152,76.3969465648855,7
0.2,2489,96,190248,76.40481927710843,6
0.2,2490,23,190271,76.38338016860699,9
0.2,2491,95,190366,76.3908507223114,7
0.2,2492,93,190459,76.3975130365022,8
0.2,2493,92,190551,76.40376904570971,9
0.2,2494,96,190647,76.41162324649298,6
0.2,2495,94,190741,76.41866987179488,7
0.2,2496,24,190765,76.39767721265518,9
0.2,2497,27,190792,76.37790232185749,6
0.2,2498,91,190883,76.38375350140056,11
0.2,2499,93,190976,76.3904,8
0.2,2500,95,191071,76.39784086365454,6
0.2,2501,93,191164,76.4044764188649,8
0.2,2502,92,191256,76.4107071514183,9
0.2,2503,94,191350,76.41773162939297,7
0.2,2504,89,191439,76.42275449101797,12
0.2,2505,25,191464,76.40223463687151,8
0.2,2506,88,191552,76.4068607897886,13
0.2,2507,92,191644,76.41307814992025,10
0.2,2508,93,191737,76.41968911917098,8
0.2,2509,94,191831,76.42669322709163,7
0.2,2510,96,191927,76.43448825169256,7
0.2,2511,92,192019,76.4406847133758,9
0.2,2512,24,192043,76.41981695185038,9
0.2,2513,89,192132,76.42482100238664,12
0.2,2514,92,192224,76.43101391650099,9
0.2,2515,94,192318,76.43799682034977,7
0.2,2516,26,192344,76.41795788637266,7
0.2,2517,93,192437,76.42454328832406,8
0.2,2518,96,192533,76.43231441048034,6
0.2,2519,92,192625,76.43849206349206,10
0.2,2520,95,192720,76.44585481951607,6
0.2,2521,96,192816,76.45360824742268,6
0.2,2522,-57,192759,76.40071343638526,20
0.2,2523,93,192852,76.40729001584786,8
0.2,2524,95,192947,76.41465346534653,6
0.2,2525,91,193038,76.42042755344418,11
0.2,2526,92,193130,76.42659279778394,11
0.2,2527,94,193224,76.43354430379746,8
0.2,2528,26,193250,76.41360221431395,7
0.2,2529,25,193275,76.39328063241106,8
0.2,2530,92,193367,76.39944685894903,11
0.2,2531,86,193453,76.40323854660348,15
0.2,2532,95,193548,76.41058033951836,6
0.2,2533,24,193572,76.38989739542225,9
0.2,2534,92,193664,76.39605522682446,9
0.2,2535,27,193691,76.37657728706624,6
0.2,2536,92,193783,76.38273551438706,10
0.2,2537,92,193875,76.38888888888889,9
0.2,2538,96,193971,76.39661283970067,6
0.2,2539,96,194067,76.40433070866142,6
0.2,2540,26,194093,76.3844942935852,7
0.2,2541,94,194187,76.39142407553108,7
0.2,2542,94,194281,76.39834840739285,7
0.2,2543,95,194376,76.40566037735849,6
0.2,2544,93,194469,76.41218074656189,9
0.2,2545,90,194559,76.41751767478398,11
0.2,2546,25,194584,76.3973301923832,7
0.2,2547,-48,194536,76.34850863422292,12
0.2,2548,91,194627,76.35425657120439,11
0.2,2549,89,194716,76.35921568627451,12
0.2,2550,94,194810,76.36613092904743,7
0.2,2551,94,194904,76.3730407523511,7
0.2,2552,95,194999,76.38033685859773,6
0.2,2553,90,195089,76.38566953797964,11
0.2,2554,85,195174,76.3890410958904,16
0.2,2555,23,195197,76.36815336463224,10
0.2,2556,94,195291,76.3750488854126,7
0.2,2557,96,195387,76.38272087568413,6
0.2,2558,91,195478,76.38843298163346,11
0.2,2559,92,195570,76.39453125,9
0.2,2560,94,195664,76.40140570089808,7
0.2,2561,89,195753,76.40632318501171,12
0.2,2562,92,195845,76.41240733515411,9
0.2,2563,91,195936,76.41809672386896,10
0.2,2564,95,196031,76.4253411306043,6
0.2,2565,94,196125,76.43219017926734,7
0.2,2566,96,196221,76.43981301129723,6
0.2,2567,27,196248,76.42056074766356,6
0.2,2568,93,196341,76.42701440249124,8
0.2,2569,94,196435,76.43385214007782,8
0.2,2570,94,196529,76.44068455853754,7
0.2,2571,95,196624,76.44790046656298,7
0.2,2572,94,196718,76.4547221142635,7
0.2,2573,96,196814,76.46231546231546,6
0.2,2574,92,196906,76.4683495145631,9
0.2,2575,93,196999,76.47476708074534,9
0.2,2576,19,197018,76.45246410554908,13
0.2,2577,93,197111,76.4588828549263,9
0.2,2578,94,197205,76.46568437378829,7
0.2,2579,92,197297,76.47170542635659,10
0.2,2580,94,197391,76.47849670670283,7
0.2,2581,92,197483,76.48450813323005,10
0.2,2582,92,197575,76.49051490514906,11
0.2,2583,92,197667,76.49651702786377,9
0.2,2584,94,197761,76.50328820116054,7
0.2,2585,21,197782,76.48182521268369,12
0.2,2586,94,197876,76.48859683030537,9
0.2,2587,95,197971,76.49574961360123,7
0.2,2588,92,198063,76.50173812282735,9
0.2,2589,94,198157,76.50849420849421,7
0.2,2590,92,198249,76.51447317637978,9
0.2,2591,95,198344,76.52160493827161,7
0.2,2592,96,198440,76.52911685306594,6
0.2,2593,93,198533,76.53546646106399,8
0.2,2594,95,198628,76.54258188824663,6
0.2,2595,94,198722,76.54930662557781,7
0.2,2596,22,198744,76.52830188679245,10
0.2,2597,94,198838,76.53502694380292,7
0.2,2598,92,198930,76.54097729896114,9
0.2,2599,94,199024,76.5476923076923,7
0.2,2600,94,199118,76.55440215301807,7
0.2,2601,94,199212,76.56110684089163,8
0.2,2602,94,199306,76.56780637725701,7
0.2,2603,91,199397,76.57334869431644,10
0.2,2604,19,199416,76.55124760076775,13
0.2,2605,94,199510,76.55794320798158,7
0.2,2606,96,199606,76.56540084388186,6
0.2,2607,95,199701,76.57246932515338,6
0.2,2608,94,199795,76.57914909927175,7
0.2,2609,96,199891,76.58659003831417,6
0.2,2610,95,199986,76.59364228265032,6
0.2,2611,94,200080,76.60030627871363,8
0.2,2612,94,200174,76.60696517412936,8
0.2,2613,94,200268,76.61361897475133,8
0.2,2614,93,200361,76.61988527724665,9
0.2,2615,84,200445,76.62270642201835,17
0.2,2616,92,200537,76.62858234619793,9
0.2,2617,93,200630,76.63483575248281,10
0.2,2618,94,200724,76.64146620847652,7
0.2,2619,91,200815,76.6469465648855,11
0.2,2620,93,200908,76.65318580694391,9
0.2,2621,91,200999,76.65865751334859,10
0.2,2622,92,201091,76.66450629050705,9
0.2,2623,93,201184,76.67073170731707,8
0.2,2624,93,201277,76.67695238095239,8
0.2,2625,94,201371,76.68354912414318,7
0.2,2626,93,201464,76.68976018271793,8
0.2,2627,95,201559,76.69672754946727,6
0.2,2628,92,201651,76.70254849752757,9
0.2,2629,93,201744,76.70874524714829,8
0.2,2630,94,201838,76.71531736982136,7
0.2,2631,95,201933,76.72226443768997,6
0.2,2632,26,201959,76.70300037979491,7
0.2,2633,94,202053,76.70956719817768,8
0.2,2634,95,202148,76.71650853889943,7
0.2,2635,94,202242,76.72306525037936,7
0.2,2636,25,202267,76.7034508911642,8
0.2,2637,93,202360,76.70962850644428,8
0.2,2638,95,202455,76.7165593027662,6
0.2,2639,87,202542,76.72045454545454,15
0.2,2640,92,202634,76.72624006058311,11
0.2,2641,94,202728,76.7327781983346,7
0.2,2642,94,202822,76.7393113885736,7
0.2,2643,90,202912,76.74432677760969,11
0.2,2644,94,203006,76.7508506616257,7
0.2,2645,96,203102,76.75812547241118,6
0.2,2646,95,203197,76.76501700037778,6
0.2,2647,92,203289,76.77077039274924,9
0.2,2648,93,203382,76.77689694224236,8
0.2,2649,94,203476,76.78339622641509,7
0.2,2650,95,203571,76.79026782346284,7
0.2,2651,91,203662,76.79562594268477,10
0.2,2652,92,203754,76.80135695439125,9
0.2,2653,96,203850,76.80859080633007,6
0.2,2654,26,203876,76.78945386064031,6
0.2,2655,93,203969,76.79555722891567,9
0.2,2656,95,204064,76.80240873165224,6
0.2,2657,21,204085,76.78141459744168,11
0.2,2658,94,204179,76.7878901842798,7
0.2,2659,94,204273,76.79436090225563,7
0.2,2660,90,204363,76.79932356257046,11
0.2,2661,96,204459,76.80653643876785,6
0.2,2662,94,204553,76.81299286518964,7
0.2,2663,93,204646,76.81906906906907,8
0.2,2664,91,204737,76.82439024390244,10
0.2,2665,90,204827,76.82933233308327,11
0.2,2666,-50,204777,76.78177727784028,13
0.2,2667,90,204867,76.78673163418291,11
0.2,2668,96,204963,76.7939303109779,6
0.2,2669,94,205057,76.8003745318352,8
0.2,2670,89,205146,76.80494196929989,12
0.2,2671,83,205229,76.80726047904191,19
0.2,2672,87,205316,76.81107369996259,15
0.2,2673,23,205339,76.79094988780852,9
0.2,2674,91,205430,76.79626168224299,10
0.2,2675,91,205521,76.80156950672645,10
0.2,2676,21,205542,76.7807246918192,11
0.2,2677,94,205636,76.78715459297983,7
0.2,2678,-63,205573,76.73497573721538,27
0.2,2679,92,205665,76.74067164179104,9
0.2,2680,94,205759,76.74710928757926,7
0.2,2681,93,205852,76.75316927665921,9
0.2,2682,95,205947,76.75997018263138,6
0.2,2683,83,206030,76.76229508196721,18
0.2,2684,96,206126,76.76945996275606,6
0.2,2685,96,206222,76.77661950856292,6
0.2,2686,96,206318,76.78377372534425,6
0.2,2687,90,206408,76.78869047619048,11
0.2,2688,24,206432,76.76905912978802,8
0.2,2689,91,206523,76.77434944237918,11
0.2,2690,91,206614,76.77963582311408,10
0.2,2691,92,206706,76.7852897473997,9
0.2,2692,95,206801,76.79205347196435,6
0.2,2693,23,206824,76.7720861172977,9
0.2,2694,93,206917,76.77810760667903,8
0.2,2695,93,207010,76.78412462908013,8
0.2,2696,90,207100,76.7890248424175,11
0.2,2697,95,207195,76.79577464788733,6
0.2,2698,95,207290,76.80251945164876,6
0.2,2699,95,207385,76.80925925925926,7
0.2,2700,94,207479,76.8156238430211,8
0.2,2701,88,207567,76.819763138416,13
0.2,2702,91,207658,76.82500924898261,10
0.2,2703,95,207753,76.83173076923077,6
0.2,2704,92,207845,76.83733826247689,9
0.2,2705,92,207937,76.8429416112343,10
0.2,2706,94,208031,76.84927964536386,7
0.2,2707,94,208125,76.8556129985229,7
0.2,2708,-44,208081,76.8110003691399,8
0.2,2709,90,208171,76.81586715867158,11
0.2,2710,94,208265,76.82220582810771,7
0.2,2711,89,208354,76.82669616519173,12
0.2,2712,95,208449,76.83339476594176,6
0.2,2713,92,208541,76.83898305084746,9
0.2,2714,96,208637,76.84604051565377,6
0.2,2715,-61,208576,76.79528718703976,25
0.2,2716,17,208593,76.77327935222672,15
0.2,2717,94,208687,76.77961736571008,8
0.2,2718,-48,208639,76.73372563442442,11
0.2,2719,95,208734,76.74044117647058,6
0.2,2720,94,208828,76.74678427048879,7
0.2,2721,90,208918,76.75165319617928,11
0.2,2722,93,209011,76.7576202717591,8
0.2,2723,17,209028,76.73568281938326,15
0.2,2724,91,209119,76.74091743119266,10
0.2,2725,20,209139,76.72010271460015,13
0.2,2726,93,209232,76.72607260726073,8
0.2,2727,94,209326,76.73240469208211,7
0.2,2728,95,209421,76.7390985709051,7
0.2,2729,88,209509,76.74322344322344,13
0.2,2730,90,209599,76.74807762724276,11
0.2,2731,91,209690,76.75329428989751,10
0.2,2732,93,209783,76.75923893157702,8
0.2,2733,90,209873,76.76408193123629,11
0.2,2734,89,209962,76.76855575868373,12
0.2,2735,92,210054,76.77412280701755,9
0.2,2736,96,210150,76.7811472415053,6
0.2,2737,93,210243,76.78707085463843,8
0.2,2738,23,210266,76.767433369843,9
0.2,2739,96,210362,76.77445255474453,6
0.2,2740,85,210447,76.77745348412988,16
0.2,2741,92,210539,76.78300510576221,9
0.2,2742,91,210630,76.78818811520233,11
0.2,2743,20,210650,76.76749271137027,12
0.2,2744,84,210734,76.77012750455373,17
0.2,2745,91,210825,76.77530954115076,10
0.2,2746,86,210911,76.77866763742264,15
0.2,2747,94,211005,76.7849344978166,7
0.2,2748,92,211097,76.79046926154966,11
0.2,2749,89,211186,76.79490909090909,13
0.2,2750,95,211281,76.80152671755725,6
0.2,2751,93,211374,76.80741279069767,8
0.2,2752,93,211467,76.81329458772248,8
0.2,2753,90,211557,76.81808278867102,11
0.2,2754,89,211646,76.82250453720508,12
0.2,2755,25,211671,76.80370101596516,8
0.2,2756,22,211693,76.78382299601016,10
0.2,2757,19,211712,76.76287164612037,13
0.2,2758,90,211802,76.76766944545125,12
0.2,2759,22,211824,76.74782608695652,10
0.2,2760,22,211846,76.72799710249909,10
0.2,2761,92,211938,76.73352643012309,9
0.2,2762,22,211960,76.7137169743033,10
0.2,2763,92,212052,76.71924746743849,9
0.2,2764,96,212148,76.72622061482821,6
0.2,2765,90,212238,76.73101952277658,11
0.2,2766,91,212329,76.73617636429346,10
0.2,2767,92,212421,76.74169075144509,9
0.2,2768,92,212513,76.74720115565187,9
0.2,2769,95,212608,76.75379061371841,6
0.2,2770,96,212704,76.76073619631902,6
0.2,2771,92,212796,76.76623376623377,9
0.2,2772,27,212823,76.74828705373243,7
0.2,2773,91,212914,76.75342465753425,10
0.2,2774,95,213009,76.76,7
0.2,2775,94,213103,76.76621037463977,7
0.2,2776,94,213197,76.77241627655744,7
0.2,2777,25,213222,76.7537796976242,9
0.2,2778,89,213311,76.75818639798489,12
0.2,2779,94,213405,76.76438848920863,8
0.2,2780,95,213500,76.77094570298453,6
0.2,2781,22,213522,76.75125808770669,10
0.2,2782,96,213618,76.75817463169241,6
0.2,2783,93,213711,76.76400862068965,8
0.2,2784,18,213729,76.74290843806104,16
0.2,2785,16,213745,76.72110552763819,16
0.2,2786,91,213836,76.72622891998564,10
0.2,2787,96,213932,76.73314203730273,6
0.2,2788,94,214026,76.73933309429903,8
0.2,2789,91,214117,76.74444444444444,10
0.2,2790,91,214208,76.74955213185238,10
0.2,2791,91,214299,76.75465616045845,10
0.2,2792,26,214325,76.73648406731114,7
0.2,2793,19,214344,76.71581961345741,15
0.2,2794,90,214434,76.72057245080501,12
0.2,2795,94,214528,76.72675250357653,7
0.2,2796,94,214622,76.73292813728996,7
0.2,2797,95,214717,76.73945675482487,7
0.2,2798,95,214812,76.7459807073955,6
0.2,2799,95,214907,76.7525,6
0.2,2800,93,215000,76.7583006069261,8
0.2,2801,93,215093,76.76409707351891,8
0.2,2802,94,215187,76.7702461648234,7
0.2,2803,94,215281,76.77639087018545,9
0.2,2804,23,215304,76.75721925133689,10
0.2,2805,22,215326,76.73770491803279,10
0.2,2806,18,215344,76.71677947987175,14
0.2,2807,94,215438,76.72293447293447,8
0.2,2808,95,215533,76.72944108223567,7
0.2,2809,94,215627,76.7355871886121,7
0.2,2810,25,215652,76.7171824973319,9
0.2,2811,93,215745,76.72297297297297,8
0.2,2812,90,215835,76.72769285460363,12
0.2,2813,95,215930,76.73418621179815,7
0.2,2814,92,216022,76.73960923623446,9
0.2,2815,91,216113,76.74467329545455,10
0.2,2816,94,216207,76.75079872204473,7
0.2,2817,94,216301,76.7569198012775,7
0.2,2818,-60,216241,76.70840723660872,24
0.2,2819,96,216337,76.71524822695035,6
0.2,2820,93,216430,76.72102091456931,8
0.2,2821,91,216521,76.72608079376329,11
0.2,2822,94,216615,76.73219978746015,7
0.2,2823,95,216710,76.73866855524079,7
0.2,2824,94,216804,76.74477876106195,8
0.2,2825,95,216899,76.75123849964615,6
0.2,2826,89,216988,76.75557127697205,12
0.2,2827,91,217079,76.7606082036775,10
0.2,2828,19,217098,76.74019088016968,13
0.2,2829,90,217188,76.74487632508834,11
0.2,2830,95,217283,76.75132462027553,6
0.2,2831,93,217376,76.75706214689265,8
0.2,2832,95,217471,76.76350158842217,6
0.2,2833,95,217566,76.76993648553281,6
0.2,2834,91,217657,76.77495590828924,10
0.2,2835,94,217751,76.78102961918195,7
0.2,2836,94,217845,76.78709904829044,8
0.2,2837,95,217940,76.79351656095842,6
0.2,2838,95,218035,76.79992955265939,7
0.2,2839,22,218057,76.78063380281691,10
0.2,2840,92,218149,76.78599084829285,9
0.2,2841,95,218244,76.7923997185081,6
0.2,2842,25,218269,76.77418220189941,8
0.2,2843,94,218363,76.78023909985936,7
0.2,2844,87,218450,76.78383128295255,14
0.2,2845,92,218542,76.78917779339423,9
0.2,2846,94,218636,76.79522304179838,8
0.2,2847,95,218731,76.80161516853933,7
0.2,2848,91,218822,76.80659880659881,10
0.2,2849,92,218914,76.8119298245614,9
0.2,2850,92,219006,76.81725710277095,9
0.2,2851,94,219100,76.82328190743338,7
0.2,2852,91,219191,76.82825096389764,10
0.2,2853,95,219286,76.83461807988787,6
0.2,2854,93,219379,76.84028021015762,8
0.2,2855,92,219471,76.84558823529412,9
0.2,2856,92,219563,76.85089254462723,9
0.2,2857,91,219654,76.85584324702589,10
0.2,2858,90,219744,76.8604407135362,11
0.2,2859,83,219827,76.86258741258742,18
0.2,2860,18,219845,76.8420132820692,14
0.2,2861,91,219936,76.84696016771488,10
0.2,2862,94,220030,76.85295144952846,8
0.2,2863,94,220124,76.85893854748603,7
0.2,2864,93,220217,76.86457242582897,8
0.2,2865,89,220306,76.86880669923238,12
0.2,2866,96,220402,76.87547959539589,6
0.2,2867,94,220496,76.88145048814505,7
0.2,2868,95,220591,76.88776577204601,7
0.2,2869,94,220685,76.89372822299651,7
0.2,2870,93,220778,76.89933820968304,9
0.2,2871,92,220870,76.90459610027855,9
0.2,2872,85,220955,76.90741385311522,16
0.2,2873,91,221046,76.91231732776617,10
0.2,2874,85,221131,76.91513043478261,16
0.2,2875,96,221227,76.92176634214186,6
0.2,2876,93,221320,76.92735488355926,8
0.2,2877,95,221415,76.93363446838082,6
0.2,2878,89,221504,76.93782563390066,12
0.2,2879,91,221595,76.94270833333333,10
0.2,2880,96,221691,76.94932315168344,6
0.2,2881,96,221787,76.9559333795975,6
0.2,2882,92,221879,76.96115157821714,10
0.2,2883,26,221905,76.94348127600554,8
0.2,2884,95,222000,76.94974003466204,6
0.2,2885,94,222094,76.95564795564796,7
0.2,2886,95,222189,76.96189816418428,7
0.2,2887,21,222210,76.94252077562327,11
0.2,2888,96,222306,76.9491173416407,7
0.2,2889,21,222327,76.92975778546713,11
0.2,2890,96,222423,76.93635420269803,6
0.2,2891,89,222512,76.94052558782849,14
0.2,2892,94,222606,76.94642239889389,8
0.2,2893,86,222692,76.94955079474775,15
0.2,2894,93,222785,76.95509499136442,10
0.2,2895,25,222810,76.9371546961326,8
0.2,2896,94,222904,76.94304452882292,9
0.2,2897,92,222996,76.94824016563147,9
0.2,2898,95,223091,76.95446705760607,6
0.2,2899,89,223180,76.95862068965518,12
0.2,2900,16,223196,76.93760772147536,17
0.2,2901,94,223290,76.9434872501723,8
0.2,2902,94,223384,76.9493627282122,7
0.2,2903,92,223476,76.95454545454545,10
0.2,2904,23,223499,76.93597246127366,10
0.2,2905,93,223592,76.94150034411562,8
0.2,2906,24,223616,76.92328861369108,8
0.2,2907,92,223708,76.92847317744155,9
0.2,2908,94,223802,76.93434169817807,7
0.2,2909,94,223896,76.940206185567,7
0.2,2910,92,223988,76.94537959464101,9
0.2,2911,94,224082,76.95123626373626,7
0.2,2912,94,224176,76.9570889117748,8
0.2,2913,96,224272,76.96362388469458,6
0.2,2914,91,224363,76.96843910806174,10
0.2,2915,95,224458,76.97462277091907,6
0.2,2916,96,224554,76.98114501199863,6
0.2,2917,94,224648,76.98697738176834,7
0.2,2918,95,224743,76.99314833847208,6
0.2,2919,82,224825,76.99486301369863,19
0.2,2920,93,224918,77.00034234851078,8
0.2,2921,96,225014,77.00684462696783,6
0.2,2922,92,225106,77.01197399931577,10
0.2,2923,22,225128,76.99316005471957,10
0.2,2924,21,225149,76.9740170940171,12
0.2,2925,89,225238,76.97812713602187,13
0.2,2926,83,225321,76.98018448923813,18
0.2,2927,92,225413,76.98531420765028,9
0.2,2928,23,225436,76.96688289518607,9
0.2,2929,90,225526,76.97133105802048,12
0.2,2930,94,225620,76.97714090754009,7
0.2,2931,94,225714,76.98294679399727,7
0.2,2932,94,225808,76.98874872144562,7
0.2,2933,93,225901,76.99420586230403,8
0.2,2934,15,225916,76.97308347529813,18
0.2,2935,25,225941,76.95538147138964,8
0.2,2936,89,226030,76.95948246510044,12
0.2,2937,93,226123,76.96494213750852,10
0.2,2938,93,226216,76.97039809459,8
0.2,2939,91,226307,76.97517006802721,11
0.2,2940,94,226401,76.98095885753145,7
0.2,2941,96,226497,76.987423521414,6
0.2,2942,93,226590,76.99286442405709,8
0.2,2943,96,226686,76.9993206521739,6
0.2,2944,20,226706,76.97996604414261,13
0.2,2945,94,226800,76.9857433808554,7
0.2,2946,94,226894,76.99151679674245,7
0.2,2947,92,226986,76.99660786974219,9
0.2,2948,87,227073,77.0,14
0.2,2949,25,227098,76.98237288135593,7
0.2,2950,89,227187,76.98644527278888,12
0.2,2951,90,227277,76.99085365853658,11
0.2,2952,91,227368,76.99559769725703,10
0.2,2953,94,227462,77.00135409614083,7
0.2,2954,24,227486,76.9834179357022,8
0.2,2955,89,227575,76.98748308525033,12
0.2,2956,92,227667,76.99256002705445,9
0.2,2957,94,227761,76.99830966869506,7
0.2,2958,91,227852,77.00304156809733,10
0.2,2959,90,227942,77.00743243243244,11
0.2,2960,25,227967,76.98986828774063,8
0.2,2961,87,228054,76.9932478055368,14
0.2,2962,94,228148,76.99898751265609,7
0.2,2963,95,228243,77.00506072874494,6
0.2,2964,91,228334,77.00978077571669,10
0.2,2965,23,228357,76.99157113958192,9
0.2,2966,92,228449,76.99662959218065,10
0.2,2967,95,228544,77.00269541778975,7
0.2,2968,85,228629,77.00538901987201,16
0.2,2969,81,228710,77.006734006734,20
0.2,2970,94,228804,77.01245371928644,7
0.2,2971,91,228895,77.0171601615074,10
0.2,2972,91,228986,77.0218634376051,10
0.2,2973,93,229079,77.02723604572965,8
0.2,2974,93,229172,77.03260504201681,8
0.2,2975,90,229262,77.03696236559139,12
0.2,2976,94,229356,77.04266039637218,7
0.2,2977,95,229451,77.04869039623908,6
0.2,2978,95,229546,77.05471634776771,6
0.2,2979,18,229564,77.03489932885905,15
0.2,2980,94,229658,77.04059040590406,7
0.2,2981,94,229752,77.04627766599597,7
0.2,2982,90,229842,77.0506201810258,12
0.2,2983,95,229937,77.05663538873995,7
0.2,2984,95,230032,77.06264656616415,6
0.2,2985,25,230057,77.04521098459477,7
0.2,2986,94,230151,77.05088717777033,7
0.2,2987,93,230244,77.05622489959839,8
0.2,2988,96,230340,77.06256273001004,6
0.2,2989,89,230429,77.06655518394649,12
0.2,2990,93,230522,77.07188231360749,8
0.2,2991,95,230617,77.0778743315508,7
0.2,2992,22,230639,77.05947210157034,10
0.2,2993,92,230731,77.06446225784903,10
0.2,2994,88,230819,77.06811352253756,13
0.2,2995,95,230914,77.07409879839787,6
0.2,2996,93,231007,77.07941274607941,8
0.2,2997,94,231101,77.08505670446965,8
0.2,2998,90,231191,77.08936312104035,11
0.2,2999,93,231284,77.09466666666667,8
0.2,3000,87,231371,77.09796734421859,16
0.2,3001,20,231391,77.07894736842105,12
0.2,3002,93,231484,77.08424908424908,8
0.2,3003,94,231578,77.08988015978694,8
0.2,3004,91,231669,77.09450915141431,10
0.2,3005,90,231759,77.09880239520957,11
0.2,3006,95,231854,77.10475557033588,6
0.2,3007,93,231947,77.11003989361703,8
0.2,3008,21,231968,77.09139248919907,12
0.2,3009,91,232059,77.09601328903655,10
0.2,3010,92,232151,77.10096313517104,10
0.2,3011,90,232241,77.10524568393095,11
0.2,3012,26,232267,77.0882841022237,8
0.2,3013,91,232358,77.092899800929,10
0.2,3014,94,232452,77.09850746268657,7
0.2,3015,94,232546,77.10411140583554,8
0.2,3016,94,232640,77.10971163407358,8
0.2,3017,92,232732,77.11464546056992,9
0.2,3018,95,232827,77.12056972507453,6
0.2,3019,94,232921,77.12615894039735,7
0.2,3020,93,233014,77.13141343925852,8
0.2,3021,26,233040,77.114493712773,6
0.2,3022,93,233133,77.11974859411181,8
0.2,3023,19,233152,77.1005291005291,13
0.2,3024,91,233243,77.10512396694214,10
0.2,3025,94,233337,77.11070720423001,8
0.2,3026,91,233428,77.11529567228278,10
0.2,3027,94,233522,77.12087186261559,7
0.2,3028,94,233616,77.12644437107956,7
0.2,3029,94,233710,77.13201320132013,7
0.2,3030,96,233806,77.1382382052128,6
0.2,3031,92,233898,77.14313984168865,9
0.2,3032,23,233921,77.12528849324102,10
0.2,3033,92,234013,77.13019116677653,9
0.2,3034,94,234107,77.13574958813838,7
0.2,3035,95,234202,77.14163372859025,6
0.2,3036,92,234294,77.1465261771485,9
0.2,3037,95,234389,77.15240289664253,7
0.2,3038,91,234480,77.15695952615992,13
0.2,3039,92,234572,77.16184210526316,10
0.2,3040,93,234665,77.16705031239724,9
0.2,3041,92,234757,77.17192636423405,9
0.2,3042,25,234782,77.15478146565889,8
0.2,3043,94,234876,77.16031537450722,7
0.2,3044,91,234967,77.1648604269294,10
0.2,3045,95,235062,77.17071569271175,6
0.2,3046,22,235084,77.15260912372825,10
0.2,3047,24,235108,77.13517060367454,8
0.2,3048,27,235135,77.11872745162349,6
0.2,3049,96,235231,77.12491803278688,6
0.2,3050,96,235327,77.13110455588331,6
0.2,3051,21,235348,77.11271297509829,11
0.2,3052,94,235442,77.11824434981985,7
0.2,3053,94,235536,77.1237721021611,7
0.2,3054,95,235631,77.12962356792144,6
0.2,3055,24,235655,77.11223821989529,8
0.2,3056,88,235743,77.11579980372915,13
0.2,3057,94,235837,77.12132112491825,7
0.2,3058,94,235931,77.12683883622098,7
0.2,3059,93,236024,77.13202614379085,9
0.2,3060,93,236117,77.13721006207122,9
0.2,3061,23,236140,77.11952971913782,9
0.2,3062,96,236236,77.12569376428338,8
0.2,3063,93,236329,77.13087467362924,9
0.2,3064,91,236420,77.13539967373572,11
0.2,3065,93,236513,77.14057403783431,8
0.2,3066,92,236605,77.14541897619824,9
0.2,3067,93,236698,77.15058670143416,8
0.2,3068,95,236793,77.1564027370479,6
0.2,3069,91,236884,77.16091205211727,10
0.2,3070,96,236980,77.16704656463692,6
0.2,3071,90,237070,77.17122395833333,11
0.2,3072,92,237162,77.17604946306541,9
0.2,3073,92,237254,77.18087182823683,9
0.2,3074,92,237346,77.18569105691057,10
0.2,3075,94,237440,77.19115734720417,7
0.2,3076,91,237531,77.19564510887228,10
0.2,3077,93,237624,77.20077972709552,9
0.2,3078,95,237719,77.20656057161416,7
0.2,3079,96,237815,77.21266233766234,6
0.2,3080,21,237836,77.19441739694905,11
0.2,3081,94,237930,77.19987021414666,7
0.2,3082,94,238024,77.20531949399935,7
0.2,3083,95,238119,77.21108949416342,6
0.2,3084,92,238211,77.2158833063209,9
0.2,3085,17,238228,77.19637070641608,15
0.2,3086,93,238321,77.20149011985747,8
0.2,3087,94,238415,77.20693005181347,7
0.2,3088,94,238509,77.21236646163807,7
0.2,3089,93,238602,77.21747572815534,8
0.2,3090,94,238696,77.22290520867033,7
0.2,3091,94,238790,77.22833117723157,8
0.2,3092,94,238884,77.2337536372454,7
0.2,3093,92,238976,77.23852617970265,9
0.2,3094,94,239070,77.24394184168013,7
0.2,3095,92,239162,77.24870801033592,9
0.2,3096,93,239255,77.25379399418793,8
0.2,3097,96,239351,77.25984506132988,6
0.2,3098,92,239443,77.2646014843498,9
0.2,3099,90,239533,77.26870967741935,11
0.2,3100,94,239627,77.27410512737826,7
0.2,3101,92,239719,77.27885235332045,9
0.2,3102,92,239811,77.28359651949727,10
0.2,3103,23,239834,77.26610824742268,10
0.2,3104,88,239922,77.2695652173913,13
0.2,3105,92,240014,77.27430779137154,9
0.2,3106,96,240110,77.28033472803347,6
0.2,3107,94,240204,77.28571428571429,7
0.2,3108,94,240298,77.29109038275973,7
0.2,3109,91,240389,77.29549839228295,10
0.2,3110,96,240485,77.30151076824173,6
0.2,3111,96,240581,77.30751928020565,6
0.2,3112,96,240677,77.31352393189849,6
0.2,3113,92,240769,77.31824020552344,10
0.2,3114,95,240864,77.3239165329053,7
0.2,3115,89,240953,77.32766367137356,12
0.2,3116,95,241048,77.33333333333333,6
0.2,3117,95,241143,77.33899935856319,6
0.2,3118,89,241232,77.34273805706957,12
0.2,3119,96,241328,77.34871794871795,6
0.2,3120,87,241415,77.35181031720603,14
0.2,3121,91,241506,77.35618193465727,10
0.2,3122,95,241601,77.36183157220621,6
0.2,3123,92,241693,77.36651728553137,9
0.2,3124,25,241718,77.34976,8
0.2,3125,94,241812,77.35508637236084,8
0.2,3126,24,241836,77.33802366485449,9
0.2,3127,88,241924,77.34143222506394,16
0.2,3128,-48,241876,77.30137424097155,11
0.2,3129,92,241968,77.30607028753994,9
0.2,3130,93,242061,77.31108272117534,8
0.2,3131,94,242155,77.31641123882503,7
0.2,3132,94,242249,77.32173635493137,8
0.2,3133,94,242343,77.32705807275048,7
0.2,3134,-55,242288,77.28484848484848,19
0.2,3135,89,242377,77.28858418367346,12
0.2,3136,94,242471,77.29391138029965,8
0.2,3137,91,242562,77.29827915869981,10
0.2,3138,96,242658,77.30423701815864,6
0.2,3139,93,242751,77.30923566878981,9
0.2,3140,92,242843,77.31391276663483,10
0.2,3141,93,242936,77.31890515595163,10
0.2,3142,89,243025,77.32262169901368,12
0.2,3143,87,243112,77.32569974554707,14
0.2,3144,92,243204,77.33036565977743,9
0.2,3145,92,243296,77.33502860775587,9
0.2,3146,84,243380,77.33714648871941,17
0.2,3147,93,243473,77.34212198221093,8
0.2,3148,94,243567,77.34741187678628,9
0.2,3149,90,243657,77.35142857142857,11
0.2,3150,90,243747,77.3554427165979,12
0.2,3151,94,243841,77.3607233502538,8
0.2,3152,13,243854,77.34031081509673,20
0.2,3153,91,243945,77.34464172479392,10
0.2,3154,92,244037,77.34928684627575,10
0.2,3155,94,244131,77.35456273764258,8
0.2,3156,95,244226,77.36015204307887,7
0.2,3157,18,244244,77.34135528815706,14
0.2,3158,-118,244126,77.27951883507438,13
0.2,3159,94,244220,77.28481012658227,8
0.2,3160,94,244314,77.29009807023094,7
0.2,3161,21,244335,77.27229601518026,11
0.2,3162,86,244421,77.275055327221,15
0.2,3163,89,244510,77.27876106194691,12
0.2,3164,93,244603,77.28372827804107,8
0.2,3165,94,244697,77.28900821225521,7
0.2,3166,15,244712,77.26934006946637,17
0.2,3167,93,244805,77.27430555555556,8
0.2,3168,24,244829,77.25749447775324,8
0.2,3169,14,244843,77.23753943217666,18
0.2,3170,89,244932,77.24124881740775,12
0.2,3171,91,245023,77.24558638083228,10
0.2,3172,94,245117,77.25086668767727,7
0.2,3173,96,245213,77.25677378701954,7
0.2,3174,95,245308,77.26236220472441,6
0.2,3175,93,245401,77.26731738035265,8
0.2,3176,94,245495,77.2725841989298,8
0.2,3177,95,245590,77.27816236626809,7
0.2,3178,91,245681,77.28247876690783,10
0.2,3179,90,245771,77.28647798742138,12
0.2,3180,-130,245641,77.22131405218485,24
0.2,3181,95,245736,77.22690131992458,6
0.2,3182,94,245830,77.23217090794847,7
0.2,3183,92,245922,77.23680904522612,9
0.2,3184,92,246014,77.2414442700157,9
0.2,3185,95,246109,77.24701820464533,7
0.2,3186,88,246197,77.2503922183872,13
0.2,3187,91,246288,77.2547051442911,10
0.2,3188,95,246383,77.26026967701473,7
0.2,3189,94,246477,77.26551724137931,7
0.2,3190,96,246573,77.2713882795362,6
0.2,3191,94,246667,77.2766290726817,7
0.2,3192,93,246760,77.28155339805825,8
0.2,3193,92,246852,77.28616155291171,10
0.2,3194,94,246946,77.29139280125196,7
0.2,3195,93,247039,77.29630788485608,8
0.2,3196,25,247064,77.27994995308102,7
0.2,3197,93,247157,77.2848655409631,8
0.2,3198,93,247250,77.28977805564239,10
0.2,3199,94,247344,77.295,7
0.2,3200,93,247437,77.29990627928773,8
0.2,3201,91,247528,77.30418488444722,10
0.2,3202,87,247615,77.30721198876054,15
0.2,3203,91,247706,77.31148564294632,10
0.2,3204,-45,247661,77.27332293291731,9
0.2,3205,89,247750,77.27698066126014,12
0.2,3206,95,247845,77.28250701590271,6
0.2,3207,91,247936,77.28678304239402,11
0.2,3208,93,248029,77.29167965098162,8
0.2,3209,95,248124,77.29719626168225,6
0.2,3210,20,248144,77.27935222672065,12
0.2,3211,96,248240,77.2851805728518,6
0.2,3212,95,248335,77.29069405539994,6
0.2,3213,92,248427,77.29527069072806,10
0.2,3214,96,248523,77.30108864696734,6
0.2,3215,95,248618,77.30659203980099,6
0.2,3216,91,248709,77.31084861672366,10
0.2,3217,20,248729,77.29303915475451,12
0.2,3218,94,248823,77.2982292637465,7
0.2,3219,94,248917,77.30341614906833,8
0.2,3220,95,249012,77.3089102763117,6
0.2,3221,93,249105,77.31378026070763,9
0.2,3222,93,249198,77.31864722308408,8
0.2,3223,96,249294,77.32444168734492,6
0.2,3224,96,249390,77.33023255813953,6
0.2,3225,92,249482,77.33477991320521,9
0.2,3226,96,249578,77.34056399132321,6
0.2,3227,93,249671,77.34541511771995,8
0.2,3228,94,249765,77.35057293279654,7
0.2,3229,92,249857,77.35510835913313,9
0.2,3230,95,249952,77.36056948313215,6
0.2,3231,21,249973,77.34313118811882,11
0.2,3232,94,250067,77.34828332817817,7
0.2,3233,18,250085,77.32993197278911,14
0.2,3234,94,250179,77.33508500772797,8
0.2,3235,94,250273,77.3402348578492,7
0.2,3236,89,250362,77.34383688600556,12
0.2,3237,91,250453,77.34805435453984,10
0.2,3238,23,250476,77.33127508490274,9
0.2,3239,95,250571,77.33672839506173,6
0.2,3240,93,250664,77.34156124652885,10
0.2,3241,96,250760,77.347316471314,6
0.2,3242,90,250850,77.35121800801727,11
0.2,3243,91,250941,77.35542540073983,11
0.2,3244,92,251033,77.35993836671803,9
0.2,3245,92,251125,77.36444855206408,9
0.2,3246,23,251148,77.34770557437635,10
0.2,3247,24,251172,77.33128078817734,9
0.2,3248,94,251266,77.33641120344721,7
0.2,3249,92,251358,77.34092307692308,9
0.2,3250,92,251450,77.34543217471547,9
0.2,3251,88,251538,77.34870848708488,14
0.2,3252,95,251633,77.35413464494313,6
0.2,3253,96,251729,77.359864781807,7
0.2,3254,77,251806,77.35975422427035,24
0.2,3255,96,251902,77.36547911547912,6
0.2,3256,94,251996,77.37058642922935,7
0.2,3257,96,252092,77.37630448127686,6
0.2,3258,89,252181,77.3798711261123,14
0.2,3259,94,252275,77.38496932515338,7
0.2,3260,95,252370,77.39037105182459,7
0.2,3261,19,252389,77.37247087676272,13
0.2,3262,94,252483,77.37756665645112,7
0.2,3263,94,252577,77.38265931372548,7
0.2,3264,94,252671,77.38774885145483,8
0.2,3265,95,252766,77.3931414574403,6
0.2,3266,94,252860,77.39822467095195,7
0.2,3267,25,252885,77.38219094247246,8
0.2,3268,96,252981,77.38788620373202,6
0.2,3269,96,253077,77.39357798165138,7
0.2,3270,94,253171,77.39865484561297,7
0.2,3271,96,253267,77.40433985330074,6
0.2,3272,19,253286,77.38649556981363,14
0.2,3273,93,253379,77.39126450824679,10
0.2,3274,95,253474,77.39664122137404,6
0.2,3275,23,253497,77.38003663003663,9
0.2,3276,89,253586,77.38358254501068,12
0.2,3277,92,253678,77.38804148871263,9
0.2,3278,90,253768,77.39188777066178,12
0.2,3279,22,253790,77.375,10
0.2,3280,90,253880,77.37884791222189,11
0.2,3281,95,253975,77.3842169408897,6
0.2,3282,88,254063,77.38745050258909,13
0.2,3283,21,254084,77.37028014616321,11
0.2,3284,93,254177,77.37503805175038,10
0.2,3285,92,254269,77.37948874010955,9
0.2,3286,94,254363,77.38454517797383,7
0.2,3287,94,254457,77.38959854014598,8
0.2,3288,94,254551,77.39464882943143,7
0.2,3289,21,254572,77.37750759878419,11
0.2,3290,91,254663,77.38164691583106,10
0.2,3291,89,254752,77.38517618469015,12
0.2,3292,96,254848,77.39082903127847,6
0.2,3293,92,254940,77.39526411657559,9
0.2,3294,94,255034,77.40030349013657,7
0.2,3295,95,255129,77.4056432038835,6
0.2,3296,93,255222,77.41037306642403,9
0.2,3297,92,255314,77.41479684657368,9
0.2,3298,94,255408,77.41982418914823,7
0.2,3299,91,255499,77.42393939393939,11
0.2,3300,91,255590,77.4280521054226,10
0.2,3301,91,255681,77.43216232586312,10
0.2,3302,93,255774,77.43687556766575,8
0.2,3303,91,255865,77.44098062953995,10
0.2,3304,27,255892,77.42571860816945,6
0.2,3305,93,255985,77.43042952208107,8
0.2,3306,89,256074,77.43392803144845,12
0.2,3307,91,256165,77.43802902055623,10
0.2,3308,91,256256,77.44212753097612,10
0.2,3309,94,256350,77.44712990936556,7
0.2,3310,93,256443,77.45182724252491,8
0.2,3311,94,256537,77.45682367149759,7
0.2,3312,92,256629,77.46121340175068,9
0.2,3313,95,256724,77.46650573325287,8
0.2,3314,94,256818,77.47149321266969,7
0.2,3315,16,256834,77.45295536791315,16
0.2,3316,95,256929,77.45824540247212,7
0.2,3317,95,257024,77.46353224834237,7
0.2,3318,90,257114,77.46730943055137,11
0.2,3319,95,257209,77.47259036144578,6
0.2,3320,24,257233,77.45648900933453,8
0.2,3321,91,257324,77.46056592414209,11
0.2,3322,94,257418,77.46554318387,7
0.2,3323,90,257508,77.46931407942239,11
0.2,3324,93,257601,77.47398496240602,8
0.2,3325,92,257693,77.4783523752255,9
0.2,3326,94,257787,77.48331830477908,7
0.2,3327,90,257877,77.48707932692308,11
0.2,3328,94,257971,77.49203965154702,7
0.2,3329,93,258064,77.4966966966967,8
0.2,3330,89,258153,77.50015010507356,12
0.2,3331,94,258247,77.50510204081633,7
0.2,3332,92,258339,77.50945094509451,9
0.2,3333,95,258434,77.51469706058788,6
0.2,3334,93,258527,77.51934032983509,8
0.2,3335,89,258616,77.52278177458034,12
0.2,3336,94,258710,77.5277195085406,7
0.2,3337,92,258802,77.53205512282804,9
0.2,3338,95,258897,77.53728661275831,7
0.2,3339,95,258992,77.54251497005988,7
0.2,3340,93,259085,77.54714157437893,8
0.2,3341,24,259109,77.53111909036505,8
0.2,3342,89,259198,77.53454980556387,12
0.2,3343,94,259292,77.53947368421052,7
0.2,3344,94,259386,77.54439461883408,8
0.2,3345,95,259481,77.54961147638971,6
0.2,3346,94,259575,77.55452644158949,7
0.2,3347,94,259669,77.5594384707288,7
0.2,3348,92,259761,77.56375037324574,9
0.2,3349,21,259782,77.5468656716418,13
0.2,3350,94,259876,77.5517755893763,7
0.2,3351,15,259891,77.53311455847255,19
0.2,3352,92,259983,77.53742916790934,9
0.2,3353,91,260074,77.54144305307096,10
0.2,3354,92,260166,77.54575260804769,11
0.2,3355,93,260259,77.55035756853397,8
0.2,3356,95,260354,77.55555555555556,6
0.2,3357,90,260444,77.55926146515783,11
0.2,3358,93,260537,77.56385829115808,8
0.2,3359,96,260633,77.56934523809524,6
0.2,3360,93,260726,77.57393632847366,8
0.2,3361,95,260821,77.57911957168352,6
0.2,3362,92,260913,77.58340767172167,9
0.2,3363,85,260998,77.58561236623068,16
0.2,3364,95,261093,77.59078751857355,8
0.2,3365,94,261187,77.5956625074272,7
0.2,3366,15,261202,77.57707157707158,17
0.2,3367,94,261296,77.58194774346794,7
0.2,3368,91,261387,77.58593054318789,10
0.2,3369,94,261481,77.59080118694362,8
0.2,3370,96,261577,77.59626223672501,6
0.2,3371,96,261673,77.60172004744959,6
0.2,3372,94,261767,77.60658167803143,7
0.2,3373,95,261862,77.61173681090693,6
0.2,3374,95,261957,77.6168888888889,6
0.2,3375,95,262052,77.62203791469194,7
0.2,3376,94,262146,77.62688777021025,7
0.2,3377,93,262239,77.63143872113676,8
0.2,3378,94,262333,77.63628292394199,7
0.2,3379,90,262423,77.63994082840237,11
0.2,3380,95,262518,77.64507542147294,7
0.2,3381,-55,262463,77.60585452395033,19
0.2,3382,91,262554,77.60981377475613,10
0.2,3383,95,262649,77.61495271867612,6
0.2,3384,96,262745,77.62038404726735,6
0.2,3385,94,262839,77.62522150029534,7
0.2,3386,22,262861,77.60879834661942,10
0.2,3387,95,262956,77.61393152302243,6
0.2,3388,94,263050,77.61876659781646,7
0.2,3389,94,263144,77.623598820059,7
0.2,3390,95,263239,77.62872309053377,6
0.2,3391,93,263332,77.63325471698113,9
0.2,3392,95,263427,77.63837312113174,6
0.2,3393,85,263512,77.6405421331762,16
0.2,3394,89,263601,77.6438880706922,12
0.2,3395,92,263693,77.64811542991755,9
0.2,3396,96,263789,77.65351780983221,6
0.2,3397,94,263883,77.65832842848735,7
0.2,3398,95,263978,77.66343042071198,6
0.2,3399,92,264070,77.66764705882353,9
0.2,3400,93,264163,77.67215524845633,8
0.2,3401,94,264257,77.67695473251028,7
0.2,3402,23,264280,77.66088745224802,9
0.2,3403,95,264375,77.66598119858989,7
0.2,3404,23,264398,77.64992657856094,9
0.2,3405,91,264489,77.65384615384616,11
0.2,3406,92,264581,77.65805694159084,9
0.2,3407,24,264605,77.64231220657277,9
0.2,3408,93,264698,77.64681724845995,8
0.2,3409,94,264792,77.65161290322581,7
0.2,3410,93,264885,77.6561125769569,9
0.2,3411,94,264979,77.66090269636577,7
0.2,3412,95,265074,77.66598300615294,6
0.2,3413,92,265166,77.67018160515525,10
0.2,3414,90,265256,77.67379209370425,11
0.2,3415,93,265349,77.67827868852459,8
0.2,3416,17,265366,77.66052092478783,15
0.2,3417,95,265461,77.66559391456993,6
0.2,3418,96,265557,77.67095642000585,6
0.2,3419,93,265650,77.67543859649123,8
0.2,3420,96,265746,77.68079508915521,7
0.2,3421,96,265842,77.68614845119814,6
0.2,3422,96,265938,77.69149868536371,6
0.2,3423,23,265961,77.67552570093459,9
0.2,3424,23,265984,77.65956204379562,10
0.2,3425,93,266077,77.66403969643899,9
0.2,3426,95,266172,77.66909833673768,6
0.2,3427,95,266267,77.67415402567094,6
0.2,3428,95,266362,77.67920676582094,7
0.2,3429,92,266454,77.68338192419824,9
0.2,3430,90,266544,77.68697172835908,11
0.2,3431,87,266631,77.68968531468532,14
0.2,3432,91,266722,77.69356248179434,10
0.2,3433,91,266813,77.6974373907979,10
0.2,3434,91,266904,77.70131004366812,10
0.2,3435,93,266997,77.70576251455181,8
0.2,3436,91,267088,77.70963049170788,10
0.2,3437,94,267182,77.71436881908086,7
0.2,3438,94,267276,77.71910439081128,7
0.2,3439,96,267372,77.72441860465116,6
0.2,3440,20,267392,77.70764312699797,16
0.2,3441,93,267485,77.71208599651365,8
0.2,3442,95,267580,77.71710717397619,7
0.2,3443,20,267600,77.70034843205575,12
0.2,3444,93,267693,77.70478955007258,9
0.2,3445,91,267784,77.70864770748695,10
0.2,3446,96,267880,77.71395416304033,6
0.2,3447,94,267974,77.71867749419954,7
0.2,3448,94,268068,77.72339808640186,7
0.2,3449,86,268154,77.72579710144927,15
0.2,3450,91,268245,77.72964358157056,10
0.2,3451,92,268337,77.7337775202781,9
0.2,3452,91,268428,77.73761946133797,11
0.2,3453,94,268522,77.74232773595831,7
0.2,3454,95,268617,77.74732272069464,6
0.2,3455,95,268712,77.75231481481481,7
0.2,3456,23,268735,77.7364767139138,10
0.2,3457,90,268825,77.74002313475998,12
0.2,3458,90,268915,77.74356750505926,12
0.2,3459,26,268941,77.72861271676301,7
0.2,3460,92,269033,77.73273620340942,9
0.2,3461,92,269125,77.7368573079145,9
0.2,3462,94,269219,77.74155356627202,7
0.2,3463,93,269312,77.7459584295612,8
0.2,3464,92,269404,77.75007215007216,9
0.2,3465,92,269496,77.75418349682631,9
0.2,3466,21,269517,77.73781367176232,11
0.2,3467,91,269608,77.74163783160323,10
0.2,3468,93,269701,77.74603632170654,8
0.2,3469,89,269790,77.7492795389049,12
0.2,3470,88,269878,77.75223278594065,13
0.2,3471,24,269902,77.73675115207374,9
0.2,3472,93,269995,77.74114598329975,8
0.2,3473,85,270080,77.74323546344272,16
0.2,3474,96,270176,77.74848920863309,6
0.2,3475,93,270269,77.75287686996548,9
0.2,3476,91,270360,77.75668679896462,10
0.2,3477,94,270454,77.76135710178264,8
0.2,3478,96,270550,77.76659959758551,6
0.2,3479,94,270644,77.77126436781609,7
0.2,3480,91,270735,77.77506463659869,10
0.2,3481,92,270827,77.77914991384262,9
0.2,3482,93,270920,77.78351995406258,9
0.2,3483,21,270941,77.76722158438577,11
0.2,3484,92,271033,77.77130559540889,9
0.2,3485,91,271124,77.77510040160642,11
0.2,3486,92,271216,77.77917981072555,9
0.2,3487,92,271308,77.78325688073394,10
0.2,3488,96,271404,77.78847807394669,6
0.2,3489,88,271492,77.79140401146132,13
0.2,3490,94,271586,77.79604697794328,7
0.2,3491,18,271604,77.77892325315005,14
0.2,3492,96,271700,77.7841397079874,6
0.2,3493,89,271789,77.78734974241557,12
0.2,3494,94,271883,77.79198855507869,7
0.2,3495,96,271979,77.79719679633867,6
0.2,3496,89,272068,77.80040034315127,12
0.2,3497,90,272158,77.8038879359634,11
0.2,3498,93,272251,77.80823092312089,8
0.2,3499,24,272275,77.79285714285714,8
0.2,3500,87,272362,77.79548700371322,15
0.2,3501,94,272456,77.80011422044547,9
0.2,3502,92,272548,77.80416785612333,9
0.2,3503,94,272642,77.8087899543379,7
0.2,3504,92,272734,77.81283880171183,9
0.2,3505,92,272826,77.81688533941814,9
0.2,3506,94,272920,77.821499857428,8
0.2,3507,95,273015,77.8263968072976,6
0.2,3508,94,273109,77.831005984611,7
0.2,3509,21,273130,77.81481481481481,11
0.2,3510,21,273151,77.79863286812873,11
0.2,3511,95,273246,77.80353075170842,6
0.2,3512,91,273337,77.80728721890122,10
0.2,3513,91,273428,77.81104154809334,10
0.2,3514,96,273524,77.81621621621622,6
0.2,3515,93,273617,77.82053469852104,9
0.2,3516,88,273705,77.82342905885697,14
0.2,3517,92,273797,77.82745878339966,9
0.2,3518,95,273892,77.8323387325945,6
0.2,3519,87,273979,77.83494318181818,15
0.2,3520,94,274073,77.83953422323204,7
0.2,3521,94,274167,77.84412265758093,7
0.2,3522,90,274257,77.84757309111552,11
0.2,3523,91,274348,77.85130533484677,10
0.2,3524,95,274443,77.85617021276596,6
0.2,3525,95,274538,77.86103233125354,7
0.2,3526,-53,274485,77.82392968528494,20
0.2,3527,94,274579,77.82851473922902,7
0.2,3528,95,274674,77.83338056106545,7
0.2,3529,96,274770,77.83852691218131,6
0.2,3530,94,274864,77.84310393656187,7
0.2,3531,96,274960,77.84824462061155,6
0.2,3532,23,274983,77.83272006793094,10
0.2,3533,96,275079,77.83786078098473,6
0.2,3534,91,275170,77.84158415841584,10
0.2,3535,95,275265,77.84643665158372,6
0.2,3536,94,275359,77.85100367543116,7
0.2,3537,17,275376,77.83380440927077,16
0.2,3538,95,275471,77.83865498728454,6
0.2,3539,91,275562,77.84237288135593,10
0.2,3540,95,275657,77.84721829991528,6
0.2,3541,96,275753,77.85234330886504,6
0.2,3542,87,275840,77.85492520462884,14
0.2,3543,95,275935,77.85976297968398,6
0.2,3544,91,276026,77.86346967559943,10
0.2,3545,96,276122,77.86858432036097,6
0.2,3546,92,276214,77.87256836763463,10
0.2,3547,94,276308,77.8771138669673,10
0.2,3548,91,276399,77.88081149619612,11
0.2,3549,94,276493,77.88535211267606,7
0.2,3550,94,276587,77.8898901717826,7
0.2,3551,94,276681,77.89442567567568,7
0.2,3552,93,276774,77.89867717421897,9
0.2,3553,94,276868,77.90320765334835,8
0.2,3554,95,276963,77.90801687763712,6
0.2,3555,25,276988,77.89313835770528,8
0.2,3556,85,277073,77.89513635085747,16
0.2,3557,95,277168,77.8999437886453,7
0.2,3558,95,277263,77.90474852486653,6
0.2,3559,91,277354,77.90842696629214,11
0.2,3560,93,277447,77.9126649817467,8
0.2,3561,96,277543,77.9177428411005,6
0.2,3562,92,277635,77.9216952006736,9
0.2,3563,90,277725,77.92508417508418,11
0.2,3564,93,277818,77.92931276297335,8
0.2,3565,94,277912,77.93381940549635,7
0.2,3566,-54,277858,77.896832071769,17
0.2,3567,93,277951,77.90106502242152,8
0.2,3568,92,278043,77.90501541047912,9
0.2,3569,93,278136,77.90924369747898,8
0.2,3570,86,278222,77.91150938112574,15
0.2,3571,95,278317,77.91629339305712,6
0.2,3572,94,278411,77.92079485026588,7
0.2,3573,93,278504,77.92501398992725,8
0.2,3574,96,278600,77.93006993006993,6
0.2,3575,93,278693,77.9342841163311,8
0.2,3576,95,278788,77.93905507408442,6
0.2,3577,91,278879,77.94270542202348,10
0.2,3578,93,278972,77.94691254540375,8
0.2,3579,21,278993,77.93100558659218,11
0.2,3580,93,279086,77.93521362747836,8
0.2,3581,95,279181,77.93997766610832,6
0.2,3582,94,279275,77.94445994976277,7
0.2,3583,93,279368,77.94866071428571,8
0.2,3584,90,279458,77.95202231520223,12
0.2,3585,94,279552,77.95649749023983,7
0.2,3586,92,279644,77.96041260105937,9
0.2,3587,25,279669,77.94565217391305,8
0.2,3588,21,279690,77.92978545555866,11
0.2,3589,11,279701,77.91114206128134,21
0.2,3590,90,279791,77.91450849345586,11
0.2,3591,94,279885,77.91898663697104,7
0.2,3592,94,279979,77.9234622877818,7
0.2,3593,94,280073,77.92793544796884,7
0.2,3594,94,280167,77.93240611961058,7
0.2,3595,96,280263,77.93743047830924,6
0.2,3596,88,280351,77.9402279677509,13
0.2,3597,93,280444,77.9444135630906,8
0.2,3598,95,280539,77.94915254237289,6
0.2,3599,91,280630,77.95277777777778,10
0.2,3600,92,280722,77.95667870036101,9
0.2,3601,94,280816,77.9611327040533,7
0.2,3602,91,280907,77.96475159589231,10
0.2,3603,93,281000,77.96892341842397,9
0.2,3604,91,281091,77.97253814147018,10
0.2,3605,95,281186,77.97726012201886,6
0.2,3606,89,281275,77.98031605212087,12
0.2,3607,90,281365,77.98364745011087,11
0.2,3608,90,281455,77.9869770019396,11
0.2,3609,94,281549,77.99141274238227,7
0.2,3610,95,281644,77.99612295762947,7
0.2,3611,94,281738,78.00055370985604,7
0.2,3612,90,281828,78.00387489620813,12
0.2,3613,94,281922,78.00830105146652,8
0.2,3614,92,282014,78.01217150760719,10
0.2,3615,87,282101,78.01465707964601,15
0.2,3616,95,282196,78.01935305501797,6
0.2,3617,92,282288,78.02321724709785,10
0.2,3618,94,282382,78.02763194252556,8
0.2,3619,91,282473,78.03121546961326,10
0.2,3620,-52,282421,77.99530516431925,15
0.2,3621,96,282517,78.0002760905577,6
0.2,3622,96,282613,78.00524427270219,6
0.2,3623,25,282638,77.99061810154525,8
0.2,3624,90,282728,77.99393103448276,12
0.2,3625,94,282822,77.99834528405957,7
0.2,3626,94,282916,78.0027570995313,7
0.2,3627,94,283010,78.00716648291069,7
0.2,3628,93,283103,78.01129787820337,8
0.2,3629,93,283196,78.01542699724519,8
0.2,3630,95,283291,78.02010465436518,6
0.2,3631,96,283387,78.02505506607929,6
0.2,3632,23,283410,78.00990916597853,9
0.2,3633,94,283504,78.01430930104569,7
0.2,3634,90,283594,78.01760660247592,12
0.2,3635,95,283689,78.02227722772277,8
0.2,3636,95,283784,78.0269452845752,7
0.2,3637,87,283871,78.02941176470588,14
0.2,3638,94,283965,78.03380049464138,8
0.2,3639,27,283992,78.01978021978022,6
0.2,3640,87,284079,78.02224663553969,14
0.2,3641,94,284173,78.02663371773751,7
0.2,3642,93,284266,78.03074389239637,8
0.2,3643,96,284362,78.03567508232712,6
0.2,3644,94,284456,78.0400548696845,9
0.2,3645,91,284547,78.04360943499725,10
0.2,3646,89,284636,78.04661365505895,13
0.2,3647,96,284732,78.0515350877193,6
0.2,3648,93,284825,78.05563167991231,9
0.2,3649,95,284920,78.06027397260274,6
0.2,3650,94,285014,78.06463982470557,7
0.2,3651,94,285108,78.06900328587075,7
0.2,3652,90,285198,78.07226936764303,11
0.2,3653,18,285216,78.05582922824303,14
0.2,3654,94,285310,78.06019151846785,7
0.2,3655,20,285330,78.04431072210066,13
0.2,3656,94,285424,78.04867377631939,7
0.2,3657,95,285519,78.05330781848005,7
0.2,3658,92,285611,78.05711943153867,10
0.2,3659,87,285698,78.05956284153005,14
0.2,3660,93,285791,78.0636438131658,8
0.2,3661,96,285887,78.06854178044784,6
0.2,3662,91,285978,78.07207207207207,10
0.2,3663,93,286071,78.07614628820961,8
0.2,3664,93,286164,78.08021828103684,8
0.2,3665,95,286259,78.08483360611021,7
0.2,3666,93,286352,78.08890100899919,8
0.2,3667,95,286447,78.09351145038168,6
0.2,3668,94,286541,78.09784682474789,8
0.2,3669,91,286632,78.10136239782017,11
0.2,3670,92,286724,78.10514846090983,10
0.2,3671,92,286816,78.10893246187364,9
0.2,3672,-48,286768,78.07459842090934,11
0.2,3673,93,286861,78.07866086009798,9
0.2,3674,95,286956,78.08326530612244,6
0.2,3675,94,287050,78.08759521218715,7
0.2,3676,95,287145,78.09219472395975,6
0.2,3677,96,287241,78.09706362153344,6
0.2,3678,91,287332,78.10057080728458,10
0.2,3679,93,287425,78.10461956521739,8
0.2,3680,94,287519,78.1089377886444,7
0.2,3681,90,287609,78.11216730038022,11
0.2,3682,94,287703,78.11648112951399,7
0.2,3683,94,287797,78.12079261672096,8
0.2,3684,87,287884,78.12320217096337,14
0.2,3685,94,287978,78.12750949538795,8
0.2,3686,94,288072,78.13181448331977,8
0.2,3687,19,288091,78.11578091106291,13
0.2,3688,95,288186,78.12035782054757,6
0.2,3689,92,288278,78.12411924119242,11
0.2,3690,18,288296,78.10782985640748,14
0.2,3691,94,288390,78.11213434452871,7
0.2,3692,22,288412,78.09694015705388,10
0.2,3693,94,288506,78.10124526258798,7
0.2,3694,89,288595,78.1041948579161,12
0.2,3695,93,288688,78.10822510822511,8
0.2,3696,92,288780,78.11198268866649,9
0.2,3697,94,288874,78.11627906976744,7
0.2,3698,19,288893,78.10029737766963,13
0.2,3699,90,288983,78.10351351351352,11
0.2,3700,93,289076,78.10753850310726,8
0.2,3701,91,289167,78.11102106969206,10
0.2,3702,95,289262,78.11558196057251,6
0.2,3703,92,289354,78.11933045356372,9
0.2,3704,92,289446,78.12307692307692,9
0.2,3705,92,289538,78.12682137075014,9
0.2,3706,20,289558,78.11114108443485,13
0.2,3707,92,289650,78.11488673139158,10
0.2,3708,21,289671,78.09948773254247,11
0.2,3709,87,289758,78.10188679245283,14
0.2,3710,90,289848,78.1050929668553,11
0.2,3711,19,289867,78.08917025862068,13
0.2,3712,95,289962,78.0937247508753,6
0.2,3713,93,290055,78.09773828756059,8
0.2,3714,25,290080,78.08344549125168,9
0.2,3715,93,290173,78.08745963401508,8
0.2,3716,94,290267,78.09174065106268,7
0.2,3717,95,290362,78.09628832705756,6
0.2,3718,95,290457,78.10083355740791,6
0.2,3719,94,290551,78.10510752688172,8
0.2,3720,95,290646,78.10964794410104,7
0.2,3721,94,290740,78.11391724879097,7
0.2,3722,96,290836,78.11872146118722,6
0.2,3723,95,290931,78.12325456498388,7
0.2,3724,93,291024,78.12724832214765,8
0.2,3725,94,291118,78.13150831991412,7
0.2,3726,96,291214,78.13630265629192,6
0.2,3727,84,291298,78.13787553648069,17
0.2,3728,96,291394,78.14266559399303,6
0.2,3729,90,291484,78.14584450402145,12
0.2,3730,84,291568,78.1474135620477,17
0.2,3731,94,291662,78.15166130760986,7
0.2,3732,25,291687,78.13742298419501,8
0.2,3733,96,291783,78.14220674879486,6
0.2,3734,92,291875,78.14591700133869,9
0.2,3735,20,291895,78.13035331905782,12
0.2,3736,95,291990,78.13486754080813,6
0.2,3737,94,292084,78.13911182450508,7
0.2,3738,91,292175,78.1425514843541,10
0.2,3739,90,292265,78.14572192513369,11
0.2,3740,89,292354,78.14862336273724,12
0.2,3741,27,292381,78.1349545697488,6
0.2,3742,91,292472,78.13839166444029,10
0.2,3743,90,292562,78.14155982905983,11
0.2,3744,25,292587,78.12736982643524,8
0.2,3745,91,292678,78.13080619327282,10
0.2,3746,92,292770,78.13450760608487,9
0.2,3747,91,292861,78.13794023479188,10
0.2,3748,92,292953,78.14163777007202,10
0.2,3749,94,293047,78.14586666666666,7
0.2,3750,94,293141,78.15009330845108,8
0.2,3751,91,293232,78.15351812366738,10
0.2,3752,95,293327,78.1580069277911,6
0.2,3753,96,293423,78.16275972296218,7
0.2,3754,94,293517,78.16697736351531,7
0.2,3755,96,293613,78.17172523961662,6
0.2,3756,91,293704,78.17513973915358,10
0.2,3757,92,293796,78.17881852048963,9
0.2,3758,94,293890,78.18302740090449,7
0.2,3759,91,293981,78.18643617021277,10
0.2,3760,94,294075,78.19064078702473,7
0.2,3761,95,294170,78.19510898458267,8
0.2,3762,95,294265,78.19957480733457,6
0.2,3763,96,294361,78.20430393198724,6
0.2,3764,93,294454,78.20823373173971,8
0.2,3765,92,294546,78.21189591078067,9
0.2,3766,90,294636,78.21502521900717,11
0.2,3767,93,294729,78.21894904458598,8
0.2,3768,89,294818,78.22180949854072,12
0.2,3769,90,294908,78.22493368700265,11
0.2,3770,94,295002,78.22911694510739,7
0.2,3771,19,295021,78.21341463414635,13
0.2,3772,-54,294967,78.1783726477604,17
0.2,3773,21,294988,78.16322204557498,11
0.2,3774,94,295082,78.16741721854305,7
0.2,3775,95,295177,78.171875,8
0.2,3776,94,295271,78.17606566057718,7
0.2,3777,89,295360,78.17893065113817,12
0.2,3778,94,295454,78.18311722677957,7
0.2,3779,93,295547,78.18703703703704,8
0.2,3780,91,295638,78.19042581327692,10
0.2,3781,18,295656,78.17451084082496,14
0.2,3782,92,295748,78.17816547713456,9
0.2,3783,96,295844,78.1828752642706,6
0.2,3784,88,295932,78.18546895640687,13
0.2,3785,92,296024,78.18911780243,9
0.2,3786,94,296118,78.19329284393979,7
0.2,3787,90,296208,78.19640971488913,11
0.2,3788,93,296301,78.20031670625495,8
0.2,3789,93,296394,78.20422163588391,8
0.2,3790,93,296487,78.20812450540754,8
0.2,3791,94,296581,78.21228902953587,7
0.2,3792,95,296676,78.21671500131822,6
0.2,3793,94,296770,78.22087506589352,8
0.2,3794,86,296856,78.22292490118578,17
0.2,3795,96,296952,78.22760800842993,6
0.2,3796,94,297046,78.23176191730313,7
0.2,3797,94,297140,78.23591363875724,7
0.2,3798,93,297233,78.23979994735457,8
0.2,3799,92,297325,78.24342105263158,9
0.2,3800,91,297416,78.24677716390424,10
0.2,3801,94,297510,78.25092056812204,7
0.2,3802,95,297605,78.25532474362346,6
0.2,3803,94,297699,78.25946372239747,7
0.2,3804,91,297790,78.26281208935612,10
0.2,3805,94,297884,78.26694692590647,7
0.2,3806,95,297979,78.27134226425007,7
0.2,3807,95,298074,78.27573529411765,6
0.2,3808,21,298095,78.26069834602258,11
0.2,3809,90,298185,78.26377952755905,11
0.2,3810,93,298278,78.26764628706377,9
0.2,3811,94,298372,78.27177334732424,9
0.2,3812,85,298457,78.2735378966693,16
0.2,3813,94,298551,78.27766124803357,7
0.2,3814,92,298643,78.28125819134993,9
0.2,3815,92,298735,78.28485324947589,9
0.2,3816,94,298829,78.28897039559864,7
0.2,3817,94,298923,78.29308538501833,8
0.2,3818,96,299019,78.29772191673213,6
0.2,3819,94,299113,78.30183246073298,7
0.2,3820,94,299207,78.30594085317979,8
0.2,3821,93,299300,78.3097854526426,8
0.2,3822,93,299393,78.31362804080565,8
0.2,3823,93,299486,78.31746861924687,8
0.2,3824,94,299580,78.32156862745099,7
0.2,3825,23,299603,78.30710925248302,9
0.2,3826,92,299695,78.31068722236739,9
0.2,3827,93,299788,78.31452455590387,9
0.2,3828,93,299881,78.31835988508749,8
0.2,3829,91,299972,78.32167101827676,10
0.2,3830,94,300066,78.3257635082224,7
0.2,3831,9,300075,78.30767223382045,23
0.2,3832,96,300171,78.31228802504566,6
0.2,3833,91,300262,78.31559728742828,10
0.2,3834,94,300356,78.31968709256844,7
0.2,3835,96,300452,78.32429614181439,6
0.2,3836,94,300546,78.32838154808444,7
0.2,3837,87,300633,78.33064095883273,14
0.2,3838,94,300727,78.33472258400626,10
0.2,3839,25,300752,78.32083333333334,7
0.2,3840,94,300846,78.32491538661807,7
0.2,3841,-55,300791,78.29021343050495,18
0.2,3842,94,300885,78.2943013270882,7
0.2,3843,93,300978,78.29812695109261,8
0.2,3844,19,300997,78.28270481144344,13
0.2,3845,93,301090,78.28653146125845,8
0.2,3846,93,301183,78.29035612165323,8
0.2,3847,88,301271,78.29287941787942,13
0.2,3848,90,301361,78.29592101844635,11
0.2,3849,23,301384,78.28155844155845,10
0.2,3850,90,301474,78.28460140223319,11
0.2,3851,92,301566,78.28816199376946,9
0.2,3852,96,301662,78.29275888917726,6
0.2,3853,26,301688,78.27919045147898,6
0.2,3854,95,301783,78.28352788586251,6
0.2,3855,23,301806,78.26919087136929,9
0.2,3856,23,301829,78.25486129115893,9
0.2,3857,95,301924,78.25920165889062,6
0.2,3858,93,302017,78.26302150816274,8
0.2,3859,95,302112,78.26735751295337,6
0.2,3860,90,302202,78.27039627039628,11
0.2,3861,91,302293,78.27369238736406,12
0.2,3862,12,302305,78.25653637069635,20
0.2,3863,90,302395,78.25957556935818,11
0.2,3864,25,302420,78.24579560155239,8
0.2,3865,91,302511,78.24909467149509,10
0.2,3866,94,302605,78.25316783035944,8
0.2,3867,95,302700,78.2574974146846,6
0.2,3868,96,302796,78.2620832256397,6
0.2,3869,93,302889,78.26589147286822,8
0.2,3870,93,302982,78.26969775251872,8
0.2,3871,93,303075,78.2735020661157,8
0.2,3872,92,303167,78.27704621740253,9
0.2,3873,90,303257,78.28007227671657,11
0.2,3874,90,303347,78.28309677419355,11
0.2,3875,93,303440,78.28689370485036,8
0.2,3876,96,303536,78.29146247098272,6
0.2,3877,89,303625,78.2942238267148,12
0.2,3878,93,303718,78.2980149523073,8
0.2,3879,-126,303592,78.24536082474226,20
0.2,3880,24,303616,78.23138366400413,8
0.2,3881,94,303710,78.23544564657394,7
0.2,3882,93,303803,78.23924800412053,8
0.2,3883,94,303897,78.24330587023687,7
0.2,3884,95,303992,78.24761904761905,7
0.2,3885,91,304083,78.25090066906846,10
0.2,3886,94,304177,78.25495240545408,7
0.2,3887,93,304270,78.25874485596708,8
0.2,3888,89,304359,78.26150681409102,13
0.2,3889,93,304452,78.26529562982005,8
0.2,3890,92,304544,78.26882549473143,9
0.2,3891,93,304637,78.27261048304214,8
0.2,3892,94,304731,78.27665039815052,7
0.2,3893,95,304826,78.28094504365691,6
0.2,3894,96,304922,78.28549422336329,6
0.2,3895,94,305016,78.28952772073922,7
0.2,3896,93,305109,78.29330254041571,8
0.2,3897,25,305134,78.27963057978451,8
0.2,3898,94,305228,78.28366247755835,8
0.2,3899,91,305319,78.28692307692307,10
0.2,3900,93,305412,78.29069469366829,8
0.2,3901,96,305508,78.29523321373655,6
0.2,3902,27,305535,78.28209069946195,6
0.2,3903,91,305626,78.28534836065573,10
0.2,3904,21,305647,78.27067861715749,11
0.2,3905,85,305732,78.27240143369175,16
0.2,3906,96,305828,78.27693882774507,6
0.2,3907,95,305923,78.28121801432958,6
0.2,3908,90,306013,78.28421591199795,11
0.2,3909,93,306106,78.28797953964194,9
0.2,3910,95,306201,78.29225262081309,6
0.2,3911,91,306292,78.29550102249489,10
0.2,3912,96,306388,78.30002555583951,6
0.2,3913,94,306482,78.30403679100664,7
0.2,3914,94,306576,78.30804597701149,7
0.2,3915,92,306668,78.31154239019408,9
0.2,3916,92,306760,78.31503701812612,10
0.2,3917,92,306852,78.31852986217459,9
0.2,3918,87,306939,78.32074508803267,14
0.2,3919,91,307030,78.32397959183673,10
0.2,3920,23,307053,78.30986993114001,9
0.2,3921,94,307147,78.31387047424784,7
0.2,3922,96,307243,78.31837879174101,6
0.2,3923,91,307334,78.32161060142711,10
0.2,3924,94,307428,78.3256050955414,7
0.2,3925,18,307446,78.31023942944472,16
0.2,3926,94,307540,78.31423478482301,7
0.2,3927,94,307634,78.31822810590631,7
0.2,3928,94,307728,78.3222193942479,7
0.2,3929,93,307821,78.32595419847328,8
0.2,3930,-50,307771,78.293309590435,13
0.2,3931,90,307861,78.29628687690743,11
0.2,3932,94,307955,78.30027968471904,7
0.2,3933,17,307972,78.2846975088968,15
0.2,3934,92,308064,78.2881829733164,10
0.2,3935,94,308158,78.29217479674797,7
0.2,3936,24,308182,78.27838455676911,9
0.2,3937,91,308273,78.28161503301168,11
0.2,3938,91,308364,78.28484386900229,10
0.2,3939,94,308458,78.28883248730965,7
0.2,3940,89,308547,78.29155036792692,12
0.2,3941,92,308639,78.29502790461694,9
0.2,3942,89,308728,78.29774283540452,13
0.2,3943,94,308822,78.30172413793103,7
0.2,3944,89,308911,78.30443599493029,13
0.2,3945,94,309005,78.30841358337557,7
0.2,3946,94,309099,78.31238915632126,7
0.2,3947,19,309118,78.29736575481256,13
0.2,3948,91,309209,78.30058242593061,10
0.2,3949,11,309220,78.28354430379747,21
0.2,3950,91,309311,78.2867628448494,11
0.2,3951,94,309405,78.29073886639677,10
0.2,3952,21,309426,78.27624588919808,12
0.2,3953,94,309520,78.28022255943348,7
0.2,3954,89,309609,78.28293299620734,13
0.2,3955,22,309631,78.26870576339738,10
0.2,3956,-117,309514,78.21935809957039,12
0.2,3957,95,309609,78.22359777665487,6
0.2,3958,93,309702,78.22733013387219,8
0.2,3959,23,309725,78.21338383838383,9
0.2,3960,93,309818,78.21711688967433,8
0.2,3961,91,309909,78.2203432609793,10
0.2,3962,90,309999,78.22331566994701,11
0.2,3963,92,310091,78.22679112008073,9
0.2,3964,18,310109,78.21160151324085,14
0.2,3965,95,310204,78.21583459404943,6
0.2,3966,92,310296,78.21930930173934,9
0.2,3967,21,310317,78.20488911290323,11
0.2,3968,87,310404,78.20710506424793,14
0.2,3969,94,310498,78.2110831234257,7
0.2,3970,96,310594,78.21556283052128,6
0.2,3971,93,310687,78.21928499496475,9
0.2,3972,90,310777,78.22225018877423,13
0.2,3973,96,310873,78.22672370407649,6
0.2,3974,20,310893,78.21207547169811,13
0.2,3975,92,310985,78.21554325955735,9
0.2,3976,91,311076,78.21875785768167,10
0.2,3977,88,311164,78.22121669180493,14
0.2,3978,92,311256,78.22467956773059,10
0.2,3979,92,311348,78.22814070351758,9
0.2,3980,90,311438,78.23109771414218,11
0.2,3981,95,311533,78.23530889000503,7
0.2,3982,94,311627,78.2392668842581,7
0.2,3983,91,311718,78.24246987951807,10
0.2,3984,92,311810,78.24592220828106,9
0.2,3985,95,311905,78.25012543903662,6
0.2,3986,90,311995,78.25307248557813,11
0.2,3987,92,312087,78.25651955867603,10
0.2,3988,95,312182,78.2607169716721,8
0.2,3989,94,312276,78.26466165413534,7
0.2,3990,-197,312079,78.19569030318216,22
0.2,3991,94,312173,78.1996492985972,8
0.2,3992,93,312266,78.20335587277737,8
0.2,3993,27,312293,78.19053580370556,6
0.2,3994,90,312383,78.19349186483105,11
0.2,3995,94,312477,78.19744744744744,7
0.2,3996,95,312572,78.20165123842882,6
0.2,3997,95,312667,78.20585292646324,6
0.2,3998,90,312757,78.20880220055014,12
0.2,3999,-56,312701,78.17525,20
0.2,4000,95,312796,78.17945513621595,8
0.2,4001,87,312883,78.18165917041479,15
0.2,4002,20,312903,78.16712465650762,12
0.2,4003,25,312928,78.15384615384616,8
0.2,4004,94,313022,78.15780274656679,7
0.2,4005,96,313118,78.16225661507738,6
0.2,4006,84,313202,78.1637135013726,17
0.2,4007,88,313290,78.16616766467065,13
0.2,4008,91,313381,78.16936891993015,10
0.2,4009,94,313475,78.17331670822942,7
0.2,4010,94,313569,78.17726252804786,7
0.2,4011,20,313589,78.16276171485544,12
0.2,4012,92,313681,78.1662098180912,10
0.2,4013,92,313773,78.1696562032885,9
0.2,4014,95,313868,78.17384806973848,6
0.2,4015,96,313964,78.17828685258964,6
0.2,4016,95,314059,78.18247448344536,6
0.2,4017,88,314147,78.18491786958685,14
0.2,4018,95,314242,78.18910176660862,6
0.2,4019,95,314337,78.19328358208955,6
0.2,4020,23,314360,78.17955732404874,9
0.2,4021,96,314456,78.18398806563899,6
0.2,4022,94,314550,78.18791946308725,7
0.2,4023,96,314646,78.19234592445328,6
0.2,4024,91,314737,78.19552795031056,11
0.2,4025,95,314832,78.19970193740686,6
0.2,4026,92,314924,78.2031288800596,9
0.2,4027,23,314947,78.18942403177756,11
0.2,4028,94,315041,78.1933482253661,7
0.2,4029,90,315131,78.19627791563275,11
0.2,4030,91,315222,78.19945422971968,11
0.2,4031,95,315317,78.20362103174604,6
0.2,4032,96,315413,78.20803372179519,6
0.2,4033,92,315505,78.21145265245414,9
0.2,4034,95,315600,78.21561338289963,6
0.2,4035,95,315695,78.21977205153617,6
0.2,4036,93,315788,78.22343324250681,9
0.2,4037,92,315880,78.2268449727588,9
0.2,4038,95,315975,78.23099777172567,7
0.2,4039,91,316066,78.23415841584159,10
0.2,4040,96,316162,78.23855481316505,6
0.2,4041,95,316257,78.24270163285502,6
0.2,4042,95,316352,78.24684640118724,6
0.2,4043,91,316443,78.25,10
0.2,4044,95,316538,78.25414091470952,6
0.2,4045,92,316630,78.25753830944143,9
0.2,4046,87,316717,78.25969854212997,14
0.2,4047,93,316810,78.26333992094861,8
0.2,4048,91,316901,78.26648555198814,10
0.2,4049,90,316991,78.26938271604938,11
0.2,4050,94,317085,78.27326586028141,7
0.2,4051,96,317181,78.27764067127345,6
0.2,4052,93,317274,78.28127313101406,8
0.2,4053,94,317368,78.28515046867291,8
0.2,4054,94,317462,78.28902589395808,7
0.2,4055,96,317558,78.29339250493096,6
0.2,4056,-52,317506,78.26127680552132,15
0.2,4057,83,317589,78.26244455396747,18
0.2,4058,96,317685,78.26681448632668,6
0.2,4059,26,317711,78.25394088669951,8
0.2,4060,23,317734,78.24033489288352,10
0.2,4061,91,317825,78.24347612013786,10
0.2,4062,95,317920,78.24760029534826,8
0.2,4063,91,318011,78.25073818897638,10
0.2,4064,93,318104,78.25436654366544,8
0.2,4065,91,318195,78.25750122970979,10
0.2,4066,93,318288,78.26112613720187,8
0.2,4067,92,318380,78.2645034414946,9
0.2,4068,92,318472,78.26787908577046,9
0.2,4069,23,318495,78.25429975429975,10
0.2,4070,86,318581,78.25620240727095,15
0.2,4071,95,318676,78.26031434184677,6
0.2,4072,94,318770,78.26417873803094,8
0.2,4073,94,318864,78.26804123711341,7
0.2,4074,95,318959,78.2721472392638,6
0.2,4075,92,319051,78.27551521099117,11
0.2,4076,91,319142,78.27863625214619,10
0.2,4077,95,319237,78.28273663560569,6
0.2,4078,95,319332,78.28683500858054,6
0.2,4079,90,319422,78.28970588235295,11
0.2,4080,93,319515,78.29331046312178,8
0.2,4081,94,319609,78.29715825575698,7
0.2,4082,94,319703,78.30100416360519,7
0.2,4083,94,319797,78.30484818805093,7
0.2,4084,16,319813,78.28959608323133,16
0.2,4085,95,319908,78.29368575624082,8
0.2,4086,22,319930,78.27991191583068,11
0.2,4087,93,320023,78.28351272015655,8
0.2,4088,94,320117,78.28735632183908,8
0.2,4089,95,320212,78.29144254278728,6
0.2,4090,93,320305,78.29503788804693,8
0.2,4091,94,320399,78.29887585532747,8
0.2,4092,22,320421,78.28512093818715,11
0.2,4093,93,320514,78.28871519296531,8
0.2,4094,23,320537,78.27521367521368,9
0.2,4095,88,320625,78.277587890625,13
0.2,4096,92,320717,78.28093727117403,9
0.2,4097,94,320811,78.28477306002928,8
0.2,4098,94,320905,78.28860697731155,7
0.2,4099,94,320999,78.29243902439025,7
0.2,4100,94,321093,78.29626920263351,9
0.2,4101,94,321187,78.30009751340809,7
0.2,4102,92,321279,78.30343650987082,9
0.2,4103,90,321369,78.30628654970761,11
0.2,4104,85,321454,78.30791717417783,17
0.2,4105,94,321548,78.31173891865562,7
0.2,4106,18,321566,78.29705381056732,14
0.2,4107,90,321656,78.29990262901656,11
0.2,4108,95,321751,78.3039669019226,7
0.2,4109,95,321846,78.30802919708029,6
0.2,4110,88,321934,78.31038676720992,13
0.2,4111,96,322030,78.31468871595331,6
0.2,4112,96,322126,78.3189885728179,6
0.2,4113,18,322144,78.30432668935343,14
0.2,4114,93,322237,78.30789793438639,8
0.2,4115,21,322258,78.29397473275024,13
0.2,4116,91,322349,78.29706096672334,10
0.2,4117,-116,322233,78.24987858183584,12
0.2,4118,21,322254,78.23597960670065,11
0.2,4119,21,322275,78.22208737864078,11
0.2,4120,96,322371,78.22640135889347,6
0.2,4121,92,322463,78.22974284327996,9
0.2,4122,92,322555,78.23308270676692,9
0.2,4123,93,322648,78.23666343355966,8
0.2,4124,94,322742,78.24048484848485,7
0.2,4125,92,322834,78.24381968007755,9
0.2,4126,87,322921,78.245941361764,15
0.2,4127,91,323012,78.24903100775194,10
0.2,4128,95,323107,78.25308791474933,6
0.2,4129,93,323200,78.25665859564165,8
0.2,4130,93,323293,78.26022754780925,8
0.2,4131,96,323389,78.26452081316553,6
0.2,4132,23,323412,78.25114928623276,9
0.2,4133,89,323501,78.25374939525882,12
0.2,4134,93,323594,78.25731559854897,9
0.2,4135,11,323605,78.24105415860735,22
0.2,4136,18,323623,78.22649262750785,14
0.2,4137,88,323711,78.22885451909134,13
0.2,4138,91,323802,78.23194008214544,10
0.2,4139,-50,323752,78.20096618357488,13
0.2,4140,94,323846,78.20478145375513,7
0.2,4141,93,323939,78.20835345243843,8
0.2,4142,96,324035,78.21264783972967,6
0.2,4143,16,324051,78.19763513513513,16
0.2,4144,93,324144,78.20120627261761,8
0.2,4145,93,324237,78.20477568740955,8
0.2,4146,93,324330,78.20834338075717,8
0.2,4147,24,324354,78.19527483124398,8
0.2,4148,-118,324236,78.14798746685949,12
0.2,4149,91,324327,78.1510843373494,10
0.2,4150,20,324347,78.13707540351723,12
0.2,4151,92,324439,78.14041425818883,9
0.2,4152,24,324463,78.12737779918132,9
0.2,4153,24,324487,78.11434761675494,8
0.2,4154,92,324579,78.11768953068592,9
0.2,4155,92,324671,78.12102983638114,11
0.2,4156,90,324761,78.12388741881165,11
0.2,4157,92,324853,78.12722462722462,10
0.2,4158,94,324947,78.1310411156528,8
0.2,4159,-50,324897,78.10024038461539,14
0.2,4160,92,324989,78.10358086998318,9
0.2,4161,96,325085,78.10788082652572,6
0.2,4162,26,325111,78.09536392024982,7
0.2,4163,27,325138,78.08309317963497,6
0.2,4164,87,325225,78.08523409363745,14
0.2,4165,93,325318,78.08881421027364,9
0.2,4166,94,325412,78.09263258939285,8
0.2,4167,26,325438,78.08013435700576,7
0.2,4168,96,325534,78.0844327176781,6
0.2,4169,22,325556,78.07098321342926,11
0.2,4170,94,325650,78.07480220570606,7
0.2,4171,90,325740,78.07766059443912,11
0.2,4172,93,325833,78.08123652048886,8
0.2,4173,92,325925,78.08457115476762,9
0.2,4174,83,326008,78.08574850299401,18
0.2,4175,91,326099,78.08884099616859,10
0.2,4176,-46,326053,78.05913334929375,10
0.2,4177,95,326148,78.06318812829105,7
0.2,4178,95,326243,78.06724096673845,6
0.2,4179,87,326330,78.06937799043062,14
0.2,4180,91,326421,78.07247070078928,10
0.2,4181,93,326514,78.07604017216643,8
0.2,4182,95,326609,78.08008606263448,6
0.2,4183,94,326703,78.08389101338432,7
0.2,4184,18,326721,78.06953405017921,14
0.2,4185,27,326748,78.05733397037744,6
0.2,4186,89,326837,78.0599474564127,13
0.2,4187,94,326931,78.06375358166189,7
0.2,4188,92,327023,78.06708044879446,9
0.2,4189,88,327111,78.06945107398568,14
0.2,4190,94,327205,78.07325220711047,7
0.2,4191,89,327294,78.07585877862596,12
0.2,4192,96,327390,78.08013355592655,6
0.2,4193,95,327485,78.08416785884597,6
0.2,4194,93,327578,78.08772348033374,8
0.2,4195,94,327672,78.09151572926596,7
0.2,4196,96,327768,78.09578270192995,6
0.2,4197,92,327860,78.09909480705097,9
0.2,4198,92,327952,78.10240533460347,9
0.2,4199,92,328044,78.10571428571428,9
0.2,4200,92,328136,78.10902166150916,9
0.2,4201,15,328151,78.09400285578296,18
0.2,4202,94,328245,78.09778729478944,7
0.2,4203,94,328339,78.10156993339676,7
0.2,4204,94,328433,78.10535077288942,7
0.2,4205,95,328528,78.10936757013789,6
0.2,4206,90,328618,78.11219396244354,11
0.2,4207,93,328711,78.1157319391635,8
0.2,4208,88,328799,78.11808030411024,13
0.2,4209,90,328889,78.1209026128266,11
0.2,4210,94,328983,78.12467347423414,8
0.2,4211,20,329003,78.11087369420703,12
0.2,4212,93,329096,78.11440778542607,11
0.2,4213,92,329188,78.11770289511153,9
0.2,4214,95,329283,78.12170818505338,6
0.2,4215,94,329377,78.12547438330171,7
0.2,4216,95,329472,78.12947593075646,6
0.2,4217,95,329567,78.133475580844,6
0.2,4218,96,329663,78.13771035790472,6
0.2,4219,96,329759,78.14194312796208,6
0.2,4220,96,329855,78.14617389244255,6
0.2,4221,94,329949,78.14992894362861,7
0.2,4222,95,330044,78.1539190149183,6
0.2,4223,88,330132,78.15625,13
0.2,4224,91,330223,78.1592899408284,10
0.2,4225,-54,330169,78.12801703738761,17
0.2,4226,15,330184,78.11308256446652,17
0.2,4227,94,330278,78.11684011352885,8
0.2,4228,27,330305,78.10475289666587,6
0.2,4229,94,330399,78.10851063829787,7
0.2,4230,90,330489,78.11132120066178,11
0.2,4231,96,330585,78.11554820415878,7
0.2,4232,93,330678,78.11906449326719,8
0.2,4233,94,330772,78.12281530467642,7
0.2,4234,94,330866,78.12656434474616,8
0.2,4235,90,330956,78.12936732766761,11
0.2,4236,92,331048,78.13264101958933,9
0.2,4237,15,331063,78.11774421897121,17
0.2,4238,96,331159,78.12196272705827,6
0.2,4239,96,331255,78.12617924528301,6
0.2,4240,25,331280,78.11365244046216,8
0.2,4241,94,331374,78.11739745403112,7
0.2,4242,20,331394,78.10370021211408,12
0.2,4243,96,331490,78.10791705937794,6
0.2,4244,94,331584,78.11166077738515,8
0.2,4245,21,331605,78.09821008007536,11
0.2,4246,94,331699,78.10195432069696,7
0.2,4247,91,331790,78.10499058380414,10
0.2,4248,21,331811,78.09155095316545,11
0.2,4249,22,331833,78.07835294117648,10
0.2,4250,92,331925,78.08162785227006,9
0.2,4251,85,332010,78.0832549388523,17
0.2,4252,91,332101,78.08629202915589,10
0.2,4253,95,332196,78.09026798307475,6
0.2,4254,92,332288,78.09353701527614,10
0.2,4255,89,332377,78.09609962406014,12
0.2,4256,96,332473,78.10030537937514,6
0.2,4257,88,332561,78.10263034288398,13
0.2,4258,96,332657,78.10683258980981,6
0.2,4259,93,332750,78.11032863849765,8
0.2,4260,94,332844,78.11405773292654,7
0.2,4261,89,332933,78.11661191928673,12
0.2,4262,-44,332889,78.08796622097115,8
0.2,4263,94,332983,78.09169793621012,8
0.2,4264,94,333077,78.09542790152403,7
0.2,4265,94,333171,78.09915611814345,7
0.2,4266,96,333267,78.10335130067963,6
0.2,4267,96,333363,78.10754451733833,6
0.2,4268,-49,333314,78.0777699695479,13
0.2,4269,94,333408,78.08149882903982,7
0.2,4270,94,333502,78.08522594240225,8
0.2,4271,91,333593,78.08824906367042,10
0.2,4272,91,333684,78.09127076995085,10
0.2,4273,92,333776,78.09452503509593,9
0.2,4274,93,333869,78.09801169590644,8
0.2,4275,90,333959,78.10079513564078,11
0.2,4276,93,334052,78.10427870002339,8
0.2,4277,24,334076,78.09163160355307,8
0.2,4278,94,334170,78.09534938069642,9
0.2,4279,92,334262,78.09859813084113,9
0.2,4280,93,334355,78.10207895351553,8
0.2,4281,92,334447,78.10532461466605,9
0.2,4282,95,334542,78.10926920382909,6
0.2,4283,22,334564,78.09617180205416,10
0.2,4284,92,334656,78.09941656942824,9
0.2,4285,89,334745,78.10195986934204,12
0.2,4286,89,334834,78.10450198273851,12
0.2,4287,19,334853,78.09071828358209,13
0.2,4288,94,334947,78.09442760550245,7
0.2,4289,24,334971,78.08181818181818,8
0.2,4290,94,335065,78.08552784898625,7
0.2,4291,85,335150,78.08713886300093,16
0.2,4292,92,335242,78.09037968786396,9
0.2,4293,92,335334,78.09361900326036,10
0.2,4294,92,335426,78.09685681024447,9
0.2,4295,95,335521,78.100791433892,7
0.2,4296,90,335611,78.10356062369095,13
0.2,4297,95,335706,78.10749185667753,7
0.2,4298,94,335800,78.11118864852291,7
0.2,4299,94,335894,78.11488372093024,7
0.2,4300,93,335987,78.11834457103,8
0.2,4301,89,336076,78.1208740120874,13
0.2,4302,24,336100,78.10829653729955,8
0.2,4303,94,336194,78.11198884758365,7
0.2,4304,-49,336145,78.08246225319397,12
0.2,4305,92,336237,78.08569437993498,10
0.2,4306,94,336331,78.08938936614813,7
0.2,4307,20,336351,78.0759052924791,12
0.2,4308,20,336371,78.06242747737294,12
0.2,4309,94,336465,78.06612529002321,7
0.2,4310,95,336560,78.07005335189051,7
0.2,4311,92,336652,78.07328385899814,9
0.2,4312,94,336746,78.07697658242523,7
0.2,4313,94,336840,78.08066759388039,7
0.2,4314,20,336860,78.06720741599074,12
0.2,4315,94,336954,78.07089898053754,7
0.2,4316,93,337047,78.07435719249479,8
0.2,4317,95,337142,78.07827698008337,6
0.2,4318,90,337232,78.08103727714749,11
0.2,4319,89,337321,78.08356481481482,12
0.2,4320,94,337415,78.08724832214764,8
0.2,4321,92,337507,78.09046737621472,9
0.2,4322,95,337602,78.09437890353921,6
0.2,4323,90,337692,78.09713228492137,12
0.2,4324,94,337786,78.10080924855491,7
0.2,4325,25,337811,78.08853444290338,8
0.2,4326,-46,337765,78.05985671365842,10
0.2,4327,91,337856,78.06284658040666,10
0.2,4328,96,337952,78.06699006699007,6
0.2,4329,89,338041,78.06951501154734,12
0.2,4330,92,338133,78.07273147079196,9
0.2,4331,94,338227,78.0764081255771,7
0.2,4332,94,338321,78.08008308331411,7
0.2,4333,91,338412,78.08306414397785,10
0.2,4334,93,338505,78.08650519031141,8
0.2,4335,95,338600,78.09040590405904,6
0.2,4336,94,338694,78.09407424486973,7
0.2,4337,95,338789,78.0979714153988,6
0.2,4338,95,338884,78.10186678958286,6
0.2,4339,95,338979,78.1057603686636,7
0.2,4340,93,339072,78.10919143054596,8
0.2,4341,95,339167,78.1130815292492,8
0.2,4342,91,339258,78.11604881418374,12
0.2,4343,91,339349,78.11901473296501,10
0.2,4344,92,339441,78.12220943613349,10
0.2,4345,95,339536,78.1260929590428,6
0.2,4346,93,339629,78.12951460777548,9
0.2,4347,19,339648,78.11591536338547,13
0.2,4348,21,339669,78.10278224879282,11
0.2,4349,96,339765,78.10689655172413,6
0.2,4350,94,339859,78.11054929901172,8
0.2,4351,21,339880,78.09742647058823,12
0.2,4352,93,339973,78.10084998851367,8
0.2,4353,92,340065,78.10404225999082,9
0.2,4354,93,340158,78.10746268656716,9
0.2,4355,91,340249,78.11042240587695,10
0.2,4356,25,340274,78.09823272894194,8
0.2,4357,91,340365,78.10119320789353,10
0.2,4358,94,340459,78.10484055976141,7
0.2,4359,91,340550,78.10779816513761,10
0.2,4360,91,340641,78.1107544141252,10
0.2,4361,87,340728,78.11279229711141,15
0.2,4362,91,340819,78.11574604629841,10
0.2,4363,93,340912,78.11915673693859,8
0.2,4364,94,341006,78.12279495990836,8
0.2,4365,94,341100,78.12643151626203,9
0.2,4366,94,341194,78.1300664071445,7
0.2,4367,94,341288,78.13369963369964,7
0.2,4368,93,341381,78.13710231174181,8
0.2,4369,92,341473,78.14027459954234,9
0.2,4370,89,341562,78.14275909402883,12
0.2,4371,95,341657,78.14661482159195,6
0.2,4372,93,341750,78.15001143379831,9
0.2,4373,91,341841,78.15294924554183,10
0.2,4374,95,341936,78.1568,6
0.2,4375,90,342026,78.15950639853747,11
0.2,4376,90,342116,78.16221156042951,11
0.2,4377,88,342204,78.16445865692097,14
0.2,4378,95,342299,78.16830326558575,7
0.2,4379,19,342318,78.15479452054795,13
0.2,4380,22,342340,78.14197671764437,10
0.2,4381,93,342433,78.14536741214057,8
0.2,4382,92,342525,78.14852840520192,9
0.2,4383,94,342619,78.15214416058394,7
0.2,4384,95,342714,78.15598631698974,8
0.2,4385,93,342807,78.1593707250342,8
0.2,4386,93,342900,78.16275359015272,8
0.2,4387,91,342991,78.16567912488605,10
0.2,4388,-55,342936,78.13533834586467,18
0.2,4389,94,343030,78.13895216400911,7
0.2,4390,93,343123,78.14233659758597,9
0.2,4391,18,343141,78.12864298724955,15
0.2,4392,91,343232,78.13157295697701,11
0.2,4393,96,343328,78.13563950842057,6
0.2,4394,88,343416,78.13788395904437,15
0.2,4395,23,343439,78.12534121929026,10
0.2,4396,95,343534,78.12917898567206,8
0.2,4397,85,343619,78.13074124602092,16
0.2,4398,94,343713,78.13434871561718,8
0.2,4399,94,343807,78.13795454545455,8
0.2,4400,95,343902,78.14178595773687,6
0.2,4401,90,343992,78.14447978191731,11
0.2,4402,91,344083,78.14739950034068,10
0.2,4403,93,344176,78.15077202543142,8
0.2,4404,95,344271,78.15459704880817,7
0.2,4405,95,344366,78.15842033590559,7
0.2,4406,95,344461,78.16224188790561,6
0.2,4407,-49,344412,78.13339382940109,14
0.2,4408,91,344503,78.13631208890905,10
0.2,4409,-49,344454,78.10748299319728,12
0.2,4410,94,344548,78.11108592155973,7
0.2,4411,19,344567,78.09768812330009,13
0.2,4412,90,344657,78.1003852254702,11
0.2,4413,95,344752,78.10421386497508,6
0.2,4414,90,344842,78.10690826727067,11
0.2,4415,96,344938,78.11096014492753,6
0.2,4416,89,345027,78.11342540185646,12
0.2,4417,94,345121,78.11702127659575,8
0.2,4418,93,345214,78.1203892283322,8
0.2,4419,25,345239,78.10837104072398,8
0.2,4420,93,345332,78.11173942546935,8
0.2,4421,96,345428,78.11578471279964,6
0.2,4422,93,345521,78.1191498982591,8
0.2,4423,94,345615,78.12273960216999,7
0.2,4424,90,345705,78.12542372881356,13
0.2,4425,94,345799,78.1290103931315,8
0.2,4426,25,345824,78.1170092613508,8
0.2,4427,93,345917,78.12037037037037,8
0.2,4428,94,346011,78.1239557462181,7
0.2,4429,94,346105,78.127539503386,7
0.2,4430,94,346199,78.13112164296999,7
0.2,4431,90,346289,78.13379963898917,11
0.2,4432,94,346383,78.13737875028198,7
0.2,4433,92,346475,78.1405051871899,9
0.2,4434,92,346567,78.14363021420519,9
0.2,4435,94,346661,78.14720468890893,8
0.2,4436,-50,346611,78.11832319134551,14
0.2,4437,91,346702,78.12122577737719,11
0.2,4438,94,346796,78.12480288353233,7
0.2,4439,96,346892,78.12882882882883,6
0.2,4440,94,346986,78.13240261202432,7
0.2,4441,92,347078,78.13552453849617,10
0.2,4442,95,347173,78.13932027909071,6
0.2,4443,94,347267,78.1428892889289,7
0.2,4444,94,347361,78.14645669291339,7
0.2,4445,93,347454,78.1497975708502,8
0.2,4446,93,347547,78.1531369462559,9
0.2,4447,95,347642,78.15692446043165,6
0.2,4448,25,347667,78.14497639919082,8
0.2,4449,94,347761,78.14853932584269,7
0.2,4450,96,347857,78.15254998876657,6
0.2,4451,93,347950,78.15588499550763,8
0.2,4452,86,348036,78.15764653042892,15
0.2,4453,95,348131,78.1614279299506,6
0.2,4454,94,348225,78.16498316498317,8
0.2,4455,9,348234,78.14946140035907,26
0.2,4456,94,348328,78.15301772492708,7
0.2,4457,92,348420,78.15612382234185,12
0.2,4458,95,348515,78.15990132316664,6
0.2,4459,-44,348471,78.13251121076233,8
0.2,4460,21,348492,78.11970410221923,11
0.2,4461,92,348584,78.12281488121918,9
0.2,4462,92,348676,78.12592426618866,9
0.2,4463,27,348703,78.11447132616487,6
0.2,4464,91,348794,78.11735722284435,10
0.2,4465,95,348889,78.12113748320645,6
0.2,4466,90,348979,78.12379673158719,14
0.2,4467,25,349004,78.11190689346464,8
0.2,4468,90,349094,78.1145670172298,11
0.2,4469,93,349187,78.1178970917226,8
0.2,4470,95,349282,78.12167300380229,7
0.2,4471,89,349371,78.12410554561717,12
0.2,4472,18,349389,78.11066398390342,14
0.2,4473,94,349483,78.1142154671435,7
0.2,4474,91,349574,78.11709497206704,10
0.2,4475,87,349661,78.11907953529938,15
0.2,4476,90,349751,78.12173330355148,11
0.2,4477,94,349845,78.12527914247431,8
0.2,4478,90,349935,78.12793034159411,11
0.2,4479,94,350029,78.13147321428572,8
0.2,4480,92,350121,78.13456817674626,9
0.2,4481,95,350216,78.13833110218653,6
0.2,4482,93,350309,78.14164621904975,10
0.2,4483,94,350403,78.14518287243533,7
0.2,4484,96,350499,78.14916387959866,6
0.2,4485,94,350593,78.152697280428,7
0.2,4486,90,350683,78.15533764207711,11
0.2,4487,23,350706,78.14304812834224,10
0.2,4488,90,350796,78.1456894631321,11
0.2,4489,88,350884,78.14788418708241,13
0.2,4490,91,350975,78.15074593631708,10
0.2,4491,95,351070,78.15449688334817,7
0.2,4492,85,351155,78.15602047629646,16
0.2,4493,21,351176,78.14330218068535,13
0.2,4494,92,351268,78.14638487208009,9
0.2,4495,92,351360,78.14946619217082,9
0.2,4496,94,351454,78.15299088281077,7
0.2,4497,94,351548,78.156514006225,7
0.2,4498,92,351640,78.15959102022671,9
0.2,4499,26,351666,78.148,7
0.2,4500,95,351761,78.15174405687625,7
0.2,4501,91,351852,78.15459795646379,10
0.2,4502,26,351878,78.14301576726626,6
0.2,4503,93,351971,78.14631438721136,8
0.2,4504,93,352064,78.1496115427303,9
0.2,4505,96,352160,78.15357301375943,6
0.2,4506,90,352250,78.15620146438873,11
0.2,4507,94,352344,78.15971606033717,8
0.2,4508,22,352366,78.14726103348858,11
0.2,4509,21,352387,78.13458980044346,11
0.2,4510,94,352481,78.13810684992241,8
0.2,4511,92,352573,78.14117907801419,9
0.2,4512,96,352669,78.14513627298915,6
0.2,4513,95,352764,78.14887018165707,6
0.2,4514,24,352788,78.13687707641196,8
0.2,4515,94,352882,78.14038972542073,7
0.2,4516,94,352976,78.14390081912774,7
0.2,4517,92,353068,78.14696768481629,9
0.2,4518,23,353091,78.13476432839124,9
0.2,4519,92,353183,78.13783185840708,9
0.2,4520,25,353208,78.12607830126078,8
0.2,4521,96,353304,78.13003095975232,6
0.2,4522,24,353328,78.1180632323679,8
0.2,4523,85,353413,78.11958443854995,16
0.2,4524,23,353436,78.10740331491712,9
0.2,4525,22,353458,78.09500662836942,10
0.2,4526,90,353548,78.09763640379943,11
0.2,4527,95,353643,78.10136925795052,6
0.2,4528,96,353739,78.10532126297196,6
0.2,4529,91,353830,78.10816777041943,10
0.2,4530,94,353924,78.11167512690355,7
0.2,4531,95,354019,78.11540158870255,6
0.2,4532,18,354037,78.10213986322523,14
0.2,4533,92,354129,78.10520511689458,9
0.2,4534,94,354223,78.10871003307608,7
0.2,4535,19,354242,78.09567901234568,14
0.2,4536,92,354334,78.09874366321358,9
0.2,4537,92,354426,78.10180696342,9
0.2,4538,95,354521,78.10552985239039,6
0.2,4539,94,354615,78.10903083700441,7
0.2,4540,96,354711,78.11297071129707,6
0.2,4541,92,354803,78.11602818141787,10
0.2,4542,94,354897,78.11952454325336,9
0.2,4543,95,354992,78.12323943661971,7
0.2,4544,93,355085,78.12651265126513,8
0.2,4545,95,355180,78.13022437307524,6
0.2,4546,96,355276,78.13415438750825,6
0.2,4547,93,355369,78.13742304309586,8
0.2,4548,27,355396,78.12618157836887,6
0.2,4549,96,355492,78.13010989010989,6
0.2,4550,90,355582,78.13271808393759,11
0.2,4551,27,355609,78.12148506151142,6
0.2,4552,94,355703,78.12497254557435,7
0.2,4553,92,355795,78.1280193236715,9
0.2,4554,93,355888,78.13128430296378,8
0.2,4555,93,355981,78.13454784899034,8
0.2,4556,92,356073,78.137590520079,9
0.2,4557,27,356100,78.12637121544537,6
0.2,4558,94,356194,78.12985303794692,7
0.2,4559,17,356211,78.11644736842105,15
0.2,4560,94,356305,78.11992983994737,7
0.2,4561,94,356399,78.12341078474353,8
0.2,4562,20,356419,78.11067280298049,12
0.2,4563,93,356512,78.11393514461,8
0.2,4564,94,356606,78.11741511500547,7
0.2,4565,94,356700,78.12089356110381,7
0.2,4566,90,356790,78.12349463542807,11
0.2,4567,90,356880,78.1260945709282,12
0.2,4568,94,356974,78.12956883344276,8
0.2,4569,22,356996,78.11728665207877,10
0.2,4570,88,357084,78.11944869831547,14
0.2,4571,17,357101,78.10608048993876,15
0.2,4572,96,357197,78.10999343975509,6
0.2,4573,94,357291,78.11346742457367,7
0.2,4574,92,357383,78.11650273224043,10
0.2,4575,21,357404,78.10402097902097,11
0.2,4576,94,357498,78.10749399169762,7
0.2,4577,90,357588,78.11009174311927,11
0.2,4578,17,357605,78.09674601441363,15
0.2,4579,15,357620,78.08296943231441,17
0.2,4580,95,357715,78.08666230080769,6
0.2,4581,94,357809,78.0901353120908,7
0.2,4582,95,357904,78.09382500545495,6
0.2,4583,87,357991,78.09576788830715,15
0.2,4584,89,358080,78.09814612868048,12
0.2,4585,92,358172,78.10117749672918,10
0.2,4586,93,358265,78.10442555046872,9
0.2,4587,94,358359,78.10789014821273,7
0.2,4588,96,358455,78.11178906079756,6
0.2,4589,92,358547,78.11481481481482,9
0.2,4590,24,358571,78.10302766281856,8
0.2,4591,95,358666,78.10670731707317,6
0.2,4592,90,358756,78.10929675593295,11
0.2,4593,92,358848,78.11232041793644,9
0.2,4594,94,358942,78.1157780195865,7
0.2,4595,15,358957,78.102045256745,18
0.2,4596,92,359049,78.10506852294975,10
0.2,4597,93,359142,78.1083079599826,9
0.2,4598,85,359227,78.10980647966949,17
0.2,4599,87,359314,78.11173913043478,14
0.2,4600,94,359408,78.11519234948923,8
0.2,4601,16,359424,78.10169491525424,17
0.2,4602,96,359520,78.1055833152292,6
0.2,4603,95,359615,78.10925282363162,7
0.2,4604,92,359707,78.11226927252986,9
0.2,4605,96,359803,78.11615284411637,6
0.2,4606,27,359830,78.10505752116345,6
0.2,4607,91,359921,78.10785590277777,10
0.2,4608,24,359945,78.096116294207,8
0.2,4609,92,360037,78.09913232104121,11
0.2,4610,93,360130,78.10236391238342,8
0.2,4611,92,360222,78.10537727666956,9
0.2,4612,92,360314,78.10838933448949,9
0.2,4613,87,360401,78.11031642826181,14
0.2,4614,94,360495,78.11375947995667,8
0.2,4615,95,360590,78.11741767764298,7
0.2,4616,90,360680,78.1199913363656,12
0.2,4617,94,360774,78.12343005630143,10
0.2,4618,83,360857,78.12448581944143,19
0.2,4619,95,360952,78.12813852813852,6
0.2,4620,83,361035,78.12919281540792,18
0.2,4621,92,361127,78.13219385547382,10
0.2,4622,88,361215,78.13432835820896,13
0.2,4623,88,361303,78.13646193771626,13
0.2,4624,92,361395,78.13945945945946,9
0.2,4625,94,361489,78.14288802421098,8
0.2,4626,94,361583,78.14631510698077,7
0.2,4627,93,361676,78.1495246326707,8
0.2,4628,94,361770,78.15294880103694,7
0.2,4629,89,361859,78.15529157667386,12
0.2,4630,92,361951,78.15828114877996,9
0.2,4631,92,362043,78.16126943005182,10
0.2,4632,95,362138,78.16490394992445,6
0.2,4633,94,362232,78.168321104877,8
0.2,4634,94,362326,78.17173678532902,7
0.2,4635,90,362416,78.17428817946505,14
0.2,4636,92,362508,78.17726978649989,9
0.2,4637,96,362604,78.18111254851229,6
0.2,4638,88,362692,78.18322914421212,14
0.2,4639,92,362784,78.18620689655172,10
0.2,4640,96,362880,78.19004524886878,6
0.2,4641,93,362973,78.19323567427833,8
0.2,4642,95,363068,78.19685548136981,6
0.2,4643,90,363158,78.1993970714901,11
0.2,4644,23,363181,78.18751345532831,9
0.2,4645,93,363274,78.19070167886353,8
0.2,4646,96,363370,78.19453410802669,6
0.2,4647,93,363463,78.19771944922547,8
0.2,4648,91,363554,78.20047322004733,10
0.2,4649,92,363646,78.20344086021505,9
0.2,4650,19,363665,78.19071167490863,13
0.2,4651,96,363761,78.1945399828031,6
0.2,4652,94,363855,78.1979368149581,7
0.2,4653,93,363948,78.20111731843575,8
0.2,4654,90,364038,78.20365198711063,11
0.2,4655,94,364132,78.20704467353951,7
0.2,4656,94,364226,78.21043590294181,7
0.2,4657,92,364318,78.21339630742808,9
0.2,4658,94,364412,78.21678471775058,8
0.2,4659,94,364506,78.22017167381975,7
0.2,4660,96,364602,78.22398626904098,6
0.2,4661,96,364698,78.22779922779922,6
0.2,4662,92,364790,78.23075273429123,9
0.2,4663,90,364880,78.23327615780445,11
0.2,4664,90,364970,78.2357984994641,12
0.2,4665,88,365058,78.2378911273039,13
0.2,4666,94,365152,78.2412684808228,7
0.2,4667,93,365245,78.24443016281063,8
0.2,4668,94,365339,78.24780466909402,8
0.2,4669,94,365433,78.25117773019272,7
0.2,4670,94,365527,78.2545493470349,7
0.2,4671,93,365620,78.25770547945206,8
0.2,4672,89,365709,78.26000427990584,12
0.2,4673,93,365802,78.26315789473684,8
0.2,4674,94,365896,78.26652406417112,10
0.2,4675,17,365913,78.25342172797262,15
0.2,4676,96,366009,78.25721616420782,6
0.2,4677,88,366097,78.25929884566054,13
0.2,4678,90,366187,78.26180807864928,11
0.2,4679,93,366280,78.26495726495726,8
0.2,4680,94,366374,78.26831873531297,7
0.2,4681,94,366468,78.27167876975652,7
0.2,4682,91,366559,78.27439675421738,10
0.2,4683,26,366585,78.2632365499573,9
0.2,4684,92,366677,78.26616862326574,9
0.2,4685,94,366771,78.26952624839949,7
0.2,4686,94,366865,78.27288244079368,7
0.2,4687,92,366957,78.27581058020478,9
0.2,4688,91,367048,78.27852420558754,10
0.2,4689,94,367142,78.2818763326226,7
0.2,4690,90,367232,78.28437433383074,11
0.2,4691,92,367324,78.28729752770674,9
0.2,4692,94,367418,78.2906456424462,7
0.2,4693,-50,367368,78.26331487004687,14
0.2,4694,94,367462,78.26666666666667,7
0.2,4695,90,367552,78.26916524701873,11
0.2,4696,25,367577,78.25782414307004,9
0.2,4697,90,367667,78.26032354193273,11
0.2,4698,92,367759,78.26324749946797,9
0.2,4699,90,367849,78.26574468085106,11
0.2,4700,80,367929,78.26611359285259,22
0.2,4701,90,368019,78.26860910250957,12
0.2,4702,94,368113,78.27195407186902,7
0.2,4703,95,368208,78.27551020408163,6
0.2,4704,96,368304,78.27927736450584,6
0.2,4705,93,368397,78.28240543986401,8
0.2,4706,95,368492,78.28595708519227,6
0.2,4707,92,368584,78.28887000849618,9
0.2,4708,94,368678,78.29220641325122,7
0.2,4709,94,368772,78.29554140127388,7
0.2,4710,95,368867,78.29908724262364,6
0.2,4711,93,368960,78.30220713073005,8
0.2,4712,87,369047,78.30405262041162,14
0.2,4713,94,369141,78.30738226559185,8
0.2,4714,93,369234,78.31049840933191,9
0.2,4715,94,369328,78.31382527565734,8
0.2,4716,95,369423,78.31736273054908,6
0.2,4717,92,369515,78.32026282323018,9
0.2,4718,94,369609,78.32358550540368,7
0.2,4719,95,369704,78.3271186440678,6
0.2,4720,89,369793,78.32937936877781,12
0.2,4721,94,369887,78.33269800931808,7
0.2,4722,93,369980,78.33580351471522,8
0.2,4723,94,370074,78.33911939034716,7
0.2,4724,95,370169,78.3426455026455,7
0.2,4725,96,370265,78.34638171815489,6
0.2,4726,95,370360,78.34990480220013,6
0.2,4727,84,370444,78.35109983079526,18
0.2,4728,93,370537,78.35419750475788,8
0.2,4729,81,370618,78.35475687103595,20
0.2,4730,-69,370549,78.32361023039526,32
0.2,4731,94,370643,78.32692307692308,7
0.2,4732,87,370730,78.32875554616523,15
0.2,4733,88,370818,78.33079847908745,13
0.2,4734,92,370910,78.3336853220697,9
0.2,4735,93,371003,78.3367820945946,8
0.2,4736,95,371098,78.34029976778552,7
0.2,4737,93,371191,78.34339383706205,8
0.2,4738,93,371284,78.34648660054864,8
0.2,4739,93,371377,78.34957805907173,8
0.2,4740,83,371460,78.35055895380721,18
0.2,4741,89,371549,78.35280472374525,12
0.2,4742,95,371644,78.35631456883829,6
0.2,4743,95,371739,78.35982293423271,6
0.2,4744,94,371833,78.36311907270812,7
0.2,4745,27,371860,78.35229667088075,6
0.2,4746,92,371952,78.3551716873815,9
0.2,4747,91,372043,78.3578348778433,10
0.2,4748,23,372066,78.3461781427669,10
0.2,4749,88,372154,78.3482105263158,13
0.2,4750,27,372181,78.33740265207325,6
0.2,4751,92,372273,78.34027777777777,9
0.2,4752,95,372368,78.34378287397433,7
0.2,4753,92,372460,78.34665544804375,9
0.2,4754,95,372555,78.35015772870662,6
0.2,4755,94,372649,78.35344827586206,8
0.2,4756,91,372740,78.35610678999369,10
0.2,4757,24,372764,78.34468263976461,10
0.2,4758,87,372851,78.34650136583316,14
0.2,4759,27,372878,78.33571428571429,7
0.2,4760,92,372970,78.3385843310229,9
0.2,4761,94,373064,78.34187316253674,8
0.2,4762,95,373159,78.3453705647701,6
0.2,4763,93,373252,78.34844668345927,9
0.2,4764,95,373347,78.35194123819517,6
0.2,4765,93,373440,78.35501468736886,8
0.2,4766,86,373526,78.35661841829243,15
0.2,4767,96,373622,78.36031879194631,6
0.2,4768,90,373712,78.36275948836234,11
0.2,4769,94,373806,78.36603773584906,8
0.2,4770,94,373900,78.36931460909662,7
0.2,4771,92,373992,78.37217099748533,9
0.2,4772,92,374084,78.37502618897967,9
0.2,4773,93,374177,78.3780896522832,9
0.2,4774,94,374271,78.38136125654451,7
0.2,4775,89,374360,78.38358458961474,12
0.2,4776,-118,374242,78.34247435629055,13
0.2,4777,90,374332,78.34491419003767,11
0.2,4778,93,374425,78.34798074911069,8
0.2,4779,94,374519,78.35125523012552,7
0.2,4780,88,374607,78.35327337377117,14
0.2,4781,94,374701,78.35654537850272,8
0.2,4782,21,374722,78.34455362743049,12
0.2,4783,92,374814,78.34740802675586,9
0.2,4784,92,374906,78.35026123301985,9
0.2,4785,93,374999,78.35332218972002,8
0.2,4786,96,375095,78.35700856486316,6
0.2,4787,94,375189,78.36027568922306,8
0.2,4788,93,375282,78.3633326372938,9
0.2,4789,88,375370,78.36534446764092,13
0.2,4790,92,375462,78.36819035691923,10
0.2,4791,93,375555,78.37124373956594,8
0.2,4792,91,375646,78.37387857291884,10
0.2,4793,84,375730,78.37505214851898,17
0.2,4794,90,375820,78.37747653806048,12
0.2,4795,90,375910,78.37989991659717,11
0.2,4796,92,376002,78.38273921200751,11
0.2,4797,-51,375951,78.35577323884952,14
0.2,4798,23,375974,78.34423838299645,10
0.2,4799,94,376068,78.3475,7
0.2,4800,96,376164,78.35117683815872,6
0.2,4801,95,376259,78.35464389837567,6
0.2,4802,92,376351,78.35748490526754,9
0.2,4803,89,376440,78.35970024979184,13
0.2,4804,94,376534,78.36295525494276,8
0.2,4805,91,376625,78.36558468580941,10
0.2,4806,79,376704,78.3657166631995,22
0.2,4807,27,376731,78.35503327787022,6
0.2,4808,94,376825,78.35828654605947,7
0.2,4809,89,376914,78.36049896049896,13
0.2,4810,87,377001,78.36229474121804,15
0.2,4811,90,377091,78.36471321695761,11
0.2,4812,25,377116,78.35362559734054,8
0.2,4813,90,377206,78.3560448691317,11
0.2,4814,93,377299,78.35908618899273,8
0.2,4815,91,377390,78.36171096345515,11
0.2,4816,93,377483,78.36474984430143,8
0.2,4817,92,377575,78.3675799086758,9
0.2,4818,90,377665,78.36999377464204,12
0.2,4819,88,377753,78.37199170124481,13
0.2,4820,91,377844,78.37461107654013,10
0.2,4821,93,377937,78.37764413106595,10
0.2,4822,96,378033,78.38129794733568,6
0.2,4823,90,378123,78.3837064676617,11
0.2,4824,92,378215,78.38652849740933,9
0.2,4825,93,378308,78.38955656858683,8
0.2,4826,96,378404,78.39320488916512,6
0.2,4827,96,378500,78.39685169842585,6
0.2,4828,92,378592,78.39966866846137,10
0.2,4829,93,378685,78.40269151138716,8
0.2,4830,92,378777,78.40550610639619,9
0.2,4831,92,378869,78.40831953642385,9
0.2,4832,94,378963,78.41154562383613,7
0.2,4833,88,379051,78.41352916839057,13
0.2,4834,91,379142,78.41613236814891,10
0.2,4835,94,379236,78.41935483870968,7
0.2,4836,87,379323,78.42112879884226,14
0.2,4837,90,379413,78.4235221165771,12
0.2,4838,94,379507,78.42674106220294,8
0.2,4839,93,379600,78.4297520661157,8
0.2,4840,92,379692,78.43255525717827,9
0.2,4841,95,379787,78.43597686906237,7
0.2,4842,90,379877,78.43836465001033,12
0.2,4843,92,379969,78.44116432700248,9
0.2,4844,23,379992,78.4297213622291,10
0.2,4845,86,380078,78.43128353281057,15
0.2,4846,91,380169,78.43387662471632,10
0.2,4847,91,380260,78.43646864686468,10
0.2,4848,-44,380216,78.41121880800165,8
0.2,4849,94,380310,78.41443298969072,7
0.2,4850,88,380398,78.41640898783756,13
0.2,4851,95,380493,78.41982687551526,6
0.2,4852,95,380588,78.42324335462601,6
0.2,4853,95,380683,78.42665842604038,6
0.2,4854,94,380777,78.42986611740474,7
0.2,4855,96,380873,78.43348434925865,6
0.2,4856,96,380969,78.43710109120856,6
0.2,4857,89,381058,78.43927542198436,12
0.2,4858,94,381152,78.4424778761062,8
0.2,4859,93,381245,78.4454732510288,9
0.2,4860,90,381335,78.44785023657684,12
0.2,4861,88,381423,78.44981489099136,15
0.2,4862,90,381513,78.45219000616903,11
0.2,4863,19,381532,78.43996710526316,13
0.2,4864,93,381625,78.44295991778006,8
0.2,4865,94,381719,78.44615700780929,7
0.2,4866,91,381810,78.44873638791863,10
0.2,4867,95,381905,78.45213640098603,6
0.2,4868,90,381995,78.45450811254878,12
0.2,4869,88,382083,78.4564681724846,13
0.2,4870,95,382178,78.45986450420858,7
0.2,4871,92,382270,78.46264367816092,10
0.2,4872,92,382362,78.46542171147138,9
0.2,4873,94,382456,78.4686089454247,8
0.2,4874,87,382543,78.47035897435897,15
0.2,4875,92,382635,78.47313371616079,9
0.2,4876,93,382728,78.4761123641583,8
0.2,4877,91,382819,78.47867978679787,10
0.2,4878,95,382914,78.48206599713056,6
0.2,4879,92,383006,78.48483606557377,9
0.2,4880,96,383102,78.48842450317558,6
0.2,4881,95,383197,78.49180663662433,6
0.2,4882,95,383292,78.49518738480442,7
0.2,4883,92,383384,78.4979524979525,10
0.2,4884,-62,383322,78.4691914022518,25
0.2,4885,94,383416,78.47237003683995,7
0.2,4886,96,383512,78.47595661960302,6
0.2,4887,95,383607,78.4793371522095,6
0.2,4888,94,383701,78.48251176109633,8
0.2,4889,19,383720,78.47034764826176,13
0.2,4890,95,383815,78.47372725414026,7
0.2,4891,94,383909,78.47690106295994,7
0.2,4892,92,384001,78.47966482730432,10
0.2,4893,25,384026,78.46873722926031,7
0.2,4894,90,384116,78.47109295199184,11
0.2,4895,22,384138,78.4595588235294,10
0.2,4896,95,384233,78.46293649172964,7
0.2,4897,90,384323,78.46529195590037,11
0.2,4898,91,384414,78.46785058175138,10
0.2,4899,95,384509,78.47122448979592,6
0.2,4900,20,384529,78.45929402162824,12
0.2,4901,88,384617,78.46124031007751,14
0.2,4902,-54,384563,78.43422394452377,17
0.2,4903,91,384654,78.4367862969005,11
0.2,4904,27,384681,78.42629969418961,6
0.2,4905,19,384700,78.41418671015083,13
0.2,4906,92,384792,78.41695536987976,9
0.2,4907,94,384886,78.420130399348,7
0.2,4908,90,384976,78.4224893053575,11
0.2,4909,92,385068,78.42525458248473,9
0.2,4910,96,385164,78.42883323152107,6
0.2,4911,92,385256,78.43159609120521,9
0.2,4912,94,385350,78.43476490942398,7
0.2,4913,90,385440,78.43711843711844,11
0.2,4914,93,385533,78.44008138351984,10
0.2,4915,94,385627,78.44324654190399,9
0.2,4916,95,385722,78.44661378889568,6
0.2,4917,93,385815,78.44957299715331,8
0.2,4918,95,385910,78.45293758894084,7
0.2,4919,90,386000,78.45528455284553,11
0.2,4920,90,386090,78.45763056289373,12
0.2,4921,96,386186,78.4611946363267,6
0.2,4922,94,386280,78.46435100548446,7
0.2,4923,94,386374,78.46750609260764,7
0.2,4924,95,386469,78.47086294416243,6
0.2,4925,27,386496,78.46041412911084,6
0.2,4926,91,386587,78.462959204384,10
0.2,4927,92,386679,78.46570616883118,9
0.2,4928,90,386769,78.46804625684723,11
0.2,4929,92,386861,78.47079107505071,9
0.2,4930,92,386953,78.4735347799635,10
0.2,4931,93,387046,78.4764801297648,9
0.2,4932,94,387140,78.47962700182445,8
0.2,4933,93,387233,78.48256992298339,8
0.2,4934,90,387323,78.48490374873353,11
0.2,4935,92,387415,78.48764181523501,9
0.2,4936,96,387511,78.49118898116265,6
0.2,4937,94,387605,78.49432968813285,7
0.2,4938,20,387625,78.48248633326584,13
0.2,4939,94,387719,78.48562753036437,8
0.2,4940,94,387813,78.48876745598056,7
0.2,4941,94,387907,78.49190611088628,7
0.2,4942,91,387998,78.49443657697755,10
0.2,4943,94,388092,78.49757281553399,7
0.2,4944,93,388185,78.5005055611729,8
0.2,4945,92,388277,78.50323493732309,9
0.2,4946,93,388370,78.50616535273903,8
0.2,4947,88,388458,78.50808407437349,14
0.2,4948,94,388552,78.5112143867448,7
0.2,4949,19,388571,78.49919191919192,13
0.2,4950,95,388666,78.50252474247627,6
0.2,4951,95,388761,78.5058562197092,7
0.2,4952,95,388856,78.50918635170603,7
0.2,4953,96,388952,78.51271699636658,6
0.2,4954,92,389044,78.515438950555,10
0.2,4955,95,389139,78.51876513317191,7
0.2,4956,88,389227,78.52067782933226,13
0.2,4957,94,389321,78.5237999193223,7
0.2,4958,94,389415,78.52692075015123,7
0.2,4959,93,389508,78.52983870967742,9
0.2,4960,94,389602,78.53295706510784,8
0.2,4961,84,389686,78.53405884723901,17
0.2,4962,93,389779,78.53697360467459,8
0.2,4963,89,389868,78.53908138597905,12
0.2,4964,96,389964,78.54259818731119,6
0.2,4965,96,390060,78.54611357229159,6
0.2,4966,93,390153,78.54902355546608,8
0.2,4967,94,390247,78.55213365539453,7
0.2,4968,94,390341,78.55524250352184,7
0.2,4969,92,390433,78.5579476861167,9
0.2,4970,94,390527,78.5610541138604,7
0.2,4971,89,390616,78.5631536604988,13
0.2,4972,96,390712,78.56665996380454,6
0.2,4973,93,390805,78.56956172094894,8
0.2,4974,91,390896,78.57206030150753,10
0.2,4975,92,390988,78.57475884244373,10
0.2,4976,92,391080,78.57745629897529,10
0.2,4977,93,391173,78.58035355564483,8
0.2,4978,96,391269,78.58385217915244,6
0.2,4979,94,391363,78.58694779116466,8
0.2,4980,90,391453,78.58923910861273,11
0.2,4981,94,391547,78.59233239662787,7
0.2,4982,92,391639,78.59502307846678,9
0.2,4983,90,391729,78.5973113964687,11
0.2,4984,87,391816,78.59899699097292,14
0.2,4985,93,391909,78.60188527878059,9
0.2,4986,89,391998,78.60397032283939,12
0.2,4987,93,392091,78.60685645549319,8
0.2,4988,93,392184,78.60974143114852,8
0.2,4989,92,392276,78.6124248496994,9
0.2,4990,92,392368,78.6151071929473,9
0.2,4991,95,392463,78.61838942307692,7
0.2,4992,94,392557,78.62147005808131,7
0.2,4993,93,392650,78.62434921906288,8
0.2,4994,95,392745,78.62762762762763,6
0.2,4995,95,392840,78.63090472377903,7
0.2,4996,93,392933,78.63378026816089,8
0.2,4997,94,393027,78.63685474189676,7
0.2,4998,88,393115,78.6387277455491,13
0.2,4999,94,393209,78.6418,7
0.2,5000,19,393228,78.62987402519497,14
0.2,5001,93,393321,78.6327469012395,8
0.2,5002,90,393411,78.63501898860683,12
0.2,5003,94,393505,78.6380895283773,7
0.2,5004,95,393600,78.64135864135864,6
0.2,5005,92,393692,78.64402716739912,9
0.2,5006,89,393781,78.64609546634712,12
0.2,5007,94,393875,78.64916134185303,7
0.2,5008,94,393969,78.65222599321221,8
0.2,5009,95,394064,78.65548902195609,7
0.2,5010,92,394156,78.658152065456,9
0.2,5011,94,394250,78.66121308858739,9
0.2,5012,93,394343,78.66407340913625,8
0.2,5013,27,394370,78.65376944555246,7
0.2,5014,24,394394,78.64287138584247,8
0.2,5015,91,394485,78.64533492822966,11
0.2,5016,92,394577,78.64799681084314,9
0.2,5017,89,394666,78.65005978477481,13
0.2,5018,90,394756,78.65232117951783,11
0.2,5019,92,394848,78.65498007968128,9
0.2,5020,91,394939,78.65743875721968,10
0.2,5021,87,395026,78.65909996017523,16
0.2,5022,95,395121,78.66235317539319,6
0.2,5023,92,395213,78.66500796178345,9
0.2,5024,94,395307,78.66805970149254,7
0.2,5025,88,395395,78.66991643454038,16
0.2,5026,91,395486,78.67236920628605,10
0.2,5027,94,395580,78.67541766109785,7
0.2,5028,95,395675,78.67866375024856,6
0.2,5029,90,395765,78.68091451292247,11
0.2,5030,96,395861,78.68435698668257,6
0.2,5031,91,395952,78.68680445151034,10
0.2,5032,91,396043,78.68925094377111,10
0.2,5033,93,396136,78.69209376241558,8
0.2,5034,93,396229,78.69493545183714,8
0.2,5035,16,396245,78.68248610007943,16
0.2,5036,92,396337,78.68513003772087,9
0.2,5037,93,396430,78.68797141722906,8
0.2,5038,94,396524,78.69101012105577,7
0.2,5039,94,396618,78.69404761904762,7
0.2,5040,94,396712,78.69708391192223,7
0.2,5041,90,396802,78.69932566441888,11
0.2,5042,94,396896,78.7023597065239,7
0.2,5043,91,396987,78.70479777954004,10
0.2,5044,92,397079,78.70743310208127,9
0.2,5045,94,397173,78.71046373365041,7
0.2,5046,83,397256,78.71131365167426,18
0.2,5047,93,397349,78.71414421553091,11
0.2,5048,95,397444,78.71736977619331,6
0.2,5049,94,397538,78.72039603960395,7
0.2,5050,27,397565,78.71015640467235,6
0.2,5051,92,397657,78.71278701504355,9
0.2,5052,93,397750,78.7156144864437,8
0.2,5053,95,397845,78.71883656509695,6
0.2,5054,94,397939,78.72185954500495,8
0.2,5055,93,398032,78.7246835443038,8
0.2,5056,21,398053,78.71326873640498,11
0.2,5057,94,398147,78.71629102412021,7
0.2,5058,83,398230,78.71713777426369,18
0.2,5059,-50,398180,78.69169960474308,14
0.2,5060,96,398276,78.69511954159258,6
0.2,5061,94,398370,78.69814302647175,8
0.2,5062,93,398463,78.70096780564883,8
0.2,5063,92,398555,78.70359399684044,9
0.2,5064,93,398648,78.70641658440276,8
0.2,5065,92,398740,78.70904066324516,9
0.2,5066,90,398830,78.71126899546083,11
0.2,5067,94,398924,78.71428571428571,7
0.2,5068,88,399012,78.71611757743145,13
0.2,5069,92,399104,78.71873767258383,10
0.2,5070,95,399199,78.721948333662,6
0.2,5071,89,399288,78.72397476340694,12
0.2,5072,93,399381,78.72678888231816,8
0.2,5073,94,399475,78.72979897516753,7
0.2,5074,92,399567,78.73241379310345,9
0.2,5075,95,399662,78.73561859732072,7
0.2,5076,89,399751,78.73764033878274,12
0.2,5077,95,399846,78.74084285151635,6
0.2,5078,80,399926,78.7410907658988,21
0.2,5079,95,400021,78.74429133858268,7
0.2,5080,96,400117,78.74768746309782,6
0.2,5081,92,400209,78.75029515938607,9
0.2,5082,26,400235,78.73991737163092,6
0.2,5083,90,400325,78.7421321793863,11
0.2,5084,92,400417,78.74473942969519,10
0.2,5085,94,400511,78.74773889107354,7
0.2,5086,92,400603,78.75034401415373,10
0.2,5087,93,400696,78.75314465408805,8
0.2,5088,94,400790,78.756140695618,8
0.2,5089,94,400884,78.75913555992142,8
0.2,5090,80,400964,78.75937929679827,21
0.2,5091,92,401056,78.76197957580519,9
0.2,5092,96,401152,78.76536422540742,6
0.2,5093,90,401242,78.76756968983118,11
0.2,5094,94,401336,78.77055937193327,7
0.2,5095,89,401425,78.7725667189953,12
0.2,5096,91,401516,78.77496566607809,10
0.2,5097,92,401608,78.77755982738329,9
0.2,5098,92,401700,78.78015297117082,10
0.2,5099,96,401796,78.7835294117647,6
0.2,5100,94,401890,78.7865124485395,8
0.2,5101,96,401986,78.78988631909056,6
0.2,5102,96,402082,78.79325886733294,6
0.2,5103,24,402106,78.78252351097179,8
0.2,5104,-45,402061,78.75827619980411,11
0.2,5105,92,402153,78.76086956521739,9
0.2,5106,21,402174,78.74955942823576,12
0.2,5107,93,402267,78.75234925606891,9
0.2,5108,-49,402218,78.72734390291642,13
0.2,5109,93,402311,78.73013698630137,8
0.2,5110,95,402406,78.73332028957151,7
0.2,5111,84,402490,78.73435054773083,18
0.2,5112,93,402583,78.73714062194406,8
0.2,5113,25,402608,78.7266327727806,8
0.2,5114,96,402704,78.73000977517107,7
0.2,5115,92,402796,78.73260359655981,9
0.2,5116,90,402886,78.73480555012702,11
0.2,5117,94,402980,78.73778819851505,7
0.2,5118,94,403074,78.74076968157843,7
0.2,5119,96,403170,78.744140625,6
0.2,5120,89,403259,78.7461433313806,12
0.2,5121,93,403352,78.74892620070285,8
0.2,5122,92,403444,78.75151278547726,9
0.2,5123,92,403536,78.75409836065573,9
0.2,5124,94,403630,78.7570731707317,7
0.2,5125,93,403723,78.75985173624659,8
0.2,5126,20,403743,78.74839087185488,12
0.2,5127,92,403835,78.75097503900156,10
0.2,5128,92,403927,78.75355819847924,9
0.2,5129,94,404021,78.75653021442496,7
0.2,5130,93,404114,78.75930617813292,8
0.2,5131,85,404199,78.76052221356197,17
0.2,5132,93,404292,78.76329631794272,8
0.2,5133,91,404383,78.76567978184652,10
0.2,5134,96,404479,78.76903602726388,6
0.2,5135,92,404571,78.77161214953271,10
0.2,5136,93,404664,78.7743819349815,8
0.2,5137,90,404754,78.77656675749319,11
0.2,5138,95,404849,78.77972368165013,6
0.2,5139,94,404943,78.78268482490273,7
0.2,5140,92,405035,78.7852557868119,9
0.2,5141,92,405127,78.7878257487359,9
0.2,5142,94,405221,78.79078358934474,7
0.2,5143,89,405310,78.79276827371694,12
0.2,5144,93,405403,78.7955296404276,10
0.2,5145,93,405496,78.79828993392927,9
0.2,5146,94,405590,78.80124344278221,7
0.2,5147,93,405683,78.80400155400156,8
0.2,5148,90,405773,78.8061759564964,11
0.2,5149,93,405866,78.80893203883495,8
0.2,5150,90,405956,78.81110463987575,11
0.2,5151,94,406050,78.81405279503106,7
0.2,5152,95,406145,78.81719386764992,6
0.2,5153,93,406238,78.81994567326349,8
0.2,5154,93,406331,78.82269641125121,8
0.2,5155,94,406425,78.82564003103181,7
0.2,5156,96,406521,78.82897033158814,6
0.2,5157,95,406616,78.83210546723537,6
0.2,5158,25,406641,78.82167086644698,8
0.2,5159,95,406736,78.82480620155039,6
0.2,5160,94,406830,78.82774656074405,8
0.2,5161,93,406923,78.83049205734211,8
0.2,5162,94,407017,78.83343017625411,7
0.2,5163,89,407106,78.83539891556933,12
0.2,5164,94,407200,78.83833494675702,8
0.2,5165,92,407292,78.84088269454124,10
0.2,5166,93,407385,78.84362299206502,8
0.2,5167,94,407479,78.84655572755418,8
0.2,5168,89,407568,78.84852002321533,13
0.2,5169,93,407661,78.85125725338492,8
0.2,5170,94,407755,78.8541868110617,7
0.2,5171,92,407847,78.85672853828306,9
0.2,5172,91,407938,78.85907597138991,11
0.2,5173,96,408034,78.862388867414,6
0.2,5174,94,408128,78.86531400966183,7
0.2,5175,-46,408082,78.84119010819165,10
0.2,5176,88,408170,78.84295924280471,13
0.2,5177,94,408264,78.84588644264194,7
0.2,5178,95,408359,78.8490055995366,7
0.2,5179,93,408452,78.85173745173745,9
0.2,5180,93,408545,78.8544682493727,9
0.2,5181,92,408637,78.85700501736781,9
0.2,5182,93,408730,78.85973374493537,8
0.2,5183,93,408823,78.86246141975309,8
0.2,5184,89,408912,78.86441658630666,14
0.2,5185,88,409000,78.86617817200154,14
0.2,5186,95,409095,78.86928860613071,6
0.2,5187,93,409188,78.87201233616037,8
0.2,5188,94,409282,78.87492773174021,7
0.2,5189,95,409377,78.87803468208092,6
0.2,5190,89,409466,78.87998458871122,12
0.2,5191,94,409560,78.88289676425269,7
0.2,5192,94,409654,78.88580781821683,8
0.2,5193,21,409675,78.87466307277629,11
0.2,5194,94,409769,78.87757459095283,8
0.2,5195,91,409860,78.87990762124711,10
0.2,5196,92,409952,78.88243217240716,9
0.2,5197,91,410043,78.88476337052712,10
0.2,5198,94,410137,78.88767070590498,7
0.2,5199,93,410230,78.89038461538462,8
0.2,5200,96,410326,78.89367429340511,6
0.2,5201,95,410421,78.89677047289504,8
0.2,5202,94,410515,78.8996732654238,7
0.2,5203,93,410608,78.90238278247502,8
0.2,5204,94,410702,78.90528338136407,7
0.2,5205,91,410793,78.90760660776027,10
0.2,5206,91,410884,78.9099289418091,10
0.2,5207,90,410974,78.9120583717358,11
0.2,5208,93,411067,78.91476291034748,9
0.2,5209,89,411156,78.91669865642994,12
0.2,5210,88,411244,78.91844175781999,13
0.2,5211,90,411334,78.9205679201842,11
0.2,5212,17,411351,78.90868981392673,15
0.2,5213,25,411376,78.89835059455312,7
0.2,5214,93,411469,78.90105465004794,8
0.2,5215,92,411561,78.90356595092024,9
0.2,5216,94,411655,78.90645965114051,7
0.2,5217,24,411679,78.89593714066692,8
0.2,5218,92,411771,78.89844797853995,9
0.2,5219,94,411865,78.90134099616859,7
0.2,5220,95,411960,78.9044244397625,6
0.2,5221,94,412054,78.90731520490233,7
0.2,5222,23,412077,78.89661114302125,9
0.2,5223,92,412169,78.89911944869831,10
0.2,5224,95,412264,78.9022009569378,6
0.2,5225,92,412356,78.90470723306544,9
0.2,5226,93,412449,78.90740386454945,8
0.2,5227,94,412543,78.91029074215761,7
0.2,5228,96,412639,78.91355899789635,6
0.2,5229,91,412730,78.91586998087953,11
0.2,5230,92,412822,78.91837124832728,9
0.2,5231,94,412916,78.92125382262996,7
0.2,5232,24,412940,78.91075864704759,9
0.2,5233,96,413036,78.91402369124953,6
0.2,5234,93,413129,78.91671442215855,8
0.2,5235,96,413225,78.91997708174179,6
0.2,5236,93,413318,78.92266564827192,9
0.2,5237,94,413412,78.92554410080183,8
0.2,5238,94,413506,78.92842145447605,8
0.2,5239,92,413598,78.93091603053435,9
0.2,5240,95,413693,78.9339820644915,6
0.2,5241,91,413784,78.93628386112171,10
0.2,5242,89,413873,78.93820331871066,12
0.2,5243,25,413898,78.9279176201373,8
0.2,5244,-51,413847,78.90314585319352,14
0.2,5245,96,413943,78.90640487990851,7
0.2,5246,90,414033,78.90851915380217,11
0.2,5247,96,414129,78.91177591463415,6
0.2,5248,94,414223,78.91465040960183,8
0.2,5249,93,414316,78.91733333333333,8
0.2,5250,92,414408,78.9198247952771,9
0.2,5251,90,414498,78.92193450114242,11
0.2,5252,93,414591,78.92461450599657,8
0.2,5253,95,414686,78.92767415302626,6
0.2,5254,96,414782,78.93092293054234,7
0.2,5255,95,414877,78.9339802130898,6
0.2,5256,95,414972,78.93703633250904,7
0.2,5257,21,414993,78.9260174971472,11
0.2,5258,90,415083,78.9281232173417,11
0.2,5259,93,415176,78.93079847908746,9
0.2,5260,93,415269,78.93347272381676,8
0.2,5261,92,415361,78.93595591030027,9
0.2,5262,95,415456,78.9390081702451,6
0.2,5263,96,415552,78.94224924012158,6
0.2,5264,92,415644,78.94472934472934,11
0.2,5265,94,415738,78.94758830231675,7
0.2,5266,92,415830,78.95006645149041,9
0.2,5267,88,415918,78.95178435839028,14
0.2,5268,89,416007,78.95369140254317,12
0.2,5269,94,416101,78.95654648956356,7
0.2,5270,92,416193,78.95902105862265,9
0.2,5271,91,416284,78.96130500758726,10
0.2,5272,-55,416229,78.93589986724825,18
0.2,5273,95,416324,78.93894577171028,7
0.2,5274,93,416417,78.94161137440759,8
0.2,5275,93,416510,78.9442759666414,9
0.2,5276,94,416604,78.94712905059693,7
0.2,5277,90,416694,78.9492231906025,11
0.2,5278,96,416790,78.95245311612048,6
0.2,5279,94,416884,78.95530303030303,7
0.2,5280,93,416977,78.95796250710093,9
0.2,5281,90,417067,78.9600530102234,11
0.2,5282,94,417161,78.96289986749953,7
0.2,5283,95,417256,78.96593489780469,6
0.2,5284,93,417349,78.96859035004731,9
0.2,5285,94,417443,78.9714339765418,8
0.2,5286,93,417536,78.9740873841498,9
0.2,5287,89,417625,78.97598335854765,12
0.2,5288,92,417717,78.97844583096993,10
0.2,5289,25,417742,78.96824196597353,8
0.2,5290,79,417821,78.96824796824797,22
0.2,5291,23,417844,78.95767195767196,9
0.2,5292,26,417870,78.94766672964292,7
0.2,5293,87,417957,78.94918775972799,15
0.2,5294,93,418050,78.95184135977337,8
0.2,5295,92,418142,78.95430513595166,9
0.2,5296,93,418235,78.95695676798188,8
0.2,5297,92,418327,78.95941864854662,11
0.2,5298,92,418419,78.96187959992452,9
0.2,5299,92,418511,78.9643396226415,9
0.2,5300,95,418606,78.96736464817958,7
0.2,5301,88,418694,78.96906827612221,14
0.2,5302,91,418785,78.97133697906845,10
0.2,5303,94,418879,78.97417043740573,8
0.2,5304,95,418974,78.97719132893496,6
0.2,5305,25,418999,78.96701846965699,7
0.2,5306,14,419013,78.95477671000565,18
0.2,5307,94,419107,78.95761115297664,7
0.2,5308,93,419200,78.96025616877002,8
0.2,5309,94,419294,78.96308851224106,7
0.2,5310,13,419307,78.95066842402561,19
0.2,5311,91,419398,78.95293674698796,10
0.2,5312,93,419491,78.95558065123282,9
0.2,5313,89,419580,78.95747083176515,12
0.2,5314,94,419674,78.96030103480715,7
0.2,5315,80,419754,78.96049661399549,22
0.2,5316,88,419842,78.9621967274779,13
0.2,5317,83,419925,78.96295599849567,20
0.2,5318,91,420016,78.96521902613273,13
0.2,5319,93,420109,78.96785714285714,10
0.2,5320,95,420204,78.97087013719225,6
0.2,5321,92,420296,78.97331830139045,9
0.2,5322,23,420319,78.9628029306782,9
0.2,5323,89,420408,78.96468820435763,12
0.2,5324,94,420502,78.9675117370892,8
0.2,5325,94,420596,78.97033420953811,7
0.2,5326,92,420688,78.97278017645955,9
0.2,5327,96,420784,78.97597597597597,6
0.2,5328,88,420872,78.97766935635204,14
0.2,5329,86,420958,78.97898686679174,15
0.2,5330,93,421051,78.98161695741886,8
0.2,5331,93,421144,78.98424606151538,10
0.2,5332,90,421234,78.98631164447778,11
0.2,5333,91,421325,78.98856392950881,10
0.2,5334,94,421419,78.99137769447047,7
0.2,5335,19,421438,78.98013493253373,13
0.2,5336,92,421530,78.98257448004497,9
0.2,5337,93,421623,78.9852004496066,8
0.2,5338,92,421715,78.98763813448211,9
0.2,5339,91,421806,78.98988764044944,11
0.2,5340,94,421900,78.99269799662984,7
0.2,5341,94,421994,78.99550730063646,7
0.2,5342,95,422089,78.99850271383119,6
0.2,5343,85,422174,78.999625748503,16
0.2,5344,95,422269,79.00261927034612,6
0.2,5345,91,422360,79.00486344930789,11
0.2,5346,89,422449,79.00673274733495,12
0.2,5347,93,422542,79.00934928945401,8
0.2,5348,23,422565,78.99887829500841,9
0.2,5349,90,422655,79.00093457943925,11
0.2,5350,95,422750,79.00392450009345,6
0.2,5351,87,422837,79.00541853512705,14
0.2,5352,92,422929,79.00784606762564,9
0.2,5353,95,423024,79.01083302203959,7
0.2,5354,94,423118,79.01363211951447,7
0.2,5355,93,423211,79.0162434652726,8
0.2,5356,89,423300,79.01810714952398,12
0.2,5357,94,423394,79.02090332213513,7
0.2,5358,96,423490,79.02407165515955,6
0.2,5359,91,423581,79.02630597014925,10
0.2,5360,87,423668,79.02779332214139,14
0.2,5361,23,423691,79.01734427452443,9
0.2,5362,94,423785,79.02013798247249,8
0.2,5363,90,423875,79.02218493661447,11
0.2,5364,86,423961,79.02348555452004,15
0.2,5365,94,424055,79.02627655609392,7
0.2,5366,91,424146,79.02850754611515,10
0.2,5367,93,424239,79.03111028315946,8
0.2,5368,92,424331,79.03352579623765,10
0.2,5369,93,424424,79.03612662942272,8
0.2,5370,93,424517,79.03872649413518,8
0.2,5371,95,424612,79.04169769173492,6
0.2,5372,89,424701,79.04355108877722,12
0.2,5373,95,424796,79.04652028284332,7
0.2,5374,94,424890,79.0493023255814,7
0.2,5375,-45,424845,79.02622767857143,9
0.2,5376,91,424936,79.02845452854751,10
0.2,5377,92,425028,79.03086649312012,9
0.2,5378,90,425118,79.03290574456219,11
0.2,5379,93,425211,79.03550185873605,8
0.2,5380,95,425306,79.03846868611782,6
0.2,5381,93,425399,79.04106280193237,9
0.2,5382,89,425488,79.04291287386216,12
0.2,5383,90,425578,79.04494799405646,12
0.2,5384,94,425672,79.04772516248839,7
0.2,5385,94,425766,79.0505012996658,7
0.2,5386,92,425858,79.05290514200854,9
0.2,5387,94,425952,79.05567928730513,7
0.2,5388,-45,425907,79.03265912043051,9
0.2,5389,25,425932,79.02263450834879,8
0.2,5390,94,426026,79.02541272491189,7
0.2,5391,22,426048,79.01483679525222,11
0.2,5392,94,426142,79.0176154274059,7
0.2,5393,93,426235,79.02020763811643,9
0.2,5394,24,426259,79.01000926784059,8
0.2,5395,26,426285,79.00018532246108,6
0.2,5396,14,426299,78.988141560126,18
0.2,5397,95,426394,78.99110781771026,6
0.2,5398,92,426486,78.99351731802186,9
0.2,5399,93,426579,78.9961111111111,8
0.2,5400,93,426672,78.99870394371413,8
0.2,5401,94,426766,79.00148093298779,8
0.2,5402,91,426857,79.00370164723302,10
0.2,5403,94,426951,79.00647668393782,7
0.2,5404,84,427035,79.00740055504163,17
0.2,5405,27,427062,78.99778024417314,6
0.2,5406,94,427156,79.00055483632329,7
0.2,5407,91,427247,79.00277366863905,12
0.2,5408,96,427343,79.00591606581624,6
0.2,5409,85,427428,79.00702402957486,16
0.2,5410,17,427445,78.99556459064868,15
0.2,5411,93,427538,78.99815225424982,9
0.2,5412,91,427629,79.00036948087937,10
0.2,5413,95,427724,79.00332471370521,6
0.2,5414,17,427741,78.99187442289936,16
0.2,5415,96,427837,78.99501477104874,6
0.2,5416,21,427858,78.98430865792874,11
0.2,5417,95,427953,78.98726467331119,6
0.2,5418,91,428044,78.98948145414283,10
0.2,5419,91,428135,78.99169741697418,10
0.2,5420,95,428230,78.99465043349936,6
0.2,5421,87,428317,78.99612689044633,15
0.2,5422,94,428411,78.99889360132768,7
0.2,5423,91,428502,79.00110619469027,12
0.2,5424,90,428592,79.00313364055299,12
0.2,5425,94,428686,79.00589753040914,7
0.2,5426,94,428780,79.00866040169522,7
0.2,5427,93,428873,79.01123802505526,8
0.2,5428,94,428967,79.0139988948241,7
0.2,5429,91,429058,79.01620626151013,10
0.2,5430,94,429152,79.01896519977905,7
0.2,5431,94,429246,79.02172312223858,7
0.2,5432,88,429334,79.02337566721884,14
0.2,5433,96,429430,79.0264998159735,6
0.2,5434,93,429523,79.02907083716651,8
0.2,5435,91,429614,79.03127299484916,11
0.2,5436,92,429706,79.03365826742689,9
0.2,5437,88,429794,79.03530709819786,13
0.2,5438,15,429809,79.02353373781945,19
0.2,5439,93,429902,79.02610294117648,9
0.2,5440,90,429992,79.02811983091344,11
0.2,5441,93,430085,79.03068724733554,8
0.2,5442,93,430178,79.03325372037479,9
0.2,5443,90,430268,79.03526818515797,11
0.2,5444,90,430358,79.03728191000918,11
0.2,5445,94,430452,79.040029379361,8
0.2,5446,85,430537,79.04112355425005,17
0.2,5447,89,430626,79.04295154185021,12
0.2,5448,92,430718,79.04532941824188,10
0.2,5449,27,430745,79.03577981651377,6
0.2,5450,94,430839,79.03852504127683,7
0.2,5451,95,430934,79.04145267791637,7
0.2,5452,88,431022,79.0430955437374,14
0.2,5453,26,431048,79.03337000366703,7
0.2,5454,96,431144,79.03648029330888,6
0.2,5455,-56,431088,79.0117302052786,19
0.2,5456,21,431109,79.00109950522265,11
0.2,5457,93,431202,79.00366434591426,8
0.2,5458,94,431296,79.00641143066495,7
0.2,5459,95,431391,79.00934065934067,6
0.2,5460,94,431485,79.01208569859,7
0.2,5461,18,431503,79.00091541559868,14
0.2,5462,94,431597,79.00366099212887,7
0.2,5463,94,431691,79.00640556368961,8
0.2,5464,90,431781,79.00841720036597,12
0.2,5465,93,431874,79.01097694840834,8
0.2,5466,89,431963,79.01280409731113,12
0.2,5467,87,432050,79.01426481346013,14
0.2,5468,89,432139,79.0160906929969,12
0.2,5469,94,432233,79.01882998171847,7
0.2,5470,95,432328,79.02175105099616,7
0.2,5471,24,432352,79.01169590643275,8
0.2,5472,95,432447,79.01461721176686,7
0.2,5473,95,432542,79.01753744976251,6
0.2,5474,92,432634,79.01990867579909,9
0.2,5475,94,432728,79.02264426588751,9
0.2,5476,94,432822,79.02537885703852,8
0.2,5477,92,432914,79.02774735304855,9
0.2,5478,95,433009,79.0306625296587,7
0.2,5479,93,433102,79.03321167883212,8
0.2,5480,91,433193,79.03539500091225,10
0.2,5481,92,433285,79.03775994162714,9
0.2,5482,-48,433237,79.01459055261718,13
0.2,5483,92,433329,79.01695842450766,9
0.2,5484,94,433423,79.01969006381039,7
0.2,5485,96,433519,79.02278527160044,6
0.2,5486,94,433613,79.0255148532896,7
0.2,5487,89,433702,79.02733236151603,13
0.2,5488,89,433791,79.02914920750592,13
0.2,5489,93,433884,79.03169398907104,8
0.2,5490,94,433978,79.03441995993444,7
0.2,5491,95,434073,79.03732702112163,6
0.2,5492,92,434165,79.03968687420353,9
0.2,5493,25,434190,79.02985074626865,7
0.2,5494,92,434282,79.03221110100091,9
0.2,5495,92,434374,79.03457059679766,9
0.2,5496,23,434397,79.02437693287247,10
0.2,5497,90,434487,79.02637322662787,11
0.2,5498,25,434512,79.01654846335697,8
0.2,5499,77,434589,79.01618181818182,24
0.2,5500,95,434684,79.01908743864752,6
0.2,5501,94,434778,79.02181025081788,7
0.2,5502,94,434872,79.0245320734145,7
0.2,5503,88,434960,79.02616279069767,13
0.2,5504,90,435050,79.02815622161671,12
0.2,5505,95,435145,79.03105702869597,8
0.2,5506,95,435240,79.0339567822771,6
0.2,5507,95,435335,79.03685548293392,6
0.2,5508,95,435430,79.03975313123979,6
0.2,5509,89,435519,79.04156079854809,12
0.2,5510,90,435609,79.04354926510615,11
0.2,5511,96,435705,79.04662554426706,6
0.2,5512,88,435793,79.04824959187376,13
0.2,5513,88,435881,79.04987305041712,14
0.2,5514,91,435972,79.05203989120581,10
0.2,5515,91,436063,79.05420594633793,10
0.2,5516,95,436158,79.05709624796084,7
0.2,5517,92,436250,79.05944182674882,10
0.2,5518,91,436341,79.06160536329045,10
0.2,5519,92,436433,79.06394927536232,9
0.2,5520,94,436527,79.0666545915595,7
0.2,5521,96,436623,79.06972111553785,6
0.2,5522,90,436713,79.07170016295491,11
0.2,5523,90,436803,79.07367849384504,11
0.2,5524,86,436889,79.07493212669684,15
0.2,5525,92,436981,79.07727108215708,9
0.2,5526,19,437000,79.06640130269585,13
0.2,5527,96,437096,79.06946454413892,6
0.2,5528,88,437184,79.07107976125882,13
0.2,5529,93,437277,79.07359855334539,8
0.2,5530,94,437371,79.07629723377327,8
0.2,5531,92,437463,79.07863340563992,9
0.2,5532,95,437558,79.08151093439363,7
0.2,5533,94,437652,79.08420672208167,8
0.2,5534,94,437746,79.08690153568202,7
0.2,5535,96,437842,79.08995664739885,6
0.2,5536,94,437936,79.09264944916019,7
0.2,5537,91,438027,79.09479956663056,10
0.2,5538,96,438123,79.09785159776133,6
0.2,5539,91,438214,79.1,10
0.2,5540,85,438299,79.10106478974915,16
0.2,5541,91,438390,79.103211836882,10
0.2,5542,96,438486,79.10626014793434,6
0.2,5543,94,438580,79.10894660894661,7
0.2,5544,92,438672,79.11127141568981,9
0.2,5545,94,438766,79.11395600432745,7
0.2,5546,93,438859,79.116459347395,9
0.2,5547,94,438953,79.1191420331651,7
0.2,5548,95,439048,79.12200396467831,6
0.2,5549,27,439075,79.11261261261261,6
0.2,5550,95,439170,79.11547468924518,6
0.2,5551,95,439265,79.11833573487031,6
0.2,5552,94,439359,79.12101566720692,7
0.2,5553,93,439452,79.12351458408354,8
0.2,5554,90,439542,79.12547254725473,11
0.2,5555,92,439634,79.12778977681785,9
0.2,5556,91,439725,79.12992621918302,10
0.2,5557,94,439819,79.13260165527169,8
0.2,5558,95,439914,79.13545601726929,6
0.2,5559,26,439940,79.12589928057554,7
0.2,5560,91,440031,79.12803452616436,10
0.2,5561,94,440125,79.1307083782812,7
0.2,5562,88,440213,79.13230271436275,13
0.2,5563,94,440307,79.13497483824587,7
0.2,5564,93,440400,79.13746630727763,8
0.2,5565,93,440493,79.1399568810636,8
0.2,5566,88,440581,79.14154841027484,13
0.2,5567,94,440675,79.144216954023,7
0.2,5568,86,440761,79.14544801580176,16
0.2,5569,-46,440715,79.1229802513465,10
0.2,5570,90,440805,79.12493268712979,11
0.2,5571,89,440894,79.12670495333812,12
0.2,5572,92,440986,79.12901489323524,9
0.2,5573,92,441078,79.13132400430571,9
0.2,5574,88,441166,79.13291479820627,13
0.2,5575,90,441256,79.1348637015782,11
0.2,5576,23,441279,79.12479827864443,10
0.2,5577,92,441371,79.12710648978128,9
0.2,5578,94,441465,79.12977236063811,8
0.2,5579,94,441559,79.13243727598567,8
0.2,5580,91,441650,79.13456369826196,10
0.2,5581,24,441674,79.12468649229666,9
0.2,5582,96,441770,79.12770911696221,6
0.2,5583,92,441862,79.13001432664757,9
0.2,5584,96,441958,79.13303491495076,6
0.2,5585,19,441977,79.12226996061582,13
0.2,5586,93,442070,79.12475389296581,8
0.2,5587,85,442155,79.12580529706514,16
0.2,5588,92,442247,79.12810878511361,9
0.2,5589,92,442339,79.1304114490161,10
0.2,5590,93,442432,79.13289214809515,8
0.2,5591,93,442525,79.13537195994277,8
0.2,5592,87,442612,79.13677811550151,16
0.2,5593,96,442708,79.13979263496603,7
0.2,5594,93,442801,79.14226988382484,8
0.2,5595,91,442892,79.14438884917799,10
0.2,5596,96,442988,79.14740039306771,6
0.2,5597,89,443077,79.14916041443372,12
0.2,5598,95,443172,79.15199142704054,8
0.2,5599,90,443262,79.15392857142857,11
0.2,5600,95,443357,79.15675772183539,7
0.2,5601,92,443449,79.15905033916458,9
0.2,5602,95,443544,79.16187756558986,6
0.2,5603,94,443638,79.16452533904354,7
0.2,5604,93,443731,79.16699375557538,8
0.2,5605,94,443825,79.16963967178023,7
0.2,5606,82,443907,79.1701444622793,20
0.2,5607,95,444002,79.17296718972896,6
0.2,5608,87,444089,79.17436263148511,14
0.2,5609,91,444180,79.17647058823529,10
0.2,5610,92,444272,79.17875601497059,9
0.2,5611,94,444366,79.18139700641483,7
0.2,5612,94,444460,79.18403705683235,8
0.2,5613,89,444549,79.1857855361596,12
0.2,5614,22,444571,79.17560106856634,10
0.2,5615,94,444665,79.17824074074075,7
0.2,5616,23,444688,79.16823927363362,9
0.2,5617,93,444781,79.17070131719473,8
0.2,5618,95,444876,79.17351841964762,6
0.2,5619,91,444967,79.17562277580072,11
0.2,5620,95,445062,79.17843800035581,7
0.2,5621,92,445154,79.18071860547848,9
0.2,5622,85,445239,79.18175351235995,17
0.2,5623,93,445332,79.1842105263158,8
0.2,5624,92,445424,79.18648888888889,9
0.2,5625,92,445516,79.18876644152151,9
0.2,5626,95,445611,79.19157632841656,6
0.2,5627,95,445706,79.19438521677327,6
0.2,5628,94,445800,79.19701545567597,7
0.2,5629,92,445892,79.19928952042629,9
0.2,5630,95,445987,79.2020955425324,6
0.2,5631,91,446078,79.2041903409091,10
0.2,5632,93,446171,79.20663944612107,8
0.2,5633,91,446262,79.2087326943557,11
0.2,5634,94,446356,79.21135758651286,7
0.2,5635,93,446449,79.21380411639461,8
0.2,5636,91,446540,79.21589497959907,11
0.2,5637,94,446634,79.21851720468251,7
0.2,5638,94,446728,79.221138499734,7
0.2,5639,93,446821,79.22358156028369,8
0.2,5640,95,446916,79.22637830171955,6
0.2,5641,23,446939,79.21641261963843,11
0.2,5642,96,447035,79.2193868509658,6
0.2,5643,95,447130,79.22218284904324,7
0.2,5644,24,447154,79.21240035429584,9
0.2,5645,94,447248,79.2150194828197,7
0.2,5646,94,447342,79.21763768372587,8
0.2,5647,94,447436,79.22025495750708,7
0.2,5648,21,447457,79.20994866348026,13
0.2,5649,92,447549,79.21221238938053,9
0.2,5650,94,447643,79.21482923376394,7
0.2,5651,93,447736,79.21726822363765,9
0.2,5652,83,447819,79.21793737838316,18
0.2,5653,26,447845,79.20852493809693,7
0.2,5654,91,447936,79.2106100795756,11
0.2,5655,89,448025,79.21234087694484,12
0.2,5656,90,448115,79.21424783454128,11
0.2,5657,88,448203,79.21580063626723,13
0.2,5658,94,448297,79.21841314719916,8
0.2,5659,92,448389,79.22067137809188,10
0.2,5660,89,448478,79.22239886945769,12
0.2,5661,91,448569,79.22447898269162,10
0.2,5662,93,448662,79.22691153099063,8
0.2,5663,95,448757,79.22969632768361,7
0.2,5664,95,448852,79.232480141218,7
0.2,5665,93,448945,79.23490998941053,8
0.2,5666,94,449039,79.23751544026823,8
0.2,5667,93,449132,79.23994354269584,8
0.2,5668,94,449226,79.24254718645264,7
0.2,5669,88,449314,79.24409171075838,13
0.2,5670,90,449404,79.24598836184094,11
0.2,5671,94,449498,79.24858956276445,7
0.2,5672,93,449591,79.25101357306539,8
0.2,5673,23,449614,79.24109975326049,9
0.2,5674,82,449696,79.2415859030837,20
0.2,5675,86,449782,79.24277660324172,15
0.2,5676,90,449872,79.24467148141625,11
0.2,5677,94,449966,79.24727016555126,7
0.2,5678,92,450058,79.24951575981687,9
0.2,5679,93,450151,79.25193661971831,8
0.2,5680,95,450246,79.25470867804964,7
0.2,5681,92,450338,79.25695177754312,9
0.2,5682,94,450432,79.259546014429,8
0.2,5683,94,450526,79.26213933849402,7
0.2,5684,84,450610,79.26297273526825,17
0.2,5685,94,450704,79.26556454449525,7
0.2,5686,77,450781,79.26516616845437,25
0.2,5687,95,450876,79.26793248945148,7
0.2,5688,95,450971,79.27069783793286,8
0.2,5689,91,451062,79.27275922671353,10
0.2,5690,94,451156,79.27534703918468,7
0.2,5691,21,451177,79.26510892480674,12
0.2,5692,93,451270,79.26752151765326,8
0.2,5693,96,451366,79.27046013347383,8
0.2,5694,94,451460,79.27304653204565,9
0.2,5695,90,451550,79.2749297752809,11
0.2,5696,91,451641,79.2769878883623,10
0.2,5697,92,451733,79.27922077922078,9
0.2,5698,94,451827,79.2818038252325,8
0.2,5699,25,451852,79.27228070175438,8
0.2,5700,96,451948,79.27521487458341,6
0.2,5701,27,451975,79.26604700105226,6
0.2,5702,94,452069,79.26863054532703,7
0.2,5703,95,452164,79.27138849929874,6
0.2,5704,94,452258,79.27397020157757,7
0.2,5705,23,452281,79.26410795653698,9
0.2,5706,93,452374,79.26651480637813,8
0.2,5707,92,452466,79.2687456201822,9
0.2,5708,93,452559,79.27115081450341,8
0.2,5709,94,452653,79.27373029772329,7
0.2,5710,94,452747,79.27630887760462,7
0.2,5711,96,452843,79.27923669467788,6
0.2,5712,96,452939,79.28216348678453,6
0.2,5713,94,453033,79.28473923696185,8
0.2,5714,95,453128,79.28748906386701,6
0.2,5715,92,453220,79.28971308607417,9
0.2,5716,89,453309,79.29141157949974,12
0.2,5717,91,453400,79.29345925148654,10
0.2,5718,92,453492,79.29568106312293,9
0.2,5719,90,453582,79.29755244755245,11
0.2,5720,93,453675,79.2999475616151,8
0.2,5721,88,453763,79.30146801817547,13
0.2,5722,93,453856,79.30386161104316,8
0.2,5723,92,453948,79.30607966457023,9
0.2,5724,93,454041,79.30847161572052,8
0.2,5725,89,454130,79.31016416346489,12
0.2,5726,96,454226,79.31307840055875,7
0.2,5727,80,454306,79.31319832402235,21
0.2,5728,90,454396,79.31506371094432,11
0.2,5729,88,454484,79.31657940663176,13
0.2,5730,92,454576,79.31879253184435,9
0.2,5731,81,454657,79.31908583391487,20
0.2,5732,95,454752,79.32182103610675,6
0.2,5733,94,454846,79.3243808859435,8
0.2,5734,95,454941,79.32711421098517,6
0.2,5735,92,455033,79.32932357043235,9
0.2,5736,94,455127,79.33188077392366,7
0.2,5737,93,455220,79.33426280934124,9
0.2,5738,91,455311,79.33629552186792,10
0.2,5739,11,455322,79.32439024390244,21
0.2,5740,93,455415,79.3267723393137,9
0.2,5741,93,455508,79.32915360501568,8
0.2,5742,92,455600,79.33135991641998,9
0.2,5743,94,455694,79.33391364902506,7
0.2,5744,-46,455648,79.31209747606614,9
0.2,5745,90,455738,79.31395753567699,13
0.2,5746,87,455825,79.3152949364886,15
0.2,5747,92,455917,79.31750173973556,9
0.2,5748,94,456011,79.32005566185424,8
0.2,5749,23,456034,79.31026086956521,11
0.2,5750,90,456124,79.31211963136846,11
0.2,5751,93,456217,79.3144993045897,8
0.2,5752,93,456310,79.31687815053016,8
0.2,5753,92,456402,79.31908237747653,10
0.2,5754,88,456490,79.32059079061686,13
0.2,5755,91,456581,79.32261987491313,10
0.2,5756,91,456672,79.32464825429912,10
0.2,5757,95,456767,79.3273706147968,6
0.2,5758,95,456862,79.3300920298663,6
0.2,5759,95,456957,79.3328125,6
0.2,5760,93,457050,79.33518486373893,8
0.2,5761,83,457133,79.33582089552239,18
0.2,5762,94,457227,79.33836543466944,7
0.2,5763,96,457323,79.3412560721721,6
0.2,5764,96,457419,79.34414570685169,6
0.2,5765,92,457511,79.34634061741242,9
0.2,5766,92,457603,79.34853476677648,9
0.2,5767,96,457699,79.35142163661581,6
0.2,5768,24,457723,79.3418270064136,9
0.2,5769,86,457809,79.34298093587522,15
0.2,5770,94,457903,79.3455207069832,8
0.2,5771,89,457992,79.34719334719335,15
0.2,5772,91,458083,79.34921184825913,10
0.2,5773,15,458098,79.33806719778316,17
0.2,5774,93,458191,79.3404329004329,9
0.2,5775,95,458286,79.34314404432133,6
0.2,5776,93,458379,79.34550804916046,8
0.2,5777,95,458474,79.34821737625477,6
0.2,5778,85,458559,79.34919536251947,16
0.2,5779,90,458649,79.35103806228373,12
0.2,5780,93,458742,79.35339906590555,9
0.2,5781,95,458837,79.35610515392598,6
0.2,5782,91,458928,79.35811862355179,10
0.2,5783,94,459022,79.36065006915629,8
0.2,5784,89,459111,79.36231633535004,12
0.2,5785,91,459202,79.36432768752161,10
0.2,5786,94,459296,79.36685674788319,9
0.2,5787,88,459384,79.36834830684174,14
0.2,5788,90,459474,79.37018483330455,11
0.2,5789,95,459569,79.37288428324698,6
0.2,5790,95,459664,79.37558280089794,6
0.2,5791,96,459760,79.37845303867404,6
0.2,5792,92,459852,79.38063179699637,10
0.2,5793,92,459944,79.38280980324474,9
0.2,5794,91,460035,79.38481449525453,10
0.2,5795,95,460130,79.38750862663906,7
0.2,5796,94,460224,79.3900293255132,10
0.2,5797,95,460319,79.39272162814764,8
0.2,5798,94,460413,79.39524055871702,7
0.2,5799,94,460507,79.39775862068966,7
0.2,5800,94,460601,79.40027581451474,7
0.2,5801,92,460693,79.40244743192002,9
0.2,5802,90,460783,79.40427365155954,11
0.2,5803,90,460873,79.40609924190214,11
0.2,5804,87,460960,79.4074074074074,14
0.2,5805,27,460987,79.39838098518774,6
0.2,5806,91,461078,79.40037885310832,10
0.2,5807,95,461173,79.40306473829202,7
0.2,5808,91,461264,79.40506111206749,10
0.2,5809,92,461356,79.40722891566266,9
0.2,5810,95,461451,79.40991223541559,6
0.2,5811,93,461544,79.41225051617343,8
0.2,5812,95,461639,79.41493204885602,8
0.2,5813,90,461729,79.41675266597868,11
0.2,5814,95,461824,79.41943250214962,6
0.2,5815,95,461919,79.42211141678129,6
0.2,5816,96,462015,79.42496132026818,6
0.2,5817,94,462109,79.4274664833276,7
0.2,5818,90,462199,79.42928338202441,11
0.2,5819,94,462293,79.43178694158075,7
0.2,5820,94,462387,79.43428964095516,8
0.2,5821,92,462479,79.43644795602886,9
0.2,5822,81,462560,79.43671646917396,20
0.2,5823,91,462651,79.43870192307692,10
0.2,5824,89,462740,79.44034334763948,12
0.2,5825,94,462834,79.44284243048403,7
0.2,5826,94,462928,79.4453406555689,7
0.2,5827,89,463017,79.44698009608786,12
0.2,5828,95,463112,79.44964831017327,8
0.2,5829,21,463133,79.43962264150943,12
0.2,5830,87,463220,79.4409192248328,14
0.2,5831,92,463312,79.44307270233196,9
0.2,5832,96,463408,79.44591119492543,6
0.2,5833,92,463500,79.44806307850531,9
0.2,5834,20,463520,79.43787489288775,12
0.2,5835,94,463614,79.44037011651817,7
0.2,5836,90,463704,79.44217920164468,11
0.2,5837,90,463794,79.44398766700925,13
0.2,5838,92,463886,79.44613803733516,9
0.2,5839,20,463906,79.43595890410958,12
0.2,5840,20,463926,79.42578325629174,14
0.2,5841,88,464014,79.42725094145841,13
0.2,5842,94,464108,79.42974499400992,8
0.2,5843,92,464200,79.4318959616701,9
0.2,5844,94,464294,79.43438836612489,7
0.2,5845,93,464387,79.4367088607595,8
0.2,5846,93,464480,79.43902856165555,8
0.2,5847,92,464572,79.44117647058823,9
0.2,5848,92,464664,79.44332364506754,9
0.2,5849,91,464755,79.44529914529915,11
0.2,5850,95,464850,79.44795761408307,6
0.2,5851,94,464944,79.45044429254956,7
0.2,5852,87,465031,79.45173415342559,14
0.2,5853,93,465124,79.4540485138367,11
0.2,5854,94,465218,79.45653287788215,7
0.2,5855,91,465309,79.45850409836065,10
0.2,5856,91,465400,79.46047464572307,12
0.2,5857,94,465494,79.46295664049164,8
0.2,5858,95,465589,79.46560846560847,6
0.2,5859,94,465683,79.46808873720137,7
0.2,5860,15,465698,79.45708923391912,21
0.2,5861,95,465793,79.4597407028318,7
0.2,5862,94,465887,79.46222070612315,7
0.2,5863,94,465981,79.46469986357435,7
0.2,5864,89,466070,79.46632566069906,12
0.2,5865,16,466086,79.45550630753495,17
0.2,5866,96,466182,79.45832623146413,6
0.2,5867,95,466277,79.46097477845944,6
0.2,5868,90,466367,79.46277048901005,12
0.2,5869,87,466454,79.46405451448041,15
0.2,5870,89,466543,79.46567876000681,12
0.2,5871,15,466558,79.45470027247957,17
0.2,5872,94,466652,79.45717691128895,7
0.2,5873,90,466742,79.45897173987062,11
0.2,5874,93,466835,79.46127659574468,8
0.2,5875,93,466928,79.4635806671205,8
0.2,5876,95,467023,79.46622426408031,8
0.2,5877,92,467115,79.46835658387207,9
0.2,5878,92,467207,79.4704881782616,10
0.2,5879,88,467295,79.47193877551021,13
0.2,5880,90,467385,79.47372895766026,11
0.2,5881,95,467480,79.47636858211493,7
0.2,5882,86,467566,79.47747747747748,15
0.2,5883,90,467656,79.47926580557444,11
0.2,5884,93,467749,79.48156329651657,8
0.2,5885,84,467833,79.48233095480802,19
0.2,5886,92,467925,79.48445727874979,10
0.2,5887,91,468016,79.48641304347827,10
0.2,5888,15,468031,79.47546272711836,19
0.2,5889,90,468121,79.47724957555178,11
0.2,5890,27,468148,79.46834153793922,7
0.2,5891,83,468231,79.46894093686355,19
0.2,5892,91,468322,79.47089767520788,11
0.2,5893,92,468414,79.47302341364099,10
0.2,5894,95,468509,79.47565733672604,7
0.2,5895,92,468601,79.4777815468114,9
0.2,5896,95,468696,79.48041376971341,7
0.2,5897,95,468791,79.4830451000339,6
0.2,5898,95,468886,79.48567553822681,6
0.2,5899,92,468978,79.4877966101695,9
0.2,5900,89,469067,79.48940857481783,12
0.2,5901,21,469088,79.4794984750932,11
0.2,5902,90,469178,79.48128070472642,11
0.2,5903,82,469260,79.48170731707317,19
0.2,5904,85,469345,79.4826418289585,16
0.2,5905,92,469437,79.48476125973586,9
0.2,5906,92,469529,79.4868799729135,9
0.2,5907,90,469619,79.48865944482058,11
0.2,5908,92,469711,79.49077678118125,9
0.2,5909,94,469805,79.4932318104907,9
0.2,5910,90,469895,79.49500930468618,12
0.2,5911,92,469987,79.4971244925575,9
0.2,5912,91,470078,79.4990698461018,10
0.2,5913,94,470172,79.50152181264795,7
0.2,5914,93,470265,79.50380388841927,8
0.2,5915,92,470357,79.50591615956728,9
0.2,5916,95,470452,79.50853473043772,6
0.2,5917,89,470541,79.51013856032444,12
0.2,5918,96,470637,79.51292448048657,6
0.2,5919,91,470728,79.51486486486486,11
0.2,5920,90,470818,79.51663570342848,11
0.2,5921,82,470900,79.51705504896994,20
0.2,5922,88,470988,79.5184872530812,13
0.2,5923,90,471078,79.5202565833896,11
0.2,5924,85,471163,79.52118143459916,16
0.2,5925,92,471255,79.52328720890989,9
0.2,5926,94,471349,79.52572971148979,8
0.2,5927,93,471442,79.52800269905534,8
0.2,5928,96,471538,79.53078090740428,6
0.2,5929,91,471629,79.53271500843171,10
0.2,5930,90,471719,79.53447985162704,12
0.2,5931,94,471813,79.53691840863115,8
0.2,5932,93,471906,79.5391875948087,8
0.2,5933,-49,471857,79.5175261206606,13
0.2,5934,93,471950,79.51979780960404,8
0.2,5935,94,472044,79.5222371967655,7
0.2,5936,92,472136,79.52433889169615,9
0.2,5937,84,472220,79.52509262377905,17
0.2,5938,94,472314,79.52752988718639,8
0.2,5939,95,472409,79.53013468013468,7
0.2,5940,91,472500,79.53206530887056,10
0.2,5941,93,472593,79.53433187478963,8
0.2,5942,93,472686,79.53659767794043,8
0.2,5943,95,472781,79.53919919246299,6
0.2,5944,92,472873,79.54129520605551,9
0.2,5945,93,472966,79.54355869492096,8
0.2,5946,94,473060,79.54598957457542,7
0.2,5947,96,473156,79.54875588433087,6
0.2,5948,91,473247,79.55068078668684,10
0.2,5949,91,473338,79.55260504201681,10
0.2,5950,95,473433,79.55520080658712,6
0.2,5951,96,473529,79.55796370967742,6
0.2,5952,93,473622,79.56022173693935,8
0.2,5953,90,473712,79.56197514276117,11
0.2,5954,94,473806,79.56439966414777,8
0.2,5955,91,473897,79.566319677636,10
0.2,5956,95,473992,79.56891052543226,6
0.2,5957,26,474018,79.55991943605237,8
0.2,5958,86,474104,79.56100016781339,15
0.2,5959,96,474200,79.56375838926175,6
0.2,5960,94,474294,79.56618017111224,7
0.2,5961,91,474385,79.56809795370681,10
0.2,5962,93,474478,79.57035049471743,8
0.2,5963,88,474566,79.57176391683434,13
0.2,5964,93,474659,79.57401508801341,9
0.2,5965,96,474755,79.57676835400603,6
0.2,5966,86,474841,79.57784481313892,16
0.2,5967,94,474935,79.58026139410188,8
0.2,5968,25,474960,79.57111744010722,8
0.2,5969,93,475053,79.57336683417086,8
0.2,5970,95,475148,79.57595042706414,6
0.2,5971,93,475241,79.57819825853986,10
0.2,5972,92,475333,79.5802779172945,9
0.2,5973,93,475426,79.58252427184466,8
0.2,5974,95,475521,79.58510460251046,6
0.2,5975,25,475546,79.57597054886212,8
0.2,5976,77,475623,79.57553956834532,24
0.2,5977,24,475647,79.56624289059886,9
0.2,5978,96,475743,79.5689914701455,6
0.2,5979,83,475826,79.5695652173913,18
0.2,5980,90,475916,79.57130914562782,11
0.2,5981,96,476012,79.57405549983284,6
0.2,5982,94,476106,79.57646665552399,8
0.2,5983,92,476198,79.57854278074866,9
0.2,5984,94,476292,79.58095238095238,7
0.2,5985,95,476387,79.5835282325426,6
0.2,5986,93,476480,79.58576916652747,8
0.2,5987,26,476506,79.57682030728122,7
0.2,5988,92,476598,79.57889464017366,9
0.2,5989,95,476693,79.581469115192,6
0.2,5990,92,476785,79.58354197963612,9
0.2,5991,96,476881,79.58628170894526,6
0.2,5992,95,476976,79.58885366260637,6
0.2,5993,93,477069,79.59109109109109,9
0.2,5994,92,477161,79.5931609674729,10
0.2,5995,96,477257,79.59589726484323,6
0.2,5996,84,477341,79.59663164915791,17
0.2,5997,94,477435,79.59903301100367,7
0.2,5998,93,477528,79.60126687781298,9
0.2,5999,92,477620,79.60333333333334,9
0.2,6000,95,477715,79.60589901683053,6
0.2,6001,95,477810,79.60846384538488,7
0.2,6002,94,477904,79.61086123604865,7
0.2,6003,91,477995,79.61275816122586,10
0.2,6004,96,478091,79.61548709408827,6
0.2,6005,15,478106,79.6047286047286,17
0.2,6006,94,478200,79.60712502080905,7
0.2,6007,93,478293,79.60935419440746,8
0.2,6008,95,478388,79.61191546014312,6
0.2,6009,83,478471,79.61247920133111,18
0.2,6010,95,478566,79.61503909499251,7
0.2,6011,92,478658,79.61709913506321,9
0.2,6012,91,478749,79.6189921836022,10
0.2,6013,94,478843,79.62138343864316,7
0.2,6014,90,478933,79.62310889443059,11
0.2,6015,92,479025,79.62516622340425,9
0.2,6016,86,479111,79.62622569386737,16
0.2,6017,93,479204,79.62844798936524,9
0.2,6018,92,479296,79.63050340588137,9
0.2,6019,85,479381,79.63139534883722,16
0.2,6020,92,479473,79.63344959309084,10
0.2,6021,95,479568,79.6360013284623,6
0.2,6022,96,479664,79.6387182467209,6
0.2,6023,92,479756,79.64077025232403,9
0.2,6024,93,479849,79.64298755186722,8
0.2,6025,17,479866,79.63259210089612,15
0.2,6026,91,479957,79.63447818151651,10
0.2,6027,92,480049,79.6365295288653,10
0.2,6028,90,480139,79.63824846574889,11
0.2,6029,94,480233,79.64063018242123,8
0.2,6030,91,480324,79.6425136793235,10
0.2,6031,92,480416,79.64456233421751,10
0.2,6032,94,480510,79.64694181999006,8
0.2,6033,96,480606,79.64965197215777,6
0.2,6034,94,480700,79.65202982601491,7
0.2,6035,95,480795,79.65457256461232,8
0.2,6036,91,480886,79.65645188007288,12
0.2,6037,96,480982,79.65915866180855,6
0.2,6038,90,481072,79.6608710051333,11
0.2,6039,94,481166,79.66324503311259,7
0.2,6040,95,481261,79.66578381062737,6
0.2,6041,92,481353,79.66782522343595,9
0.2,6042,94,481447,79.67019692205858,7
0.2,6043,95,481542,79.67273328921245,6
0.2,6044,93,481635,79.67493796526054,8
0.2,6045,90,481725,79.67664571617598,12
0.2,6046,91,481816,79.67851827352406,10
0.2,6047,92,481908,79.68055555555556,9
0.2,6048,23,481931,79.67118531988758,10
0.2,6049,87,482018,79.67239669421488,14
0.2,6050,91,482109,79.67426871591472,10
0.2,6051,91,482200,79.67614011896893,10
0.2,6052,94,482294,79.67850652568974,7
0.2,6053,90,482384,79.6802114304592,12
0.2,6054,93,482477,79.68241123038811,8
0.2,6055,95,482572,79.68494055482167,7
0.2,6056,94,482666,79.68730394584777,7
0.2,6057,93,482759,79.68950148563883,8
0.2,6058,92,482851,79.69153325631292,10
0.2,6059,85,482936,79.69240924092409,16
0.2,6060,95,483031,79.6949348292361,6
0.2,6061,95,483126,79.69745958429561,6
0.2,6062,86,483212,79.69849909285833,15
0.2,6063,91,483303,79.70036279683377,12
0.2,6064,94,483397,79.70272052761747,7
0.2,6065,87,483484,79.7039235080778,14
0.2,6066,84,483568,79.7046316136476,17
0.2,6067,93,483661,79.70682267633487,9
0.2,6068,94,483755,79.70917778876256,7
0.2,6069,92,483847,79.71120263591433,9
0.2,6070,84,483931,79.71190907593477,17
0.2,6071,1,483932,79.69894598155467,31
0.2,6072,92,484024,79.7009715132554,9
0.2,6073,95,484119,79.7034902864669,7
0.2,6074,90,484209,79.70518518518519,11
0.2,6075,95,484304,79.70770243581303,6
0.2,6076,90,484394,79.70939608359387,11
0.2,6077,86,484480,79.71043106284962,16
0.2,6078,92,484572,79.71245270603718,9
0.2,6079,88,484660,79.71381578947368,13
0.2,6080,90,484750,79.71550731787535,11
0.2,6081,93,484843,79.71769154883262,8
0.2,6082,94,484937,79.72003945421667,8
0.2,6083,94,485031,79.7223865877712,8
0.2,6084,91,485122,79.72423993426459,11
0.2,6085,94,485216,79.72658560630957,9
0.2,6086,94,485310,79.72893050763923,7
0.2,6087,94,485404,79.73127463863338,7
0.2,6088,96,485500,79.733946460831,6
0.2,6089,94,485594,79.73628899835796,7
0.2,6090,95,485689,79.73879494335905,6
0.2,6091,86,485775,79.7398227183191,15
0.2,6092,95,485870,79.74232726079107,7
0.2,6093,94,485964,79.74466688546111,7
0.2,6094,87,486051,79.74585726004922,14
0.2,6095,94,486145,79.74819553805774,8
0.2,6096,87,486232,79.7493849434148,14
0.2,6097,91,486323,79.75122991144637,10
0.2,6098,90,486413,79.7529103131661,11
0.2,6099,84,486497,79.75360655737705,17
0.2,6100,93,486590,79.75577774135388,8
0.2,6101,96,486686,79.75843985578499,6
0.2,6102,94,486780,79.760773390136,7
0.2,6103,95,486875,79.76326998689385,6
0.2,6104,85,486960,79.76412776412776,17
0.2,6105,93,487053,79.76629544710121,8
0.2,6106,93,487146,79.76846242017358,8
0.2,6107,92,487238,79.77046496398167,9
0.2,6108,93,487331,79.7726305450974,8
0.2,6109,96,487427,79.77528641571195,6
0.2,6110,91,487518,79.77712322042218,10
0.2,6111,94,487612,79.7794502617801,8
0.2,6112,95,487707,79.78194012759693,7
0.2,6113,94,487801,79.78426561988879,7
0.2,6114,22,487823,79.77481602616517,10
0.2,6115,91,487914,79.7766514061478,11
0.2,6116,94,488008,79.77897662252738,7
0.2,6117,94,488102,79.78130107878391,8
0.2,6118,96,488198,79.7839516260827,6
0.2,6119,94,488292,79.78627450980392,7
0.2,6120,96,488388,79.78892337853291,6
0.2,6121,93,488481,79.79108134596537,8
0.2,6122,94,488575,79.79340192715989,7
0.2,6123,94,488669,79.79572175048988,7
0.2,6124,95,488764,79.79820408163265,6
0.2,6125,94,488858,79.80052236369572,7
0.2,6126,95,488953,79.80300310102824,7
0.2,6127,23,488976,79.79373368146214,9
0.2,6128,92,489068,79.79572524065917,9
0.2,6129,94,489162,79.79804241435563,7
0.2,6130,94,489256,79.8003588321644,7
0.2,6131,90,489346,79.8020221787345,11
0.2,6132,94,489440,79.8043371922387,7
0.2,6133,91,489531,79.80616237365504,10
0.2,6134,94,489625,79.80847595762022,7
0.2,6135,94,489719,79.8107887874837,7
0.2,6136,89,489808,79.81228613328989,12
0.2,6137,93,489901,79.81443466927338,9
0.2,6138,96,489997,79.81707118423196,6
0.2,6139,92,490089,79.81905537459284,10
0.2,6140,88,490177,79.82038755902947,13
0.2,6141,94,490271,79.82269619016607,7
0.2,6142,93,490364,79.82484128276087,9
0.2,6143,81,490445,79.82503255208333,20
0.2,6144,94,490539,79.8273393002441,8
0.2,6145,92,490631,79.82931988285064,9
0.2,6146,94,490725,79.8316251830161,8
0.2,6147,92,490817,79.83360442420299,9
0.2,6148,90,490907,79.83525776549033,12
0.2,6149,96,491003,79.8378861788618,6
0.2,6150,96,491099,79.84051373760364,6
0.2,6151,95,491194,79.84297789336802,6
0.2,6152,96,491290,79.84560377051845,6
0.2,6153,92,491382,79.84757881052974,9
0.2,6154,94,491476,79.84987814784728,7
0.2,6155,86,491562,79.85087719298245,15
0.2,6156,95,491657,79.85333766444697,6
0.2,6157,94,491751,79.85563494641117,8
0.2,6158,-50,491701,79.83455106348433,13
0.2,6159,93,491794,79.8366883116883,8
0.2,6160,15,491809,79.82616458367148,17
0.2,6161,93,491902,79.82830249918858,8
0.2,6162,94,491996,79.83060197955541,8
0.2,6163,82,492078,79.83095392602206,19
0.2,6164,95,492173,79.83341443633414,6
0.2,6165,96,492269,79.83603632825171,6
0.2,6166,94,492363,79.83833306307767,8
0.2,6167,90,492453,79.83998054474708,11
0.2,6168,25,492478,79.83109093856379,8
0.2,6169,93,492571,79.83322528363047,8
0.2,6170,95,492666,79.835683033544,6
0.2,6171,15,492681,79.8251782242385,18
0.2,6172,95,492776,79.82763648145148,6
0.2,6173,91,492867,79.82944606413994,12
0.2,6174,94,492961,79.83174089068827,7
0.2,6175,94,493055,79.83403497409327,8
0.2,6176,25,493080,79.82515784361341,8
0.2,6177,93,493173,79.82729038523794,9
0.2,6178,94,493267,79.82958407509305,7
0.2,6179,91,493358,79.83139158576051,10
0.2,6180,94,493452,79.83368386992396,7
0.2,6181,94,493546,79.83597541248787,9
0.2,6182,95,493641,79.83842794759825,6
0.2,6183,90,493731,79.84007115135834,11
0.2,6184,92,493823,79.84203718674212,9
0.2,6185,92,493915,79.84400258648562,9
0.2,6186,91,494006,79.84580572167448,10
0.2,6187,94,494100,79.8480930833872,7
0.2,6188,19,494119,79.83826143157215,13
0.2,6189,96,494215,79.84087237479807,6
0.2,6190,93,494308,79.84299790017768,9
0.2,6191,96,494404,79.84560723514213,6
0.2,6192,93,494497,79.84773130954304,8
0.2,6193,92,494589,79.84969325153374,11
0.2,6194,25,494614,79.8408393866021,9
0.2,6195,95,494709,79.84328599096192,6
0.2,6196,95,494804,79.84573180571245,6
0.2,6197,87,494891,79.84688609228783,14
0.2,6198,88,494979,79.848201322794,13
0.2,6199,95,495074,79.85064516129032,6
0.2,6200,77,495151,79.85018545395904,25
0.2,6201,23,495174,79.8410190261206,10
0.2,6202,88,495262,79.84233435434467,13
0.2,6203,96,495358,79.84493874919407,6
0.2,6204,96,495454,79.84754230459308,6
0.2,6205,92,495546,79.84950048340316,10
0.2,6206,94,495640,79.85178024810698,7
0.2,6207,88,495728,79.85309278350516,13
0.2,6208,95,495823,79.85553229183444,6
0.2,6209,92,495915,79.85748792270532,9
0.2,6210,94,496009,79.85976493318306,7
0.2,6211,94,496103,79.8620412105602,7
0.2,6212,94,496197,79.86431675519073,7
0.2,6213,96,496293,79.86691342130673,6
0.2,6214,92,496385,79.8688656476267,9
0.2,6215,93,496478,79.87097812097812,8
0.2,6216,94,496572,79.8732507640341,7
0.2,6217,91,496663,79.87504020585398,11
0.2,6218,92,496755,79.87698986975398,11
0.2,6219,93,496848,79.8790996784566,9
0.2,6220,95,496943,79.88153030059476,7
0.2,6221,94,497037,79.8837994214079,7
0.2,6222,90,497127,79.88542503615619,13
0.2,6223,94,497221,79.88769280205655,8
0.2,6224,92,497313,79.88963855421687,9
0.2,6225,94,497407,79.89190491487311,9
0.2,6226,94,497501,79.89417054761522,8
0.2,6227,94,497595,79.89643545279384,7
0.2,6228,89,497684,79.89789693369723,13
0.2,6229,95,497779,79.90032102728732,7
0.2,6230,21,497800,79.89086823944793,11
0.2,6231,86,497886,79.8918485237484,16
0.2,6232,-51,497835,79.87084870848709,15
0.2,6233,25,497860,79.86204683991016,7
0.2,6234,94,497954,79.86431435445068,7
0.2,6235,94,498048,79.86658114175754,8
0.2,6236,95,498143,79.8690075356742,6
0.2,6237,96,498239,79.87159345944212,6
0.2,6238,89,498328,79.87305657958007,12
0.2,6239,92,498420,79.875,11
0.2,6240,96,498516,79.87758372055761,6
0.2,6241,92,498608,79.87952579301506,9
0.2,6242,96,498704,79.88210796091623,6
0.2,6243,94,498798,79.88436899423446,7
0.2,6244,90,498888,79.88598879103283,11
0.2,6245,89,498977,79.88744796669869,12
0.2,6246,93,499070,79.88954698255162,8
0.2,6247,88,499158,79.89084507042253,13
0.2,6248,90,499248,79.89246279404705,11
0.2,6249,90,499338,79.89408,12
0.2,6250,91,499429,79.89585666293394,11
0.2,6251,92,499521,79.89779270633397,10
0.2,6252,89,499610,79.89924836078683,12
0.2,6253,94,499704,79.90150303805565,8
0.2,6254,93,499797,79.90359712230216,8
0.2,6255,94,499891,79.90585038363172,7
0.2,6256,90,499981,79.9074636407224,12
0.2,6257,95,500076,79.90987535953978,7
0.2,6258,95,500171,79.91228630771688,6
0.2,6259,94,500265,79.91453674121406,7
0.2,6260,90,500355,79.91614758025874,11
0.2,6261,24,500379,79.90721814116895,9
0.2,6262,93,500472,79.9093086380329,9
0.2,6263,95,500567,79.91171775223499,6
0.2,6264,87,500654,79.91284916201117,14
0.2,6265,95,500749,79.9152569422279,6
0.2,6266,91,500840,79.91702569012287,10
0.2,6267,93,500933,79.91911295469049,8
0.2,6268,82,501015,79.91944488754187,19
0.2,6269,91,501106,79.92121212121212,11
0.2,6270,94,501200,79.92345718386223,7
0.2,6271,96,501296,79.92602040816327,6
0.2,6272,93,501389,79.9281045751634,8
0.2,6273,89,501478,79.92955052598023,12
0.2,6274,95,501573,79.93195219123506,7
0.2,6275,94,501667,79.93419375398342,8
0.2,6276,22,501689,79.92496415485104,10
0.2,6277,27,501716,79.91653392800255,6
0.2,6278,93,501809,79.91861761426979,10
0.2,6279,86,501895,79.91958598726114,15
0.2,6280,94,501989,79.92182773443719,7
0.2,6281,96,502085,79.92438713785418,6
0.2,6282,93,502178,79.9264682476524,8
0.2,6283,94,502272,79.92870782940803,7
0.2,6284,94,502366,79.93094669848847,7
0.2,6285,94,502460,79.93318485523385,7
0.2,6286,94,502554,79.9354222999841,7
0.2,6287,89,502643,79.93686386768448,12
0.2,6288,91,502734,79.93862299252663,11
0.2,6289,94,502828,79.94085850556439,7
0.2,6290,89,502917,79.94229852169767,12
0.2,6291,85,503002,79.94310235219326,16
0.2,6292,92,503094,79.945018274273,9
0.2,6293,93,503187,79.94709246901812,8
0.2,6294,90,503277,79.94868943606036,11
0.2,6295,22,503299,79.93948538754765,11
0.2,6296,90,503389,79.94108305542322,11
0.2,6297,87,503476,79.94220387424579,14
0.2,6298,91,503567,79.94395935862835,10
0.2,6299,91,503658,79.94571428571429,10
0.2,6300,96,503754,79.94826218060625,6
0.2,6301,96,503850,79.9508092668994,6
0.2,6302,20,503870,79.94129779470093,12
0.2,6303,93,503963,79.9433692893401,8
0.2,6304,91,504054,79.94512291831879,11
0.2,6305,89,504143,79.94655883285759,12
0.2,6306,94,504237,79.94878706199461,8
0.2,6307,85,504322,79.94958782498415,17
0.2,6308,91,504413,79.95133935647488,10
0.2,6309,94,504507,79.95356576862123,7
0.2,6310,91,504598,79.95531611472033,10
0.2,6311,92,504690,79.95722433460077,9
0.2,6312,95,504785,79.95960715982892,6
0.2,6313,91,504876,79.96135571745327,10
0.2,6314,92,504968,79.96326207442597,9
0.2,6315,26,504994,79.9547181760608,7
0.2,6316,-50,504944,79.93414595535856,13
0.2,6317,89,505033,79.93558088002533,12
0.2,6318,94,505127,79.93780661497073,7
0.2,6319,90,505217,79.93939873417722,11
0.2,6320,20,505237,79.92991615250752,14
0.2,6321,26,505263,79.9213856374565,6
0.2,6322,93,505356,79.9234540566187,8
0.2,6323,94,505450,79.92567994939911,7
0.2,6324,95,505545,79.92806324110671,6
0.2,6325,91,505636,79.92981346822637,10
0.2,6326,91,505727,79.93156314208946,10
0.2,6327,96,505823,79.93410240202276,6
0.2,6328,20,505843,79.92463264338758,14
0.2,6329,90,505933,79.926224328594,11
0.2,6330,93,506026,79.92828936976781,8
0.2,6331,94,506120,79.93051168667088,7
0.2,6332,94,506214,79.93273330175272,8
0.2,6333,93,506307,79.93479633722767,8
0.2,6334,93,506400,79.93685872138911,8
0.2,6335,94,506494,79.93907828282828,7
0.2,6336,95,506589,79.94145494713587,6
0.2,6337,87,506676,79.94256863363837,14
0.2,6338,84,506760,79.94320870799811,17
0.2,6339,92,506852,79.94511041009464,9
0.2,6340,92,506944,79.94701151237975,9
0.2,6341,93,507037,79.9490696941028,8
0.2,6342,90,507127,79.95065426454359,12
0.2,6343,25,507152,79.94199243379572,8
0.2,6344,90,507242,79.94357762017337,11
0.2,6345,86,507328,79.94453198865428,16
0.2,6346,92,507420,79.94643138490626,9
0.2,6347,92,507512,79.94833018273472,10
0.2,6348,-50,507462,79.9278626555363,14
0.2,6349,94,507556,79.93007874015748,8
0.2,6350,94,507650,79.93229412690914,7
0.2,6351,93,507743,79.93435138539043,8
0.2,6352,93,507836,79.93640799622226,8
0.2,6353,90,507926,79.93799181617878,11
0.2,6354,93,508019,79.94004720692368,8
0.2,6355,92,508111,79.9419446192574,10
0.2,6356,91,508202,79.9436841277332,11
0.2,6357,93,508295,79.94573765335011,8
0.2,6358,92,508387,79.94763327567227,10
0.2,6359,93,508480,79.9496855345912,8
0.2,6360,90,508570,79.95126552428863,11
0.2,6361,90,508660,79.95284501729016,11
0.2,6362,93,508753,79.95489548954896,8
0.2,6363,93,508846,79.95694531741043,9
0.2,6364,92,508938,79.95883739198743,10
0.2,6365,93,509031,79.96088595664467,8
0.2,6366,19,509050,79.95131144966233,13
0.2,6367,93,509143,79.95336055276383,8
0.2,6368,92,509235,79.95525200188412,10
0.2,6369,93,509328,79.95729984301413,9
0.2,6370,94,509422,79.95950400251138,8
0.2,6371,91,509513,79.9612366603892,10
0.2,6372,92,509605,79.96312568648987,9
0.2,6373,89,509694,79.9645434577973,14
0.2,6374,92,509786,79.96643137254902,9
0.2,6375,-52,509734,79.94573400250941,15
0.2,6376,88,509822,79.94699702054257,13
0.2,6377,93,509915,79.94904358733145,8
0.2,6378,22,509937,79.93995924126038,11
0.2,6379,88,510025,79.94122257053291,13
0.2,6380,94,510119,79.94342579532989,7
0.2,6381,92,510211,79.94531494829207,10
0.2,6382,90,510301,79.94689017703274,11
0.2,6383,86,510387,79.94783834586467,15
0.2,6384,93,510480,79.94988253719656,8
0.2,6385,96,510576,79.95239586595677,6
0.2,6386,94,510670,79.95459527164553,7
0.2,6387,96,510766,79.95710707576707,6
0.2,6388,88,510854,79.95836594146189,13
0.2,6389,94,510948,79.96056338028168,7
0.2,6390,92,511040,79.96244719136286,9
0.2,6391,95,511135,79.9647997496871,7
0.2,6392,94,511229,79.96699515094635,7
0.2,6393,-50,511179,79.94666875195496,14
0.2,6394,89,511268,79.94808444096951,12
0.2,6395,94,511362,79.95028142589118,8
0.2,6396,93,511455,79.95232140065656,9
0.2,6397,92,511547,79.95420443888715,10
0.2,6398,94,511641,79.9563994374121,8
0.2,6399,23,511664,79.9475,9
0.2,6400,94,511758,79.94969536009998,7
0.2,6401,90,511848,79.95126522961574,11
0.2,6402,84,511932,79.95189754802436,17
0.2,6403,95,512027,79.95424734540912,7
0.2,6404,91,512118,79.9559718969555,10
0.2,6405,90,512208,79.95753980643147,11
0.2,6406,96,512304,79.96004370220072,6
0.2,6407,94,512398,79.96223470661673,7
0.2,6408,90,512488,79.96380090497738,11
0.2,6409,95,512583,79.96614664586583,6
0.2,6410,92,512675,79.96802370924972,10
0.2,6411,94,512769,79.97021210230817,8
0.2,6412,95,512864,79.97255574614066,7
0.2,6413,90,512954,79.97411911443717,11
0.2,6414,95,513049,79.97646141855027,6
0.2,6415,91,513140,79.9781795511222,10
0.2,6416,91,513231,79.9798971482001,10
0.2,6417,94,513325,79.98208164537239,7
0.2,6418,95,513420,79.9844212494158,7
0.2,6419,92,513512,79.98629283489096,9
0.2,6420,93,513605,79.98831957638997,8
0.2,6421,-54,513551,79.96745562130178,17
0.2,6422,93,513644,79.969484664487,8
0.2,6423,92,513736,79.97135740971358,9
0.2,6424,92,513828,79.97322957198443,9
0.2,6425,95,513923,79.97556800497976,6
0.2,6426,93,514016,79.97759452310565,9
0.2,6427,94,514110,79.97977598008711,7
0.2,6428,91,514201,79.9814901228807,10
0.2,6429,94,514295,79.98367029548989,7
0.2,6430,92,514387,79.98553879645468,11
0.2,6431,93,514480,79.98756218905473,8
0.2,6432,95,514575,79.98989584952588,6
0.2,6433,94,514669,79.99207336027355,7
0.2,6434,92,514761,79.9939393939394,10
0.2,6435,95,514856,79.99627097576135,7
0.2,6436,87,514943,79.99735901817617,14
0.2,6437,94,515037,79.9995340167754,7
0.2,6438,96,515133,80.00201894704146,6
0.2,6439,90,515223,80.00357142857143,11
0.2,6440,96,515319,80.00605496040987,6
0.2,6441,95,515414,80.00838248990996,7
0.2,6442,86,515500,80.00931243209685,15
0.2,6443,93,515593,80.01132836747362,8
0.2,6444,94,515687,80.01349883630722,7
0.2,6445,95,515782,80.015823766677,7
0.2,6446,93,515875,80.0178377539941,8
0.2,6447,94,515969,80.02000620347394,7
0.2,6448,94,516063,80.02217398046209,7
0.2,6449,19,516082,80.01271317829458,13
0.2,6450,90,516172,80.0142613548287,11
0.2,6451,85,516257,80.01503409795413,17
0.2,6452,96,516353,80.01751123508446,6
0.2,6453,95,516448,80.01983266191509,8
0.2,6454,94,516542,80.02199845081333,7
0.2,6455,90,516632,80.02354399008674,11
0.2,6456,91,516723,80.0252439213257,10
0.2,6457,92,516815,80.02709817280892,9
0.2,6458,94,516909,80.02926149558755,7
0.2,6459,95,517004,80.03157894736842,7
0.2,6460,88,517092,80.03281225816437,13
0.2,6461,88,517180,80.03404518724852,13
0.2,6462,94,517274,80.03620609624014,8
0.2,6463,94,517368,80.03836633663366,7
0.2,6464,85,517453,80.03913379737045,16
0.2,6465,90,517543,80.04067429631921,13
0.2,6466,95,517638,80.04298747487243,6
0.2,6467,96,517734,80.04545454545455,6
0.2,6468,-48,517686,80.02566084402535,12
0.2,6469,89,517775,80.02704791344668,12
0.2,6470,95,517870,80.0293617678875,7
0.2,6471,94,517964,80.03152039555006,7
0.2,6472,92,518056,80.03336938050363,9
0.2,6473,89,518145,80.03475440222428,12
0.2,6474,92,518237,80.03660231660231,9
0.2,6475,21,518258,80.02748610253242,12
0.2,6476,95,518353,80.02979774587,7
0.2,6477,95,518448,80.03210867551714,6
0.2,6478,21,518469,80.02299737613829,13
0.2,6479,89,518558,80.02438271604939,12
0.2,6480,95,518653,80.02669341151056,6
0.2,6481,93,518746,80.02869484726936,8
0.2,6482,90,518836,80.03023291685948,12
0.2,6483,90,518926,80.03177051202961,11
0.2,6484,95,519021,80.03407864302235,7
0.2,6485,87,519108,80.03515263644773,15
0.2,6486,95,519203,80.03745953445352,6
0.2,6487,93,519296,80.03945745992601,8
0.2,6488,93,519389,80.04145476961011,9
0.2,6489,91,519480,80.04314329738058,10
0.2,6490,23,519503,80.0343552611308,10
0.2,6491,93,519596,80.03635243376463,8
0.2,6492,92,519688,80.03819497920838,9
0.2,6493,96,519784,80.04065291037881,6
0.2,6494,94,519878,80.04280215550423,7
0.2,6495,90,519968,80.04433497536945,11
0.2,6496,94,520062,80.04648299215022,7
0.2,6497,91,520153,80.04816866728224,10
0.2,6498,96,520249,80.05062317279581,7
0.2,6499,94,520343,80.05276923076923,7
0.2,6500,94,520437,80.05491462851869,7
0.2,6501,93,520530,80.05690556751769,8
0.2,6502,95,520625,80.05920344456405,6
0.2,6503,27,520652,80.05104551045511,6
0.2,6504,86,520738,80.05196003074558,15
0.2,6505,92,520830,80.05379649554257,9
0.2,6506,95,520925,80.05609343783618,6
0.2,6507,19,520944,80.04671173939767,13
0.2,6508,93,521037,80.04870179751114,8
0.2,6509,88,521125,80.04992319508449,14
0.2,6510,94,521219,80.05206573491016,7
0.2,6511,90,521309,80.05359336609337,11
0.2,6512,91,521400,80.05527406725011,10
0.2,6513,96,521496,80.05772182990482,6
0.2,6514,94,521590,80.0598618572525,8
0.2,6515,90,521680,80.06138735420504,11
0.2,6516,90,521770,80.0629123829983,12
0.2,6517,22,521792,80.05400429579626,10
0.2,6518,95,521887,80.05629697806413,6
0.2,6519,91,521978,80.0579754601227,12
0.2,6520,96,522074,80.06042018095384,6
0.2,6521,96,522170,80.06286415210059,7
0.2,6522,89,522259,80.06423424804538,12
0.2,6523,85,522344,80.06499080318822,16
0.2,6524,93,522437,80.06697318007663,9
0.2,6525,92,522529,80.06880171621208,9
0.2,6526,93,522622,80.07078290179255,8
0.2,6527,96,522718,80.07322303921569,6
0.2,6528,96,522814,80.0756624291622,6
0.2,6529,90,522904,80.07718223583461,11
0.2,6530,93,522997,80.07916092482009,10
0.2,6531,93,523090,80.08113900796081,8
0.2,6532,94,523184,80.08326955456911,7
0.2,6533,94,523278,80.08539944903582,7
0.2,6534,96,523374,80.08783473603673,6
0.2,6535,92,523466,80.08965728274174,9
0.2,6536,22,523488,80.08077099586967,10
0.2,6537,93,523581,80.08274701743653,8
0.2,6538,-122,523459,80.05184278941734,18
0.2,6539,94,523553,80.05397553516819,7
0.2,6540,96,523649,80.05641339244764,6
0.2,6541,93,523742,80.05839192907368,8
0.2,6542,92,523834,80.06021702582913,9
0.2,6543,94,523928,80.06234718826406,7
0.2,6544,94,524022,80.06447669977082,8
0.2,6545,95,524117,80.06675832569508,6
0.2,6546,91,524208,80.06842828776539,10
0.2,6547,93,524301,80.07040317654246,9
0.2,6548,94,524395,80.07253015727592,7
0.2,6549,93,524488,80.0745038167939,8
0.2,6550,93,524581,80.07647687375973,8
0.2,6551,90,524671,80.07799145299145,11
0.2,6552,93,524764,80.07996337555318,8
0.2,6553,95,524859,80.08223985352457,7
0.2,6554,91,524950,80.08390541571319,11
0.2,6555,92,525042,80.08572300183039,9
0.2,6556,90,525132,80.08723501601342,12
0.2,6557,23,525155,80.07853003964624,9
0.2,6558,93,525248,80.08050007623113,8
0.2,6559,86,525334,80.08140243902439,15
0.2,6560,93,525427,80.0833714372809,8
0.2,6561,94,525521,80.08549222797927,8
0.2,6562,27,525548,80.07740362639036,7
0.2,6563,88,525636,80.07861060329067,14
0.2,6564,84,525720,80.07920792079207,17
0.2,6565,94,525814,80.0813280536095,7
0.2,6566,85,525899,80.0820770519263,17
0.2,6567,94,525993,80.08419610231425,7
0.2,6568,22,526015,80.07535393514995,12
0.2,6569,93,526108,80.07732115677321,8
0.2,6570,86,526194,80.07822249277127,15
0.2,6571,92,526286,80.0800365185636,9
0.2,6572,94,526380,80.08215426745778,7
0.2,6573,91,526471,80.08381502890174,10
0.2,6574,91,526562,80.0854752851711,10
0.2,6575,92,526654,80.08728710462287,9
0.2,6576,-54,526600,80.0668998023415,17
0.2,6577,-122,526478,80.03618121009426,17
0.2,6578,95,526573,80.03845569235446,6
0.2,6579,94,526667,80.04057750759878,7
0.2,6580,89,526756,80.0419389150585,12
0.2,6581,93,526849,80.04390762686114,8
0.2,6582,86,526935,80.04481239556434,15
0.2,6583,93,527028,80.04678007290401,8
0.2,6584,92,527120,80.04859529233106,9
0.2,6585,89,527209,80.04995444883086,14
0.2,6586,92,527301,80.05176863519053,9
0.2,6587,94,527395,80.05388585306618,7
0.2,6588,-47,527348,80.03460312642282,10
0.2,6589,94,527442,80.03672230652504,7
0.2,6590,94,527536,80.03884084357458,7
0.2,6591,95,527631,80.0411104368932,6
0.2,6592,92,527723,80.042924313666,10
0.2,6593,91,527814,80.04458598726114,10
0.2,6594,94,527908,80.04670204700531,7
0.2,6595,92,528000,80.04851425106125,9
0.2,6596,93,528093,80.05047748976807,8
0.2,6597,95,528188,80.05274325553198,7
0.2,6598,94,528282,80.05485679648432,7
0.2,6599,92,528374,80.05666666666667,9
0.2,6600,95,528469,80.05893046508105,7
0.2,6601,23,528492,80.05028779157831,9
0.2,6602,92,528584,80.0520975314251,9
0.2,6603,91,528675,80.05375529981829,10
0.2,6604,93,528768,80.0557153671461,8
0.2,6605,88,528856,80.05691795337572,13
0.2,6606,93,528949,80.05887694869078,9
0.2,6607,96,529045,80.06128934624698,6
0.2,6608,90,529135,80.06279316084128,12
0.2,6609,96,529231,80.06520423600605,6
0.2,6610,94,529325,80.0673120556648,7
0.2,6611,25,529350,80.0589836660617,8
0.2,6612,92,529442,80.06078935430213,9
0.2,6613,94,529536,80.06289688539462,8
0.2,6614,89,529625,80.06424792139077,12
0.2,6615,11,529636,80.05380894800484,21
0.2,6616,92,529728,80.05561432673417,9
0.2,6617,95,529823,80.05787246902388,7
0.2,6618,88,529911,80.0590723674271,13
0.2,6619,93,530004,80.06102719033233,8
0.2,6620,23,530027,80.05240900166137,9
0.2,6621,92,530119,80.05421322863184,9
0.2,6622,94,530213,80.05631888872112,8
0.2,6623,84,530297,80.05691425120773,17
0.2,6624,95,530392,80.05916981132076,6
0.2,6625,89,530481,80.0605191669182,12
0.2,6626,94,530575,80.06262260449675,8
0.2,6627,94,530669,80.0647254073627,7
0.2,6628,91,530760,80.06637501885653,10
0.2,6629,94,530854,80.0684766214178,7
0.2,6630,95,530949,80.07072839692354,6
0.2,6631,93,531042,80.0726779252111,8
0.2,6632,90,531132,80.07417458163727,11
0.2,6633,83,531215,80.07461561652096,18
0.2,6634,93,531308,80.07656367746797,8
0.2,6635,95,531403,80.0788125376733,6
0.2,6636,93,531496,80.0807593792376,9
0.2,6637,93,531589,80.08270563422718,8
0.2,6638,89,531678,80.0840488025305,12
0.2,6639,87,531765,80.08509036144578,14
0.2,6640,95,531860,80.08733624454149,6
0.2,6641,92,531952,80.0891297801867,9
0.2,6642,92,532044,80.09092277585428,9
0.2,6643,21,532065,80.08202889825407,11
0.2,6644,90,532155,80.08352144469526,11
0.2,6645,93,532248,80.08546494131808,8
0.2,6646,90,532338,80.08695652173913,11
0.2,6647,96,532434,80.08935018050542,6
0.2,6648,95,532529,80.09159272070988,6
0.2,6649,94,532623,80.09368421052632,8
0.2,6650,96,532719,80.09607577807849,6
0.2,6651,88,532807,80.09726398075766,13
0.2,6652,92,532899,80.09905305877048,9
0.2,6653,89,532988,80.10039074241058,12
0.2,6654,92,533080,80.10217881292262,9
0.2,6655,92,533172,80.10396634615384,10
0.2,6656,94,533266,80.10605377797806,8
0.2,6657,93,533359,80.10799038750376,8
0.2,6658,92,533451,80.10977624267908,9
0.2,6659,91,533542,80.11141141141141,10
0.2,6660,23,533565,80.10283741180002,12
0.2,6661,95,533660,80.10507355148604,6
0.2,6662,95,533755,80.10730901996098,6
0.2,6663,94,533849,80.109393757503,7
0.2,6664,-50,533799,80.08987246811702,14
0.2,6665,87,533886,80.0909090909091,14
0.2,6666,93,533979,80.09284535773212,8
0.2,6667,93,534072,80.09478104379124,8
0.2,6668,-49,534023,80.07542360173939,13
0.2,6669,93,534116,80.07736131934033,8
0.2,6670,88,534204,80.07854894318693,13
0.2,6671,93,534297,80.0804856115108,8
0.2,6672,95,534392,80.08272141465608,6
0.2,6673,91,534483,80.08435720707222,10
0.2,6674,23,534506,80.0758052434457,11
0.2,6675,92,534598,80.07759137207908,9
0.2,6676,27,534625,80.06964205481503,6
0.2,6677,91,534716,80.0712788259958,10
0.2,6678,93,534809,80.07321455307681,8
0.2,6679,94,534903,80.07529940119761,8
0.2,6680,27,534930,80.06735518634935,6
0.2,6681,88,535018,80.06854235258905,13
0.2,6682,96,535114,80.0709262307347,6
0.2,6683,90,535204,80.07241172950329,11
0.2,6684,90,535294,80.07389678384443,11
0.2,6685,87,535381,80.07493269518396,14
0.2,6686,20,535401,80.06594885598923,12
0.2,6687,92,535493,80.06773325358851,9
0.2,6688,93,535586,80.0696666168336,8
0.2,6689,95,535681,80.07189835575485,6
0.2,6690,90,535771,80.07338215513376,11
0.2,6691,95,535866,80.07561267184698,6
0.2,6692,95,535961,80.07784252203795,6
0.2,6693,90,536051,80.07932476844935,11
0.2,6694,89,536140,80.0806572068708,12
0.2,6695,94,536234,80.08273596176822,7
0.2,6696,92,536326,80.0845154546812,9
0.2,6697,88,536414,80.08569722305165,13
0.2,6698,92,536506,80.08747574264815,9
0.2,6699,96,536602,80.08985074626865,6
0.2,6700,95,536697,80.09207580958066,6
0.2,6701,24,536721,80.08370635631155,9
0.2,6702,92,536813,80.08548411159182,9
0.2,6703,95,536908,80.08770883054892,6
0.2,6704,87,536995,80.08873974645786,14
0.2,6705,91,537086,80.09036683566956,10
0.2,6706,90,537176,80.09184434173252,11
0.2,6707,95,537271,80.09406678592725,6
0.2,6708,91,537362,80.09569235355492,10
0.2,6709,91,537453,80.0973174366617,10
0.2,6710,94,537547,80.09938906273283,7
0.2,6711,91,537638,80.10101311084624,11
0.2,6712,94,537732,80.1030835691941,8
0.2,6713,90,537822,80.10455764075067,11
0.2,6714,91,537913,80.10618019359643,10
0.2,6715,95,538008,80.10839785586658,6
0.2,6716,91,538099,80.11001935387822,11
0.2,6717,92,538191,80.11178922298303,9
0.2,6718,23,538214,80.10328917993749,10
0.2,6719,90,538304,80.1047619047619,12
0.2,6720,93,538397,80.10668055348907,8
0.2,6721,94,538491,80.10874739660815,7
0.2,6722,90,538581,80.11021865238733,12
0.2,6723,92,538673,80.11198691255206,9
0.2,6724,93,538766,80.1139033457249,8
0.2,6725,94,538860,80.11596788581623,7
0.2,6726,93,538953,80.1178831574253,8
0.2,6727,23,538976,80.10939357907253,10
0.2,6728,90,539066,80.11086342695795,11
0.2,6729,95,539161,80.11307578008915,6
0.2,6730,95,539256,80.11528747585797,10
0.2,6731,95,539351,80.11749851455734,6
0.2,6732,92,539443,80.11926332986782,11
0.2,6733,92,539535,80.12102762102762,9
0.2,6734,94,539629,80.1230883444692,7
0.2,6735,95,539724,80.12529691211401,6
0.2,6736,88,539812,80.12646578595815,14
0.2,6737,95,539907,80.1286731967943,6
0.2,6738,94,540001,80.13073156254637,7
0.2,6739,93,540094,80.1326409495549,9
0.2,6740,93,540187,80.13454977006378,8
0.2,6741,94,540281,80.1366063482646,8
0.2,6742,93,540374,80.13851401453358,8
0.2,6743,89,540463,80.13982799525505,13
0.2,6744,90,540553,80.14128984432914,11
0.2,6745,94,540647,80.14334420397273,7
0.2,6746,91,540738,80.14495331258337,11
0.2,6747,95,540833,80.14715471250742,6
0.2,6748,96,540929,80.14950363016743,6
0.2,6749,90,541019,80.15096296296296,11
0.2,6750,94,541113,80.15301436824174,7
0.2,6751,92,541205,80.15476895734596,9
0.2,6752,94,541299,80.15681919147046,7
0.2,6753,78,541377,80.15649985193959,25
0.2,6754,94,541471,80.15854922279793,10
0.2,6755,92,541563,80.16030195381883,9
0.2,6756,20,541583,80.15139854965221,15
0.2,6757,90,541673,80.15285587451909,12
0.2,6758,88,541761,80.15401686640035,13
0.2,6759,95,541856,80.15621301775148,6
0.2,6760,93,541949,80.15811270522111,8
0.2,6761,90,542039,80.15956817509613,11
0.2,6762,93,542132,80.16146680467249,8
0.2,6763,96,542228,80.16380839739799,6
0.2,6764,91,542319,80.16541019955655,10
0.2,6765,93,542412,80.16730712385457,10
0.2,6766,94,542506,80.16935126348456,7
0.2,6767,92,542598,80.17109929078015,9
0.2,6768,87,542685,80.17210814005023,14
0.2,6769,91,542776,80.17370753323486,10
0.2,6770,91,542867,80.17530645399498,12
0.2,6771,88,542955,80.1764619019492,13
0.2,6772,94,543049,80.17850287907869,8
0.2,6773,94,543143,80.18054325361678,8
0.2,6774,95,543238,80.18273062730627,7
0.2,6775,94,543332,80.18476977567887,7
0.2,6776,95,543427,80.18695588018298,6
0.2,6777,87,543514,80.18796105045736,14
0.2,6778,92,543606,80.18970349609087,9
0.2,6779,94,543700,80.19174041297936,8
0.2,6780,92,543792,80.193481787347,9
0.2,6781,96,543888,80.19581244470658,6
0.2,6782,89,543977,80.19711042311661,12
0.2,6783,80,544057,80.19708136792453,21
0.2,6784,92,544149,80.19882092851878,9
0.2,6785,88,544237,80.19997052755673,15
0.2,6786,92,544329,80.20170914984529,10
0.2,6787,86,544415,80.20256334708309,17
0.2,6788,94,544509,80.2045956694653,8
0.2,6789,96,544605,80.20692194403534,7
0.2,6790,90,544695,80.20836401119128,12
0.2,6791,89,544784,80.20965842167256,12
0.2,6792,93,544877,80.211541292507,8
0.2,6793,88,544965,80.21268766558728,13
0.2,6794,96,545061,80.21501103752759,6
0.2,6795,94,545155,80.21703943496175,7
0.2,6796,93,545248,80.21892011181403,9
0.2,6797,91,545339,80.22050603118565,10
0.2,6798,95,545434,80.2226798058538,7
0.2,6799,-50,545384,80.2035294117647,14
0.2,6800,96,545480,80.20585208057639,6
0.2,6801,92,545572,80.20758600411644,9
0.2,6802,94,545666,80.20961340585036,8
0.2,6803,95,545761,80.21178718400941,7
0.2,6804,95,545856,80.2139603232917,7
0.2,6805,94,545950,80.2159858947987,7
0.2,6806,93,546043,80.21786396356691,8
0.2,6807,94,546137,80.2198883666275,8
0.2,6808,92,546229,80.22161844617418,9
0.2,6809,84,546313,80.22217327459619,17
0.2,6810,94,546407,80.22419615328145,7
0.2,6811,14,546421,80.21447445684088,18
0.2,6812,94,546515,80.21649787171583,7
0.2,6813,95,546610,80.21866744936895,7
0.2,6814,91,546701,80.2202494497432,10
0.2,6815,21,546722,80.21156103286386,11
0.2,6816,90,546812,80.21299691946604,11
0.2,6817,88,546900,80.21413904370783,13
0.2,6818,20,546920,80.20530869628978,12
0.2,6819,89,547009,80.2065982404692,16
0.2,6820,93,547102,80.2084738308166,8
0.2,6821,94,547196,80.21049545587805,8
0.2,6822,93,547289,80.21236992525282,8
0.2,6823,92,547381,80.21409730363423,9
0.2,6824,92,547473,80.21582417582418,9
0.2,6825,94,547567,80.21784353940815,7
0.2,6826,92,547659,80.219569356965,10
0.2,6827,96,547755,80.22188049209139,6
0.2,6828,83,547838,80.22228730414409,18
0.2,6829,96,547934,80.22459736456808,6
0.2,6830,89,548023,80.2258820084907,12
0.2,6831,23,548046,80.21750585480093,9
0.2,6832,96,548142,80.21981560076101,6
0.2,6833,93,548235,80.22168568920105,9
0.2,6834,86,548321,80.22253108997805,15
0.2,6835,92,548413,80.22425394967817,10
0.2,6836,94,548507,80.22626883135878,8
0.2,6837,91,548598,80.22784439894706,10
0.2,6838,92,548690,80.22956572598333,9
0.2,6839,93,548783,80.23143274853801,8
0.2,6840,93,548876,80.23329922525946,8
0.2,6841,94,548970,80.23531131248173,7
0.2,6842,92,549062,80.23703054215987,9
0.2,6843,96,549158,80.23933372296902,6
0.2,6844,95,549253,80.24149013878744,6
0.2,6845,94,549347,80.24349985392931,7
0.2,6846,-47,549300,80.2249160216153,10
0.2,6847,91,549391,80.2264894859813,10
0.2,6848,94,549485,80.22850051102351,7
0.2,6849,89,549574,80.22978102189781,12
0.2,6850,94,549668,80.23179097941906,7
0.2,6851,94,549762,80.2338003502627,9
0.2,6852,94,549856,80.23580913468554,7
0.2,6853,90,549946,80.23723373212722,11
0.2,6854,91,550037,80.23880379285194,10
0.2,6855,94,550131,80.24081096849476,7
0.2,6856,94,550225,80.24281755869914,7
0.2,6857,88,550313,80.24394867308253,13
0.2,6858,92,550405,80.24566263303689,9
0.2,6859,81,550486,80.24577259475218,20
0.2,6860,88,550574,80.24690278385076,13
0.2,6861,94,550668,80.2489070241912,7
0.2,6862,96,550764,80.25120209820778,6
0.2,6863,17,550781,80.24198717948718,15
0.2,6864,94,550875,80.24399126001457,7
0.2,6865,92,550967,80.24570346635596,9
0.2,6866,89,551056,80.24697830202417,12
0.2,6867,95,551151,80.24912638322655,7
0.2,6868,96,551247,80.25141942058524,6
0.2,6869,91,551338,80.25298398835517,11
0.2,6870,91,551429,80.25454810071314,10
0.2,6871,96,551525,80.25683934807917,6
0.2,6872,88,551613,80.257965953732,13
0.2,6873,93,551706,80.2598196101251,8
0.2,6874,89,551795,80.26109090909091,12
0.2,6875,92,551887,80.2627981384526,9
0.2,6876,27,551914,80.25505307546895,6
0.2,6877,85,551999,80.25574294853155,16
0.2,6878,94,552093,80.25774095071958,8
0.2,6879,87,552180,80.25872093023256,14
0.2,6880,94,552274,80.26071791890713,8
0.2,6881,94,552368,80.26271432723046,7
0.2,6882,91,552459,80.26427429899753,10
0.2,6883,94,552553,80.26626961069145,8
0.2,6884,92,552645,80.26797385620915,9
0.2,6885,92,552737,80.26967760673831,9
0.2,6886,87,552824,80.27065485697692,14
0.2,6887,96,552920,80.27293844367016,6
0.2,6888,93,553013,80.27478589055015,10
0.2,6889,93,553106,80.2766328011611,8
0.2,6890,94,553200,80.2786242925555,8
0.2,6891,90,553290,80.28003482298317,11
0.2,6892,94,553384,80.28202524300015,8
0.2,6893,93,553477,80.2838700319118,8
0.2,6894,89,553566,80.28513415518492,12
0.2,6895,93,553659,80.28697795823666,8
0.2,6896,96,553755,80.2892561983471,6
0.2,6897,94,553849,80.29124383879385,7
0.2,6898,94,553943,80.29323090302942,8
0.2,6899,94,554037,80.29521739130435,7
0.2,6900,86,554123,80.29604405158673,16
0.2,6901,22,554145,80.28759779773979,10
0.2,6902,96,554241,80.28987396784007,6
0.2,6903,93,554334,80.29171494785632,8
0.2,6904,94,554428,80.29370021723389,7
0.2,6905,87,554515,80.29467130031857,14
0.2,6906,95,554610,80.29680034747358,9
0.2,6907,95,554705,80.29892877822815,6
0.2,6908,96,554801,80.30120133159647,6
0.2,6909,94,554895,80.30318379160637,7
0.2,6910,94,554989,80.3051656779048,7
0.2,6911,93,555082,80.30700231481481,8
0.2,6912,94,555176,80.30898307536525,7
0.2,6913,94,555270,80.31096326294475,7
0.2,6914,93,555363,80.31279826464208,8
0.2,6915,91,555454,80.31434355118566,12
0.2,6916,96,555550,80.31661124765071,6
0.2,6917,93,555643,80.31844463717837,8
0.2,6918,93,555736,80.32027749674809,8
0.2,6919,93,555829,80.3221098265896,8
0.2,6920,91,555920,80.32365265135095,10
0.2,6921,14,555934,80.3140710777232,18
0.2,6922,85,556019,80.3147479416438,16
0.2,6923,92,556111,80.31643558636627,9
0.2,6924,91,556202,80.31797833935018,10
0.2,6925,95,556297,80.32009818076811,7
0.2,6926,94,556391,80.32207304749531,8
0.2,6927,24,556415,80.31394341801386,8
0.2,6928,94,556509,80.31591860297301,8
0.2,6929,92,556601,80.31760461760462,9
0.2,6930,93,556694,80.3194344250469,8
0.2,6931,93,556787,80.32126370455858,8
0.2,6932,92,556879,80.32294821866437,9
0.2,6933,93,556972,80.32477646380156,8
0.2,6934,92,557064,80.32645998558039,9
0.2,6935,88,557152,80.3275663206459,13
0.2,6936,96,557248,80.32982557301428,6
0.2,6937,92,557340,80.33150763908907,9
0.2,6938,24,557364,80.32338953739732,9
0.2,6939,96,557460,80.3256484149856,6
0.2,6940,92,557552,80.3273303558565,9
0.2,6941,92,557644,80.32901181215787,10
0.2,6942,82,557726,80.32925248451679,20
0.2,6943,96,557822,80.33150921658986,6
0.2,6944,95,557917,80.33362131029517,7
0.2,6945,96,558013,80.33587676360496,6
0.2,6946,93,558106,80.33769972650065,8
0.2,6947,93,558199,80.3395221646517,8
0.2,6948,88,558287,80.340624550295,13
0.2,6949,95,558382,80.34273381294965,6
0.2,6950,95,558477,80.34484246870954,7
0.2,6951,92,558569,80.34651898734177,9
0.2,6952,93,558662,80.34833884654107,8
0.2,6953,85,558747,80.34900776531492,16
0.2,6954,94,558841,80.3509705248023,7
0.2,6955,89,558930,80.35221391604371,14
0.2,6956,93,559023,80.35403191030616,8
0.2,6957,95,559118,80.35613682092556,6
0.2,6958,91,559209,80.35766633136944,10
0.2,6959,93,559302,80.35948275862069,8
0.2,6960,95,559397,80.361585979026,7
0.2,6961,92,559489,80.3632576845734,9
0.2,6962,90,559579,80.36464167743789,11
0.2,6963,95,559674,80.36674325100518,7
0.2,6964,95,559769,80.36884422110553,7
0.2,6965,94,559863,80.37080103359173,7
0.2,6966,94,559957,80.37275728434047,7
0.2,6967,91,560048,80.37428243398392,10
0.2,6968,93,560141,80.37609413115224,8
0.2,6969,91,560232,80.37761836441894,10
0.2,6970,93,560325,80.37942906326208,10
0.2,6971,91,560416,80.38095238095238,10
0.2,6972,92,560508,80.38261867202066,9
0.2,6973,91,560599,80.38414109549757,11
0.2,6974,92,560691,80.38580645161291,9
0.2,6975,93,560784,80.38761467889908,8
0.2,6976,93,560877,80.38942238784578,9
0.2,6977,90,560967,80.39079965606192,11
0.2,6978,93,561060,80.39260639060038,9
0.2,6979,95,561155,80.39469914040114,7
0.2,6980,95,561250,80.39679129064604,6
0.2,6981,95,561345,80.39888284159267,7
0.2,6982,94,561439,80.40083058857225,7
0.2,6983,92,561531,80.40249140893471,9
0.2,6984,93,561624,80.40429491768074,8
0.2,6985,91,561715,80.40581162324649,10
0.2,6986,93,561808,80.40761414054673,8
0.2,6987,91,561899,80.40912993703492,10
0.2,6988,92,561991,80.41078838174273,10
0.2,6989,93,562084,80.41258941344778,8
0.2,6990,89,562173,80.41381776569875,12
0.2,6991,25,562198,80.40589244851259,8
0.2,6992,91,562289,80.4074074074074,10
0.2,6993,94,562383,80.40935087217615,8
0.2,6994,92,562475,80.41100786275912,9
0.2,6995,84,562559,80.41152086906804,19
0.2,6996,95,562654,80.41360583107046,7
0.2,6997,87,562741,80.41454701343241,14
0.2,6998,94,562835,80.41648806972425,7
0.2,6999,94,562929,80.41842857142858,8
0.2,7000,91,563020,80.41994000857021,10
0.2,7001,94,563114,80.42187946301057,7
0.2,7002,93,563207,80.42367556761388,9
0.2,7003,94,563301,80.42561393489434,7
0.2,7004,93,563394,80.42740899357602,9
0.2,7005,93,563487,80.429203539823,8
0.2,7006,86,563573,80.42999857285571,15
0.2,7007,96,563669,80.43222031963471,6
0.2,7008,94,563763,80.43415608503352,7
0.2,7009,91,563854,80.43566333808845,10
0.2,7010,27,563881,80.42804164883754,6
0.2,7011,94,563975,80.42997718197375,7
0.2,7012,92,564067,80.43162697846856,10
0.2,7013,86,564153,80.43242087254063,15
0.2,7014,92,564245,80.43406985032074,9
0.2,7015,91,564336,80.43557582668187,10
0.2,7016,93,564429,80.43736639589568,8
0.2,7017,25,564454,80.4294670846395,7
0.2,7018,-124,564330,80.40034192904972,18
0.2,7019,93,564423,80.40213675213676,8
0.2,7020,96,564519,80.4043583535109,6
0.2,7021,93,564612,80.40615209342067,8
0.2,7022,94,564706,80.40808771180407,7
0.2,7023,87,564793,80.40902619589977,14
0.2,7024,96,564889,80.41124555160143,6
0.2,7025,94,564983,80.41317961855964,8
0.2,7026,92,565075,80.41482851857123,9
0.2,7027,94,565169,80.41676152532726,7
0.2,7028,95,565264,80.41883624982216,6
0.2,7029,90,565354,80.42019914651493,11
0.2,7030,90,565444,80.42156165552554,11
0.2,7031,95,565539,80.42363481228669,6
0.2,7032,-51,565488,80.40494810180577,14
0.2,7033,26,565514,80.39721353426215,7
0.2,7034,96,565610,80.39943141435678,6
0.2,7035,90,565700,80.40079590676521,12
0.2,7036,95,565795,80.40287054142391,6
0.2,7037,94,565889,80.40480250071043,7
0.2,7038,94,565983,80.40673391106691,7
0.2,7039,95,566078,80.40880681818182,7
0.2,7040,26,566104,80.4010793921318,7
0.2,7041,92,566196,80.40272649815394,9
0.2,7042,85,566281,80.40337924180037,16
0.2,7043,94,566375,80.40530948324816,7
0.2,7044,90,566465,80.40667139815471,12
0.2,7045,93,566558,80.40845869997162,8
0.2,7046,90,566648,80.40981978146729,11
0.2,7047,93,566741,80.41160612939841,9
0.2,7048,26,566767,80.40388707618102,7
0.2,7049,95,566862,80.40595744680851,7
0.2,7050,92,566954,80.4076017586158,9
0.2,7051,95,567049,80.4096710153148,6
0.2,7052,94,567143,80.41159790160215,7
0.2,7053,94,567237,80.41352424156507,7
0.2,7054,94,567331,80.41545003543587,7
0.2,7055,94,567425,80.41737528344672,7
0.2,7056,92,567517,80.41901657928298,10
0.2,7057,95,567612,80.4210824596203,6
0.2,7058,89,567701,80.42229777588894,13
0.2,7059,90,567791,80.42365439093484,12
0.2,7060,92,567883,80.42529386772412,9
0.2,7061,94,567977,80.42721608609459,7
0.2,7062,91,568068,80.42871301146822,10
0.2,7063,93,568161,80.4304926387316,8
0.2,7064,90,568251,80.43184713375796,11
0.2,7065,94,568345,80.43376733654118,7
0.2,7066,93,568438,80.43554549313711,8
0.2,7067,-55,568383,80.41638370118845,18
0.2,7068,84,568467,80.4168906493139,17
0.2,7069,95,568562,80.41895332390382,6
0.2,7070,19,568581,80.4102672889266,13
0.2,7071,94,568675,80.41218891402715,7
0.2,7072,92,568767,80.41382723031245,9
0.2,7073,91,568858,80.41532372066723,10
0.2,7074,95,568953,80.4173851590106,6
0.2,7075,94,569047,80.41930469191634,8
0.2,7076,95,569142,80.42136498516321,6
0.2,7077,92,569234,80.4230008476971,9
0.2,7078,92,569326,80.42463624805764,9
0.2,7079,94,569420,80.42655367231639,7
0.2,7080,92,569512,80.42818810902415,9
0.2,7081,94,569606,80.430104490257,8
0.2,7082,94,569700,80.43202033036849,8
0.2,7083,27,569727,80.42447769621683,6
0.2,7084,27,569754,80.41693719124912,6
0.2,7085,94,569848,80.41885407846458,7
0.2,7086,91,569939,80.42034711443488,12
0.2,7087,90,570029,80.4216986455982,12
0.2,7088,94,570123,80.42361404993652,7
0.2,7089,95,570218,80.42566995768688,6
0.2,7090,27,570245,80.41813566492738,6
0.2,7091,93,570338,80.4199097574732,9
0.2,7092,92,570430,80.42154236571267,10
0.2,7093,21,570451,80.41316605582182,11
0.2,7094,92,570543,80.41479915433403,9
0.2,7095,94,570637,80.41671364148816,8
0.2,7096,92,570729,80.418345779907,10
0.2,7097,94,570823,80.42025922795153,7
0.2,7098,89,570912,80.42146781236794,14
0.2,7099,88,571000,80.4225352112676,13
0.2,7100,92,571092,80.4241656104774,9
0.2,7101,92,571184,80.42579555054914,10
0.2,7102,95,571279,80.42784738842742,7
0.2,7103,14,571293,80.41849662162163,20
0.2,7104,91,571384,80.41998592540465,10
0.2,7105,92,571476,80.42161553616663,9
0.2,7106,89,571565,80.42282256929788,12
0.2,7107,14,571579,80.41347777152504,19
0.2,7108,90,571669,80.41482627655085,12
0.2,7109,92,571761,80.41645569620253,10
0.2,7110,92,571853,80.41808465757278,9
0.2,7111,95,571948,80.42013498312711,6
0.2,7112,94,572042,80.42204414452411,7
0.2,7113,92,572134,80.42367163339892,9
0.2,7114,-55,572079,80.40463808854533,18
0.2,7115,92,572171,80.40626756604834,10
0.2,7116,90,572261,80.40761556835746,14
0.2,7117,94,572355,80.40952514751335,7
0.2,7118,93,572448,80.41129372102823,9
0.2,7119,92,572540,80.41292134831461,9
0.2,7120,96,572636,80.41511023732622,6
0.2,7121,90,572726,80.41645605167088,11
0.2,7122,86,572812,80.41723992699706,15
0.2,7123,95,572907,80.4192869174621,6
0.2,7124,93,573000,80.42105263157895,8
0.2,7125,95,573095,80.42309851248947,7
0.2,7126,86,573181,80.4238810158552,15
0.2,7127,92,573273,80.42550505050505,9
0.2,7128,92,573365,80.42712862954131,9
0.2,7129,95,573460,80.42917251051894,6
0.2,7130,18,573478,80.42041789370354,14
0.2,7131,92,573570,80.42204150308469,9
0.2,7132,93,573663,80.42380485069395,8
0.2,7133,93,573756,80.42556770395291,8
0.2,7134,94,573850,80.42747021723896,7
0.2,7135,95,573945,80.42951233183857,7
0.2,7136,-47,573898,80.41165755919855,10
0.2,7137,96,573994,80.41384141216027,6
0.2,7138,22,574016,80.40565905589018,10
0.2,7139,90,574106,80.40700280112044,11
0.2,7140,89,574195,80.40820613359473,12
0.2,7141,91,574286,80.40968916269952,10
0.2,7142,94,574380,80.41159176816464,7
0.2,7143,96,574476,80.41377379619261,6
0.2,7144,26,574502,80.40615815255424,7
0.2,7145,23,574525,80.39812482507696,10
0.2,7146,94,574619,80.40002798376942,8
0.2,7147,83,574702,80.40039171796306,18
0.2,7148,93,574795,80.40215414743321,9
0.2,7149,94,574889,80.40405594405594,7
0.2,7150,96,574985,80.40623688994546,6
0.2,7151,95,575080,80.4082774049217,7
0.2,7152,92,575172,80.40989794491821,9
0.2,7153,91,575263,80.41137824993011,10
0.2,7154,94,575357,80.41327742837177,7
0.2,7155,27,575384,80.40581330352153,6
0.2,7156,94,575478,80.40771272879698,8
0.2,7157,27,575505,80.4002514668902,6
0.2,7158,93,575598,80.4020114541137,9
0.2,7159,22,575620,80.39385474860335,11
0.2,7160,91,575711,80.39533584694875,10
0.2,7161,89,575800,80.39653728008936,13
0.2,7162,96,575896,80.39871562194611,6
0.2,7163,91,575987,80.40019542155221,10
0.2,7164,92,576079,80.40181437543615,10
0.2,7165,87,576166,80.40273513815238,14
0.2,7166,92,576258,80.40435328589368,9
0.2,7167,94,576352,80.40625,7
0.2,7168,90,576442,80.40758822708885,11
0.2,7169,96,576538,80.40976290097629,6
0.2,7170,95,576633,80.41179751777995,6
0.2,7171,94,576727,80.41369213608478,8
0.2,7172,91,576818,80.41516799107765,10
0.2,7173,94,576912,80.41706161137441,7
0.2,7174,92,577004,80.41867595818816,9
0.2,7175,95,577099,80.42070791527313,6
0.2,7176,88,577187,80.42176396823186,13
0.2,7177,87,577274,80.42268041237114,14
0.2,7178,94,577368,80.42457166736314,7
0.2,7179,96,577464,80.4267409470752,6
0.2,7180,89,577553,80.42793482801838,12
0.2,7181,91,577644,80.42940685045949,10
0.2,7182,21,577665,80.42113323124043,12
0.2,7183,91,577756,80.42260579064587,10
0.2,7184,94,577850,80.42449547668754,7
0.2,7185,95,577945,80.42652379627053,6
0.2,7186,95,578040,80.42855155141227,6
0.2,7187,96,578136,80.43071786310517,6
0.2,7188,91,578227,80.43218806509945,10
0.2,7189,92,578319,80.43379694019471,9
0.2,7190,94,578413,80.43568349325545,7
0.2,7191,94,578507,80.43756952169076,7
0.2,7192,93,578600,80.43931600166829,8
0.2,7193,21,578621,80.4310536558243,11
0.2,7194,16,578637,80.42209867963864,17
0.2,7195,94,578731,80.4239855475264,7
0.2,7196,93,578824,80.42573294428234,8
0.2,7197,92,578916,80.42734092803556,9
0.2,7198,88,579004,80.42839283233782,13
0.2,7199,89,579093,80.42958333333333,12
0.2,7200,90,579183,80.43091237328149,12
0.2,7201,94,579277,80.43279644543182,7
0.2,7202,93,579370,80.43454116340413,9
0.2,7203,90,579460,80.43586896168794,12
0.2,7204,93,579553,80.43761276891048,8
0.2,7205,87,579640,80.43852345267833,16
0.2,7206,93,579733,80.44026640765922,8
0.2,7207,96,579829,80.44242508324085,6
0.2,7208,94,579923,80.44430572894993,8
0.2,7209,90,580013,80.44563106796116,14
0.2,7210,94,580107,80.44751074746914,7
0.2,7211,93,580200,80.44925124792013,8
0.2,7212,88,580288,80.45029807292389,13
0.2,7213,96,580384,80.45245356251733,6
0.2,7214,94,580478,80.45433125433125,7
0.2,7215,87,580565,80.45523835920177,14
0.2,7216,92,580657,80.45683802133851,9
0.2,7217,93,580750,80.45857578276531,8
0.2,7218,93,580843,80.46031306275107,8
0.2,7219,92,580935,80.46191135734072,9
0.2,7220,26,580961,80.4543692009417,7
0.2,7221,92,581053,80.45596787593465,11
0.2,7222,95,581148,80.45798144815174,9
0.2,7223,-50,581098,80.43992248062015,13
0.2,7224,20,581118,80.43155709342561,12
0.2,7225,24,581142,80.42374757818988,9
0.2,7226,95,581237,80.42576449425765,7
0.2,7227,94,581331,80.4276425013835,8
0.2,7228,94,581425,80.42951998893346,7
0.2,7229,90,581515,80.43084370677731,11
0.2,7230,94,581609,80.43272023233301,7
0.2,7231,95,581704,80.43473451327434,6
0.2,7232,22,581726,80.42665560624914,11
0.2,7233,91,581817,80.42811722421897,10
0.2,7234,95,581912,80.43013130615066,8
0.2,7235,88,582000,80.43117744610282,14
0.2,7236,92,582092,80.43277601215974,9
0.2,7237,94,582186,80.43465045592706,7
0.2,7238,90,582276,80.43597181931206,11
0.2,7239,92,582368,80.43756906077348,9
0.2,7240,94,582462,80.43944206601299,8
0.2,7241,93,582555,80.44117647058823,8
0.2,7242,94,582649,80.44304846058263,7
0.2,7243,93,582742,80.44478188845942,9
0.2,7244,89,582831,80.44596273291926,13
0.2,7245,88,582919,80.4470052442727,13
0.2,7246,93,583012,80.44873740858286,8
0.2,7247,86,583098,80.44950331125828,16
0.2,7248,90,583188,80.45082080286936,11
0.2,7249,90,583278,80.45213793103449,12
0.2,7250,94,583372,80.45400634395256,7
0.2,7251,89,583461,80.45518477661335,12
0.2,7252,92,583553,80.45677650627327,9
0.2,7253,-122,583431,80.42886683209264,16
0.2,7254,96,583527,80.43101309441764,6
0.2,7255,96,583623,80.43315876515987,6
0.2,7256,94,583717,80.43502824858757,8
0.2,7257,94,583811,80.43689721686415,8
0.2,7258,92,583903,80.43849015015843,9
0.2,7259,94,583997,80.44035812672176,7
0.2,7260,91,584088,80.44181242253133,11
0.2,7261,95,584183,80.44381713026715,6
0.2,7262,94,584277,80.44568360181744,7
0.2,7263,94,584371,80.44754955947137,7
0.2,7264,96,584467,80.44969029593943,6
0.2,7265,21,584488,80.44150839526561,11
0.2,7266,91,584579,80.442961332049,10
0.2,7267,91,584670,80.44441386901487,10
0.2,7268,5,584675,80.43403494290824,28
0.2,7269,92,584767,80.43562585969738,9
0.2,7270,92,584859,80.43721633888049,9
0.2,7271,94,584953,80.43908140814081,7
0.2,7272,94,585047,80.44094596452634,7
0.2,7273,91,585138,80.44239758042343,10
0.2,7274,92,585230,80.44398625429554,10
0.2,7275,92,585322,80.44557449147884,9
0.2,7276,93,585415,80.44729971141955,9
0.2,7277,94,585509,80.4491618576532,7
0.2,7278,96,585605,80.45129825525484,6
0.2,7279,94,585699,80.45315934065934,7
0.2,7280,93,585792,80.4548825710754,9
0.2,7281,86,585878,80.45564405383136,15
0.2,7282,93,585971,80.45736646986133,8
0.2,7283,95,586066,80.45936298736957,6
0.2,7284,91,586157,80.4608098833219,10
0.2,7285,25,586182,80.4531979138073,8
0.2,7286,88,586270,80.4542335666255,13
0.2,7287,93,586363,80.45595499451153,8
0.2,7288,94,586457,80.45781314309234,7
0.2,7289,-44,586413,80.44074074074074,8
0.2,7290,94,586507,80.44260046632834,9
0.2,7291,21,586528,80.43444871091607,12
0.2,7292,92,586620,80.43603455368161,9
0.2,7293,93,586713,80.43775706059775,8
0.2,7294,96,586809,80.43989033584647,6
0.2,7295,94,586903,80.44174890350877,7
0.2,7296,27,586930,80.43442510620802,6
0.2,7297,96,587026,80.43655796108523,6
0.2,7298,93,587119,80.438279216331,8
0.2,7299,95,587214,80.44027397260274,6
0.2,7300,93,587307,80.44199424736337,8
0.2,7301,95,587402,80.44398794850726,6
0.2,7302,89,587491,80.4451595234835,12
0.2,7303,94,587585,80.44701533406352,7
0.2,7304,92,587677,80.44859685147159,9
0.2,7305,94,587771,80.45045168354777,7
0.2,7306,92,587863,80.45203229779663,10
0.2,7307,95,587958,80.45402298850574,6
0.2,7308,93,588051,80.4557394992475,9
0.2,7309,18,588069,80.44719562243502,14
0.2,7310,92,588161,80.44877581726166,9
0.2,7311,84,588245,80.44926148796499,17
0.2,7312,96,588341,80.4513879392862,6
0.2,7313,91,588432,80.45283018867924,10
0.2,7314,88,588520,80.45386192754614,13
0.2,7315,91,588611,80.45530344450519,10
0.2,7316,92,588703,80.45688123547902,9
0.2,7317,93,588796,80.45859524460235,9
0.2,7318,87,588883,80.45948900122967,14
0.2,7319,92,588975,80.4610655737705,9
0.2,7320,27,589002,80.45376314711105,6
0.2,7321,94,589096,80.45561322043157,7
0.2,7322,91,589187,80.45705312030589,10
0.2,7323,94,589281,80.45890223921354,7
0.2,7324,91,589372,80.46034129692833,10
0.2,7325,91,589463,80.46177996177997,10
0.2,7326,95,589558,80.46376415995633,7
0.2,7327,92,589650,80.4653384279476,10
0.2,7328,93,589743,80.46704871060172,8
0.2,7329,93,589836,80.468758526603,8
0.2,7330,92,589928,80.47033146910381,9
0.2,7331,92,590020,80.47190398254229,9
0.2,7332,95,590115,80.47388517659894,6
0.2,7333,91,590206,80.47532042541587,10
0.2,7334,95,590301,80.47730061349694,6
0.2,7335,95,590396,80.479280261723,6
0.2,7336,90,590486,80.48057789287175,11
0.2,7337,86,590572,80.48133006268738,17
0.2,7338,95,590667,80.4833083526366,6
0.2,7339,95,590762,80.48528610354224,6
0.2,7340,22,590784,80.47731916632611,10
0.2,7341,94,590878,80.47916099155543,8
0.2,7342,91,590969,80.48059376276726,11
0.2,7343,26,590995,80.47317538126362,7
0.2,7344,94,591089,80.47501701837984,7
0.2,7345,-49,591040,80.45739177783828,12
0.2,7346,94,591134,80.45923506193004,7
0.2,7347,91,591225,80.46066956995101,10
0.2,7348,95,591320,80.46264797931691,6
0.2,7349,89,591409,80.46380952380953,12
0.2,7350,96,591505,80.46592300367297,6
0.2,7351,91,591596,80.46735582154515,10
0.2,7352,89,591685,80.46851625186999,12
0.2,7353,95,591780,80.47049224911613,8
0.2,7354,96,591876,80.47260367097213,6
0.2,7355,92,591968,80.4741707449701,9
0.2,7356,91,592059,80.47560146798968,10
0.2,7357,93,592152,80.4773036151128,8
0.2,7358,96,592248,80.47941296371789,6
0.2,7359,27,592275,80.47214673913044,6
0.2,7360,93,592368,80.4738486618666,8
0.2,7361,94,592462,80.47568595490355,8
0.2,7362,89,592551,80.4768436778487,12
0.2,7363,25,592576,80.46931015752308,8
0.2,7364,94,592670,80.47114731839783,7
0.2,7365,91,592761,80.4725767037741,10
0.2,7366,87,592848,80.47346273924256,14
0.2,7367,25,592873,80.46593376764386,8
0.2,7368,90,592963,80.46722757497625,12
0.2,7369,95,593058,80.46919945725917,7
0.2,7370,93,593151,80.47089947089947,8
0.2,7371,90,593241,80.47219207813347,12
0.2,7372,89,593330,80.47334870473348,12
0.2,7373,92,593422,80.47491185245457,9
0.2,7374,92,593514,80.47647457627119,9
0.2,7375,88,593602,80.47749457700651,13
0.2,7376,84,593686,80.4779720753694,17
0.2,7377,93,593779,80.47966928706967,8
0.2,7378,89,593868,80.48082395988617,12
0.2,7379,24,593892,80.47317073170731,8
0.2,7380,-60,593832,80.45413900555481,24
0.2,7381,94,593926,80.45597399078841,7
0.2,7382,91,594017,80.45740214005147,12
0.2,7383,95,594112,80.45937161430119,6
0.2,7384,96,594208,80.46147596479351,6
0.2,7385,95,594303,80.4634443541836,7
0.2,7386,92,594395,80.46500609178287,9
0.2,7387,95,594490,80.46697347049269,6
0.2,7388,94,594584,80.46880498037623,7
0.2,7389,92,594676,80.47036535859269,9
0.2,7390,93,594769,80.47206061426058,8
0.2,7391,96,594865,80.47416125541126,6
0.2,7392,79,594944,80.47396185580955,22
0.2,7393,93,595037,80.47565593724642,8
0.2,7394,94,595131,80.47748478701826,9
0.2,7395,96,595227,80.47958355868037,6
0.2,7396,26,595253,80.47221846694606,7
0.2,7397,96,595349,80.47431738307651,6
0.2,7398,94,595443,80.47614542505744,7
0.2,7399,96,595539,80.47824324324324,6
0.2,7400,25,595564,80.47074719632482,8
0.2,7401,93,595657,80.47243988111322,8
0.2,7402,96,595753,80.47453734972308,6
0.2,7403,94,595847,80.47636412749866,7
0.2,7404,94,595941,80.47819041188386,8
0.2,7405,92,596033,80.47974615176884,9
0.2,7406,95,596128,80.48170649385716,6
0.2,7407,87,596215,80.48258639308855,14
0.2,7408,95,596310,80.48454582264813,6
0.2,7409,91,596401,80.4859649122807,10
0.2,7410,91,596492,80.48738361894482,10
0.2,7411,94,596586,80.48920669185105,7
0.2,7412,95,596681,80.49116417105085,6
0.2,7413,91,596772,80.49258160237389,10
0.2,7414,89,596861,80.49372892784895,12
0.2,7415,89,596950,80.49487594390507,12
0.2,7416,94,597044,80.49669677767291,7
0.2,7417,93,597137,80.498382313292,8
0.2,7418,85,597222,80.49898908208654,16
0.2,7419,92,597314,80.50053908355795,9
0.2,7420,87,597401,80.50141490365179,15
0.2,7421,87,597488,80.50229048773916,14
0.2,7422,93,597581,80.50397413444699,8
0.2,7423,88,597669,80.50498383620689,13
0.2,7424,89,597758,80.50612794612795,12
0.2,7425,94,597852,80.50794505790466,7
0.2,7426,92,597944,80.50949239262151,9
0.2,7427,95,598039,80.51144318793753,6
0.2,7428,87,598126,80.5123165971194,14
0.2,7429,95,598221,80.514266487214,7
0.2,7430,94,598315,80.51608128111964,7
0.2,7431,93,598408,80.51776103336921,8
0.2,7432,94,598502,80.5195748688282,8
0.2,7433,94,598596,80.52138821630346,8
0.2,7434,89,598685,80.52252858103564,12
0.2,7435,95,598780,80.52447552447552,7
0.2,7436,95,598875,80.5264219443324,6
0.2,7437,88,598963,80.52742672761495,14
0.2,7438,87,599050,80.52829681408791,14
0.2,7439,93,599143,80.52997311827957,9
0.2,7440,94,599237,80.53178336245128,7
0.2,7441,94,599331,80.533593120129,8
0.2,7442,95,599426,80.53553674593577,6
0.2,7443,94,599520,80.53734551316496,7
0.2,7444,94,599614,80.53915379449295,8
0.2,7445,93,599707,80.54082728982004,9
0.2,7446,92,599799,80.54236605344434,9
0.2,7447,94,599893,80.54417293233082,7
0.2,7448,93,599986,80.5458450798765,8
0.2,7449,96,600082,80.54791946308725,6
0.2,7450,95,600177,80.54985907931821,6
0.2,7451,88,600265,80.55085882984433,13
0.2,7452,90,600355,80.55212666040521,11
0.2,7453,91,600446,80.55352830694929,10
0.2,7454,27,600473,80.54634473507713,7
0.2,7455,25,600498,80.53889484978541,7
0.2,7456,95,600593,80.54083411559608,7
0.2,7457,94,600687,80.54263877715205,7
0.2,7458,94,600781,80.54444295481969,8
0.2,7459,90,600871,80.54571045576408,11
0.2,7460,91,600962,80.54711164723227,11
0.2,7461,95,601057,80.54904851246314,7
0.2,7462,95,601152,80.55098485863594,6
0.2,7463,95,601247,80.55292068595926,6
0.2,7464,75,601322,80.55217682518419,26
0.2,7465,90,601412,80.5534422716314,11
0.2,7466,90,601502,80.55470737913485,12
0.2,7467,89,601591,80.55583824317087,12
0.2,7468,94,601685,80.55763823805061,7
0.2,7469,88,601773,80.55863453815262,13
0.2,7470,92,601865,80.56016597510373,9
0.2,7471,93,601958,80.56183083511777,8
0.2,7472,96,602054,80.56389669476783,7
0.2,7473,91,602145,80.56529301578807,10
0.2,7474,95,602240,80.56722408026756,6
0.2,7475,93,602333,80.56888710540396,8
0.2,7476,94,602427,80.57068342918282,7
0.2,7477,87,602514,80.5715431933672,14
0.2,7478,95,602609,80.57347238935687,6
0.2,7479,94,602703,80.57526737967915,8
0.2,7480,91,602794,80.57666087421468,11
0.2,7481,94,602888,80.57845495856722,7
0.2,7482,91,602979,80.57984765468395,10
0.2,7483,91,603070,80.58123997862106,11
0.2,7484,93,603163,80.58289913159652,8
0.2,7485,92,603255,80.58442425861608,9
0.2,7486,94,603349,80.5862161079204,7
0.2,7487,89,603438,80.58733974358974,12
0.2,7488,92,603530,80.58886366671118,9
0.2,7489,90,603620,80.59012016021362,12
0.2,7490,95,603715,80.59204378587638,6
0.2,7491,24,603739,80.58449012279765,9
0.2,7492,94,603833,80.58628052849326,7
0.2,7493,94,603927,80.58807045636509,7
0.2,7494,95,604022,80.58999332888592,7
0.2,7495,95,604117,80.59191568836712,6
0.2,7496,92,604209,80.59343737494999,9
0.2,7497,93,604302,80.59509202453988,9
0.2,7498,89,604391,80.59621282837712,12
0.2,7499,94,604485,80.598,7
0.2,7500,94,604579,80.59978669510731,8
0.2,7501,94,604673,80.60157291388963,7
0.2,7502,94,604767,80.60335865653738,7
0.2,7503,90,604857,80.60461087420043,11
0.2,7504,89,604946,80.60572951365756,14
0.2,7505,90,605036,80.60698108180122,11
0.2,7506,94,605130,80.60876515252431,7
0.2,7507,96,605226,80.61081513052744,6
0.2,7508,93,605319,80.61246504194966,10
0.2,7509,89,605408,80.61358189081226,12
0.2,7510,92,605500,80.61509785647716,9
0.2,7511,95,605595,80.61701277955271,6
0.2,7512,93,605688,80.61866098762145,8
0.2,7513,96,605784,80.62070801171147,6
0.2,7514,94,605878,80.6224883566201,7
0.2,7515,89,605967,80.62360298030868,12
0.2,7516,94,606061,80.62538246640948,7
0.2,7517,92,606153,80.6268954509178,10
0.2,7518,95,606248,80.6288070222104,6
0.2,7519,91,606339,80.63018617021277,10
0.2,7520,95,606434,80.63209679563887,7
0.2,7521,95,606529,80.63400691305503,6
0.2,7522,93,606622,80.63565067127476,8
0.2,7523,89,606711,80.63676236044657,12
0.2,7524,93,606804,80.63840531561462,8
0.2,7525,93,606897,80.64004783417487,10
0.2,7526,94,606991,80.64182277135644,7
0.2,7527,85,607076,80.64240170031881,16
0.2,7528,94,607170,80.64417585336697,7
0.2,7529,93,607263,80.64581673306773,8
0.2,7530,93,607356,80.64745717700173,8
0.2,7531,95,607451,80.64936271906532,6
0.2,7532,-58,607393,80.63095712199654,21
0.2,7533,94,607487,80.6327316166711,7
0.2,7534,91,607578,80.63410749834108,12
0.2,7535,95,607673,80.63601380042464,6
0.2,7536,95,607768,80.63791959665649,7
0.2,7537,93,607861,80.63955956487132,8
0.2,7538,90,607951,80.64080116726356,11
0.2,7539,88,608039,80.64177718832892,14
0.2,7540,17,608056,80.63333775361357,15
0.2,7541,95,608151,80.63524264120923,6
0.2,7542,-50,608101,80.61792390295638,13
0.2,7543,82,608183,80.61810710498409,19
0.2,7544,91,608274,80.61948310139165,10
0.2,7545,93,608367,80.621123774185,8
0.2,7546,94,608461,80.62289651517159,7
0.2,7547,94,608555,80.62466878643349,10
0.2,7548,96,608651,80.62670552391045,6
0.2,7549,89,608740,80.62781456953643,12
0.2,7550,93,608833,80.62945305257581,9
0.2,7551,93,608926,80.63109110169492,8
0.2,7552,93,609019,80.63272871706607,8
0.2,7553,92,609111,80.63423351866561,9
0.2,7554,89,609200,80.63534083388484,12
0.2,7555,95,609295,80.63724192694548,7
0.2,7556,93,609388,80.63887786158529,8
0.2,7557,90,609478,80.64011643291876,11
0.2,7558,85,609563,80.64069321338802,18
0.2,7559,92,609655,80.64219576719577,9
0.2,7560,93,609748,80.64383018119297,10
0.2,7561,95,609843,80.64572864321607,7
0.2,7562,90,609933,80.64696548988496,11
0.2,7563,92,610025,80.64846641988366,9
0.2,7564,92,610117,80.64996695307336,9
0.2,7565,89,610206,80.65107057890563,12
0.2,7566,90,610296,80.65230606581208,11
0.2,7567,94,610390,80.65406976744185,7
0.2,7568,93,610483,80.65570088518959,8
0.2,7569,91,610574,80.65706737120212,10
0.2,7570,93,610667,80.65869766213181,8
0.2,7571,23,610690,80.65108293713682,11
0.2,7572,92,610782,80.65258153968044,9
0.2,7573,95,610877,80.6544758383945,6
0.2,7574,87,610964,80.65531353135313,15
0.2,7575,-50,610914,80.63806758183738,14
0.2,7576,94,611008,80.63983106770489,7
0.2,7577,93,611101,80.64146212721035,8
0.2,7578,91,611192,80.64282886924396,10
0.2,7579,93,611285,80.64445910290237,9
0.2,7580,94,611379,80.64622081519589,7
0.2,7581,94,611473,80.64798206278027,7
0.2,7582,96,611569,80.65000659369643,6
0.2,7583,95,611664,80.65189873417721,6
0.2,7584,91,611755,80.65326301911668,10
0.2,7585,95,611850,80.65515423147905,7
0.2,7586,91,611941,80.6565177276921,11
0.2,7587,92,612033,80.65801265155508,11
0.2,7588,94,612127,80.65977072078007,7
0.2,7589,89,612216,80.6608695652174,12
0.2,7590,94,612310,80.66262679488868,7
0.2,7591,94,612404,80.66438356164383,7
0.2,7592,94,612498,80.66613986566574,8
0.2,7593,95,612593,80.66802739004477,6
0.2,7594,92,612685,80.66951942067149,9
0.2,7595,94,612779,80.67127435492364,8
0.2,7596,88,612867,80.672239041727,14
0.2,7597,94,612961,80.67399315609372,7
0.2,7598,89,613050,80.6750888274773,12
0.2,7599,94,613144,80.67684210526316,7
0.2,7600,25,613169,80.66951716879358,8
0.2,7601,96,613265,80.67153380689292,6
0.2,7602,94,613359,80.67328686044982,8
0.2,7603,96,613455,80.67530247238295,6
0.2,7604,92,613547,80.6767915844839,10
0.2,7605,94,613641,80.67854325532474,7
0.2,7606,21,613662,80.67069804127777,12
0.2,7607,-47,613615,80.65391692954785,10
0.2,7608,25,613640,80.64660270732028,8
0.2,7609,94,613734,80.64835742444153,7
0.2,7610,96,613830,80.65037445802129,6
0.2,7611,92,613922,80.6518654755649,9
0.2,7612,95,614017,80.65375016419283,6
0.2,7613,92,614109,80.65524034672971,9
0.2,7614,89,614198,80.65633617859488,13
0.2,7615,88,614286,80.65730042016807,13
0.2,7616,94,614380,80.65905212025731,7
0.2,7617,94,614474,80.66080336046207,7
0.2,7618,92,614566,80.66229163932275,9
0.2,7619,92,614658,80.66377952755906,9
0.2,7620,93,614751,80.66539824170056,10
0.2,7621,26,614777,80.6582261873524,7
0.2,7622,92,614869,80.65971402335039,10
0.2,7623,92,614961,80.66120146904512,9
0.2,7624,93,615054,80.66281967213115,9
0.2,7625,89,615143,80.66391292945187,12
0.2,7626,89,615232,80.66500590009178,12
0.2,7627,93,615325,80.66662296801259,8
0.2,7628,94,615419,80.66837069078517,7
0.2,7629,93,615512,80.6699868938401,9
0.2,7630,95,615607,80.67186476215437,7
0.2,7631,96,615703,80.67387316561845,6
0.2,7632,96,615799,80.6758810428403,6
0.2,7633,90,615889,80.67710243646843,11
0.2,7634,95,615984,80.67897838899803,6
0.2,7635,81,616065,80.67902042954427,20
0.2,7636,17,616082,80.67068220505433,16
0.2,7637,92,616174,80.67216548834773,9
0.2,7638,86,616260,80.67286294017542,16
0.2,7639,96,616356,80.67486910994765,6
0.2,7640,92,616448,80.6763512629237,9
0.2,7641,91,616539,80.67770217220622,10
0.2,7642,91,616630,80.67905272798639,10
0.2,7643,94,616724,80.6807953950811,7
0.2,7644,94,616818,80.68253760627861,8
0.2,7645,24,616842,80.67512424797279,9
0.2,7646,17,616859,80.66679743690337,15
0.2,7647,93,616952,80.668410041841,8
0.2,7648,95,617047,80.67028369721532,6
0.2,7649,92,617139,80.67176470588235,10
0.2,7650,93,617232,80.67337602927722,8
0.2,7651,96,617328,80.67537898588604,6
0.2,7652,93,617421,80.67698941591533,8
0.2,7653,96,617517,80.67899137705774,6
0.2,7654,94,617611,80.68073154800784,7
0.2,7655,92,617703,80.68221003134796,9
0.2,7656,93,617796,80.68381872796134,8
0.2,7657,91,617887,80.68516583964481,10
0.2,7658,94,617981,80.68690429559994,7
0.2,7659,90,618071,80.68812010443864,11
0.2,7660,94,618165,80.68985772092417,7
0.2,7661,89,618254,80.69094231271208,12
0.2,7662,27,618281,80.68393579538039,6
0.2,7663,95,618376,80.68580375782881,9
0.2,7664,92,618468,80.68727984344423,9
0.2,7665,91,618559,80.68862509783459,11
0.2,7666,86,618645,80.6893178557454,16
0.2,7667,96,618741,80.69131455399061,6
0.2,7668,92,618833,80.69278915112791,9
0.2,7669,90,618923,80.69400260756193,11
0.2,7670,89,619012,80.69508538652066,12
0.2,7671,94,619106,80.69681960375391,7
0.2,7672,92,619198,80.69829271471393,10
0.2,7673,92,619290,80.69976544175137,9
0.2,7674,95,619385,80.70162866449512,7
0.2,7675,94,619479,80.70336112558624,7
0.2,7676,89,619568,80.70444183926013,12
0.2,7677,86,619654,80.7051315446731,16
0.2,7678,94,619748,80.70686287276989,7
0.2,7679,93,619841,80.70846354166666,8
0.2,7680,26,619867,80.70134097122771,7
0.2,7681,93,619960,80.70294194220256,8
0.2,7682,90,620050,80.70415202394898,11
0.2,7683,27,620077,80.69716293597085,6
0.2,7684,96,620173,80.69915419648666,6
0.2,7685,95,620268,80.70101483216237,6
0.2,7686,24,620292,80.69363861064134,9
0.2,7687,94,620386,80.69536940686784,7
0.2,7688,93,620479,80.6969696969697,8
0.2,7689,21,620500,80.6892067620286,11
0.2,7690,-46,620454,80.67273436484203,10
0.2,7691,91,620545,80.67407696307852,10
0.2,7692,92,620637,80.67554920057195,9
0.2,7693,27,620664,80.66857291395893,6
0.2,7694,92,620756,80.67004548408057,10
0.2,7695,94,620850,80.67177754677755,7
0.2,7696,93,620943,80.67337923866441,8
0.2,7697,94,621037,80.67511041829046,7
0.2,7698,94,621131,80.67684114820106,7
0.2,7699,92,621223,80.6783116883117,9
0.2,7700,93,621316,80.67991169977925,8
0.2,7701,92,621408,80.6813814593612,9
0.2,7702,95,621503,80.68324029598858,6
0.2,7703,9,621512,80.67393561786085,23
0.2,7704,93,621605,80.67553536664504,8
0.2,7705,95,621700,80.6773942382559,6
0.2,7706,94,621794,80.67912287530817,7
0.2,7707,90,621884,80.68033212247016,11
0.2,7708,93,621977,80.68193021144117,10
0.2,7709,96,622073,80.68391699092088,6
0.2,7710,94,622167,80.68564388535857,8
0.2,7711,92,622259,80.68711099585062,9
0.2,7712,92,622351,80.68857772591728,9
0.2,7713,89,622440,80.6896551724138,12
0.2,7714,91,622531,80.69099157485418,10
0.2,7715,91,622622,80.69232763089684,10
0.2,7716,86,622708,80.69301542050019,15
0.2,7717,94,622802,80.69473956983674,7
0.2,7718,93,622895,80.69633372198471,9
0.2,7719,92,622987,80.69779792746114,9
0.2,7720,90,623077,80.69900271985495,13
0.2,7721,87,623164,80.6998186998187,15
0.2,7722,90,623254,80.70102291855497,11
0.2,7723,88,623342,80.70196789228379,14
0.2,7724,93,623435,80.70355987055017,8
0.2,7725,91,623526,80.70489257054103,12
0.2,7726,89,623615,80.70596609292093,12
0.2,7727,93,623708,80.7075569358178,8
0.2,7728,95,623803,80.70940613274679,7
0.2,7729,93,623896,80.71099611901681,8
0.2,7730,94,623990,80.71271504333204,8
0.2,7731,96,624086,80.71469218830833,6
0.2,7732,82,624168,80.71485839906893,19
0.2,7733,89,624257,80.7159296612361,12
0.2,7734,91,624348,80.71725921137686,10
0.2,7735,89,624437,80.71832988624612,12
0.2,7736,94,624531,80.72004652966265,7
0.2,7737,24,624555,80.71271646420264,8
0.2,7738,94,624649,80.71443338932679,7
0.2,7739,87,624736,80.71524547803618,14
0.2,7740,95,624831,80.71709081514017,6
0.2,7741,96,624927,80.71906484112633,6
0.2,7742,90,625017,80.72026346377373,11
0.2,7743,91,625108,80.7215909090909,10
0.2,7744,95,625203,80.7234344738541,6
0.2,7745,94,625297,80.72514846372322,7
0.2,7746,93,625390,80.72673292887569,9
0.2,7747,92,625482,80.72818791946308,9
0.2,7748,87,625569,80.7289972899729,14
0.2,7749,95,625664,80.73083870967741,6
0.2,7750,95,625759,80.73267965423817,7
0.2,7751,93,625852,80.73426212590299,8
0.2,7752,94,625946,80.73597317167548,8
0.2,7753,-44,625902,80.71988651018829,8
0.2,7754,94,625996,80.72159896840748,7
0.2,7755,93,626089,80.72318205260443,8
0.2,7756,92,626181,80.72463581281423,10
0.2,7757,94,626275,80.72634699664862,7
0.2,7758,93,626368,80.72792885681145,8
0.2,7759,90,626458,80.72912371134021,11
0.2,7760,92,626550,80.73057595670662,10
0.2,7761,91,626641,80.73189899510436,12
0.2,7762,92,626733,80.7333505088239,9
0.2,7763,96,626829,80.7353168469861,6
0.2,7764,92,626921,80.73676754668384,9
0.2,7765,23,626944,80.72933298995622,9
0.2,7766,95,627039,80.73117033603708,6
0.2,7767,92,627131,80.7326210092688,9
0.2,7768,95,627226,80.73445745913244,6
0.2,7769,91,627317,80.73577863577863,10
0.2,7770,89,627406,80.73684210526316,12
0.2,7771,92,627498,80.73829130211014,10
0.2,7772,22,627520,80.73073459410782,11
0.2,7773,93,627613,80.73231283766401,8
0.2,7774,94,627707,80.7340192926045,7
0.2,7775,91,627798,80.73533950617283,10
0.2,7776,85,627883,80.73588787450174,16
0.2,7777,96,627979,80.73785034713293,6
0.2,7778,91,628070,80.7391695590693,10
0.2,7779,86,628156,80.73984575835476,15
0.2,7780,96,628252,80.74180696568564,6
0.2,7781,90,628342,80.74299665895657,12
0.2,7782,93,628435,80.74457150199152,8
0.2,7783,96,628531,80.74653134635149,7
0.2,7784,16,628547,80.73821451509313,17
0.2,7785,95,628642,80.74004623683534,6
0.2,7786,95,628737,80.74187748812123,7
0.2,7787,95,628832,80.743708269132,6
0.2,7788,93,628925,80.7452818076775,8
0.2,7789,92,629017,80.74672657252889,10
0.2,7790,94,629111,80.74842767295597,7
0.2,7791,93,629204,80.75,8
0.2,7792,19,629223,80.74207622225074,14
0.2,7793,91,629314,80.74339235309212,10
0.2,7794,83,629397,80.74368184733804,18
0.2,7795,93,629490,80.74525397639815,8
0.2,7796,84,629574,80.74567141208156,17
0.2,7797,94,629668,80.74737112080021,7
0.2,7798,96,629764,80.74932683677395,6
0.2,7799,94,629858,80.75102564102563,8
0.2,7800,94,629952,80.75272400974234,7
0.2,7801,92,630044,80.75416559856447,9
0.2,7802,91,630135,80.75547866205305,10
0.2,7803,94,630229,80.75717580727832,7
0.2,7804,89,630318,80.75823190262652,13
0.2,7805,94,630412,80.75992826031258,7
0.2,7806,92,630504,80.76136800307417,10
0.2,7807,91,630595,80.76267930327869,10
0.2,7808,84,630679,80.76309386605199,17
0.2,7809,94,630773,80.76478873239436,7
0.2,7810,94,630867,80.76648316476764,8
0.2,7811,88,630955,80.76740911418331,13
0.2,7812,94,631049,80.76910277742225,7
0.2,7813,88,631137,80.77002815459431,13
0.2,7814,92,631229,80.77146513115802,9
0.2,7815,89,631318,80.77251791197544,13
0.2,7816,94,631412,80.77421005500831,7
0.2,7817,90,631502,80.77539012535175,11
0.2,7818,94,631596,80.77708146821844,7
0.2,7819,93,631689,80.77864450127878,8
0.2,7820,88,631777,80.77956783020075,13
0.2,7821,92,631869,80.78100230120174,9
0.2,7822,27,631896,80.7741275725425,6
0.2,7823,91,631987,80.7754345603272,10
0.2,7824,94,632081,80.77712460063898,7
0.2,7825,88,632169,80.77804753386148,13
0.2,7826,96,632265,80.77999233422767,6
0.2,7827,93,632358,80.78155339805825,8
0.2,7828,90,632448,80.7827308723975,12
0.2,7829,27,632475,80.77586206896552,6
0.2,7830,92,632567,80.77729536457669,11
0.2,7831,87,632654,80.77808988764045,14
0.2,7832,94,632748,80.77977786288778,7
0.2,7833,94,632842,80.78146540719939,7
0.2,7834,91,632933,80.78276962348437,10
0.2,7835,86,633019,80.78343542623787,17
0.2,7836,92,633111,80.78486665816001,9
0.2,7837,91,633202,80.78616994131156,10
0.2,7838,93,633295,80.787728026534,8
0.2,7839,95,633390,80.78954081632654,6
0.2,7840,93,633483,80.79109807422523,8
0.2,7841,89,633572,80.79214486100484,12
0.2,7842,96,633668,80.7940838964682,6
0.2,7843,91,633759,80.79538500764916,10
0.2,7844,94,633853,80.79706819630337,7
0.2,7845,91,633944,80.79836859546266,11
0.2,7846,95,634039,80.80017841213203,6
0.2,7847,86,634125,80.80084097859327,15
0.2,7848,94,634219,80.80252261434578,7
0.2,7849,89,634308,80.80356687898089,12
0.2,7850,94,634402,80.8052477391415,7
0.2,7851,92,634494,80.80667345899134,10
0.2,7852,90,634584,80.80784413599898,11
0.2,7853,95,634679,80.80965113318055,7
0.2,7854,95,634774,80.81145767027371,6
0.2,7855,94,634868,80.81313645621181,7
0.2,7856,93,634961,80.81468753977344,10
0.2,7857,94,635055,80.81636548740137,7
0.2,7858,-55,635000,80.7990838529075,19
0.2,7859,96,635096,80.80101781170484,7
0.2,7860,89,635185,80.80206080651317,12
0.2,7861,94,635279,80.8037395064869,7
0.2,7862,25,635304,80.7966425028615,8
0.2,7863,91,635395,80.79793997965412,11
0.2,7864,92,635487,80.79936427209155,10
0.2,7865,89,635576,80.80040681413679,13
0.2,7866,93,635669,80.80195754417186,8
0.2,7867,95,635764,80.80376207422471,6
0.2,7868,94,635858,80.80543906468421,7
0.2,7869,92,635950,80.80686149936467,9
0.2,7870,86,636036,80.80752128065049,15
0.2,7871,91,636127,80.80881605691057,11
0.2,7872,94,636221,80.81049155341039,8
0.2,7873,91,636312,80.81178562357125,10
0.2,7874,90,636402,80.81295238095238,11
0.2,7875,85,636487,80.81348400203149,16
0.2,7876,88,636575,80.8143963437857,13
0.2,7877,90,636665,80.81556232546332,12
0.2,7878,95,636760,80.8173626094682,6
0.2,7879,91,636851,80.81865482233502,10
0.2,7880,25,636876,80.8115721355158,8
0.2,7881,84,636960,80.81197665567115,17
0.2,7882,92,637052,80.81339591526068,9
0.2,7883,92,637144,80.81481481481481,10
0.2,7884,91,637235,80.81610653138871,10
0.2,7885,93,637328,80.8176515343647,8
0.2,7886,94,637422,80.81932293647775,8
0.2,7887,91,637513,80.82061359026369,10
0.2,7888,91,637604,80.82190391684624,10
0.2,7889,96,637700,80.82382762991128,6
0.2,7890,89,637789,80.82486376885059,12
0.2,7891,91,637880,80.82615306639634,11
0.2,7892,22,637902,80.81870011402509,10
0.2,7893,94,637996,80.82036990119077,7
0.2,7894,88,638084,80.82127929069031,14
0.2,7895,94,638178,80.82294832826747,7
0.2,7896,90,638268,80.82411042167912,11
0.2,7897,94,638362,80.82577867814636,7
0.2,7898,93,638455,80.82731991391316,9
0.2,7899,93,638548,80.82886075949367,8
0.2,7900,96,638644,80.83078091380838,6
0.2,7901,24,638668,80.82358896481904,10
0.2,7902,94,638762,80.8252562318107,7
0.2,7903,92,638854,80.82667004048584,9
0.2,7904,94,638948,80.82833649588868,7
0.2,7905,90,639038,80.82949658487225,11
0.2,7906,92,639130,80.83090932085494,10
0.2,7907,93,639223,80.83244815376834,8
0.2,7908,94,639317,80.83411303578202,7
0.2,7909,95,639412,80.83590391908976,6
0.2,7910,94,639506,80.83756794336999,7
0.2,7911,89,639595,80.83859959555106,13
0.2,7912,94,639689,80.84026285858714,7
0.2,7913,95,639784,80.84205205964115,6
0.2,7914,91,639875,80.84333543903979,10
0.2,7915,92,639967,80.84474482061647,9
0.2,7916,94,640061,80.84640646709612,7
0.2,7917,91,640152,80.84768881030563,10
0.2,7918,88,640240,80.84859199393863,13
0.2,7919,87,640327,80.84936868686869,15
0.2,7920,96,640423,80.85128140386315,6
0.2,7921,93,640516,80.85281494572078,8
0.2,7922,95,640611,80.85460053010223,6
0.2,7923,19,640630,80.84679454820798,13
0.2,7924,89,640719,80.84782334384857,12
0.2,7925,94,640813,80.84948271511482,8
0.2,7926,91,640904,80.85076321433077,10
0.2,7927,89,640993,80.85179112008073,12
0.2,7928,95,641088,80.85357548240636,6
0.2,7929,94,641182,80.85523329129886,8
0.2,7930,94,641276,80.8568906821334,7
0.2,7931,96,641372,80.85879979828543,6
0.2,7932,92,641464,80.86020421026093,10
0.2,7933,94,641558,80.86186034786992,7
0.2,7934,95,641653,80.86364209199748,6
0.2,7935,92,641745,80.86504536290323,9
0.2,7936,91,641836,80.86632228801814,10
0.2,7937,94,641930,80.86797682035777,7
0.2,7938,92,642022,80.86937901498929,9
0.2,7939,93,642115,80.87090680100755,8
0.2,7940,92,642207,80.87230827351719,9
0.2,7941,93,642300,80.87383530596827,8
0.2,7942,96,642396,80.87573964497041,6
0.2,7943,95,642491,80.87751762336354,6
0.2,7944,93,642584,80.87904342353681,8
0.2,7945,92,642676,80.88044299018374,10
0.2,7946,92,642768,80.8818422046055,9
0.2,7947,94,642862,80.88349270256668,7
0.2,7948,85,642947,80.88401056736697,16
0.2,7949,87,643034,80.88477987421383,14
0.2,7950,94,643128,80.8864293799522,8
0.2,7951,94,643222,80.88807847082495,7
0.2,7952,88,643310,80.88897271469885,13
0.2,7953,88,643398,80.88986673371889,13
0.2,7954,92,643490,80.89126335637964,9
0.2,7955,87,643577,80.89203117144294,14
0.2,7956,95,643672,80.89380419756189,6
0.2,7957,90,643762,80.89494847951747,11
0.2,7958,94,643856,80.89659504962935,7
0.2,7959,92,643948,80.89798994974875,10
0.2,7960,91,644039,80.89925888707448,10
0.2,7961,93,644132,80.9007786988194,8
0.2,7962,85,644217,80.9012934823559,16
0.2,7963,93,644310,80.9028126569563,9
0.2,7964,91,644401,80.90408035153798,10
0.2,7965,94,644495,80.90572432839568,7
0.2,7966,94,644589,80.90736789255679,7
0.2,7967,95,644684,80.90913654618474,6
0.2,7968,93,644777,80.91065378341072,8
0.2,7969,92,644869,80.9120451693852,9
0.2,7970,96,644965,80.91393802534186,6
0.2,7971,94,645059,80.91557952834923,8
0.2,7972,90,645149,80.91671892637652,11
0.2,7973,22,645171,80.90933032355154,11
0.2,7974,95,645266,80.91109717868339,6
0.2,7975,93,645359,80.91261283851554,9
0.2,7976,21,645380,80.90510216873511,11
0.2,7977,89,645469,80.90611682125846,12
0.2,7978,27,645496,80.89936082215816,7
0.2,7979,95,645591,80.90112781954888,6
0.2,7980,91,645682,80.90239318381155,10
0.2,7981,88,645770,80.90328238536708,14
0.2,7982,91,645861,80.90454716272077,11
0.2,7983,87,645948,80.90531062124248,14
0.2,7984,88,646036,80.90619912335629,14
0.2,7985,95,646131,80.90796393688956,6
0.2,7986,90,646221,80.90910229122323,12
0.2,7987,88,646309,80.90998998497747,13
0.2,7988,93,646402,80.91150331706096,8
0.2,7989,86,646488,80.91214017521902,15
0.2,7990,91,646579,80.91340257790014,10
0.2,7991,95,646674,80.91516516516516,6
0.2,7992,94,646768,80.91680220192669,7
0.2,7993,93,646861,80.91831373530148,8
0.2,7994,90,646951,80.91944965603503,11
0.2,7995,93,647044,80.92096048024013,10
0.2,7996,95,647139,80.92272102038264,7
0.2,7997,93,647232,80.92423105776444,8
0.2,7998,92,647324,80.92561570196274,9
0.2,7999,93,647417,80.927125,8
0.2,8000,93,647510,80.9286339207599,8
0.2,8001,94,647604,80.93026743314171,8
0.2,8002,91,647695,80.9315256778708,10
0.2,8003,24,647719,80.9244127936032,9
0.2,8004,82,647801,80.92454715802623,19
0.2,8005,19,647820,80.91681239070697,13
0.2,8006,93,647913,80.91832146871488,8
0.2,8007,92,648005,80.9197052947053,9
0.2,8008,91,648096,80.92096391559495,11
0.2,8009,92,648188,80.92234706616729,9
0.2,8010,-48,648140,80.90625390088628,12
0.2,8011,92,648232,80.90763854218672,9
0.2,8012,24,648256,80.90053662797953,9
0.2,8013,92,648348,80.90192163713502,9
0.2,8014,93,648441,80.90343106674985,9
0.2,8015,96,648537,80.90531437125749,6
0.2,8016,95,648632,80.90707247099913,6
0.2,8017,94,648726,80.90870541282115,8
0.2,8018,27,648753,80.90198279087168,6
0.2,8019,88,648841,80.90286783042394,13
0.2,8020,90,648931,80.90400199476375,11
0.2,8021,83,649014,80.90426327599103,19
0.2,8022,96,649110,80.90614483360339,6
0.2,8023,87,649197,80.90690428713859,14
0.2,8024,23,649220,80.89968847352024,10
0.2,8025,86,649306,80.90032394717169,16
0.2,8026,92,649398,80.90170673975334,9
0.2,8027,92,649490,80.90308918784255,10
0.2,8028,94,649584,80.90472038859136,7
0.2,8029,96,649680,80.906600249066,6
0.2,8030,90,649770,80.90773253642136,11
0.2,8031,88,649858,80.9086155378486,13
0.2,8032,92,649950,80.9099962654052,9
0.2,8033,94,650044,80.91162559123724,8
0.2,8034,96,650140,80.91350342252645,6
0.2,8035,95,650235,80.91525634644101,7
0.2,8036,93,650328,80.91675998506905,8
0.2,8037,96,650424,80.9186364767355,6
0.2,8038,91,650515,80.91989053364847,10
0.2,8039,91,650606,80.92114427860696,10
0.2,8040,89,650695,80.92214898644447,13
0.2,8041,27,650722,80.91544391942303,6
0.2,8042,89,650811,80.91644908616188,12
0.2,8043,92,650903,80.91782695176529,10
0.2,8044,25,650928,80.91087632069609,7
0.2,8045,96,651024,80.91275167785236,6
0.2,8046,93,651117,80.91425375916491,9
0.2,8047,95,651212,80.91600397614314,6
0.2,8048,89,651301,80.9170083240154,12
0.2,8049,94,651395,80.91863354037267,7
0.2,8050,85,651480,80.91914047944354,16
0.2,8051,93,651573,80.92064083457527,9
0.2,8052,92,651665,80.92201663976158,9
0.2,8053,25,651690,80.9150732555252,8
0.2,8054,95,651785,80.91682184978275,6
0.2,8055,92,651877,80.91819761668322,11
0.2,8056,95,651972,80.91994538910264,6
0.2,8057,88,652060,80.92082402581286,13
0.2,8058,91,652151,80.92207469909418,10
0.2,8059,95,652246,80.92382133995038,6
0.2,8060,94,652340,80.9254434933631,7
0.2,8061,94,652434,80.92706524435624,7
0.2,8062,91,652525,80.92831452313035,11
0.2,8063,91,652616,80.9295634920635,10
0.2,8064,-59,652557,80.91221326720397,22
0.2,8065,94,652651,80.91383585420283,7
0.2,8066,26,652677,80.90702863518037,6
0.2,8067,90,652767,80.90815567674764,11
0.2,8068,90,652857,80.90928243896394,11
0.2,8069,94,652951,80.91090458488227,7
0.2,8070,93,653044,80.91240242844752,8
0.2,8071,95,653139,80.91414767096134,6
0.2,8072,91,653230,80.91539700235353,11
0.2,8073,91,653321,80.91664602427545,10
0.2,8074,95,653416,80.91839009287926,6
0.2,8075,94,653510,80.920009905894,7
0.2,8076,96,653606,80.92187693450539,6
0.2,8077,94,653700,80.9234959148304,7
0.2,8078,92,653792,80.9248669389776,11
0.2,8079,89,653881,80.92586633663366,12
0.2,8080,90,653971,80.92698923400569,12
0.2,8081,88,654059,80.92786439000247,13
0.2,8082,96,654155,80.9297290609922,6
0.2,8083,94,654249,80.931345868382,7
0.2,8084,18,654267,80.92356215213358,16
0.2,8085,94,654361,80.92517932228543,7
0.2,8086,94,654455,80.92679609249413,7
0.2,8087,92,654547,80.92816518298714,9
0.2,8088,93,654640,80.9296575596489,8
0.2,8089,92,654732,80.9310259579728,9
0.2,8090,91,654823,80.93227042392782,10
0.2,8091,93,654916,80.93376173999012,8
0.2,8092,94,655010,80.93537625108118,8
0.2,8093,92,655102,80.93674326661724,9
0.2,8094,91,655193,80.93798641136505,10
0.2,8095,91,655284,80.93922924901186,10
0.2,8096,95,655379,80.9409657897987,6
0.2,8097,94,655473,80.94257841442331,8
0.2,8098,95,655568,80.94431411285343,7
0.2,8099,93,655661,80.9458024691358,9
0.2,8100,94,655755,80.94741389951858,7
0.2,8101,94,655849,80.94902493211552,8
0.2,8102,93,655942,80.9505121559916,8
0.2,8103,91,656033,80.95175222112537,11
0.2,8104,92,656125,80.95311536088835,10
0.2,8105,94,656219,80.9547248951394,7
0.2,8106,96,656315,80.95658073270013,6
0.2,8107,85,656400,80.9570794277257,16
0.2,8108,95,656495,80.95881119743495,6
0.2,8109,92,656587,80.96017262638718,9
0.2,8110,94,656681,80.96178029836025,7
0.2,8111,94,656775,80.9633875739645,7
0.2,8112,94,656869,80.96499445334648,8
0.2,8113,92,656961,80.96635444910032,9
0.2,8114,91,657052,80.9675908810844,11
0.2,8115,94,657146,80.96919664859537,8
0.2,8116,92,657238,80.97055562399902,9
0.2,8117,90,657328,80.97166789849717,11
0.2,8118,96,657424,80.97351890626925,6
0.2,8119,90,657514,80.97463054187192,11
0.2,8120,94,657608,80.97623445388498,7
0.2,8121,95,657703,80.97796109332677,7
0.2,8122,89,657792,80.97894866428659,12
0.2,8123,15,657807,80.97082717872969,18
0.2,8124,93,657900,80.9723076923077,8
0.2,8125,95,657995,80.97403396505045,6
0.2,8126,91,658086,80.97526762643042,10
0.2,8127,25,658111,80.96838090551181,8
0.2,8128,96,658207,80.9702300405954,6
0.2,8129,94,658301,80.97183271832718,8
0.2,8130,94,658395,80.97343500184479,8
0.2,8131,94,658489,80.97503689129366,7
0.2,8132,96,658585,80.97688429853683,6
0.2,8133,89,658674,80.97787066633883,12
0.2,8134,87,658761,80.97861094038107,14
0.2,8135,92,658853,80.97996558505407,9
0.2,8136,96,658949,80.98181147843185,6
0.2,8137,96,659045,80.98365691816171,6
0.2,8138,91,659136,80.98488757832658,10
0.2,8139,91,659227,80.98611793611794,11
0.2,8140,93,659320,80.98759366171232,8
0.2,8141,92,659412,80.98894620486367,9
0.2,8142,94,659506,80.99054402554341,7
0.2,8143,27,659533,80.98391453831042,6
0.2,8144,92,659625,80.9852670349908,9
0.2,8145,95,659720,80.98698747851707,6
0.2,8146,95,659815,80.98870749969313,6
0.2,8147,89,659904,80.98969072164948,12
0.2,8148,93,659997,80.99116456006873,8
0.2,8149,79,660076,80.99092024539877,22
0.2,8150,22,660098,80.98368298368298,11
0.2,8151,96,660194,80.98552502453386,6
0.2,8152,88,660282,80.98638537961486,13
0.2,8153,94,660376,80.98798135884229,8
0.2,8154,94,660470,80.98957694665849,7
0.2,8155,91,660561,80.9908043158411,12
0.2,8156,84,660645,80.99117322545054,18
0.2,8157,92,660737,80.99252267712674,9
0.2,8158,93,660830,80.99399436205417,8
0.2,8159,92,660922,80.9953431372549,9
0.2,8160,18,660940,80.98762406567822,14
0.2,8161,93,661033,80.98909580985053,8
0.2,8162,94,661127,80.99068969741516,7
0.2,8163,27,661154,80.98407643312102,6
0.2,8164,92,661246,80.98542559706063,9
0.2,8165,93,661339,80.98689688954201,8
0.2,8166,86,661425,80.98751071384841,15
0.2,8167,93,661518,80.98898139079334,9
0.2,8168,91,661609,80.99020687966703,10
0.2,8169,91,661700,80.99143206854345,10
0.2,8170,94,661794,80.9930241096561,8
0.2,8171,91,661885,80.99424865394029,10
0.2,8172,92,661977,80.9955952526612,11
0.2,8173,15,661992,80.98752140934671,17
0.2,8174,92,662084,80.98886850152905,9
0.2,8175,95,662179,80.99058219178082,6
0.2,8176,91,662270,80.99180628592393,10
0.2,8177,92,662362,80.99315235999022,9
0.2,8178,92,662454,80.9944981049028,9
0.2,8179,92,662546,80.9958435207824,9
0.2,8180,92,662638,80.99718860774966,10
0.2,8181,92,662730,80.9985333659252,9
0.2,8182,93,662823,81.0,8
0.2,8183,91,662914,81.00122189638319,10
0.2,8184,96,663010,81.00305436774588,6
0.2,8185,94,663104,81.00464207182995,7
0.2,8186,92,663196,81.00598509832662,9
0.2,8187,91,663287,81.0072056668295,10
0.2,8188,96,663383,81.00903651239467,6
0.2,8189,23,663406,81.0019536019536,10
0.2,8190,94,663500,81.00354047124893,7
0.2,8191,94,663594,81.005126953125,8
0.2,8192,92,663686,81.00646893689735,9
0.2,8193,94,663780,81.00805467415182,8
0.2,8194,94,663874,81.00964002440513,7
0.2,8195,94,663968,81.01122498779893,7
0.2,8196,19,663987,81.00365987556422,13
0.2,8197,90,664077,81.00475725786777,11
0.2,8198,91,664168,81.00597633857788,10
0.2,8199,92,664260,81.00731707317073,9
0.2,8200,90,664350,81.00841360809657,11
0.2,8201,89,664439,81.00938795415752,12
0.2,8202,94,664533,81.01097159575765,7
0.2,8203,90,664623,81.01206728425159,11
0.2,8204,21,664644,81.00475319926873,11
0.2,8205,95,664739,81.00645868876433,6
0.2,8206,90,664829,81.00755452662361,11
0.2,8207,93,664922,81.0090155945419,8
0.2,8208,95,665017,81.0107199415276,6
0.2,8209,92,665109,81.01205846528623,9
0.2,8210,88,665197,81.01290951163074,14
0.2,8211,95,665292,81.01461276181199,6
0.2,8212,25,665317,81.00779252404725,8
0.2,8213,93,665410,81.00925249573898,8
0.2,8214,88,665498,81.01010346926354,13
0.2,8215,95,665593,81.01180623174294,6
0.2,8216,92,665685,81.013143483023,9
0.2,8217,93,665778,81.01460209296665,8
0.2,8218,92,665870,81.01593867867138,9
0.2,8219,25,665895,81.00912408759125,8
0.2,8220,93,665988,81.01058265417832,8
0.2,8221,94,666082,81.01216249087813,7
0.2,8222,93,666175,81.01362033321172,9
0.2,8223,80,666255,81.01349708171206,23
0.2,8224,93,666348,81.01495440729484,8
0.2,8225,90,666438,81.01604668125456,11
0.2,8226,92,666530,81.0173817916616,9
0.2,8227,91,666621,81.01859504132231,10
0.2,8228,94,666715,81.02017256045693,7
0.2,8229,92,666807,81.02150668286755,9
0.2,8230,22,666829,81.0143360466529,10
0.2,8231,93,666922,81.01579203109816,8
0.2,8232,81,667003,81.01579011296003,20
0.2,8233,91,667094,81.01700267184843,10
0.2,8234,26,667120,81.01032179720704,7
0.2,8235,92,667212,81.01165614375911,9
0.2,8236,95,667307,81.01335437659343,6
0.2,8237,87,667394,81.01408108764264,14
0.2,8238,94,667488,81.01565723995631,7
0.2,8239,27,667515,81.00910194174757,6
0.2,8240,94,667609,81.01067831573837,7
0.2,8241,96,667705,81.01249696675565,6
0.2,8242,95,667800,81.01419386145821,6
0.2,8243,96,667896,81.0160116448326,6
0.2,8244,93,667989,81.01746513038205,8
0.2,8245,95,668084,81.0191608052389,8
0.2,8246,87,668171,81.01988601915848,14
0.2,8247,96,668267,81.02170223084384,6
0.2,8248,88,668355,81.02254818765911,13
0.2,8249,91,668446,81.02375757575757,10
0.2,8250,22,668468,81.01660404799418,11
0.2,8251,94,668562,81.0181774115366,8
0.2,8252,92,668654,81.01950805767599,10
0.2,8253,94,668748,81.0210806881512,7
0.2,8254,93,668841,81.02253179890975,8
0.2,8255,26,668867,81.01586724806202,6
0.2,8256,95,668962,81.01756085745428,6
0.2,8257,86,669048,81.01816420440785,15
0.2,8258,89,669137,81.01913064535658,12
0.2,8259,96,669233,81.02094430992736,6
0.2,8260,19,669252,81.01343662994795,14
0.2,8261,85,669337,81.01391914790608,16
0.2,8262,93,669430,81.01536972044052,8
0.2,8263,94,669524,81.01694094869313,7
0.2,8264,94,669618,81.01851179673321,7
0.2,8265,96,669714,81.02032421969514,6
0.2,8266,95,669809,81.02201524132091,6
0.2,8267,93,669902,81.02346395742622,8
0.2,8268,90,669992,81.02454952231226,11
0.2,8269,94,670086,81.0261185006046,8
0.2,8270,91,670177,81.02732438641036,11
0.2,8271,95,670272,81.02901353965184,6
0.2,8272,92,670364,81.03033965913211,10
0.2,8273,96,670460,81.0321489001692,6
0.2,8274,95,670555,81.03383685800604,6
0.2,8275,90,670645,81.03492025132914,11
0.2,8276,25,670670,81.02815029600097,7
0.2,8277,91,670761,81.02935491664654,10
0.2,8278,95,670856,81.0310423964247,6
0.2,8279,95,670951,81.03272946859903,6
0.2,8280,94,671045,81.03429537495471,7
0.2,8281,84,671129,81.03465346534654,17
0.2,8282,90,671219,81.03573584450079,11
0.2,8283,95,671314,81.0374215354901,6
0.2,8284,90,671404,81.03850331925166,12
0.2,8285,95,671499,81.04018826937002,6
0.2,8286,95,671594,81.04187281283939,6
0.2,8287,94,671688,81.04343629343629,7
0.2,8288,91,671779,81.04463747134757,12
0.2,8289,25,671804,81.037876960193,7
0.2,8290,95,671899,81.03956096972621,6
0.2,8291,90,671989,81.04064158224794,11
0.2,8292,94,672083,81.04220426866031,7
0.2,8293,86,672169,81.04280202556065,15
0.2,8294,93,672262,81.0442435201929,8
0.2,8295,96,672358,81.0460462873674,6
0.2,8296,92,672450,81.04736651801856,9
0.2,8297,92,672542,81.04868643046517,9
0.2,8298,95,672637,81.05036751415834,6
0.2,8299,96,672733,81.05216867469879,6
0.2,8300,92,672825,81.0534875316227,10
0.2,8301,88,672913,81.05432425921465,13
0.2,8302,93,673006,81.05576297723714,8
0.2,8303,94,673100,81.0573217726397,8
0.2,8304,96,673196,81.05912101143889,6
0.2,8305,96,673292,81.06091981699976,6
0.2,8306,96,673388,81.06271818947876,6
0.2,8307,88,673476,81.06355320173327,13
0.2,8308,95,673571,81.0652304729811,6
0.2,8309,92,673663,81.06654632972322,11
0.2,8310,90,673753,81.06762122488269,11
0.2,8311,94,673847,81.069177093359,7
0.2,8312,90,673937,81.07025141344882,11
0.2,8313,92,674029,81.07156603319702,9
0.2,8314,93,674122,81.07300060132292,8
0.2,8315,94,674216,81.07455507455508,7
0.2,8316,95,674311,81.0762294096429,6
0.2,8317,90,674401,81.07730223611445,11
0.2,8318,96,674497,81.07909604519774,6
0.2,8319,92,674589,81.08040865384615,9
0.2,8320,96,674685,81.08220165845451,6
0.2,8321,91,674776,81.08339341504445,10
0.2,8322,91,674867,81.08458488525773,10
0.2,8323,88,674955,81.08541566554541,13
0.2,8324,93,675048,81.08684684684685,9
0.2,8325,93,675141,81.08827768436224,8
0.2,8326,91,675232,81.08946799567671,10
0.2,8327,92,675324,81.0907780979827,9
0.2,8328,89,675413,81.09172769840318,12
0.2,8329,95,675508,81.09339735894358,8
0.2,8330,93,675601,81.09482655143441,8
0.2,8331,91,675692,81.09601536245799,10
0.2,8332,92,675784,81.09732389295571,9
0.2,8333,92,675876,81.09863210943125,9
0.2,8334,96,675972,81.10041991601679,6
0.2,8335,96,676068,81.10220729366603,6
0.2,8336,93,676161,81.10363440086363,9
0.2,8337,90,676251,81.10470136723436,11
0.2,8338,87,676338,81.1054083223408,14
0.2,8339,93,676431,81.1068345323741,8
0.2,8340,92,676523,81.10814051073012,9
0.2,8341,92,676615,81.10944617597698,9
0.2,8342,87,676702,81.11015222342083,14
0.2,8343,89,676791,81.11109779482263,14
0.2,8344,87,676878,81.1118034751348,15
0.2,8345,20,676898,81.10448118859334,12
0.2,8346,93,676991,81.10590631364562,8
0.2,8347,95,677086,81.10757067561093,6
0.2,8348,92,677178,81.1088753144089,9
0.2,8349,94,677272,81.11041916167665,7
0.2,8350,89,677361,81.11136390851395,12
0.2,8351,95,677456,81.11302681992338,6
0.2,8352,95,677551,81.11468933317371,6
0.2,8353,94,677645,81.11623174527173,7
0.2,8354,90,677735,81.11729503291443,11
0.2,8355,94,677829,81.11883676400191,7
0.2,8356,94,677923,81.12037812612182,7
0.2,8357,86,678009,81.12096195262025,15
0.2,8358,96,678105,81.12274195477929,6
0.2,8359,88,678193,81.12356459330144,13
0.2,8360,94,678287,81.12510465255352,7
0.2,8361,94,678381,81.12664434345851,9
0.2,8362,92,678473,81.12794451751763,9
0.2,8363,92,678565,81.1292443806791,9
0.2,8364,96,678661,81.13102211595935,6
0.2,8365,94,678755,81.13256036337557,7
0.2,8366,94,678849,81.13409824309788,7
0.2,8367,93,678942,81.13551625239006,8
0.2,8368,94,679036,81.13705341139921,7
0.2,8369,95,679131,81.13870967741936,6
0.2,8370,94,679225,81.14024608768366,9
0.2,8371,94,679319,81.14178213091256,7
0.2,8372,92,679411,81.1430789442255,9
0.2,8373,95,679506,81.14473369954621,7
0.2,8374,95,679601,81.1463880597015,6
0.2,8375,81,679682,81.146370582617,20
0.2,8376,20,679702,81.1390712665632,13
0.2,8377,90,679792,81.1401289090475,11
0.2,8378,96,679888,81.14190237498508,6
0.2,8379,95,679983,81.14355608591886,7
0.2,8380,92,680075,81.14485144970767,9
0.2,8381,91,680166,81.14602720114532,11
0.2,8382,95,680261,81.14767982822379,7
0.2,8383,96,680357,81.14945133587786,6
0.2,8384,94,680451,81.15098389982111,7
0.2,8385,90,680541,81.15203911280706,11
0.2,8386,93,680634,81.15345177059736,9
0.2,8387,89,680723,81.15438721983786,12
0.2,8388,91,680814,81.15556085349863,11
0.2,8389,90,680904,81.15661501787842,11
0.2,8390,93,680997,81.15802645691812,8
0.2,8391,95,681092,81.15967588179218,6
0.2,8392,94,681186,81.16120576671035,8
0.2,8393,96,681282,81.16297355253752,6
0.2,8394,95,681377,81.1646217986897,7
0.2,8395,84,681461,81.16495950452597,17
0.2,8396,91,681552,81.16613076098606,10
0.2,8397,90,681642,81.16718266253869,11
0.2,8398,92,681734,81.16847243719491,9
0.2,8399,94,681828,81.17,8
0.2,8400,93,681921,81.17140816569456,8
0.2,8401,94,682015,81.1729350154725,7
0.2,8402,95,682110,81.1745805069618,6
0.2,8403,94,682204,81.1761066158972,7
0.2,8404,91,682295,81.1772754312909,10
0.2,8405,27,682322,81.17083035926719,7
0.2,8406,92,682414,81.17211847270131,9
0.2,8407,85,682499,81.17257373929591,16
0.2,8408,94,682593,81.1740991794506,8
0.2,8409,88,682681,81.17491082045184,15
0.2,8410,92,682773,81.17619783616692,10
0.2,8411,26,682799,81.16963861150737,7
0.2,8412,92,682891,81.17092594793772,9
0.2,8413,92,682983,81.17221297836939,10
0.2,8414,89,683072,81.17314319667261,12
0.2,8415,94,683166,81.17466730038022,8
0.2,8416,94,683260,81.17619104193894,7
0.2,8417,90,683350,81.17723924922784,11
0.2,8418,92,683442,81.17852476541157,9
0.2,8419,95,683537,81.18016627078384,6
0.2,8420,91,683628,81.1813323833274,10
0.2,8421,96,683724,81.18309190216101,6
0.2,8422,20,683744,81.17582808975425,12
0.2,8423,92,683836,81.17711301044635,9
0.2,8424,92,683928,81.17839762611275,10
0.2,8425,93,684021,81.17980061713743,8
0.2,8426,93,684114,81.1812032751869,8
0.2,8427,93,684207,81.18260560037969,9
0.2,8428,94,684301,81.18412623086962,7
0.2,8429,96,684397,81.1858837485172,6
0.2,8430,96,684493,81.18764084924683,6
0.2,8431,93,684586,81.18904174573055,9
0.2,8432,91,684677,81.19020514644848,10
0.2,8433,87,684764,81.19089400047427,14
0.2,8434,91,684855,81.19205690574985,10
0.2,8435,94,684949,81.19357515410147,7
0.2,8436,14,684963,81.18561099917032,20
0.2,8437,91,685054,81.18677411708936,10
0.2,8438,93,685147,81.18817395425998,8
0.2,8439,91,685238,81.189336492891,11
0.2,8440,91,685329,81.19049875607156,10
0.2,8441,89,685418,81.19142383321488,12
0.2,8442,95,685513,81.19305933909747,7
0.2,8443,85,685598,81.19351018474657,16
0.2,8444,-56,685542,81.1772646536412,20
0.2,8445,91,685633,81.17842765806299,10
0.2,8446,87,685720,81.1791168462176,16
0.2,8447,91,685811,81.18027935606061,10
0.2,8448,94,685905,81.1817966623269,7
0.2,8449,96,686001,81.18355029585798,6
0.2,8450,95,686096,81.18518518518519,7
0.2,8451,85,686181,81.18563653573119,16
0.2,8452,92,686273,81.18691588785046,9
0.2,8453,94,686367,81.18843151171043,7
0.2,8454,88,686455,81.1892371377883,14
0.2,8455,86,686541,81.18980605487228,15
0.2,8456,90,686631,81.1908478183753,12
0.2,8457,83,686714,81.1910617167179,19
0.2,8458,92,686806,81.19233952003783,10
0.2,8459,92,686898,81.1936170212766,9
0.2,8460,94,686992,81.19513059921995,8
0.2,8461,92,687084,81.19640746868353,11
0.2,8462,92,687176,81.19768403639371,9
0.2,8463,94,687270,81.19919659735349,8
0.2,8464,94,687364,81.20070880094507,7
0.2,8465,93,687457,81.20210252775809,9
0.2,8466,92,687549,81.20337781977088,9
0.2,8467,94,687643,81.20488899385923,7
0.2,8468,92,687735,81.20616365568544,9
0.2,8469,93,687828,81.20755608028335,8
0.2,8470,93,687921,81.20894817613032,8
0.2,8471,95,688016,81.21057601510859,6
0.2,8472,93,688109,81.21196742594122,8
0.2,8473,93,688202,81.21335850837858,8
0.2,8474,94,688296,81.21486725663716,7
0.2,8475,17,688313,81.20729117508259,15
0.2,8476,93,688406,81.20868231685738,8
0.2,8477,84,688490,81.20901155933004,18
0.2,8478,93,688583,81.21040217006723,8
0.2,8479,92,688675,81.21167452830188,10
0.2,8480,85,688760,81.21212121212122,16
0.2,8481,88,688848,81.21292148078284,13
0.2,8482,96,688944,81.21466462336437,8
0.2,8483,88,689032,81.21546440358321,13
0.2,8484,96,689128,81.21720683559222,6
0.2,8485,94,689222,81.21871317464058,8
0.2,8486,96,689318,81.22045481324379,6
0.2,8487,92,689410,81.22172478793591,9
0.2,8488,90,689500,81.22275886441277,11
0.2,8489,91,689591,81.22391048292108,10
0.2,8490,91,689682,81.22506183017312,10
0.2,8491,93,689775,81.22644842204427,8
0.2,8492,93,689868,81.22783468738962,8
0.2,8493,95,689963,81.2294560866494,7
0.2,8494,94,690057,81.23095938787522,7
0.2,8495,22,690079,81.22398775894538,11
0.2,8496,94,690173,81.2254913498882,7
0.2,8497,23,690196,81.21863967992469,10
0.2,8498,94,690290,81.22014354629957,7
0.2,8499,95,690385,81.22176470588235,7
0.2,8500,96,690481,81.22350311728032,6
0.2,8501,95,690576,81.22512350035286,6
0.2,8502,95,690671,81.2267435022933,6
0.2,8503,96,690767,81.22848071495767,6
0.2,8504,93,690860,81.22986478542035,8
0.2,8505,91,690951,81.23101340230426,10
0.2,8506,22,690973,81.22405078170918,12
0.2,8507,94,691067,81.22555242125058,8
0.2,8508,95,691162,81.22717123046186,7
0.2,8509,85,691247,81.22761457109283,16
0.2,8510,86,691333,81.22817530254964,15
0.2,8511,94,691427,81.2296757518797,7
0.2,8512,88,691515,81.23047104428521,13
0.2,8513,88,691603,81.2312661498708,13
0.2,8514,94,691697,81.23276570757487,7
0.2,8515,94,691791,81.23426491310474,8
0.2,8516,92,691883,81.23552894211576,9
0.2,8517,93,691976,81.23691007278704,8
0.2,8518,95,692071,81.2385256485503,6
0.2,8519,90,692161,81.23955399061033,11
0.2,8520,89,692250,81.24046473418613,12
0.2,8521,94,692344,81.24196198075569,7
0.2,8522,27,692371,81.23559779420391,6
0.2,8523,96,692467,81.23732989206945,7
0.2,8524,93,692560,81.23870967741935,9
0.2,8525,94,692654,81.24020642739855,8
0.2,8526,94,692748,81.24170282631641,7
0.2,8527,94,692842,81.24319887429644,7
0.2,8528,94,692936,81.24469457146208,8
0.2,8529,92,693028,81.24595545134818,9
0.2,8530,23,693051,81.23912788653148,9
0.2,8531,86,693137,81.23968588842007,15
0.2,8532,96,693233,81.24141568030001,6
0.2,8533,90,693323,81.24244199671901,11
0.2,8534,89,693412,81.24335090802577,13
0.2,8535,92,693504,81.24461105904405,9
0.2,8536,94,693598,81.24610518917653,8
0.2,8537,93,693691,81.24748184586554,8
0.2,8538,92,693783,81.24874107038295,9
0.2,8539,92,693875,81.25,9
0.2,8540,86,693961,81.2505561409671,15
0.2,8541,-128,693833,81.22605947084992,23
0.2,8542,92,693925,81.22732061336767,9
0.2,8543,19,693944,81.22003745318352,14
0.2,8544,94,694038,81.22153306026917,8
0.2,8545,93,694131,81.22291130353382,9
0.2,8546,88,694219,81.22370422370422,13
0.2,8547,95,694314,81.22531586335985,6
0.2,8548,93,694407,81.22669318048895,8
0.2,8549,96,694503,81.22842105263157,6
0.2,8550,96,694599,81.23014852064087,7
0.2,8551,84,694683,81.230472404116,17
0.2,8552,90,694773,81.2314977200982,11
0.2,8553,92,694865,81.23275660509704,9
0.2,8554,93,694958,81.23413208649913,8
0.2,8555,96,695054,81.23585787751286,7
0.2,8556,87,695141,81.23653149468272,14
0.2,8557,94,695235,81.23802290254733,7
0.2,8558,-53,695182,81.2223390583012,16
0.2,8559,87,695269,81.22301401869159,14
0.2,8560,93,695362,81.22438967410349,8
0.2,8561,94,695456,81.22588180331698,7
0.2,8562,92,695548,81.22714002102067,9
0.2,8563,96,695644,81.2288650163475,6
0.2,8564,95,695739,81.23047285464098,7
0.2,8565,93,695832,81.23184683632968,8
0.2,8566,93,695925,81.23322049725692,8
0.2,8567,89,696014,81.23412698412699,12
0.2,8568,94,696108,81.23561675808146,7
0.2,8569,19,696127,81.22835472578763,14
0.2,8570,93,696220,81.22972815307432,8
0.2,8571,96,696316,81.23145123658423,6
0.2,8572,94,696410,81.23294062755161,7
0.2,8573,94,696504,81.23442967109867,7
0.2,8574,96,696600,81.23615160349854,6
0.2,8575,91,696691,81.2372901119403,10
0.2,8576,94,696785,81.23877812755043,7
0.2,8577,93,696878,81.24014921893215,8
0.2,8578,94,696972,81.24163655437697,7
0.2,8579,94,697066,81.24312354312355,7
0.2,8580,93,697159,81.24449364875889,8
0.2,8581,91,697250,81.24563038918667,10
0.2,8582,93,697343,81.24699988349062,8
0.2,8583,93,697436,81.24836905871389,8
0.2,8584,94,697530,81.24985439720443,7
0.2,8585,95,697625,81.2514558583741,6
0.2,8586,95,697720,81.2530569465471,7
0.2,8587,90,697810,81.25407545412203,12
0.2,8588,93,697903,81.25544300849924,8
0.2,8589,95,697998,81.2570430733411,6
0.2,8590,90,698088,81.25806076126179,12
0.2,8591,20,698108,81.25093109869646,12
0.2,8592,95,698203,81.25253112998952,6
0.2,8593,92,698295,81.25378170816849,9
0.2,8594,94,698389,81.25526468877254,7
0.2,8595,95,698484,81.25686365751513,6
0.2,8596,93,698577,81.25822961498197,8
0.2,8597,95,698672,81.2598278669458,6
0.2,8598,93,698765,81.26119316199558,9
0.2,8599,95,698860,81.26279069767442,7
0.2,8600,94,698954,81.26427159632601,7
0.2,8601,93,699047,81.26563589862823,8
0.2,8602,94,699141,81.26711612228293,7
0.2,8603,88,699229,81.26789865178986,13
0.2,8604,94,699323,81.26937826844858,8
0.2,8605,96,699419,81.27108993725308,6
0.2,8606,96,699515,81.27280120831881,6
0.2,8607,94,699609,81.27427973977696,7
0.2,8608,94,699703,81.27575792775004,7
0.2,8609,94,699797,81.27723577235773,7
0.2,8610,95,699892,81.27882940425037,6
0.2,8611,92,699984,81.28007431490943,10
0.2,8612,92,700076,81.28131893649135,9
0.2,8613,94,700170,81.28279544926863,7
0.2,8614,94,700264,81.28427161926872,7
0.2,8615,94,700358,81.28574744661096,8
0.2,8616,89,700447,81.28664268306835,12
0.2,8617,95,700542,81.28823392898585,7
0.2,8618,91,700633,81.28936071470008,11
0.2,8619,86,700719,81.28990719257541,15
0.2,8620,84,700803,81.29022155202412,17
0.2,8621,90,700893,81.29123173277662,12
0.2,8622,92,700985,81.29247361707063,9
0.2,8623,93,701078,81.29383116883118,8
0.2,8624,92,701170,81.29507246376812,9
0.2,8625,93,701263,81.29642939948991,8
0.2,8626,27,701290,81.29013562072564,6
0.2,8627,94,701384,81.29160871580899,7
0.2,8628,92,701476,81.29284969289604,10
0.2,8629,92,701568,81.29409038238703,9
0.2,8630,92,701660,81.29533078438187,10
0.2,8631,93,701753,81.29668674698796,8
0.2,8632,94,701847,81.29815823004749,7
0.2,8633,94,701941,81.29962937224924,7
0.2,8634,91,702032,81.30075275043428,11
0.2,8635,94,702126,81.30222325150532,7
0.2,8636,94,702220,81.30369341206438,7
0.2,8637,90,702310,81.30470016207455,11
0.2,8638,87,702397,81.30535941659915,15
0.2,8639,94,702491,81.3068287037037,7
0.2,8640,95,702586,81.30841337808124,6
0.2,8641,94,702680,81.30988197176579,7
0.2,8642,88,702768,81.3106560222145,13
0.2,8643,95,702863,81.31223970384082,6
0.2,8644,92,702955,81.31347599768652,10
0.2,8645,89,703044,81.31436502428869,12
0.2,8646,94,703138,81.31583208049034,7
0.2,8647,85,703223,81.31625809435708,16
0.2,8648,94,703317,81.31772459243844,7
0.2,8649,95,703412,81.3193063583815,7
0.2,8650,93,703505,81.32065657149462,9
0.2,8651,92,703597,81.32189089227924,9
0.2,8652,96,703693,81.32358719519242,6
0.2,8653,95,703788,81.32516755257684,6
0.2,8654,25,703813,81.31865973425765,7
0.2,8655,95,703908,81.32024029574862,6
0.2,8656,25,703933,81.31373455007508,8
0.2,8657,94,704027,81.31519981519982,7
0.2,8658,95,704122,81.31678022866382,7
0.2,8659,94,704216,81.31824480369515,7
0.2,8660,21,704237,81.31128045260363,11
0.2,8661,89,704326,81.31216809051027,12
0.2,8662,95,704421,81.3137481242064,6
0.2,8663,92,704513,81.31498153277931,10
0.2,8664,-46,704467,81.30028851702251,9
0.2,8665,95,704562,81.30186937456727,6
0.2,8666,93,704655,81.30321910695743,8
0.2,8667,96,704751,81.30491462851869,6
0.2,8668,94,704845,81.30637905179375,8
0.2,8669,95,704940,81.30795847750865,6
0.2,8670,89,705029,81.3088455772114,12
0.2,8671,92,705121,81.31007841328413,9
0.2,8672,94,705215,81.31154156577885,7
0.2,8673,20,705235,81.3044731381139,12
0.2,8674,84,705319,81.30478386167147,17
0.2,8675,93,705412,81.30613185799908,8
0.2,8676,94,705506,81.30759479082633,7
0.2,8677,20,705526,81.30053007605439,12
0.2,8678,95,705621,81.30210853784999,6
0.2,8679,94,705715,81.30357142857143,7
0.2,8680,95,705810,81.30514917636216,6
0.2,8681,92,705902,81.30638101819858,9
0.2,8682,94,705996,81.30784291143614,7
0.2,8683,27,706023,81.30158912943344,6
0.2,8684,92,706115,81.3028209556707,9
0.2,8685,93,706208,81.30416762606494,8
0.2,8686,94,706302,81.30562910095546,7
0.2,8687,93,706395,81.30697513812154,8
0.2,8688,26,706421,81.30060996662446,7
0.2,8689,94,706515,81.30207134637514,7
0.2,8690,93,706608,81.30341732827063,8
0.2,8691,93,706701,81.3047630004602,10
0.2,8692,94,706795,81.30622339813644,7
0.2,8693,95,706890,81.30779848171153,6
0.2,8694,90,706980,81.308798159862,11
0.2,8695,96,707076,81.31048758049678,6
0.2,8696,89,707165,81.31137173738071,12
0.2,8697,95,707260,81.31294550471372,6
0.2,8698,93,707353,81.31428899873549,9
0.2,8699,94,707447,81.31574712643678,8
0.2,8700,25,707472,81.30927479600047,8
0.2,8701,92,707564,81.31050333256722,9
0.2,8702,94,707658,81.31196139262323,7
0.2,8703,88,707746,81.31272977941177,13
0.2,8704,88,707834,81.31349798966112,14
0.2,8705,95,707929,81.31507006662072,6
0.2,8706,92,708021,81.31629723211209,9
0.2,8707,93,708114,81.31763895268719,8
0.2,8708,93,708207,81.31898036513951,8
0.2,8709,90,708297,81.31997703788748,11
0.2,8710,90,708387,81.32097348180461,11
0.2,8711,95,708482,81.32254361799816,6
0.2,8712,90,708572,81.32353953862045,11
0.2,8713,94,708666,81.32499426210696,9
0.2,8714,94,708760,81.32644865174986,7
0.2,8715,93,708853,81.32778797613584,8
0.2,8716,95,708948,81.32935642996443,7
0.2,8717,96,709044,81.331039229181,6
0.2,8718,24,709068,81.32446381465765,8
0.2,8719,-56,709012,81.30871559633027,20
0.2,8720,93,709105,81.31005618621718,9
0.2,8721,92,709197,81.31128181609722,9
0.2,8722,93,709290,81.31262180442508,8
0.2,8723,94,709384,81.31407611187528,7
0.2,8724,91,709475,81.31518624641834,12
0.2,8725,93,709568,81.31652532661013,9
0.2,8726,88,709656,81.31729116534892,14
0.2,8727,94,709750,81.31874427131072,7
0.2,8728,94,709844,81.32019704433498,7
0.2,8729,94,709938,81.32164948453608,7
0.2,8730,89,710027,81.32252891994044,12
0.2,8731,93,710120,81.32386623912048,8
0.2,8732,95,710215,81.3254322684072,7
0.2,8733,91,710306,81.32653995878177,11
0.2,8734,94,710400,81.32799084144247,7
0.2,8735,91,710491,81.32909798534799,11
0.2,8736,90,710581,81.33009042005266,12
0.2,8737,93,710674,81.33142595559625,8
0.2,8738,85,710759,81.33184574894153,17
0.2,8739,93,710852,81.33318077803203,8
0.2,8740,92,710944,81.33440109827251,9
0.2,8741,94,711038,81.33584991992679,7
0.2,8742,94,711132,81.33729841015669,9
0.2,8743,83,711215,81.33748856358646,18
0.2,8744,94,711309,81.33893653516294,7
0.2,8745,96,711405,81.3406128515893,6
0.2,8746,91,711496,81.3417171601692,11
0.2,8747,94,711590,81.34316415180612,7
0.2,8748,93,711683,81.34449651388731,9
0.2,8749,92,711775,81.34571428571428,9
0.2,8750,86,711861,81.3462461432979,15
0.2,8751,95,711956,81.34780621572212,6
0.2,8752,94,712050,81.34925168513652,7
0.2,8753,93,712143,81.35058259081563,9
0.2,8754,96,712239,81.35225585379783,6
0.2,8755,95,712334,81.35381452718136,6
0.2,8756,91,712425,81.35491606714628,10
0.2,8757,92,712517,81.35613153688057,10
0.2,8758,92,712609,81.35734672907866,9
0.2,8759,93,712702,81.35867579908675,8
0.2,8760,84,712786,81.35897728569797,17
0.2,8761,91,712877,81.36007760785209,10
0.2,8762,93,712970,81.36140591121762,8
0.2,8763,93,713063,81.36273391145596,8
0.2,8764,95,713158,81.36428978893326,6
0.2,8765,95,713253,81.36584531143053,6
0.2,8766,88,713341,81.36660203034106,13
0.2,8767,25,713366,81.36017335766424,7
0.2,8768,87,713453,81.36081651271525,14
0.2,8769,96,713549,81.36248574686431,6
0.2,8770,93,713642,81.36381256413179,10
0.2,8771,92,713734,81.36502507979937,9
0.2,8772,91,713825,81.36612333295338,10
0.2,8773,88,713913,81.36687941645772,14
0.2,8774,92,714005,81.36809116809117,10
0.2,8775,96,714101,81.36975843208751,6
0.2,8776,90,714191,81.37074171129088,11
0.2,8777,92,714283,81.37195260879471,10
0.2,8778,93,714376,81.37327713862626,8
0.2,8779,96,714472,81.3749430523918,6
0.2,8780,26,714498,81.36863682951828,7
0.2,8781,94,714592,81.37007515372352,8
0.2,8782,90,714682,81.37105772515086,11
0.2,8783,91,714773,81.37215391621129,10
0.2,8784,93,714866,81.37347751849744,8
0.2,8785,93,714959,81.37480081948554,8
0.2,8786,95,715054,81.37635142824627,7
0.2,8787,86,715140,81.37687756030951,15
0.2,8788,27,715167,81.3706906360223,6
0.2,8789,22,715189,81.36393629124005,11
0.2,8790,92,715281,81.36514617222159,9
0.2,8791,92,715373,81.36635577797998,9
0.2,8792,90,715463,81.3673376549528,11
0.2,8793,93,715556,81.36866045030703,8
0.2,8794,93,715649,81.36998294485502,8
0.2,8795,92,715741,81.3711914506594,10
0.2,8796,21,715762,81.36432874843696,15
0.2,8797,94,715856,81.36576494657876,7
0.2,8798,94,715950,81.36720081827481,8
0.2,8799,95,716045,81.36875,6
0.2,8800,96,716141,81.37041245313033,6
0.2,8801,87,716228,81.37105203362871,16
0.2,8802,95,716323,81.3726002499148,6
0.2,8803,92,716415,81.37380736029078,9
0.2,8804,91,716506,81.3749006246451,10
0.2,8805,95,716601,81.37644787644787,6
0.2,8806,91,716692,81.37754059271035,10
0.2,8807,-44,716648,81.36330608537693,8
0.2,8808,94,716742,81.36474060619821,8
0.2,8809,94,716836,81.36617480136209,7
0.2,8810,89,716925,81.36704119850187,12
0.2,8811,94,717019,81.36847480708126,7
0.2,8812,92,717111,81.36968115284239,9
0.2,8813,94,717205,81.37111413660087,7
0.2,8814,93,717298,81.3724333522405,8
0.2,8815,91,717389,81.37352540834846,10
0.2,8816,89,717478,81.37439038221618,12
0.2,8817,89,717567,81.3752551599002,12
0.2,8818,90,717657,81.37623313300828,12
0.2,8819,90,717747,81.37721088435374,12
0.2,8820,89,717836,81.37807504818048,12
0.2,8821,13,717849,81.37032418952619,19
0.2,8822,94,717943,81.37175563867166,7
0.2,8823,94,718037,81.37318676337262,7
0.2,8824,88,718125,81.37393767705383,13
0.2,8825,94,718219,81.37536823022887,7
0.2,8826,24,718243,81.3688682451569,9
0.2,8827,91,718334,81.36995922066153,10
0.2,8828,25,718359,81.36357458375807,8
0.2,8829,92,718451,81.36477916194791,9
0.2,8830,90,718541,81.3657569924131,11
0.2,8831,85,718626,81.36616847826087,16
0.2,8832,86,718712,81.36669308275783,16
0.2,8833,93,718805,81.36800996151234,8
0.2,8834,94,718899,81.36943972835314,8
0.2,8835,93,718992,81.37075599818922,8
0.2,8836,95,719087,81.37229829127531,6
0.2,8837,92,719179,81.37350079203439,9
0.2,8838,93,719272,81.37481615567371,8
0.2,8839,27,719299,81.36866515837104,6
0.2,8840,95,719394,81.37020699015949,7
0.2,8841,86,719480,81.37073060393575,16
0.2,8842,95,719575,81.37227185344341,6
0.2,8843,96,719671,81.37392582541837,6
0.2,8844,92,719763,81.37512719050311,9
0.2,8845,95,719858,81.37666742030297,6
0.2,8846,12,719870,81.36882559059568,20
0.2,8847,91,719961,81.36991410488245,10
0.2,8848,94,720055,81.37134139450785,7
0.2,8849,90,720145,81.37231638418079,11
0.2,8850,26,720171,81.36606033216586,6
0.2,8851,90,720261,81.3670356981473,11
0.2,8852,92,720353,81.36823675590196,9
0.2,8853,94,720447,81.36966342895866,7
0.2,8854,90,720537,81.37063805759458,11
0.2,8855,94,720631,81.37206413730804,7
0.2,8856,92,720723,81.37326408490459,10
0.2,8857,92,720815,81.37446376157146,9
0.2,8858,91,720906,81.37555028784287,10
0.2,8859,93,720999,81.37686230248308,8
0.2,8860,84,721083,81.37715833427379,17
0.2,8861,91,721174,81.37824418867073,10
0.2,8862,94,721268,81.3796682838768,8
0.2,8863,94,721362,81.38109205776173,7
0.2,8864,27,721389,81.37495769881556,6
0.2,8865,92,721481,81.37615610196255,10
0.2,8866,90,721571,81.37712867937296,12
0.2,8867,95,721666,81.3786648624267,7
0.2,8868,93,721759,81.37997519449769,8
0.2,8869,82,721841,81.38004509582863,19
0.2,8870,92,721933,81.38124225002818,9
0.2,8871,92,722025,81.38243913435528,9
0.2,8872,88,722113,81.38318494308577,13
0.2,8873,96,722209,81.38483209375704,6
0.2,8874,91,722300,81.38591549295775,10
0.2,8875,88,722388,81.38666065795404,14
0.2,8876,94,722482,81.38808155908528,8
0.2,8877,89,722571,81.38893895021401,12
0.2,8878,95,722666,81.39047189998874,8
0.2,8879,92,722758,81.39166666666667,9
0.2,8880,93,722851,81.39297376421574,8
0.2,8881,93,722944,81.39428056743976,8
0.2,8882,90,723034,81.39524935269615,12
0.2,8883,94,723128,81.39666816749212,7
0.2,8884,94,723222,81.39808666291502,7
0.2,8885,91,723313,81.39916722934954,11
0.2,8886,27,723340,81.39304602227973,6
0.2,8887,94,723434,81.39446444644464,8
0.2,8888,92,723526,81.39565755428058,9
0.2,8889,92,723618,81.39685039370079,9
0.2,8890,94,723712,81.39826791137105,8
0.2,8891,89,723801,81.39912280701755,12
0.2,8892,95,723896,81.40065219835826,7
0.2,8893,90,723986,81.4016190690353,11
0.2,8894,92,724078,81.40281056773468,9
0.2,8895,92,724170,81.40400179856115,9
0.2,8896,95,724265,81.40552995391705,7
0.2,8897,91,724356,81.40660822656777,10
0.2,8898,91,724447,81.4076862568828,10
0.2,8899,-47,724400,81.3932584269663,10
0.2,8900,23,724423,81.38669812380631,10
0.2,8901,90,724513,81.38766569310268,11
0.2,8902,92,724605,81.38885768841963,9
0.2,8903,94,724699,81.39027403414195,7
0.2,8904,95,724794,81.39180235822572,7
0.2,8905,95,724889,81.39333033909723,6
0.2,8906,92,724981,81.39452116313012,10
0.2,8907,95,725076,81.39604849573418,7
0.2,8908,95,725171,81.39757548546413,7
0.2,8909,93,725264,81.39887766554433,9
0.2,8910,90,725354,81.39984289080911,11
0.2,8911,96,725450,81.40148114901257,6
0.2,8912,91,725541,81.40255806125883,10
0.2,8913,94,725635,81.40397128113081,7
0.2,8914,92,725727,81.4051598429613,10
0.2,8915,94,725821,81.40657245401525,8
0.2,8916,94,725915,81.40798474823372,8
0.2,8917,96,726011,81.40962099125365,6
0.2,8918,91,726102,81.41069626639758,10
0.2,8919,-44,726058,81.39663677130045,8
0.2,8920,94,726152,81.39804954601502,7
0.2,8921,89,726241,81.3989015915714,12
0.2,8922,93,726334,81.40020172587695,8
0.2,8923,23,726357,81.39365755266697,10
0.2,8924,87,726444,81.39428571428572,15
0.2,8925,95,726539,81.39580999327806,7
0.2,8926,91,726630,81.39688585190994,10
0.2,8927,94,726724,81.39829749103943,8
0.2,8928,94,726818,81.39970881397693,7
0.2,8929,94,726912,81.40111982082867,7
0.2,8930,94,727006,81.40253051170082,7
0.2,8931,82,727088,81.40259740259741,19
0.2,8932,18,727106,81.39549983208329,14
0.2,8933,94,727200,81.39691067830759,7
0.2,8934,94,727294,81.39832120872971,7
0.2,8935,96,727390,81.39995523724261,6
0.2,8936,94,727484,81.4013651113349,7
0.2,8937,93,727577,81.40266278809577,8
0.2,8938,93,727670,81.40396017451617,9
0.2,8939,94,727764,81.40536912751678,8
0.2,8940,91,727855,81.40644223241249,10
0.2,8941,22,727877,81.39979870275106,10
0.2,8942,93,727970,81.4010958291401,8
0.2,8943,94,728064,81.40250447227191,7
0.2,8944,95,728159,81.40402459474566,7
0.2,8945,92,728251,81.40520903196959,9
0.2,8946,88,728339,81.40594612719347,13
0.2,8947,25,728364,81.39964237818506,8
0.2,8948,93,728457,81.4009386523634,8
0.2,8949,94,728551,81.40234636871509,7
0.2,8950,93,728644,81.40364205116747,8
0.2,8951,94,728738,81.4050491510277,7
0.2,8952,90,728828,81.40600915894113,11
0.2,8953,88,728916,81.40674558856377,13
0.2,8954,89,729005,81.40759352317141,12
0.2,8955,84,729089,81.40788298347476,17
0.2,8956,91,729180,81.40895389081166,11
0.2,8957,94,729274,81.41035945523555,7
0.2,8958,96,729370,81.41198794508315,6
0.2,8959,95,729465,81.41350446428571,6
0.2,8960,89,729554,81.41435107688874,12
0.2,8961,94,729648,81.41575541173844,7
0.2,8962,93,729741,81.41704786343858,9
0.2,8963,94,729835,81.41845158411424,7
0.2,8964,94,729929,81.41985499163414,9
0.2,8965,87,730016,81.42047735891144,14
0.2,8966,89,730105,81.42132262741163,12
0.2,8967,92,730197,81.42250223015165,9
0.2,8968,93,730290,81.42379306500168,8
0.2,8969,94,730384,81.42519509476031,7
0.2,8970,94,730478,81.42659681194962,7
0.2,8971,92,730570,81.42777530093625,9
0.2,8972,94,730664,81.42917641814331,7
0.2,8973,94,730758,81.43057722308892,8
0.2,8974,82,730840,81.43064066852368,19
0.2,8975,94,730934,81.43204099821747,7
0.2,8976,96,731030,81.43366380750808,6
0.2,8977,92,731122,81.43484072176432,9
0.2,8978,87,731209,81.43546051898875,14
0.2,8979,26,731235,81.4292873051225,7
0.2,8980,92,731327,81.43046431355083,9
0.2,8981,93,731420,81.43175239367625,8
0.2,8982,91,731511,81.43281754425026,10
0.2,8983,94,731605,81.43421638468388,7
0.2,8984,92,731697,81.43539232053422,9
0.2,8985,90,731787,81.43634542621857,11
0.2,8986,96,731883,81.43796595081785,6
0.2,8987,89,731972,81.43880729862039,12
0.2,8988,93,732065,81.440093447547,8
0.2,8989,-117,731948,81.41802002224694,12
0.2,8990,94,732042,81.41941941941941,8
0.2,8991,91,732133,81.42048487544484,10
0.2,8992,92,732225,81.42166129211608,9
0.2,8993,94,732319,81.42305981765621,7
0.2,8994,92,732411,81.4242356864925,9
0.2,8995,92,732503,81.4254112939084,10
0.2,8996,88,732591,81.42614204734912,13
0.2,8997,95,732686,81.42765058901978,6
0.2,8998,96,732782,81.42926991887988,6
0.2,8999,95,732877,81.43077777777778,6
0.2,9000,93,732970,81.43206310409954,8
0.2,9001,96,733066,81.43368140413241,6
0.2,9002,92,733158,81.43485504831723,10
0.2,9003,89,733247,81.43569524655709,12
0.2,9004,96,733343,81.43731260410883,6
0.2,9005,92,733435,81.43848545414168,9
0.2,9006,93,733528,81.43976906850227,8
0.2,9007,92,733620,81.44094138543517,9
0.2,9008,94,733714,81.44233544233545,8
0.2,9009,91,733805,81.44339622641509,10
0.2,9010,94,733899,81.44478970147597,7
0.2,9011,90,733989,81.44573901464713,11
0.2,9012,93,734082,81.44702096971042,8
0.2,9013,91,734173,81.44808076325715,11
0.2,9014,93,734266,81.44936217415419,8
0.2,9015,93,734359,81.45064330079857,8
0.2,9016,91,734450,81.4517023400244,11
0.2,9017,96,734546,81.45331559104014,6
0.2,9018,94,734640,81.45470673023617,7
0.2,9019,91,734731,81.45576496674057,11
0.2,9020,94,734825,81.4571555259949,7
0.2,9021,94,734919,81.45854577698958,7
0.2,9022,-54,734865,81.44353319295135,17
0.2,9023,93,734958,81.44481382978724,8
0.2,9024,92,735050,81.44598337950139,10
0.2,9025,90,735140,81.4469310879681,13
0.2,9026,94,735234,81.44832170156198,7
0.2,9027,89,735323,81.44915817456801,13
0.2,9028,92,735415,81.45032672499723,9
0.2,9029,94,735509,81.45171650055372,7
0.2,9030,95,735604,81.45321669804008,6
0.2,9031,95,735699,81.45471656333038,8
0.2,9032,96,735795,81.456326801727,7
0.2,9033,94,735889,81.457715297764,8
0.2,9034,88,735977,81.45843940232429,13
0.2,9035,94,736071,81.45982735723771,7
0.2,9036,92,736163,81.4609936925971,9
0.2,9037,93,736256,81.46227041380837,9
0.2,9038,95,736351,81.46376811594203,6
0.2,9039,25,736376,81.45752212389381,8
0.2,9040,94,736470,81.4589094126756,7
0.2,9041,27,736497,81.45288652952887,6
0.2,9042,91,736588,81.45394227579344,10
0.2,9043,93,736681,81.45521892967713,12
0.2,9044,95,736776,81.45671641791044,6
0.2,9045,85,736861,81.45710811408357,16
0.2,9046,94,736955,81.45849452857301,7
0.2,9047,94,737049,81.45988063660478,7
0.2,9048,96,737145,81.46148745717758,6
0.2,9049,90,737235,81.46243093922652,11
0.2,9050,94,737329,81.46381615291128,7
0.2,9051,93,737422,81.46509058771542,8
0.2,9052,93,737515,81.46636474096985,8
0.2,9053,93,737608,81.46763861276784,9
0.2,9054,96,737704,81.4692435118719,6
0.2,9055,94,737798,81.47062720848056,7
0.2,9056,92,737890,81.47178977586397,10
0.2,9057,23,737913,81.46533451092957,10
0.2,9058,92,738005,81.46649740589469,9
0.2,9059,95,738100,81.46799116997792,6
0.2,9060,95,738195,81.46948460434831,7
0.2,9061,95,738290,81.47097770911499,6
0.2,9062,92,738382,81.47213946816727,10
0.2,9063,93,738475,81.47341129744042,9
0.2,9064,93,738568,81.47468284611142,9
0.2,9065,94,738662,81.47606441650122,7
0.2,9066,-50,738612,81.46156391309142,14
0.2,9067,93,738705,81.46283634759594,8
0.2,9068,94,738799,81.46421876722903,8
0.2,9069,93,738892,81.46549062844542,9
0.2,9070,24,738916,81.45915555065594,9
0.2,9071,93,739009,81.46042768959435,9
0.2,9072,93,739102,81.46169954810978,9
0.2,9073,95,739197,81.46319153625744,6
0.2,9074,88,739285,81.46391184573002,13
0.2,9075,96,739381,81.46551344204495,6
0.2,9076,94,739475,81.46689434835298,7
0.2,9077,88,739563,81.4676140118969,13
0.2,9078,94,739657,81.46899438264126,8
0.2,9079,95,739752,81.4704845814978,6
0.2,9080,95,739847,81.47197445215285,7
0.2,9081,94,739941,81.47335388680908,7
0.2,9082,92,740033,81.47451282615876,9
0.2,9083,88,740121,81.47523117569352,13
0.2,9084,93,740214,81.47649972482114,8
0.2,9085,92,740306,81.47765793528505,9
0.2,9086,95,740401,81.4791460327941,6
0.2,9087,93,740494,81.48041373239437,9
0.2,9088,12,740506,81.47276928154912,20
0.2,9089,89,740595,81.47359735973598,12
0.2,9090,90,740685,81.47453525464745,11
0.2,9091,90,740775,81.47547294324681,12
0.2,9092,25,740800,81.46926206972397,8
0.2,9093,96,740896,81.47085990763141,6
0.2,9094,89,740985,81.47168774051677,12
0.2,9095,91,741076,81.47273526824978,10
0.2,9096,92,741168,81.47389249203034,9
0.2,9097,93,741261,81.47515937568697,8
0.2,9098,90,741351,81.47609627431586,11
0.2,9099,85,741436,81.47648351648351,16
0.2,9100,91,741527,81.47752994176464,10
0.2,9101,89,741616,81.47835640518568,13
0.2,9102,90,741706,81.47929254092058,11
0.2,9103,95,741801,81.48077768014059,6
0.2,9104,96,741897,81.48237232289951,6
0.2,9105,23,741920,81.47594992312762,10
0.2,9106,95,742015,81.47743494015593,6
0.2,9107,94,742109,81.4788098375055,7
0.2,9108,94,742203,81.48018443297838,7
0.2,9109,91,742294,81.48122941822173,10
0.2,9110,93,742387,81.48249368894743,8
0.2,9111,92,742479,81.48364793678665,10
0.2,9112,95,742574,81.48513113135081,6
0.2,9113,96,742670,81.48672372174676,6
0.2,9114,93,742763,81.48798683488755,8
0.2,9115,90,742853,81.4889205792014,11
0.2,9116,91,742944,81.48996380388286,10
0.2,9117,94,743038,81.49133581925861,7
0.2,9118,88,743126,81.49204956683847,13
0.2,9119,91,743217,81.49309210526316,10
0.2,9120,95,743312,81.49457296349084,7
0.2,9121,22,743334,81.48805086603815,10
0.2,9122,96,743430,81.48964156527458,6
0.2,9123,93,743523,81.49090311266988,8
0.2,9124,86,743609,81.49139726027397,16
0.2,9125,93,743702,81.49265833881219,8
0.2,9126,91,743793,81.4937000109565,10
0.2,9127,93,743886,81.49496056091148,8
0.2,9128,93,743979,81.4962208347026,8
0.2,9129,93,744072,81.49748083242059,8
0.2,9130,93,744165,81.49874055415617,8
0.2,9131,93,744258,81.5,9
0.2,9132,92,744350,81.50114967699551,9
0.2,9133,86,744436,81.50164221589665,15
0.2,9134,89,744525,81.50246305418719,13
0.2,9135,92,744617,81.50361208406305,9
0.2,9136,95,744712,81.50508919776732,6
0.2,9137,95,744807,81.50656598818122,7
0.2,9138,86,744893,81.5070576649524,16
0.2,9139,89,744982,81.50787746170678,12
0.2,9140,93,745075,81.50913466797944,8
0.2,9141,94,745169,81.5105009844673,7
0.2,9142,94,745263,81.51186700207809,7
0.2,9143,17,745280,81.50481189851268,15
0.2,9144,23,745303,81.49841443411701,9
0.2,9145,19,745322,81.49158101902471,13
0.2,9146,89,745411,81.49240188039795,13
0.2,9147,94,745505,81.49376912986445,7
0.2,9148,90,745595,81.4946988741939,11
0.2,9149,94,745689,81.4960655737705,7
0.2,9150,89,745778,81.49688558627473,13
0.2,9151,91,745869,81.49792395104895,11
0.2,9152,94,745963,81.4992898503223,7
0.2,9153,96,746059,81.50087393489186,6
0.2,9154,27,746086,81.49492080830147,8
0.2,9155,93,746179,81.49617737003058,8
0.2,9156,93,746272,81.49743365731135,8
0.2,9157,95,746367,81.49890805852806,6
0.2,9158,92,746459,81.50005459111257,9
0.2,9159,20,746479,81.49334061135372,12
0.2,9160,92,746571,81.49448750136447,9
0.2,9161,94,746665,81.49585243396638,7
0.2,9162,96,746761,81.49743533777148,6
0.2,9163,96,746857,81.49901789611523,7
0.2,9164,92,746949,81.50016366612111,9
0.2,9165,95,747044,81.50163648265328,6
0.2,9166,92,747136,81.50278171702847,9
0.2,9167,25,747161,81.49661867364748,8
0.2,9168,93,747254,81.49787326862253,8
0.2,9169,93,747347,81.49912758996729,10
0.2,9170,91,747438,81.50016355904482,13
0.2,9171,95,747533,81.50163541212386,6
0.2,9172,92,747625,81.50277989752534,9
0.2,9173,25,747650,81.49662088511009,7
0.2,9174,92,747742,81.49776566757494,9
0.2,9175,91,747833,81.49880122057542,10
0.2,9176,91,747924,81.49983654789146,10
0.2,9177,95,748019,81.50130747439529,6
0.2,9178,92,748111,81.50245124741257,9
0.2,9179,88,748199,81.50315904139434,14
0.2,9180,94,748293,81.50452020477073,7
0.2,9181,94,748387,81.50588107166195,7
0.2,9182,94,748481,81.50724164216487,9
0.2,9183,93,748574,81.50849303135888,8
0.2,9184,96,748670,81.5100707675558,7
0.2,9185,94,748764,81.51143043762247,7
0.2,9186,96,748860,81.51300751061282,6
0.2,9187,90,748950,81.51393121462777,11
0.2,9188,95,749045,81.51539884644684,6
0.2,9189,93,749138,81.51664853101197,8
0.2,9190,93,749231,81.51789794364052,8
0.2,9191,93,749324,81.51914708442123,8
0.2,9192,94,749418,81.5205047318612,7
0.2,9193,93,749511,81.5217533173809,8
0.2,9194,92,749603,81.52289287656335,9
0.2,9195,90,749693,81.52381470204436,11
0.2,9196,90,749783,81.52473632706317,11
0.2,9197,92,749875,81.52587519025874,9
0.2,9198,95,749970,81.52733992825307,6
0.2,9199,92,750062,81.52847826086956,9
0.2,9200,25,750087,81.52233452885555,7
0.2,9201,91,750178,81.5233644859813,11
0.2,9202,92,750270,81.52450287949581,9
0.2,9203,94,750364,81.5258583224685,7
0.2,9204,87,750451,81.52645301466595,14
0.2,9205,25,750476,81.52031283945253,8
0.2,9206,93,750569,81.52155968285001,9
0.2,9207,96,750665,81.52313205907906,6
0.2,9208,88,750753,81.52383537843414,13
0.2,9209,93,750846,81.52508143322476,9
0.2,9210,92,750938,81.5262186516122,10
0.2,9211,92,751030,81.5273556231003,9
0.2,9212,92,751122,81.52849234776946,9
0.2,9213,89,751211,81.52930323420881,12
0.2,9214,93,751304,81.53054801953337,11
0.2,9215,89,751393,81.53135850694444,14
0.2,9216,94,751487,81.53271129434741,7
0.2,9217,89,751576,81.53352137123021,12
0.2,9218,26,751602,81.52749755938822,6
0.2,9219,95,751697,81.52895878524946,6
0.2,9220,85,751782,81.52933521310054,16
0.2,9221,91,751873,81.53036217740187,11
0.2,9222,94,751967,81.53171419277892,7
0.2,9223,96,752063,81.5332827406765,6
0.2,9224,92,752155,81.53441734417345,9
0.2,9225,95,752250,81.53587686971602,6
0.2,9226,90,752340,81.5367941909613,11
0.2,9227,87,752427,81.53738621586476,15
0.2,9228,90,752517,81.53830317477517,11
0.2,9229,90,752607,81.53921993499458,12
0.2,9230,91,752698,81.54024482721265,10
0.2,9231,87,752785,81.54083622183708,14
0.2,9232,96,752881,81.5424022527889,6
0.2,9233,87,752968,81.54299328568334,15
0.2,9234,96,753064,81.54455874390904,6
0.2,9235,92,753156,81.54569077522737,10
0.2,9236,93,753249,81.54693082169536,8
0.2,9237,22,753271,81.54048495345313,10
0.2,9238,93,753364,81.54172529494534,8
0.2,9239,94,753458,81.54307359307359,8
0.2,9240,92,753550,81.54420517260037,9
0.2,9241,95,753645,81.54566111231335,7
0.2,9242,92,753737,81.54679216704533,9
0.2,9243,94,753831,81.5481393336218,7
0.2,9244,93,753924,81.54937804218497,8
0.2,9245,95,754019,81.55083279255895,6
0.2,9246,94,754113,81.55217908510869,7
0.2,9247,21,754134,81.54563148788927,12
0.2,9248,96,754230,81.54719429127474,6
0.2,9249,92,754322,81.54832432432433,9
0.2,9250,95,754417,81.54977840233488,7
0.2,9251,-121,754296,81.52788586251621,15
0.2,9252,94,754390,81.52923376202313,7
0.2,9253,95,754485,81.53068943159715,6
0.2,9254,91,754576,81.53171258779038,11
0.2,9255,94,754670,81.53305963699222,7
0.2,9256,90,754760,81.5339742897267,11
0.2,9257,88,754848,81.53467271548931,14
0.2,9258,96,754944,81.53623501458041,6
0.2,9259,96,755040,81.5377969762419,6
0.2,9260,94,755134,81.53914264118346,8
0.2,9261,89,755223,81.5399481753401,12
0.2,9262,21,755244,81.53341250134946,12
0.2,9263,94,755338,81.53475820379965,8
0.2,9264,19,755357,81.52800863464653,13
0.2,9265,94,755451,81.52935462982948,7
0.2,9266,94,755545,81.53070033452035,7
0.2,9267,89,755634,81.53150625809236,12
0.2,9268,93,755727,81.53274355378142,8
0.2,9269,94,755821,81.53408845738943,7
0.2,9270,94,755915,81.53543307086615,7
0.2,9271,92,756007,81.53656169111302,9
0.2,9272,93,756100,81.53779790790468,9
0.2,9273,91,756191,81.53881820142334,10
0.2,9274,26,756217,81.53283018867924,7
0.2,9275,92,756309,81.53395860284606,10
0.2,9276,88,756397,81.53465559987065,14
0.2,9277,95,756492,81.53610691959474,7
0.2,9278,94,756586,81.53745015626684,7
0.2,9279,23,756609,81.53114224137931,10
0.2,9280,25,756634,81.52505117982976,7
0.2,9281,17,756651,81.51809954751131,15
0.2,9282,89,756740,81.51890552623074,13
0.2,9283,92,756832,81.52003446790177,10
0.2,9284,93,756925,81.52127086698977,8
0.2,9285,93,757018,81.52250699978462,8
0.2,9286,25,757043,81.51642080327339,8
0.2,9287,94,757137,81.51776485788113,7
0.2,9288,90,757227,81.51867800624395,11
0.2,9289,94,757321,81.52002152852529,8
0.2,9290,92,757413,81.52114949951566,9
0.2,9291,93,757506,81.52238484718038,9
0.2,9292,81,757587,81.52232863445604,20
0.2,9293,92,757679,81.52345599311384,10
0.2,9294,93,757772,81.52469069392146,8
0.2,9295,96,757868,81.52624784853701,7
0.2,9296,86,757954,81.52672905238249,15
0.2,9297,94,758048,81.52807055280705,8
0.2,9298,91,758139,81.5290891493709,10
0.2,9299,90,758229,81.53,11
0.2,9300,27,758256,81.5241371895495,6
0.2,9301,96,758352,81.52569339926897,6
0.2,9302,94,758446,81.52703429001397,8
0.2,9303,92,758538,81.52815993121239,10
0.2,9304,93,758631,81.52939279957012,8
0.2,9305,94,758725,81.53073286052009,7
0.2,9306,93,758818,81.53196518749328,9
0.2,9307,91,758909,81.53298238074774,11
0.2,9308,95,759004,81.53442904715867,6
0.2,9309,91,759095,81.53544575725027,11
0.2,9310,92,759187,81.5365696488025,9
0.2,9311,96,759283,81.53812285223368,6
0.2,9312,94,759377,81.5394609685386,7
0.2,9313,26,759403,81.53349796006013,8
0.2,9314,90,759493,81.53440687063876,11
0.2,9315,94,759587,81.53574495491627,7
0.2,9316,96,759683,81.53729741333048,6
0.2,9317,92,759775,81.53842026185878,9
0.2,9318,91,759866,81.53943556175555,11
0.2,9319,93,759959,81.5406652360515,8
0.2,9320,90,760049,81.54157279261882,11
0.2,9321,84,760133,81.54183651576915,18
0.2,9322,85,760218,81.5422074439558,16
0.2,9323,93,760311,81.54343629343629,9
0.2,9324,80,760391,81.54327077747989,22
0.2,9325,94,760485,81.54460647651726,7
0.2,9326,94,760579,81.54594188913906,7
0.2,9327,92,760671,81.54706260720411,9
0.2,9328,20,760691,81.54046521599314,12
0.2,9329,95,760786,81.54190782422293,6
0.2,9330,92,760878,81.54302861429643,9
0.2,9331,85,760963,81.54339905700814,16
0.2,9332,94,761057,81.54473374049073,8
0.2,9333,89,761146,81.545532461967,12
0.2,9334,93,761239,81.54675950723085,9
0.2,9335,95,761334,81.54820051413881,7
0.2,9336,82,761416,81.54824890221698,19
0.2,9337,96,761512,81.54979653030628,6
0.2,9338,93,761605,81.55102259342542,8
0.2,9339,91,761696,81.55203426124197,10
0.2,9340,93,761789,81.55325982228884,8
0.2,9341,94,761883,81.55459216441875,7
0.2,9342,96,761979,81.55613828534732,6
0.2,9343,90,762069,81.55704195205479,11
0.2,9344,92,762161,81.5581594435527,9
0.2,9345,89,762250,81.55895570297453,12
0.2,9346,94,762344,81.56028672301274,7
0.2,9347,92,762436,81.56140350877193,9
0.2,9348,88,762524,81.56209220237459,13
0.2,9349,91,762615,81.56310160427807,10
0.2,9350,93,762708,81.56432467115816,8
0.2,9351,92,762800,81.56544054747647,9
0.2,9352,94,762894,81.56677002031434,8
0.2,9353,92,762986,81.56788539662176,9
0.2,9354,17,763003,81.56098343132015,15
0.2,9355,90,763093,81.56188542112014,11
0.2,9356,-44,763049,81.54846638879982,8
0.2,9357,92,763141,81.54958324428297,9
0.2,9358,96,763237,81.5511272571856,6
0.2,9359,90,763327,81.55202991452991,11
0.2,9360,25,763352,81.54598867642346,8
0.2,9361,95,763447,81.5474257637257,7
0.2,9362,23,763470,81.54117270105735,9
0.2,9363,95,763565,81.54260999572833,7
0.2,9364,91,763656,81.54361986118526,10
0.2,9365,96,763752,81.54516335682256,6
0.2,9366,18,763770,81.53837941710259,14
0.2,9367,92,763862,81.53949615713066,9
0.2,9368,91,763953,81.54050592379123,11
0.2,9369,96,764049,81.54204909284952,6
0.2,9370,94,764143,81.54337850816349,8
0.2,9371,-52,764091,81.52912932138284,15
0.2,9372,90,764181,81.5300330737224,11
0.2,9373,96,764277,81.53157670151482,6
0.2,9374,92,764369,81.53269333333333,9
0.2,9375,89,764458,81.53348976109216,12
0.2,9376,90,764548,81.53439266289858,11
0.2,9377,95,764643,81.53582853486884,7
0.2,9378,90,764733,81.53673099477557,12
0.2,9379,94,764827,81.53805970149254,8
0.2,9380,89,764916,81.53885513271506,12
0.2,9381,94,765010,81.54018332978043,7
0.2,9382,92,765102,81.54129809229458,10
0.2,9383,94,765196,81.54262574595056,7
0.2,9384,94,765290,81.54395311667555,7
0.2,9385,94,765384,81.54528020455999,8
0.2,9386,93,765477,81.54650047938638,8
0.2,9387,91,765568,81.54750745632722,10
0.2,9388,90,765658,81.54840771115134,12
0.2,9389,95,765753,81.54984025559105,7
0.2,9390,91,765844,81.55084655521243,10
0.2,9391,92,765936,81.55195911413969,9
0.2,9392,93,766029,81.55317789843501,8
0.2,9393,94,766123,81.554502874175,7
0.2,9394,-55,766068,81.53996806812134,18
0.2,9395,89,766157,81.5407620263942,12
0.2,9396,87,766244,81.5413429818027,14
0.2,9397,90,766334,81.542243030432,11
0.2,9398,90,766424,81.54314288754122,12
0.2,9399,94,766518,81.54446808510639,7
0.2,9400,96,766614,81.54600574406977,7
0.2,9401,94,766708,81.54733035524356,7
0.2,9402,91,766799,81.54833563756247,10
0.2,9403,88,766887,81.54902169289664,13
0.2,9404,92,766979,81.55013290802765,9
0.2,9405,91,767070,81.55113757176271,10
0.2,9406,87,767157,81.55171680663335,14
0.2,9407,94,767251,81.5530399659864,8
0.2,9408,89,767340,81.55383143798491,12
0.2,9409,21,767361,81.54739638682253,11
0.2,9410,92,767453,81.54850706619912,10
0.2,9411,93,767546,81.54972375690608,8
0.2,9412,94,767640,81.5510464251567,7
0.2,9413,90,767730,81.55194391332059,11
0.2,9414,95,767825,81.55337227827934,6
0.2,9415,94,767919,81.55469413763807,7
0.2,9416,89,768008,81.55548476160136,12
0.2,9417,90,768098,81.55638139732427,11
0.2,9418,89,768187,81.5571716742754,12
0.2,9419,90,768277,81.55806794055202,11
0.2,9420,92,768369,81.55917630824753,10
0.2,9421,91,768460,81.56017830609213,10
0.2,9422,95,768555,81.56160458452722,7
0.2,9423,86,768641,81.56207555178268,15
0.2,9424,95,768736,81.56350132625995,8
0.2,9425,94,768830,81.56482070867813,7
0.2,9426,92,768922,81.5659276546091,10
0.2,9427,93,769015,81.5671404327535,9
0.2,9428,96,769111,81.56867112100966,6
0.2,9429,90,769201,81.5695652173913,11
0.2,9430,90,769291,81.57045912416498,11
0.2,9431,94,769385,81.57177692960136,8
0.2,9432,92,769477,81.57288243400826,9
0.2,9433,87,769564,81.57345770616918,14
0.2,9434,96,769660,81.57498675145735,6
0.2,9435,95,769755,81.57640949554896,6
0.2,9436,94,769849,81.57772597223693,7
0.2,9437,92,769941,81.57883026064845,9
0.2,9438,90,770031,81.57972242822333,11
0.2,9439,90,770121,81.58061440677966,11
0.2,9440,94,770215,81.58192988030929,7
0.2,9441,92,770307,81.58303325566617,9
0.2,9442,91,770398,81.58403049878217,10
0.2,9443,94,770492,81.58534519271495,7
0.2,9444,94,770586,81.58665960825834,7
0.2,9445,91,770677,81.58765615075164,10
0.2,9446,94,770771,81.58897004340002,7
0.2,9447,93,770864,81.59017781541067,8
0.2,9448,94,770958,81.59149116308605,7
0.2,9449,24,770982,81.58539682539683,9
0.2,9450,94,771076,81.58671040101576,7
0.2,9451,92,771168,81.58781210325857,10
0.2,9452,89,771257,81.58859621284249,12
0.2,9453,94,771351,81.58990903321346,7
0.2,9454,89,771440,81.590692755156,12
0.2,9455,89,771529,81.59147631133672,12
0.2,9456,91,771620,81.59247118536534,10
0.2,9457,92,771712,81.59357157961514,10
0.2,9458,92,771804,81.59467174119885,9
0.2,9459,94,771898,81.59598308668076,7
0.2,9460,95,771993,81.5973998520241,8
0.2,9461,91,772084,81.59839357429719,10
0.2,9462,94,772178,81.59970411074713,7
0.2,9463,89,772267,81.60048605240912,12
0.2,9464,93,772360,81.60169043845748,9
0.2,9465,87,772447,81.6022607225861,14
0.2,9466,87,772534,81.6028308862364,14
0.2,9467,93,772627,81.60403464300802,8
0.2,9468,24,772651,81.597951209209,8
0.2,9469,93,772744,81.59915522703274,8
0.2,9470,92,772836,81.60025340513145,9
0.2,9471,95,772931,81.60166807432432,6
0.2,9472,94,773025,81.60297688166368,7
0.2,9473,88,773113,81.60365210048553,14
0.2,9474,90,773203,81.6045382585752,12
0.2,9475,94,773297,81.60584634867033,8
0.2,9476,-57,773240,81.59122085048011,21
0.2,9477,92,773332,81.59231905465288,9
0.2,9478,88,773420,81.59299504167106,13
0.2,9479,95,773515,81.59440928270043,7
0.2,9480,92,773607,81.59550680307984,9
0.2,9481,94,773701,81.5968150179287,7
0.2,9482,94,773795,81.59812295687018,7
0.2,9483,90,773885,81.59900885702235,11
0.2,9484,92,773977,81.60010542962573,9
0.2,9485,91,774068,81.6010963525195,10
0.2,9486,94,774162,81.60240328871087,8
0.2,9487,20,774182,81.59591062394604,13
0.2,9488,90,774272,81.59679629044156,11
0.2,9489,91,774363,81.59778714436248,11
0.2,9490,92,774455,81.59888315246023,9
0.2,9491,96,774551,81.600400337126,6
0.2,9492,92,774643,81.60149583903929,9
0.2,9493,95,774738,81.60290709922056,6
0.2,9494,88,774826,81.60358083201685,14
0.2,9495,22,774848,81.59730412805392,11
0.2,9496,93,774941,81.59850479098662,8
0.2,9497,95,775036,81.59991577174142,6
0.2,9498,94,775130,81.60122118117697,7
0.2,9499,86,775216,81.60168421052632,15
0.2,9500,-49,775167,81.5879381117777,13
0.2,9501,91,775258,81.58892864660072,10
0.2,9502,24,775282,81.58286856782068,9
0.2,9503,96,775378,81.58438552188552,6
0.2,9504,96,775474,81.5859021567596,6
0.2,9505,92,775566,81.5869976856722,9
0.2,9506,96,775662,81.58851372672767,6
0.2,9507,95,775757,81.58992427429533,8
0.2,9508,94,775851,81.59122936165738,7
0.2,9509,94,775945,81.59253417455311,7
0.2,9510,95,776040,81.59394385448428,6
0.2,9511,-50,775990,81.58010933557611,13
0.2,9512,94,776084,81.58141490591822,7
0.2,9513,87,776171,81.58198444397729,14
0.2,9514,95,776266,81.58339464004204,7
0.2,9515,93,776359,81.58459436738126,8
0.2,9516,27,776386,81.57885888410213,6
0.2,9517,86,776472,81.57932338726623,15
0.2,9518,91,776563,81.58031305809433,10
0.2,9519,23,776586,81.57415966386554,10
0.2,9520,90,776676,81.57504463816827,11
0.2,9521,27,776703,81.56931316950221,6
0.2,9522,23,776726,81.56316286884385,9
0.2,9523,90,776816,81.56404871902562,11
0.2,9524,93,776909,81.56524934383202,11
0.2,9525,91,777000,81.56623976485409,10
0.2,9526,93,777093,81.56743990763094,9
0.2,9527,95,777188,81.5688497061293,6
0.2,9528,96,777284,81.57036415153742,6
0.2,9529,93,777377,81.57156348373557,8
0.2,9530,95,777472,81.5729724058336,6
0.2,9531,89,777561,81.57375157364666,13
0.2,9532,96,777657,81.57526486940102,6
0.2,9533,92,777749,81.57635829662262,9
0.2,9534,96,777845,81.57787100157316,6
0.2,9535,94,777939,81.57917365771812,7
0.2,9536,87,778026,81.57974205725071,14
0.2,9537,93,778119,81.58093940029356,9
0.2,9538,90,778209,81.5818219939197,11
0.2,9539,84,778293,81.58207547169812,17
0.2,9540,95,778388,81.58348181532334,7
0.2,9541,88,778476,81.58415426535318,14
0.2,9542,96,778572,81.58566488525621,6
0.2,9543,93,778665,81.58686085498742,8
0.2,9544,93,778758,81.58805657412258,8
0.2,9545,94,778852,81.58935679865913,8
0.2,9546,88,778940,81.59002828113543,13
0.2,9547,15,778955,81.58305404273146,17
0.2,9548,88,779043,81.583726044612,13
0.2,9549,95,779138,81.58513089005235,6
0.2,9550,91,779229,81.58611663700137,12
0.2,9551,96,779325,81.5876256281407,6
0.2,9552,96,779421,81.5891343033602,6
0.2,9553,82,779503,81.58917730793385,20
0.2,9554,88,779591,81.58984824699111,13
0.2,9555,93,779684,81.59104227710338,9
0.2,9556,92,779776,81.59213142199435,10
0.2,9557,91,779867,81.59311571458464,10
0.2,9558,16,779883,81.58625379223768,16
0.2,9559,94,779977,81.58755230125523,7
0.2,9560,89,780066,81.58832758079699,12
0.2,9561,95,780161,81.5897301819703,6
0.2,9562,91,780252,81.59071421102165,11
0.2,9563,93,780345,81.59190715181933,8
0.2,9564,21,780366,81.58557239937271,12
0.2,9565,94,780460,81.5868701651683,7
0.2,9566,95,780555,81.58827218563813,6
0.2,9567,93,780648,81.58946488294315,8
0.2,9568,92,780740,81.59055282683666,10
0.2,9569,-46,780694,81.57722048066876,10
0.2,9570,94,780788,81.57851844112423,8
0.2,9571,93,780881,81.57971165900543,8
0.2,9572,85,780966,81.58006894390473,16
0.2,9573,93,781059,81.58126175057447,8
0.2,9574,94,781153,81.5825587467363,8
0.2,9575,93,781246,81.58375104427736,9
0.2,9576,95,781341,81.58515192649055,6
0.2,9577,95,781436,81.58655251618292,8
0.2,9578,93,781529,81.58774402338449,8
0.2,9579,94,781623,81.58903966597077,8
0.2,9580,93,781716,81.59023066485753,8
0.2,9581,94,781810,81.59152577749948,7
0.2,9582,88,781898,81.59219451111343,13
0.2,9583,94,781992,81.59348914858097,7
0.2,9584,93,782085,81.59467918622848,8
0.2,9585,94,782179,81.59597329438765,7
0.2,9586,87,782266,81.59653697715656,15
0.2,9587,93,782359,81.59772632457238,8
0.2,9588,85,782444,81.59808113463343,16
0.2,9589,93,782537,81.5992700729927,8
0.2,9590,93,782630,81.60045876342404,8
0.2,9591,92,782722,81.60154295246038,9
0.2,9592,96,782818,81.603043886167,6
0.2,9593,26,782844,81.59724828017511,8
0.2,9594,94,782938,81.59854090672225,7
0.2,9595,22,782960,81.59233013755731,10
0.2,9596,90,783050,81.59320621027405,12
0.2,9597,94,783144,81.5944988539279,7
0.2,9598,94,783238,81.59579122825295,7
0.2,9599,94,783332,81.59708333333333,7
0.2,9600,88,783420,81.59775023435058,13
0.2,9601,88,783508,81.59841699645906,13
0.2,9602,95,783603,81.59981255857545,6
0.2,9603,91,783694,81.60079133694295,10
0.2,9604,93,783787,81.6019781363873,9
0.2,9605,91,783878,81.60295648552987,11
0.2,9606,87,783965,81.60351826792963,14
0.2,9607,95,784060,81.60491257285595,6
0.2,9608,91,784151,81.60589031116662,10
0.2,9609,27,784178,81.60020811654526,6
0.2,9610,96,784274,81.60170637810842,6
0.2,9611,95,784369,81.60310029130254,6
0.2,9612,96,784465,81.6045979402892,6
0.2,9613,88,784553,81.60526315789474,14
0.2,9614,88,784641,81.60592823712949,14
0.2,9615,96,784737,81.60742512479202,6
0.2,9616,92,784829,81.60850577103047,9
0.2,9617,92,784921,81.60958619255562,9
0.2,9618,87,785008,81.61014658488408,14
0.2,9619,84,785092,81.61039501039501,17
0.2,9620,92,785184,81.61147489865918,9
0.2,9621,93,785277,81.61265849095822,8
0.2,9622,90,785367,81.61353008417333,11
0.2,9623,93,785460,81.61471321695761,8
0.2,9624,25,785485,81.60883116883117,8
0.2,9625,95,785580,81.61022231456472,6
0.2,9626,87,785667,81.61078217513244,14
0.2,9627,95,785762,81.61217282924802,6
0.2,9628,90,785852,81.61304392979541,11
0.2,9629,82,785934,81.61308411214954,19
0.2,9630,96,786030,81.61457792544907,6
0.2,9631,91,786121,81.61555232558139,10
0.2,9632,96,786217,81.61704557251116,6
0.2,9633,88,786305,81.61770811708533,13
0.2,9634,91,786396,81.61868188894655,10
0.2,9635,83,786479,81.61882523868825,18
0.2,9636,23,786502,81.61274255473695,9
0.2,9637,89,786591,81.61350902676904,12
0.2,9638,94,786685,81.61479406577446,7
0.2,9639,94,786779,81.61607883817427,8
0.2,9640,92,786871,81.61715589669122,10
0.2,9641,94,786965,81.61844015764365,8
0.2,9642,96,787061,81.61993155656953,6
0.2,9643,94,787155,81.62121526337619,7
0.2,9644,-116,787039,81.60072576464489,12
0.2,9645,89,787128,81.60149284677587,12
0.2,9646,85,787213,81.60184513320203,16
0.2,9647,92,787305,81.60292288557214,10
0.2,9648,94,787399,81.60420768991605,7
0.2,9649,95,787494,81.60559585492229,7
0.2,9650,92,787586,81.606672883639,9
0.2,9651,94,787680,81.60795690012432,7
0.2,9652,92,787772,81.60903346110018,10
0.2,9653,88,787860,81.60969546302051,13
0.2,9654,94,787954,81.61097876747799,8
0.2,9655,93,788047,81.61215824357912,8
0.2,9656,86,788133,81.61261261261261,15
0.2,9657,88,788221,81.613273969766,13
0.2,9658,92,788313,81.61434931152293,9
0.2,9659,96,788409,81.61583850931677,6
0.2,9660,95,788504,81.61722388986648,6
0.2,9661,92,788596,81.61829848892569,9
0.2,9662,94,788690,81.6195798406292,9
0.2,9663,88,788778,81.62024006622516,13
0.2,9664,94,788872,81.62152095188826,8
0.2,9665,94,788966,81.62280157252225,7
0.2,9666,94,789060,81.62408192820938,8
0.2,9667,93,789153,81.62525858502275,8
0.2,9668,96,789249,81.62674526838349,6
0.2,9669,90,789339,81.62761116856257,11
0.2,9670,94,789433,81.62889049736324,7
0.2,9671,92,789525,81.62996277915633,9
0.2,9672,92,789617,81.63103483924326,9
0.2,9673,93,789710,81.63221004755013,8
0.2,9674,96,789806,81.63369509043928,6
0.2,9675,96,789902,81.63517982637454,6
0.2,9676,91,789993,81.63614756639454,11
0.2,9677,94,790087,81.63742508782806,7
0.2,9678,91,790178,81.63839239590867,10
0.2,9679,94,790272,81.6396694214876,8
0.2,9680,96,790368,81.64115277347382,6
0.2,9681,95,790463,81.64253253460029,7
0.2,9682,95,790558,81.64391201074048,6
0.2,9683,95,790653,81.64529120198266,6
0.2,9684,88,790741,81.64594734124935,13
0.2,9685,94,790835,81.64722279578774,8
0.2,9686,94,790929,81.64849798699288,7
0.2,9687,90,791019,81.64936003303055,11
0.2,9688,90,791109,81.650221901125,12
0.2,9689,96,791205,81.65170278637771,6
0.2,9690,93,791298,81.6528738004334,8
0.2,9691,91,791389,81.65383821708626,10
0.2,9692,93,791482,81.6550087692149,8
0.2,9693,23,791505,81.64895811842376,10
0.2,9694,92,791597,81.65002578648787,9
0.2,9695,88,791685,81.6506806930693,13
0.2,9696,92,791777,81.65174796328762,9
0.2,9697,91,791868,81.6527118993607,10
0.2,9698,91,791959,81.65367563666358,10
0.2,9699,92,792051,81.65474226804123,10
0.2,9700,94,792145,81.65601484383053,8
0.2,9701,90,792235,81.65687487116058,12
0.2,9702,95,792330,81.65825002576523,6
0.2,9703,93,792423,81.65941879637263,8
0.2,9704,93,792516,81.66058732612056,8
0.2,9705,93,792609,81.66175561508345,8
0.2,9706,92,792701,81.66282064489543,9
0.2,9707,94,792795,81.66409147095179,7
0.2,9708,92,792887,81.6651560407869,9
0.2,9709,95,792982,81.66652935118435,6
0.2,9710,94,793076,81.66779940273916,8
0.2,9711,90,793166,81.66865733113674,12
0.2,9712,90,793256,81.66951508287862,12
0.2,9713,84,793340,81.66975499279391,17
0.2,9714,96,793436,81.67123005661348,6
0.2,9715,93,793529,81.67239604775628,8
0.2,9716,89,793618,81.673150149223,13
0.2,9717,95,793713,81.67452150648282,6
0.2,9718,92,793805,81.67558390780944,9
0.2,9719,86,793891,81.67602880658436,16
0.2,9720,93,793984,81.67719370435141,8
0.2,9721,86,794070,81.67763834601934,15
0.2,9722,93,794163,81.67880283863005,8
0.2,9723,91,794254,81.67976141505554,11
0.2,9724,87,794341,81.68030848329049,14
0.2,9725,92,794433,81.68136952498458,9
0.2,9726,95,794528,81.68273876837668,6
0.2,9727,91,794619,81.68369654605263,10
0.2,9728,94,794713,81.68496248329735,7
0.2,9729,94,794807,81.68622816032888,7
0.2,9730,91,794898,81.68718528414345,11
0.2,9731,93,794991,81.6883477188656,9
0.2,9732,92,795083,81.68940717147848,9
0.2,9733,90,795173,81.69026094103144,11
0.2,9734,90,795263,81.69111453518234,12
0.2,9735,92,795355,81.69217337715695,9
0.2,9736,91,795446,81.69312930060593,10
0.2,9737,94,795540,81.69439309919902,7
0.2,9738,92,795632,81.69545127836534,9
0.2,9739,94,795726,81.69671457905544,8
0.2,9740,94,795820,81.69797762036752,7
0.2,9741,89,795909,81.69872716074728,12
0.2,9742,91,796000,81.69968182284717,10
0.2,9743,86,796086,81.70012315270937,16
0.2,9744,84,796170,81.70035915854284,17
0.2,9745,90,796260,81.70121075312949,12
0.2,9746,91,796351,81.70216476864677,11
0.2,9747,96,796447,81.70363151415675,6
0.2,9748,93,796540,81.70479023489588,8
0.2,9749,94,796634,81.70605128205128,7
0.2,9750,94,796728,81.70731207055687,7
0.2,9751,92,796820,81.70836751435603,9
0.2,9752,83,796903,81.70849994873372,19
0.2,9753,27,796930,81.70289112159114,6
0.2,9754,93,797023,81.70404920553563,10
0.2,9755,90,797113,81.70489954899548,13
0.2,9756,83,797196,81.70503228451368,19
0.2,9757,95,797291,81.70639475302316,8
0.2,9758,87,797378,81.7069371861871,14
0.2,9759,88,797466,81.70758196721312,13
0.2,9760,90,797556,81.70843151316464,11
0.2,9761,92,797648,81.70948576111452,10
0.2,9762,89,797737,81.71023251049883,14
0.2,9763,95,797832,81.71159360917656,7
0.2,9764,92,797924,81.7126472094214,9
0.2,9765,93,798017,81.71380298996519,8
0.2,9766,92,798109,81.71485614825433,9
0.2,9767,92,798201,81.7159090909091,9
0.2,9768,93,798294,81.71706418261849,8
0.2,9769,94,798388,81.71832139201638,7
0.2,9770,95,798483,81.71968068774946,7
0.2,9771,93,798576,81.72083503888662,9
0.2,9772,92,798668,81.72188683106518,9
0.2,9773,95,798763,81.7232453447923,7
0.2,9774,91,798854,81.72419437340153,11
0.2,9775,92,798946,81.72524549918167,9
0.2,9776,94,799040,81.7265009716682,7
0.2,9777,14,799054,81.71957455512374,19
0.2,9778,93,799147,81.72072809080683,8
0.2,9779,94,799241,81.7219836400818,8
0.2,9780,93,799334,81.72313669358961,8
0.2,9781,87,799421,81.7236761398487,14
0.2,9782,93,799514,81.7248287846264,8
0.2,9783,93,799607,81.72598119378577,8
0.2,9784,94,799701,81.72723556463976,7
0.2,9785,94,799795,81.72848967913346,7
0.2,9786,94,799889,81.72974353734546,7
0.2,9787,92,799981,81.7307928075194,9
0.2,9788,92,800073,81.73184186331596,9
0.2,9789,96,800169,81.73329928498468,6
0.2,9790,94,800263,81.73455213972015,7
0.2,9791,92,800355,81.73560049019608,9
0.2,9792,94,800449,81.73685285407944,8
0.2,9793,96,800545,81.7383091688789,6
0.2,9794,89,800634,81.73905053598774,13
0.2,9795,95,800729,81.74040424663127,7
0.2,9796,92,800821,81.7414514647341,10
0.2,9797,86,800907,81.74188609920392,15
0.2,9798,96,801003,81.74334115726094,6
0.2,9799,93,801096,81.74448979591837,8
0.2,9800,94,801190,81.74574023058871,8
0.2,9801,84,801274,81.74597021016119,17
0.2,9802,93,801367,81.74711822911354,8
0.2,9803,91,801458,81.74806201550388,11
0.2,9804,22,801480,81.74196838347781,10
0.2,9805,92,801572,81.74301448093004,9
0.2,9806,90,801662,81.74385642908126,11
0.2,9807,94,801756,81.74510603588907,7
0.2,9808,92,801848,81.74615149352636,11
0.2,9809,90,801938,81.74699286442406,11
0.2,9810,93,802031,81.74813984303333,8
0.2,9811,95,802126,81.749490419894,6
0.2,9812,92,802218,81.75053500458576,9
0.2,9813,93,802311,81.75168127165274,8
0.2,9814,95,802406,81.75303107488539,6
0.2,9815,94,802500,81.75427872860635,7
0.2,9816,92,802592,81.75532239991851,10
0.2,9817,93,802685,81.75646771236504,8
0.2,9818,93,802778,81.75761279152663,10
0.2,9819,22,802800,81.75152749490834,10
0.2,9820,93,802893,81.75267284390591,9
0.2,9821,94,802987,81.75391977194055,8
0.2,9822,95,803082,81.7552682479894,6
0.2,9823,95,803177,81.7566164495114,7
0.2,9824,92,803269,81.75765903307888,9
0.2,9825,94,803363,81.75890494606146,8
0.2,9826,95,803458,81.7602523659306,6
0.2,9827,94,803552,81.76149776149776,7
0.2,9828,92,803644,81.76253942415302,9
0.2,9829,91,803735,81.76347914547304,10
0.2,9830,96,803831,81.76492727087783,6
0.2,9831,82,803913,81.764951179821,19
0.2,9832,84,803997,81.76517848062646,18
0.2,9833,93,804090,81.76632092739476,8
0.2,9834,95,804185,81.76766649720386,6
0.2,9835,9,804194,81.76026840178935,23
0.2,9836,94,804288,81.76151265629765,7
0.2,9837,87,804375,81.76204513112421,14
0.2,9838,95,804470,81.76339058847444,6
0.2,9839,93,804563,81.7645325203252,8
0.2,9840,95,804658,81.7658774514785,6
0.2,9841,89,804747,81.76661247713879,12
0.2,9842,94,804841,81.76785532865996,7
0.2,9843,79,804920,81.7675741568468,22
0.2,9844,93,805013,81.76871508379888,8
0.2,9845,88,805101,81.76934795856185,13
0.2,9846,93,805194,81.7704884736468,8
0.2,9847,95,805289,81.77183184402925,6
0.2,9848,95,805384,81.77317494161844,6
0.2,9849,96,805480,81.7746192893401,6
0.2,9850,93,805573,81.77575880621256,10
0.2,9851,93,805666,81.77689809175801,8
0.2,9852,90,805756,81.77773267025272,14
0.2,9853,95,805851,81.77907448751776,6
0.2,9854,89,805940,81.77980720446475,14
0.2,9855,96,806036,81.78125,6
0.2,9856,83,806119,81.78137364309627,18
0.2,9857,87,806206,81.78190302292555,15
0.2,9858,90,806296,81.78273658586063,11
0.2,9859,96,806392,81.7841784989858,6
0.2,9860,95,806487,81.78551871006998,7
0.2,9861,94,806581,81.7867572500507,7
0.2,9862,95,806676,81.7880969279124,7
0.2,9863,27,806703,81.78254257907543,6
0.2,9864,94,806797,81.78378104409529,7
0.2,9865,94,806891,81.78501925805797,7
0.2,9866,93,806984,81.78615587311239,8
0.2,9867,94,807078,81.78739359546007,8
0.2,9868,90,807168,81.78822575742223,11
0.2,9869,91,807259,81.78915906788247,10
0.2,9870,89,807348,81.78988957552426,14
0.2,9871,89,807437,81.79061993517018,12
0.2,9872,94,807531,81.79185657854755,7
0.2,9873,94,807625,81.79309297144015,7
0.2,9874,96,807721,81.79453164556962,6
0.2,9875,91,807812,81.79546375050627,10
0.2,9876,95,807907,81.79680064797003,6
0.2,9877,94,808001,81.79803603968415,7
0.2,9878,92,808093,81.799068731653,9
0.2,9879,90,808183,81.7998987854251,11
0.2,9880,87,808270,81.80042505819249,14
0.2,9881,91,808361,81.80135600080955,10
0.2,9882,93,808454,81.802489122736,8
0.2,9883,93,808547,81.8036220153784,8
0.2,9884,94,808641,81.80485584218513,8
0.2,9885,94,808735,81.80608941938094,7
0.2,9886,93,808828,81.80722160412662,8
0.2,9887,89,808917,81.80794902912622,13
0.2,9888,94,809011,81.80918191930428,7
0.2,9889,92,809103,81.81021233569263,9
0.2,9890,18,809121,81.8037609948438,14
0.2,9891,91,809212,81.80469065911848,10
0.2,9892,91,809303,81.8056201354493,10
0.2,9893,95,809398,81.80695370931878,7
0.2,9894,91,809489,81.80788276907529,10
0.2,9895,95,809584,81.80921584478577,6
0.2,9896,94,809678,81.81044761038699,7
0.2,9897,27,809705,81.80491008284501,6
0.2,9898,87,809792,81.80543489241337,14
0.2,9899,93,809885,81.80656565656565,8
0.2,9900,89,809974,81.8072921927078,12
0.2,9901,87,810061,81.80781660270652,14
0.2,9902,91,810152,81.80874482480057,10
0.2,9903,93,810245,81.80987479806139,8
0.2,9904,16,810261,81.80323069156991,16
0.2,9905,92,810353,81.80426004441752,9
0.2,9906,94,810447,81.80549106692237,8
0.2,9907,96,810543,81.8069236980218,6
0.2,9908,94,810637,81.80815420324957,7
0.2,9909,96,810733,81.80958627648839,6
0.2,9910,91,810824,81.81051357077995,10
0.2,9911,95,810919,81.81184422921712,6
0.2,9912,88,811007,81.81246847573892,13
0.2,9913,93,811100,81.81359693362921,8
0.2,9914,93,811193,81.81472516389309,8
0.2,9915,92,811285,81.81575231948366,10
0.2,9916,94,811379,81.81698094181708,7
0.2,9917,94,811473,81.81820931639443,7
0.2,9918,25,811498,81.81248109688477,8
0.2,9919,93,811591,81.81360887096774,8
0.2,9920,94,811685,81.81483721399053,7
0.2,9921,95,811780,81.81616609554526,6
0.2,9922,95,811875,81.81749470926131,7
0.2,9923,90,811965,81.8183192261185,11
0.2,9924,88,812053,81.81894206549119,13
0.2,9925,96,812149,81.82037074350191,6
0.2,9926,92,812241,81.82139619220308,10
0.2,9927,95,812336,81.82272360999194,6
0.2,9928,94,812430,81.82395004532178,7
0.2,9929,94,812524,81.82517623363545,8
0.2,9930,94,812618,81.82640217500756,7
0.2,9931,93,812711,81.82752718485703,8
0.2,9932,91,812802,81.8284506191483,10
0.2,9933,96,812898,81.82987718945037,6
0.2,9934,92,812990,81.83090085556115,9
0.2,9935,95,813085,81.83222624798712,6
0.2,9936,82,813167,81.8322431317299,19
0.2,9937,85,813252,81.8325618836788,17
0.2,9938,89,813341,81.83328302646142,13
0.2,9939,90,813431,81.8341046277666,11
0.2,9940,92,813523,81.83512725077959,9
0.2,9941,92,813615,81.83614966807484,9
0.2,9942,96,813711,81.83757417278487,7
0.2,9943,19,813730,81.83125502815768,13
0.2,9944,19,813749,81.82493715434892,13
0.2,9945,93,813842,81.82606072793082,8
0.2,9946,94,813936,81.82728460842465,8
0.2,9947,88,814024,81.82790510655408,13
0.2,9948,95,814119,81.82922906824807,7
0.2,9949,93,814212,81.83035175879397,8
0.2,9950,95,814307,81.83167520852176,6
0.2,9951,20,814327,81.82546221864952,13
0.2,9952,95,814422,81.82678589370039,6
0.2,9953,92,814514,81.82780791641551,9
0.2,9954,88,814602,81.8284279256655,13
0.2,9955,89,814691,81.82914825231016,12
0.2,9956,-49,814642,81.81600883800341,12
0.2,9957,94,814736,81.81723237597912,7
0.2,9958,23,814759,81.81132643839743,10
0.2,9959,93,814852,81.81244979919678,8
0.2,9960,94,814946,81.8136733259713,7
0.2,9961,94,815040,81.814896607107,7
0.2,9962,95,815135,81.81622001405199,7
0.2,9963,94,815229,81.8174427940586,7
0.2,9964,94,815323,81.81866532865027,7
0.2,9965,94,815417,81.81988761790086,7
0.2,9966,94,815511,81.82110966188422,7
0.2,9967,96,815607,81.82253210272873,6
0.2,9968,95,815702,81.82385394723643,6
0.2,9969,94,815796,81.82507522567703,7
0.2,9970,94,815890,81.82629625915153,7
0.2,9971,94,815984,81.82751704773365,7
0.2,9972,93,816077,81.82863732076606,8
0.2,9973,94,816171,81.82985762983758,7
0.2,9974,92,816263,81.83087719298246,10
0.2,9975,96,816359,81.83229751403368,6
0.2,9976,91,816450,81.83321639771475,10
0.2,9977,91,816541,81.83413509721387,10
0.2,9978,93,816634,81.83525403347029,8
0.2,9979,27,816661,81.82975951903808,6
0.2,9980,91,816752,81.83067828874863,10
0.2,9981,94,816846,81.83189741534763,7
0.2,9982,92,816938,81.83291595712711,10
0.2,9983,94,817032,81.83413461538461,8
0.2,9984,20,817052,81.8279419128693,12
0.2,9985,91,817143,81.8288604045664,10
0.2,9986,90,817233,81.8296785821568,11
0.2,9987,93,817326,81.83079695634761,8
0.2,9988,90,817416,81.83161477625389,11
0.2,9989,94,817510,81.83283283283284,7
0.2,9990,94,817604,81.83405064558103,8
0.2,9991,94,817698,81.83526821457166,7
0.2,9992,87,817785,81.83578504953468,14
0.2,9993,86,817871,81.83620172103262,15
0.2,9994,89,817960,81.83691845922961,13
0.2,9995,93,818053,81.83803521408564,8
0.2,9996,92,818145,81.83905171551466,9
0.2,9997,93,818238,81.84016803360672,8
0.2,9998,95,818333,81.84148414841484,7
0.2,9999,93,818426,81.8426,8
