0.05,0,84,84,84.0,23
0.05,1,-387,-303,-151.5,190
0.05,2,3,-300,-100.0,68
0.05,3,89,-211,-52.75,15
0.05,4,79,-132,-26.4,114
0.05,5,84,-48,-8.0,86
0.05,6,93,45,6.428571428571429,26
0.05,7,96,141,17.625,6
0.05,8,85,226,25.11111111111111,17
0.05,9,88,314,31.4,14
0.05,10,94,408,37.09090909090909,9
0.05,11,92,500,41.666666666666664,9
0.05,12,93,593,45.61538461538461,8
0.05,13,94,687,49.07142857142857,7
0.05,14,23,710,47.333333333333336,9
0.05,15,91,801,50.0625,10
0.05,16,95,896,52.705882352941174,6
0.05,17,84,980,54.44444444444444,17
0.05,18,25,1005,52.89473684210526,7
0.05,19,94,1099,54.95,7
0.05,20,93,1192,56.76190476190476,8
0.05,21,94,1286,58.45454545454545,8
0.05,22,93,1379,59.95652173913044,8
0.05,23,26,1405,58.541666666666664,8
0.05,24,93,1498,59.92,8
0.05,25,94,1592,61.23076923076923,7
0.05,26,25,1617,59.888888888888886,7
0.05,27,96,1713,61.17857142857143,6
0.05,28,95,1808,62.3448275862069,6
0.05,29,96,1904,63.46666666666667,6
0.05,30,95,1999,64.48387096774194,8
0.05,31,92,2091,65.34375,9
0.05,32,23,2114,64.06060606060606,9
0.05,33,94,2208,64.94117647058823,7
0.05,34,93,2301,65.74285714285715,9
0.05,35,90,2391,66.41666666666667,11
0.05,36,25,2416,65.29729729729729,8
0.05,37,96,2512,66.10526315789474,6
0.05,38,94,2606,66.82051282051282,7
0.05,39,-44,2562,64.05,8
0.05,40,94,2656,64.78048780487805,7
0.05,41,94,2750,65.47619047619048,7
0.05,42,95,2845,66.16279069767442,7
0.05,43,94,2939,66.79545454545455,7
0.05,44,92,3031,67.35555555555555,9
0.05,45,13,3044,66.17391304347827,20
0.05,46,88,3132,66.63829787234043,13
0.05,47,94,3226,67.20833333333333,7
0.05,48,94,3320,67.75510204081633,8
0.05,49,92,3412,68.24,9
0.05,50,96,3508,68.7843137254902,6
0.05,51,96,3604,69.3076923076923,6
0.05,52,94,3698,69.77358490566037,8
0.05,53,95,3793,70.24074074074075,6
0.05,54,94,3887,70.67272727272727,7
0.05,55,96,3983,71.125,6
0.05,56,94,4077,71.52631578947368,7
0.05,57,94,4171,71.91379310344827,7
0.05,58,90,4261,72.22033898305085,11
0.05,59,93,4354,72.56666666666666,8
0.05,60,88,4442,72.81967213114754,13
0.05,61,90,4532,73.09677419354838,11
0.05,62,94,4626,73.42857142857143,7
0.05,63,94,4720,73.75,7
0.05,64,94,4814,74.06153846153846,8
0.05,65,93,4907,74.34848484848484,8
0.05,66,94,5001,74.64179104477611,7
0.05,67,94,5095,74.92647058823529,7
0.05,68,25,5120,74.20289855072464,8
0.05,69,21,5141,73.44285714285714,12
0.05,70,22,5163,72.71830985915493,10
0.05,71,95,5258,73.02777777777777,6
0.05,72,89,5347,73.24657534246575,12
0.05,73,-133,5214,70.45945945945945,27
0.05,74,89,5303,70.70666666666666,12
0.05,75,95,5398,71.02631578947368,7
0.05,76,94,5492,71.32467532467533,7
0.05,77,92,5584,71.58974358974359,9
0.05,78,94,5678,71.87341772151899,7
0.05,79,95,5773,72.1625,6
0.05,80,18,5791,71.49382716049382,15
0.05,81,94,5885,71.76829268292683,8
0.05,82,94,5979,72.03614457831326,7
0.05,83,94,6073,72.29761904761905,7
0.05,84,89,6162,72.49411764705883,12
0.05,85,94,6256,72.74418604651163,7
0.05,86,92,6348,72.96551724137932,10
0.05,87,94,6442,73.20454545454545,7
0.05,88,92,6534,73.41573033707866,9
0.05,89,94,6628,73.64444444444445,8
0.05,90,95,6723,73.87912087912088,6
0.05,91,27,6750,73.3695652173913,6
0.05,92,21,6771,72.80645161290323,11
0.05,93,95,6866,73.04255319148936,6
0.05,94,92,6958,73.2421052631579,10
0.05,95,95,7053,73.46875,6
0.05,96,96,7149,73.70103092783505,6
0.05,97,19,7168,73.14285714285714,13
0.05,98,93,7261,73.34343434343434,9
0.05,99,95,7356,73.56,8
0.05,100,95,7451,73.77227722772277,6
0.05,101,93,7544,73.96078431372548,8
0.05,102,96,7640,74.1747572815534,6
0.05,103,27,7667,73.72115384615384,6
0.05,104,93,7760,73.9047619047619,8
0.05,105,94,7854,74.09433962264151,8
0.05,106,93,7947,74.27102803738318,8
0.05,107,22,7969,73.78703703703704,10
0.05,108,95,8064,73.98165137614679,6
0.05,109,95,8159,74.17272727272727,6
0.05,110,95,8254,74.36036036036036,6
0.05,111,95,8349,74.54464285714286,7
0.05,112,94,8443,74.71681415929204,7
0.05,113,94,8537,74.8859649122807,7
0.05,114,92,8629,75.03478260869565,9
0.05,115,94,8723,75.19827586206897,7
0.05,116,94,8817,75.35897435897436,7
0.05,117,24,8841,74.92372881355932,8
0.05,118,94,8935,75.08403361344538,8
0.05,119,96,9031,75.25833333333334,6
0.05,120,96,9127,75.4297520661157,6
0.05,121,94,9221,75.58196721311475,7
0.05,122,96,9317,75.7479674796748,6
0.05,123,23,9340,75.3225806451613,9
0.05,124,96,9436,75.488,6
0.05,125,96,9532,75.65079365079364,6
0.05,126,95,9627,75.80314960629921,7
0.05,127,94,9721,75.9453125,7
0.05,128,88,9809,76.03875968992249,13
0.05,129,95,9904,76.18461538461538,7
0.05,130,93,9997,76.31297709923665,8
0.05,131,96,10093,76.46212121212122,6
0.05,132,25,10118,76.07518796992481,7
0.05,133,94,10212,76.2089552238806,7
0.05,134,95,10307,76.34814814814816,7
0.05,135,96,10403,76.49264705882354,6
0.05,136,92,10495,76.60583941605839,9
0.05,137,91,10586,76.71014492753623,10
0.05,138,27,10613,76.35251798561151,6
0.05,139,94,10707,76.47857142857143,8
0.05,140,23,10730,76.09929078014184,9
0.05,141,92,10822,76.21126760563381,9
0.05,142,95,10917,76.34265734265735,6
0.05,143,92,11009,76.45138888888889,9
0.05,144,95,11104,76.57931034482759,6
0.05,145,94,11198,76.6986301369863,8
0.05,146,20,11218,76.31292517006803,12
0.05,147,19,11237,75.92567567567568,13
0.05,148,96,11333,76.06040268456375,6
0.05,149,92,11425,76.16666666666667,10
0.05,150,92,11517,76.27152317880795,9
0.05,151,94,11611,76.38815789473684,7
0.05,152,92,11703,76.49019607843137,9
0.05,153,94,11797,76.6038961038961,8
0.05,154,96,11893,76.72903225806452,6
0.05,155,90,11983,76.81410256410257,11
0.05,156,27,12010,76.4968152866242,6
0.05,157,93,12103,76.60126582278481,8
0.05,158,94,12197,76.71069182389937,7
0.05,159,92,12289,76.80625,9
0.05,160,96,12385,76.92546583850931,6
0.05,161,92,12477,77.01851851851852,9
0.05,162,95,12572,77.12883435582822,6
0.05,163,96,12668,77.2439024390244,6
0.05,164,95,12763,77.35151515151514,7
0.05,165,91,12854,77.43373493975903,10
0.05,166,94,12948,77.53293413173652,7
0.05,167,94,13042,77.63095238095238,7
0.05,168,96,13138,77.7396449704142,6
0.05,169,95,13233,77.84117647058824,6
0.05,170,93,13326,77.9298245614035,9
0.05,171,92,13418,78.01162790697674,9
0.05,172,96,13514,78.11560693641619,6
0.05,173,92,13606,78.19540229885058,10
0.05,174,95,13701,78.29142857142857,6
0.05,175,91,13792,78.36363636363636,10
0.05,176,90,13882,78.42937853107344,11
0.05,177,19,13901,78.09550561797752,13
0.05,178,24,13925,77.79329608938548,9
0.05,179,94,14019,77.88333333333334,7
0.05,180,94,14113,77.97237569060773,9
0.05,181,92,14205,78.04945054945055,9
0.05,182,94,14299,78.13661202185793,7
0.05,183,95,14394,78.22826086956522,6
0.05,184,94,14488,78.31351351351351,7
0.05,185,95,14583,78.40322580645162,8
0.05,186,96,14679,78.49732620320856,6
0.05,187,93,14772,78.57446808510639,9
0.05,188,25,14797,78.29100529100529,8
0.05,189,90,14887,78.35263157894737,11
0.05,190,89,14976,78.40837696335079,12
0.05,191,95,15071,78.49479166666667,7
0.05,192,94,15165,78.57512953367876,7
0.05,193,96,15261,78.66494845360825,6
0.05,194,19,15280,78.35897435897436,13
0.05,195,92,15372,78.42857142857143,9
0.05,196,96,15468,78.51776649746193,6
0.05,197,95,15563,78.6010101010101,7
0.05,198,95,15658,78.68341708542714,6
0.05,199,94,15752,78.76,7
0.05,200,93,15845,78.83084577114428,8
0.05,201,94,15939,78.9059405940594,7
0.05,202,94,16033,78.98029556650246,7
0.05,203,93,16126,79.04901960784314,8
0.05,204,96,16222,79.13170731707316,6
0.05,205,94,16316,79.20388349514563,7
0.05,206,91,16407,79.26086956521739,11
0.05,207,23,16430,78.99038461538461,9
0.05,208,95,16525,79.06698564593302,7
0.05,209,93,16618,79.13333333333334,8
0.05,210,94,16712,79.20379146919431,8
0.05,211,96,16808,79.28301886792453,6
0.05,212,94,16902,79.35211267605634,9
0.05,213,96,16998,79.42990654205607,6
0.05,214,-51,16947,78.8232558139535,16
0.05,215,96,17043,78.90277777777777,6
0.05,216,94,17137,78.97235023041475,7
0.05,217,21,17158,78.70642201834862,11
0.05,218,95,17253,78.78082191780823,6
0.05,219,94,17347,78.85,8
0.05,220,93,17440,78.91402714932127,8
0.05,221,-48,17392,78.34234234234235,11
0.05,222,94,17486,78.41255605381166,7
0.05,223,96,17582,78.49107142857143,6
0.05,224,95,17677,78.56444444444445,6
0.05,225,94,17771,78.63274336283186,7
0.05,226,94,17865,78.70044052863436,7
0.05,227,92,17957,78.75877192982456,10
0.05,228,90,18047,78.80786026200873,11
0.05,229,92,18139,78.86521739130434,9
0.05,230,93,18232,78.92640692640693,8
0.05,231,96,18328,79.0,6
0.05,232,25,18353,78.76824034334764,7
0.05,233,94,18447,78.83333333333333,7
0.05,234,96,18543,78.9063829787234,6
0.05,235,96,18639,78.97881355932203,7
0.05,236,90,18729,79.0253164556962,11
0.05,237,23,18752,78.78991596638656,9
0.05,238,94,18846,78.85355648535565,7
0.05,239,95,18941,78.92083333333333,7
0.05,240,94,19035,78.98340248962656,7
0.05,241,94,19129,79.04545454545455,7
0.05,242,93,19222,79.10288065843622,8
0.05,243,96,19318,79.17213114754098,6
0.05,244,25,19343,78.95102040816326,7
0.05,245,88,19431,78.98780487804878,13
0.05,246,93,19524,79.04453441295547,8
0.05,247,96,19620,79.11290322580645,6
0.05,248,96,19716,79.18072289156626,6
0.05,249,92,19808,79.232,9
0.05,250,94,19902,79.29083665338645,7
0.05,251,95,19997,79.35317460317461,6
0.05,252,24,20021,79.13438735177866,8
0.05,253,94,20115,79.19291338582677,7
0.05,254,94,20209,79.25098039215686,7
0.05,255,96,20305,79.31640625,6
0.05,256,96,20401,79.38132295719845,6
0.05,257,94,20495,79.43798449612403,7
0.05,258,95,20590,79.4980694980695,7
0.05,259,94,20684,79.55384615384615,7
0.05,260,93,20777,79.60536398467433,8
0.05,261,94,20871,79.66030534351145,7
0.05,262,94,20965,79.7148288973384,7
0.05,263,96,21061,79.77651515151516,6
0.05,264,96,21157,79.8377358490566,6
0.05,265,92,21249,79.88345864661655,9
0.05,266,96,21345,79.9438202247191,6
0.05,267,94,21439,79.99626865671642,8
0.05,268,96,21535,80.05576208178438,6
0.05,269,96,21631,80.11481481481482,6
0.05,270,95,21726,80.16974169741698,6
0.05,271,94,21820,80.22058823529412,8
0.05,272,94,21914,80.27106227106228,8
0.05,273,92,22006,80.31386861313868,9
0.05,274,93,22099,80.36,8
0.05,275,94,22193,80.40942028985508,7
0.05,276,85,22278,80.4259927797834,17
0.05,277,93,22371,80.47122302158273,8
0.05,278,95,22466,80.52329749103943,6
0.05,279,94,22560,80.57142857142857,7
0.05,280,-48,22512,80.11387900355872,11
0.05,281,96,22608,80.17021276595744,6
0.05,282,23,22631,79.96819787985866,10
0.05,283,94,22725,80.01760563380282,7
0.05,284,94,22819,80.06666666666666,8
0.05,285,27,22846,79.88111888111888,6
0.05,286,92,22938,79.92334494773519,9
0.05,287,91,23029,79.96180555555556,12
0.05,288,95,23124,80.01384083044982,6
0.05,289,94,23218,80.06206896551724,7
0.05,290,94,23312,80.10996563573883,7
0.05,291,94,23406,80.15753424657534,7
0.05,292,90,23496,80.19112627986348,11
0.05,293,90,23586,80.22448979591837,11
0.05,294,87,23673,80.24745762711865,14
0.05,295,95,23768,80.29729729729729,6
0.05,296,96,23864,80.35016835016835,6
0.05,297,94,23958,80.39597315436242,7
0.05,298,94,24052,80.44147157190635,7
0.05,299,94,24146,80.48666666666666,7
0.05,300,96,24242,80.53820598006645,6
0.05,301,93,24335,80.5794701986755,8
0.05,302,95,24430,80.62706270627062,6
0.05,303,92,24522,80.66447368421052,9
0.05,304,23,24545,80.47540983606558,9
0.05,305,95,24640,80.52287581699346,6
0.05,306,94,24734,80.56677524429968,7
0.05,307,95,24829,80.61363636363636,6
0.05,308,95,24924,80.66019417475728,7
0.05,309,23,24947,80.47419354838709,9
0.05,310,95,25042,80.52090032154341,6
0.05,311,95,25137,80.5673076923077,6
0.05,312,94,25231,80.61022364217253,7
0.05,313,21,25252,80.42038216560509,12
0.05,314,95,25347,80.46666666666667,6
0.05,315,95,25442,80.5126582278481,6
0.05,316,93,25535,80.55205047318611,8
0.05,317,96,25631,80.6006289308176,6
0.05,318,87,25718,80.62068965517241,16
0.05,319,92,25810,80.65625,9
0.05,320,-46,25764,80.26168224299066,10
0.05,321,94,25858,80.30434782608695,7
0.05,322,92,25950,80.3405572755418,9
0.05,323,94,26044,80.38271604938272,7
0.05,324,95,26139,80.42769230769231,6
0.05,325,94,26233,80.46932515337423,7
0.05,326,22,26255,80.29051987767583,11
0.05,327,96,26351,80.33841463414635,6
0.05,328,22,26373,80.16109422492401,12
0.05,329,24,26397,79.99090909090908,8
0.05,330,24,26421,79.82175226586102,8
0.05,331,19,26440,79.63855421686748,13
0.05,332,95,26535,79.68468468468468,7
0.05,333,94,26629,79.72754491017965,7
0.05,334,94,26723,79.77014925373135,8
0.05,335,23,26746,79.60119047619048,9
0.05,336,25,26771,79.43916913946587,7
0.05,337,96,26867,79.48816568047337,6
0.05,338,-54,26813,79.09439528023599,19
0.05,339,91,26904,79.12941176470588,10
0.05,340,95,26999,79.17595307917888,6
0.05,341,92,27091,79.21345029239767,10
0.05,342,26,27117,79.05830903790087,7
0.05,343,93,27210,79.09883720930233,10
0.05,344,21,27231,78.9304347826087,11
0.05,345,25,27256,78.77456647398844,8
0.05,346,24,27280,78.61671469740634,8
0.05,347,94,27374,78.66091954022988,7
0.05,348,94,27468,78.70487106017193,7
0.05,349,93,27561,78.74571428571429,9
0.05,350,93,27654,78.78632478632478,8
0.05,351,94,27748,78.82954545454545,7
0.05,352,94,27842,78.87252124645893,7
0.05,353,25,27867,78.72033898305085,7
0.05,354,93,27960,78.7605633802817,8
0.05,355,93,28053,78.8005617977528,8
0.05,356,96,28149,78.84873949579831,6
0.05,357,94,28243,78.89106145251397,7
0.05,358,94,28337,78.93314763231197,7
0.05,359,95,28432,78.97777777777777,6
0.05,360,94,28526,79.01939058171745,7
0.05,361,94,28620,79.06077348066299,7
0.05,362,94,28714,79.10192837465564,7
0.05,363,93,28807,79.14010989010988,8
0.05,364,92,28899,79.17534246575343,9
0.05,365,95,28994,79.21857923497268,6
0.05,366,95,29089,79.26158038147139,7
0.05,367,95,29184,79.30434782608695,8
0.05,368,94,29278,79.34417344173441,8
0.05,369,27,29305,79.20270270270271,6
0.05,370,94,29399,79.24258760107817,7
0.05,371,93,29492,79.27956989247312,8
0.05,372,94,29586,79.31903485254692,7
0.05,373,92,29678,79.3529411764706,9
0.05,374,94,29772,79.392,7
0.05,375,96,29868,79.43617021276596,6
0.05,376,96,29964,79.48010610079575,6
0.05,377,95,30059,79.52116402116403,6
0.05,378,95,30154,79.56200527704486,6
0.05,379,96,30250,79.60526315789474,6
0.05,380,94,30344,79.64304461942257,7
0.05,381,96,30440,79.68586387434554,6
0.05,382,93,30533,79.72062663185379,8
0.05,383,91,30624,79.75,10
0.05,384,94,30718,79.78701298701299,7
0.05,385,94,30812,79.8238341968912,8
0.05,386,-48,30764,79.49354005167959,12
0.05,387,93,30857,79.52835051546391,8
0.05,388,93,30950,79.5629820051414,8
0.05,389,95,31045,79.6025641025641,6
0.05,390,94,31139,79.63938618925832,7
0.05,391,95,31234,79.67857142857143,6
0.05,392,95,31329,79.7175572519084,7
0.05,393,26,31355,79.58121827411168,6
0.05,394,23,31378,79.4379746835443,9
0.05,395,96,31474,79.47979797979798,6
0.05,396,90,31564,79.50629722921914,11
0.05,397,94,31658,79.5427135678392,7
0.05,398,93,31751,79.57644110275689,10
0.05,399,94,31845,79.6125,7
0.05,400,90,31935,79.63840399002494,11
0.05,401,94,32029,79.67412935323384,8
0.05,402,94,32123,79.70967741935483,7
0.05,403,94,32217,79.7450495049505,7
0.05,404,96,32313,79.78518518518518,6
0.05,405,92,32405,79.8152709359606,9
0.05,406,96,32501,79.85503685503686,6
0.05,407,27,32528,79.72549019607843,6
0.05,408,93,32621,79.75794621026895,8
0.05,409,94,32715,79.79268292682927,7
0.05,410,96,32811,79.83211678832117,6
0.05,411,95,32906,79.86893203883496,6
0.05,412,94,33000,79.90314769975787,7
0.05,413,26,33026,79.77294685990339,6
0.05,414,96,33122,79.81204819277109,6
0.05,415,92,33214,79.84134615384616,9
0.05,416,92,33306,79.87050359712231,9
0.05,417,92,33398,79.89952153110048,9
0.05,418,95,33493,79.93556085918854,7
0.05,419,18,33511,79.78809523809524,14
0.05,420,94,33605,79.82185273159145,7
0.05,421,94,33699,79.85545023696683,9
0.05,422,94,33793,79.88888888888889,8
0.05,423,93,33886,79.91981132075472,8
0.05,424,94,33980,79.95294117647059,8
0.05,425,96,34076,79.9906103286385,6
0.05,426,95,34171,80.02576112412179,6
0.05,427,24,34195,79.89485981308411,8
0.05,428,94,34289,79.92773892773893,8
0.05,429,93,34382,79.95813953488373,8
0.05,430,94,34476,79.9907192575406,8
0.05,431,90,34566,80.01388888888889,11
0.05,432,23,34589,79.88221709006929,9
0.05,433,94,34683,79.9147465437788,7
0.05,434,94,34777,79.94712643678162,7
0.05,435,92,34869,79.97477064220183,9
0.05,436,94,34963,80.00686498855835,7
0.05,437,24,34987,79.87899543378995,8
0.05,438,94,35081,79.91116173120729,7
0.05,439,96,35177,79.94772727272728,6
0.05,440,26,35203,79.82539682539682,6
0.05,441,94,35297,79.85746606334841,7
0.05,442,96,35393,79.89390519187359,6
0.05,443,95,35488,79.92792792792793,7
0.05,444,96,35584,79.96404494382023,6
0.05,445,95,35679,79.99775784753363,6
0.05,446,95,35774,80.03131991051454,8
0.05,447,94,35868,80.0625,7
0.05,448,96,35964,80.09799554565701,6
0.05,449,95,36059,80.13111111111111,6
0.05,450,27,36086,80.01330376940133,6
0.05,451,94,36180,80.04424778761062,7
0.05,452,19,36199,79.90949227373068,13
0.05,453,95,36294,79.94273127753304,6
0.05,454,94,36388,79.97362637362637,8
0.05,455,96,36484,80.00877192982456,6
0.05,456,95,36579,80.04157549234135,7
0.05,457,91,36670,80.06550218340611,10
0.05,458,94,36764,80.0958605664488,8
0.05,459,96,36860,80.1304347826087,6
0.05,460,23,36883,80.00650759219089,9
0.05,461,94,36977,80.03679653679653,8
0.05,462,92,37069,80.06263498920086,9
0.05,463,95,37164,80.09482758620689,6
0.05,464,94,37258,80.1247311827957,7
0.05,465,22,37280,80.0,10
0.05,466,95,37375,80.0321199143469,6
0.05,467,95,37470,80.06410256410257,7
0.05,468,21,37491,79.93816631130063,11
0.05,469,94,37585,79.96808510638297,7
0.05,470,92,37677,79.99363057324841,9
0.05,471,89,37766,80.01271186440678,12
0.05,472,94,37860,80.04228329809725,7
0.05,473,96,37956,80.07594936708861,6
0.05,474,94,38050,80.10526315789474,7
0.05,475,96,38146,80.13865546218487,6
0.05,476,94,38240,80.16771488469601,7
0.05,477,95,38335,80.19874476987448,6
0.05,478,94,38429,80.22755741127348,8
0.05,479,92,38521,80.25208333333333,10
0.05,480,94,38615,80.28066528066527,7
0.05,481,92,38707,80.30497925311204,9
0.05,482,93,38800,80.33126293995859,8
0.05,483,-52,38748,80.05785123966942,15
0.05,484,94,38842,80.08659793814434,8
0.05,485,93,38935,80.11316872427983,8
0.05,486,94,39029,80.14168377823408,8
0.05,487,94,39123,80.17008196721312,8
0.05,488,95,39218,80.20040899795501,6
0.05,489,91,39309,80.22244897959183,10
0.05,490,94,39403,80.25050916496944,7
0.05,491,94,39497,80.27845528455285,7
0.05,492,90,39587,80.29817444219067,12
0.05,493,94,39681,80.32591093117409,7
0.05,494,94,39775,80.35353535353535,7
0.05,495,96,39871,80.3850806451613,6
0.05,496,94,39965,80.41247484909456,7
0.05,497,95,40060,80.4417670682731,6
0.05,498,93,40153,80.46693386773548,8
0.05,499,23,40176,80.352,9
0.05,500,96,40272,80.38323353293413,6
0.05,501,21,40293,80.26494023904382,11
0.05,502,26,40319,80.15705765407554,6
0.05,503,94,40413,80.18452380952381,7
0.05,504,95,40508,80.21386138613862,6
0.05,505,24,40532,80.10276679841897,8
0.05,506,94,40626,80.1301775147929,7
0.05,507,95,40721,80.15944881889764,7
0.05,508,94,40815,80.18664047151277,7
0.05,509,24,40839,80.0764705882353,8
0.05,510,94,40933,80.10371819960861,8
0.05,511,91,41024,80.125,10
0.05,512,92,41116,80.14814814814815,10
0.05,513,25,41141,80.0408560311284,8
0.05,514,94,41235,80.06796116504854,8
0.05,515,95,41330,80.09689922480621,6
0.05,516,94,41424,80.1237911025145,7
0.05,517,92,41516,80.14671814671814,9
0.05,518,94,41610,80.17341040462428,7
0.05,519,26,41636,80.06923076923077,6
0.05,520,92,41728,80.09213051823417,9
0.05,521,93,41821,80.11685823754789,9
0.05,522,94,41915,80.1434034416826,7
0.05,523,92,42007,80.16603053435115,9
0.05,524,95,42102,80.19428571428571,6
0.05,525,95,42197,80.22243346007605,8
0.05,526,25,42222,80.11764705882354,7
0.05,527,94,42316,80.14393939393939,7
0.05,528,94,42410,80.17013232514178,7
0.05,529,94,42504,80.19622641509434,7
0.05,530,94,42598,80.22222222222223,7
0.05,531,18,42616,80.10526315789474,14
0.05,532,24,42640,80.0,8
0.05,533,94,42734,80.02621722846442,7
0.05,534,94,42828,80.05233644859813,7
0.05,535,96,42924,80.08208955223881,6
0.05,536,94,43018,80.10800744878958,8
0.05,537,95,43113,80.135687732342,7
0.05,538,21,43134,80.02597402597402,11
0.05,539,94,43228,80.05185185185185,7
0.05,540,96,43324,80.08133086876155,6
0.05,541,94,43418,80.1070110701107,7
0.05,542,92,43510,80.12891344383057,9
0.05,543,96,43606,80.15808823529412,6
0.05,544,94,43700,80.18348623853211,7
0.05,545,94,43794,80.20879120879121,7
0.05,546,95,43889,80.23583180987202,6
0.05,547,94,43983,80.26094890510949,9
0.05,548,91,44074,80.28051001821494,10
0.05,549,25,44099,80.18,7
0.05,550,95,44194,80.20689655172414,6
0.05,551,96,44290,80.23550724637681,6
0.05,552,90,44380,80.25316455696202,11
0.05,553,96,44476,80.28158844765343,6
0.05,554,96,44572,80.3099099099099,6
0.05,555,94,44666,80.33453237410072,7
0.05,556,94,44760,80.35906642728905,7
0.05,557,94,44854,80.38351254480287,7
0.05,558,92,44946,80.40429338103756,9
0.05,559,96,45042,80.43214285714286,6
0.05,560,94,45136,80.45632798573975,7
0.05,561,25,45161,80.35765124555161,7
0.05,562,95,45256,80.38365896980461,6
0.05,563,94,45350,80.40780141843972,8
0.05,564,94,45444,80.43185840707964,8
0.05,565,95,45539,80.45759717314488,6
0.05,566,96,45635,80.48500881834215,6
0.05,567,95,45730,80.5105633802817,6
0.05,568,23,45753,80.40949033391915,9
0.05,569,94,45847,80.43333333333334,7
0.05,570,94,45941,80.45709281961472,7
0.05,571,95,46036,80.48251748251748,6
0.05,572,27,46063,80.3891797556719,6
0.05,573,27,46090,80.29616724738676,6
0.05,574,94,46184,80.32,8
0.05,575,95,46279,80.34548611111111,6
0.05,576,96,46375,80.37261698440209,6
0.05,577,94,46469,80.3961937716263,7
0.05,578,94,46563,80.41968911917098,7
0.05,579,94,46657,80.44310344827586,7
0.05,580,90,46747,80.45955249569707,11
0.05,581,95,46842,80.48453608247422,6
0.05,582,96,46938,80.51114922813036,6
0.05,583,94,47032,80.53424657534246,7
0.05,584,94,47126,80.55726495726496,7
0.05,585,95,47221,80.58191126279864,6
0.05,586,94,47315,80.60477001703578,7
0.05,587,94,47409,80.62755102040816,7
0.05,588,94,47503,80.65025466893039,7
0.05,589,26,47529,80.55762711864406,7
0.05,590,92,47621,80.57698815566836,9
0.05,591,94,47715,80.59966216216216,7
0.05,592,90,47805,80.61551433389545,11
0.05,593,95,47900,80.63973063973064,6
0.05,594,94,47994,80.66218487394958,7
0.05,595,96,48090,80.68791946308725,6
0.05,596,94,48184,80.71021775544389,7
0.05,597,96,48280,80.73578595317726,6
0.05,598,91,48371,80.75292153589315,10
0.05,599,94,48465,80.775,7
0.05,600,23,48488,80.67886855241265,9
0.05,601,96,48584,80.70431893687707,6
0.05,602,94,48678,80.72636815920399,7
0.05,603,25,48703,80.6341059602649,8
0.05,604,94,48797,80.65619834710743,8
0.05,605,21,48818,80.55775577557756,11
0.05,606,21,48839,80.45963756177925,11
0.05,607,94,48933,80.48190789473684,7
0.05,608,95,49028,80.50574712643679,7
0.05,609,94,49122,80.52786885245902,7
0.05,610,19,49141,80.42716857610475,13
0.05,611,94,49235,80.44934640522875,7
0.05,612,91,49326,80.46655791190865,10
0.05,613,95,49421,80.49022801302931,6
0.05,614,96,49517,80.51544715447154,6
0.05,615,94,49611,80.53733766233766,8
0.05,616,24,49635,80.44570502431118,8
0.05,617,24,49659,80.35436893203884,8
0.05,618,95,49754,80.37802907915993,6
0.05,619,95,49849,80.40161290322581,6
0.05,620,92,49941,80.42028985507247,10
0.05,621,96,50037,80.44533762057878,6
0.05,622,91,50128,80.46227929373997,10
0.05,623,96,50224,80.48717948717949,6
0.05,624,27,50251,80.4016,6
0.05,625,94,50345,80.42332268370608,7
0.05,626,96,50441,80.4481658692185,6
0.05,627,94,50535,80.46974522292993,7
0.05,628,93,50628,80.48966613672496,8
0.05,629,92,50720,80.5079365079365,9
0.05,630,94,50814,80.52931854199683,7
0.05,631,94,50908,80.5506329113924,7
0.05,632,94,51002,80.57187993680884,7
0.05,633,95,51097,80.59463722397476,6
0.05,634,95,51192,80.61732283464566,6
0.05,635,25,51217,80.52987421383648,7
0.05,636,96,51313,80.5541601255887,6
0.05,637,92,51405,80.57210031347962,9
0.05,638,96,51501,80.59624413145539,6
0.05,639,92,51593,80.6140625,9
0.05,640,95,51688,80.6365054602184,6
0.05,641,94,51782,80.65732087227414,7
0.05,642,95,51877,80.6796267496112,6
0.05,643,94,51971,80.70031055900621,7
0.05,644,93,52064,80.71937984496124,8
0.05,645,95,52159,80.74148606811146,6
0.05,646,94,52253,80.76197836166924,7
0.05,647,23,52276,80.67283950617283,10
0.05,648,94,52370,80.69337442218799,7
0.05,649,94,52464,80.71384615384615,7
0.05,650,95,52559,80.7357910906298,6
0.05,651,95,52654,80.75766871165644,7
0.05,652,95,52749,80.77947932618683,6
0.05,653,95,52844,80.80122324159021,7
0.05,654,95,52939,80.82290076335877,6
0.05,655,95,53034,80.84451219512195,8
0.05,656,94,53128,80.86453576864535,8
0.05,657,95,53223,80.88601823708207,6
0.05,658,92,53315,80.90288315629742,9
0.05,659,95,53410,80.92424242424242,6
0.05,660,92,53502,80.94099848714069,9
0.05,661,94,53596,80.9607250755287,7
0.05,662,-47,53549,80.76772247360482,10
0.05,663,94,53643,80.78765060240964,8
0.05,664,25,53668,80.70375939849625,7
0.05,665,95,53763,80.72522522522523,7
0.05,666,92,53855,80.74212893553224,9
0.05,667,92,53947,80.75898203592814,9
0.05,668,25,53972,80.67563527653213,7
0.05,669,90,54062,80.68955223880597,11
0.05,670,95,54157,80.71087928464978,7
0.05,671,92,54249,80.72767857142857,9
0.05,672,94,54343,80.74739970282317,7
0.05,673,-48,54295,80.55637982195846,11
0.05,674,96,54391,80.57925925925926,6
0.05,675,96,54487,80.60207100591715,6
0.05,676,94,54581,80.6218611521418,7
0.05,677,96,54677,80.64454277286136,6
0.05,678,95,54772,80.66568483063328,6
0.05,679,95,54867,80.68676470588235,7
0.05,680,94,54961,80.70631424375918,7
0.05,681,21,54982,80.61876832844575,11
0.05,682,95,55077,80.6398243045388,6
0.05,683,96,55173,80.66228070175438,6
0.05,684,96,55269,80.68467153284672,6
0.05,685,94,55363,80.70408163265306,7
0.05,686,95,55458,80.72489082969432,6
0.05,687,94,55552,80.74418604651163,8
0.05,688,94,55646,80.76342525399129,7
0.05,689,93,55739,80.78115942028985,8
0.05,690,94,55833,80.80028943560058,8
0.05,691,95,55928,80.82080924855491,7
0.05,692,25,55953,80.74025974025975,8
0.05,693,95,56048,80.76080691642652,6
0.05,694,95,56143,80.78129496402877,6
0.05,695,96,56239,80.80316091954023,6
0.05,696,94,56333,80.82209469153516,7
0.05,697,23,56356,80.73925501432664,9
0.05,698,94,56450,80.758226037196,7
0.05,699,94,56544,80.77714285714286,7
0.05,700,93,56637,80.79457917261055,8
0.05,701,96,56733,80.81623931623932,6
0.05,702,94,56827,80.83499288762447,7
0.05,703,92,56919,80.85085227272727,9
0.05,704,93,57012,80.86808510638298,8
0.05,705,96,57108,80.88951841359773,6
0.05,706,94,57202,80.90806223479491,7
0.05,707,93,57295,80.92514124293785,8
0.05,708,95,57390,80.94499294781382,7
0.05,709,96,57486,80.96619718309859,6
0.05,710,25,57511,80.88748241912799,8
0.05,711,94,57605,80.90589887640449,7
0.05,712,95,57700,80.92566619915848,7
0.05,713,95,57795,80.9453781512605,6
0.05,714,91,57886,80.95944055944057,10
0.05,715,95,57981,80.97905027932961,6
0.05,716,96,58077,81.0,6
0.05,717,94,58171,81.01810584958217,7
0.05,718,93,58264,81.03477051460362,8
0.05,719,93,58357,81.0513888888889,8
0.05,720,92,58449,81.06657420249654,9
0.05,721,93,58542,81.08310249307479,9
0.05,722,94,58636,81.10096818810511,7
0.05,723,95,58731,81.12016574585635,6
0.05,724,94,58825,81.13793103448276,7
0.05,725,93,58918,81.15426997245179,8
0.05,726,95,59013,81.17331499312242,6
0.05,727,92,59105,81.18818681318682,9
0.05,728,95,59200,81.20713305898491,6
0.05,729,94,59294,81.22465753424657,7
0.05,730,94,59388,81.24213406292749,7
0.05,731,25,59413,81.1653005464481,8
0.05,732,96,59509,81.18553888130968,6
0.05,733,94,59603,81.20299727520435,7
0.05,734,89,59692,81.21360544217687,12
0.05,735,96,59788,81.2336956521739,6
0.05,736,93,59881,81.24966078697422,8
0.05,737,96,59977,81.26964769647697,6
0.05,738,95,60072,81.28822733423546,6
0.05,739,95,60167,81.30675675675676,7
0.05,740,96,60263,81.32658569500674,6
0.05,741,95,60358,81.34501347708895,6
0.05,742,92,60450,81.35935397039032,9
0.05,743,94,60544,81.3763440860215,9
0.05,744,96,60640,81.39597315436242,6
0.05,745,94,60734,81.41286863270777,8
0.05,746,94,60828,81.429718875502,7
0.05,747,96,60924,81.44919786096257,6
0.05,748,95,61019,81.46728971962617,6
0.05,749,94,61113,81.484,7
0.05,750,95,61208,81.50199733688416,8
0.05,751,93,61301,81.51728723404256,8
0.05,752,94,61395,81.53386454183267,8
0.05,753,95,61490,81.55172413793103,8
0.05,754,94,61584,81.5682119205298,7
0.05,755,92,61676,81.58201058201058,9
0.05,756,94,61770,81.59841479524438,7
0.05,757,95,61865,81.61609498680738,6
0.05,758,95,61960,81.63372859025033,6
0.05,759,95,62055,81.65131578947368,6
0.05,760,96,62151,81.67017082785809,6
0.05,761,95,62246,81.68766404199475,7
0.05,762,94,62340,81.7038007863696,7
0.05,763,94,62434,81.71989528795811,7
0.05,764,94,62528,81.7359477124183,7
0.05,765,94,62622,81.75195822454307,7
0.05,766,95,62717,81.76923076923077,6
0.05,767,94,62811,81.78515625,7
0.05,768,94,62905,81.80104031209363,7
0.05,769,23,62928,81.72467532467533,9
0.05,770,94,63022,81.74059662775616,7
0.05,771,95,63117,81.75777202072538,6
0.05,772,94,63211,81.77360931435963,7
0.05,773,92,63303,81.78682170542636,9
0.05,774,94,63397,81.80258064516129,7
0.05,775,95,63492,81.81958762886597,6
0.05,776,90,63582,81.83011583011583,11
0.05,777,96,63678,81.84832904884318,6
0.05,778,96,63774,81.86649550706034,6
0.05,779,94,63868,81.88205128205128,7
0.05,780,95,63963,81.89884763124199,6
0.05,781,94,64057,81.91432225063939,7
0.05,782,94,64151,81.92975734355045,9
0.05,783,95,64246,81.94642857142857,6
0.05,784,94,64340,81.96178343949045,7
0.05,785,93,64433,81.97582697201018,8
0.05,786,93,64526,81.98983481575604,8
0.05,787,96,64622,82.00761421319797,6
0.05,788,94,64716,82.02281368821293,7
0.05,789,94,64810,82.0379746835443,7
0.05,790,23,64833,81.96333754740834,9
0.05,791,92,64925,81.9760101010101,9
0.05,792,23,64948,81.90163934426229,9
0.05,793,90,65038,81.911838790932,12
0.05,794,94,65132,81.92704402515723,7
0.05,795,94,65226,81.94221105527639,7
0.05,796,96,65322,81.95984943538268,6
0.05,797,25,65347,81.88847117794487,7
0.05,798,94,65441,81.90362953692114,7
0.05,799,94,65535,81.91875,8
0.05,800,94,65629,81.9338327091136,7
0.05,801,96,65725,81.95137157107231,6
0.05,802,24,65749,81.87920298879203,9
0.05,803,96,65845,81.89676616915423,6
0.05,804,96,65941,81.91428571428571,6
0.05,805,93,66034,81.92803970223325,8
0.05,806,21,66055,81.85254027261462,13
0.05,807,94,66149,81.86757425742574,8
0.05,808,94,66243,81.88257107540173,7
0.05,809,92,66335,81.89506172839506,9
0.05,810,90,66425,81.90505548705302,11
0.05,811,94,66519,81.91995073891626,7
0.05,812,92,66611,81.93234932349324,10
0.05,813,90,66701,81.94226044226045,11
0.05,814,90,66791,81.95214723926381,11
0.05,815,94,66885,81.96691176470588,7
0.05,816,21,66906,81.89228886168911,11
0.05,817,92,66998,81.90464547677261,9
0.05,818,96,67094,81.92185592185592,6
0.05,819,24,67118,81.85121951219512,8
0.05,820,94,67212,81.86601705237516,7
0.05,821,23,67235,81.79440389294403,9
0.05,822,95,67330,81.8104495747266,6
0.05,823,92,67422,81.82281553398059,10
0.05,824,94,67516,81.83757575757576,7
0.05,825,94,67610,81.85230024213075,7
0.05,826,94,67704,81.86698911729141,7
0.05,827,94,67798,81.88164251207729,7
0.05,828,22,67820,81.80940892641738,10
0.05,829,95,67915,81.82530120481928,7
0.05,830,91,68006,81.83634175691937,10
0.05,831,94,68100,81.85096153846153,7
0.05,832,25,68125,81.78271308523409,7
0.05,833,92,68217,81.79496402877697,9
0.05,834,95,68312,81.81077844311378,6
0.05,835,92,68404,81.82296650717703,9
0.05,836,94,68498,81.83751493428913,7
0.05,837,95,68593,81.85322195704057,6
0.05,838,94,68687,81.86769964243146,7
0.05,839,95,68782,81.88333333333334,6
0.05,840,94,68876,81.89774078478003,7
0.05,841,24,68900,81.8289786223278,8
0.05,842,94,68994,81.84341637010677,7
0.05,843,90,69084,81.85308056872037,11
0.05,844,93,69177,81.86627218934912,8
0.05,845,93,69270,81.87943262411348,9
0.05,846,26,69296,81.81345926800472,6
0.05,847,23,69319,81.74410377358491,9
0.05,848,93,69412,81.75736160188457,8
0.05,849,94,69506,81.77176470588235,7
0.05,850,23,69529,81.70270270270271,9
0.05,851,94,69623,81.71713615023474,7
0.05,852,93,69716,81.7303634232122,8
0.05,853,94,69810,81.7447306791569,7
0.05,854,96,69906,81.76140350877193,6
0.05,855,93,69999,81.77453271028037,8
0.05,856,94,70093,81.78879813302217,7
0.05,857,24,70117,81.72144522144522,8
0.05,858,92,70209,81.73341094295692,9
0.05,859,21,70230,81.66279069767442,12
0.05,860,-50,70180,81.50987224157956,13
0.05,861,93,70273,81.52320185614849,8
0.05,862,95,70368,81.5388180764774,6
0.05,863,92,70460,81.55092592592592,10
0.05,864,89,70549,81.55953757225434,12
0.05,865,93,70642,81.57274826789839,9
0.05,866,94,70736,81.58708189158016,7
0.05,867,25,70761,81.52188940092167,7
0.05,868,96,70857,81.53855005753739,6
0.05,869,95,70952,81.55402298850575,6
0.05,870,27,70979,81.49138920780712,6
0.05,871,94,71073,81.50573394495413,7
0.05,872,94,71167,81.5200458190149,8
0.05,873,95,71262,81.53546910755149,6
0.05,874,92,71354,81.54742857142857,9
0.05,875,96,71450,81.56392694063926,6
0.05,876,23,71473,81.49714937286203,9
0.05,877,96,71569,81.51366742596811,6
0.05,878,94,71663,81.52787258248009,7
0.05,879,92,71755,81.53977272727273,9
0.05,880,94,71849,81.5539160045403,7
0.05,881,96,71945,81.5702947845805,6
0.05,882,92,72037,81.58210645526614,9
0.05,883,93,72130,81.59502262443439,8
0.05,884,93,72223,81.60790960451978,9
0.05,885,95,72318,81.62302483069978,6
0.05,886,26,72344,81.56031567080045,7
0.05,887,25,72369,81.49662162162163,7
0.05,888,93,72462,81.5095613048369,8
0.05,889,94,72556,81.52359550561798,7
0.05,890,-44,72512,81.38271604938272,9
0.05,891,94,72606,81.39686098654708,7
0.05,892,95,72701,81.41209406494961,6
0.05,893,94,72795,81.4261744966443,7
0.05,894,93,72888,81.4391061452514,8
0.05,895,94,72982,81.453125,8
0.05,896,95,73077,81.46822742474916,6
0.05,897,-121,72956,81.24276169265033,15
0.05,898,94,73050,81.25695216907675,7
0.05,899,87,73137,81.26333333333334,14
0.05,900,94,73231,81.27746947835738,7
0.05,901,95,73326,81.29268292682927,6
0.05,902,93,73419,81.30564784053156,8
0.05,903,95,73514,81.320796460177,6
0.05,904,95,73609,81.33591160220995,7
0.05,905,96,73705,81.35209713024283,6
0.05,906,95,73800,81.36714443219405,8
0.05,907,94,73894,81.38105726872247,7
0.05,908,96,73990,81.3971397139714,6
0.05,909,96,74086,81.41318681318681,6
0.05,910,95,74181,81.42810098792536,6
0.05,911,-45,74136,81.28947368421052,8
0.05,912,96,74232,81.30558598028477,6
0.05,913,94,74326,81.31947483588621,7
0.05,914,94,74420,81.33333333333333,7
0.05,915,91,74511,81.3438864628821,10
0.05,916,92,74603,81.35550708833152,9
0.05,917,95,74698,81.37037037037037,6
0.05,918,93,74791,81.38302502720349,9
0.05,919,94,74885,81.39673913043478,8
0.05,920,96,74981,81.41259500542888,6
0.05,921,-47,74934,81.27331887201736,10
0.05,922,91,75025,81.28385698808233,10
0.05,923,95,75120,81.2987012987013,6
0.05,924,95,75215,81.31351351351351,6
0.05,925,96,75311,81.329373650108,6
0.05,926,92,75403,81.34088457389429,10
0.05,927,94,75497,81.35452586206897,7
0.05,928,95,75592,81.36921420882669,7
0.05,929,94,75686,81.38279569892472,7
0.05,930,92,75778,81.39419978517724,9
0.05,931,92,75870,81.40557939914163,9
0.05,932,94,75964,81.41907824222936,7
0.05,933,93,76057,81.43147751605996,9
0.05,934,93,76150,81.44385026737967,8
0.05,935,94,76244,81.45726495726495,7
0.05,936,95,76339,81.47171824973319,6
0.05,937,92,76431,81.48294243070363,9
0.05,938,93,76524,81.49520766773163,8
0.05,939,20,76544,81.42978723404255,12
0.05,940,94,76638,81.44314558979809,7
0.05,941,93,76731,81.45541401273886,8
0.05,942,93,76824,81.46765641569459,8
0.05,943,94,76918,81.48093220338983,7
0.05,944,22,76940,81.41798941798942,11
0.05,945,95,77035,81.4323467230444,7
0.05,946,94,77129,81.44561774023231,7
0.05,947,93,77222,81.457805907173,8
0.05,948,96,77318,81.4731296101159,6
0.05,949,94,77412,81.48631578947368,7
0.05,950,95,77507,81.50052576235541,6
0.05,951,91,77598,81.51050420168067,10
0.05,952,94,77692,81.52360965372507,7
0.05,953,95,77787,81.5377358490566,6
0.05,954,94,77881,81.55078534031414,7
0.05,955,94,77975,81.56380753138075,7
0.05,956,90,78065,81.57262277951934,11
0.05,957,96,78161,81.58768267223383,6
0.05,958,96,78257,81.60271115745569,6
0.05,959,90,78347,81.61145833333333,11
0.05,960,94,78441,81.62434963579605,7
0.05,961,96,78537,81.63929313929314,6
0.05,962,92,78629,81.65005192107996,9
0.05,963,94,78723,81.66286307053942,7
0.05,964,-54,78669,81.52227979274612,17
0.05,965,93,78762,81.53416149068323,8
0.05,966,96,78858,81.54912099276112,6
0.05,967,94,78952,81.56198347107438,7
0.05,968,94,79046,81.57481940144478,7
0.05,969,95,79141,81.58865979381443,6
0.05,970,92,79233,81.59938208032956,9
0.05,971,94,79327,81.61213991769547,7
0.05,972,94,79421,81.62487153134636,7
0.05,973,22,79443,81.56365503080082,10
0.05,974,94,79537,81.57641025641026,7
0.05,975,95,79632,81.59016393442623,6
0.05,976,26,79658,81.53326509723644,7
0.05,977,93,79751,81.54498977505112,8
0.05,978,94,79845,81.55771195097037,7
0.05,979,96,79941,81.57244897959184,6
0.05,980,95,80036,81.5861365953109,6
0.05,981,94,80130,81.59877800407332,7
0.05,982,93,80223,81.61037639877925,8
0.05,983,92,80315,81.6209349593496,9
0.05,984,95,80410,81.63451776649747,6
0.05,985,96,80506,81.64908722109533,7
0.05,986,23,80529,81.58966565349544,9
0.05,987,96,80625,81.60425101214575,6
0.05,988,94,80719,81.61678463094034,7
0.05,989,93,80812,81.62828282828283,8
0.05,990,94,80906,81.64076690211907,7
0.05,991,93,80999,81.65221774193549,8
0.05,992,94,81093,81.66465256797584,7
0.05,993,94,81187,81.67706237424547,7
0.05,994,96,81283,81.69145728643215,6
0.05,995,24,81307,81.63353413654619,8
0.05,996,91,81398,81.64292878635908,10
0.05,997,94,81492,81.65531062124248,7
0.05,998,93,81585,81.66666666666667,8
0.05,999,25,81610,81.61,7
0.05,1000,94,81704,81.62237762237763,7
0.05,1001,96,81800,81.63672654690619,6
0.05,1002,94,81894,81.64905284147558,7
0.05,1003,96,81990,81.66334661354581,6
0.05,1004,91,82081,81.6726368159204,10
0.05,1005,94,82175,81.68489065606362,7
0.05,1006,95,82270,81.69811320754717,8
0.05,1007,95,82365,81.71130952380952,6
0.05,1008,94,82459,81.72348860257681,7
0.05,1009,96,82555,81.73762376237623,6
0.05,1010,94,82649,81.74975272007913,8
0.05,1011,94,82743,81.76185770750988,7
0.05,1012,92,82835,81.77196446199407,9
0.05,1013,92,82927,81.78205128205128,9
0.05,1014,94,83021,81.79408866995074,7
0.05,1015,93,83114,81.80511811023622,10
0.05,1016,24,83138,81.74827925270404,8
0.05,1017,94,83232,81.76031434184677,7
0.05,1018,96,83328,81.77428851815506,6
0.05,1019,95,83423,81.78725490196078,7
0.05,1020,90,83513,81.7952987267385,11
0.05,1021,92,83605,81.80528375733856,10
0.05,1022,92,83697,81.81524926686217,10
0.05,1023,93,83790,81.826171875,10
0.05,1024,93,83883,81.83707317073171,8
0.05,1025,95,83978,81.84990253411306,6
0.05,1026,95,84073,81.86270691333982,6
0.05,1027,94,84167,81.87451361867704,7
0.05,1028,94,84261,81.8862973760933,7
0.05,1029,94,84355,81.89805825242719,7
0.05,1030,92,84447,81.9078564500485,9
0.05,1031,94,84541,81.91957364341086,7
0.05,1032,20,84561,81.8596321393998,12
0.05,1033,26,84587,81.80560928433269,6
0.05,1034,93,84680,81.81642512077295,8
0.05,1035,95,84775,81.82915057915058,6
0.05,1036,95,84870,81.84185149469624,7
0.05,1037,94,84964,81.85356454720616,7
0.05,1038,94,85058,81.86525505293551,7
0.05,1039,92,85150,81.875,9
0.05,1040,92,85242,81.88472622478386,9
0.05,1041,94,85336,81.89635316698656,7
0.05,1042,93,85429,81.90699904122722,8
0.05,1043,95,85524,81.91954022988506,7
0.05,1044,27,85551,81.86698564593301,7
0.05,1045,94,85645,81.87858508604207,7
0.05,1046,93,85738,81.88920725883477,8
0.05,1047,95,85833,81.90171755725191,6
0.05,1048,93,85926,81.91229742612012,8
0.05,1049,94,86020,81.92380952380952,7
0.05,1050,96,86116,81.9372026641294,6
0.05,1051,96,86212,81.95057034220532,6
0.05,1052,22,86234,81.89363722697055,10
0.05,1053,94,86328,81.90512333965845,7
0.05,1054,94,86422,81.91658767772512,7
0.05,1055,94,86516,81.9280303030303,7
0.05,1056,94,86610,81.93945127719962,7
0.05,1057,92,86702,81.94896030245746,10
0.05,1058,95,86797,81.96128423040604,6
0.05,1059,93,86890,81.97169811320755,8
0.05,1060,94,86984,81.98303487276155,7
0.05,1061,24,87008,81.92843691148776,9
0.05,1062,94,87102,81.93979303857009,7
0.05,1063,93,87195,81.95018796992481,8
0.05,1064,95,87290,81.96244131455398,6
0.05,1065,88,87378,81.96810506566604,14
0.05,1066,95,87473,81.98031865042174,6
0.05,1067,94,87567,81.99157303370787,7
0.05,1068,96,87663,82.0046772684752,6
0.05,1069,96,87759,82.0177570093458,6
0.05,1070,94,87853,82.02894491129786,7
0.05,1071,-47,87806,81.90858208955224,12
0.05,1072,96,87902,81.92171481826654,6
0.05,1073,93,87995,81.93202979515829,8
0.05,1074,94,88089,81.94325581395348,7
0.05,1075,21,88110,81.88661710037175,11
0.05,1076,96,88206,81.89972144846797,6
0.05,1077,95,88301,81.91187384044527,6
0.05,1078,94,88395,81.92307692307692,7
0.05,1079,94,88489,81.93425925925926,7
0.05,1080,96,88585,81.9472710453284,6
0.05,1081,94,88679,81.95841035120148,7
0.05,1082,95,88774,81.97045244690673,7
0.05,1083,93,88867,81.98062730627306,9
0.05,1084,94,88961,81.99170506912442,7
0.05,1085,93,89054,82.00184162062615,8
0.05,1086,94,89148,82.0128794848206,7
0.05,1087,88,89236,82.01838235294117,13
0.05,1088,96,89332,82.03122130394857,6
0.05,1089,94,89426,82.04220183486238,8
0.05,1090,96,89522,82.05499541704857,6
0.05,1091,96,89618,82.06776556776556,6
0.05,1092,94,89712,82.0786825251601,9
0.05,1093,94,89806,82.08957952468008,7
0.05,1094,94,89900,82.10045662100457,7
0.05,1095,94,89994,82.11131386861314,7
0.05,1096,25,90019,82.05925250683683,9
0.05,1097,95,90114,82.07103825136612,6
0.05,1098,94,90208,82.08189262966333,7
0.05,1099,96,90304,82.09454545454545,6
0.05,1100,92,90396,82.10354223433242,9
0.05,1101,96,90492,82.11615245009074,6
0.05,1102,93,90585,82.1260199456029,9
0.05,1103,94,90679,82.13677536231884,7
0.05,1104,92,90771,82.14570135746607,9
0.05,1105,94,90865,82.15641952983725,7
0.05,1106,94,90959,82.16711833785004,7
0.05,1107,94,91053,82.17779783393502,7
0.05,1108,96,91149,82.190261496844,6
0.05,1109,95,91244,82.2018018018018,6
0.05,1110,88,91332,82.20702070207021,13
0.05,1111,93,91425,82.21672661870504,8
0.05,1112,93,91518,82.22641509433963,8
0.05,1113,23,91541,82.17324955116696,9
0.05,1114,94,91635,82.18385650224215,7
0.05,1115,96,91731,82.19623655913979,6
0.05,1116,96,91827,82.20859444941809,6
0.05,1117,96,91923,82.22093023255815,6
0.05,1118,95,92018,82.23235031277926,6
0.05,1119,92,92110,82.24107142857143,10
0.05,1120,92,92202,82.24977698483497,9
0.05,1121,23,92225,82.1969696969697,9
0.05,1122,94,92319,82.20747996438112,7
0.05,1123,91,92410,82.2153024911032,10
0.05,1124,96,92506,82.22755555555555,6
0.05,1125,92,92598,82.23623445825932,9
0.05,1126,95,92693,82.24755989352262,6
0.05,1127,25,92718,82.19680851063829,8
0.05,1128,94,92812,82.20726306465899,7
0.05,1129,95,92907,82.21858407079647,6
0.05,1130,93,93000,82.22811671087533,8
0.05,1131,22,93022,82.17491166077738,10
0.05,1132,96,93118,82.18711385701677,6
0.05,1133,95,93213,82.1984126984127,6
0.05,1134,94,93307,82.20881057268723,7
0.05,1135,94,93401,82.21919014084507,7
0.05,1136,96,93497,82.23131046613896,6
0.05,1137,95,93592,82.24253075571177,6
0.05,1138,95,93687,82.25373134328358,6
0.05,1139,89,93776,82.25964912280702,12
0.05,1140,25,93801,82.20946538124453,8
0.05,1141,94,93895,82.21978984238179,7
0.05,1142,96,93991,82.2318460192476,6
0.05,1143,26,94017,82.1826923076923,6
0.05,1144,27,94044,82.13449781659389,6
0.05,1145,94,94138,82.14485165794066,7
0.05,1146,92,94230,82.153443766347,9
0.05,1147,95,94325,82.16463414634147,7
0.05,1148,90,94415,82.17145343777197,11
0.05,1149,95,94510,82.18260869565218,6
0.05,1150,26,94536,82.13379669852303,8
0.05,1151,96,94632,82.14583333333333,6
0.05,1152,95,94727,82.15698178664354,6
0.05,1153,25,94752,82.10745233968804,8
0.05,1154,92,94844,82.11601731601732,9
0.05,1155,92,94936,82.12456747404845,10
0.05,1156,96,95032,82.13656006914434,6
0.05,1157,19,95051,82.08203799654576,13
0.05,1158,91,95142,82.08973252804141,10
0.05,1159,91,95233,82.09741379310344,11
0.05,1160,94,95327,82.10766580534022,7
0.05,1161,93,95420,82.1170395869191,10
0.05,1162,91,95511,82.12467755803955,10
0.05,1163,93,95604,82.1340206185567,8
0.05,1164,96,95700,82.14592274678111,6
0.05,1165,95,95795,82.15694682675814,6
0.05,1166,93,95888,82.1662382176521,9
0.05,1167,23,95911,82.11558219178082,9
0.05,1168,96,96007,82.12745936698032,6
0.05,1169,95,96102,82.13846153846154,7
0.05,1170,92,96194,82.1468830059778,9
0.05,1171,96,96290,82.15870307167235,6
0.05,1172,25,96315,82.10997442455243,7
0.05,1173,95,96410,82.12095400340715,6
0.05,1174,92,96502,82.12936170212765,9
0.05,1175,26,96528,82.08163265306122,7
0.05,1176,24,96552,82.0322854715378,8
0.05,1177,94,96646,82.04244482173175,7
0.05,1178,23,96669,81.99236641221374,9
0.05,1179,93,96762,82.00169491525423,8
0.05,1180,92,96854,82.01016088060965,10
0.05,1181,93,96947,82.01945854483925,8
0.05,1182,91,97038,82.02704987320372,10
0.05,1183,89,97127,82.0329391891892,12
0.05,1184,92,97219,82.04135021097046,9
0.05,1185,92,97311,82.04974704890388,9
0.05,1186,93,97404,82.05897219882056,8
0.05,1187,96,97500,82.07070707070707,6
0.05,1188,96,97596,82.08242220353237,6
0.05,1189,92,97688,82.09075630252102,10
0.05,1190,25,97713,82.04282115869017,8
0.05,1191,23,97736,81.99328859060402,9
0.05,1192,-117,97619,81.82648784576698,12
0.05,1193,92,97711,81.83500837520938,9
0.05,1194,95,97806,81.8460251046025,6
0.05,1195,94,97900,81.8561872909699,7
0.05,1196,89,97989,81.86215538847118,12
0.05,1197,94,98083,81.87228714524207,7
0.05,1198,96,98179,81.88407005838198,6
0.05,1199,-46,98133,81.7775,10
0.05,1200,93,98226,81.78684429641964,8
0.05,1201,95,98321,81.79783693843594,6
0.05,1202,93,98414,81.80714879467996,8
0.05,1203,94,98508,81.8172757475083,7
0.05,1204,95,98603,81.82821576763486,7
0.05,1205,22,98625,81.77860696517413,10
0.05,1206,96,98721,81.7903893951947,6
0.05,1207,96,98817,81.8021523178808,6
0.05,1208,94,98911,81.81224152191893,7
0.05,1209,96,99007,81.82396694214876,6
0.05,1210,96,99103,81.8356729975227,6
0.05,1211,96,99199,81.8473597359736,6
0.05,1212,24,99223,81.79967023907668,8
0.05,1213,94,99317,81.80971993410215,8
0.05,1214,94,99411,81.81975308641975,7
0.05,1215,95,99506,81.83059210526316,6
0.05,1216,95,99601,81.84141331142153,6
0.05,1217,92,99693,81.84975369458128,9
0.05,1218,92,99785,81.85808039376538,9
0.05,1219,93,99878,81.8672131147541,8
0.05,1220,95,99973,81.87796887796888,7
0.05,1221,92,100065,81.88625204582651,9
0.05,1222,96,100161,81.89779231398201,6
0.05,1223,94,100255,81.9076797385621,8
0.05,1224,92,100347,81.91591836734693,9
0.05,1225,96,100443,81.9274061990212,6
0.05,1226,96,100539,81.93887530562347,6
0.05,1227,94,100633,81.9486970684039,8
0.05,1228,94,100727,81.95850284784377,8
0.05,1229,92,100819,81.96666666666667,10
0.05,1230,93,100912,81.97562956945573,8
0.05,1231,96,101008,81.98701298701299,6
0.05,1232,94,101102,81.99675587996757,7
0.05,1233,94,101196,82.0064829821718,7
0.05,1234,94,101290,82.01619433198381,7
0.05,1235,96,101386,82.02750809061489,6
0.05,1236,94,101480,82.03718674211802,7
0.05,1237,91,101571,82.04442649434571,10
0.05,1238,94,101665,82.05407586763519,7
0.05,1239,24,101689,82.00725806451612,8
0.05,1240,91,101780,82.01450443190976,10
0.05,1241,94,101874,82.02415458937197,7
0.05,1242,95,101969,82.0345937248592,6
0.05,1243,95,102064,82.04501607717042,6
0.05,1244,95,102159,82.05542168674698,6
0.05,1245,96,102255,82.06661316211878,6
0.05,1246,94,102349,82.07618283881315,7
0.05,1247,93,102442,82.0849358974359,8
0.05,1248,19,102461,82.03442754203363,13
0.05,1249,94,102555,82.044,7
0.05,1250,21,102576,81.99520383693046,11
0.05,1251,94,102670,82.00479233226837,7
0.05,1252,93,102763,82.01356743814844,9
0.05,1253,95,102858,82.02392344497608,6
0.05,1254,94,102952,82.03346613545817,7
0.05,1255,96,103048,82.04458598726114,6
0.05,1256,94,103142,82.0540970564837,7
0.05,1257,96,103238,82.06518282988871,6
0.05,1258,94,103332,82.0746624305004,7
0.05,1259,92,103424,82.08253968253969,9
0.05,1260,95,103519,82.09278350515464,8
0.05,1261,95,103614,82.10301109350237,6
0.05,1262,92,103706,82.11084718923199,9
0.05,1263,91,103797,82.11787974683544,11
0.05,1264,92,103889,82.12569169960474,9
0.05,1265,94,103983,82.13507109004739,7
0.05,1266,94,104077,82.14443567482242,8
0.05,1267,96,104173,82.15536277602524,6
0.05,1268,94,104267,82.16469661150512,7
0.05,1269,-49,104218,82.06141732283464,12
0.05,1270,95,104313,82.07159716758459,7
0.05,1271,96,104409,82.08254716981132,6
0.05,1272,94,104503,82.09190887666928,7
0.05,1273,94,104597,82.10125588697018,8
0.05,1274,94,104691,82.11058823529412,7
0.05,1275,92,104783,82.11833855799372,10
0.05,1276,95,104878,82.12842599843383,6
0.05,1277,94,104972,82.1377151799687,7
0.05,1278,96,105068,82.14855355746677,6
0.05,1279,94,105162,82.1578125,7
0.05,1280,94,105256,82.16705698672912,7
0.05,1281,94,105350,82.17628705148206,7
0.05,1282,94,105444,82.18550272798129,7
0.05,1283,94,105538,82.19470404984423,7
0.05,1284,96,105634,82.20544747081712,6
0.05,1285,93,105727,82.21384136858475,8
0.05,1286,94,105821,82.22299922299922,7
0.05,1287,96,105917,82.2336956521739,6
0.05,1288,25,105942,82.18929402637704,7
0.05,1289,25,105967,82.14496124031008,7
0.05,1290,94,106061,82.15414407436096,7
0.05,1291,27,106088,82.11145510835914,6
0.05,1292,93,106181,82.11987625676721,8
0.05,1293,94,106275,82.129057187017,7
0.05,1294,92,106367,82.13667953667954,9
0.05,1295,96,106463,82.14737654320987,6
0.05,1296,92,106555,82.15497301464919,10
0.05,1297,95,106650,82.1648690292758,6
0.05,1298,94,106744,82.17397998460355,7
0.05,1299,94,106838,82.18307692307692,7
0.05,1300,23,106861,82.13758647194466,9
0.05,1301,90,106951,82.1436251920123,11
0.05,1302,91,107042,82.1504221028396,11
0.05,1303,94,107136,82.15950920245399,7
0.05,1304,27,107163,82.11724137931034,6
0.05,1305,94,107257,82.12633996937213,7
0.05,1306,94,107351,82.13542463657231,7
0.05,1307,94,107445,82.14449541284404,8
0.05,1308,92,107537,82.1520244461421,9
0.05,1309,24,107561,82.10763358778625,8
0.05,1310,25,107586,82.06407322654462,8
0.05,1311,96,107682,82.07469512195122,6
0.05,1312,96,107778,82.08530083777609,6
0.05,1313,94,107872,82.09436834094369,8
0.05,1314,26,107898,82.05171102661598,6
0.05,1315,90,107988,82.05775075987842,11
0.05,1316,94,108082,82.0668185269552,8
0.05,1317,92,108174,82.07435508345979,9
0.05,1318,95,108269,82.0841546626232,6
0.05,1319,27,108296,82.04242424242425,6
0.05,1320,96,108392,82.05299015897047,6
0.05,1321,95,108487,82.06278366111951,6
0.05,1322,94,108581,82.07180650037793,7
0.05,1323,95,108676,82.08157099697885,6
0.05,1324,96,108772,82.09207547169811,6
0.05,1325,94,108866,82.10105580693816,7
0.05,1326,94,108960,82.11002260738508,7
0.05,1327,96,109056,82.12048192771084,6
0.05,1328,95,109151,82.13017306245297,6
0.05,1329,95,109246,82.13984962406015,6
0.05,1330,93,109339,82.14800901577762,8
0.05,1331,92,109431,82.1554054054054,9
0.05,1332,93,109524,82.16354088522131,10
0.05,1333,94,109618,82.17241379310344,8
0.05,1334,93,109711,82.18052434456929,8
0.05,1335,96,109807,82.19086826347305,6
0.05,1336,24,109831,82.14734480179506,8
0.05,1337,95,109926,82.15695067264573,6
0.05,1338,89,110015,82.16206123973114,12
0.05,1339,96,110111,82.17238805970149,6
0.05,1340,23,110134,82.1282624906786,9
0.05,1341,94,110228,82.1371087928465,7
0.05,1342,93,110321,82.1451973194341,8
0.05,1343,94,110415,82.15401785714286,8
0.05,1344,24,110439,82.11078066914499,8
0.05,1345,94,110533,82.11961367013373,7
0.05,1346,95,110628,82.12917594654789,6
0.05,1347,92,110720,82.13649851632047,9
0.05,1348,93,110813,82.14455151964418,8
0.05,1349,94,110907,82.15333333333334,7
0.05,1350,91,110998,82.159881569208,10
0.05,1351,95,111093,82.16937869822485,6
0.05,1352,93,111186,82.17738359201773,8
0.05,1353,94,111280,82.1861152141802,7
0.05,1354,96,111376,82.19630996309964,6
0.05,1355,90,111466,82.20206489675516,11
0.05,1356,95,111561,82.21149594694178,6
0.05,1357,94,111655,82.220176730486,7
0.05,1358,95,111750,82.22958057395144,7
0.05,1359,95,111845,82.23897058823529,7
0.05,1360,94,111939,82.24761204996327,7
0.05,1361,95,112034,82.25697503671071,6
0.05,1362,91,112125,82.26338958180484,10
0.05,1363,94,112219,82.27199413489735,8
0.05,1364,25,112244,82.23003663003664,8
0.05,1365,95,112339,82.2393850658858,6
0.05,1366,93,112432,82.24725676664228,8
0.05,1367,94,112526,82.25584795321637,7
0.05,1368,25,112551,82.21402483564646,8
0.05,1369,96,112647,82.22408759124087,6
0.05,1370,95,112742,82.23340627279359,6
0.05,1371,95,112837,82.24271137026238,6
0.05,1372,92,112929,82.24981791697014,9
0.05,1373,95,113024,82.25909752547307,6
0.05,1374,94,113118,82.26763636363637,8
0.05,1375,18,113136,82.22093023255815,14
0.05,1376,94,113230,82.22948438634714,7
0.05,1377,94,113324,82.23802612481857,9
0.05,1378,94,113418,82.24655547498188,7
0.05,1379,94,113512,82.25507246376812,7
0.05,1380,96,113608,82.26502534395365,6
0.05,1381,93,113701,82.27279305354558,8
0.05,1382,95,113796,82.28199566160521,6
0.05,1383,96,113892,82.29190751445087,6
0.05,1384,92,113984,82.29891696750903,9
0.05,1385,92,114076,82.30591630591631,10
0.05,1386,94,114170,82.31434751261716,7
0.05,1387,95,114265,82.32348703170028,6
0.05,1388,94,114359,82.33189344852411,7
0.05,1389,94,114453,82.34028776978417,7
0.05,1390,94,114547,82.34867002156722,7
0.05,1391,96,114643,82.35847701149426,6
0.05,1392,95,114738,82.36755204594401,6
0.05,1393,96,114834,82.37733142037303,6
0.05,1394,94,114928,82.38566308243728,7
0.05,1395,94,115022,82.39398280802293,7
0.05,1396,96,115118,82.40372226198998,6
0.05,1397,96,115214,82.4134477825465,6
0.05,1398,94,115308,82.42172980700501,7
0.05,1399,94,115402,82.43,7
0.05,1400,94,115496,82.43825838686652,7
0.05,1401,91,115587,82.44436519258203,12
0.05,1402,96,115683,82.45402708481825,6
0.05,1403,23,115706,82.41168091168092,9
0.05,1404,95,115801,82.42064056939502,6
0.05,1405,95,115896,82.42958748221906,6
0.05,1406,94,115990,82.43781094527363,7
0.05,1407,94,116084,82.44602272727273,7
0.05,1408,92,116176,82.45280340667139,9
0.05,1409,90,116266,82.45815602836879,11
0.05,1410,94,116360,82.46633593196314,7
0.05,1411,95,116455,82.47521246458923,7
0.05,1412,94,116549,82.48336871903751,7
0.05,1413,94,116643,82.49151343705799,7
0.05,1414,95,116738,82.50035335689046,7
0.05,1415,92,116830,82.50706214689265,9
0.05,1416,94,116924,82.51517290049401,7
0.05,1417,94,117018,82.52327221438647,7
0.05,1418,96,117114,82.53276955602537,6
0.05,1419,93,117207,82.54014084507043,8
0.05,1420,94,117301,82.54820548909218,7
0.05,1421,94,117395,82.556258790436,7
0.05,1422,93,117488,82.56359803232607,9
0.05,1423,96,117584,82.57303370786516,6
0.05,1424,94,117678,82.58105263157894,8
0.05,1425,91,117769,82.58695652173913,11
0.05,1426,94,117863,82.59495444989489,7
0.05,1427,24,117887,82.55392156862744,8
0.05,1428,95,117982,82.56263121063681,6
0.05,1429,95,118077,82.57132867132867,6
0.05,1430,95,118172,82.5800139762404,6
0.05,1431,93,118265,82.5872905027933,8
0.05,1432,95,118360,82.59595254710398,7
0.05,1433,94,118454,82.60390516039051,8
0.05,1434,95,118549,82.61254355400696,7
0.05,1435,96,118645,82.62186629526462,6
0.05,1436,95,118740,82.63048016701461,6
0.05,1437,96,118836,82.63977746870654,6
0.05,1438,94,118930,82.64767199444059,7
0.05,1439,92,119022,82.65416666666667,9
0.05,1440,96,119118,82.66342817487856,6
0.05,1441,95,119213,82.67198335644937,6
0.05,1442,95,119308,82.68052668052668,8
0.05,1443,-52,119256,82.58725761772853,15
0.05,1444,94,119350,82.59515570934256,7
0.05,1445,94,119444,82.6030428769018,7
0.05,1446,95,119539,82.61161022805805,6
0.05,1447,94,119633,82.61947513812154,7
0.05,1448,96,119729,82.62870945479641,6
0.05,1449,94,119823,82.63655172413793,7
0.05,1450,23,119846,82.59545141281875,9
0.05,1451,95,119941,82.60399449035813,6
0.05,1452,96,120037,82.61321403991741,6
0.05,1453,94,120131,82.62104539202201,7
0.05,1454,94,120225,82.62886597938144,8
0.05,1455,94,120319,82.63667582417582,7
0.05,1456,26,120345,82.59780370624571,6
0.05,1457,92,120437,82.6042524005487,9
0.05,1458,91,120528,82.6100068540096,11
0.05,1459,94,120622,82.61780821917809,7
0.05,1460,96,120718,82.62696783025325,6
0.05,1461,94,120812,82.63474692202462,7
0.05,1462,95,120907,82.6431989063568,6
0.05,1463,93,121000,82.65027322404372,8
0.05,1464,-116,120884,82.51467576791809,10
0.05,1465,96,120980,82.52387448840382,6
0.05,1466,94,121074,82.5316973415133,7
0.05,1467,94,121168,82.53950953678473,8
0.05,1468,96,121264,82.54867256637168,6
0.05,1469,94,121358,82.55646258503401,8
0.05,1470,96,121454,82.56560163154317,6
0.05,1471,27,121481,82.52785326086956,6
0.05,1472,91,121572,82.53360488798371,10
0.05,1473,94,121666,82.54138398914519,7
0.05,1474,94,121760,82.54915254237288,7
0.05,1475,23,121783,82.50880758807588,9
0.05,1476,93,121876,82.51591062965471,9
0.05,1477,90,121966,82.52097428958051,11
0.05,1478,96,122062,82.53008789722786,6
0.05,1479,91,122153,82.53581081081082,10
0.05,1480,95,122248,82.54422687373396,6
0.05,1481,94,122342,82.5519568151147,7
0.05,1482,22,122364,82.51112609575185,10
0.05,1483,94,122458,82.51886792452831,7
0.05,1484,94,122552,82.52659932659932,7
0.05,1485,94,122646,82.53432032301481,7
0.05,1486,95,122741,82.54270342972428,6
0.05,1487,94,122835,82.55040322580645,7
0.05,1488,96,122931,82.5594358629953,6
0.05,1489,94,123025,82.56711409395973,7
0.05,1490,94,123119,82.57478202548626,7
0.05,1491,94,123213,82.58243967828419,7
0.05,1492,94,123307,82.59008707300737,7
0.05,1493,94,123401,82.59772423025436,8
0.05,1494,94,123495,82.60535117056857,7
0.05,1495,96,123591,82.61430481283422,6
0.05,1496,94,123685,82.62191048764196,7
0.05,1497,22,123707,82.58144192256341,10
0.05,1498,96,123803,82.59039359573049,6
0.05,1499,94,123897,82.598,8
0.05,1500,95,123992,82.60626249167221,6
0.05,1501,95,124087,82.61451398135819,7
0.05,1502,95,124182,82.62275449101796,6
0.05,1503,94,124276,82.63031914893617,7
0.05,1504,25,124301,82.59202657807309,7
0.05,1505,93,124394,82.59893758300133,8
0.05,1506,95,124489,82.60716655607166,6
0.05,1507,89,124578,82.61140583554376,12
0.05,1508,26,124604,82.5738899933731,8
0.05,1509,95,124699,82.58211920529801,6
0.05,1510,92,124791,82.58835208471211,9
0.05,1511,91,124882,82.59391534391534,11
0.05,1512,94,124976,82.60145406477197,7
0.05,1513,96,125072,82.61030383091149,6
0.05,1514,95,125167,82.61848184818481,6
0.05,1515,95,125262,82.62664907651715,6
0.05,1516,92,125354,82.63282794990113,9
0.05,1517,22,125376,82.59288537549408,10
0.05,1518,93,125469,82.5997366688611,8
0.05,1519,94,125563,82.60723684210527,7
0.05,1520,90,125653,82.612097304405,11
0.05,1521,94,125747,82.61957950065703,7
0.05,1522,93,125840,82.62639527248851,8
0.05,1523,94,125934,82.63385826771653,7
0.05,1524,85,126019,82.63540983606558,17
0.05,1525,96,126115,82.64416775884666,6
0.05,1526,94,126209,82.65160445317616,7
0.05,1527,94,126303,82.65903141361257,7
0.05,1528,96,126399,82.66775670372793,6
0.05,1529,93,126492,82.67450980392157,8
0.05,1530,24,126516,82.63618549967342,9
0.05,1531,94,126610,82.64360313315927,7
0.05,1532,96,126706,82.65231572080887,6
0.05,1533,95,126801,82.66036505867014,6
0.05,1534,95,126896,82.66840390879479,6
0.05,1535,94,126990,82.67578125,7
0.05,1536,94,127084,82.68314899154197,7
0.05,1537,91,127175,82.68855656697009,10
0.05,1538,93,127268,82.69525666016894,8
0.05,1539,23,127291,82.6564935064935,9
0.05,1540,95,127386,82.66450356911096,8
0.05,1541,93,127479,82.67120622568093,8
0.05,1542,94,127573,82.67854828256642,7
0.05,1543,93,127666,82.68523316062176,8
0.05,1544,94,127760,82.69255663430421,7
0.05,1545,92,127852,82.69857697283312,9
0.05,1546,27,127879,82.66257272139624,6
0.05,1547,-44,127835,82.58074935400516,8
0.05,1548,94,127929,82.58812136862493,7
0.05,1549,96,128025,82.59677419354838,6
0.05,1550,96,128121,82.60541586073501,7
0.05,1551,92,128213,82.61146907216495,9
0.05,1552,92,128305,82.61751448808758,9
0.05,1553,93,128398,82.62419562419562,8
0.05,1554,93,128491,82.63086816720258,8
0.05,1555,93,128584,82.63753213367609,8
0.05,1556,93,128677,82.6441875401413,8
0.05,1557,95,128772,82.65211810012838,6
0.05,1558,94,128866,82.65939704939063,7
0.05,1559,95,128961,82.66730769230769,7
0.05,1560,93,129054,82.6739269698911,9
0.05,1561,94,129148,82.68117797695263,8
0.05,1562,93,129241,82.68777991042866,8
0.05,1563,96,129337,82.6962915601023,6
0.05,1564,92,129429,82.70223642172525,9
0.05,1565,95,129524,82.71008939974458,6
0.05,1566,95,129619,82.71793235481812,7
0.05,1567,23,129642,82.67984693877551,10
0.05,1568,94,129736,82.68706182281709,7
0.05,1569,95,129831,82.69490445859873,6
0.05,1570,94,129925,82.70210057288351,7
0.05,1571,96,130021,82.71055979643766,6
0.05,1572,94,130115,82.7177368086459,7
0.05,1573,95,130210,82.72554002541295,7
0.05,1574,26,130236,82.6895238095238,7
0.05,1575,94,130330,82.69670050761421,7
0.05,1576,93,130423,82.70323398858592,8
0.05,1577,94,130517,82.71039290240812,7
0.05,1578,20,130537,82.67067764407854,12
0.05,1579,95,130632,82.67848101265822,6
0.05,1580,95,130727,82.68627450980392,6
0.05,1581,94,130821,82.69342604298356,7
0.05,1582,94,130915,82.70056854074542,8
0.05,1583,93,131008,82.70707070707071,8
0.05,1584,96,131104,82.71545741324921,6
0.05,1585,23,131127,82.67780580075662,9
0.05,1586,96,131223,82.68620037807183,6
0.05,1587,96,131319,82.69458438287154,6
0.05,1588,94,131413,82.7016991818754,7
0.05,1589,95,131508,82.70943396226416,7
0.05,1590,94,131602,82.71653048397235,7
0.05,1591,94,131696,82.72361809045226,7
0.05,1592,92,131788,82.7294413057125,10
0.05,1593,26,131814,82.69385194479297,7
0.05,1594,95,131909,82.70156739811912,6
0.05,1595,96,132005,82.70989974937343,6
0.05,1596,94,132099,82.71696931747026,8
0.05,1597,94,132193,82.72403003754694,7
0.05,1598,94,132287,82.73108192620387,7
0.05,1599,26,132313,82.695625,6
0.05,1600,95,132408,82.70331043098064,7
0.05,1601,95,132503,82.71098626716605,6
0.05,1602,94,132597,82.71802869619464,7
0.05,1603,96,132693,82.72630922693267,6
0.05,1604,25,132718,82.69034267912772,7
0.05,1605,94,132812,82.69738480697384,7
0.05,1606,90,132902,82.70192906036092,11
0.05,1607,96,132998,82.71019900497512,6
0.05,1608,94,133092,82.7172156619018,7
0.05,1609,95,133187,82.72484472049689,6
0.05,1610,93,133280,82.7312228429547,8
0.05,1611,95,133375,82.73883374689827,6
0.05,1612,94,133469,82.74581525108493,7
0.05,1613,94,133563,82.75278810408922,7
0.05,1614,23,133586,82.71578947368421,9
0.05,1615,94,133680,82.72277227722772,7
0.05,1616,22,133702,82.6852195423624,10
0.05,1617,94,133796,82.69221260815821,8
0.05,1618,96,133892,82.70043236565782,6
0.05,1619,93,133985,82.70679012345678,8
0.05,1620,94,134079,82.7137569401604,7
0.05,1621,93,134172,82.72009864364982,8
0.05,1622,92,134264,82.72581638940234,9
0.05,1623,93,134357,82.73214285714286,8
0.05,1624,94,134451,82.73907692307692,7
0.05,1625,95,134546,82.74661746617465,6
0.05,1626,95,134641,82.7541487400123,6
0.05,1627,94,134735,82.76105651105651,7
0.05,1628,94,134829,82.76795580110497,7
0.05,1629,96,134925,82.7760736196319,6
0.05,1630,95,135020,82.7835683629675,6
0.05,1631,93,135113,82.78982843137256,8
0.05,1632,94,135207,82.79669320269443,7
0.05,1633,94,135301,82.80354957160343,7
0.05,1634,94,135395,82.81039755351682,7
0.05,1635,93,135488,82.81662591687042,8
0.05,1636,94,135582,82.82345754428833,8
0.05,1637,94,135676,82.83028083028083,7
0.05,1638,23,135699,82.79377669310556,9
0.05,1639,96,135795,82.80182926829268,6
0.05,1640,24,135819,82.76599634369288,11
0.05,1641,24,135843,82.73020706455542,9
0.05,1642,89,135932,82.73402312842362,12
0.05,1643,94,136026,82.74087591240875,7
0.05,1644,94,136120,82.74772036474164,7
0.05,1645,96,136216,82.75577156743621,6
0.05,1646,94,136310,82.76259866423801,7
0.05,1647,93,136403,82.76881067961165,8
0.05,1648,25,136428,82.7337780473014,7
0.05,1649,95,136523,82.74121212121211,6
0.05,1650,94,136617,82.74803149606299,7
0.05,1651,93,136710,82.7542372881356,8
0.05,1652,93,136803,82.76043557168784,8
0.05,1653,24,136827,82.72490931076179,8
0.05,1654,95,136922,82.73232628398792,8
0.05,1655,23,136945,82.69625603864735,9
0.05,1656,25,136970,82.66143633071816,7
0.05,1657,95,137065,82.66887816646562,6
0.05,1658,94,137159,82.67570825798674,7
0.05,1659,94,137253,82.68253012048193,7
0.05,1660,88,137341,82.68573148705599,13
0.05,1661,96,137437,82.69374247894103,6
0.05,1662,96,137533,82.70174383644017,6
0.05,1663,94,137627,82.70853365384616,7
0.05,1664,27,137654,82.67507507507507,6
0.05,1665,95,137749,82.68247298919567,8
0.05,1666,94,137843,82.68926214757049,7
0.05,1667,92,137935,82.69484412470024,9
0.05,1668,95,138030,82.70221689634512,6
0.05,1669,95,138125,82.70958083832335,6
0.05,1670,96,138221,82.71753441053262,6
0.05,1671,24,138245,82.68241626794259,8
0.05,1672,96,138341,82.69037656903765,6
0.05,1673,94,138435,82.69713261648745,7
0.05,1674,94,138529,82.70388059701493,7
0.05,1675,94,138623,82.71062052505967,7
0.05,1676,27,138650,82.67740011926058,6
0.05,1677,93,138743,82.68355184743743,8
0.05,1678,94,138837,82.69029184038118,7
0.05,1679,94,138931,82.69702380952381,7
0.05,1680,94,139025,82.70374776918501,7
0.05,1681,93,139118,82.70986920332938,8
0.05,1682,91,139209,82.71479500891266,11
0.05,1683,96,139305,82.72268408551069,6
0.05,1684,91,139396,82.72759643916913,10
0.05,1685,94,139490,82.73428232502965,8
0.05,1686,92,139582,82.7397747480735,10
0.05,1687,93,139675,82.74585308056872,8
0.05,1688,26,139701,82.71225577264654,6
0.05,1689,95,139796,82.71952662721894,6
0.05,1690,22,139818,82.6836191602602,10
0.05,1691,94,139912,82.6903073286052,7
0.05,1692,93,140005,82.69639692852924,8
0.05,1693,92,140097,82.70188902007084,9
0.05,1694,94,140191,82.70855457227138,7
0.05,1695,24,140215,82.67393867924528,8
0.05,1696,27,140242,82.64113140836771,6
0.05,1697,96,140338,82.6489988221437,6
0.05,1698,94,140432,82.65567981165391,7
0.05,1699,96,140528,82.6635294117647,6
0.05,1700,94,140622,82.67019400352734,7
0.05,1701,25,140647,82.63631022326675,8
0.05,1702,96,140743,82.6441573693482,6
0.05,1703,96,140839,82.65199530516432,6
0.05,1704,96,140935,82.65982404692082,6
0.05,1705,93,141028,82.66588511137164,8
0.05,1706,95,141123,82.67311072056239,7
0.05,1707,94,141217,82.67974238875878,7
0.05,1708,90,141307,82.68402574605032,11
0.05,1709,95,141402,82.69122807017544,6
0.05,1710,94,141496,82.69783752191701,7
0.05,1711,96,141592,82.70560747663552,6
0.05,1712,90,141682,82.7098657326328,11
0.05,1713,95,141777,82.71703617269544,6
0.05,1714,91,141868,82.72186588921282,10
0.05,1715,96,141964,82.72960372960372,6
0.05,1716,24,141988,82.69539895165987,8
0.05,1717,95,142083,82.70256111757858,7
0.05,1718,96,142179,82.71029668411867,6
0.05,1719,95,142274,82.71744186046512,6
0.05,1720,96,142370,82.72515979081929,6
0.05,1721,94,142464,82.73170731707317,9
0.05,1722,95,142559,82.73882762623332,8
0.05,1723,93,142652,82.74477958236659,8
0.05,1724,95,142747,82.75188405797101,6
0.05,1725,96,142843,82.7595596755504,6
0.05,1726,94,142937,82.76606832657788,7
0.05,1727,94,143031,82.77256944444444,7
0.05,1728,93,143124,82.77848467322151,8
0.05,1729,92,143216,82.78381502890173,10
0.05,1730,93,143309,82.78971692663201,8
0.05,1731,95,143404,82.79676674364896,7
0.05,1732,94,143498,82.80323139065204,7
0.05,1733,25,143523,82.76989619377163,7
0.05,1734,94,143617,82.7763688760807,7
0.05,1735,95,143712,82.78341013824885,6
0.05,1736,92,143804,82.78871617731721,9
0.05,1737,27,143831,82.7566168009206,6
0.05,1738,95,143926,82.76365727429557,6
0.05,1739,92,144018,82.76896551724138,9
0.05,1740,94,144112,82.7754164273406,7
0.05,1741,95,144207,82.78243398392652,8
0.05,1742,93,144300,82.78829604130809,8
0.05,1743,94,144394,82.7947247706422,7
0.05,1744,94,144488,82.80114613180515,8
0.05,1745,94,144582,82.80756013745705,7
0.05,1746,96,144678,82.81511161991986,6
0.05,1747,26,144704,82.78260869565217,8
0.05,1748,94,144798,82.78902229845626,7
0.05,1749,93,144891,82.79485714285714,8
0.05,1750,94,144985,82.80125642490006,7
0.05,1751,96,145081,82.8087899543379,6
0.05,1752,95,145176,82.81574443810611,6
0.05,1753,95,145271,82.82269099201824,7
0.05,1754,21,145292,82.78746438746438,12
0.05,1755,94,145386,82.79384965831436,7
0.05,1756,-45,145341,82.7211155378486,8
0.05,1757,94,145435,82.72753128555176,7
0.05,1758,94,145529,82.73393973848778,7
0.05,1759,95,145624,82.74090909090908,8
0.05,1760,91,145715,82.74559909142533,10
0.05,1761,95,145810,82.75255391600454,6
0.05,1762,93,145903,82.75836642087351,8
0.05,1763,95,145998,82.76530612244898,6
0.05,1764,95,146093,82.77223796033995,6
0.05,1765,94,146187,82.77859569648925,7
0.05,1766,18,146205,82.74193548387096,14
0.05,1767,94,146299,82.74830316742081,9
0.05,1768,25,146324,82.71565856416055,7
0.05,1769,96,146420,82.7231638418079,6
0.05,1770,95,146515,82.73009599096555,6
0.05,1771,94,146609,82.7364559819413,7
0.05,1772,94,146703,82.74280879864637,8
0.05,1773,94,146797,82.74915445321308,7
0.05,1774,95,146892,82.75605633802817,7
0.05,1775,95,146987,82.76295045045045,6
0.05,1776,94,147081,82.76927405740011,8
0.05,1777,94,147175,82.7755905511811,7
0.05,1778,95,147270,82.78246205733558,7
0.05,1779,94,147364,82.78876404494382,9
0.05,1780,26,147390,82.75687815833801,8
0.05,1781,93,147483,82.76262626262626,8
0.05,1782,95,147578,82.76948962422883,7
0.05,1783,94,147672,82.77578475336323,7
0.05,1784,94,147766,82.78207282913165,7
0.05,1785,96,147862,82.78947368421052,6
0.05,1786,93,147955,82.79518746502518,9
0.05,1787,94,148049,82.80145413870247,7
0.05,1788,92,148141,82.80659586361095,9
0.05,1789,24,148165,82.77374301675978,9
0.05,1790,94,148259,82.78001116694584,7
0.05,1791,92,148351,82.78515625,9
0.05,1792,92,148443,82.79029559397658,9
0.05,1793,94,148537,82.79654403567447,7
0.05,1794,96,148633,82.80389972144847,6
0.05,1795,94,148727,82.81013363028953,7
0.05,1796,92,148819,82.81524763494713,9
0.05,1797,95,148914,82.82202447163515,6
0.05,1798,96,149010,82.82934963868816,6
0.05,1799,95,149105,82.83611111111111,6
0.05,1800,95,149200,82.84286507495835,6
0.05,1801,95,149295,82.8496115427303,6
0.05,1802,93,149388,82.85524126455907,8
0.05,1803,96,149484,82.86252771618625,6
0.05,1804,94,149578,82.86869806094182,7
0.05,1805,96,149674,82.87596899224806,6
0.05,1806,92,149766,82.88101826231323,9
0.05,1807,93,149859,82.88661504424779,8
0.05,1808,94,149953,82.89275843007186,8
0.05,1809,95,150048,82.89944751381215,6
0.05,1810,26,150074,82.868028713418,6
0.05,1811,94,150168,82.87417218543047,7
0.05,1812,27,150195,82.84335355763928,6
0.05,1813,92,150287,82.84840132304299,9
0.05,1814,27,150314,82.81763085399449,6
0.05,1815,94,150408,82.8237885462555,7
0.05,1816,94,150502,82.82993946064943,10
0.05,1817,94,150596,82.83608360836084,7
0.05,1818,96,150692,82.8433205057724,6
0.05,1819,93,150785,82.8489010989011,8
0.05,1820,92,150877,82.85392641405821,9
0.05,1821,94,150971,82.86004390779364,8
0.05,1822,96,151067,82.86725178277564,6
0.05,1823,93,151160,82.87280701754386,8
0.05,1824,94,151254,82.87890410958904,7
0.05,1825,94,151348,82.88499452354874,7
0.05,1826,91,151439,82.88943623426383,10
0.05,1827,95,151534,82.89606126914661,6
0.05,1828,-117,151417,82.78676872607983,11
0.05,1829,21,151438,82.75300546448088,11
0.05,1830,94,151532,82.7591480065538,7
0.05,1831,93,151625,82.76473799126637,8
0.05,1832,94,151719,82.7708674304419,7
0.05,1833,95,151814,82.77753544165758,6
0.05,1834,94,151908,82.78365122615804,7
0.05,1835,92,152000,82.78867102396514,9
0.05,1836,95,152095,82.79531845400109,6
0.05,1837,95,152190,82.80195865070729,6
0.05,1838,96,152286,82.80913539967374,7
0.05,1839,27,152313,82.77880434782608,6
0.05,1840,95,152408,82.78544269418794,7
0.05,1841,95,152503,82.79207383279045,6
0.05,1842,94,152597,82.79815518176885,7
0.05,1843,92,152689,82.8031453362256,10
0.05,1844,93,152782,82.80867208672086,8
0.05,1845,94,152876,82.81473456121343,7
0.05,1846,96,152972,82.82187330806714,6
0.05,1847,93,153065,82.82738095238095,8
0.05,1848,94,153159,82.8334234721471,8
0.05,1849,94,153253,82.83945945945946,7
0.05,1850,96,153349,82.84656942193409,6
0.05,1851,95,153444,82.85313174946005,6
0.05,1852,94,153538,82.85914732865623,7
0.05,1853,96,153634,82.86623516720604,6
0.05,1854,96,153730,82.8733153638814,6
0.05,1855,96,153826,82.88038793103448,6
0.05,1856,94,153920,82.88637587506732,7
0.05,1857,96,154016,82.89343379978472,6
0.05,1858,94,154110,82.89940828402366,7
0.05,1859,94,154204,82.90537634408602,7
0.05,1860,93,154297,82.91080064481461,8
0.05,1861,94,154391,82.91675617615468,7
0.05,1862,94,154485,82.92270531400966,8
0.05,1863,93,154578,82.92811158798283,8
0.05,1864,94,154672,82.93404825737265,7
0.05,1865,23,154695,82.90192926045016,10
0.05,1866,25,154720,82.8709159078736,8
0.05,1867,94,154814,82.87687366167023,7
0.05,1868,95,154909,82.88336008560728,6
0.05,1869,25,154934,82.8524064171123,7
0.05,1870,21,154955,82.81934794227686,11
0.05,1871,96,155051,82.82638888888889,6
0.05,1872,94,155145,82.83235451147891,7
0.05,1873,96,155241,82.83938100320171,6
0.05,1874,96,155337,82.8464,6
0.05,1875,93,155430,82.85181236673775,8
0.05,1876,91,155521,82.85615343633458,10
0.05,1877,92,155613,82.86102236421725,9
0.05,1878,93,155706,82.86641830761043,8
0.05,1879,94,155800,82.87234042553192,7
0.05,1880,23,155823,82.84051036682615,9
0.05,1881,25,155848,82.80977683315622,7
0.05,1882,94,155942,82.81571959638875,8
0.05,1883,94,156036,82.82165605095541,7
0.05,1884,94,156130,82.82758620689656,7
0.05,1885,91,156221,82.83191940615059,10
0.05,1886,27,156248,82.80233174350822,6
0.05,1887,88,156336,82.80508474576271,13
0.05,1888,94,156430,82.81101111699311,7
0.05,1889,95,156525,82.81746031746032,6
0.05,1890,92,156617,82.8223162347964,9
0.05,1891,94,156711,82.82822410147992,8
0.05,1892,94,156805,82.83412572636027,7
0.05,1893,94,156899,82.84002111932418,7
0.05,1894,22,156921,82.80791556728232,10
0.05,1895,94,157015,82.81381856540085,8
0.05,1896,94,157109,82.81971534001055,7
0.05,1897,18,157127,82.78556375131717,14
0.05,1898,95,157222,82.79199578725645,6
0.05,1899,95,157317,82.79842105263158,6
0.05,1900,94,157411,82.80431351920042,7
0.05,1901,96,157507,82.8112513144059,6
0.05,1902,94,157601,82.81713084603258,7
0.05,1903,94,157695,82.82300420168067,7
0.05,1904,95,157790,82.82939632545931,6
0.05,1905,92,157882,82.83420776495278,9
0.05,1906,25,157907,82.80388044048243,7
0.05,1907,94,158001,82.80974842767296,7
0.05,1908,95,158096,82.81613410162389,6
0.05,1909,96,158192,82.82303664921466,6
0.05,1910,95,158287,82.82940868655155,6
0.05,1911,91,158378,82.8336820083682,10
0.05,1912,96,158474,82.84056455828542,6
0.05,1913,94,158568,82.84639498432603,7
0.05,1914,96,158664,82.8532637075718,6
0.05,1915,96,158760,82.86012526096033,6
0.05,1916,23,158783,82.82889932185707,9
0.05,1917,96,158879,82.83576642335767,6
0.05,1918,23,158902,82.80458572173006,9
0.05,1919,95,158997,82.8109375,6
0.05,1920,95,159092,82.8172826652785,6
0.05,1921,94,159186,82.82310093652445,7
0.05,1922,95,159281,82.82943317732709,7
0.05,1923,23,159304,82.79833679833679,9
0.05,1924,96,159400,82.8051948051948,6
0.05,1925,94,159494,82.8110072689512,7
0.05,1926,96,159590,82.81785158277114,6
0.05,1927,95,159685,82.82417012448133,6
0.05,1928,96,159781,82.83100051840331,6
0.05,1929,93,159874,82.83626943005181,8
0.05,1930,95,159969,82.84256861729673,6
0.05,1931,94,160063,82.84834368530021,7
0.05,1932,25,160088,82.81841696844283,8
0.05,1933,26,160114,82.78903826266804,7
0.05,1934,93,160207,82.79431524547803,8
0.05,1935,23,160230,82.76342975206612,9
0.05,1936,93,160323,82.76871450696954,8
0.05,1937,90,160413,82.77244582043343,11
0.05,1938,94,160507,82.77823620422899,7
0.05,1939,92,160599,82.78298969072165,10
0.05,1940,93,160692,82.78825347758887,8
0.05,1941,92,160784,82.79299691040164,9
0.05,1942,95,160879,82.79927946474524,6
0.05,1943,96,160975,82.80606995884774,6
0.05,1944,88,161063,82.80874035989717,13
0.05,1945,92,161155,82.81346351490237,9
0.05,1946,94,161249,82.81920903954803,7
0.05,1947,96,161345,82.82597535934292,6
0.05,1948,94,161439,82.83170856849667,7
0.05,1949,96,161535,82.83846153846154,6
0.05,1950,96,161631,82.8452075858534,6
0.05,1951,95,161726,82.8514344262295,6
0.05,1952,94,161820,82.85714285714286,7
0.05,1953,96,161916,82.86386898669396,6
0.05,1954,95,162011,82.87007672634272,6
0.05,1955,94,162105,82.87576687116564,7
0.05,1956,91,162196,82.87991824220747,10
0.05,1957,92,162288,82.88457609805924,9
0.05,1958,93,162381,82.88973966309341,8
0.05,1959,94,162475,82.8954081632653,8
0.05,1960,94,162569,82.90107088220296,7
0.05,1961,96,162665,82.90774719673803,6
0.05,1962,94,162759,82.91339786041773,7
0.05,1963,93,162852,82.91853360488798,8
0.05,1964,92,162944,82.92315521628498,9
0.05,1965,93,163037,82.92828077314344,8
0.05,1966,94,163131,82.93390950686324,7
0.05,1967,21,163152,82.90243902439025,13
0.05,1968,94,163246,82.9080751650584,7
0.05,1969,95,163341,82.91421319796954,6
0.05,1970,96,163437,82.92085235920852,6
0.05,1971,24,163461,82.89097363083164,8
0.05,1972,95,163556,82.89711099847948,6
0.05,1973,94,163650,82.90273556231003,8
0.05,1974,94,163744,82.90835443037975,7
0.05,1975,92,163836,82.91295546558705,9
0.05,1976,94,163930,82.91856348002024,7
0.05,1977,95,164025,82.92467138523762,6
0.05,1978,94,164119,82.93026781202627,7
0.05,1979,94,164213,82.93585858585858,8
0.05,1980,94,164307,82.9414437152953,7
0.05,1981,94,164401,82.94702320887991,7
0.05,1982,21,164422,82.91578416540595,11
0.05,1983,93,164515,82.92086693548387,8
0.05,1984,94,164609,82.92644836272041,7
0.05,1985,96,164705,82.9330312185297,6
0.05,1986,96,164801,82.93960744841469,6
0.05,1987,94,164895,82.94517102615694,7
0.05,1988,94,164989,82.95072900955253,7
0.05,1989,94,165083,82.95628140703518,7
0.05,1990,93,165176,82.96132596685082,8
0.05,1991,94,165270,82.96686746987952,7
0.05,1992,25,165295,82.93778223783241,7
0.05,1993,94,165389,82.94332998996991,7
0.05,1994,96,165485,82.9498746867168,6
0.05,1995,27,165512,82.92184368737475,6
0.05,1996,94,165606,82.92739108662994,7
0.05,1997,95,165701,82.93343343343344,6
0.05,1998,25,165726,82.90445222611305,7
0.05,1999,92,165818,82.909,9
0.05,2000,96,165914,82.91554222888556,6
0.05,2001,94,166008,82.92107892107892,7
0.05,2002,96,166104,82.92760858711932,6
0.05,2003,95,166199,82.93363273453093,6
0.05,2004,94,166293,82.93915211970075,8
0.05,2005,91,166384,82.94317048853439,10
0.05,2006,94,166478,82.94867962132537,7
0.05,2007,94,166572,82.95418326693228,7
0.05,2008,92,166664,82.95868591338974,9
0.05,2009,94,166758,82.96417910447761,8
0.05,2010,95,166853,82.97016409746395,6
0.05,2011,94,166947,82.97564612326043,7
0.05,2012,94,167041,82.98112270243418,8
0.05,2013,94,167135,82.9865938430983,7
0.05,2014,96,167231,82.99305210918114,6
0.05,2015,94,167325,82.9985119047619,9
0.05,2016,94,167419,83.00396628656421,7
0.05,2017,92,167511,83.00842418235877,9
0.05,2018,91,167602,83.01238236750866,12
0.05,2019,94,167696,83.01782178217822,7
0.05,2020,94,167790,83.02325581395348,7
0.05,2021,96,167886,83.02967359050444,6
0.05,2022,91,167977,83.03361344537815,10
0.05,2023,96,168073,83.04001976284584,6
0.05,2024,94,168167,83.04543209876543,7
0.05,2025,94,168261,83.05083909180651,8
0.05,2026,94,168355,83.05624074987666,9
0.05,2027,94,168449,83.06163708086785,7
0.05,2028,96,168545,83.06801379990144,6
0.05,2029,94,168639,83.07339901477833,7
0.05,2030,94,168733,83.07877892663713,7
0.05,2031,-48,168685,83.0142716535433,11
0.05,2032,92,168777,83.01869158878505,9
0.05,2033,95,168872,83.02458210422812,6
0.05,2034,96,168968,83.03095823095823,6
0.05,2035,95,169063,83.03683693516699,6
0.05,2036,93,169156,83.04172803141876,8
0.05,2037,27,169183,83.01422963689892,6
0.05,2038,94,169277,83.01961745953899,7
0.05,2039,94,169371,83.025,7
0.05,2040,94,169465,83.03037726604606,8
0.05,2041,89,169554,83.03330068560236,12
0.05,2042,93,169647,83.0381791483113,8
0.05,2043,93,169740,83.04305283757338,8
0.05,2044,93,169833,83.0479217603912,9
0.05,2045,94,169927,83.05327468230693,7
0.05,2046,23,169950,83.02393746946751,9
0.05,2047,92,170042,83.0283203125,9
0.05,2048,96,170138,83.03465104929234,6
0.05,2049,88,170226,83.0370731707317,13
0.05,2050,94,170320,83.04241833252073,7
0.05,2051,94,170414,83.04775828460039,7
0.05,2052,24,170438,83.01899659035557,9
0.05,2053,94,170532,83.02434274586173,7
0.05,2054,94,170626,83.02968369829684,7
0.05,2055,94,170720,83.03501945525292,7
0.05,2056,94,170814,83.04035002430724,7
0.05,2057,96,170910,83.0466472303207,6
0.05,2058,93,171003,83.05148130160272,8
0.05,2059,25,171028,83.02330097087379,7
0.05,2060,96,171124,83.02959728287239,6
0.05,2061,25,171149,83.00145489815714,8
0.05,2062,94,171243,83.00678623364033,7
0.05,2063,90,171333,83.01017441860465,11
0.05,2064,25,171358,82.9820823244552,7
0.05,2065,90,171448,82.98547918683447,11
0.05,2066,94,171542,82.99080793420416,7
0.05,2067,90,171632,82.99419729206963,11
0.05,2068,94,171726,82.99951667472209,7
0.05,2069,96,171822,83.00579710144928,6
0.05,2070,95,171917,83.01158860453887,6
0.05,2071,92,172009,83.01592664092664,9
0.05,2072,94,172103,83.02122527737578,7
0.05,2073,96,172199,83.0274831243973,6
0.05,2074,95,172294,83.03325301204819,6
0.05,2075,93,172387,83.03805394990366,8
0.05,2076,95,172482,83.043813192104,6
0.05,2077,95,172577,83.04956689124158,6
0.05,2078,93,172670,83.05435305435306,9
0.05,2079,93,172763,83.05913461538462,8
0.05,2080,94,172857,83.06439211917348,7
0.05,2081,95,172952,83.07012487992316,6
0.05,2082,23,172975,83.04128660585694,9
0.05,2083,94,173069,83.04654510556622,7
0.05,2084,96,173165,83.05275779376498,6
0.05,2085,94,173259,83.05800575263663,7
0.05,2086,93,173352,83.06276952563488,8
0.05,2087,25,173377,83.03496168582376,7
0.05,2088,22,173399,83.00574437529919,10
0.05,2089,96,173495,83.01196172248804,6
0.05,2090,93,173588,83.01673840267814,8
0.05,2091,94,173682,83.02198852772466,7
0.05,2092,94,173776,83.02723363592929,7
0.05,2093,94,173870,83.03247373447947,9
0.05,2094,96,173966,83.03866348448688,6
0.05,2095,24,173990,83.0104961832061,8
0.05,2096,94,174084,83.01573676680972,7
0.05,2097,93,174177,83.0204957102002,9
0.05,2098,94,174271,83.02572653644593,7
0.05,2099,93,174364,83.0304761904762,8
0.05,2100,96,174460,83.03664921465969,6
0.05,2101,-47,174413,82.97478591817317,12
0.05,2102,95,174508,82.98050404184498,6
0.05,2103,93,174601,82.98526615969581,8
0.05,2104,96,174697,82.9914489311164,6
0.05,2105,27,174724,82.96486229819563,6
0.05,2106,23,174747,82.93640246796393,10
0.05,2107,94,174841,82.94165085388994,7
0.05,2108,22,174863,82.91275486012329,10
0.05,2109,96,174959,82.91895734597156,6
0.05,2110,96,175055,82.92515395547134,6
0.05,2111,91,175146,82.92897727272727,12
0.05,2112,92,175238,82.93327023189778,9
0.05,2113,94,175332,82.93850520340587,8
0.05,2114,92,175424,82.94278959810875,9
0.05,2115,92,175516,82.94706994328922,9
0.05,2116,96,175612,82.95323571091167,7
0.05,2117,94,175706,82.95845136921623,7
0.05,2118,94,175800,82.9636621047664,7
0.05,2119,94,175894,82.9688679245283,7
0.05,2120,90,175984,82.97218293257897,11
0.05,2121,95,176079,82.97785108388312,6
0.05,2122,92,176171,82.98210080075366,10
0.05,2123,95,176266,82.98775894538606,6
0.05,2124,91,176357,82.9915294117647,10
0.05,2125,94,176451,82.9967074317968,8
0.05,2126,92,176543,83.00094029149037,9
0.05,2127,94,176637,83.00610902255639,8
0.05,2128,90,176727,83.00939408172852,11
0.05,2129,93,176820,83.01408450704226,8
0.05,2130,94,176914,83.01923979352416,8
0.05,2131,14,176928,82.98686679174484,19
0.05,2132,92,177020,82.99109235818096,10
0.05,2133,25,177045,82.9639175257732,7
0.05,2134,94,177139,82.96908665105387,7
0.05,2135,95,177234,82.9747191011236,7
0.05,2136,93,177327,82.97941038839495,8
0.05,2137,96,177423,82.98550046772685,6
0.05,2138,92,177515,82.98971482000935,9
0.05,2139,92,177607,82.99392523364486,10
0.05,2140,94,177701,82.99906585707613,7
0.05,2141,94,177795,83.00420168067227,7
0.05,2142,-117,177678,82.91087260849277,11
0.05,2143,93,177771,82.91557835820896,9
0.05,2144,93,177864,82.92027972027972,8
0.05,2145,93,177957,82.92497670083877,8
0.05,2146,96,178053,82.9310666045645,6
0.05,2147,94,178147,82.93621973929237,7
0.05,2148,94,178241,82.9413680781759,8
0.05,2149,26,178267,82.91488372093023,7
0.05,2150,94,178361,82.92003719200372,7
0.05,2151,25,178386,82.89312267657992,7
0.05,2152,96,178482,82.89921040408731,6
0.05,2153,89,178571,82.90204271123491,13
0.05,2154,15,178586,82.87053364269141,17
0.05,2155,96,178682,82.87662337662337,6
0.05,2156,95,178777,82.88224385720909,6
0.05,2157,95,178872,82.88785912882298,7
0.05,2158,24,178896,82.86058360352015,8
0.05,2159,96,178992,82.86666666666666,6
0.05,2160,94,179086,82.87181860249885,7
0.05,2161,94,179180,82.87696577243294,7
0.05,2162,94,179274,82.88210818307905,7
0.05,2163,94,179368,82.88724584103512,7
0.05,2164,93,179461,82.8919168591224,8
0.05,2165,96,179557,82.89796860572484,6
0.05,2166,94,179651,82.90309183202584,8
0.05,2167,88,179739,82.90544280442805,13
0.05,2168,22,179761,82.87736284001844,11
0.05,2169,92,179853,82.8815668202765,9
0.05,2170,94,179947,82.88668816213726,7
0.05,2171,94,180041,82.89180478821363,8
0.05,2172,-47,179994,82.83202945237,10
0.05,2173,25,180019,82.80542778288869,8
0.05,2174,96,180115,82.81149425287356,6
0.05,2175,25,180140,82.78492647058823,7
0.05,2176,95,180235,82.79053743683968,6
0.05,2177,25,180260,82.76400367309458,7
0.05,2178,95,180355,82.76961909132629,6
0.05,2179,92,180447,82.77385321100917,9
0.05,2180,94,180541,82.77900045850528,7
0.05,2181,96,180637,82.78505957836848,6
0.05,2182,94,180731,82.79019697663766,7
0.05,2183,23,180754,82.76282051282051,9
0.05,2184,95,180849,82.76842105263158,6
0.05,2185,96,180945,82.77447392497713,6
0.05,2186,95,181040,82.78006401463192,6
0.05,2187,25,181065,82.7536563071298,7
0.05,2188,25,181090,82.72727272727273,7
0.05,2189,92,181182,82.73150684931507,9
0.05,2190,25,181207,82.70515746234597,7
0.05,2191,93,181300,82.70985401459853,8
0.05,2192,93,181393,82.71454628362973,8
0.05,2193,96,181489,82.72060164083865,6
0.05,2194,92,181581,82.72482915717539,9
0.05,2195,-48,181533,82.6653005464481,11
0.05,2196,92,181625,82.66954938552571,9
0.05,2197,94,181719,82.6747042766151,7
0.05,2198,94,181813,82.67985447930877,7
0.05,2199,94,181907,82.685,7
0.05,2200,25,181932,82.65879145842798,8
0.05,2201,25,181957,82.63260672116257,7
0.05,2202,94,182051,82.63776668179754,7
0.05,2203,95,182146,82.64337568058076,6
0.05,2204,24,182170,82.61678004535148,8
0.05,2205,94,182264,82.6219401631913,7
0.05,2206,96,182360,82.62800181241504,6
0.05,2207,95,182455,82.63360507246377,6
0.05,2208,93,182548,82.63829787234043,9
0.05,2209,95,182643,82.64389140271493,6
0.05,2210,95,182738,82.64947987336048,6
0.05,2211,96,182834,82.65551537070525,6
0.05,2212,94,182928,82.66064166290104,7
0.05,2213,96,183024,82.66666666666667,6
0.05,2214,94,183118,82.67178329571107,8
0.05,2215,96,183214,82.67779783393502,6
0.05,2216,91,183305,82.68155164636897,10
0.05,2217,92,183397,82.68575293056809,9
0.05,2218,90,183487,82.68904912122578,11
0.05,2219,92,183579,82.69324324324324,9
0.05,2220,96,183675,82.69923457901847,6
0.05,2221,94,183769,82.7043204320432,7
0.05,2222,95,183864,82.70985155195682,6
0.05,2223,95,183959,82.71537769784173,6
0.05,2224,93,184052,82.72,8
0.05,2225,93,184145,82.72461814914645,8
0.05,2226,92,184237,82.72878311629995,9
0.05,2227,91,184328,82.73249551166965,10
0.05,2228,93,184421,82.73710183938987,8
0.05,2229,94,184515,82.74215246636771,8
0.05,2230,95,184610,82.74764679515913,6
0.05,2231,17,184627,82.7181899641577,15
0.05,2232,92,184719,82.72234661889834,9
0.05,2233,94,184813,82.72739480752014,7
0.05,2234,91,184904,82.73109619686801,12
0.05,2235,91,184995,82.73479427549195,10
0.05,2236,94,185089,82.73983012963791,7
0.05,2237,92,185181,82.74396782841823,10
0.05,2238,94,185275,82.74899508709245,7
0.05,2239,94,185369,82.75401785714286,7
0.05,2240,96,185465,82.7599286033021,6
0.05,2241,95,185560,82.76538804638716,6
0.05,2242,95,185655,82.77084262148908,7
0.05,2243,90,185745,82.774064171123,11
0.05,2244,93,185838,82.77861915367484,9
0.05,2245,96,185934,82.78450578806768,6
0.05,2246,95,186029,82.78994214508234,6
0.05,2247,95,186124,82.79537366548043,6
0.05,2248,23,186147,82.76878612716763,9
0.05,2249,94,186241,82.77377777777778,7
0.05,2250,92,186333,82.77787649933363,9
0.05,2251,92,186425,82.78197158081706,9
0.05,2252,27,186452,82.757212605415,6
0.05,2253,94,186546,82.76220053238687,7
0.05,2254,94,186640,82.76718403547672,7
0.05,2255,95,186735,82.77260638297872,6
0.05,2256,93,186828,82.77713779353124,8
0.05,2257,22,186850,82.75022143489814,10
0.05,2258,94,186944,82.755201416556,7
0.05,2259,92,187036,82.75929203539823,9
0.05,2260,93,187129,82.76382131800088,8
0.05,2261,92,187221,82.76790450928382,9
0.05,2262,94,187315,82.77286787450288,7
0.05,2263,94,187409,82.77782685512368,7
0.05,2264,96,187505,82.78366445916114,6
0.05,2265,94,187599,82.78861429832304,7
0.05,2266,94,187693,82.79355977062197,7
0.05,2267,96,187789,82.79938271604938,6
0.05,2268,95,187884,82.80475980608198,7
0.05,2269,96,187980,82.81057268722466,6
0.05,2270,21,188001,82.78335535006605,11
0.05,2271,93,188094,82.78785211267606,8
0.05,2272,96,188190,82.79366476022878,6
0.05,2273,96,188286,82.7994722955145,6
0.05,2274,23,188309,82.77318681318681,10
0.05,2275,93,188402,82.77768014059754,8
0.05,2276,-48,188354,82.72024593763724,12
0.05,2277,94,188448,82.72519754170325,7
0.05,2278,96,188544,82.73102237823606,6
0.05,2279,21,188565,82.70394736842105,11
0.05,2280,94,188659,82.70889960543622,7
0.05,2281,96,188755,82.71472392638037,6
0.05,2282,94,188849,82.71966710468682,8
0.05,2283,94,188943,82.72460595446584,7
0.05,2284,91,189034,82.72822757111598,10
0.05,2285,96,189130,82.73403324584427,6
0.05,2286,94,189224,82.73895933537385,7
0.05,2287,94,189318,82.74388111888112,7
0.05,2288,94,189412,82.74879860200961,7
0.05,2289,91,189503,82.75240174672489,11
0.05,2290,95,189598,82.75774770842428,6
0.05,2291,96,189694,82.76352530541013,6
0.05,2292,94,189788,82.7684256432621,7
0.05,2293,94,189882,82.77332170880558,7
0.05,2294,94,189976,82.77821350762527,7
0.05,2295,95,190071,82.78353658536585,8
0.05,2296,95,190166,82.78885502829777,6
0.05,2297,95,190261,82.79416884247172,6
0.05,2298,96,190357,82.79991300565463,6
0.05,2299,94,190451,82.80478260869565,8
0.05,2300,23,190474,82.77879182963929,9
0.05,2301,95,190569,82.78410078192876,6
0.05,2302,92,190661,82.78810247503256,9
0.05,2303,95,190756,82.79340277777777,6
0.05,2304,96,190852,82.79913232104121,6
0.05,2305,92,190944,82.8031222896791,9
0.05,2306,94,191038,82.80797572605115,7
0.05,2307,94,191132,82.81282495667244,7
0.05,2308,95,191227,82.81810307492421,6
0.05,2309,94,191321,82.82294372294372,7
0.05,2310,93,191414,82.8273474686283,9
0.05,2311,24,191438,82.80190311418686,8
0.05,2312,94,191532,82.80674448767834,7
0.05,2313,95,191627,82.81201382886776,6
0.05,2314,23,191650,82.78617710583153,9
0.05,2315,94,191744,82.79101899827289,7
0.05,2316,92,191836,82.79499352611136,9
0.05,2317,93,191929,82.79939603106126,8
0.05,2318,94,192023,82.80422595946528,8
0.05,2319,92,192115,82.80818965517241,9
0.05,2320,95,192210,82.81344248168892,6
0.05,2321,94,192304,82.8182601205857,7
0.05,2322,93,192397,82.8226431338786,8
0.05,2323,94,192491,82.82745266781411,7
0.05,2324,94,192585,82.83225806451613,7
0.05,2325,92,192677,82.83619948409286,9
0.05,2326,93,192770,82.84056725397508,8
0.05,2327,94,192864,82.84536082474227,7
0.05,2328,95,192959,82.85057964791756,6
0.05,2329,94,193053,82.85536480686696,7
0.05,2330,93,193146,82.85971685971685,8
0.05,2331,96,193242,82.86535162950257,6
0.05,2332,92,193334,82.86926703814831,9
0.05,2333,26,193360,82.84490145672665,6
0.05,2334,23,193383,82.81927194860813,9
0.05,2335,93,193476,82.8236301369863,9
0.05,2336,95,193571,82.8288403936671,6
0.05,2337,95,193666,82.83404619332764,6
0.05,2338,92,193758,82.83796494228302,9
0.05,2339,95,193853,82.84316239316239,6
0.05,2340,93,193946,82.8475010679197,8
0.05,2341,92,194038,82.85140905209222,9
0.05,2342,95,194133,82.85659411011524,7
0.05,2343,94,194227,82.8613481228669,7
0.05,2344,94,194321,82.86609808102345,7
0.05,2345,24,194345,82.84100596760443,8
0.05,2346,96,194441,82.84661269706008,6
0.05,2347,22,194463,82.82069846678024,10
0.05,2348,96,194559,82.82630906768838,6
0.05,2349,94,194653,82.83106382978724,7
0.05,2350,94,194747,82.83581454700128,7
0.05,2351,94,194841,82.84056122448979,8
0.05,2352,25,194866,82.81597960050999,8
0.05,2353,94,194960,82.82073067119796,7
0.05,2354,93,195053,82.82505307855627,8
0.05,2355,95,195148,82.830220713073,6
0.05,2356,92,195240,82.83411115825201,9
0.05,2357,93,195333,82.8384223918575,8
0.05,2358,95,195428,82.84357778719796,7
0.05,2359,96,195524,82.84915254237288,6
0.05,2360,96,195620,82.85472257518,6
0.05,2361,26,195646,82.83065198983913,6
0.05,2362,95,195741,82.83580194667795,7
0.05,2363,96,195837,82.84137055837563,6
0.05,2364,95,195932,82.84651162790698,7
0.05,2365,95,196027,82.85164835164835,7
0.05,2366,95,196122,82.85678073510773,6
0.05,2367,26,196148,82.83277027027027,6
0.05,2368,92,196240,82.83663993246095,9
0.05,2369,94,196334,82.84135021097046,7
0.05,2370,95,196429,82.84647827920709,6
0.05,2371,95,196524,82.85160202360876,6
0.05,2372,95,196619,82.85672144964181,7
0.05,2373,86,196705,82.8580454928391,15
0.05,2374,94,196799,82.86273684210526,7
0.05,2375,26,196825,82.83880471380472,6
0.05,2376,94,196919,82.84350021034918,7
0.05,2377,23,196942,82.81833473507149,9
0.05,2378,92,197034,82.82219419924338,9
0.05,2379,95,197129,82.82731092436975,6
0.05,2380,95,197224,82.83242335153297,7
0.05,2381,96,197320,82.83795130142737,6
0.05,2382,94,197414,82.84263533361309,7
0.05,2383,93,197507,82.84689597315436,9
0.05,2384,95,197602,82.85199161425577,6
0.05,2385,94,197696,82.8566638725901,7
0.05,2386,94,197790,82.86133221617092,8
0.05,2387,94,197884,82.86599664991624,7
0.05,2388,95,197979,82.87107576391796,6
0.05,2389,94,198073,82.87573221757322,7
0.05,2390,96,198169,82.88122124634044,6
0.05,2391,93,198262,82.88545150501672,8
0.05,2392,93,198355,82.88967822816548,9
0.05,2393,95,198450,82.89473684210526,6
0.05,2394,96,198546,82.90020876826722,6
0.05,2395,94,198640,82.90484140233723,7
0.05,2396,95,198735,82.909887359199,6
0.05,2397,94,198829,82.91451209341118,7
0.05,2398,96,198925,82.91996665277199,6
0.05,2399,95,199020,82.925,6
0.05,2400,93,199113,82.92919616826322,8
0.05,2401,94,199207,82.93380516236469,7
0.05,2402,92,199299,82.93757802746566,9
0.05,2403,92,199391,82.94134775374376,9
0.05,2404,94,199485,82.94594594594595,7
0.05,2405,94,199579,82.95054031587698,7
0.05,2406,92,199671,82.95429995845451,9
0.05,2407,95,199766,82.95930232558139,7
0.05,2408,94,199860,82.96388542963885,7
0.05,2409,94,199954,82.96846473029045,7
0.05,2410,90,200044,82.97138116963916,11
0.05,2411,93,200137,82.97553897180762,8
0.05,2412,94,200231,82.98010774968918,7
0.05,2413,94,200325,82.98467274233637,7
0.05,2414,95,200420,82.9896480331263,6
0.05,2415,25,200445,82.96564569536424,7
0.05,2416,92,200537,82.96938353330575,9
0.05,2417,94,200631,82.97394540942928,9
0.05,2418,91,200722,82.97726333195536,10
0.05,2419,93,200815,82.98140495867769,8
0.05,2420,94,200909,82.98595621643949,7
0.05,2421,95,201004,82.99091659785302,7
0.05,2422,94,201098,82.99546017333884,7
0.05,2423,95,201193,83.00041254125412,6
0.05,2424,94,201287,83.00494845360825,8
0.05,2425,94,201381,83.00948062654575,7
0.05,2426,92,201473,83.01318500206015,9
0.05,2427,95,201568,83.0181219110379,6
0.05,2428,92,201660,83.02181967888019,9
0.05,2429,21,201681,82.9962962962963,11
0.05,2430,96,201777,83.00164541341012,6
0.05,2431,25,201802,82.97779605263158,7
0.05,2432,96,201898,82.98314837648994,6
0.05,2433,88,201986,82.98520953163516,13
0.05,2434,93,202079,82.98932238193018,9
0.05,2435,95,202174,82.99425287356321,6
0.05,2436,91,202265,82.9975379565039,11
0.05,2437,95,202360,83.00246103363412,6
0.05,2438,94,202454,83.0069700697007,7
0.05,2439,95,202549,83.01188524590164,6
0.05,2440,93,202642,83.01597705858255,10
0.05,2441,94,202736,83.02047502047502,7
0.05,2442,94,202830,83.02496930004094,7
0.05,2443,96,202926,83.03027823240589,6
0.05,2444,18,202944,83.0036809815951,15
0.05,2445,92,203036,83.0073589533933,10
0.05,2446,96,203132,83.01266857376379,6
0.05,2447,95,203227,83.01756535947712,6
0.05,2448,93,203320,83.02164148632095,8
0.05,2449,24,203344,82.99755102040817,9
0.05,2450,89,203433,83.0,12
0.05,2451,95,203528,83.00489396411093,6
0.05,2452,94,203622,83.00937627395027,7
0.05,2453,26,203648,82.98614506927466,6
0.05,2454,94,203742,82.99063136456212,7
0.05,2455,94,203836,82.99511400651465,7
0.05,2456,27,203863,82.97232397232398,7
0.05,2457,96,203959,82.97762408462164,6
0.05,2458,96,204055,82.98291988613258,6
0.05,2459,27,204082,82.96016260162601,6
0.05,2460,92,204174,82.9638358390898,9
0.05,2461,96,204270,82.96913078797725,6
0.05,2462,92,204362,82.97279740154283,9
0.05,2463,95,204457,82.97767857142857,6
0.05,2464,94,204551,82.98215010141988,7
0.05,2465,94,204645,82.98661800486617,8
0.05,2466,95,204740,82.99148763680584,6
0.05,2467,92,204832,82.99513776337115,9
0.05,2468,94,204926,82.99959497772377,7
0.05,2469,90,205016,83.00242914979756,11
0.05,2470,96,205112,83.00768919465803,6
0.05,2471,91,205203,83.01092233009709,11
0.05,2472,93,205296,83.0149615851193,9
0.05,2473,22,205318,82.99029911075182,10
0.05,2474,94,205412,82.99474747474747,8
0.05,2475,94,205506,82.99919224555735,7
0.05,2476,95,205601,83.00403714170368,7
0.05,2477,95,205696,83.0088781275222,7
0.05,2478,92,205788,83.01250504235578,9
0.05,2479,25,205813,82.9891129032258,7
0.05,2480,93,205906,82.9931479242241,8
0.05,2481,96,206002,82.99838839645447,6
0.05,2482,94,206096,83.00281917035844,7
0.05,2483,94,206190,83.0072463768116,8
0.05,2484,86,206276,83.00845070422535,15
0.05,2485,95,206371,83.01327433628319,6
0.05,2486,91,206462,83.01648572577402,10
0.05,2487,94,206556,83.02090032154341,7
0.05,2488,95,206651,83.02571313780635,6
0.05,2489,24,206675,83.00200803212851,8
0.05,2490,95,206770,83.0068245684464,6
0.05,2491,95,206865,83.01163723916532,6
0.05,2492,89,206954,83.01403931006818,12
0.05,2493,92,207046,83.01764234161989,9
0.05,2494,94,207140,83.02204408817636,8
0.05,2495,93,207233,83.02604166666667,8
0.05,2496,95,207328,83.03083700440529,6
0.05,2497,93,207421,83.03482786228983,8
0.05,2498,96,207517,83.04001600640257,6
0.05,2499,95,207612,83.0448,6
0.05,2500,96,207708,83.04998000799681,6
0.05,2501,94,207802,83.05435651478817,7
0.05,2502,-46,207756,83.00279664402717,9
0.05,2503,95,207851,83.00758785942492,6
0.05,2504,25,207876,82.98443113772456,7
0.05,2505,93,207969,82.98842777334397,8
0.05,2506,94,208063,82.99282010370962,7
0.05,2507,94,208157,82.99720893141946,7
0.05,2508,23,208180,82.9732961339179,10
0.05,2509,95,208275,82.9780876494024,7
0.05,2510,94,208369,82.98247710075667,7
0.05,2511,96,208465,82.98765923566879,6
0.05,2512,95,208560,82.9924393155591,6
0.05,2513,24,208584,82.9689737470167,8
0.05,2514,95,208679,82.97375745526838,7
0.05,2515,96,208775,82.97893481717011,6
0.05,2516,93,208868,82.98291617004371,8
0.05,2517,94,208962,82.98729150119142,8
0.05,2518,93,209055,82.99126637554585,8
0.05,2519,93,209148,82.9952380952381,8
0.05,2520,96,209244,83.0003966679889,6
0.05,2521,96,209340,83.00555114988104,6
0.05,2522,92,209432,83.00911613158938,9
0.05,2523,94,209526,83.013470681458,8
0.05,2524,93,209619,83.01742574257426,9
0.05,2525,26,209645,82.99485352335708,8
0.05,2526,96,209741,83.0,6
0.05,2527,95,209836,83.00474683544304,6
0.05,2528,95,209931,83.00948991696323,6
0.05,2529,93,210024,83.01343873517787,8
0.05,2530,21,210045,82.98893717898063,11
0.05,2531,95,210140,82.99368088467615,6
0.05,2532,94,210234,82.99802605606001,7
0.05,2533,21,210255,82.97355958958168,11
0.05,2534,94,210349,82.97790927021697,7
0.05,2535,92,210441,82.98146687697161,9
0.05,2536,25,210466,82.95861253448956,7
0.05,2537,95,210561,82.96335697399527,6
0.05,2538,96,210657,82.96849153209925,6
0.05,2539,93,210750,82.9724409448819,8
0.05,2540,95,210845,82.9771743408107,6
0.05,2541,93,210938,82.98111723052715,8
0.05,2542,95,211033,82.98584349193865,7
0.05,2543,94,211127,82.99017295597484,7
0.05,2544,94,211221,82.99449901768173,7
0.05,2545,95,211316,82.99921445404556,6
0.05,2546,17,211333,82.97330192383195,15
0.05,2547,96,211429,82.97841444270016,6
0.05,2548,90,211519,82.98116908591605,11
0.05,2549,92,211611,82.98470588235294,9
0.05,2550,23,211634,82.96119168953352,9
0.05,2551,93,211727,82.96512539184953,8
0.05,2552,94,211821,82.96944770857814,7
0.05,2553,23,211844,82.94596711041504,9
0.05,2554,91,211935,82.94911937377691,11
0.05,2555,94,212029,82.95344287949922,7
0.05,2556,92,212121,82.95698083691826,9
0.05,2557,95,212216,82.96168881939015,8
0.05,2558,94,212310,82.96600234466588,7
0.05,2559,23,212333,82.942578125,9
0.05,2560,22,212355,82.91878172588832,10
0.05,2561,94,212449,82.92310694769711,7
0.05,2562,26,212475,82.90089738587592,7
0.05,2563,95,212570,82.90561622464898,6
0.05,2564,94,212664,82.90994152046784,7
0.05,2565,27,212691,82.88815276695246,6
0.05,2566,94,212785,82.89248149590962,7
0.05,2567,96,212881,82.89758566978193,6
0.05,2568,96,212977,82.90268586998832,6
0.05,2569,95,213072,82.90739299610895,6
0.05,2570,94,213166,82.91170750680669,7
0.05,2571,96,213262,82.91679626749611,6
0.05,2572,96,213358,82.9218810726778,6
0.05,2573,93,213451,82.92579642579642,8
0.05,2574,94,213545,82.93009708737864,7
0.05,2575,93,213638,82.93400621118012,8
0.05,2576,92,213730,82.93752425300737,9
0.05,2577,92,213822,82.94103956555469,9
0.05,2578,94,213916,82.94532764637457,7
0.05,2579,94,214010,82.94961240310077,8
0.05,2580,94,214104,82.95389383959706,7
0.05,2581,95,214199,82.9585592563904,6
0.05,2582,93,214292,82.96244676732482,8
0.05,2583,94,214386,82.96671826625386,7
0.05,2584,23,214409,82.94352030947776,9
0.05,2585,18,214427,82.91840680587781,14
0.05,2586,95,214522,82.92307692307692,8
0.05,2587,23,214545,82.89992272024729,9
0.05,2588,96,214641,82.90498261877173,6
0.05,2589,94,214735,82.90926640926641,7
0.05,2590,26,214761,82.88730219992281,6
0.05,2591,95,214856,82.89197530864197,7
0.05,2592,92,214948,82.89548785190898,9
0.05,2593,95,215043,82.90015420200463,6
0.05,2594,93,215136,82.90404624277457,8
0.05,2595,91,215227,82.90716486902927,10
0.05,2596,94,215321,82.91143627262225,7
0.05,2597,94,215415,82.91570438799076,7
0.05,2598,95,215510,82.92035398230088,6
0.05,2599,95,215605,82.925,6
0.05,2600,96,215701,82.93002691272588,6
0.05,2601,94,215795,82.93428132205996,8
0.05,2602,93,215888,82.93814829043411,8
0.05,2603,95,215983,82.94278033794163,6
0.05,2604,94,216077,82.94702495201535,7
0.05,2605,95,216172,82.95165003837299,6
0.05,2606,94,216266,82.95588799386267,7
0.05,2607,93,216359,82.95973926380368,8
0.05,2608,21,216380,82.9359908010732,11
0.05,2609,94,216474,82.94022988505748,7
0.05,2610,96,216570,82.94523171198774,6
0.05,2611,23,216593,82.92228177641654,9
0.05,2612,26,216619,82.90049751243781,6
0.05,2613,96,216715,82.90550879877583,6
0.05,2614,24,216739,82.882982791587,8
0.05,2615,95,216834,82.88761467889908,6
0.05,2616,92,216926,82.89109667558273,9
0.05,2617,25,216951,82.86898395721926,7
0.05,2618,92,217043,82.87247040855289,9
0.05,2619,95,217138,82.87709923664121,6
0.05,2620,94,217232,82.8813429988554,7
0.05,2621,95,217327,82.8859649122807,6
0.05,2622,93,217420,82.88982081585971,8
0.05,2623,94,217514,82.89405487804878,7
0.05,2624,92,217606,82.8975238095238,9
0.05,2625,96,217702,82.9025133282559,6
0.05,2626,94,217796,82.90673772363913,7
0.05,2627,93,217889,82.91057838660578,8
0.05,2628,25,217914,82.88855077976417,7
0.05,2629,93,218007,82.89239543726235,8
0.05,2630,95,218102,82.89699733941467,6
0.05,2631,96,218198,82.90197568389058,6
0.05,2632,94,218292,82.9061906570452,7
0.05,2633,95,218387,82.91078208048596,6
0.05,2634,20,218407,82.88690702087287,12
0.05,2635,94,218501,82.89112291350531,7
0.05,2636,92,218593,82.89457717102768,9
0.05,2637,94,218687,82.89878695981804,7
0.05,2638,92,218779,82.90223569533914,9
0.05,2639,92,218871,82.90568181818182,9
0.05,2640,90,218961,82.90836804240818,11
0.05,2641,95,219056,82.91294473883421,6
0.05,2642,95,219151,82.91751797200152,6
0.05,2643,96,219247,82.92246596066566,6
0.05,2644,96,219343,82.9274102079395,6
0.05,2645,92,219435,82.93083900226758,9
0.05,2646,92,219527,82.93426520589347,10
0.05,2647,22,219549,82.91125377643505,10
0.05,2648,95,219644,82.91581728954323,6
0.05,2649,94,219738,82.92,7
0.05,2650,96,219834,82.92493398717465,6
0.05,2651,96,219930,82.92986425339366,6
0.05,2652,94,220024,82.93403693931398,7
0.05,2653,93,220117,82.9378296910324,8
0.05,2654,96,220213,82.94274952919021,6
0.05,2655,27,220240,82.92168674698796,6
0.05,2656,93,220333,82.92547986450884,9
0.05,2657,94,220427,82.92964635063957,7
0.05,2658,94,220521,82.93380970289583,7
0.05,2659,94,220615,82.93796992481202,7
0.05,2660,94,220709,82.94212701991732,7
0.05,2661,24,220733,82.91998497370398,8
0.05,2662,93,220826,82.923770184003,8
0.05,2663,95,220921,82.92830330330331,6
0.05,2664,94,221015,82.93245778611632,7
0.05,2665,96,221111,82.93735933983496,6
0.05,2666,22,221133,82.91451068616423,10
0.05,2667,94,221227,82.91866566716642,7
0.05,2668,94,221321,82.92281753465717,7
0.05,2669,94,221415,82.92696629213484,7
0.05,2670,94,221509,82.93111194309247,7
0.05,2671,94,221603,82.93525449101796,7
0.05,2672,94,221697,82.93939393939394,7
0.05,2673,91,221788,82.94240837696336,11
0.05,2674,94,221882,82.94654205607476,7
0.05,2675,95,221977,82.95104633781764,6
0.05,2676,23,222000,82.9286514755323,9
0.05,2677,27,222027,82.90776699029126,6
0.05,2678,95,222122,82.91228070175438,6
0.05,2679,93,222215,82.9160447761194,8
0.05,2680,24,222239,82.89406937709809,8
0.05,2681,21,222260,82.8709917971663,11
0.05,2682,94,222354,82.87513976891539,7
0.05,2683,92,222446,82.87853949329359,9
0.05,2684,92,222538,82.88193668528864,9
0.05,2685,95,222633,82.88644825018615,6
0.05,2686,96,222729,82.891328619278,6
0.05,2687,94,222823,82.89546130952381,7
0.05,2688,94,222917,82.89959092599479,7
0.05,2689,94,223011,82.90371747211896,7
0.05,2690,24,223035,82.88182831661092,8
0.05,2691,92,223127,82.88521545319465,10
0.05,2692,-125,223002,82.8080207946528,20
0.05,2693,94,223096,82.81217520415738,7
0.05,2694,94,223190,82.81632653061224,7
0.05,2695,93,223283,82.82010385756676,8
0.05,2696,94,223377,82.82424916573972,7
0.05,2697,90,223467,82.82690882134915,11
0.05,2698,94,223561,82.831048536495,7
0.05,2699,93,223654,82.83481481481482,8
0.05,2700,95,223749,82.83931877082561,7
0.05,2701,94,223843,82.84344929681717,7
0.05,2702,94,223937,82.84757676655568,7
0.05,2703,94,224031,82.85170118343196,7
0.05,2704,94,224125,82.85582255083179,7
0.05,2705,92,224217,82.85920177383592,9
0.05,2706,92,224309,82.86257850018471,9
0.05,2707,94,224403,82.86669128508125,7
0.05,2708,21,224424,82.84385382059801,11
0.05,2709,24,224448,82.82214022140221,8
0.05,2710,94,224542,82.82626337144966,7
0.05,2711,93,224635,82.83001474926253,8
0.05,2712,93,224728,82.83376336159233,10
0.05,2713,93,224821,82.83750921149594,8
0.05,2714,96,224917,82.84235727440148,6
0.05,2715,91,225008,82.84536082474227,10
0.05,2716,94,225102,82.84946632315054,7
0.05,2717,94,225196,82.85356880058866,7
0.05,2718,20,225216,82.83045237219567,12
0.05,2719,90,225306,82.83308823529411,11
0.05,2720,94,225400,82.83719220874679,7
0.05,2721,92,225492,82.84055841293167,9
0.05,2722,23,225515,82.81858244583181,9
0.05,2723,94,225609,82.82268722466961,7
0.05,2724,95,225704,82.82715596330276,6
0.05,2725,95,225799,82.83162142333089,7
0.05,2726,95,225894,82.83608360836084,6
0.05,2727,94,225988,82.84017595307918,7
0.05,2728,22,226010,82.81788200806156,10
0.05,2729,94,226104,82.82197802197803,7
0.05,2730,94,226198,82.82607103625045,7
0.05,2731,95,226293,82.8305270863836,6
0.05,2732,96,226389,82.83534577387486,6
0.05,2733,94,226483,82.8394294074616,7
0.05,2734,92,226575,82.84277879341865,9
0.05,2735,95,226670,82.84722222222223,6
0.05,2736,93,226763,82.85093167701864,8
0.05,2737,91,226854,82.85390796201607,10
0.05,2738,95,226949,82.8583424607521,6
0.05,2739,94,227043,82.8624087591241,7
0.05,2740,93,227136,82.86610726012404,9
0.05,2741,94,227230,82.87016776075858,7
0.05,2742,94,227324,82.87422530076559,7
0.05,2743,23,227347,82.85240524781341,9
0.05,2744,92,227439,82.85573770491803,9
0.05,2745,95,227534,82.86016023306628,6
0.05,2746,94,227628,82.86421550782671,8
0.05,2747,94,227722,82.86826783114992,7
0.05,2748,94,227816,82.87231720625682,7
0.05,2749,94,227910,82.87636363636364,7
0.05,2750,22,227932,82.85423482370047,10
0.05,2751,92,228024,82.85755813953489,9
0.05,2752,95,228119,82.86196876135125,6
0.05,2753,94,228213,82.86601307189542,7
0.05,2754,27,228240,82.84573502722323,7
0.05,2755,92,228332,82.84905660377359,9
0.05,2756,93,228425,82.85273848385927,8
0.05,2757,25,228450,82.83176214648296,8
0.05,2758,93,228543,82.83544762595143,9
0.05,2759,94,228637,82.83949275362319,7
0.05,2760,96,228733,82.84425932633104,6
0.05,2761,95,228828,82.848660391021,6
0.05,2762,89,228917,82.85088671733622,12
0.05,2763,92,229009,82.8541968162084,9
0.05,2764,92,229101,82.85750452079566,9
0.05,2765,96,229197,82.86225596529285,6
0.05,2766,94,229291,82.86628117094325,7
0.05,2767,92,229383,82.8695809248555,9
0.05,2768,94,229477,82.87360057782593,7
0.05,2769,94,229571,82.87761732851986,7
0.05,2770,94,229665,82.8816311800794,7
0.05,2771,92,229757,82.88492063492063,9
0.05,2772,96,229853,82.88965019834114,6
0.05,2773,94,229947,82.89365537130497,7
0.05,2774,95,230042,82.89801801801802,7
0.05,2775,96,230138,82.90273775216139,6
0.05,2776,95,230233,82.90709398631617,8
0.05,2777,94,230327,82.91108711303096,7
0.05,2778,95,230422,82.91543720762864,6
0.05,2779,93,230515,82.91906474820144,8
0.05,2780,95,230610,82.92340884573895,6
0.05,2781,96,230706,82.92810927390367,6
0.05,2782,94,230800,82.93208767517068,7
0.05,2783,94,230894,82.9360632183908,7
0.05,2784,93,230987,82.93967684021544,8
0.05,2785,93,231080,82.94328786791098,8
0.05,2786,93,231173,82.94689630426983,8
0.05,2787,95,231268,82.95121951219512,6
0.05,2788,96,231364,82.95589817138759,6
0.05,2789,23,231387,82.93440860215054,10
0.05,2790,92,231479,82.93765675385167,10
0.05,2791,94,231573,82.94161891117479,7
0.05,2792,94,231667,82.94557823129252,7
0.05,2793,95,231762,82.94989262705798,6
0.05,2794,92,231854,82.9531305903399,9
0.05,2795,94,231948,82.95708154506438,8
0.05,2796,94,232042,82.96102967465141,7
0.05,2797,26,232068,82.94067190850608,6
0.05,2798,25,232093,82.9199714183637,8
0.05,2799,24,232117,82.89892857142857,8
0.05,2800,94,232211,82.90289182434844,8
0.05,2801,96,232307,82.90756602426838,6
0.05,2802,96,232403,82.91223688904745,6
0.05,2803,95,232498,82.91654778887303,6
0.05,2804,94,232592,82.9204991087344,7
0.05,2805,19,232611,82.89771917320029,13
0.05,2806,25,232636,82.87709298183114,7
0.05,2807,94,232730,82.88105413105413,7
0.05,2808,92,232822,82.88430046279815,10
0.05,2809,90,232912,82.88683274021352,11
0.05,2810,93,233005,82.89043045179652,8
0.05,2811,95,233100,82.89473684210526,7
0.05,2812,96,233196,82.89939566299324,6
0.05,2813,94,233290,82.90334044065388,7
0.05,2814,93,233383,82.90692717584369,9
0.05,2815,95,233478,82.9112215909091,6
0.05,2816,93,233571,82.91480298189563,8
0.05,2817,93,233664,82.91838183108588,8
0.05,2818,94,233758,82.9223128769067,7
0.05,2819,94,233852,82.92624113475178,7
0.05,2820,93,233945,82.9298121233605,8
0.05,2821,25,233970,82.90928419560595,9
0.05,2822,94,234064,82.91321289408431,8
0.05,2823,95,234159,82.91749291784703,6
0.05,2824,24,234183,82.8966371681416,8
0.05,2825,87,234270,82.89808917197452,14
0.05,2826,96,234366,82.90272373540856,6
0.05,2827,94,234460,82.90664780763791,7
0.05,2828,96,234556,82.91127606928244,6
0.05,2829,93,234649,82.9148409893993,8
0.05,2830,95,234744,82.91910985517485,6
0.05,2831,94,234838,82.92302259887006,7
0.05,2832,94,234932,82.92693258030357,7
0.05,2833,25,234957,82.90649258997882,7
0.05,2834,93,235050,82.91005291005291,10
0.05,2835,93,235143,82.91361071932299,8
0.05,2836,94,235237,82.91751850546352,7
0.05,2837,92,235329,82.92071881606765,9
0.05,2838,24,235353,82.8999647763297,8
0.05,2839,-45,235308,82.85492957746479,8
0.05,2840,95,235403,82.85920450545582,8
0.05,2841,95,235498,82.86347642505278,8
0.05,2842,96,235594,82.86809708054872,6
0.05,2843,25,235619,82.84774964838256,7
0.05,2844,95,235714,82.85202108963094,6
0.05,2845,94,235808,82.8559381588194,7
0.05,2846,96,235904,82.86055497014401,6
0.05,2847,94,235998,82.86446629213484,8
0.05,2848,96,236094,82.86907686907686,6
0.05,2849,96,236190,82.87368421052632,6
0.05,2850,92,236282,82.87688530340232,9
0.05,2851,96,236378,82.88148667601683,6
0.05,2852,94,236472,82.88538380651946,7
0.05,2853,95,236567,82.8896285914506,6
0.05,2854,94,236661,82.89352014010508,7
0.05,2855,96,236757,82.89810924369748,6
0.05,2856,94,236851,82.90199509975498,8
0.05,2857,23,236874,82.88103568929321,9
0.05,2858,95,236969,82.88527457152851,6
0.05,2859,92,237061,82.88846153846154,9
0.05,2860,94,237155,82.89234533379937,7
0.05,2861,96,237251,82.89692522711391,6
0.05,2862,95,237346,82.90115263709396,7
0.05,2863,90,237436,82.9036312849162,11
0.05,2864,96,237532,82.90820244328097,6
0.05,2865,95,237627,82.91242149337054,7
0.05,2866,87,237714,82.91384722706663,14
0.05,2867,94,237808,82.91771269177127,7
0.05,2868,26,237834,82.89787382363193,8
0.05,2869,94,237928,82.90174216027874,7
0.05,2870,93,238021,82.90525949146638,8
0.05,2871,94,238115,82.9091225626741,7
0.05,2872,94,238209,82.91298294465716,7
0.05,2873,96,238305,82.91753653444677,6
0.05,2874,90,238395,82.92,11
0.05,2875,91,238486,82.92280945757997,10
0.05,2876,95,238581,82.92700729927007,6
0.05,2877,94,238675,82.93085476025017,7
0.05,2878,91,238766,82.93365751997221,11
0.05,2879,93,238859,82.93715277777778,8
0.05,2880,93,238952,82.94064560916348,8
0.05,2881,26,238978,82.92088827203331,6
0.05,2882,94,239072,82.9247311827957,7
0.05,2883,90,239162,82.92718446601941,11
0.05,2884,96,239258,82.9317157712305,6
0.05,2885,92,239350,82.93485793485793,9
0.05,2886,95,239445,82.93903706269484,6
0.05,2887,96,239541,82.94355955678671,6
0.05,2888,94,239635,82.94738663897543,8
0.05,2889,96,239731,82.95190311418685,6
0.05,2890,93,239824,82.95537876167415,8
0.05,2891,25,239849,82.9353388658368,7
0.05,2892,94,239943,82.93916349809886,8
0.05,2893,96,240039,82.94367657221838,6
0.05,2894,95,240134,82.94784110535406,6
0.05,2895,94,240228,82.95165745856353,7
0.05,2896,92,240320,82.95478080773213,9
0.05,2897,96,240416,82.95928226363009,6
0.05,2898,93,240509,82.96274577440497,8
0.05,2899,96,240605,82.96724137931035,6
0.05,2900,25,240630,82.94725956566701,8
0.05,2901,24,240654,82.92694693314955,8
0.05,2902,94,240748,82.930761281433,7
0.05,2903,92,240840,82.93388429752066,9
0.05,2904,23,240863,82.91325301204819,9
0.05,2905,21,240884,82.89194769442533,11
0.05,2906,94,240978,82.89576883384933,7
0.05,2907,27,241005,82.87654745529574,6
0.05,2908,93,241098,82.8800275008594,8
0.05,2909,96,241194,82.88453608247423,6
0.05,2910,96,241290,82.889041566472,6
0.05,2911,94,241384,82.89285714285714,7
0.05,2912,95,241479,82.89701338825952,6
0.05,2913,91,241570,82.89979409746053,11
0.05,2914,26,241596,82.88027444253859,6
0.05,2915,94,241690,82.8840877914952,8
0.05,2916,23,241713,82.8635584504628,9
0.05,2917,25,241738,82.84372858122002,7
0.05,2918,93,241831,82.84720794792737,8
0.05,2919,93,241924,82.85068493150685,8
0.05,2920,94,242018,82.85450188291681,7
0.05,2921,94,242112,82.85831622176592,7
0.05,2922,94,242206,82.86212795073554,8
0.05,2923,90,242296,82.86456908344734,11
0.05,2924,95,242391,82.86871794871794,6
0.05,2925,95,242486,82.87286397812714,8
0.05,2926,21,242507,82.85172531602323,11
0.05,2927,92,242599,82.85484972677595,10
0.05,2928,94,242693,82.85865483100034,7
0.05,2929,93,242786,82.86211604095563,8
0.05,2930,23,242809,82.841692255203,9
0.05,2931,94,242903,82.84549795361528,7
0.05,2932,95,242998,82.84964200477327,7
0.05,2933,93,243091,82.85310156782549,8
0.05,2934,25,243116,82.83339011925042,7
0.05,2935,92,243208,82.83651226158038,9
0.05,2936,95,243303,82.84065372829417,6
0.05,2937,95,243398,82.84479237576582,6
0.05,2938,23,243421,82.8244300782579,9
0.05,2939,92,243513,82.82755102040817,10
0.05,2940,25,243538,82.8078884733084,8
0.05,2941,96,243634,82.81237253569,6
0.05,2942,95,243729,82.81651376146789,6
0.05,2943,94,243823,82.8203125,8
0.05,2944,19,243842,82.79864176570459,14
0.05,2945,94,243936,82.80244399185337,7
0.05,2946,94,244030,82.80624363759756,7
0.05,2947,96,244126,82.81071913161465,6
0.05,2948,94,244220,82.81451339437098,7
0.05,2949,94,244314,82.81830508474576,7
0.05,2950,96,244410,82.82277194171468,6
0.05,2951,94,244504,82.82655826558266,7
0.05,2952,94,244598,82.83034202505927,7
0.05,2953,25,244623,82.81076506431957,7
0.05,2954,25,244648,82.7912013536379,8
0.05,2955,96,244744,82.7956698240866,6
0.05,2956,95,244839,82.79979709164694,6
0.05,2957,90,244929,82.80223123732252,13
0.05,2958,91,245020,82.80500168976005,10
0.05,2959,27,245047,82.78614864864865,6
0.05,2960,23,245070,82.76595744680851,9
0.05,2961,90,245160,82.76839972991222,11
0.05,2962,23,245183,82.74822814714815,9
0.05,2963,96,245279,82.75269905533064,6
0.05,2964,94,245373,82.75649241146712,7
0.05,2965,94,245467,82.76028320971005,7
0.05,2966,92,245559,82.76339737108191,9
0.05,2967,93,245652,82.76684636118598,8
0.05,2968,93,245745,82.77029302795555,8
0.05,2969,92,245837,82.77340067340067,9
0.05,2970,25,245862,82.75395489734096,8
0.05,2971,95,245957,82.75807537012113,8
0.05,2972,94,246051,82.76185671039354,8
0.05,2973,96,246147,82.76630800268998,6
0.05,2974,94,246241,82.77008403361344,7
0.05,2975,95,246336,82.7741935483871,6
0.05,2976,94,246430,82.77796439368491,7
0.05,2977,94,246524,82.78173270651443,7
0.05,2978,93,246617,82.78516280631084,9
0.05,2979,96,246713,82.78959731543624,6
0.05,2980,94,246807,82.79335793357933,7
0.05,2981,92,246899,82.79644533869886,9
0.05,2982,90,246989,82.79886020784446,11
0.05,2983,92,247081,82.80194369973191,9
0.05,2984,93,247174,82.80536013400335,8
0.05,2985,94,247268,82.80910917615539,7
0.05,2986,90,247358,82.81151657181118,11
0.05,2987,95,247453,82.81559571619813,6
0.05,2988,94,247547,82.81933757109401,7
0.05,2989,93,247640,82.82274247491638,10
0.05,2990,94,247734,82.82647943831495,8
0.05,2991,94,247828,82.83021390374331,8
0.05,2992,91,247919,82.8329435349148,10
0.05,2993,26,247945,82.81396125584503,6
0.05,2994,93,248038,82.81736227045076,8
0.05,2995,95,248133,82.82142857142857,6
0.05,2996,94,248227,82.82515849182516,7
0.05,2997,24,248251,82.80553702468312,8
0.05,2998,88,248339,82.80726908969656,15
0.05,2999,92,248431,82.81033333333333,9
0.05,3000,92,248523,82.81339553482172,9
0.05,3001,94,248617,82.81712191872086,8
0.05,3002,92,248709,82.82017982017982,10
0.05,3003,94,248803,82.82390146471371,7
0.05,3004,91,248894,82.82662229617304,11
0.05,3005,90,248984,82.82900864936794,12
0.05,3006,96,249080,82.83338875956102,6
0.05,3007,26,249106,82.81449468085107,6
0.05,3008,96,249202,82.81887670322367,6
0.05,3009,95,249297,82.82292358803987,6
0.05,3010,95,249392,82.8269677847891,6
0.05,3011,95,249487,82.83100929614874,6
0.05,3012,94,249581,82.83471622967143,7
0.05,3013,95,249676,82.83875248838753,6
0.05,3014,25,249701,82.81956882255389,7
0.05,3015,92,249793,82.8226127320955,9
0.05,3016,25,249818,82.80344713291349,7
0.05,3017,93,249911,82.80682571239231,8
0.05,3018,89,250000,82.80887711162637,13
0.05,3019,94,250094,82.81258278145695,7
0.05,3020,94,250188,82.8162859980139,8
0.05,3021,94,250282,82.81998676373263,8
0.05,3022,94,250376,82.82368508104533,7
0.05,3023,23,250399,82.80390211640211,9
0.05,3024,93,250492,82.80727272727273,8
0.05,3025,95,250587,82.81130204890945,6
0.05,3026,96,250683,82.81565906838453,6
0.05,3027,94,250777,82.81935270805812,7
0.05,3028,95,250872,82.82337405084186,6
0.05,3029,94,250966,82.82706270627062,8
0.05,3030,94,251060,82.83074892774661,7
0.05,3031,94,251154,82.8344327176781,7
0.05,3032,91,251245,82.83712495878667,10
0.05,3033,95,251340,82.84113381674358,6
0.05,3034,95,251435,82.84514003294893,6
0.05,3035,92,251527,82.84815546772069,9
0.05,3036,93,251620,82.8514981890023,9
0.05,3037,95,251715,82.85549703752469,6
0.05,3038,90,251805,82.857847976308,11
0.05,3039,95,251900,82.86184210526316,6
0.05,3040,93,251993,82.86517592897073,8
0.05,3041,94,252087,82.86883629191321,7
0.05,3042,94,252181,82.87249424909629,7
0.05,3043,-124,252057,82.8045335085414,18
0.05,3044,92,252149,82.80755336617406,9
0.05,3045,23,252172,82.78791858174655,9
0.05,3046,92,252264,82.79094191007549,9
0.05,3047,95,252359,82.79494750656168,6
0.05,3048,95,252454,82.79895047556576,6
0.05,3049,24,252478,82.77967213114754,8
0.05,3050,94,252572,82.78334972140281,8
0.05,3051,23,252595,82.7637614678899,9
0.05,3052,94,252689,82.76744186046511,7
0.05,3053,95,252784,82.77144728225278,6
0.05,3054,96,252880,82.77577741407529,6
0.05,3055,92,252972,82.77879581151832,9
0.05,3056,95,253067,82.78279358848545,6
0.05,3057,92,253159,82.78580771746239,9
0.05,3058,91,253250,82.78849297155934,10
0.05,3059,93,253343,82.79183006535948,9
0.05,3060,93,253436,82.79516497876511,8
0.05,3061,92,253528,82.7981711299804,10
0.05,3062,96,253624,82.80248122755468,6
0.05,3063,95,253719,82.80646214099217,6
0.05,3064,94,253813,82.81011419249592,7
0.05,3065,94,253907,82.81376386170906,7
0.05,3066,94,254001,82.81741115096185,8
0.05,3067,95,254096,82.82138200782269,6
0.05,3068,94,254190,82.82502443792767,7
0.05,3069,94,254284,82.82866449511401,7
0.05,3070,94,254378,82.83230218169977,7
0.05,3071,94,254472,82.8359375,7
0.05,3072,96,254568,82.84022128213472,6
0.05,3073,93,254661,82.84352635003253,8
0.05,3074,93,254754,82.84682926829268,8
0.05,3075,27,254781,82.82867360208063,6
0.05,3076,22,254803,82.80890477738056,10
0.05,3077,95,254898,82.81286549707602,7
0.05,3078,92,254990,82.81584930172134,9
0.05,3079,23,255013,82.79642857142858,9
0.05,3080,94,255107,82.80006491398896,8
0.05,3081,94,255201,82.80369889682025,7
0.05,3082,92,255293,82.80668180343821,9
0.05,3083,93,255386,82.80998702983139,8
0.05,3084,95,255481,82.81393841166937,7
0.05,3085,25,255506,82.7952041477641,7
0.05,3086,93,255599,82.79850988014253,8
0.05,3087,94,255693,82.80213730569949,7
0.05,3088,25,255718,82.78342505665263,7
0.05,3089,94,255812,82.78705501618123,7
0.05,3090,95,255907,82.79100614687803,7
0.05,3091,94,256001,82.79463130659767,7
0.05,3092,95,256096,82.79857743291304,6
0.05,3093,21,256117,82.77860374919199,12
0.05,3094,95,256212,82.78255250403878,6
0.05,3095,94,256306,82.78617571059432,7
0.05,3096,95,256401,82.79011947045528,6
0.05,3097,94,256495,82.7937378954164,7
0.05,3098,93,256588,82.79703130041949,8
0.05,3099,95,256683,82.80096774193548,6
0.05,3100,92,256775,82.80393421476943,9
0.05,3101,94,256869,82.80754352030948,8
0.05,3102,96,256965,82.8117950370609,6
0.05,3103,96,257061,82.81604381443299,6
0.05,3104,25,257086,82.79742351046698,8
0.05,3105,95,257181,82.80135222150676,6
0.05,3106,94,257275,82.80495654972643,7
0.05,3107,90,257365,82.80727155727156,11
0.05,3108,94,257459,82.81087166291412,7
0.05,3109,95,257554,82.81479099678457,7
0.05,3110,92,257646,82.81774349083896,9
0.05,3111,96,257742,82.8219794344473,6
0.05,3112,26,257768,82.80372630902666,6
0.05,3113,94,257862,82.8073217726397,7
0.05,3114,91,257953,82.80995184590691,11
0.05,3115,94,258047,82.8135430038511,7
0.05,3116,95,258142,82.81745267885788,6
0.05,3117,96,258238,82.8216805644644,6
0.05,3118,95,258333,82.825585123437,6
0.05,3119,94,258427,82.82916666666667,7
0.05,3120,94,258521,82.83274591477091,7
0.05,3121,95,258616,82.83664317745036,6
0.05,3122,95,258711,82.84053794428434,6
0.05,3123,96,258807,82.84475032010243,6
0.05,3124,92,258899,82.84768,9
0.05,3125,93,258992,82.850927703135,8
0.05,3126,93,259085,82.8541733290694,8
0.05,3127,87,259172,82.85549872122762,15
0.05,3128,93,259265,82.85874081176095,8
0.05,3129,94,259359,82.86230031948882,7
0.05,3130,94,259453,82.86585755349728,7
0.05,3131,93,259546,82.8690932311622,8
0.05,3132,90,259636,82.87136929460581,11
0.05,3133,96,259732,82.87555839183152,6
0.05,3134,94,259826,82.87910685805423,7
0.05,3135,94,259920,82.88265306122449,7
0.05,3136,95,260015,82.88651577940708,6
0.05,3137,94,260109,82.89005736137668,7
0.05,3138,94,260203,82.89359668684294,7
0.05,3139,94,260297,82.89713375796178,7
0.05,3140,92,260389,82.90003183699459,9
0.05,3141,92,260481,82.90292807129217,9
0.05,3142,95,260576,82.90677696468342,6
0.05,3143,94,260670,82.91030534351145,10
0.05,3144,92,260762,82.91319554848967,9
0.05,3145,93,260855,82.91640178003814,8
0.05,3146,91,260946,82.91897044804576,10
0.05,3147,95,261041,82.9228081321474,6
0.05,3148,93,261134,82.9260082565894,8
0.05,3149,96,261230,82.93015873015872,6
0.05,3150,23,261253,82.91113932085052,9
0.05,3151,95,261348,82.91497461928934,7
0.05,3152,94,261442,82.91849032667301,7
0.05,3153,94,261536,82.92200380469245,7
0.05,3154,93,261629,82.92519809825673,8
0.05,3155,23,261652,82.90621039290241,9
0.05,3156,95,261747,82.91004117833386,6
0.05,3157,96,261843,82.91418619379354,6
0.05,3158,25,261868,82.89585311807534,7
0.05,3159,92,261960,82.89873417721519,9
0.05,3160,26,261986,82.88073394495413,6
0.05,3161,94,262080,82.88425047438331,8
0.05,3162,95,262175,82.88808093582043,6
0.05,3163,94,262269,82.89159292035399,7
0.05,3164,90,262359,82.89383886255924,12
0.05,3165,93,262452,82.89703095388502,8
0.05,3166,92,262544,82.89990527312915,9
0.05,3167,96,262640,82.9040404040404,6
0.05,3168,94,262734,82.90754181129694,7
0.05,3169,96,262830,82.91167192429022,6
0.05,3170,94,262924,82.91516871649321,7
0.05,3171,25,262949,82.8969104665826,7
0.05,3172,90,263039,82.89914907028049,11
0.05,3173,95,263134,82.90296156269692,6
0.05,3174,92,263226,82.90582677165354,9
0.05,3175,94,263320,82.90931989924434,7
0.05,3176,96,263416,82.91344035253384,6
0.05,3177,-50,263366,82.87161736941472,13
0.05,3178,95,263461,82.87543252595155,6
0.05,3179,27,263488,82.85786163522013,6
0.05,3180,95,263583,82.86167871738446,6
0.05,3181,91,263674,82.86423632935261,10
0.05,3182,95,263769,82.86804901036757,8
0.05,3183,27,263796,82.85050251256281,6
0.05,3184,94,263890,82.85400313971742,7
0.05,3185,94,263984,82.85750156936598,8
0.05,3186,94,264078,82.86099780357704,7
0.05,3187,92,264170,82.86386449184441,9
0.05,3188,94,264264,82.86735653809971,7
0.05,3189,91,264355,82.86990595611286,10
0.05,3190,94,264449,82.87339392040113,7
0.05,3191,94,264543,82.87687969924812,7
0.05,3192,93,264636,82.88005010961479,8
0.05,3193,91,264727,82.88259236067627,10
0.05,3194,24,264751,82.86416275430359,10
0.05,3195,92,264843,82.86702127659575,10
0.05,3196,93,264936,82.87019080387864,8
0.05,3197,93,265029,82.87335834896811,8
0.05,3198,90,265119,82.8755861206627,11
0.05,3199,94,265213,82.8790625,7
0.05,3200,20,265233,82.85941893158387,12
0.05,3201,94,265327,82.8628981886321,7
0.05,3202,96,265423,82.8669996877927,6
0.05,3203,21,265444,82.84769038701623,11
0.05,3204,92,265536,82.85054602184087,9
0.05,3205,93,265629,82.853711790393,8
0.05,3206,94,265723,82.8571874025569,7
0.05,3207,93,265816,82.86034912718205,8
0.05,3208,92,265908,82.86319725771268,9
0.05,3209,92,266000,82.86604361370716,9
0.05,3210,94,266094,82.86951105574587,7
0.05,3211,94,266188,82.87297633872976,7
0.05,3212,96,266284,82.87706193588546,6
0.05,3213,96,266380,82.88114499066583,6
0.05,3214,88,266468,82.88273716951788,13
0.05,3215,96,266564,82.886815920398,6
0.05,3216,93,266657,82.88995958967982,8
0.05,3217,96,266753,82.89403356121815,6
0.05,3218,94,266847,82.89748369058714,7
0.05,3219,93,266940,82.90062111801242,8
0.05,3220,26,266966,82.88295560384974,8
0.05,3221,96,267062,82.88702669149596,6
0.05,3222,95,267157,82.89078498293516,6
0.05,3223,95,267252,82.89454094292805,6
0.05,3224,22,267274,82.87565891472869,10
0.05,3225,26,267300,82.8580285182889,6
0.05,3226,96,267396,82.86210102262163,6
0.05,3227,93,267489,82.86524163568774,8
0.05,3228,95,267584,82.8689996903066,6
0.05,3229,95,267679,82.87275541795665,6
0.05,3230,94,267773,82.87619931909626,7
0.05,3231,92,267865,82.87902227722772,9
0.05,3232,92,267957,82.88184348901949,9
0.05,3233,23,267980,82.86332714904144,9
0.05,3234,96,268076,82.86738794435858,6
0.05,3235,94,268170,82.8708281829419,7
0.05,3236,92,268262,82.8736484399135,9
0.05,3237,94,268356,82.87708462013589,7
0.05,3238,94,268450,82.8805186786045,7
0.05,3239,96,268546,82.88456790123456,6
0.05,3240,95,268641,82.88830607837087,6
0.05,3241,94,268735,82.89173349784083,7
0.05,3242,94,268829,82.89515880357693,7
0.05,3243,94,268923,82.89858199753391,7
0.05,3244,95,269018,82.90231124807396,6
0.05,3245,94,269112,82.90573012939002,7
0.05,3246,92,269204,82.90853095164768,9
0.05,3247,92,269296,82.91133004926108,9
0.05,3248,27,269323,82.89412126808249,6
0.05,3249,93,269416,82.89723076923077,8
0.05,3250,94,269510,82.90064595509074,7
0.05,3251,94,269604,82.90405904059041,7
0.05,3252,23,269627,82.88564402090378,9
0.05,3253,92,269719,82.88844499078058,9
0.05,3254,94,269813,82.89185867895546,7
0.05,3255,94,269907,82.89527027027027,7
0.05,3256,92,269999,82.89806570463617,9
0.05,3257,25,270024,82.88029465930019,7
0.05,3258,23,270047,82.86192083461185,9
0.05,3259,94,270141,82.86533742331288,7
0.05,3260,94,270235,82.86875191659,7
0.05,3261,94,270329,82.87216431637033,7
0.05,3262,96,270425,82.87618755746246,6
0.05,3263,24,270449,82.85814950980392,8
0.05,3264,91,270540,82.86064318529863,10
0.05,3265,94,270634,82.86405388854868,7
0.05,3266,24,270658,82.8460361187634,8
0.05,3267,96,270754,82.8500611995104,6
0.05,3268,96,270850,82.85408381768124,6
0.05,3269,25,270875,82.83639143730886,7
0.05,3270,94,270969,82.83980434118007,7
0.05,3271,95,271064,82.84352078239608,6
0.05,3272,92,271156,82.84631836235869,9
0.05,3273,94,271250,82.84972510690287,7
0.05,3274,92,271342,82.85251908396947,9
0.05,3275,94,271436,82.85592185592185,7
0.05,3276,94,271530,82.85932255111382,8
0.05,3277,96,271626,82.8633312995729,6
0.05,3278,94,271720,82.86672766087221,7
0.05,3279,96,271816,82.87073170731708,6
0.05,3280,96,271912,82.87473331301433,6
0.05,3281,95,272007,82.87842778793419,6
0.05,3282,94,272101,82.88181541273225,7
0.05,3283,95,272196,82.88550548112059,6
0.05,3284,21,272217,82.86666666666666,11
0.05,3285,94,272311,82.87005477784541,9
0.05,3286,94,272405,82.87344082750228,7
0.05,3287,95,272500,82.87712895377129,6
0.05,3288,94,272594,82.88051079355427,8
0.05,3289,94,272688,82.8838905775076,7
0.05,3290,95,272783,82.88757216651474,6
0.05,3291,94,272877,82.89094775212637,8
0.05,3292,95,272972,82.8946249620407,6
0.05,3293,92,273064,82.89738919247117,9
0.05,3294,94,273158,82.90075872534143,7
0.05,3295,93,273251,82.90382281553399,8
0.05,3296,95,273346,82.90749165908402,6
0.05,3297,95,273441,82.9111582777441,6
0.05,3298,95,273536,82.91482267353743,6
0.05,3299,96,273632,82.91878787878788,6
0.05,3300,92,273724,82.9215389275977,9
0.05,3301,95,273819,82.9251968503937,6
0.05,3302,95,273914,82.92885255828035,6
0.05,3303,94,274008,82.9322033898305,7
0.05,3304,94,274102,82.93555219364599,7
0.05,3305,92,274194,82.9382940108893,10
0.05,3306,95,274289,82.94194133655881,6
0.05,3307,94,274383,82.94528415961305,7
0.05,3308,94,274477,82.94862496222424,7
0.05,3309,94,274571,82.95196374622357,7
0.05,3310,23,274594,82.93385684083358,9
0.05,3311,21,274615,82.91515700483092,11
0.05,3312,92,274707,82.91789918502867,9
0.05,3313,95,274802,82.92154496077248,6
0.05,3314,96,274898,82.92549019607843,6
0.05,3315,95,274993,82.92913148371532,6
0.05,3316,93,275086,82.93216762134459,8
0.05,3317,90,275176,82.93429776974081,11
0.05,3318,95,275271,82.93793311238325,6
0.05,3319,94,275365,82.94126506024097,7
0.05,3320,91,275456,82.9436916591388,10
0.05,3321,27,275483,82.92685129440096,6
0.05,3322,94,275577,82.9301835690641,9
0.05,3323,94,275671,82.9335138387485,7
0.05,3324,96,275767,82.93744360902255,6
0.05,3325,94,275861,82.94076969332532,8
0.05,3326,95,275956,82.9443943492636,6
0.05,3327,20,275976,82.92548076923077,12
0.05,3328,93,276069,82.92850705917694,10
0.05,3329,95,276164,82.93213213213214,6
0.05,3330,96,276260,82.93605523866707,6
0.05,3331,92,276352,82.93877551020408,9
0.05,3332,94,276446,82.94209420942094,7
0.05,3333,25,276471,82.9247150569886,7
0.05,3334,18,276489,82.90524737631185,14
0.05,3335,94,276583,82.90857314148681,7
0.05,3336,91,276674,82.91099790230746,10
0.05,3337,94,276768,82.9143199520671,8
0.05,3338,94,276862,82.91764001197963,7
0.05,3339,27,276889,82.90089820359282,6
0.05,3340,21,276910,82.8823705477402,11
0.05,3341,94,277004,82.88569718731299,7
0.05,3342,92,277096,82.88842357164224,9
0.05,3343,96,277192,82.89234449760765,6
0.05,3344,27,277219,82.87563527653214,6
0.05,3345,92,277311,82.87836222355051,9
0.05,3346,94,277405,82.88168509112639,7
0.05,3347,93,277498,82.8847072879331,9
0.05,3348,94,277592,82.88802627650045,7
0.05,3349,92,277684,82.89074626865671,9
0.05,3350,94,277778,82.89406147418681,7
0.05,3351,93,277871,82.89707637231504,8
0.05,3352,93,277964,82.90008947211453,8
0.05,3353,87,278051,82.90131186642814,14
0.05,3354,95,278146,82.90491803278688,6
0.05,3355,90,278236,82.90703218116806,11
0.05,3356,94,278330,82.91033661006851,7
0.05,3357,25,278355,82.89309112567004,8
0.05,3358,94,278449,82.89639773742185,7
0.05,3359,94,278543,82.89970238095238,7
0.05,3360,94,278637,82.90300505801845,7
0.05,3361,94,278731,82.90630577037477,7
0.05,3362,96,278827,82.91019922688076,6
0.05,3363,89,278916,82.91200951248514,12
0.05,3364,92,279008,82.9147102526003,10
0.05,3365,94,279102,82.91800356506239,7
0.05,3366,93,279195,82.92099792099792,8
0.05,3367,96,279291,82.92488123515439,6
0.05,3368,96,279387,82.92876224398931,6
0.05,3369,22,279409,82.9106824925816,10
0.05,3370,94,279503,82.91397211509938,9
0.05,3371,95,279598,82.91755634638197,7
0.05,3372,94,279692,82.92084198043285,8
0.05,3373,96,279788,82.92471843509188,6
0.05,3374,93,279881,82.9277037037037,10
0.05,3375,94,279975,82.93098341232228,7
0.05,3376,92,280067,82.93366893692627,9
0.05,3377,94,280161,82.93694493783303,7
0.05,3378,95,280256,82.94051494525007,6
0.05,3379,93,280349,82.94349112426036,8
0.05,3380,94,280443,82.94676131322095,7
0.05,3381,93,280536,82.94973388527498,8
0.05,3382,89,280625,82.9515223174697,12
0.05,3383,94,280719,82.95478723404256,7
0.05,3384,91,280810,82.95716395864106,11
0.05,3385,91,280901,82.95953927938571,10
0.05,3386,95,280996,82.96309418364334,6
0.05,3387,23,281019,82.94539551357734,9
0.05,3388,95,281114,82.94895249336088,6
0.05,3389,94,281208,82.95221238938053,7
0.05,3390,91,281299,82.95458566794456,10
0.05,3391,95,281394,82.95813679245283,6
0.05,3392,92,281486,82.96080165045683,9
0.05,3393,93,281579,82.96375957572187,8
0.05,3394,25,281604,82.94668630338734,7
0.05,3395,96,281700,82.95053003533569,6
0.05,3396,95,281795,82.95407712687665,8
0.05,3397,92,281887,82.95673925838729,9
0.05,3398,93,281980,82.95969402765519,8
0.05,3399,96,282076,82.96352941176471,6
0.05,3400,96,282172,82.96736254042929,6
0.05,3401,96,282268,82.97119341563786,6
0.05,3402,96,282364,82.97502203937702,6
0.05,3403,93,282457,82.97796709753231,8
0.05,3404,26,282483,82.9612334801762,8
0.05,3405,25,282508,82.94421608925425,7
0.05,3406,94,282602,82.94746110948049,7
0.05,3407,94,282696,82.95070422535211,7
0.05,3408,93,282789,82.95365209738927,8
0.05,3409,94,282883,82.95689149560117,7
0.05,3410,96,282979,82.960715332747,6
0.05,3411,94,283073,82.96395076201641,7
0.05,3412,94,283167,82.96718429534134,7
0.05,3413,93,283260,82.9701230228471,9
0.05,3414,95,283355,82.97364568081991,6
0.05,3415,92,283447,82.97628805620609,10
0.05,3416,93,283540,82.97922153936202,8
0.05,3417,96,283636,82.98303101228788,6
0.05,3418,96,283732,82.98683825680024,6
0.05,3419,93,283825,82.98976608187135,8
0.05,3420,94,283919,82.99298450745395,7
0.05,3421,94,284013,82.99620105201636,8
0.05,3422,93,284106,82.99912357581069,8
0.05,3423,92,284198,83.0017523364486,9
0.05,3424,96,284294,83.00554744525547,6
0.05,3425,95,284389,83.00904845300641,6
0.05,3426,92,284481,83.01167201634082,9
0.05,3427,94,284575,83.01487747957994,7
0.05,3428,92,284667,83.0174978127734,9
0.05,3429,94,284761,83.02069970845481,7
0.05,3430,95,284856,83.02419119790149,6
0.05,3431,21,284877,83.00611888111888,11
0.05,3432,95,284972,83.00961258374599,6
0.05,3433,95,285067,83.01310425160163,7
0.05,3434,90,285157,83.01513828238718,11
0.05,3435,94,285251,83.01833527357392,7
0.05,3436,95,285346,83.02182135583358,6
0.05,3437,94,285440,83.02501454333915,8
0.05,3438,23,285463,83.00756033730735,10
0.05,3439,93,285556,83.01046511627906,8
0.05,3440,91,285647,83.01278698052892,10
0.05,3441,94,285741,83.01597908192912,7
0.05,3442,93,285834,83.01887888469358,8
0.05,3443,94,285928,83.02206736353078,7
0.05,3444,94,286022,83.02525399129173,7
0.05,3445,94,286116,83.02843876958792,7
0.05,3446,94,286210,83.031621700029,7
0.05,3447,96,286306,83.03538283062645,6
0.05,3448,25,286331,83.01855610321833,8
0.05,3449,94,286425,83.02173913043478,7
0.05,3450,94,286519,83.02492031295277,7
0.05,3451,95,286614,83.02838933951332,6
0.05,3452,93,286707,83.03127715030408,8
0.05,3453,93,286800,83.03416328894036,8
0.05,3454,96,286896,83.03791606367584,6
0.05,3455,26,286922,83.02141203703704,8
0.05,3456,23,286945,83.00404975412206,9
0.05,3457,94,287039,83.00722961249276,7
0.05,3458,96,287135,83.01098583405609,6
0.05,3459,94,287229,83.01416184971099,7
0.05,3460,94,287323,83.01733603004912,7
0.05,3461,96,287419,83.0210860774119,6
0.05,3462,92,287511,83.02367889113485,9
0.05,3463,94,287605,83.02684757505774,7
0.05,3464,24,287629,83.00981240981241,10
0.05,3465,93,287722,83.01269474899019,8
0.05,3466,20,287742,82.99451975771561,12
0.05,3467,96,287838,82.99826989619378,6
0.05,3468,23,287861,82.98097434419141,10
0.05,3469,90,287951,82.98299711815562,11
0.05,3470,93,288044,82.98588303082686,8
0.05,3471,92,288136,82.98847926267281,10
0.05,3472,22,288158,82.9709185142528,10
0.05,3473,91,288249,82.97322970639033,10
0.05,3474,25,288274,82.95654676258992,8
0.05,3475,91,288365,82.95886075949367,10
0.05,3476,26,288391,82.9424791486914,6
0.05,3477,96,288487,82.94623346751007,6
0.05,3478,90,288577,82.94826099453866,11
0.05,3479,94,288671,82.95143678160919,7
0.05,3480,94,288765,82.95461074403907,7
0.05,3481,95,288860,82.95807007466973,6
0.05,3482,93,288953,82.96095320126328,8
0.05,3483,95,289048,82.96440872560275,6
0.05,3484,94,289142,82.96757532281205,7
0.05,3485,15,289157,82.94807802639129,17
0.05,3486,94,289251,82.95124749067966,7
0.05,3487,95,289346,82.95470183486239,7
0.05,3488,94,289440,82.95786758383491,7
0.05,3489,93,289533,82.96074498567336,8
0.05,3490,25,289558,82.94414207963334,7
0.05,3491,95,289653,82.94759450171821,8
0.05,3492,96,289749,82.95133123389637,6
0.05,3493,95,289844,82.9547796222095,6
0.05,3494,94,289938,82.95793991416309,7
0.05,3495,96,290034,82.9616704805492,6
0.05,3496,18,290052,82.94309408064055,14
0.05,3497,25,290077,82.92652944539736,7
0.05,3498,92,290169,82.92912260645899,9
0.05,3499,95,290264,82.93257142857144,6
0.05,3500,95,290359,82.93601828049128,6
0.05,3501,94,290453,82.93917761279269,7
0.05,3502,95,290548,82.94262061090494,7
0.05,3503,-48,290500,82.90525114155251,11
0.05,3504,95,290595,82.90870185449359,6
0.05,3505,94,290689,82.91186537364518,8
0.05,3506,92,290781,82.91445680068435,10
0.05,3507,22,290803,82.89709236031928,10
0.05,3508,95,290898,82.90054146480479,6
0.05,3509,92,290990,82.9031339031339,9
0.05,3510,96,291086,82.90686414127029,6
0.05,3511,96,291182,82.91059225512528,6
0.05,3512,92,291274,82.91317961855964,9
0.05,3513,96,291370,82.91690381331816,6
0.05,3514,94,291464,82.92005689900427,7
0.05,3515,91,291555,82.92235494880546,10
0.05,3516,95,291650,82.92578902473699,6
0.05,3517,94,291744,82.92893689596362,7
0.05,3518,23,291767,82.9119067917022,9
0.05,3519,94,291861,82.91505681818182,7
0.05,3520,26,291887,82.89889236012496,7
0.05,3521,26,291913,82.88273708120386,6
0.05,3522,96,292009,82.88646040306557,6
0.05,3523,94,292103,82.88961407491487,8
0.05,3524,95,292198,82.89304964539006,6
0.05,3525,91,292289,82.8953488372093,10
0.05,3526,25,292314,82.8789339381911,7
0.05,3527,96,292410,82.88265306122449,6
0.05,3528,90,292500,82.88466987815245,11
0.05,3529,94,292594,82.88781869688385,7
0.05,3530,95,292689,82.8912489379779,6
0.05,3531,94,292783,82.89439411098527,7
0.05,3532,93,292876,82.89725445796773,8
0.05,3533,94,292970,82.9003961516695,7
0.05,3534,95,293065,82.9038189533239,8
0.05,3535,88,293153,82.90526018099547,13
0.05,3536,94,293247,82.90839694656489,7
0.05,3537,92,293339,82.91096664782363,9
0.05,3538,94,293433,82.91410002825657,7
0.05,3539,23,293456,82.89717514124294,9
0.05,3540,96,293552,82.90087545890991,6
0.05,3541,94,293646,82.90400903444382,7
0.05,3542,95,293741,82.90742308777872,8
0.05,3543,96,293837,82.91111738148985,6
0.05,3544,94,293931,82.91424541607898,8
0.05,3545,94,294025,82.91737168640722,8
0.05,3546,93,294118,82.92021426557655,9
0.05,3547,27,294145,82.90445321307779,6
0.05,3548,95,294240,82.90786136939982,6
0.05,3549,95,294335,82.9112676056338,7
0.05,3550,87,294422,82.91241903689102,17
0.05,3551,94,294516,82.91554054054055,7
0.05,3552,95,294611,82.91894173937517,6
0.05,3553,94,294705,82.92205965109736,8
0.05,3554,25,294730,82.90576652601969,8
0.05,3555,95,294825,82.9091676040495,6
0.05,3556,94,294919,82.9122856339612,7
0.05,3557,94,295013,82.91540191118607,7
0.05,3558,93,295106,82.9182354593987,8
0.05,3559,21,295127,82.90084269662921,11
0.05,3560,96,295223,82.90452120190957,6
0.05,3561,94,295317,82.90763615946098,9
0.05,3562,95,295412,82.91103003087287,6
0.05,3563,25,295437,82.89478114478115,8
0.05,3564,23,295460,82.87798036465638,9
0.05,3565,94,295554,82.88109927089175,7
0.05,3566,96,295650,82.8847771236333,6
0.05,3567,94,295744,82.88789237668162,7
0.05,3568,95,295839,82.89128607453068,6
0.05,3569,92,295931,82.893837535014,11
0.05,3570,93,296024,82.89666760011201,9
0.05,3571,91,296115,82.89893617021276,10
0.05,3572,92,296207,82.90148334732717,9
0.05,3573,23,296230,82.8847229994404,9
0.05,3574,-46,296184,82.84867132867133,9
0.05,3575,94,296278,82.85178970917227,7
0.05,3576,94,296372,82.85490634610008,7
0.05,3577,23,296395,82.8381777529346,9
0.05,3578,96,296491,82.84185526683432,6
0.05,3579,95,296586,82.84525139664804,6
0.05,3580,25,296611,82.8290980173136,8
0.05,3581,95,296706,82.83249581239531,6
0.05,3582,91,296797,82.83477532793748,11
0.05,3583,96,296893,82.83844866071429,6
0.05,3584,94,296987,82.84156206415621,7
0.05,3585,92,297079,82.84411600669269,9
0.05,3586,94,297173,82.84722609422916,7
0.05,3587,95,297268,82.85061315496098,9
0.05,3588,94,297362,82.85371969908053,7
0.05,3589,94,297456,82.85682451253481,7
0.05,3590,92,297548,82.85937064884433,9
0.05,3591,94,297642,82.86247216035635,7
0.05,3592,21,297663,82.84525466184247,11
0.05,3593,93,297756,82.84808013355592,8
0.05,3594,92,297848,82.85062586926287,10
0.05,3595,92,297940,82.853170189099,10
0.05,3596,94,298034,82.85626911314985,7
0.05,3597,93,298127,82.85908838243469,8
0.05,3598,95,298222,82.86246179494304,6
0.05,3599,96,298318,82.86611111111111,6
0.05,3600,27,298345,82.85059705637323,6
0.05,3601,94,298439,82.85369239311494,8
0.05,3602,93,298532,82.85650846516792,9
0.05,3603,92,298624,82.85904550499446,9
0.05,3604,93,298717,82.8618585298197,9
0.05,3605,92,298809,82.86439267886855,9
0.05,3606,20,298829,82.84696423620737,13
0.05,3607,94,298923,82.8500554323725,8
0.05,3608,93,299016,82.85286783042395,8
0.05,3609,90,299106,82.85484764542936,11
0.05,3610,92,299198,82.85738022708391,9
0.05,3611,96,299294,82.86101882613511,6
0.05,3612,96,299390,82.86465541101578,6
0.05,3613,96,299486,82.8682899833979,6
0.05,3614,96,299582,82.87192254495159,6
0.05,3615,94,299676,82.875,8
0.05,3616,94,299770,82.87807575338678,7
0.05,3617,27,299797,82.86263128800442,6
0.05,3618,94,299891,82.86570875932578,7
0.05,3619,94,299985,82.86878453038673,7
0.05,3620,94,300079,82.87185860259596,8
0.05,3621,94,300173,82.87493097736058,7
0.05,3622,93,300266,82.87772564173336,8
0.05,3623,95,300361,82.8810706401766,7
0.05,3624,96,300457,82.88468965517241,6
0.05,3625,94,300551,82.88775510204081,8
0.05,3626,90,300641,82.88971601874827,11
0.05,3627,96,300737,82.89332965821389,6
0.05,3628,95,300832,82.89666574813998,6
0.05,3629,91,300923,82.89889807162534,10
0.05,3630,94,301017,82.90195538419168,7
0.05,3631,92,301109,82.9044603524229,9
0.05,3632,92,301201,82.90696394164603,9
0.05,3633,94,301295,82.91001651073198,7
0.05,3634,94,301389,82.9130674002751,7
0.05,3635,96,301485,82.91666666666667,6
0.05,3636,94,301579,82.91971405004124,7
0.05,3637,94,301673,82.92275975810885,7
0.05,3638,93,301766,82.92552899148117,8
0.05,3639,92,301858,82.92802197802197,9
0.05,3640,94,301952,82.93106289480912,7
0.05,3641,95,302047,82.93437671609006,6
0.05,3642,96,302143,82.93796321712874,6
0.05,3643,96,302239,82.94154774972557,6
0.05,3644,94,302333,82.94458161865569,8
0.05,3645,94,302427,82.94761382336807,7
0.05,3646,23,302450,82.93117630929531,9
0.05,3647,96,302546,82.93475877192982,6
0.05,3648,93,302639,82.93751712798027,8
0.05,3649,94,302733,82.94054794520548,7
0.05,3650,-46,302687,82.90523144344016,10
0.05,3651,89,302776,82.90690032858707,12
0.05,3652,93,302869,82.9096632904462,8
0.05,3653,24,302893,82.8935413245758,8
0.05,3654,94,302987,82.89658002735978,8
0.05,3655,94,303081,82.8996170678337,7
0.05,3656,95,303176,82.9029258955428,6
0.05,3657,94,303270,82.90595954073264,7
0.05,3658,-48,303222,82.87018311013938,11
0.05,3659,96,303318,82.87377049180328,6
0.05,3660,95,303413,82.87708276427206,6
0.05,3661,95,303508,82.8803932277444,6
0.05,3662,23,303531,82.86404586404586,9
0.05,3663,95,303626,82.86735807860262,6
0.05,3664,96,303722,82.87094133697136,6
0.05,3665,92,303814,82.873431533006,9
0.05,3666,96,303910,82.87701118080174,6
0.05,3667,94,304004,82.88004362050164,7
0.05,3668,92,304096,82.88252929953666,9
0.05,3669,94,304190,82.88555858310627,7
0.05,3670,96,304286,82.88913102696813,6
0.05,3671,21,304307,82.87227668845316,13
0.05,3672,95,304402,82.87557854614757,6
0.05,3673,96,304498,82.87915078933042,6
0.05,3674,95,304593,82.88244897959184,6
0.05,3675,95,304688,82.88574537540805,6
0.05,3676,94,304782,82.8887680174055,7
0.05,3677,93,304875,82.89151712887438,8
0.05,3678,23,304898,82.87523783636858,9
0.05,3679,95,304993,82.87853260869565,7
0.05,3680,95,305088,82.88182559087204,7
0.05,3681,95,305183,82.88511678435633,6
0.05,3682,95,305278,82.88840619060548,6
0.05,3683,96,305374,82.89196525515744,6
0.05,3684,95,305469,82.89525101763908,6
0.05,3685,90,305559,82.89717851329354,11
0.05,3686,94,305653,82.9001898562517,7
0.05,3687,95,305748,82.90347071583514,8
0.05,3688,92,305840,82.90593656817566,9
0.05,3689,22,305862,82.88943089430894,10
0.05,3690,96,305958,82.8929829314549,6
0.05,3691,94,306052,82.89599133261105,7
0.05,3692,26,306078,82.88058489033307,6
0.05,3693,90,306168,82.88251218191662,11
0.05,3694,94,306262,82.88552097428958,7
0.05,3695,92,306354,82.88798701298701,9
0.05,3696,94,306448,82.89099269678117,7
0.05,3697,92,306540,82.89345592212007,9
0.05,3698,95,306635,82.89672884563396,6
0.05,3699,96,306731,82.90027027027027,6
0.05,3700,94,306825,82.90326938665225,7
0.05,3701,94,306919,82.90626688276608,7
0.05,3702,94,307013,82.90926275992439,8
0.05,3703,96,307109,82.9127969762419,6
0.05,3704,94,307203,82.91578947368421,7
0.05,3705,92,307295,82.91824069077173,9
0.05,3706,94,307389,82.92123010520636,7
0.05,3707,94,307483,82.92421790722761,7
0.05,3708,94,307577,82.92720409813965,7
0.05,3709,92,307669,82.92964959568734,9
0.05,3710,95,307764,82.93290218270008,6
0.05,3711,95,307859,82.93615301724138,6
0.05,3712,96,307955,82.93967142472394,6
0.05,3713,96,308051,82.94318793753365,6
0.05,3714,92,308143,82.94562584118438,9
0.05,3715,95,308238,82.94886975242196,6
0.05,3716,94,308332,82.95184288404627,7
0.05,3717,95,308427,82.9550833781603,6
0.05,3718,94,308521,82.95805324011832,8
0.05,3719,22,308543,82.94166666666666,10
0.05,3720,26,308569,82.92636388067724,6
0.05,3721,96,308665,82.92987641053197,6
0.05,3722,92,308757,82.93231265108783,9
0.05,3723,94,308851,82.93528464017186,7
0.05,3724,92,308943,82.93771812080537,11
0.05,3725,95,309038,82.94095544820182,6
0.05,3726,96,309134,82.9444593506842,6
0.05,3727,95,309229,82.94769313304721,7
0.05,3728,94,309323,82.95065701260391,7
0.05,3729,92,309415,82.95308310991958,9
0.05,3730,92,309507,82.95550790672742,9
0.05,3731,95,309602,82.95873526259378,6
0.05,3732,95,309697,82.96196088936512,6
0.05,3733,88,309785,82.96331012319229,13
0.05,3734,93,309878,82.96599732262383,8
0.05,3735,95,309973,82.96921841541756,6
0.05,3736,89,310062,82.97083221835697,12
0.05,3737,95,310157,82.97405029427502,6
0.05,3738,95,310252,82.97726664883659,7
0.05,3739,92,310344,82.97967914438503,9
0.05,3740,94,310438,82.98262496658647,7
0.05,3741,94,310532,82.98556921432389,8
0.05,3742,94,310626,82.98851188885921,7
0.05,3743,94,310720,82.99145299145299,7
0.05,3744,93,310813,82.99412550066755,8
0.05,3745,93,310906,82.99679658302189,8
0.05,3746,94,311000,82.9997331198292,7
0.05,3747,95,311095,83.0029348986126,6
0.05,3748,94,311189,83.00586823152841,7
0.05,3749,22,311211,82.9896,11
0.05,3750,95,311306,82.99280191948813,6
0.05,3751,94,311400,82.99573560767591,7
0.05,3752,94,311494,82.99866773248068,7
0.05,3753,89,311583,83.00026638252531,12
0.05,3754,90,311673,83.00213049267643,11
0.05,3755,93,311766,83.00479233226837,8
0.05,3756,95,311861,83.00798509449028,6
0.05,3757,94,311955,83.01091005854178,7
0.05,3758,26,311981,82.99574354881618,6
0.05,3759,95,312076,82.99893617021277,6
0.05,3760,94,312170,83.00186120712577,7
0.05,3761,93,312263,83.00451887293993,9
0.05,3762,94,312357,83.00744087164496,7
0.05,3763,94,312451,83.01036131774708,7
0.05,3764,95,312546,83.01354581673307,6
0.05,3765,96,312642,83.0169941582581,6
0.05,3766,25,312667,83.00159277940006,7
0.05,3767,93,312760,83.00424628450106,9
0.05,3768,96,312856,83.00769434863359,6
0.05,3769,92,312948,83.01007957559682,9
0.05,3770,96,313044,83.01352426412092,6
0.05,3771,23,313067,82.99761399787911,9
0.05,3772,95,313162,83.0007951232441,8
0.05,3773,96,313258,83.0042395336513,6
0.05,3774,95,313353,83.00741721854304,6
0.05,3775,25,313378,82.99205508474576,7
0.05,3776,94,313472,82.99496955255493,7
0.05,3777,92,313564,82.99735309687665,11
0.05,3778,96,313660,83.00079386080974,6
0.05,3779,95,313755,83.00396825396825,6
0.05,3780,94,313849,83.00687648770166,7
0.05,3781,95,313944,83.01004759386568,6
0.05,3782,95,314039,83.01321702352631,6
0.05,3783,94,314133,83.01612050739958,7
0.05,3784,94,314227,83.01902245706736,7
0.05,3785,94,314321,83.02192287374538,7
0.05,3786,94,314415,83.024821758648,7
0.05,3787,93,314508,83.02745512143612,8
0.05,3788,95,314603,83.03061493797836,6
0.05,3789,95,314698,83.03377308707124,6
0.05,3790,94,314792,83.03666578739119,8
0.05,3791,96,314888,83.04008438818565,6
0.05,3792,17,314905,83.0226733456367,15
0.05,3793,93,314998,83.02530311017397,8
0.05,3794,96,315094,83.02872200263505,6
0.05,3795,96,315190,83.03213909378293,6
0.05,3796,95,315285,83.03529101922571,6
0.05,3797,23,315308,83.01948393891522,9
0.05,3798,20,315328,83.00289549881548,12
0.05,3799,95,315423,83.00605263157895,6
0.05,3800,94,315517,83.00894501446987,7
0.05,3801,94,315611,83.01183587585481,7
0.05,3802,94,315705,83.014725216934,7
0.05,3803,93,315798,83.0173501577287,8
0.05,3804,92,315890,83.0197109067017,9
0.05,3805,95,315985,83.02285864424593,6
0.05,3806,96,316081,83.02626740215393,6
0.05,3807,96,316177,83.0296743697479,6
0.05,3808,92,316269,83.03202940404306,10
0.05,3809,94,316363,83.03490813648294,7
0.05,3810,96,316459,83.03831015481501,6
0.05,3811,93,316552,83.04092339979013,8
0.05,3812,92,316644,83.0432730133753,9
0.05,3813,94,316738,83.04614577871001,7
0.05,3814,94,316832,83.04901703800786,7
0.05,3815,92,316924,83.05136268343816,9
0.05,3816,-119,316805,82.99842808488341,14
0.05,3817,94,316899,83.00130958617078,7
0.05,3818,95,316994,83.00445142707515,6
0.05,3819,94,317088,83.00732984293194,7
0.05,3820,94,317182,83.01020675215912,7
0.05,3821,96,317278,83.01360544217687,6
0.05,3822,92,317370,83.01595605545383,10
0.05,3823,95,317465,83.019089958159,6
0.05,3824,91,317556,83.02117647058823,12
0.05,3825,94,317650,83.02404600104548,8
0.05,3826,96,317746,83.02743663443951,6
0.05,3827,95,317841,83.03056426332289,6
0.05,3828,94,317935,83.03342909375816,7
0.05,3829,96,318031,83.03681462140992,6
0.05,3830,95,318126,83.0399373531715,6
0.05,3831,94,318220,83.0427974947808,7
0.05,3832,94,318314,83.04565614401253,7
0.05,3833,94,318408,83.04851330203442,7
0.05,3834,92,318500,83.05084745762711,9
0.05,3835,95,318595,83.05396246089677,6
0.05,3836,94,318689,83.05681522022414,7
0.05,3837,91,318780,83.05888483585201,10
0.05,3838,96,318876,83.06225579578015,6
0.05,3839,94,318970,83.06510416666667,7
0.05,3840,95,319065,83.0682114032804,6
0.05,3841,96,319161,83.07157730348777,6
0.05,3842,95,319256,83.07468123861567,7
0.05,3843,96,319352,83.07804370447451,6
0.05,3844,94,319446,83.08088426527958,7
0.05,3845,95,319541,83.08398335933437,6
0.05,3846,26,319567,83.0691447881466,6
0.05,3847,93,319660,83.07172557172557,8
0.05,3848,96,319756,83.07508443751624,6
0.05,3849,94,319850,83.07792207792208,7
0.05,3850,91,319941,83.07997922617501,10
0.05,3851,93,320034,83.08255451713396,8
0.05,3852,95,320129,83.0856475473657,6
0.05,3853,95,320224,83.0887389724961,6
0.05,3854,94,320318,83.09156939040207,7
0.05,3855,22,320340,83.07572614107883,12
0.05,3856,25,320365,83.06066891366346,8
0.05,3857,92,320457,83.06298600311042,9
0.05,3858,-49,320408,83.02876392847888,13
0.05,3859,26,320434,83.0139896373057,8
0.05,3860,21,320455,82.997927997928,11
0.05,3861,94,320549,83.00077679958571,7
0.05,3862,94,320643,83.00362412632668,7
0.05,3863,91,320734,83.00569358178053,10
0.05,3864,95,320829,83.00879689521345,6
0.05,3865,94,320923,83.01163993792034,7
0.05,3866,25,320948,82.99663822084302,7
0.05,3867,93,321041,82.99922440537746,8
0.05,3868,94,321135,83.00206771775653,7
0.05,3869,93,321228,83.0046511627907,8
0.05,3870,96,321324,83.00800826659778,6
0.05,3871,95,321419,83.01110537190083,6
0.05,3872,94,321513,83.01394268009295,7
0.05,3873,94,321607,83.01677852348993,7
0.05,3874,91,321698,83.01883870967742,10
0.05,3875,95,321793,83.0219298245614,6
0.05,3876,94,321887,83.02476141346402,7
0.05,3877,23,321910,83.00928313563692,9
0.05,3878,94,322004,83.01211652487754,7
0.05,3879,94,322098,83.01494845360824,7
0.05,3880,94,322192,83.017778922958,8
0.05,3881,22,322214,83.00206079340546,13
0.05,3882,94,322308,83.00489312387329,7
0.05,3883,95,322403,83.00798146240989,6
0.05,3884,94,322497,83.01081081081081,7
0.05,3885,95,322592,83.0138960370561,6
0.05,3886,22,322614,82.99819912528943,11
0.05,3887,94,322708,83.00102880658436,7
0.05,3888,94,322802,83.00385703265621,7
0.05,3889,96,322898,83.00719794344474,6
0.05,3890,96,322994,83.01053713698278,6
0.05,3891,95,323089,83.01361767728675,6
0.05,3892,94,323183,83.01643976367839,8
0.05,3893,94,323277,83.01926040061633,7
0.05,3894,94,323371,83.02207958921694,7
0.05,3895,95,323466,83.02515400410678,6
0.05,3896,94,323560,83.02797023351296,7
0.05,3897,94,323654,83.03078501795792,7
0.05,3898,96,323750,83.03411131059246,6
0.05,3899,96,323846,83.0374358974359,6
0.05,3900,95,323941,83.04050243527301,6
0.05,3901,91,324032,83.04254228600718,11
0.05,3902,95,324127,83.04560594414554,7
0.05,3903,94,324221,83.0484118852459,7
0.05,3904,94,324315,83.05121638924456,7
0.05,3905,96,324411,83.05453149001536,6
0.05,3906,94,324505,83.05733299206553,7
0.05,3907,94,324599,83.06013306038895,7
0.05,3908,95,324694,83.06318751598874,6
0.05,3909,89,324783,83.06470588235294,12
0.05,3910,92,324875,83.06699053950396,9
0.05,3911,95,324970,83.0700408997955,6
0.05,3912,94,325064,83.07283414260158,7
0.05,3913,95,325159,83.07588145120081,6
0.05,3914,95,325254,83.07892720306513,6
0.05,3915,93,325347,83.0814606741573,8
0.05,3916,92,325439,83.0837375542507,9
0.05,3917,93,325532,83.08626850433895,8
0.05,3918,95,325627,83.08930849706557,6
0.05,3919,27,325654,83.075,6
0.05,3920,95,325749,83.07804131599082,6
0.05,3921,95,325844,83.08108108108108,6
0.05,3922,20,325864,83.0650012745348,12
0.05,3923,26,325890,83.05045871559633,6
0.05,3924,92,325982,83.05273885350319,9
0.05,3925,94,326076,83.05552725420274,7
0.05,3926,94,326170,83.05831423478482,7
0.05,3927,94,326264,83.061099796334,7
0.05,3928,90,326354,83.06286586917791,11
0.05,3929,95,326449,83.06590330788804,6
0.05,3930,25,326474,83.05113202747393,7
0.05,3931,94,326568,83.05391658189217,8
0.05,3932,94,326662,83.05669972031528,7
0.05,3933,96,326758,83.05998983223182,6
0.05,3934,21,326779,83.04421855146124,11
0.05,3935,95,326874,83.04725609756098,6
0.05,3936,93,326967,83.0497840995682,8
0.05,3937,94,327061,83.05256475368208,7
0.05,3938,27,327088,83.03833460269104,6
0.05,3939,23,327111,83.0230964467005,9
0.05,3940,94,327205,83.02588175589952,7
0.05,3941,92,327297,83.02815829528159,9
0.05,3942,94,327391,83.03094090793812,7
0.05,3943,93,327484,83.03346855983773,8
0.05,3944,95,327579,83.03650190114068,6
0.05,3945,96,327675,83.03978712620375,6
0.05,3946,94,327769,83.04256397263745,7
0.05,3947,96,327865,83.04584599797366,6
0.05,3948,94,327959,83.0486199037731,7
0.05,3949,23,327982,83.03341772151899,10
0.05,3950,96,328078,83.03669956972918,6
0.05,3951,23,328101,83.02150809716599,9
0.05,3952,94,328195,83.02428535289654,7
0.05,3953,94,328289,83.02706120384421,7
0.05,3954,96,328385,83.03034134007585,6
0.05,3955,25,328410,83.01567239635996,8
0.05,3956,94,328504,83.01844831943392,7
0.05,3957,95,328599,83.02147549267306,6
0.05,3958,96,328695,83.0247537256883,6
0.05,3959,93,328788,83.02727272727273,8
0.05,3960,95,328883,83.03029537995455,6
0.05,3961,96,328979,83.03356890459364,6
0.05,3962,94,329073,83.03633610900833,7
0.05,3963,88,329161,83.03758829465187,15
0.05,3964,90,329251,83.03934426229509,11
0.05,3965,93,329344,83.04185577407968,8
0.05,3966,96,329440,83.04512225863373,6
0.05,3967,94,329534,83.04788306451613,7
0.05,3968,94,329628,83.0506424792139,7
0.05,3969,95,329723,83.0536523929471,6
0.05,3970,95,329818,83.0566607907328,6
0.05,3971,92,329910,83.05891238670695,9
0.05,3972,26,329936,83.04455071734206,6
0.05,3973,95,330031,83.04755913437343,6
0.05,3974,94,330125,83.0503144654088,7
0.05,3975,94,330219,83.05306841046277,7
0.05,3976,94,330313,83.05582097058084,7
0.05,3977,96,330409,83.05907491201609,6
0.05,3978,96,330505,83.06232721789394,6
0.05,3979,94,330599,83.06507537688442,7
0.05,3980,23,330622,83.04998744034162,9
0.05,3981,94,330716,83.05273731793069,7
0.05,3982,93,330809,83.05523474767763,8
0.05,3983,95,330904,83.0582329317269,6
0.05,3984,95,330999,83.06122961104141,6
0.05,3985,94,331093,83.06397390868038,8
0.05,3986,94,331187,83.06671682969652,7
0.05,3987,27,331214,83.05265797392177,6
0.05,3988,94,331308,83.05540235648031,7
0.05,3989,93,331401,83.0578947368421,8
0.05,3990,94,331495,83.06063643197194,7
0.05,3991,27,331522,83.04659318637275,6
0.05,3992,23,331545,83.03155522163786,9
0.05,3993,94,331639,83.03430145217827,7
0.05,3994,94,331733,83.03704630788485,7
0.05,3995,93,331826,83.03953953953953,8
0.05,3996,94,331920,83.04228171128347,7
0.05,3997,95,332015,83.04527263631816,7
0.05,3998,94,332109,83.04801200300075,7
0.05,3999,94,332203,83.05075,7
0.05,4000,95,332298,83.05373656585853,6
0.05,4001,95,332393,83.05672163918041,6
0.05,4002,94,332487,83.05945540844367,7
0.05,4003,89,332576,83.06093906093906,13
0.05,4004,93,332669,83.06342072409488,8
0.05,4005,93,332762,83.06590114827759,9
0.05,4006,94,332856,83.06862989767906,8
0.05,4007,92,332948,83.07085828343314,9
0.05,4008,94,333042,83.0735844350212,7
0.05,4009,94,333136,83.07630922693266,7
0.05,4010,94,333230,83.0790326601845,7
0.05,4011,94,333324,83.08175473579263,7
0.05,4012,96,333420,83.08497383503614,6
0.05,4013,94,333514,83.08769307424016,7
0.05,4014,25,333539,83.07322540473226,7
0.05,4015,96,333635,83.07644422310757,6
0.05,4016,94,333729,83.07916355489171,7
0.05,4017,95,333824,83.08213041314086,6
0.05,4018,95,333919,83.08509579497387,6
0.05,4019,94,334013,83.08781094527363,7
0.05,4020,93,334106,83.09027605073365,8
0.05,4021,93,334199,83.09273993038289,8
0.05,4022,95,334294,83.0956997265722,7
0.05,4023,96,334390,83.09890656063618,6
0.05,4024,96,334486,83.10211180124223,6
0.05,4025,94,334580,83.10481867858917,7
0.05,4026,23,334603,83.08989322075988,9
0.05,4027,95,334698,83.09285004965243,6
0.05,4028,96,334794,83.09605361131794,6
0.05,4029,22,334816,83.08089330024814,11
0.05,4030,93,334909,83.08335400645001,8
0.05,4031,96,335005,83.08655753968254,6
0.05,4032,25,335030,83.07215472353087,8
0.05,4033,94,335124,83.07486365889936,7
0.05,4034,92,335216,83.07707558859975,9
0.05,4035,94,335310,83.07978196233896,7
0.05,4036,94,335404,83.08248699529354,7
0.05,4037,26,335430,83.06835066864785,6
0.05,4038,95,335525,83.0713047784105,6
0.05,4039,24,335549,83.05668316831684,8
0.05,4040,94,335643,83.05939123979213,7
0.05,4041,94,335737,83.06209797130134,7
0.05,4042,24,335761,83.04748948800396,8
0.05,4043,20,335781,83.03189910979229,12
0.05,4044,92,335873,83.03411619283065,9
0.05,4045,95,335968,83.03707365299061,6
0.05,4046,94,336062,83.039782554979,7
0.05,4047,95,336157,83.0427371541502,6
0.05,4048,94,336251,83.0454433193381,7
0.05,4049,94,336345,83.04814814814814,7
0.05,4050,94,336439,83.05085164156998,7
0.05,4051,95,336534,83.05380059230009,7
0.05,4052,94,336628,83.05650135701948,7
0.05,4053,95,336723,83.05944745929946,8
0.05,4054,96,336819,83.06263871763255,6
0.05,4055,95,336914,83.06558185404339,6
0.05,4056,94,337008,83.06827705200887,8
0.05,4057,25,337033,83.05396747166091,7
0.05,4058,25,337058,83.03966494210397,8
0.05,4059,94,337152,83.0423645320197,7
0.05,4060,94,337246,83.04506279241566,7
0.05,4061,96,337342,83.04825209256524,6
0.05,4062,94,337436,83.050947575683,8
0.05,4063,92,337528,83.05314960629921,9
0.05,4064,93,337621,83.05559655596556,10
0.05,4065,92,337713,83.05779636005903,9
0.05,4066,94,337807,83.06048684534055,7
0.05,4067,95,337902,83.06342182890856,6
0.05,4068,93,337995,83.06586384861146,8
0.05,4069,95,338090,83.06879606879608,6
0.05,4070,94,338184,83.07148120854826,7
0.05,4071,25,338209,83.05722003929273,7
0.05,4072,95,338304,83.06015222194942,7
0.05,4073,26,338330,83.04614629356898,7
0.05,4074,95,338425,83.04907975460122,7
0.05,4075,96,338521,83.05225711481845,6
0.05,4076,95,338616,83.0551876379691,6
0.05,4077,96,338712,83.0583619421285,6
0.05,4078,96,338808,83.06153468987497,6
0.05,4079,94,338902,83.06421568627451,7
0.05,4080,94,338996,83.06689536878216,7
0.05,4081,94,339090,83.06957373836354,7
0.05,4082,23,339113,83.05486162135685,9
0.05,4083,91,339204,83.05680705190989,10
0.05,4084,93,339297,83.05924112607099,8
0.05,4085,93,339390,83.06167400881057,8
0.05,4086,93,339483,83.06410570100319,10
0.05,4087,93,339576,83.0665362035225,8
0.05,4088,93,339669,83.06896551724138,8
0.05,4089,25,339694,83.05476772616137,7
0.05,4090,96,339790,83.05793204595453,6
0.05,4091,26,339816,83.04398826979472,6
0.05,4092,96,339912,83.04715367700953,6
0.05,4093,93,340005,83.0495847581827,8
0.05,4094,94,340099,83.05225885225886,7
0.05,4095,95,340194,83.05517578125,6
0.05,4096,96,340290,83.05833536734195,6
0.05,4097,92,340382,83.06051732552464,9
0.05,4098,90,340472,83.06221029519395,12
0.05,4099,96,340568,83.06536585365853,6
0.05,4100,94,340662,83.0680321872714,7
0.05,4101,27,340689,83.0543637250122,6
0.05,4102,95,340784,83.05727516451377,6
0.05,4103,94,340878,83.05994152046783,7
0.05,4104,94,340972,83.0626065773447,7
0.05,4105,93,341065,83.06502679006333,9
0.05,4106,95,341160,83.06793279766252,8
0.05,4107,95,341255,83.07083739045764,6
0.05,4108,92,341347,83.07301046483329,9
0.05,4109,95,341442,83.07591240875912,6
0.05,4110,27,341469,83.06227195329603,6
0.05,4111,94,341563,83.06493190661479,7
0.05,4112,95,341658,83.06783369803064,7
0.05,4113,90,341748,83.06951871657753,11
0.05,4114,94,341842,83.07217496962333,8
0.05,4115,96,341938,83.07531584062197,6
0.05,4116,26,341964,83.06145251396649,6
0.05,4117,92,342056,83.06362311801846,9
0.05,4118,94,342150,83.06627822286963,7
0.05,4119,95,342245,83.06917475728156,6
0.05,4120,96,342341,83.07231254549866,6
0.05,4121,96,342437,83.07544881125668,6
0.05,4122,95,342532,83.07834101382488,6
0.05,4123,92,342624,83.08050436469448,9
0.05,4124,94,342718,83.08315151515151,7
0.05,4125,93,342811,83.08555501696559,8
0.05,4126,94,342905,83.08819966077054,7
0.05,4127,96,343001,83.09132751937985,6
0.05,4128,25,343026,83.07725841608138,7
0.05,4129,95,343121,83.08014527845036,7
0.05,4130,96,343217,83.08327281529895,6
0.05,4131,92,343309,83.08543078412391,9
0.05,4132,95,343404,83.0883135736753,6
0.05,4133,25,343429,83.07426221577165,8
0.05,4134,96,343525,83.07738814993954,6
0.05,4135,92,343617,83.07954545454545,9
0.05,4136,96,343713,83.0826686004351,6
0.05,4137,91,343804,83.0845819236346,10
0.05,4138,93,343897,83.08697753080455,8
0.05,4139,94,343991,83.08961352657005,7
0.05,4140,23,344014,83.07510263221444,9
0.05,4141,91,344105,83.07701593433124,10
0.05,4142,88,344193,83.07820419985518,13
0.05,4143,96,344289,83.08132239382239,6
0.05,4144,95,344384,83.08419782870929,6
0.05,4145,96,344480,83.0873130728413,6
0.05,4146,93,344573,83.08970340004822,9
0.05,4147,90,344663,83.09136933461909,11
0.05,4148,-47,344616,83.06001446131597,10
0.05,4149,95,344711,83.06289156626507,6
0.05,4150,96,344807,83.0660081907974,6
0.05,4151,95,344902,83.06888246628131,6
0.05,4152,95,344997,83.07175535757284,8
0.05,4153,23,345020,83.05729417428984,9
0.05,4154,93,345113,83.05968712394706,8
0.05,4155,95,345208,83.06256015399423,6
0.05,4156,96,345304,83.06567235987491,6
0.05,4157,94,345398,83.06830206830207,7
0.05,4158,92,345490,83.07044962731426,9
0.05,4159,95,345585,83.0733173076923,6
0.05,4160,96,345681,83.07642393655371,6
0.05,4161,90,345771,83.0780874579529,11
0.05,4162,93,345864,83.0804708143166,8
0.05,4163,94,345958,83.08309317963497,8
0.05,4164,95,346053,83.0859543817527,6
0.05,4165,95,346148,83.08881421027364,6
0.05,4166,93,346241,83.09119270458363,8
0.05,4167,96,346337,83.09428982725528,6
0.05,4168,90,346427,83.09594627008875,11
0.05,4169,92,346519,83.09808153477218,9
0.05,4170,96,346615,83.10117477823064,6
0.05,4171,93,346708,83.10354745925216,8
0.05,4172,94,346802,83.10615863886892,7
0.05,4173,95,346897,83.10900814566364,6
0.05,4174,94,346991,83.11161676646707,8
0.05,4175,94,347085,83.11422413793103,7
0.05,4176,94,347179,83.11683026095284,7
0.05,4177,92,347271,83.11895643848732,9
0.05,4178,91,347362,83.12084230677195,10
0.05,4179,95,347457,83.12368421052632,6
0.05,4180,92,347549,83.12580722315235,9
0.05,4181,96,347645,83.12888570062171,6
0.05,4182,94,347739,83.13148458044466,8
0.05,4183,93,347832,83.1338432122371,9
0.05,4184,92,347924,83.13596176821983,9
0.05,4185,95,348019,83.13879598662207,7
0.05,4186,92,348111,83.14091234774301,9
0.05,4187,94,348205,83.14350525310411,7
0.05,4188,90,348295,83.14514203867272,11
0.05,4189,94,348389,83.14773269689738,7
0.05,4190,95,348484,83.15056072536387,8
0.05,4191,92,348576,83.1526717557252,9
0.05,4192,91,348667,83.15454328642977,10
0.05,4193,87,348754,83.15546018121125,14
0.05,4194,94,348848,83.15804529201431,7
0.05,4195,95,348943,83.16086749285033,6
0.05,4196,95,349038,83.16368834882059,6
0.05,4197,96,349134,83.16674606955694,6
0.05,4198,94,349228,83.16932603000714,7
0.05,4199,94,349322,83.17190476190476,7
0.05,4200,93,349415,83.17424422756487,8
0.05,4201,94,349509,83.17682056163731,7
0.05,4202,96,349605,83.17987152034262,6
0.05,4203,24,349629,83.16579448144624,8
0.05,4204,91,349720,83.16765755053508,10
0.05,4205,91,349811,83.16951973371374,10
0.05,4206,92,349903,83.17161873068694,9
0.05,4207,94,349997,83.17419201520913,8
0.05,4208,94,350091,83.1767640769779,8
0.05,4209,94,350185,83.1793349168646,7
0.05,4210,94,350279,83.18190453573973,8
0.05,4211,26,350305,83.16832858499525,6
0.05,4212,20,350325,83.153334915737,12
0.05,4213,94,350419,83.15590887517797,7
0.05,4214,94,350513,83.15848161328589,7
0.05,4215,96,350609,83.1615275142315,6
0.05,4216,95,350704,83.1643348351909,6
0.05,4217,96,350800,83.16737790422,6
0.05,4218,94,350894,83.16994548471202,7
0.05,4219,96,350990,83.17298578199052,6
0.05,4220,94,351084,83.17555081734186,7
0.05,4221,94,351178,83.17811463761251,8
0.05,4222,93,351271,83.18044044518115,8
0.05,4223,94,351365,83.18300189393939,7
0.05,4224,93,351458,83.18532544378698,8
0.05,4225,23,351481,83.17108376715571,9
0.05,4226,-52,351429,83.13910574875798,15
0.05,4227,94,351523,83.14167455061495,7
0.05,4228,94,351617,83.14424213762119,7
0.05,4229,92,351709,83.14633569739952,9
0.05,4230,94,351803,83.14890096903805,7
0.05,4231,96,351899,83.15193761814744,6
0.05,4232,94,351993,83.15450035435862,9
0.05,4233,90,352083,83.156117146906,11
0.05,4234,94,352177,83.15867768595041,7
0.05,4235,94,352271,83.16123701605288,7
0.05,4236,93,352364,83.1635591220203,9
0.05,4237,94,352458,83.16611609249647,7
0.05,4238,95,352553,83.16890776126445,7
0.05,4239,96,352649,83.17193396226415,6
0.05,4240,94,352743,83.17448714925725,7
0.05,4241,96,352839,83.17751060820368,6
0.05,4242,96,352935,83.18053264199858,6
0.05,4243,94,353029,83.18308199811499,7
0.05,4244,94,353123,83.18563015312132,7
0.05,4245,91,353214,83.18747056052756,10
0.05,4246,95,353309,83.19025194254768,6
0.05,4247,95,353404,83.19303201506591,6
0.05,4248,93,353497,83.19534008001882,8
0.05,4249,94,353591,83.19788235294118,7
0.05,4250,91,353682,83.19971771347919,10
0.05,4251,94,353776,83.20225776105362,7
0.05,4252,94,353870,83.20479661415472,8
0.05,4253,91,353961,83.20662905500706,11
0.05,4254,94,354055,83.20916568742656,7
0.05,4255,95,354150,83.21193609022556,6
0.05,4256,96,354246,83.21494009866103,6
0.05,4257,96,354342,83.21794269610146,6
0.05,4258,95,354437,83.22070908664006,6
0.05,4259,95,354532,83.22347417840376,6
0.05,4260,93,354625,83.22576859892044,8
0.05,4261,21,354646,83.21116846550915,11
0.05,4262,94,354740,83.21369927281258,7
0.05,4263,94,354834,83.21622889305816,7
0.05,4264,94,354928,83.2187573270809,7
0.05,4265,92,355020,83.22081575246132,9
0.05,4266,93,355113,83.22310756972112,8
0.05,4267,94,355207,83.22563261480788,8
0.05,4268,95,355302,83.22839072382291,7
0.05,4269,92,355394,83.2304449648712,9
0.05,4270,95,355489,83.23320065558417,6
0.05,4271,96,355585,83.23618913857678,6
0.05,4272,91,355676,83.238006084718,10
0.05,4273,94,355770,83.24052409920449,7
0.05,4274,95,355865,83.24327485380117,6
0.05,4275,94,355959,83.24579045837231,7
0.05,4276,93,356052,83.24807107785831,8
0.05,4277,94,356146,83.25058438522674,7
0.05,4278,22,356168,83.23627015657864,11
0.05,4279,96,356264,83.2392523364486,6
0.05,4280,95,356359,83.24199953281943,6
0.05,4281,92,356451,83.24404483886035,9
0.05,4282,95,356546,83.2467896334345,6
0.05,4283,94,356640,83.24929971988796,7
0.05,4284,93,356733,83.25157526254375,8
0.05,4285,94,356827,83.25408306112926,7
0.05,4286,94,356921,83.25658968975974,7
0.05,4287,92,357013,83.25862873134328,9
0.05,4288,96,357109,83.26159944042901,6
0.05,4289,96,357205,83.26456876456876,6
0.05,4290,95,357300,83.2673036588208,6
0.05,4291,94,357394,83.26980428704567,7
0.05,4292,94,357488,83.27230375029117,8
0.05,4293,94,357582,83.27480204937122,8
0.05,4294,22,357604,83.26053550640279,10
0.05,4295,94,357698,83.26303538175047,7
0.05,4296,24,357722,83.2492436583663,8
0.05,4297,93,357815,83.25151233131689,8
0.05,4298,94,357909,83.2540125610607,7
0.05,4299,91,358000,83.25581395348837,10
0.05,4300,96,358096,83.258777028598,6
0.05,4301,95,358191,83.26150627615063,6
0.05,4302,94,358285,83.26400185916802,7
0.05,4303,95,358380,83.26672862453532,6
0.05,4304,94,358474,83.2692218350755,7
0.05,4305,92,358566,83.27124941941477,9
0.05,4306,96,358662,83.27420478291154,6
0.05,4307,93,358755,83.27646239554318,8
0.05,4308,94,358849,83.2789510327222,7
0.05,4309,93,358942,83.28120649651972,8
0.05,4310,24,358966,83.26745534678729,8
0.05,4311,94,359060,83.26994434137292,7
0.05,4312,96,359156,83.27289589612799,6
0.05,4313,94,359250,83.27538247566063,7
0.05,4314,27,359277,83.26234067207416,6
0.05,4315,94,359371,83.26482854494903,7
0.05,4316,96,359467,83.26777854991893,6
0.05,4317,94,359561,83.27026401111625,7
0.05,4318,96,359657,83.27321139152582,6
0.05,4319,94,359751,83.27569444444444,7
0.05,4320,94,359845,83.27817634806757,7
0.05,4321,95,359940,83.28088847755669,6
0.05,4322,94,360034,83.28336803145963,7
0.05,4323,94,360128,83.28584643848289,7
0.05,4324,96,360224,83.28878612716763,6
0.05,4325,25,360249,83.2753120665742,7
0.05,4326,94,360343,83.2777906170557,8
0.05,4327,23,360366,83.26386321626617,9
0.05,4328,23,360389,83.24994224994225,10
0.05,4329,96,360485,83.25288683602771,6
0.05,4330,96,360581,83.25583006234126,6
0.05,4331,94,360675,83.25831024930748,7
0.05,4332,94,360769,83.26078929148396,7
0.05,4333,94,360863,83.26326718966313,7
0.05,4334,94,360957,83.26574394463668,7
0.05,4335,95,361052,83.26845018450184,6
0.05,4336,94,361146,83.27092460225963,7
0.05,4337,94,361240,83.27339787920701,8
0.05,4338,24,361264,83.2597372666513,9
0.05,4339,94,361358,83.26221198156682,8
0.05,4340,94,361452,83.26468555632343,7
0.05,4341,92,361544,83.26669737448181,9
0.05,4342,91,361635,83.26847801059176,10
0.05,4343,94,361729,83.27094843462247,7
0.05,4344,94,361823,83.27341772151898,8
0.05,4345,95,361918,83.27611596870686,6
0.05,4346,93,362011,83.27835288704854,8
0.05,4347,92,362103,83.28035878564857,9
0.05,4348,93,362196,83.28259369970108,8
0.05,4349,25,362221,83.26919540229885,8
0.05,4350,27,362248,83.25626292806251,7
0.05,4351,95,362343,83.25896139705883,6
0.05,4352,23,362366,83.24511830921203,9
0.05,4353,23,362389,83.23128158015618,9
0.05,4354,96,362485,83.23421354764638,6
0.05,4355,23,362508,83.22038567493112,9
0.05,4356,94,362602,83.22285976589396,7
0.05,4357,87,362689,83.22372648003672,14
0.05,4358,92,362781,83.22573984858913,9
0.05,4359,95,362876,83.22844036697248,6
0.05,4360,94,362970,83.23091034166475,7
0.05,4361,94,363064,83.23337918386062,7
0.05,4362,95,363159,83.23607609443044,6
0.05,4363,96,363255,83.23900091659029,6
0.05,4364,26,363281,83.22588774341352,7
0.05,4365,95,363376,83.2285845167201,8
0.05,4366,93,363469,83.23082207465079,8
0.05,4367,92,363561,83.23282967032966,9
0.05,4368,94,363655,83.23529411764706,7
0.05,4369,94,363749,83.23775743707094,7
0.05,4370,-47,363702,83.2079615648593,10
0.05,4371,93,363795,83.21020128087832,8
0.05,4372,19,363814,83.19551795106334,13
0.05,4373,94,363908,83.19798811156836,8
0.05,4374,94,364002,83.20045714285715,7
0.05,4375,25,364027,83.18715722120658,7
0.05,4376,95,364122,83.1898560657985,6
0.05,4377,23,364145,83.17610781178621,9
0.05,4378,95,364240,83.17880794701986,7
0.05,4379,94,364334,83.18127853881279,7
0.05,4380,23,364357,83.1675416571559,9
0.05,4381,94,364451,83.1700136923779,8
0.05,4382,94,364545,83.17248459958932,7
0.05,4383,95,364640,83.17518248175182,6
0.05,4384,91,364731,83.1769669327252,10
0.05,4385,27,364758,83.1641586867305,6
0.05,4386,95,364853,83.16685662183724,7
0.05,4387,96,364949,83.16978122151322,6
0.05,4388,91,365040,83.17156527682843,10
0.05,4389,95,365135,83.17425968109339,6
0.05,4390,25,365160,83.16101115918926,7
0.05,4391,95,365255,83.16370673952642,6
0.05,4392,94,365349,83.16617345777374,7
0.05,4393,94,365443,83.16863905325444,7
0.05,4394,92,365535,83.17064846416382,9
0.05,4395,92,365627,83.17265696087352,9
0.05,4396,95,365722,83.17534682738231,6
0.05,4397,24,365746,83.1618917689859,8
0.05,4398,94,365840,83.16435553534895,7
0.05,4399,96,365936,83.16727272727273,6
0.05,4400,90,366026,83.16882526698478,12
0.05,4401,92,366118,83.17083144025443,9
0.05,4402,94,366212,83.17329093799682,7
0.05,4403,96,366308,83.17620345140782,6
0.05,4404,96,366404,83.17911464245176,6
0.05,4405,27,366431,83.16636404902405,6
0.05,4406,94,366525,83.16882232811436,7
0.05,4407,92,366617,83.17082577132486,9
0.05,4408,94,366711,83.17328192333862,7
0.05,4409,94,366805,83.17573696145125,8
0.05,4410,96,366901,83.17864429834505,6
0.05,4411,94,366995,83.18109700815957,7
0.05,4412,93,367088,83.18332200317245,8
0.05,4413,94,367182,83.1857725419121,7
0.05,4414,93,367275,83.18799546998868,8
0.05,4415,94,367369,83.1904438405797,7
0.05,4416,94,367463,83.19289110255829,7
0.05,4417,93,367556,83.19511090991399,8
0.05,4418,94,367650,83.19755600814663,7
0.05,4419,94,367744,83.2,7
0.05,4420,93,367837,83.20221669305587,8
0.05,4421,95,367932,83.20488466757124,6
0.05,4422,94,368026,83.2073253447886,8
0.05,4423,94,368120,83.20976491862568,7
0.05,4424,96,368216,83.21265536723163,6
0.05,4425,95,368311,83.21531857207411,6
0.05,4426,94,368405,83.21775468714705,7
0.05,4427,95,368500,83.2204155374887,6
0.05,4428,91,368591,83.22217204786634,10
0.05,4429,94,368685,83.22460496613995,7
0.05,4430,93,368778,83.22681110358836,9
0.05,4431,94,368872,83.22924187725631,7
0.05,4432,23,368895,83.2156553124295,9
0.05,4433,94,368989,83.21808750563825,7
0.05,4434,94,369083,83.22051860202932,7
0.05,4435,90,369173,83.22204688908927,11
0.05,4436,95,369268,83.22470137480279,7
0.05,4437,95,369363,83.22735466426319,7
0.05,4438,93,369456,83.22955620635278,8
0.05,4439,94,369550,83.23198198198199,7
0.05,4440,94,369644,83.23440666516551,7
0.05,4441,94,369738,83.23683025664116,7
0.05,4442,95,369833,83.23947783029485,6
0.05,4443,93,369926,83.24167416741675,9
0.05,4444,94,370020,83.24409448818898,7
0.05,4445,95,370115,83.24673864147549,6
0.05,4446,94,370209,83.24915673487745,7
0.05,4447,95,370304,83.25179856115108,6
0.05,4448,94,370398,83.25421443020903,7
0.05,4449,96,370494,83.25707865168539,6
0.05,4450,95,370589,83.25971691754661,6
0.05,4451,95,370684,83.26235399820305,7
0.05,4452,96,370780,83.26521446216034,6
0.05,4453,94,370874,83.26762460709475,7
0.05,4454,93,370967,83.26980920314254,8
0.05,4455,94,371061,83.2722172351885,7
0.05,4456,95,371156,83.27484855283824,6
0.05,4457,94,371250,83.27725437415882,7
0.05,4458,95,371345,83.2798833819242,6
0.05,4459,95,371440,83.28251121076234,6
0.05,4460,23,371463,83.26899798251513,9
0.05,4461,94,371557,83.27140295831465,7
0.05,4462,96,371653,83.2742549854358,6
0.05,4463,94,371747,83.27665770609319,7
0.05,4464,96,371843,83.27950727883538,6
0.05,4465,21,371864,83.26556202418271,12
0.05,4466,96,371960,83.26841280501455,6
0.05,4467,93,372053,83.27059086839749,8
0.05,4468,94,372147,83.2729917207429,7
0.05,4469,96,372243,83.2758389261745,6
0.05,4470,92,372335,83.27779020353388,9
0.05,4471,94,372429,83.28018783542039,7
0.05,4472,95,372524,83.2828079588643,6
0.05,4473,21,372545,83.26888690210103,12
0.05,4474,96,372641,83.27173184357542,6
0.05,4475,94,372735,83.27412868632707,7
0.05,4476,95,372830,83.27674782220237,6
0.05,4477,25,372855,83.2637338097365,7
0.05,4478,94,372949,83.26613083277518,7
0.05,4479,25,372974,83.253125,7
0.05,4480,93,373067,83.25530015621513,8
0.05,4481,92,373159,83.25725122713075,9
0.05,4482,95,373254,83.2598706223511,6
0.05,4483,92,373346,83.26181980374666,9
0.05,4484,94,373440,83.26421404682274,7
0.05,4485,94,373534,83.2666072224699,8
0.05,4486,93,373627,83.26877646534433,8
0.05,4487,96,373723,83.27161319073083,6
0.05,4488,94,373817,83.27400311873468,7
0.05,4489,94,373911,83.27639198218263,7
0.05,4490,92,374003,83.27833444667112,9
0.05,4491,21,374024,83.26447016918966,13
0.05,4492,94,374118,83.26685955931448,7
0.05,4493,96,374214,83.26969292389853,6
0.05,4494,96,374310,83.27252502780868,6
0.05,4495,94,374404,83.27491103202847,7
0.05,4496,94,374498,83.2772959750945,7
0.05,4497,95,374593,83.27990217874611,6
0.05,4498,23,374616,83.26650366748166,9
0.05,4499,93,374709,83.26866666666666,8
0.05,4500,94,374803,83.27105087758277,7
0.05,4501,91,374894,83.2727676588183,10
0.05,4502,95,374989,83.27537197423939,7
0.05,4503,25,375014,83.26243339253996,7
0.05,4504,94,375108,83.26481687014429,7
0.05,4505,94,375202,83.26719928983577,8
0.05,4506,94,375296,83.26958065231861,8
0.05,4507,94,375390,83.27196095829636,7
0.05,4508,95,375485,83.27456198713683,6
0.05,4509,92,375577,83.27649667405765,9
0.05,4510,95,375672,83.27909554422523,6
0.05,4511,95,375767,83.28169326241135,6
0.05,4512,92,375859,83.28362508309328,9
0.05,4513,96,375955,83.2864421798848,6
0.05,4514,96,376051,83.28925802879291,6
0.05,4515,93,376144,83.29140832595218,8
0.05,4516,91,376235,83.29311489926943,10
0.05,4517,91,376326,83.29482071713147,11
0.05,4518,94,376420,83.29718964372648,7
0.05,4519,96,376516,83.3,6
0.05,4520,26,376542,83.28732581287326,8
0.05,4521,96,376638,83.29013710747456,6
0.05,4522,96,376734,83.29294715896529,6
0.05,4523,94,376828,83.29531388152078,7
0.05,4524,95,376923,83.29790055248618,8
0.05,4525,92,377015,83.29982324348211,12
0.05,4526,96,377111,83.30262867240998,6
0.05,4527,94,377205,83.30499116607774,7
0.05,4528,90,377295,83.30646941929785,11
0.05,4529,96,377391,83.30927152317881,6
0.05,4530,92,377483,83.31118958287354,9
0.05,4531,92,377575,83.3131067961165,9
0.05,4532,94,377669,83.31546437238032,7
0.05,4533,93,377762,83.31760035288929,8
0.05,4534,95,377857,83.32017640573319,6
0.05,4535,93,377950,83.32231040564373,8
0.05,4536,96,378046,83.3251046947322,6
0.05,4537,92,378138,83.32701630674306,11
0.05,4538,92,378230,83.32892707644855,9
0.05,4539,23,378253,83.31563876651983,9
0.05,4540,94,378347,83.31799163179916,7
0.05,4541,94,378441,83.32034346103039,8
0.05,4542,95,378536,83.32291437376183,6
0.05,4543,96,378632,83.32570422535211,6
0.05,4544,95,378727,83.32827282728273,6
0.05,4545,92,378819,83.3301803783546,9
0.05,4546,24,378843,83.31713217506048,10
0.05,4547,93,378936,83.31926121372031,8
0.05,4548,94,379030,83.321609144867,7
0.05,4549,25,379055,83.3087912087912,8
0.05,4550,96,379151,83.31157987255548,6
0.05,4551,94,379245,83.31392794376099,7
0.05,4552,94,379339,83.31627498352735,7
0.05,4553,20,379359,83.30237154150197,14
0.05,4554,20,379379,83.28847420417124,12
0.05,4555,95,379474,83.2910447761194,7
0.05,4556,94,379568,83.29339477726575,7
0.05,4557,95,379663,83.29596314172883,6
0.05,4558,94,379757,83.2983110331213,8
0.05,4559,95,379852,83.30087719298245,6
0.05,4560,95,379947,83.30344222758167,6
0.05,4561,92,380039,83.3053485313459,9
0.05,4562,23,380062,83.29213236905545,9
0.05,4563,92,380154,83.2940403155127,9
0.05,4564,96,380250,83.29682365826945,6
0.05,4565,92,380342,83.29872974156811,9
0.05,4566,95,380437,83.30129187650536,6
0.05,4567,92,380529,83.30319614711033,9
0.05,4568,94,380623,83.3055373166995,7
0.05,4569,95,380718,83.30809628008753,6
0.05,4570,96,380814,83.31087289433384,6
0.05,4571,94,380908,83.31321084864392,8
0.05,4572,94,381002,83.31554778045047,7
0.05,4573,95,381097,83.31810231744643,7
0.05,4574,93,381190,83.32021857923498,8
0.05,4575,23,381213,83.3070367132867,9
0.05,4576,96,381309,83.30980991916103,6
0.05,4577,95,381404,83.3123634775011,6
0.05,4578,94,381498,83.31469753221228,7
0.05,4579,91,381589,83.31637554585153,11
0.05,4580,95,381684,83.31892599869025,6
0.05,4581,92,381776,83.32082060235705,9
0.05,4582,94,381870,83.32315077460179,7
0.05,4583,96,381966,83.32591623036649,6
0.05,4584,96,382062,83.32868047982552,6
0.05,4585,90,382152,83.3301351940689,11
0.05,4586,27,382179,83.31785480706344,6
0.05,4587,92,382271,83.31974716652137,9
0.05,4588,94,382365,83.32207452604054,8
0.05,4589,26,382391,83.30958605664487,6
0.05,4590,90,382481,83.31104334567632,11
0.05,4591,95,382576,83.31358885017421,6
0.05,4592,95,382671,83.31613324624429,6
0.05,4593,96,382767,83.31889420983892,6
0.05,4594,93,382860,83.32100108813928,8
0.05,4595,95,382955,83.32354221061793,6
0.05,4596,94,383049,83.32586469436589,7
0.05,4597,95,383144,83.3284036537625,6
0.05,4598,94,383238,83.3307240704501,7
0.05,4599,96,383334,83.33347826086957,6
0.05,4600,95,383429,83.33601391001956,6
0.05,4601,20,383449,83.32225119513255,13
0.05,4602,94,383543,83.32457093200087,8
0.05,4603,94,383637,83.3268896611642,7
0.05,4604,94,383731,83.32920738327904,8
0.05,4605,92,383823,83.33108988276162,9
0.05,4606,91,383914,83.33275450401563,10
0.05,4607,94,384008,83.33506944444444,7
0.05,4608,91,384099,83.33673247993057,12
0.05,4609,27,384126,83.32451193058569,6
0.05,4610,94,384220,83.3268271524615,7
0.05,4611,21,384241,83.3133130962706,11
0.05,4612,22,384263,83.3000216778669,10
0.05,4613,91,384354,83.30169050715214,10
0.05,4614,94,384448,83.30400866738896,7
0.05,4615,94,384542,83.30632582322357,7
0.05,4616,96,384638,83.30907515702837,6
0.05,4617,94,384732,83.31139021221308,7
0.05,4618,94,384826,83.31370426499242,7
0.05,4619,95,384921,83.31623376623376,6
0.05,4620,95,385016,83.3187621726899,7
0.05,4621,95,385111,83.3212894850714,6
0.05,4622,95,385206,83.32381570408826,6
0.05,4623,93,385299,83.32590830449827,8
0.05,4624,94,385393,83.32821621621622,7
0.05,4625,93,385486,83.33030696065715,8
0.05,4626,27,385513,83.31813269937324,6
0.05,4627,95,385608,83.32065687121867,6
0.05,4628,-50,385558,83.29185569237416,13
0.05,4629,93,385651,83.29395248380129,8
0.05,4630,92,385743,83.29583243359966,9
0.05,4631,94,385837,83.29814335060449,7
0.05,4632,96,385933,83.30088495575221,6
0.05,4633,91,386024,83.30254639620199,10
0.05,4634,95,386119,83.30507011866236,6
0.05,4635,96,386215,83.30780845556514,6
0.05,4636,95,386310,83.3103299547121,6
0.05,4637,94,386404,83.3126347563605,7
0.05,4638,94,386498,83.31493856434577,7
0.05,4639,94,386592,83.31724137931035,7
0.05,4640,19,386611,83.30338289161818,13
0.05,4641,92,386703,83.3052563550194,9
0.05,4642,94,386797,83.30755976739177,8
0.05,4643,94,386891,83.30986218776917,7
0.05,4644,94,386985,83.31216361679225,7
0.05,4645,96,387081,83.31489453293156,6
0.05,4646,94,387175,83.31719388853024,7
0.05,4647,95,387270,83.3197074010327,6
0.05,4648,92,387362,83.32157453215746,10
0.05,4649,96,387458,83.32430107526882,6
0.05,4650,91,387549,83.32595140829929,10
0.05,4651,94,387643,83.32824591573517,7
0.05,4652,94,387737,83.33053943692242,7
0.05,4653,95,387832,83.33304684142674,6
0.05,4654,95,387927,83.33555316863587,6
0.05,4655,92,388019,83.33741408934708,9
0.05,4656,93,388112,83.33948894137858,8
0.05,4657,94,388206,83.34177758694719,7
0.05,4658,90,388296,83.34320669671604,11
0.05,4659,94,388390,83.34549356223177,8
0.05,4660,92,388482,83.34735035400129,9
0.05,4661,23,388505,83.33440583440583,9
0.05,4662,93,388598,83.3364786618057,8
0.05,4663,94,388692,83.33876500857633,7
0.05,4664,94,388786,83.34105037513397,7
0.05,4665,94,388880,83.34333476210887,7
0.05,4666,22,388902,83.33019070066423,10
0.05,4667,91,388993,83.33183376178235,10
0.05,4668,94,389087,83.33411865495823,7
0.05,4669,94,389181,83.33640256959315,8
0.05,4670,93,389274,83.33847141939627,8
0.05,4671,95,389369,83.34096746575342,6
0.05,4672,92,389461,83.34282045794993,9
0.05,4673,94,389555,83.34510055626872,7
0.05,4674,24,389579,83.3324064171123,10
0.05,4675,96,389675,83.33511548331907,6
0.05,4676,92,389767,83.33696814197135,9
0.05,4677,96,389863,83.3396750748183,6
0.05,4678,91,389954,83.34131224620646,10
0.05,4679,94,390048,83.34358974358975,7
0.05,4680,93,390141,83.34565263832515,9
0.05,4681,95,390236,83.34814181973516,6
0.05,4682,25,390261,83.33568225496477,7
0.05,4683,95,390356,83.33817250213492,6
0.05,4684,90,390446,83.33959445037354,11
0.05,4685,94,390540,83.34186939820742,7
0.05,4686,94,390634,83.34414337529337,7
0.05,4687,94,390728,83.34641638225256,7
0.05,4688,95,390823,83.3489016847942,6
0.05,4689,93,390916,83.35095948827292,8
0.05,4690,25,390941,83.33852057130676,8
0.05,4691,94,391035,83.34079283887468,7
0.05,4692,95,391130,83.34327722139356,6
0.05,4693,95,391225,83.34576054537708,8
0.05,4694,93,391318,83.34781682641108,8
0.05,4695,96,391414,83.35051107325383,6
0.05,4696,94,391508,83.35277836917182,7
0.05,4697,96,391604,83.35547041294167,6
0.05,4698,25,391629,83.34305171313045,7
0.05,4699,95,391724,83.34553191489361,6
0.05,4700,95,391819,83.34801106147629,6
0.05,4701,95,391914,83.35048915355168,6
0.05,4702,94,392008,83.35275356155645,7
0.05,4703,93,392101,83.3548044217687,8
0.05,4704,94,392195,83.35706695005314,7
0.05,4705,96,392291,83.35975350616235,6
0.05,4706,92,392383,83.36158912258338,9
0.05,4707,95,392478,83.36406117247239,6
0.05,4708,95,392573,83.36653217243577,6
0.05,4709,94,392667,83.3687898089172,7
0.05,4710,95,392762,83.37125875610273,6
0.05,4711,94,392856,83.37351443123939,7
0.05,4712,96,392952,83.37619350732018,6
0.05,4713,20,392972,83.36274925753077,12
0.05,4714,92,393064,83.36458112407212,9
0.05,4715,89,393153,83.36577608142494,12
0.05,4716,90,393243,83.36718253126988,11
0.05,4717,96,393339,83.3698601102162,6
0.05,4718,24,393363,83.3572790845518,8
0.05,4719,92,393455,83.35911016949153,9
0.05,4720,93,393548,83.3611522982419,8
0.05,4721,96,393644,83.36382888606522,6
0.05,4722,95,393739,83.36629261062883,6
0.05,4723,95,393834,83.36875529212531,7
0.05,4724,92,393926,83.37058201058201,9
0.05,4725,95,394021,83.37304274227677,6
0.05,4726,96,394117,83.37571398349905,6
0.05,4727,93,394210,83.37774957698815,8
0.05,4728,95,394305,83.38020723197293,6
0.05,4729,95,394400,83.38266384778012,7
0.05,4730,92,394492,83.3844853096597,9
0.05,4731,95,394587,83.38693998309382,6
0.05,4732,93,394680,83.3889710542996,9
0.05,4733,93,394773,83.39100126742713,9
0.05,4734,94,394867,83.39324181626188,7
0.05,4735,93,394960,83.39527027027027,8
0.05,4736,96,395056,83.39793118007178,6
0.05,4737,94,395150,83.40016884761502,8
0.05,4738,90,395240,83.40156151086727,11
0.05,4739,93,395333,83.4035864978903,8
0.05,4740,92,395425,83.40539970470365,10
0.05,4741,94,395519,83.40763390974273,7
0.05,4742,94,395613,83.40986717267552,7
0.05,4743,95,395708,83.41231028667791,6
0.05,4744,92,395800,83.41412012644889,9
0.05,4745,91,395891,83.41571849978929,10
0.05,4746,23,395914,83.40299136296608,9
0.05,4747,95,396009,83.40543386689133,6
0.05,4748,96,396105,83.40808591282375,6
0.05,4749,91,396196,83.40968421052632,10
0.05,4750,94,396290,83.41191328141444,7
0.05,4751,92,396382,83.41372053872054,9
0.05,4752,95,396477,83.41615821586366,7
0.05,4753,94,396571,83.41838451830039,7
0.05,4754,21,396592,83.40525762355415,11
0.05,4755,93,396685,83.40727502102607,8
0.05,4756,20,396705,83.39394576413706,12
0.05,4757,93,396798,83.39596469104666,8
0.05,4758,95,396893,83.39840302584577,6
0.05,4759,92,396985,83.40021008403362,9
0.05,4760,96,397081,83.40285654274312,6
0.05,4761,92,397173,83.40466190676186,9
0.05,4762,93,397266,83.40667646441318,10
0.05,4763,90,397356,83.40806045340051,11
0.05,4764,94,397450,83.4102833158447,7
0.05,4765,94,397544,83.41250524548887,7
0.05,4766,90,397634,83.41388714075939,12
0.05,4767,96,397730,83.41652684563758,6
0.05,4768,94,397824,83.41874606835815,7
0.05,4769,95,397919,83.42117400419288,6
0.05,4770,94,398013,83.42339132257388,7
0.05,4771,94,398107,83.4256077116513,7
0.05,4772,92,398199,83.42740414833438,9
0.05,4773,95,398294,83.42982823627985,6
0.05,4774,93,398387,83.43183246073299,8
0.05,4775,95,398482,83.43425460636516,7
0.05,4776,95,398577,83.43667573791082,6
0.05,4777,95,398672,83.4390958560067,6
0.05,4778,95,398767,83.44151496128897,8
0.05,4779,96,398863,83.44414225941422,6
0.05,4780,93,398956,83.44614097469149,8
0.05,4781,27,398983,83.43433709744876,6
0.05,4782,92,399075,83.43612795316747,10
0.05,4783,94,399169,83.43833612040133,7
0.05,4784,93,399262,83.44033437826542,8
0.05,4785,91,399353,83.44191391558712,10
0.05,4786,-48,399305,83.41445581783998,11
0.05,4787,95,399400,83.41687552213868,6
0.05,4788,96,399496,83.41950302777198,6
0.05,4789,91,399587,83.42108559498956,11
0.05,4790,92,399679,83.42287622625757,10
0.05,4791,25,399704,83.41068447412354,8
0.05,4792,94,399798,83.41289380346339,7
0.05,4793,95,399893,83.41531080517314,7
0.05,4794,96,399989,83.4179353493222,6
0.05,4795,95,400084,83.42035029190993,7
0.05,4796,92,400176,83.42213883677299,9
0.05,4797,94,400270,83.42434347644853,7
0.05,4798,93,400363,83.42633882058762,8
0.05,4799,95,400458,83.42875,6
0.05,4800,94,400552,83.43095188502396,7
0.05,4801,90,400642,83.4323198667222,11
0.05,4802,93,400735,83.43431188840309,8
0.05,4803,19,400754,83.42089925062447,13
0.05,4804,94,400848,83.42310093652445,8
0.05,4805,94,400942,83.42530170620059,8
0.05,4806,-46,400896,83.39837736634075,9
0.05,4807,95,400991,83.40079034941763,6
0.05,4808,95,401086,83.40320232896651,6
0.05,4809,93,401179,83.4051975051975,8
0.05,4810,94,401273,83.4073997090002,7
0.05,4811,23,401296,83.39484621778887,9
0.05,4812,94,401390,83.39704965717847,7
0.05,4813,94,401484,83.39925218113835,7
0.05,4814,90,401574,83.4006230529595,11
0.05,4815,90,401664,83.40199335548172,11
0.05,4816,94,401758,83.40419348141997,7
0.05,4817,94,401852,83.40639269406392,7
0.05,4818,94,401946,83.40859099398216,8
0.05,4819,95,402041,83.41099585062241,6
0.05,4820,91,402132,83.41257000622278,10
0.05,4821,25,402157,83.40045624222314,7
0.05,4822,92,402249,83.4022392701638,9
0.05,4823,90,402339,83.40360696517413,11
0.05,4824,23,402362,83.39108808290156,9
0.05,4825,93,402455,83.39307915457937,8
0.05,4826,95,402550,83.39548373731095,6
0.05,4827,94,402644,83.3976801988401,7
0.05,4828,94,402738,83.39987575067302,7
0.05,4829,94,402832,83.40207039337474,9
0.05,4830,96,402928,83.40467812047196,6
0.05,4831,90,403018,83.40604304635761,11
0.05,4832,93,403111,83.40802813987172,9
0.05,4833,91,403202,83.40959867604468,10
0.05,4834,93,403295,83.41158221302999,8
0.05,4835,23,403318,83.39909015715467,9
0.05,4836,95,403413,83.40148852594584,6
0.05,4837,96,403509,83.40409260024803,6
0.05,4838,26,403535,83.39222979954536,8
0.05,4839,94,403629,83.39442148760331,8
0.05,4840,94,403723,83.39661227019211,7
0.05,4841,93,403816,83.39859562164395,8
0.05,4842,92,403908,83.4003716704522,10
0.05,4843,96,404004,83.40297274979356,6
0.05,4844,94,404098,83.40515995872033,7
0.05,4845,94,404192,83.4073462649608,7
0.05,4846,96,404288,83.40994429544048,6
0.05,4847,96,404384,83.41254125412541,6
0.05,4848,95,404479,83.41493091359042,6
0.05,4849,93,404572,83.41690721649485,8
0.05,4850,94,404666,83.41908884766028,7
0.05,4851,95,404761,83.4214756801319,6
0.05,4852,94,404855,83.42365547084277,8
0.05,4853,96,404951,83.426246394726,6
0.05,4854,94,405045,83.42842430484038,7
0.05,4855,94,405139,83.43060131795717,7
0.05,4856,94,405233,83.43277743463042,8
0.05,4857,95,405328,83.43515850144092,6
0.05,4858,93,405421,83.43712698086026,8
0.05,4859,23,405444,83.42469135802469,10
0.05,4860,94,405538,83.42686689981485,8
0.05,4861,93,405631,83.42883587001234,8
0.05,4862,26,405657,83.41702652683529,6
0.05,4863,19,405676,83.40378289473684,13
0.05,4864,94,405770,83.40596094552929,7
0.05,4865,93,405863,83.40793259350596,8
0.05,4866,95,405958,83.41031436203,6
0.05,4867,25,405983,83.39831552999178,7
0.05,4868,93,406076,83.40028753337441,8
0.05,4869,94,406170,83.40246406570841,7
0.05,4870,92,406262,83.40422911106549,9
0.05,4871,25,406287,83.39224137931035,7
0.05,4872,94,406381,83.39441822286066,7
0.05,4873,91,406472,83.3959786622897,10
0.05,4874,94,406566,83.39815384615385,8
0.05,4875,94,406660,83.40032813781788,7
0.05,4876,96,406756,83.4029116259996,6
0.05,4877,95,406851,83.40528905289052,6
0.05,4878,96,406947,83.40787046525928,6
0.05,4879,92,407039,83.40963114754098,9
0.05,4880,96,407135,83.41221061257939,6
0.05,4881,26,407161,83.40045063498566,7
0.05,4882,95,407256,83.40282613147654,6
0.05,4883,95,407351,83.40520065520066,6
0.05,4884,96,407447,83.40777891504607,6
0.05,4885,25,407472,83.39582480556693,9
0.05,4886,96,407568,83.39840392879067,6
0.05,4887,95,407663,83.40077741407529,6
0.05,4888,92,407755,83.40253630599305,9
0.05,4889,94,407849,83.40470347648262,8
0.05,4890,96,407945,83.40727867511757,6
0.05,4891,96,408041,83.40985282093213,6
0.05,4892,22,408063,83.39730226854691,10
0.05,4893,91,408154,83.39885574172456,11
0.05,4894,94,408248,83.40102145045965,7
0.05,4895,94,408342,83.4031862745098,7
0.05,4896,96,408438,83.40575862773126,6
0.05,4897,91,408529,83.40730910575745,10
0.05,4898,25,408554,83.39538681363544,7
0.05,4899,95,408649,83.39775510204082,6
0.05,4900,94,408743,83.39991838400327,7
0.05,4901,20,408763,83.38698490412077,12
0.05,4902,93,408856,83.38894554354476,8
0.05,4903,95,408951,83.3913132137031,6
0.05,4904,94,409045,83.39347604485219,8
0.05,4905,95,409140,83.3958418263351,6
0.05,4906,93,409233,83.39779906256368,8
0.05,4907,88,409321,83.39873675631623,13
0.05,4908,94,409415,83.40089631289469,7
0.05,4909,94,409509,83.4030549898167,8
0.05,4910,96,409605,83.40562003665241,6
0.05,4911,93,409698,83.40757328990227,8
0.05,4912,92,409790,83.40932220639121,9
0.05,4913,25,409815,83.3974358974359,7
0.05,4914,95,409910,83.3997965412004,6
0.05,4915,94,410004,83.4019528071603,7
0.05,4916,96,410100,83.40451494813911,6
0.05,4917,94,410194,83.40666937779585,7
0.05,4918,95,410289,83.40902622484245,6
0.05,4919,94,410383,83.41117886178861,8
0.05,4920,92,410475,83.41292420239789,9
0.05,4921,94,410569,83.41507517269403,7
0.05,4922,92,410661,83.41681901279708,9
0.05,4923,94,410755,83.41896831844029,9
0.05,4924,94,410849,83.42111675126904,7
0.05,4925,94,410943,83.42326431181486,7
0.05,4926,93,411036,83.42520803734524,8
0.05,4927,95,411131,83.42755681818181,6
0.05,4928,94,411225,83.42970176506391,7
0.05,4929,95,411320,83.43204868154159,6
0.05,4930,94,411414,83.43419184749544,7
0.05,4931,96,411510,83.43673965936739,6
0.05,4932,25,411535,83.42489357389013,8
0.05,4933,94,411629,83.42703688690717,8
0.05,4934,96,411725,83.42958459979737,6
0.05,4935,23,411748,83.41734197730956,10
0.05,4936,26,411774,83.40571197083248,6
0.05,4937,92,411866,83.40745240988254,9
0.05,4938,94,411960,83.40959708443005,7
0.05,4939,95,412055,83.41194331983806,6
0.05,4940,93,412148,83.41388382918437,8
0.05,4941,94,412242,83.41602590044516,8
0.05,4942,96,412338,83.41857171758042,6
0.05,4943,94,412432,83.42071197411003,7
0.05,4944,92,412524,83.42244691607685,9
0.05,4945,93,412617,83.42438334007278,8
0.05,4946,96,412713,83.42692540933899,6
0.05,4947,93,412806,83.42886014551334,8
0.05,4948,96,412902,83.43140028288543,6
0.05,4949,25,412927,83.41959595959597,7
0.05,4950,24,412951,83.40759442536861,8
0.05,4951,93,413044,83.40953150242326,8
0.05,4952,91,413135,83.41106400161519,10
0.05,4953,96,413231,83.41360516754138,6
0.05,4954,-47,413184,83.38728557013118,10
0.05,4955,96,413280,83.38983050847457,6
0.05,4956,94,413374,83.39197095017147,7
0.05,4957,94,413468,83.39411052843889,7
0.05,4958,25,413493,83.38233514821536,9
0.05,4959,92,413585,83.38407258064517,9
0.05,4960,94,413679,83.3862124571659,7
0.05,4961,94,413773,83.38835147118098,8
0.05,4962,96,413869,83.39089260527906,6
0.05,4963,94,413963,83.3930298146656,8
0.05,4964,93,414056,83.39496475327292,8
0.05,4965,26,414082,83.38340716874748,6
0.05,4966,96,414178,83.38594725186229,6
0.05,4967,96,414274,83.38848631239935,6
0.05,4968,24,414298,83.37653451398671,8
0.05,4969,95,414393,83.37887323943661,7
0.05,4970,94,414487,83.38100985717159,7
0.05,4971,23,414510,83.3688656476267,9
0.05,4972,95,414605,83.37120450432334,6
0.05,4973,94,414699,83.37334137515079,7
0.05,4974,92,414791,83.37507537688442,9
0.05,4975,94,414885,83.37721061093248,7
0.05,4976,96,414981,83.37974683544304,6
0.05,4977,94,415075,83.38188027320209,7
0.05,4978,94,415169,83.38401285398675,7
0.05,4979,94,415263,83.38614457831325,7
0.05,4980,95,415358,83.38847620959646,7
0.05,4981,91,415449,83.39000401445203,10
0.05,4982,92,415541,83.39173188842064,10
0.05,4983,94,415635,83.39386035313002,8
0.05,4984,94,415729,83.39598796389167,7
0.05,4985,92,415821,83.3977135980746,9
0.05,4986,20,415841,83.38500100260677,12
0.05,4987,96,415937,83.38753007217322,6
0.05,4988,96,416033,83.39005812788133,6
0.05,4989,91,416124,83.39158316633267,10
0.05,4990,93,416217,83.39350831496694,8
0.05,4991,94,416311,83.39563301282051,7
0.05,4992,92,416403,83.39735629881835,9
0.05,4993,92,416495,83.39907889467361,9
0.05,4994,24,416519,83.38718718718718,9
0.05,4995,24,416543,83.37530024019216,9
0.05,4996,95,416638,83.37762657594557,6
0.05,4997,95,416733,83.37995198079231,6
0.05,4998,95,416828,83.38227645529106,6
0.05,4999,94,416922,83.3844,7
0.05,5000,95,417017,83.3867226554689,7
0.05,5001,96,417113,83.38924430227908,6
0.05,5002,95,417208,83.39156506096342,7
0.05,5003,96,417304,83.39408473221422,6
0.05,5004,95,417399,83.3964035964036,6
0.05,5005,90,417489,83.39772273272074,11
0.05,5006,94,417583,83.39984022368684,7
0.05,5007,93,417676,83.40175718849841,8
0.05,5008,93,417769,83.40367338790178,10
0.05,5009,95,417864,83.40598802395209,6
0.05,5010,27,417891,83.3947315905009,6
0.05,5011,92,417983,83.3964485235435,10
0.05,5012,95,418078,83.39876321563933,6
0.05,5013,95,418173,83.40107698444356,6
0.05,5014,94,418267,83.40319042871386,7
0.05,5015,96,418363,83.40570175438596,6
0.05,5016,95,418458,83.40801275662747,7
0.05,5017,94,418552,83.41012355520128,7
0.05,5018,94,418646,83.41223351265192,7
0.05,5019,94,418740,83.41434262948208,7
0.05,5020,94,418834,83.41645090619399,7
0.05,5021,96,418930,83.4189565909996,6
0.05,5022,27,418957,83.40772446744973,6
0.05,5023,93,419050,83.40963375796179,8
0.05,5024,94,419144,83.41174129353234,7
0.05,5025,94,419238,83.41384799044967,7
0.05,5026,96,419334,83.4163517008156,6
0.05,5027,22,419356,83.4041368337311,10
0.05,5028,94,419450,83.40624378604096,7
0.05,5029,95,419545,83.40854870775348,7
0.05,5030,92,419637,83.41025641025641,9
0.05,5031,95,419732,83.41255961844197,6
0.05,5032,95,419827,83.41486191138486,6
0.05,5033,94,419921,83.41696464044497,7
0.05,5034,94,420015,83.41906653426018,7
0.05,5035,95,420110,83.42136616362193,6
0.05,5036,96,420206,83.42386341076038,6
0.05,5037,95,420301,83.42616117506947,6
0.05,5038,93,420394,83.42806112323873,8
0.05,5039,90,420484,83.42936507936508,11
0.05,5040,87,420571,83.43007339813529,14
0.05,5041,94,420665,83.43216977389925,8
0.05,5042,94,420759,83.43426531826294,7
0.05,5043,94,420853,83.43636003172085,8
0.05,5044,92,420945,83.43805748265609,9
0.05,5045,93,421038,83.43995243757432,8
0.05,5046,96,421134,83.44244105409155,6
0.05,5047,94,421228,83.4445324881141,7
0.05,5048,95,421323,83.4468211527035,6
0.05,5049,95,421418,83.44910891089108,6
0.05,5050,96,421514,83.4515937438131,6
0.05,5051,94,421608,83.45368171021377,7
0.05,5052,94,421702,83.45576885018801,8
0.05,5053,94,421796,83.45785516422636,7
0.05,5054,93,421889,83.4597428288823,8
0.05,5055,95,421984,83.4620253164557,6
0.05,5056,96,422080,83.46450464702393,6
0.05,5057,95,422175,83.4667852906287,6
0.05,5058,96,422271,83.46926270013837,6
0.05,5059,94,422365,83.47134387351778,7
0.05,5060,96,422461,83.47381940327999,6
0.05,5061,91,422552,83.47530620308179,11
0.05,5062,96,422648,83.47777997234842,6
0.05,5063,93,422741,83.47966034755135,8
0.05,5064,94,422835,83.48173741362291,7
0.05,5065,96,422931,83.48420844848006,6
0.05,5066,94,423025,83.48628379711862,7
0.05,5067,96,423121,83.48875295974743,6
0.05,5068,95,423216,83.49102387058592,8
0.05,5069,94,423310,83.4930966469428,8
0.05,5070,25,423335,83.48156182212581,7
0.05,5071,95,423430,83.48383280757098,6
0.05,5072,27,423457,83.47269860043367,6
0.05,5073,24,423481,83.46097753251873,8
0.05,5074,92,423573,83.46266009852216,9
0.05,5075,95,423668,83.46493301812451,6
0.05,5076,94,423762,83.46700807563522,7
0.05,5077,25,423787,83.4554942890902,8
0.05,5078,25,423812,83.4439850364245,7
0.05,5079,93,423905,83.44586614173228,8
0.05,5080,93,423998,83.44774650659319,8
0.05,5081,94,424092,83.44982290436836,7
0.05,5082,23,424115,83.43793035608893,9
0.05,5083,96,424211,83.4404012588513,6
0.05,5084,92,424303,83.44208456243854,9
0.05,5085,95,424398,83.44435705859222,6
0.05,5086,94,424492,83.44643208177708,8
0.05,5087,96,424588,83.44889937106919,6
0.05,5088,94,424682,83.45097268618589,7
0.05,5089,96,424778,83.45343811394892,6
0.05,5090,95,424873,83.4557061481045,6
0.05,5091,94,424967,83.45777690494894,7
0.05,5092,96,425063,83.4602395444728,6
0.05,5093,95,425158,83.46250490773458,7
0.05,5094,94,425252,83.46457311089303,7
0.05,5095,96,425348,83.46703296703296,6
0.05,5096,95,425443,83.46929566411615,6
0.05,5097,25,425468,83.45782659866614,8
0.05,5098,25,425493,83.44636203177093,8
0.05,5099,93,425586,83.44823529411765,8
0.05,5100,94,425680,83.45030386198785,7
0.05,5101,94,425774,83.45237161897295,7
0.05,5102,94,425868,83.45443856554968,7
0.05,5103,95,425963,83.45670062695925,7
0.05,5104,93,426056,83.45857002938295,8
0.05,5105,96,426152,83.46102624363493,6
0.05,5106,95,426247,83.4632856863129,6
0.05,5107,90,426337,83.46456538762725,11
0.05,5108,94,426431,83.46662752006263,7
0.05,5109,96,426527,83.46908023483365,6
0.05,5110,95,426622,83.47133633339855,8
0.05,5111,92,426714,83.47300469483568,9
0.05,5112,93,426807,83.47486798357129,8
0.05,5113,90,426897,83.47614391865467,11
0.05,5114,96,426993,83.47859237536657,6
0.05,5115,95,427088,83.48084440969508,8
0.05,5116,96,427184,83.48329099081494,6
0.05,5117,27,427211,83.47225478702619,6
0.05,5118,92,427303,83.4739206876343,9
0.05,5119,93,427396,83.47578125,9
0.05,5120,94,427490,83.47783636008592,7
0.05,5121,94,427584,83.47989066770792,7
0.05,5122,92,427676,83.48155377708375,9
0.05,5123,94,427770,83.48360655737704,7
0.05,5124,26,427796,83.47239024390244,6
0.05,5125,94,427890,83.4744440109247,7
0.05,5126,96,427986,83.47688706846108,6
0.05,5127,93,428079,83.47874414976599,8
0.05,5128,93,428172,83.48060050692143,8
0.05,5129,95,428267,83.48284600389863,6
0.05,5130,92,428359,83.48450594426038,9
0.05,5131,94,428453,83.48655494933749,7
0.05,5132,96,428549,83.48899279173972,6
0.05,5133,95,428644,83.49123490455786,6
0.05,5134,25,428669,83.47984420642649,7
0.05,5135,92,428761,83.4815031152648,9
0.05,5136,86,428847,83.48199338135099,15
0.05,5137,92,428939,83.48365122615805,10
0.05,5138,91,429030,83.48511383537654,11
0.05,5139,96,429126,83.4875486381323,6
0.05,5140,96,429222,83.48998249367827,6
0.05,5141,27,429249,83.47899649941657,6
0.05,5142,94,429343,83.48104219327242,7
0.05,5143,94,429437,83.48308709175738,7
0.05,5144,94,429531,83.48513119533527,8
0.05,5145,94,429625,83.4871745044695,7
0.05,5146,89,429714,83.48824557994949,12
0.05,5147,96,429810,83.490675990676,6
0.05,5148,95,429905,83.49291124490192,6
0.05,5149,94,429999,83.49495145631067,7
0.05,5150,94,430093,83.49699087555814,8
0.05,5151,94,430187,83.49902950310559,7
0.05,5152,25,430212,83.48767708131186,8
0.05,5153,96,430308,83.49010477299186,6
0.05,5154,95,430403,83.49233753637246,6
0.05,5155,94,430497,83.494375484872,7
0.05,5156,92,430589,83.49602482063214,9
0.05,5157,96,430685,83.49844901124467,6
0.05,5158,27,430712,83.48749757704982,6
0.05,5159,94,430806,83.48953488372094,8
0.05,5160,94,430900,83.4915714008913,7
0.05,5161,23,430923,83.4798527702441,9
0.05,5162,95,431018,83.48208405965524,6
0.05,5163,93,431111,83.48392718822618,8
0.05,5164,93,431204,83.48576960309778,8
0.05,5165,94,431298,83.48780487804878,8
0.05,5166,96,431394,83.49022643700407,6
0.05,5167,25,431419,83.47890866873065,7
0.05,5168,94,431513,83.48094408976591,8
0.05,5169,25,431538,83.4696324951644,8
0.05,5170,95,431633,83.47186230903114,6
0.05,5171,-52,431581,83.44566898685228,15
0.05,5172,96,431677,83.44809588246666,6
0.05,5173,93,431770,83.44994201778121,9
0.05,5174,93,431863,83.45178743961353,9
0.05,5175,96,431959,83.45421174652242,6
0.05,5176,94,432053,83.4562487927371,7
0.05,5177,95,432148,83.45847817690228,6
0.05,5178,94,432242,83.46051361266653,7
0.05,5179,94,432336,83.46254826254827,7
0.05,5180,94,432430,83.46458212700252,7
0.05,5181,96,432526,83.46700115785411,6
0.05,5182,94,432620,83.46903337835231,7
0.05,5183,94,432714,83.47106481481481,7
0.05,5184,92,432806,83.47270973963356,10
0.05,5185,96,432902,83.47512533744697,6
0.05,5186,96,432998,83.4775400038558,6
0.05,5187,96,433094,83.47995373939861,6
0.05,5188,94,433188,83.48198111389478,7
0.05,5189,95,433283,83.48420038535646,8
0.05,5190,25,433308,83.47293392409941,7
0.05,5191,94,433402,83.47496147919877,7
0.05,5192,94,433496,83.47698825341806,7
0.05,5193,20,433516,83.46476703889103,12
0.05,5194,93,433609,83.46660250240616,10
0.05,5195,92,433701,83.46824480369516,9
0.05,5196,-46,433655,83.44333269193766,10
0.05,5197,92,433747,83.44497883801462,9
0.05,5198,24,433771,83.43354491248317,8
0.05,5199,22,433793,83.42173076923076,10
0.05,5200,96,433889,83.42414920207652,6
0.05,5201,94,433983,83.42618223760093,7
0.05,5202,93,434076,83.4280222948299,8
0.05,5203,96,434172,83.4304381245196,6
0.05,5204,96,434268,83.4328530259366,6
0.05,5205,92,434360,83.43449865539762,9
0.05,5206,94,434454,83.43652775110428,7
0.05,5207,93,434547,83.43836405529954,8
0.05,5208,95,434642,83.44058360529853,6
0.05,5209,94,434736,83.4426103646833,7
0.05,5210,21,434757,83.43062751871042,11
0.05,5211,94,434851,83.43265541059094,7
0.05,5212,22,434873,83.42087089967389,11
0.05,5213,-47,434826,83.39585730724971,10
0.05,5214,95,434921,83.39808245445829,6
0.05,5215,93,435014,83.39992331288343,9
0.05,5216,95,435109,83.40214682767875,6
0.05,5217,94,435203,83.40417784591797,8
0.05,5218,94,435297,83.4062080858402,7
0.05,5219,94,435391,83.40823754789272,7
0.05,5220,23,435414,83.39666730511397,9
0.05,5221,24,435438,83.38529299119111,9
0.05,5222,96,435534,83.38770821367031,6
0.05,5223,95,435629,83.38993108728944,6
0.05,5224,94,435723,83.39196172248803,7
0.05,5225,93,435816,83.39380022962112,8
0.05,5226,94,435910,83.39582934761813,7
0.05,5227,27,435937,83.38504208110176,6
0.05,5228,94,436031,83.38707209791548,7
0.05,5229,24,436055,83.37571701720842,8
0.05,5230,94,436149,83.37774804052762,8
0.05,5231,92,436241,83.37939602446484,11
0.05,5232,25,436266,83.3682400152876,7
0.05,5233,92,436358,83.36988918609094,9
0.05,5234,91,436449,83.37134670487106,10
0.05,5235,95,436544,83.37356760886172,8
0.05,5236,21,436565,83.3616574374642,11
0.05,5237,96,436661,83.36407025582284,6
0.05,5238,23,436684,83.35254819622065,9
0.05,5239,95,436779,83.35477099236641,6
0.05,5240,-49,436730,83.329517267697,12
0.05,5241,26,436756,83.31858069439146,7
0.05,5242,95,436851,83.3208086973107,6
0.05,5243,96,436947,83.32322654462243,6
0.05,5244,23,436970,83.3117254528122,9
0.05,5245,92,437062,83.31338162409455,9
0.05,5246,94,437156,83.31541833428626,7
0.05,5247,95,437251,83.31764481707317,6
0.05,5248,87,437338,83.31834635168603,15
0.05,5249,91,437429,83.31980952380952,10
0.05,5250,96,437525,83.32222433822129,6
0.05,5251,94,437619,83.32425742574257,8
0.05,5252,93,437712,83.32609937178755,8
0.05,5253,90,437802,83.32736962314426,11
0.05,5254,95,437897,83.32959086584205,7
0.05,5255,24,437921,83.31830289193303,8
0.05,5256,92,438013,83.3199543465855,9
0.05,5257,94,438107,83.32198554583492,7
0.05,5258,95,438202,83.32420612283704,6
0.05,5259,92,438294,83.32585551330799,9
0.05,5260,89,438383,83.32693404295762,12
0.05,5261,90,438473,83.32820220448498,11
0.05,5262,93,438566,83.33003990119704,8
0.05,5263,94,438660,83.33206686930092,7
0.05,5264,93,438753,83.33390313390314,8
0.05,5265,24,438777,83.3226357766806,8
0.05,5266,94,438871,83.3246629960129,8
0.05,5267,96,438967,83.32706909643129,6
0.05,5268,96,439063,83.32947428354527,6
0.05,5269,94,439157,83.3314990512334,7
0.05,5270,93,439250,83.33333333333333,8
0.05,5271,91,439341,83.3347875569044,10
0.05,5272,96,439437,83.3371894557178,6
0.05,5273,95,439532,83.33940083428138,6
0.05,5274,95,439627,83.34161137440758,6
0.05,5275,94,439721,83.34363153904474,7
0.05,5276,25,439746,83.33257532689028,7
0.05,5277,94,439840,83.33459643804471,7
0.05,5278,94,439934,83.33661678348172,7
0.05,5279,94,440028,83.33863636363637,7
0.05,5280,92,440120,83.34027646279114,11
0.05,5281,89,440209,83.34134797425217,12
0.05,5282,96,440305,83.3437440848003,6
0.05,5283,95,440400,83.34595003785012,6
0.05,5284,94,440494,83.34796594134342,7
0.05,5285,94,440588,83.34998108210367,7
0.05,5286,93,440681,83.35180631738226,9
0.05,5287,96,440777,83.35419818456883,6
0.05,5288,23,440800,83.34278691624125,9
0.05,5289,24,440824,83.33156899810965,8
0.05,5290,94,440918,83.33358533358533,7
0.05,5291,92,441010,83.33522297808013,10
0.05,5292,95,441105,83.33742679010014,6
0.05,5293,95,441200,83.33962976955044,6
0.05,5294,22,441222,83.32804532577903,10
0.05,5295,26,441248,83.31722054380664,6
0.05,5296,21,441269,83.30545591844441,11
0.05,5297,91,441360,83.30690826727067,10
0.05,5298,95,441455,83.30911492734478,7
0.05,5299,94,441549,83.3111320754717,8
0.05,5300,95,441644,83.31333710620638,7
0.05,5301,95,441739,83.31554130516786,6
0.05,5302,96,441835,83.31793324533282,6
0.05,5303,94,441929,83.3199472096531,7
0.05,5304,96,442025,83.32233741753063,6
0.05,5305,93,442118,83.32416132679985,8
0.05,5306,95,442213,83.32636140945921,6
0.05,5307,94,442307,83.32837226827431,7
0.05,5308,91,442398,83.32981729139198,11
0.05,5309,95,442493,83.33201506591337,6
0.05,5310,96,442589,83.33440030126154,6
0.05,5311,91,442680,83.33584337349397,10
0.05,5312,93,442773,83.33766233766234,8
0.05,5313,95,442868,83.33985698155814,6
0.05,5314,93,442961,83.34167450611477,8
0.05,5315,92,443053,83.34330323551542,9
0.05,5316,93,443146,83.345119428249,8
0.05,5317,94,443240,83.34712297856338,7
0.05,5318,93,443333,83.34893777025756,8
0.05,5319,94,443427,83.35093984962406,7
0.05,5320,94,443521,83.3529411764706,7
0.05,5321,94,443615,83.35494175122135,7
0.05,5322,95,443710,83.35712943828668,6
0.05,5323,94,443804,83.35912847483095,7
0.05,5324,94,443898,83.36112676056338,7
0.05,5325,-46,443852,83.33683815245963,10
0.05,5326,94,443946,83.33883987234842,7
0.05,5327,94,444040,83.34084084084084,8
0.05,5328,95,444135,83.34302871082755,8
0.05,5329,96,444231,83.3454033771107,6
0.05,5330,96,444327,83.34777715250422,6
0.05,5331,91,444418,83.34921230307577,12
0.05,5332,94,444512,83.35120945059066,7
0.05,5333,94,444606,83.35320584926885,7
0.05,5334,24,444630,83.34208059981256,8
0.05,5335,94,444724,83.3440779610195,7
0.05,5336,26,444750,83.33333333333333,7
0.05,5337,96,444846,83.33570625702511,6
0.05,5338,92,444938,83.33732908784417,10
0.05,5339,24,444962,83.32621722846442,8
0.05,5340,95,445057,83.32840292080135,6
0.05,5341,95,445152,83.33058779483339,6
0.05,5342,92,445244,83.33221036870673,9
0.05,5343,96,445340,83.33458083832335,7
0.05,5344,91,445431,83.33601496725912,10
0.05,5345,95,445526,83.33819678264123,8
0.05,5346,95,445621,83.3403777819338,6
0.05,5347,95,445716,83.34255796559461,6
0.05,5348,94,445810,83.3445503832492,7
0.05,5349,94,445904,83.34654205607477,7
0.05,5350,93,445997,83.34834610353205,8
0.05,5351,94,446091,83.35033632286995,7
0.05,5352,94,446185,83.3523257986176,7
0.05,5353,90,446275,83.35356742622338,11
0.05,5354,96,446371,83.35592903828199,6
0.05,5355,92,446463,83.3575429424944,9
0.05,5356,96,446559,83.35990293074482,6
0.05,5357,25,446584,83.34901082493468,7
0.05,5358,94,446678,83.35099832058219,7
0.05,5359,92,446770,83.3526119402985,9
0.05,5360,27,446797,83.34210035441149,6
0.05,5361,93,446890,83.34390152928012,8
0.05,5362,96,446986,83.34626142084655,6
0.05,5363,95,447081,83.34843400447427,8
0.05,5364,93,447174,83.3502329916123,8
0.05,5365,25,447199,83.33935892657473,8
0.05,5366,95,447294,83.34153158188933,6
0.05,5367,93,447387,83.34333084947839,8
0.05,5368,96,447483,83.34568821009499,6
0.05,5369,95,447578,83.34785847299814,6
0.05,5370,96,447674,83.35021411282816,6
0.05,5371,18,447692,83.33804914370812,14
0.05,5372,91,447783,83.33947515354551,10
0.05,5373,94,447877,83.34145887606996,7
0.05,5374,95,447972,83.34362790697675,6
0.05,5375,94,448066,83.34561011904762,7
0.05,5376,92,448158,83.34721963920401,9
0.05,5377,95,448253,83.34938638899219,6
0.05,5378,92,448345,83.35099460866331,9
0.05,5379,27,448372,83.34052044609665,6
0.05,5380,24,448396,83.329492659357,8
0.05,5381,96,448492,83.3318468970643,7
0.05,5382,94,448586,83.33382872004458,7
0.05,5383,94,448680,83.33580980683507,7
0.05,5384,94,448774,83.33779015784587,8
0.05,5385,95,448869,83.33995544002971,9
0.05,5386,94,448963,83.34193428624467,7
0.05,5387,91,449054,83.34335560504826,11
0.05,5388,93,449147,83.3451475227315,10
0.05,5389,92,449239,83.34675324675325,9
0.05,5390,92,449331,83.34835837506957,9
0.05,5391,92,449423,83.34996290801188,9
0.05,5392,94,449517,83.35193769701465,7
0.05,5393,95,449612,83.3540971449759,6
0.05,5394,-48,449564,83.32974976830398,12
0.05,5395,94,449658,83.33172720533729,7
0.05,5396,94,449752,83.3337039095794,7
0.05,5397,96,449848,83.33605038903298,6
0.05,5398,94,449942,83.33802556028894,7
0.05,5399,96,450038,83.34037037037037,6
0.05,5400,94,450132,83.34234401036845,7
0.05,5401,94,450226,83.34431691965939,7
0.05,5402,94,450320,83.3462890986489,8
0.05,5403,94,450414,83.34826054774241,8
0.05,5404,25,450439,83.33746530989825,8
0.05,5405,95,450534,83.33962264150944,6
0.05,5406,92,450626,83.34122433882006,9
0.05,5407,94,450720,83.34319526627219,7
0.05,5408,96,450816,83.34553521907931,6
0.05,5409,94,450910,83.34750462107209,7
0.05,5410,94,451004,83.34947329513953,7
0.05,5411,96,451100,83.35181079083519,6
0.05,5412,88,451188,83.35266949935341,13
0.05,5413,93,451281,83.35445142223864,8
0.05,5414,95,451376,83.35660203139427,6
0.05,5415,24,451400,83.34564254062039,8
0.05,5416,94,451494,83.34760937788444,7
0.05,5417,95,451589,83.34976005906239,6
0.05,5418,95,451684,83.3519099464846,6
0.05,5419,93,451777,83.35369003690037,8
0.05,5420,25,451802,83.34292565947243,7
0.05,5421,94,451896,83.34489118406492,7
0.05,5422,95,451991,83.34704038355154,6
0.05,5423,94,452085,83.34900442477876,7
0.05,5424,94,452179,83.35096774193548,7
0.05,5425,23,452202,83.33984518982676,9
0.05,5426,95,452297,83.34199373502857,6
0.05,5427,25,452322,83.33124539425202,7
0.05,5428,92,452414,83.33284214404127,9
0.05,5429,94,452508,83.33480662983425,7
0.05,5430,88,452596,83.3356656232738,13
0.05,5431,95,452691,83.33781296023564,6
0.05,5432,95,452786,83.3399595067182,7
0.05,5433,93,452879,83.34173721015826,8
0.05,5434,95,452974,83.34388224471022,8
0.05,5435,94,453068,83.345842531273,7
0.05,5436,94,453162,83.34780209674453,7
0.05,5437,96,453258,83.3501287237955,6
0.05,5438,94,453352,83.35208678065821,7
0.05,5439,94,453446,83.35404411764706,7
0.05,5440,95,453541,83.35618452490351,6
0.05,5441,94,453635,83.35814038956266,7
0.05,5442,23,453658,83.34705125849715,9
0.05,5443,93,453751,83.34882439382807,8
0.05,5444,92,453843,83.35041322314049,9
0.05,5445,93,453936,83.3521850899743,8
0.05,5446,96,454032,83.35450706811089,6
0.05,5447,95,454127,83.35664464023495,7
0.05,5448,25,454152,83.34593503395118,7
0.05,5449,94,454246,83.34788990825687,7
0.05,5450,96,454342,83.35021097046413,6
0.05,5451,96,454438,83.3525311812179,6
0.05,5452,95,454533,83.35466715569412,6
0.05,5453,94,454627,83.35661899523285,7
0.05,5454,90,454717,83.35783684692942,11
0.05,5455,92,454809,83.35942082111437,9
0.05,5456,96,454905,83.36173721825179,6
0.05,5457,96,455001,83.36405276658117,6
0.05,5458,21,455022,83.35262868657263,11
0.05,5459,27,455049,83.3423076923077,6
0.05,5460,96,455145,83.34462552646036,6
0.05,5461,93,455238,83.3463932625412,8
0.05,5462,94,455332,83.34834340106168,7
0.05,5463,96,455428,83.3506588579795,6
0.05,5464,91,455519,83.35205855443733,10
0.05,5465,94,455613,83.35400658616905,7
0.05,5466,87,455700,83.35467349551857,14
0.05,5467,93,455793,83.35643745427944,8
0.05,5468,94,455887,83.35838361674895,7
0.05,5469,93,455980,83.36014625228519,8
0.05,5470,92,456072,83.3617254615244,9
0.05,5471,96,456168,83.3640350877193,6
0.05,5472,90,456258,83.3652475790243,11
0.05,5473,92,456350,83.36682499086591,9
0.05,5474,95,456445,83.3689497716895,6
0.05,5475,94,456539,83.3708911614317,7
0.05,5476,92,456631,83.37246667883878,9
0.05,5477,95,456726,83.37458926615552,6
0.05,5478,94,456820,83.3765285636065,7
0.05,5479,94,456914,83.37846715328467,7
0.05,5480,93,457007,83.38022258711914,8
0.05,5481,94,457101,83.382159795695,7
0.05,5482,95,457196,83.38427867955498,6
0.05,5483,-55,457141,83.35904449307075,18
0.05,5484,95,457236,83.36116681859617,6
0.05,5485,96,457332,83.36347065257017,6
0.05,5486,95,457427,83.36559139784946,7
0.05,5487,91,457518,83.36698250728863,10
0.05,5488,23,457541,83.35598469666606,9
0.05,5489,92,457633,83.3575591985428,9
0.05,5490,96,457729,83.3598615916955,6
0.05,5491,93,457822,83.36161689730517,8
0.05,5492,24,457846,83.35081012197342,9
0.05,5493,94,457940,83.35274845285767,7
0.05,5494,93,458033,83.35450409463148,8
0.05,5495,94,458127,83.35644104803494,7
0.05,5496,96,458223,83.35874113152629,6
0.05,5497,94,458317,83.36067660967625,7
0.05,5498,93,458410,83.3624295326423,8
0.05,5499,91,458501,83.36381818181817,11
0.05,5500,25,458526,83.35320850754408,7
0.05,5501,93,458619,83.35496183206106,8
0.05,5502,96,458715,83.35725967654007,6
0.05,5503,91,458806,83.35864825581395,10
0.05,5504,96,458902,83.36094459582198,6
0.05,5505,94,458996,83.36287686160553,7
0.05,5506,88,459084,83.36371890321409,13
0.05,5507,25,459109,83.35312273057372,7
0.05,5508,94,459203,83.3550553639499,7
0.05,5509,94,459297,83.35698729582577,8
0.05,5510,93,459390,83.35873707131192,8
0.05,5511,94,459484,83.36066763425254,7
0.05,5512,93,459577,83.36241610738254,8
0.05,5513,95,459672,83.3645266594124,7
0.05,5514,92,459764,83.366092475068,9
0.05,5515,92,459856,83.36765772298767,9
0.05,5516,95,459951,83.36976617727025,6
0.05,5517,17,459968,83.35773831098224,16
0.05,5518,25,459993,83.3471643413662,7
0.05,5519,94,460087,83.34909420289856,7
0.05,5520,92,460179,83.35066111211736,9
0.05,5521,27,460206,83.34045635639261,6
0.05,5522,92,460298,83.34202426217635,9
0.05,5523,92,460390,83.34359160028964,9
0.05,5524,96,460486,83.34588235294117,6
0.05,5525,94,460580,83.34781035106768,7
0.05,5526,95,460675,83.34991858150896,6
0.05,5527,24,460699,83.33918234442837,8
0.05,5528,92,460791,83.3407487791644,9
0.05,5529,93,460884,83.34249547920435,8
0.05,5530,94,460978,83.34442234677273,7
0.05,5531,95,461073,83.34652928416486,7
0.05,5532,95,461168,83.34863545996747,6
0.05,5533,94,461262,83.35056017347307,7
0.05,5534,25,461287,83.34001806684734,7
0.05,5535,94,461381,83.3419436416185,7
0.05,5536,25,461406,83.3314068990428,7
0.05,5537,23,461429,83.32051282051282,9
0.05,5538,92,461521,83.32207979779744,10
0.05,5539,92,461613,83.32364620938628,10
0.05,5540,94,461707,83.32557300126331,7
0.05,5541,22,461729,83.31450739805125,11
0.05,5542,95,461824,83.31661555114559,6
0.05,5543,93,461917,83.31836219336219,8
0.05,5544,96,462013,83.32064923354373,6
0.05,5545,94,462107,83.32257482870537,8
0.05,5546,94,462201,83.32449972958356,7
0.05,5547,91,462292,83.32588320115357,12
0.05,5548,23,462315,83.31501171382232,9
0.05,5549,94,462409,83.31693693693694,7
0.05,5550,95,462504,83.31904161412358,6
0.05,5551,96,462600,83.32132564841498,6
0.05,5552,93,462693,83.32306861156133,8
0.05,5553,95,462788,83.3251710478934,6
0.05,5554,25,462813,83.31467146714671,7
0.05,5555,95,462908,83.31677465802736,8
0.05,5556,93,463001,83.31851718553176,8
0.05,5557,95,463096,83.32061892767183,7
0.05,5558,92,463188,83.32218024824608,9
0.05,5559,96,463284,83.32446043165467,6
0.05,5560,94,463378,83.3263801474555,8
0.05,5561,96,463474,83.32865875584322,6
0.05,5562,95,463569,83.33075678590689,7
0.05,5563,95,463664,83.33285406182603,6
0.05,5564,93,463757,83.33459119496855,9
0.05,5565,92,463849,83.33614804168164,9
0.05,5566,96,463945,83.3384228489312,6
0.05,5567,95,464040,83.34051724137932,8
0.05,5568,95,464135,83.34261088166637,7
0.05,5569,92,464227,83.34416517055655,10
0.05,5570,92,464319,83.34571890145396,9
0.05,5571,93,464412,83.34745154343145,8
0.05,5572,94,464506,83.34936300017944,7
0.05,5573,94,464600,83.35127377108002,7
0.05,5574,93,464693,83.35300448430493,9
0.05,5575,93,464786,83.35473457675754,8
0.05,5576,25,464811,83.34427111350189,7
0.05,5577,95,464906,83.34636070276085,6
0.05,5578,95,465001,83.34844954292885,6
0.05,5579,94,465095,83.35035842293907,7
0.05,5580,91,465186,83.35172908080989,10
0.05,5581,94,465280,83.35363668935865,7
0.05,5582,95,465375,83.35572272971521,6
0.05,5583,88,465463,83.35655444126074,13
0.05,5584,92,465555,83.35810205908685,9
0.05,5585,93,465648,83.35982814178303,8
0.05,5586,96,465744,83.36209056738858,6
0.05,5587,93,465837,83.36381531853972,8
0.05,5588,93,465930,83.36553945249598,8
0.05,5589,94,466024,83.36744186046512,7
0.05,5590,93,466117,83.3691647290288,8
0.05,5591,92,466209,83.37070815450643,10
0.05,5592,94,466303,83.37260861791525,7
0.05,5593,94,466397,83.37450840185913,7
0.05,5594,92,466489,83.37605004468276,9
0.05,5595,91,466580,83.37741243745532,10
0.05,5596,96,466676,83.37966767911381,6
0.05,5597,-44,466632,83.35691318327974,8
0.05,5598,95,466727,83.3589926772638,7
0.05,5599,96,466823,83.36125,6
0.05,5600,95,466918,83.36332797714694,6
0.05,5601,89,467007,83.36433416636915,12
0.05,5602,95,467102,83.36641085132965,7
0.05,5603,25,467127,83.35599571734475,7
0.05,5604,93,467220,83.35771632471008,8
0.05,5605,92,467312,83.35925793792366,9
0.05,5606,95,467407,83.36133404672731,6
0.05,5607,93,467500,83.36305278174036,8
0.05,5608,95,467595,83.36512747370298,6
0.05,5609,94,467689,83.36702317290552,8
0.05,5610,96,467785,83.36927463910176,6
0.05,5611,94,467879,83.37116892373486,7
0.05,5612,91,467970,83.37252805986104,11
0.05,5613,95,468065,83.3745992162451,6
0.05,5614,92,468157,83.37613535173642,9
0.05,5615,96,468253,83.37838319088318,6
0.05,5616,95,468348,83.38045219868258,6
0.05,5617,92,468440,83.38198647205411,9
0.05,5618,94,468534,83.38387613454351,7
0.05,5619,95,468629,83.38594306049822,8
0.05,5620,94,468723,83.38783134673545,7
0.05,5621,93,468816,83.38954108858057,9
0.05,5622,26,468842,83.37933487462209,6
0.05,5623,89,468931,83.38033428165006,12
0.05,5624,91,469022,83.38168888888889,10
0.05,5625,90,469112,83.38286526839673,12
0.05,5626,23,469135,83.37213435223032,9
0.05,5627,95,469230,83.37420042643923,6
0.05,5628,95,469325,83.376265766566,6
0.05,5629,95,469420,83.37833037300177,6
0.05,5630,92,469512,83.37986148108683,9
0.05,5631,94,469606,83.3817471590909,7
0.05,5632,94,469700,83.38363216758388,7
0.05,5633,95,469795,83.38569400070998,7
0.05,5634,94,469889,83.38757763975156,8
0.05,5635,94,469983,83.38946061036197,7
0.05,5636,93,470076,83.39116551357105,8
0.05,5637,96,470172,83.3934019155729,6
0.05,5638,92,470264,83.3949281787551,9
0.05,5639,94,470358,83.3968085106383,7
0.05,5640,94,470452,83.39868817585534,7
0.05,5641,95,470547,83.40074441687345,6
0.05,5642,92,470639,83.40226829700514,9
0.05,5643,92,470731,83.40379163713678,9
0.05,5644,94,470825,83.40566873339239,7
0.05,5645,94,470919,83.40754516471839,8
0.05,5646,96,471015,83.40977510182398,6
0.05,5647,25,471040,83.39943342776203,7
0.05,5648,94,471134,83.40130996636573,7
0.05,5649,93,471227,83.40300884955752,8
0.05,5650,94,471321,83.40488409131127,7
0.05,5651,96,471417,83.40711252653928,6
0.05,5652,96,471513,83.40934017335928,6
0.05,5653,95,471608,83.41139016625398,8
0.05,5654,94,471702,83.41326259946949,7
0.05,5655,26,471728,83.4031117397454,6
0.05,5656,96,471824,83.40533851864946,6
0.05,5657,94,471918,83.40721102863202,7
0.05,5658,95,472013,83.40925958649939,6
0.05,5659,94,472107,83.41113074204947,7
0.05,5660,96,472203,83.41335453100159,6
0.05,5661,94,472297,83.41522430236665,7
0.05,5662,94,472391,83.41709341338513,7
0.05,5663,20,472411,83.40589689265536,12
0.05,5664,94,472505,83.40776699029126,7
0.05,5665,92,472597,83.40928344511119,9
0.05,5666,96,472693,83.41150520557615,6
0.05,5667,95,472788,83.41354975299929,6
0.05,5668,92,472880,83.41506438525313,9
0.05,5669,94,472974,83.41693121693122,7
0.05,5670,25,472999,83.4066302239464,8
0.05,5671,25,473024,83.39633286318758,7
0.05,5672,93,473117,83.39802573594218,8
0.05,5673,95,473212,83.40007049700388,6
0.05,5674,94,473306,83.4019383259912,7
0.05,5675,93,473399,83.40362931642001,8
0.05,5676,27,473426,83.39369385238682,6
0.05,5677,94,473520,83.39556181754139,7
0.05,5678,96,473616,83.39778129952457,6
0.05,5679,94,473710,83.39964788732394,7
0.05,5680,94,473804,83.4015138179898,7
0.05,5681,94,473898,83.40337909186906,7
0.05,5682,24,473922,83.39292627133557,8
0.05,5683,95,474017,83.39496833216045,8
0.05,5684,92,474109,83.39648197009674,9
0.05,5685,20,474129,83.38533239535701,12
0.05,5686,94,474223,83.38719887462634,7
0.05,5687,94,474317,83.389064697609,7
0.05,5688,93,474410,83.39075408683424,8
0.05,5689,93,474503,83.39244288224955,8
0.05,5690,94,474597,83.39430680021086,7
0.05,5691,25,474622,83.38404778636684,8
0.05,5692,94,474716,83.38591252415247,7
0.05,5693,25,474741,83.37565858798736,8
0.05,5694,94,474835,83.37752414398595,7
0.05,5695,94,474929,83.37938904494382,7
0.05,5696,95,475024,83.38142882218712,6
0.05,5697,96,475120,83.38364338364339,6
0.05,5698,91,475211,83.38497982102123,10
0.05,5699,21,475232,83.37403508771929,12
0.05,5700,96,475328,83.37624978074022,6
0.05,5701,95,475423,83.37828831988776,6
0.05,5702,92,475515,83.37980010520779,9
0.05,5703,96,475611,83.3820126227209,6
0.05,5704,94,475705,83.38387379491674,7
0.05,5705,91,475796,83.38520855240098,10
0.05,5706,94,475890,83.38706851235325,7
0.05,5707,94,475984,83.38892782060266,7
0.05,5708,-45,475939,83.36643895603433,8
0.05,5709,94,476033,83.36830122591944,7
0.05,5710,95,476128,83.37033794431798,6
0.05,5711,25,476153,83.36011904761905,9
0.05,5712,95,476248,83.36215648520917,6
0.05,5713,91,476339,83.36349317465873,12
0.05,5714,95,476434,83.3655293088364,6
0.05,5715,94,476528,83.36738978306508,8
0.05,5716,22,476550,83.35665558859542,10
0.05,5717,95,476645,83.3586918502973,8
0.05,5718,93,476738,83.36037768840707,8
0.05,5719,94,476832,83.36223776223777,7
0.05,5720,96,476928,83.36444677503933,6
0.05,5721,96,477024,83.36665501572877,6
0.05,5722,93,477117,83.36833828411672,8
0.05,5723,92,477209,83.36984626135569,9
0.05,5724,95,477304,83.37187772925765,6
0.05,5725,96,477400,83.37408312958435,6
0.05,5726,95,477495,83.37611314824515,6
0.05,5727,95,477590,83.37814245810056,6
0.05,5728,94,477684,83.37999650898935,7
0.05,5729,94,477778,83.38184991273997,7
0.05,5730,94,477872,83.38370266969115,9
0.05,5731,94,477966,83.38555478018144,7
0.05,5732,94,478060,83.3874062445491,7
0.05,5733,85,478145,83.3876874782002,16
0.05,5734,94,478239,83.3895379250218,7
0.05,5735,96,478335,83.39173640167364,6
0.05,5736,91,478426,83.39306257625937,10
0.05,5737,92,478518,83.39456256535378,9
0.05,5738,94,478612,83.39641052448162,7
0.05,5739,93,478705,83.39808362369338,9
0.05,5740,26,478731,83.38808569935551,6
0.05,5741,23,478754,83.3775687913619,9
0.05,5742,94,478848,83.3794184224273,9
0.05,5743,94,478942,83.38126740947075,7
0.05,5744,96,479038,83.3834638816362,6
0.05,5745,-46,478992,83.36094674556213,9
0.05,5746,25,479017,83.35079171741778,8
0.05,5747,88,479105,83.35160055671538,13
0.05,5748,94,479199,83.35345277439555,7
0.05,5749,24,479223,83.34313043478261,8
0.05,5750,95,479318,83.3451573639367,7
0.05,5751,95,479413,83.34718358831711,6
0.05,5752,94,479507,83.34903528593777,7
0.05,5753,94,479601,83.35088633993743,7
0.05,5754,94,479695,83.3527367506516,7
0.05,5755,94,479789,83.35458651841557,7
0.05,5756,94,479883,83.35643564356435,7
0.05,5757,21,479904,83.34560611323376,11
0.05,5758,95,479999,83.34762979683973,6
0.05,5759,25,480024,83.3375,7
0.05,5760,94,480118,83.33935080715153,7
0.05,5761,91,480209,83.34068031933356,10
0.05,5762,94,480303,83.34252993232691,8
0.05,5763,96,480399,83.34472588480222,6
0.05,5764,94,480493,83.34657415437988,7
0.05,5765,96,480589,83.34876864377385,6
0.05,5766,94,480683,83.35061557135425,7
0.05,5767,89,480772,83.35159500693482,12
0.05,5768,94,480866,83.35344080429884,7
0.05,5769,93,480959,83.35511265164645,8
0.05,5770,94,481053,83.35695719979206,7
0.05,5771,94,481147,83.3588011088011,7
0.05,5772,94,481241,83.36064437900572,7
0.05,5773,95,481336,83.36266020090059,6
0.05,5774,95,481431,83.36467532467532,6
0.05,5775,96,481527,83.36686288088643,6
0.05,5776,95,481622,83.36887657953956,7
0.05,5777,93,481715,83.3705434406369,8
0.05,5778,94,481809,83.37238276518428,7
0.05,5779,93,481902,83.37404844290657,8
0.05,5780,94,481996,83.37588652482269,7
0.05,5781,94,482090,83.37772397094432,7
0.05,5782,92,482182,83.37921494034238,9
0.05,5783,93,482275,83.38087828492392,8
0.05,5784,96,482371,83.38305963699221,6
0.05,5785,95,482466,83.38506740407881,6
0.05,5786,94,482560,83.38690167617072,7
0.05,5787,93,482653,83.38856254319282,8
0.05,5788,94,482747,83.39039557782,7
0.05,5789,94,482841,83.39222797927461,7
0.05,5790,95,482936,83.39423242963218,6
0.05,5791,94,483030,83.39606353591161,7
0.05,5792,94,483124,83.39789401001208,7
0.05,5793,92,483216,83.39937866758716,9
0.05,5794,94,483310,83.40120793787749,7
0.05,5795,93,483403,83.4028640441684,8
0.05,5796,95,483498,83.40486458513024,6
0.05,5797,93,483591,83.40651948947914,8
0.05,5798,96,483687,83.40869115364718,6
0.05,5799,93,483780,83.4103448275862,9
0.05,5800,94,483874,83.41217031546284,7
0.05,5801,94,483968,83.41399517407791,8
0.05,5802,27,483995,83.40427365155954,6
0.05,5803,95,484090,83.40627153687112,6
0.05,5804,90,484180,83.4074074074074,11
0.05,5805,93,484273,83.40905959352393,8
0.05,5806,93,484366,83.41071121060789,8
0.05,5807,95,484461,83.41270661157024,6
0.05,5808,93,484554,83.41435703219143,8
0.05,5809,94,484648,83.41617900172118,7
0.05,5810,96,484744,83.41834451901566,6
0.05,5811,94,484838,83.42016517549897,7
0.05,5812,94,484932,83.42198520557372,7
0.05,5813,93,485025,83.42363261093911,8
0.05,5814,95,485120,83.4256233877902,6
0.05,5815,94,485214,83.42744154057772,7
0.05,5816,93,485307,83.42908715832904,8
0.05,5817,27,485334,83.41938810587831,6
0.05,5818,94,485428,83.421206392851,7
0.05,5819,96,485524,83.4233676975945,6
0.05,5820,94,485618,83.42518467617248,7
0.05,5821,91,485709,83.42648574373068,11
0.05,5822,94,485803,83.42830156276833,7
0.05,5823,23,485826,83.41792582417582,10
0.05,5824,94,485920,83.41974248927039,7
0.05,5825,22,485942,83.40920013731548,10
0.05,5826,94,486036,83.41101767633431,7
0.05,5827,91,486127,83.41231983527797,10
0.05,5828,95,486222,83.41430777148739,6
0.05,5829,96,486318,83.41646655231561,6
0.05,5830,94,486412,83.41828159835363,8
0.05,5831,93,486505,83.41992455418381,8
0.05,5832,94,486599,83.42173838505057,7
0.05,5833,92,486691,83.42320877613987,10
0.05,5834,92,486783,83.42467866323908,9
0.05,5835,24,486807,83.41449623029472,8
0.05,5836,94,486901,83.4163097481583,7
0.05,5837,94,486995,83.41812264474135,7
0.05,5838,94,487089,83.41993492036308,7
0.05,5839,94,487183,83.42174657534247,7
0.05,5840,94,487277,83.42355760999828,7
0.05,5841,95,487372,83.42553919890449,6
0.05,5842,93,487465,83.4271778196132,8
0.05,5843,94,487559,83.42898699520876,7
0.05,5844,95,487654,83.43096663815227,7
0.05,5845,90,487744,83.43209031816627,11
0.05,5846,96,487840,83.43423978108432,6
0.05,5847,96,487936,83.43638850889192,6
0.05,5848,96,488032,83.43853650196615,6
0.05,5849,94,488126,83.44034188034188,7
0.05,5850,92,488218,83.44180481968894,9
0.05,5851,95,488313,83.44377990430623,6
0.05,5852,95,488408,83.445754314027,6
0.05,5853,94,488502,83.44755722582849,7
0.05,5854,93,488595,83.44918872758326,9
0.05,5855,95,488690,83.45116120218579,6
0.05,5856,21,488711,83.4404985487451,11
0.05,5857,93,488804,83.44213041993855,8
0.05,5858,94,488898,83.44393241167435,7
0.05,5859,94,488992,83.4457337883959,7
0.05,5860,89,489081,83.44668145367685,12
0.05,5861,95,489176,83.44865233708632,6
0.05,5862,90,489266,83.44976974245267,11
0.05,5863,94,489360,83.45156889495225,7
0.05,5864,95,489455,83.45353793691389,6
0.05,5865,93,489548,83.45516535969996,8
0.05,5866,93,489641,83.45679222771433,8
0.05,5867,94,489735,83.45858895705521,7
0.05,5868,94,489829,83.46038507411825,8
0.05,5869,94,489923,83.46218057921635,7
0.05,5870,94,490017,83.46397547266224,7
0.05,5871,96,490113,83.46611035422343,7
0.05,5872,93,490206,83.46773369657755,9
0.05,5873,92,490298,83.46918624446714,9
0.05,5874,96,490394,83.47131914893617,6
0.05,5875,92,490486,83.47277059223961,9
0.05,5876,96,490582,83.47490216096648,6
0.05,5877,91,490673,83.47618237495747,11
0.05,5878,94,490767,83.47797244429324,7
0.05,5879,94,490861,83.4797619047619,7
0.05,5880,94,490955,83.48155075667404,7
0.05,5881,93,491048,83.4831689901394,8
0.05,5882,93,491141,83.48478667346592,10
0.05,5883,95,491236,83.48674371176071,7
0.05,5884,95,491331,83.48870008496176,6
0.05,5885,95,491426,83.49065579340808,6
0.05,5886,94,491520,83.4924409716324,7
0.05,5887,94,491614,83.49422554347827,7
0.05,5888,94,491708,83.49600950925455,7
0.05,5889,94,491802,83.49779286926994,7
0.05,5890,96,491898,83.49991512476659,6
0.05,5891,96,491994,83.5020366598778,6
0.05,5892,21,492015,83.4914305107755,11
0.05,5893,92,492107,83.49287410926365,9
0.05,5894,17,492124,83.48159457167091,15
0.05,5895,93,492217,83.48320895522389,8
0.05,5896,92,492309,83.48465321349839,9
0.05,5897,23,492332,83.47439810105121,9
0.05,5898,94,492426,83.47618240379725,7
0.05,5899,92,492518,83.47762711864407,10
0.05,5900,22,492540,83.467208947636,11
0.05,5901,21,492561,83.45662487292444,12
0.05,5902,94,492655,83.45841097746909,7
0.05,5903,95,492750,83.46036585365853,6
0.05,5904,92,492842,83.46181202370872,9
0.05,5905,93,492935,83.46342702336607,8
0.05,5906,94,493029,83.46521076688674,7
0.05,5907,95,493124,83.46716316858497,6
0.05,5908,96,493220,83.46928414283296,6
0.05,5909,95,493315,83.47123519458545,6
0.05,5910,94,493409,83.47301641008289,7
0.05,5911,95,493504,83.47496617050068,6
0.05,5912,93,493597,83.47657703365466,9
0.05,5913,95,493692,83.47852553263442,7
0.05,5914,92,493784,83.47996618765849,9
0.05,5915,91,493875,83.48123732251521,10
0.05,5916,94,493969,83.48301504140612,8
0.05,5917,94,494063,83.48479215951335,7
0.05,5918,92,494155,83.48623078222673,9
0.05,5919,95,494250,83.48817567567568,6
0.05,5920,94,494344,83.48995102178687,7
0.05,5921,96,494440,83.4920634920635,6
0.05,5922,94,494534,83.49383758230627,7
0.05,5923,95,494629,83.4957798784605,6
0.05,5924,94,494723,83.49755274261604,7
0.05,5925,-45,494678,83.47586905163685,8
0.05,5926,96,494774,83.47798211574153,6
0.05,5927,25,494799,83.46811740890688,7
0.05,5928,95,494894,83.47006240512734,6
0.05,5929,22,494916,83.45969645868466,12
0.05,5930,94,495010,83.46147361321869,7
0.05,5931,94,495104,83.4632501685772,8
0.05,5932,90,495194,83.4643519298837,11
0.05,5933,94,495288,83.46612740141558,7
0.05,5934,91,495379,83.46739679865206,10
0.05,5935,95,495474,83.46933962264151,6
0.05,5936,94,495568,83.47111335691427,7
0.05,5937,94,495662,83.47288649376894,7
0.05,5938,94,495756,83.47465903350732,7
0.05,5939,95,495851,83.47659932659933,7
0.05,5940,92,495943,83.47803400100993,9
0.05,5941,92,496035,83.47946819252776,9
0.05,5942,96,496131,83.48157496214033,6
0.05,5943,95,496226,83.48351278600269,6
0.05,5944,94,496320,83.48528174936922,7
0.05,5945,90,496410,83.48637739656913,11
0.05,5946,93,496503,83.48797713132672,8
0.05,5947,94,496597,83.48974445191661,7
0.05,5948,95,496692,83.49167927382753,6
0.05,5949,94,496786,83.49344537815126,7
0.05,5950,94,496880,83.49521088892624,7
0.05,5951,26,496906,83.48555107526882,6
0.05,5952,94,497000,83.48731731899882,7
0.05,5953,96,497096,83.48941887806517,6
0.05,5954,96,497192,83.49151973131822,6
0.05,5955,95,497287,83.49345198119543,6
0.05,5956,95,497382,83.49538358234011,6
0.05,5957,94,497476,83.49714669352132,7
0.05,5958,25,497501,83.48733008894109,7
0.05,5959,95,497596,83.48926174496644,6
0.05,5960,25,497621,83.47944975675222,7
0.05,5961,25,497646,83.46964106004697,7
0.05,5962,93,497739,83.47123930907262,8
0.05,5963,96,497835,83.47334004024145,6
0.05,5964,95,497930,83.47527242246437,6
0.05,5965,93,498023,83.47686892390212,8
0.05,5966,95,498118,83.47880006703537,6
0.05,5967,94,498212,83.48056300268097,7
0.05,5968,96,498308,83.48266041212933,6
0.05,5969,25,498333,83.47286432160804,8
0.05,5970,23,498356,83.4627365600402,11
0.05,5971,96,498452,83.46483590087072,6
0.05,5972,95,498547,83.46676711870082,6
0.05,5973,94,498641,83.46853029795781,9
0.05,5974,94,498735,83.47029288702929,7
0.05,5975,96,498831,83.47238955823293,6
0.05,5976,95,498926,83.47431821984273,6
0.05,5977,92,499018,83.4757443961191,9
0.05,5978,94,499112,83.47750459943134,7
0.05,5979,94,499206,83.47926421404682,7
0.05,5980,92,499298,83.48068884801873,9
0.05,5981,96,499394,83.48278167836844,6
0.05,5982,94,499488,83.48453952866456,7
0.05,5983,89,499577,83.48546122994652,12
0.05,5984,94,499671,83.48721804511278,7
0.05,5985,93,499764,83.48880721683929,8
0.05,5986,23,499787,83.47870385835978,10
0.05,5987,94,499881,83.48046092184369,7
0.05,5988,95,499976,83.48238437134746,6
0.05,5989,25,500001,83.47262103505842,7
0.05,5990,94,500095,83.47437823401769,7
0.05,5991,24,500119,83.4644526034713,9
0.05,5992,94,500213,83.46621057900884,7
0.05,5993,95,500308,83.46813480146814,6
0.05,5994,96,500404,83.47022518765638,6
0.05,5995,94,500498,83.47198132088059,7
0.05,5996,26,500524,83.46239786559947,6
0.05,5997,21,500545,83.45198399466489,11
0.05,5998,94,500639,83.45374229038173,7
0.05,5999,95,500734,83.45566666666667,6
0.05,6000,94,500828,83.45742376270621,7
0.05,6001,95,500923,83.45934688437188,6
0.05,6002,91,501014,83.46060303181743,10
0.05,6003,23,501037,83.45053297801466,9
0.05,6004,94,501131,83.45228975853455,7
0.05,6005,95,501226,83.45421245421245,6
0.05,6006,96,501322,83.45630098218744,6
0.05,6007,94,501416,83.45805592543276,7
0.05,6008,21,501437,83.44766184057248,11
0.05,6009,93,501530,83.44925124792013,8
0.05,6010,94,501624,83.45100648810514,7
0.05,6011,92,501716,83.45242847638058,10
0.05,6012,94,501810,83.45418260435723,7
0.05,6013,92,501902,83.45560359161955,9
0.05,6014,96,501998,83.45768911055694,6
0.05,6015,94,502092,83.45944148936171,7
0.05,6016,94,502186,83.46119328569054,7
0.05,6017,94,502280,83.46294449983384,7
0.05,6018,19,502299,83.45223459046353,13
0.05,6019,95,502394,83.45415282392027,6
0.05,6020,93,502487,83.45573824946023,8
0.05,6021,96,502583,83.45782132181999,6
0.05,6022,90,502673,83.45890752116885,11
0.05,6023,95,502768,83.46082337317397,6
0.05,6024,24,502792,83.45095435684647,8
0.05,6025,94,502886,83.4527049452373,7
0.05,6026,96,502982,83.45478679276589,6
0.05,6027,95,503077,83.45670205706702,7
0.05,6028,94,503171,83.45845082103168,7
0.05,6029,92,503263,83.45986733001658,9
0.05,6030,96,503359,83.46194660918587,6
0.05,6031,94,503453,83.46369363395226,7
0.05,6032,94,503547,83.46544007956241,7
0.05,6033,96,503643,83.46751740139212,6
0.05,6034,94,503737,83.46926263463132,7
0.05,6035,94,503831,83.47100728959576,7
0.05,6036,94,503925,83.4727513665728,7
0.05,6037,95,504020,83.47466048360384,6
0.05,6038,96,504116,83.47673455870178,6
0.05,6039,94,504210,83.47847682119205,8
0.05,6040,95,504305,83.4803840423771,6
0.05,6041,94,504399,83.48212512413109,8
0.05,6042,94,504493,83.48386562965415,7
0.05,6043,95,504588,83.48577101257446,7
0.05,6044,92,504680,83.48717948717949,9
0.05,6045,94,504774,83.48891829308634,7
0.05,6046,92,504866,83.4903257813792,9
0.05,6047,95,504961,83.49222883597884,6
0.05,6048,96,505057,83.49429657794677,6
0.05,6049,94,505151,83.49603305785124,7
0.05,6050,93,505244,83.49760370186746,8
0.05,6051,93,505337,83.49917382683411,8
0.05,6052,92,505429,83.50057822567322,9
0.05,6053,95,505524,83.50247770069376,6
0.05,6054,96,505620,83.50454170107349,6
0.05,6055,94,505714,83.50627476882431,8
0.05,6056,95,505809,83.50817236255573,8
0.05,6057,94,505903,83.5099042588313,7
0.05,6058,94,505997,83.51163558342961,7
0.05,6059,92,506089,83.51303630363036,10
0.05,6060,95,506184,83.51493152945059,6
0.05,6061,24,506208,83.50511382382052,8
0.05,6062,24,506232,83.49529935675409,9
0.05,6063,19,506251,83.4846635883905,15
0.05,6064,95,506346,83.48656224237428,6
0.05,6065,95,506441,83.48846027035938,6
0.05,6066,25,506466,83.47881984506346,10
0.05,6067,22,506488,83.46868820039552,11
0.05,6068,94,506582,83.47042346350305,7
0.05,6069,94,506676,83.47215815485997,7
0.05,6070,94,506770,83.4738922747488,7
0.05,6071,94,506864,83.4756258234519,7
0.05,6072,94,506958,83.47735880125144,7
0.05,6073,95,507053,83.47925584458348,6
0.05,6074,94,507147,83.48098765432098,7
0.05,6075,20,507167,83.47053982883476,13
0.05,6076,94,507261,83.4722725028797,7
0.05,6077,25,507286,83.4626521882198,7
0.05,6078,20,507306,83.4522125349564,12
0.05,6079,94,507400,83.45394736842105,7
0.05,6080,95,507495,83.45584607794771,6
0.05,6081,96,507591,83.45790858270306,6
0.05,6082,27,507618,83.44862732204504,6
0.05,6083,25,507643,83.43902038132808,8
0.05,6084,95,507738,83.44092029580936,6
0.05,6085,95,507833,83.44281958593493,6
0.05,6086,94,507927,83.44455396747166,7
0.05,6087,94,508021,83.44628777923785,7
0.05,6088,94,508115,83.44802102151421,7
0.05,6089,95,508210,83.44991789819376,6
0.05,6090,25,508235,83.440321786242,7
0.05,6091,92,508327,83.44172685489166,10
0.05,6092,94,508421,83.44345970786148,7
0.05,6093,96,508517,83.44552018378734,6
0.05,6094,95,508612,83.44741591468417,6
0.05,6095,94,508706,83.4491469816273,7
0.05,6096,94,508800,83.45087748072822,7
0.05,6097,95,508895,83.45277140045917,6
0.05,6098,27,508922,83.44351533038203,6
0.05,6099,26,508948,83.43409836065574,7
0.05,6100,96,509044,83.43615800688411,6
0.05,6101,94,509138,83.43788921665028,7
0.05,6102,20,509158,83.42749467475012,12
0.05,6103,94,509252,83.42922673656619,7
0.05,6104,94,509346,83.43095823095823,7
0.05,6105,95,509441,83.43285293154274,7
0.05,6106,95,509536,83.434747011626,6
0.05,6107,92,509628,83.43614931237721,9
0.05,6108,88,509716,83.43689638238665,16
0.05,6109,95,509811,83.43878887070376,8
0.05,6110,92,509903,83.44018982163313,9
0.05,6111,92,509995,83.44159031413612,9
0.05,6112,95,510090,83.44348110584001,6
0.05,6113,93,510183,83.4450441609421,8
0.05,6114,92,510275,83.44644317252657,9
0.05,6115,94,510369,83.44816873773708,7
0.05,6116,93,510462,83.44973025993134,8
0.05,6117,96,510558,83.451781627983,6
0.05,6118,90,510648,83.45285177316555,11
0.05,6119,94,510742,83.45457516339869,7
0.05,6120,20,510762,83.4442084626695,12
0.05,6121,92,510854,83.44560601110749,9
0.05,6122,94,510948,83.44732974032337,7
0.05,6123,93,511041,83.44888961463096,8
0.05,6124,26,511067,83.43951020408163,6
0.05,6125,95,511162,83.44139732288606,6
0.05,6126,93,511255,83.44295740166476,8
0.05,6127,95,511350,83.44484334203655,6
0.05,6128,95,511445,83.44672866699298,6
0.05,6129,96,511541,83.44877650897227,6
0.05,6130,94,511635,83.4504974718643,8
0.05,6131,96,511731,83.45254403131115,6
0.05,6132,93,511824,83.454100766346,8
0.05,6133,94,511918,83.45582001956309,7
0.05,6134,95,512013,83.45770171149144,7
0.05,6135,93,512106,83.45925684485006,8
0.05,6136,92,512198,83.46064852533812,9
0.05,6137,91,512289,83.46187683284458,10
0.05,6138,93,512382,83.46343052614432,8
0.05,6139,94,512476,83.46514657980455,7
0.05,6140,94,512570,83.46686207458069,7
0.05,6141,94,512664,83.46857701074569,7
0.05,6142,95,512759,83.47045417548429,6
0.05,6143,96,512855,83.47249348958333,6
0.05,6144,93,512948,83.4740439381611,8
0.05,6145,95,513043,83.4759192971038,6
0.05,6146,25,513068,83.46640637709451,8
0.05,6147,23,513091,83.45657124268055,10
0.05,6148,94,513185,83.45828590014636,7
0.05,6149,96,513281,83.46032520325203,6
0.05,6150,96,513377,83.46236384327752,6
0.05,6151,94,513471,83.4640767230169,7
0.05,6152,96,513567,83.46611409068747,6
0.05,6153,93,513660,83.46766330841729,8
0.05,6154,95,513755,83.46953696181966,6
0.05,6155,92,513847,83.47092267706303,9
0.05,6156,95,513942,83.47279519246386,7
0.05,6157,25,513967,83.46329977265346,7
0.05,6158,90,514057,83.46436109758078,12
0.05,6159,94,514151,83.46607142857142,7
0.05,6160,93,514244,83.46761889303684,8
0.05,6161,26,514270,83.45829276209022,6
0.05,6162,96,514366,83.46032776245335,6
0.05,6163,94,514460,83.46203763789747,7
0.05,6164,94,514554,83.46374695863747,7
0.05,6165,19,514573,83.45329224781058,13
0.05,6166,92,514665,83.45467812550673,9
0.05,6167,94,514759,83.4563878080415,7
0.05,6168,92,514851,83.45777273464094,10
0.05,6169,94,514945,83.45948136142626,7
0.05,6170,96,515041,83.46151353103225,6
0.05,6171,93,515134,83.46305897602073,10
0.05,6172,96,515230,83.4650899076624,6
0.05,6173,92,515322,83.466472303207,9
0.05,6174,25,515347,83.457004048583,7
0.05,6175,95,515442,83.45887305699482,7
0.05,6176,92,515534,83.46025578759915,9
0.05,6177,93,515627,83.46179993525413,8
0.05,6178,96,515723,83.46382909855964,6
0.05,6179,94,515817,83.46553398058252,7
0.05,6180,96,515913,83.46756188319043,6
0.05,6181,23,515936,83.45778065351018,9
0.05,6182,90,516026,83.45883875141517,11
0.05,6183,94,516120,83.46054333764553,7
0.05,6184,22,516142,83.450606305578,12
0.05,6185,89,516231,83.45150339476237,14
0.05,6186,95,516326,83.45336996929045,7
0.05,6187,96,516422,83.45539754363284,6
0.05,6188,94,516516,83.45710130877363,7
0.05,6189,22,516538,83.44717285945073,11
0.05,6190,94,516632,83.4488774026813,7
0.05,6191,96,516728,83.45090439276485,6
0.05,6192,23,516751,83.44114322622316,10
0.05,6193,95,516846,83.44300936390054,7
0.05,6194,95,516941,83.4448748991122,6
0.05,6195,94,517035,83.44657843770175,7
0.05,6196,91,517126,83.4477973212845,12
0.05,6197,95,517221,83.44966118102614,8
0.05,6198,96,517317,83.45168575576706,6
0.05,6199,94,517411,83.4533870967742,7
0.05,6200,25,517436,83.44396065150782,7
0.05,6201,92,517528,83.44534021283457,10
0.05,6202,95,517623,83.44720296630662,6
0.05,6203,23,517646,83.43745970341715,10
0.05,6204,94,517740,83.43916196615632,7
0.05,6205,96,517836,83.44118594908153,6
0.05,6206,96,517932,83.44320927984533,6
0.05,6207,96,518028,83.44523195876289,6
0.05,6208,94,518122,83.44693187308745,7
0.05,6209,94,518216,83.4486312399356,8
0.05,6210,96,518312,83.45065206891,6
0.05,6211,94,518406,83.45235028976175,7
0.05,6212,94,518500,83.45404796394656,7
0.05,6213,94,518594,83.45574509172836,8
0.05,6214,25,518619,83.44633950120675,8
0.05,6215,94,518713,83.44803732303733,7
0.05,6216,24,518737,83.43847514878559,8
0.05,6217,96,518833,83.44049533612093,6
0.05,6218,95,518928,83.44235407621804,7
0.05,6219,94,519022,83.44405144694534,7
0.05,6220,24,519046,83.4344960617264,9
0.05,6221,96,519142,83.4365155898425,6
0.05,6222,95,519237,83.43837377470673,7
0.05,6223,94,519331,83.44007069408741,7
0.05,6224,92,519423,83.44144578313254,9
0.05,6225,95,519518,83.44330228075812,7
0.05,6226,94,519612,83.44499759113538,7
0.05,6227,94,519706,83.44669235709698,7
0.05,6228,94,519800,83.44838657890512,7
0.05,6229,93,519893,83.44991974317817,9
0.05,6230,94,519987,83.45161290322581,7
0.05,6231,94,520081,83.4533055198973,7
0.05,6232,96,520177,83.45531846622814,6
0.05,6233,93,520270,83.45684953480911,8
0.05,6234,95,520365,83.45870088211709,6
0.05,6235,92,520457,83.46007055805003,9
0.05,6236,23,520480,83.45037678371011,9
0.05,6237,94,520574,83.45206797050336,7
0.05,6238,96,520670,83.45407917935566,6
0.05,6239,94,520764,83.45576923076923,7
0.05,6240,94,520858,83.45745874058645,7
0.05,6241,94,520952,83.45914770906761,7
0.05,6242,23,520975,83.44946339900689,9
0.05,6243,94,521069,83.4511531069827,7
0.05,6244,94,521163,83.45284227381906,7
0.05,6245,93,521256,83.45437079731028,8
0.05,6246,94,521350,83.45605890827598,8
0.05,6247,96,521446,83.45806658130601,6
0.05,6248,96,521542,83.46007361177789,6
0.05,6249,94,521636,83.46176,7
0.05,6250,25,521661,83.45240761478163,7
0.05,6251,94,521755,83.45409468969929,7
0.05,6252,94,521849,83.45578122501199,7
0.05,6253,94,521943,83.45746722097857,7
0.05,6254,94,522037,83.45915267785772,7
0.05,6255,95,522132,83.46099744245524,6
0.05,6256,96,522228,83.463001438389,6
0.05,6257,26,522254,83.45381911153723,7
0.05,6258,92,522346,83.45518453427066,9
0.05,6259,91,522437,83.45638977635782,10
0.05,6260,92,522529,83.45775435233988,9
0.05,6261,94,522623,83.4594378792718,7
0.05,6262,94,522717,83.46112086859333,8
0.05,6263,95,522812,83.46296296296296,8
0.05,6264,96,522908,83.46496408619313,6
0.05,6265,93,523001,83.46648579636131,8
0.05,6266,92,523093,83.4678474549226,9
0.05,6267,94,523187,83.46952776005105,7
0.05,6268,94,523281,83.4712075291115,7
0.05,6269,94,523375,83.47288676236045,7
0.05,6270,26,523401,83.4637218944347,6
0.05,6271,94,523495,83.46540178571429,7
0.05,6272,91,523586,83.46660290132313,10
0.05,6273,93,523679,83.4681224099458,9
0.05,6274,95,523774,83.46996015936254,6
0.05,6275,94,523868,83.47163798597833,7
0.05,6276,94,523962,83.47331527799905,7
0.05,6277,94,524056,83.47499203568016,7
0.05,6278,93,524149,83.47650899824814,8
0.05,6279,94,524243,83.4781847133758,7
0.05,6280,94,524337,83.47985989492119,7
0.05,6281,94,524431,83.48153454313913,7
0.05,6282,95,524526,83.48336781792138,6
0.05,6283,95,524621,83.48520050922978,8
0.05,6284,24,524645,83.47573587907716,8
0.05,6285,92,524737,83.47709195036589,9
0.05,6286,94,524831,83.47876570701447,9
0.05,6287,92,524923,83.48012086513995,9
0.05,6288,95,525018,83.48195261567817,6
0.05,6289,93,525111,83.48346581875994,8
0.05,6290,93,525204,83.48497854077253,8
0.05,6291,96,525300,83.48696757787667,6
0.05,6292,-47,525253,83.4662323216272,10
0.05,6293,94,525347,83.46790594216715,8
0.05,6294,93,525440,83.46942017474186,8
0.05,6295,94,525534,83.47109275730622,7
0.05,6296,90,525624,83.47212958551691,11
0.05,6297,93,525717,83.47364242616703,8
0.05,6298,94,525811,83.47531354183204,7
0.05,6299,94,525905,83.47698412698412,7
0.05,6300,-46,525859,83.45643548643072,9
0.05,6301,94,525953,83.45810853697239,8
0.05,6302,21,525974,83.4481992701888,11
0.05,6303,90,526064,83.44923857868021,12
0.05,6304,95,526159,83.45107057890563,7
0.05,6305,20,526179,83.44100856327307,12
0.05,6306,21,526200,83.43110829237355,11
0.05,6307,24,526224,83.42168674698796,8
0.05,6308,96,526320,83.42368045649073,6
0.05,6309,95,526415,83.42551505546751,6
0.05,6310,-49,526366,83.40453176992553,12
0.05,6311,94,526460,83.40621039290241,7
0.05,6312,25,526485,83.39695865674005,7
0.05,6313,94,526579,83.39863794741844,7
0.05,6314,92,526671,83.4,9
0.05,6315,94,526765,83.40167827739076,8
0.05,6316,94,526859,83.40335602342884,7
0.05,6317,94,526953,83.40503323836657,7
0.05,6318,94,527047,83.40670992245609,7
0.05,6319,94,527141,83.40838607594937,8
0.05,6320,95,527236,83.41021990191426,7
0.05,6321,95,527331,83.41205314773806,6
0.05,6322,94,527425,83.41372766092044,7
0.05,6323,21,527446,83.40385831752056,11
0.05,6324,96,527542,83.40584980237153,6
0.05,6325,93,527635,83.40736642428075,8
0.05,6326,95,527730,83.40919867235657,6
0.05,6327,95,527825,83.41103034134008,6
0.05,6328,95,527920,83.41286143150576,6
0.05,6329,96,528016,83.41484992101105,6
0.05,6330,96,528112,83.41683778234086,6
0.05,6331,95,528207,83.41866708780796,6
0.05,6332,19,528226,83.40849518395704,13
0.05,6333,94,528320,83.41016735080518,7
0.05,6334,-126,528194,83.37711128650355,20
0.05,6335,90,528284,83.37815656565657,11
0.05,6336,91,528375,83.37935931828942,10
0.05,6337,94,528469,83.38103502682235,7
0.05,6338,94,528563,83.38271020665721,7
0.05,6339,94,528657,83.38438485804416,7
0.05,6340,95,528752,83.38621668506545,6
0.05,6341,96,528848,83.38820561337117,6
0.05,6342,95,528943,83.39003626044459,6
0.05,6343,23,528966,83.38051702395964,9
0.05,6344,92,529058,83.38187549251379,9
0.05,6345,27,529085,83.37299086038449,6
0.05,6346,94,529179,83.37466519615566,7
0.05,6347,96,529275,83.37665406427222,6
0.05,6348,92,529367,83.37801228539928,9
0.05,6349,92,529459,83.37937007874015,9
0.05,6350,94,529553,83.38104235553456,7
0.05,6351,94,529647,83.38271410579345,7
0.05,6352,96,529743,83.38470014166535,6
0.05,6353,90,529833,83.38574126534466,11
0.05,6354,26,529859,83.37671125098348,6
0.05,6355,96,529955,83.37869729389553,6
0.05,6356,93,530048,83.38021079125373,8
0.05,6357,25,530073,83.37102862535389,7
0.05,6358,94,530167,83.3727001100802,7
0.05,6359,96,530263,83.3746855345912,6
0.05,6360,20,530283,83.36472252790442,13
0.05,6361,94,530377,83.36639421565546,7
0.05,6362,92,530469,83.36775106082037,12
0.05,6363,94,530563,83.36942174732873,7
0.05,6364,94,530657,83.37109190887666,7
0.05,6365,95,530752,83.37291863022305,6
0.05,6366,92,530844,83.37427359824093,9
0.05,6367,95,530939,83.37609924623115,7
0.05,6368,94,531033,83.3777673104098,7
0.05,6369,95,531128,83.37959183673469,6
0.05,6370,96,531224,83.38157275153037,6
0.05,6371,94,531318,83.38323917137477,7
0.05,6372,93,531411,83.38474815628433,8
0.05,6373,95,531506,83.38657044242234,7
0.05,6374,94,531600,83.38823529411765,7
0.05,6375,96,531696,83.39021329987453,6
0.05,6376,94,531790,83.39187705817783,7
0.05,6377,94,531884,83.39354029476326,7
0.05,6378,93,531977,83.39504624549302,8
0.05,6379,94,532071,83.39670846394985,7
0.05,6380,94,532165,83.39837016141671,7
0.05,6381,94,532259,83.40003133813852,8
0.05,6382,95,532354,83.40184866050447,7
0.05,6383,94,532448,83.40350877192982,7
0.05,6384,90,532538,83.40454189506656,11
0.05,6385,94,532632,83.40620106482932,7
0.05,6386,96,532728,83.4081728511038,6
0.05,6387,95,532823,83.40998747651847,7
0.05,6388,96,532919,83.41195805290343,6
0.05,6389,93,533012,83.41345852895148,8
0.05,6390,92,533104,83.41480206540447,9
0.05,6391,94,533198,83.41645807259074,7
0.05,6392,94,533292,83.41811356170813,7
0.05,6393,93,533385,83.41961213637785,8
0.05,6394,94,533479,83.42126661454262,7
0.05,6395,95,533574,83.42307692307692,7
0.05,6396,95,533669,83.42488666562451,7
0.05,6397,93,533762,83.42638324476398,8
0.05,6398,94,533856,83.42803563056728,8
0.05,6399,26,533882,83.4190625,6
0.05,6400,96,533978,83.42102796438057,6
0.05,6401,94,534072,83.42268041237114,8
0.05,6402,95,534167,83.42448852100578,7
0.05,6403,96,534263,83.42645221736414,6
0.05,6404,94,534357,83.42810304449648,7
0.05,6405,23,534380,83.41866999687792,10
0.05,6406,96,534476,83.42063368191042,6
0.05,6407,94,534570,83.42228464419476,7
0.05,6408,95,534665,83.42409112185989,6
0.05,6409,24,534689,83.41482059282372,8
0.05,6410,95,534784,83.41662767119014,6
0.05,6411,22,534806,83.40704928259514,10
0.05,6412,95,534901,83.40885700920006,6
0.05,6413,94,534995,83.41050826317431,8
0.05,6414,94,535089,83.41215900233827,7
0.05,6415,95,535184,83.4139650872818,6
0.05,6416,92,535276,83.41530310113761,10
0.05,6417,96,535372,83.41726394515425,6
0.05,6418,96,535468,83.4192241782209,6
0.05,6419,95,535563,83.42102803738318,6
0.05,6420,22,535585,83.41146238903598,10
0.05,6421,92,535677,83.41279975085644,9
0.05,6422,27,535704,83.40401681457263,6
0.05,6423,93,535797,83.40551058530511,8
0.05,6424,96,535893,83.40747081712063,6
0.05,6425,94,535987,83.40911920323686,7
0.05,6426,91,536078,83.41030029562782,10
0.05,6427,94,536172,83.411947728687,7
0.05,6428,91,536263,83.41312801368798,10
0.05,6429,25,536288,83.4040435458787,8
0.05,6430,93,536381,83.40553568651842,8
0.05,6431,96,536477,83.40749378109453,6
0.05,6432,-45,536432,83.38753303279962,8
0.05,6433,94,536526,83.38918246813802,7
0.05,6434,93,536619,83.39067599067599,8
0.05,6435,95,536714,83.39247980111871,6
0.05,6436,20,536734,83.38263166071151,12
0.05,6437,96,536830,83.38459148803976,6
0.05,6438,96,536926,83.38655070663147,6
0.05,6439,94,537020,83.38819875776397,8
0.05,6440,94,537114,83.38984629715883,7
0.05,6441,90,537204,83.39087239987582,11
0.05,6442,94,537298,83.3925190128822,7
0.05,6443,90,537388,83.3935443823712,11
0.05,6444,95,537483,83.39534522885958,6
0.05,6445,92,537575,83.39668011169718,10
0.05,6446,96,537671,83.39863502404219,6
0.05,6447,94,537765,83.40027915632754,7
0.05,6448,96,537861,83.40223290432625,6
0.05,6449,94,537955,83.40387596899225,7
0.05,6450,25,537980,83.39482250813828,7
0.05,6451,94,538074,83.39646621202728,8
0.05,6452,94,538168,83.3981094064776,7
0.05,6453,93,538261,83.39959714905486,8
0.05,6454,96,538357,83.40154918667699,6
0.05,6455,94,538451,83.40319083023545,7
0.05,6456,94,538545,83.40483196530897,7
0.05,6457,94,538639,83.40647259213378,7
0.05,6458,96,538735,83.40842235640191,6
0.05,6459,96,538831,83.41037151702787,6
0.05,6460,95,538926,83.41216529948925,6
0.05,6461,93,539019,83.41364902506963,8
0.05,6462,92,539111,83.41497756459849,9
0.05,6463,93,539204,83.41646039603961,8
0.05,6464,92,539296,83.41778808971384,9
0.05,6465,96,539392,83.41973399319518,6
0.05,6466,92,539484,83.4210607700634,9
0.05,6467,95,539579,83.42285095856525,6
0.05,6468,92,539671,83.42417684340701,9
0.05,6469,93,539764,83.42565687789799,8
0.05,6470,94,539858,83.42729099057333,7
0.05,6471,87,539945,83.42784301606922,14
0.05,6472,27,539972,83.4191255986405,6
0.05,6473,95,540067,83.42091442693852,6
0.05,6474,86,540153,83.42131274131275,15
0.05,6475,94,540247,83.42294626312538,7
0.05,6476,94,540341,83.4245792805311,7
0.05,6477,94,540435,83.42621179376351,7
0.05,6478,92,540527,83.42753511344343,9
0.05,6479,94,540621,83.42916666666666,7
0.05,6480,94,540715,83.43079771640178,8
0.05,6481,24,540739,83.42162912681272,8
0.05,6482,95,540834,83.42341508560851,6
0.05,6483,86,540920,83.42381246144355,15
0.05,6484,94,541014,83.4254433307633,7
0.05,6485,25,541039,83.41643539932161,7
0.05,6486,96,541135,83.41837521196238,6
0.05,6487,94,541229,83.42000616522812,7
0.05,6488,26,541255,83.41115734319618,7
0.05,6489,96,541351,83.4130970724191,6
0.05,6490,94,541445,83.41472808504082,7
0.05,6491,25,541470,83.40573012939002,8
0.05,6492,95,541565,83.40751578623133,8
0.05,6493,96,541661,83.40945488142901,6
0.05,6494,24,541685,83.4003079291763,8
0.05,6495,93,541778,83.40178571428571,8
0.05,6496,95,541873,83.40357087886717,6
0.05,6497,95,541968,83.40535549399816,6
0.05,6498,91,542059,83.40652408062779,10
0.05,6499,95,542154,83.40830769230769,7
0.05,6500,93,542247,83.40978311029072,8
0.05,6501,92,542339,83.4111042756075,9
0.05,6502,93,542432,83.4125788097801,8
0.05,6503,95,542527,83.41436039360394,7
0.05,6504,27,542554,83.40568793235973,6
0.05,6505,94,542648,83.40731632339379,7
0.05,6506,95,542743,83.40909789457507,6
0.05,6507,93,542836,83.41057160417947,8
0.05,6508,96,542932,83.41250576125366,6
0.05,6509,93,543025,83.41397849462365,8
0.05,6510,95,543120,83.41575794808786,6
0.05,6511,93,543213,83.41722972972973,8
0.05,6512,90,543303,83.41824044219254,11
0.05,6513,94,543397,83.41986490635554,7
0.05,6514,96,543493,83.42179585571758,6
0.05,6515,92,543585,83.42311233885819,9
0.05,6516,93,543678,83.42458186282032,8
0.05,6517,94,543772,83.42620435716478,7
0.05,6518,93,543865,83.42767295597484,9
0.05,6519,96,543961,83.42960122699387,6
0.05,6520,93,544054,83.43106885447017,8
0.05,6521,23,544077,83.42180312787488,11
0.05,6522,94,544171,83.42342480453779,7
0.05,6523,96,544267,83.42535254445126,6
0.05,6524,96,544363,83.4272796934866,6
0.05,6525,92,544455,83.42859331903156,9
0.05,6526,90,544545,83.42960012256779,11
0.05,6527,95,544640,83.43137254901961,6
0.05,6528,91,544731,83.4325317812835,10
0.05,6529,95,544826,83.43430321592649,7
0.05,6530,96,544922,83.43622722400858,6
0.05,6531,17,544939,83.42605633802818,15
0.05,6532,26,544965,83.41726618705036,8
0.05,6533,21,544986,83.40771349862258,12
0.05,6534,93,545079,83.40918133129304,8
0.05,6535,94,545173,83.4108017135863,7
0.05,6536,95,545268,83.41257457549335,6
0.05,6537,26,545294,83.4037932089324,6
0.05,6538,94,545388,83.40541367181527,7
0.05,6539,96,545484,83.40733944954128,6
0.05,6540,94,545578,83.40895887478979,9
0.05,6541,94,545672,83.41057780495261,7
0.05,6542,23,545695,83.40134494880024,10
0.05,6543,27,545722,83.3927261613692,6
0.05,6544,94,545816,83.39434682964095,7
0.05,6545,93,545909,83.39581423770241,8
0.05,6546,96,546005,83.39773942263632,6
0.05,6547,96,546101,83.39966401954796,6
0.05,6548,-47,546054,83.37975263398992,10
0.05,6549,90,546144,83.38076335877862,11
0.05,6550,96,546240,83.3826896656999,6
0.05,6551,94,546334,83.38431013431014,7
0.05,6552,95,546429,83.38608271020907,6
0.05,6553,95,546524,83.38785474519378,6
0.05,6554,93,546617,83.38932112890923,8
0.05,6555,94,546711,83.39093959731544,9
0.05,6556,93,546804,83.39240506329114,8
0.05,6557,92,546896,83.3937175968283,9
0.05,6558,94,546990,83.39533465467296,7
0.05,6559,86,547076,83.39573170731707,15
0.05,6560,94,547170,83.3973479652492,7
0.05,6561,93,547263,83.39881133800671,8
0.05,6562,96,547359,83.40073137284779,6
0.05,6563,94,547453,83.40234613040829,7
0.05,6564,92,547545,83.40365575019041,9
0.05,6565,95,547640,83.40542187024063,6
0.05,6566,88,547728,83.40612151667428,13
0.05,6567,93,547821,83.40758221680878,8
0.05,6568,93,547914,83.40904247221799,8
0.05,6569,94,548008,83.41065449010655,7
0.05,6570,90,548098,83.41165728199665,11
0.05,6571,96,548194,83.41357273280585,6
0.05,6572,91,548285,83.41472691312947,10
0.05,6573,90,548375,83.4157286279282,11
0.05,6574,95,548470,83.41749049429657,6
0.05,6575,93,548563,83.41894768856447,8
0.05,6576,92,548655,83.42025239470884,9
0.05,6577,94,548749,83.4218607479477,8
0.05,6578,94,548843,83.4234686122511,7
0.05,6579,93,548936,83.42492401215806,10
0.05,6580,93,549029,83.42637896976143,9
0.05,6581,95,549124,83.42813734427226,7
0.05,6582,94,549218,83.42974327814066,7
0.05,6583,94,549312,83.43134872417983,7
0.05,6584,94,549406,83.432953682612,7
0.05,6585,96,549502,83.43486182812026,6
0.05,6586,95,549597,83.43661758008199,8
0.05,6587,90,549687,83.43761384335154,13
0.05,6588,96,549783,83.43952041280923,6
0.05,6589,96,549879,83.44142640364188,6
0.05,6590,94,549973,83.44302837202245,7
0.05,6591,96,550069,83.44493325242719,6
0.05,6592,95,550164,83.44668587896254,6
0.05,6593,89,550253,83.4475280558083,12
0.05,6594,96,550349,83.4494313874147,6
0.05,6595,92,550441,83.45072771376591,9
0.05,6596,94,550535,83.45232681521904,7
0.05,6597,94,550629,83.45392543194907,7
0.05,6598,94,550723,83.45552356417639,8
0.05,6599,94,550817,83.45712121212121,7
0.05,6600,96,550913,83.45902136039994,6
0.05,6601,94,551007,83.4606179945471,7
0.05,6602,92,551099,83.46191125246101,10
0.05,6603,91,551190,83.46305269533616,11
0.05,6604,96,551286,83.46495079485238,6
0.05,6605,92,551378,83.46624280956706,9
0.05,6606,95,551473,83.46798849704858,6
0.05,6607,94,551567,83.4695823244552,7
0.05,6608,93,551660,83.47102436072024,8
0.05,6609,91,551751,83.47216338880484,10
0.05,6610,96,551847,83.47405838753592,6
0.05,6611,95,551942,83.47580157289777,8
0.05,6612,91,552033,83.476939361863,10
0.05,6613,92,552125,83.47822800120956,9
0.05,6614,94,552219,83.4798185941043,8
0.05,6615,25,552244,83.47097944377268,8
0.05,6616,93,552337,83.47241952546472,8
0.05,6617,95,552432,83.47416137805983,6
0.05,6618,22,552454,83.4648738480133,10
0.05,6619,96,552550,83.46676737160121,6
0.05,6620,96,552646,83.46866032321401,6
0.05,6621,94,552740,83.470250679553,7
0.05,6622,94,552834,83.47184055563943,8
0.05,6623,93,552927,83.47327898550725,8
0.05,6624,22,552949,83.464,12
0.05,6625,94,553043,83.46559009960761,7
0.05,6626,95,553138,83.46733061717218,7
0.05,6627,95,553233,83.46907060953531,7
0.05,6628,95,553328,83.47081007693468,6
0.05,6629,95,553423,83.47254901960784,7
0.05,6630,94,553517,83.47413663097572,8
0.05,6631,94,553611,83.47572376357057,7
0.05,6632,25,553636,83.46690788481833,7
0.05,6633,23,553659,83.45779318661441,9
0.05,6634,95,553754,83.45953278070836,6
0.05,6635,23,553777,83.45042194092827,10
0.05,6636,92,553869,83.45171010998945,9
0.05,6637,95,553964,83.45344983428744,8
0.05,6638,94,554058,83.45503840939901,7
0.05,6639,96,554154,83.45692771084337,6
0.05,6640,96,554250,83.45881644330673,6
0.05,6641,94,554344,83.46040349292382,8
0.05,6642,94,554438,83.46199006472979,7
0.05,6643,94,554532,83.4635761589404,7
0.05,6644,96,554628,83.46546275395033,6
0.05,6645,91,554719,83.46659644899188,10
0.05,6646,92,554811,83.46788024672784,9
0.05,6647,94,554905,83.46946450060169,7
0.05,6648,94,554999,83.47104827793653,7
0.05,6649,93,555092,83.47248120300752,8
0.05,6650,94,555186,83.47406405051872,7
0.05,6651,92,555278,83.47534576067348,9
0.05,6652,94,555372,83.47692770178867,7
0.05,6653,93,555465,83.47835888187556,8
0.05,6654,95,555560,83.4800901577761,6
0.05,6655,96,555656,83.48197115384616,6
0.05,6656,96,555752,83.48385158479796,6
0.05,6657,94,555846,83.48543106037849,7
0.05,6658,93,555939,83.4868598888722,8
0.05,6659,25,555964,83.47807807807808,7
0.05,6660,93,556057,83.47950758144422,8
0.05,6661,91,556148,83.48063644551186,10
0.05,6662,94,556242,83.4822152183701,8
0.05,6663,94,556336,83.48379351740697,7
0.05,6664,94,556430,83.4853713428357,7
0.05,6665,95,556525,83.48709870987099,6
0.05,6666,96,556621,83.48897555122244,6
0.05,6667,95,556716,83.49070185962807,6
0.05,6668,95,556811,83.49242765032238,7
0.05,6669,94,556905,83.49400299850075,7
0.05,6670,94,556999,83.49557787438165,7
0.05,6671,96,557095,83.4974520383693,6
0.05,6672,94,557189,83.4990259253709,7
0.05,6673,22,557211,83.48981120767156,11
0.05,6674,95,557306,83.49153558052434,6
0.05,6675,23,557329,83.48247453565008,9
0.05,6676,95,557424,83.48419949078928,6
0.05,6677,93,557517,83.48562443845462,8
0.05,6678,95,557612,83.48734840544992,6
0.05,6679,94,557706,83.48892215568863,7
0.05,6680,96,557802,83.49079479119892,6
0.05,6681,94,557896,83.49236755462437,7
0.05,6682,94,557990,83.49393984737394,7
0.05,6683,94,558084,83.49551166965888,7
0.05,6684,94,558178,83.49708302169036,7
0.05,6685,94,558272,83.49865390367933,7
0.05,6686,27,558299,83.49020487513086,6
0.05,6687,18,558317,83.48041267942584,15
0.05,6688,94,558411,83.48198534908057,7
0.05,6689,91,558502,83.4831091180867,10
0.05,6690,94,558596,83.48468091466148,7
0.05,6691,94,558690,83.48625224148236,7
0.05,6692,94,558784,83.4878230987599,7
0.05,6693,94,558878,83.48939348670451,7
0.05,6694,95,558973,83.49111277072443,6
0.05,6695,23,558996,83.4820788530466,10
0.05,6696,96,559092,83.48394803643423,6
0.05,6697,94,559186,83.48551806509406,7
0.05,6698,94,559280,83.48708762501866,7
0.05,6699,27,559307,83.47865671641792,6
0.05,6700,94,559401,83.48022683181615,7
0.05,6701,94,559495,83.48179647866309,7
0.05,6702,93,559588,83.48321647023721,8
0.05,6703,96,559684,83.48508353221958,6
0.05,6704,95,559779,83.48680089485458,6
0.05,6705,91,559870,83.48792126453922,10
0.05,6706,94,559964,83.48948859400626,8
0.05,6707,96,560060,83.49135360763267,6
0.05,6708,94,560154,83.49291995826502,7
0.05,6709,21,560175,83.48360655737704,11
0.05,6710,96,560271,83.48547161376844,6
0.05,6711,94,560365,83.48703814064362,7
0.05,6712,90,560455,83.48800834202294,11
0.05,6713,92,560547,83.4892761394102,9
0.05,6714,96,560643,83.49113924050633,6
0.05,6715,94,560737,83.49270399047052,7
0.05,6716,96,560833,83.49456602649992,6
0.05,6717,92,560925,83.49583209288478,10
0.05,6718,94,561019,83.49739544575085,7
0.05,6719,95,561114,83.49910714285714,7
0.05,6720,96,561210,83.5009671179884,6
0.05,6721,95,561305,83.50267777447188,6
0.05,6722,96,561401,83.50453666517923,6
0.05,6723,96,561497,83.50639500297441,6
0.05,6724,96,561593,83.50825278810409,6
0.05,6725,92,561685,83.509515313708,9
0.05,6726,94,561779,83.51107477330162,7
0.05,6727,94,561873,83.51263376932224,7
0.05,6728,-44,561829,83.49368405409422,8
0.05,6729,92,561921,83.49494799405646,9
0.05,6730,95,562016,83.49665725746546,6
0.05,6731,93,562109,83.49806892453951,8
0.05,6732,91,562200,83.49918312787761,10
0.05,6733,96,562296,83.5010395010395,6
0.05,6734,95,562391,83.50274684484039,6
0.05,6735,95,562486,83.50445368171022,6
0.05,6736,95,562581,83.50616001187473,6
0.05,6737,95,562676,83.50786583555951,6
0.05,6738,25,562701,83.4991838551714,8
0.05,6739,92,562793,83.50044510385757,9
0.05,6740,92,562885,83.50170597834149,9
0.05,6741,95,562980,83.50341145060813,6
0.05,6742,96,563076,83.50526471896782,6
0.05,6743,94,563170,83.50682087781732,7
0.05,6744,94,563264,83.50837657524092,7
0.05,6745,93,563357,83.50978357545212,8
0.05,6746,23,563380,83.50081517711575,10
0.05,6747,96,563476,83.5026674570243,6
0.05,6748,92,563568,83.50392650763077,9
0.05,6749,96,563664,83.50577777777778,6
0.05,6750,95,563759,83.50748037327803,6
0.05,6751,22,563781,83.49837085308057,10
0.05,6752,95,563876,83.50007404116688,6
0.05,6753,92,563968,83.50133254367782,10
0.05,6754,95,564063,83.50303478904515,7
0.05,6755,90,564153,83.50399644760213,12
0.05,6756,92,564245,83.50525381086281,9
0.05,6757,95,564340,83.50695472033146,6
0.05,6758,96,564436,83.50880307737832,6
0.05,6759,94,564530,83.5103550295858,7
0.05,6760,94,564624,83.51190652270374,7
0.05,6761,95,564719,83.51360544217687,6
0.05,6762,95,564814,83.51530385923407,6
0.05,6763,94,564908,83.51685393258427,8
0.05,6764,95,565003,83.51855136733185,6
0.05,6765,94,565097,83.52010050251256,7
0.05,6766,96,565193,83.52194473178662,6
0.05,6767,95,565288,83.52364066193853,6
0.05,6768,93,565381,83.52504062638499,8
0.05,6769,26,565407,83.5165435745938,6
0.05,6770,93,565500,83.51794417368188,8
0.05,6771,96,565596,83.51978735971647,6
0.05,6772,92,565688,83.52103942123136,9
0.05,6773,22,565710,83.51195748449956,10
0.05,6774,95,565805,83.51365313653136,6
0.05,6775,94,565899,83.51520070838252,7
0.05,6776,95,565994,83.51689538143721,6
0.05,6777,96,566090,83.5187370905872,6
0.05,6778,95,566185,83.52043074199734,7
0.05,6779,93,566278,83.52182890855457,8
0.05,6780,92,566370,83.52307919185961,9
0.05,6781,92,566462,83.52432910645827,9
0.05,6782,90,566552,83.52528379772961,11
0.05,6783,18,566570,83.515625,14
0.05,6784,94,566664,83.5171702284451,7
0.05,6785,94,566758,83.51871500147362,7
0.05,6786,94,566852,83.52025931928688,7
0.05,6787,96,566948,83.52209781968179,6
0.05,6788,93,567041,83.52349388717042,9
0.05,6789,94,567135,83.52503681885125,7
0.05,6790,95,567230,83.52672654984538,6
0.05,6791,94,567324,83.52826855123675,7
0.05,6792,92,567416,83.52951567790373,9
0.05,6793,96,567512,83.53135119222844,6
0.05,6794,96,567608,83.53318616629875,6
0.05,6795,25,567633,83.52457327839906,7
0.05,6796,94,567727,83.52611446226277,7
0.05,6797,92,567819,83.52736098852604,9
0.05,6798,96,567915,83.52919546992204,6
0.05,6799,95,568010,83.53088235294118,6
0.05,6800,95,568105,83.53256873989119,6
0.05,6801,23,568128,83.52366950896796,9
0.05,6802,93,568221,83.52506247243863,9
0.05,6803,92,568313,83.52630805408583,9
0.05,6804,27,568340,83.51800146950771,6
0.05,6805,90,568430,83.51895386423743,11
0.05,6806,95,568525,83.52064051711473,6
0.05,6807,94,568619,83.52217978848414,7
0.05,6808,91,568710,83.52327801439272,10
0.05,6809,92,568802,83.52452276064611,9
0.05,6810,91,568893,83.52562032007047,10
0.05,6811,94,568987,83.52715795654727,7
0.05,6812,96,569083,83.5289886980772,6
0.05,6813,25,569108,83.5203991781626,7
0.05,6814,94,569202,83.52193690388849,7
0.05,6815,94,569296,83.52347417840376,7
0.05,6816,27,569323,83.51518263165616,6
0.05,6817,95,569418,83.51686711645644,6
0.05,6818,22,569440,83.50784572517965,10
0.05,6819,94,569534,83.50938416422288,8
0.05,6820,94,569628,83.5109221521771,7
0.05,6821,92,569720,83.51216652008209,9
0.05,6822,95,569815,83.51385021251649,6
0.05,6823,94,569909,83.51538686987104,7
0.05,6824,26,569935,83.5069597069597,6
0.05,6825,93,570028,83.50835042484617,8
0.05,6826,94,570122,83.50988721253844,8
0.05,6827,91,570213,83.5109841827768,10
0.05,6828,92,570305,83.51222726607116,10
0.05,6829,94,570399,83.51376281112738,7
0.05,6830,94,570493,83.51529790660226,8
0.05,6831,25,570518,83.50673302107728,8
0.05,6832,91,570609,83.50782965022684,10
0.05,6833,84,570693,83.50790166812993,17
0.05,6834,27,570720,83.4996342355523,6
0.05,6835,89,570809,83.50043885313049,12
0.05,6836,92,570901,83.50168202427966,9
0.05,6837,93,570994,83.50307107341328,8
0.05,6838,92,571086,83.50431349612516,9
0.05,6839,94,571180,83.50584795321637,7
0.05,6840,94,571274,83.50738196170151,7
0.05,6841,86,571360,83.50774627301959,15
0.05,6842,96,571456,83.50957182522285,6
0.05,6843,95,571551,83.51125073056691,6
0.05,6844,93,571644,83.51263696128561,9
0.05,6845,94,571738,83.51416885772714,7
0.05,6846,94,571832,83.51570030670366,7
0.05,6847,95,571927,83.5173773364486,6
0.05,6848,94,572021,83.518907869762,7
0.05,6849,24,572045,83.51021897810219,8
0.05,6850,91,572136,83.51131221719457,10
0.05,6851,27,572163,83.50306479859896,6
0.05,6852,95,572258,83.50474244856267,6
0.05,6853,96,572354,83.50656550919172,6
0.05,6854,95,572449,83.50824215900802,6
0.05,6855,24,572473,83.49956242707118,8
0.05,6856,95,572568,83.50123960915852,6
0.05,6857,94,572662,83.50277048702246,7
0.05,6858,27,572689,83.49453273071876,6
0.05,6859,92,572781,83.49577259475218,9
0.05,6860,94,572875,83.4973036000583,7
0.05,6861,94,572969,83.49883415913727,7
0.05,6862,94,573063,83.50036427218417,7
0.05,6863,26,573089,83.49198717948718,6
0.05,6864,95,573184,83.49366351056082,6
0.05,6865,93,573277,83.49504806291873,8
0.05,6866,96,573373,83.49686908402505,6
0.05,6867,94,573467,83.49839836924869,7
0.05,6868,26,573493,83.49002766050371,6
0.05,6869,94,573587,83.49155749636098,9
0.05,6870,25,573612,83.48304468054141,7
0.05,6871,94,573706,83.48457508731083,8
0.05,6872,26,573732,83.47621126145788,8
0.05,6873,94,573826,83.47774221704975,7
0.05,6874,23,573849,83.46894545454545,9
0.05,6875,92,573941,83.47018615474113,9
0.05,6876,92,574033,83.4714264941108,9
0.05,6877,93,574126,83.47281186391393,8
0.05,6878,91,574217,83.4739060910016,10
0.05,6879,93,574310,83.47529069767442,9
0.05,6880,91,574401,83.4763842464758,10
0.05,6881,94,574495,83.47791339726824,7
0.05,6882,91,574586,83.47900624727589,11
0.05,6883,94,574680,83.48053457292272,7
0.05,6884,90,574770,83.48148148148148,11
0.05,6885,94,574864,83.48300900377578,7
0.05,6886,92,574956,83.48424568026716,9
0.05,6887,95,575051,83.4859175377468,6
0.05,6888,92,575143,83.48715343300914,9
0.05,6889,94,575237,83.48867924528302,7
0.05,6890,94,575331,83.49020461471484,7
0.05,6891,95,575426,83.4918746372606,6
0.05,6892,93,575519,83.4932540258233,8
0.05,6893,92,575611,83.4944879605454,9
0.05,6894,95,575706,83.49615663524293,6
0.05,6895,23,575729,83.48738399071925,9
0.05,6896,96,575825,83.48919820211687,6
0.05,6897,94,575919,83.49072194839084,7
0.05,6898,96,576015,83.49253515002174,6
0.05,6899,90,576105,83.49347826086957,11
0.05,6900,93,576198,83.49485581799739,8
0.05,6901,96,576294,83.49666763257027,6
0.05,6902,92,576386,83.49789946400116,9
0.05,6903,25,576411,83.48942641946698,7
0.05,6904,94,576505,83.49094858797973,7
0.05,6905,94,576599,83.49247031566753,7
0.05,6906,96,576695,83.49428116403648,6
0.05,6907,96,576791,83.49609148812971,6
0.05,6908,94,576885,83.49761181068172,7
0.05,6909,94,576979,83.49913169319827,7
0.05,6910,22,577001,83.49023296194473,10
0.05,6911,95,577096,83.49189814814815,6
0.05,6912,94,577190,83.49341819759873,7
0.05,6913,94,577284,83.49493780734741,7
0.05,6914,95,577379,83.49660159074476,6
0.05,6915,94,577473,83.49812030075188,7
0.05,6916,95,577568,83.49978314298106,6
0.05,6917,23,577591,83.4910378722174,9
0.05,6918,95,577686,83.49270125740713,6
0.05,6919,23,577709,83.48395953757226,9
0.05,6920,91,577800,83.4850455136541,10
0.05,6921,96,577896,83.48685351054608,6
0.05,6922,94,577990,83.48837209302326,7
0.05,6923,91,578081,83.48945696129405,10
0.05,6924,96,578177,83.49126353790614,6
0.05,6925,25,578202,83.48281836557898,7
0.05,6926,94,578296,83.48433665367403,7
0.05,6927,94,578390,83.4858545034642,8
0.05,6928,23,578413,83.47712512628085,9
0.05,6929,94,578507,83.47864357864358,7
0.05,6930,95,578602,83.48030587216851,6
0.05,6931,93,578695,83.48167916907097,9
0.05,6932,26,578721,83.47338814366076,7
0.05,6933,23,578744,83.46466685895587,9
0.05,6934,94,578838,83.46618601297764,7
0.05,6935,96,578934,83.46799307958477,6
0.05,6936,23,578957,83.45927634424103,11
0.05,6937,90,579047,83.46021908330931,11
0.05,6938,21,579068,83.4512177547197,11
0.05,6939,93,579161,83.45259365994237,9
0.05,6940,94,579255,83.45411324016712,7
0.05,6941,94,579349,83.45563238259868,7
0.05,6942,95,579444,83.45729511738442,6
0.05,6943,94,579538,83.4588133640553,7
0.05,6944,94,579632,83.46033117350612,8
0.05,6945,93,579725,83.46170457817449,8
0.05,6946,95,579820,83.4633654815028,6
0.05,6947,93,579913,83.4647380541163,8
0.05,6948,95,580008,83.46639804288387,6
0.05,6949,94,580102,83.46791366906474,7
0.05,6950,92,580194,83.46914113077256,9
0.05,6951,95,580289,83.4707997698504,6
0.05,6952,93,580382,83.47217028620739,8
0.05,6953,94,580476,83.47368421052632,7
0.05,6954,93,580569,83.47505391804457,8
0.05,6955,95,580664,83.47671075330649,6
0.05,6956,95,580759,83.47836711226103,6
0.05,6957,94,580853,83.47987927565393,7
0.05,6958,96,580949,83.48167840206926,6
0.05,6959,94,581043,83.48318965517241,7
0.05,6960,94,581137,83.48470047406981,7
0.05,6961,92,581229,83.48592358517668,9
0.05,6962,95,581324,83.48757719373833,6
0.05,6963,94,581418,83.48908673176335,7
0.05,6964,22,581440,83.4802584350323,13
0.05,6965,94,581534,83.48176859029572,7
0.05,6966,18,581552,83.4723697430745,15
0.05,6967,95,581647,83.47402411021814,6
0.05,6968,94,581741,83.47553450997273,7
0.05,6969,96,581837,83.47733142037303,6
0.05,6970,96,581933,83.47912781523455,6
0.05,6971,95,582028,83.48078026391279,6
0.05,6972,94,582122,83.48228882833787,7
0.05,6973,94,582216,83.48379696013765,7
0.05,6974,88,582304,83.48444444444445,13
0.05,6975,95,582399,83.48609518348624,6
0.05,6976,96,582495,83.4878887774115,6
0.05,6977,94,582589,83.48939524218974,7
0.05,6978,24,582613,83.48087118498353,9
0.05,6979,23,582636,83.47220630372493,9
0.05,6980,25,582661,83.4638303967913,7
0.05,6981,95,582756,83.46548266972215,6
0.05,6982,95,582851,83.46713446942574,6
0.05,6983,94,582945,83.46864261168385,7
0.05,6984,93,583038,83.47000715819614,8
0.05,6985,96,583134,83.47180074434583,6
0.05,6986,94,583228,83.47330757120366,7
0.05,6987,93,583321,83.47467086433886,10
0.05,6988,95,583416,83.47631993132065,6
0.05,6989,94,583510,83.47782546494993,7
0.05,6990,95,583605,83.47947360892576,6
0.05,6991,94,583699,83.48097826086956,8
0.05,6992,93,583792,83.48233948233948,9
0.05,6993,96,583888,83.48412925364599,6
0.05,6994,93,583981,83.4854896354539,8
0.05,6995,96,584077,83.48727844482562,6
0.05,6996,23,584100,83.4786337001572,10
0.05,6997,21,584121,83.46970563018004,11
0.05,6998,90,584211,83.47063866266609,11
0.05,6999,95,584306,83.47228571428572,6
0.05,7000,94,584400,83.47378945864877,7
0.05,7001,96,584496,83.47557840616966,7
0.05,7002,26,584522,83.46737112666,6
0.05,7003,95,584617,83.46901770416905,6
0.05,7004,93,584710,83.47037830121342,9
0.05,7005,92,584802,83.47159577504996,9
0.05,7006,21,584823,83.46268017696589,12
0.05,7007,96,584919,83.4644691780822,6
0.05,7008,96,585015,83.46625766871166,6
0.05,7009,95,585110,83.4679029957204,6
0.05,7010,96,585206,83.46969048637855,6
0.05,7011,25,585231,83.46135196805476,7
0.05,7012,95,585326,83.46299729074576,6
0.05,7013,96,585422,83.46478471628173,6
0.05,7014,94,585516,83.46628652886672,7
0.05,7015,93,585609,83.46764538198404,9
0.05,7016,94,585703,83.4691463588428,7
0.05,7017,96,585799,83.47093188942719,6
0.05,7018,93,585892,83.47228949992876,8
0.05,7019,91,585983,83.47336182336183,10
0.05,7020,94,586077,83.47486113089303,8
0.05,7021,92,586169,83.47607519225292,10
0.05,7022,25,586194,83.46774882528834,8
0.05,7023,23,586217,83.45914009111617,9
0.05,7024,94,586311,83.46064056939501,7
0.05,7025,94,586405,83.46214062055223,7
0.05,7026,95,586500,83.46378255300982,6
0.05,7027,92,586592,83.46499715424018,9
0.05,7028,94,586686,83.46649594536919,8
0.05,7029,25,586711,83.45817923186344,9
0.05,7030,95,586806,83.45982079362821,8
0.05,7031,95,586901,83.46146188850967,6
0.05,7032,96,586997,83.46324470354045,6
0.05,7033,94,587091,83.46474267841911,7
0.05,7034,94,587185,83.46624022743426,7
0.05,7035,94,587279,83.46773735076748,7
0.05,7036,95,587374,83.46937615461134,6
0.05,7037,95,587469,83.47101449275362,6
0.05,7038,95,587564,83.47265236539282,8
0.05,7039,94,587658,83.47414772727272,7
0.05,7040,92,587750,83.47535861383327,9
0.05,7041,95,587845,83.47699517182619,6
0.05,7042,96,587941,83.4787732500355,6
0.05,7043,96,588037,83.4805508233958,6
0.05,7044,92,588129,83.48176011355571,9
0.05,7045,94,588223,83.48325290945218,7
0.05,7046,94,588317,83.48474528168015,7
0.05,7047,95,588412,83.48637911464245,6
0.05,7048,94,588506,83.4878706199461,7
0.05,7049,94,588600,83.48936170212765,7
0.05,7050,94,588694,83.49085236136719,7
0.05,7051,94,588788,83.49234259784458,7
0.05,7052,94,588882,83.49383241173969,7
0.05,7053,23,588905,83.48525659200453,9
0.05,7054,92,588997,83.48646350106307,9
0.05,7055,94,589091,83.48795351473923,7
0.05,7056,25,589116,83.4796655802749,8
0.05,7057,96,589212,83.48143950127515,6
0.05,7058,94,589306,83.48292959342683,7
0.05,7059,93,589399,83.4842776203966,8
0.05,7060,93,589492,83.48562526554312,9
0.05,7061,94,589586,83.48711413197394,7
0.05,7062,95,589681,83.4887441597055,6
0.05,7063,96,589777,83.49051528878822,6
0.05,7064,20,589797,83.48152866242039,12
0.05,7065,23,589820,83.47296914803283,9
0.05,7066,93,589913,83.47431724918636,8
0.05,7067,94,590007,83.4758064516129,7
0.05,7068,92,590099,83.47701230725704,9
0.05,7069,92,590191,83.47821782178218,9
0.05,7070,91,590282,83.47928157262056,10
0.05,7071,93,590375,83.4806278280543,8
0.05,7072,96,590471,83.48239785098261,6
0.05,7073,89,590560,83.48317783432287,12
0.05,7074,94,590654,83.48466431095406,7
0.05,7075,96,590750,83.4864330130017,6
0.05,7076,96,590846,83.48820121520419,6
0.05,7077,93,590939,83.4895450692286,8
0.05,7078,94,591033,83.49102980646984,7
0.05,7079,91,591124,83.49209039548023,11
0.05,7080,95,591219,83.49371557689592,6
0.05,7081,94,591313,83.49519909630048,10
0.05,7082,96,591409,83.49696456303826,6
0.05,7083,92,591501,83.49816487859967,9
0.05,7084,94,591595,83.49964714184898,7
0.05,7085,94,591689,83.5011289867344,9
0.05,7086,92,591781,83.50232820657541,9
0.05,7087,95,591876,83.50395033860045,6
0.05,7088,93,591969,83.50528988573846,8
0.05,7089,93,592062,83.50662905500705,8
0.05,7090,88,592150,83.50726272740093,13
0.05,7091,95,592245,83.50888324873097,6
0.05,7092,94,592339,83.51036232905682,7
0.05,7093,24,592363,83.50197349873132,8
0.05,7094,94,592457,83.50345313601127,8
0.05,7095,96,592553,83.50521420518602,6
0.05,7096,23,592576,83.49668874172185,9
0.05,7097,94,592670,83.4981684981685,8
0.05,7098,96,592766,83.49992956754473,6
0.05,7099,95,592861,83.50154929577465,7
0.05,7100,96,592957,83.50330939304324,6
0.05,7101,93,593050,83.5046465784286,8
0.05,7102,-46,593004,83.48641419118682,10
0.05,7103,93,593097,83.48775337837837,9
0.05,7104,94,593191,83.48923293455313,7
0.05,7105,95,593286,83.49085280045033,7
0.05,7106,94,593380,83.49233150415084,8
0.05,7107,92,593472,83.49352841868317,9
0.05,7108,94,593566,83.49500633000422,7
0.05,7109,26,593592,83.48691983122363,7
0.05,7110,94,593686,83.48839825622275,7
0.05,7111,93,593779,83.48973565804275,8
0.05,7112,94,593873,83.49121327147476,7
0.05,7113,95,593968,83.49283103739106,6
0.05,7114,94,594062,83.49430780042164,7
0.05,7115,94,594156,83.49578414839797,8
0.05,7116,96,594252,83.49754109877757,7
0.05,7117,93,594345,83.49887608878899,8
0.05,7118,26,594371,83.49079926956033,6
0.05,7119,21,594392,83.48202247191011,11
0.05,7120,27,594419,83.47409071759584,6
0.05,7121,23,594442,83.46559955068801,9
0.05,7122,-48,594394,83.4471430577004,11
0.05,7123,92,594486,83.44834362717575,9
0.05,7124,24,594510,83.44,8
0.05,7125,94,594604,83.44148189727757,7
0.05,7126,96,594700,83.44324400168374,6
0.05,7127,96,594796,83.44500561167227,6
0.05,7128,94,594890,83.4464861831954,7
0.05,7129,27,594917,83.43856942496494,6
0.05,7130,94,595011,83.44005048380312,8
0.05,7131,94,595105,83.44153112731351,7
0.05,7132,23,595128,83.43305761951493,9
0.05,7133,93,595221,83.43439865433137,8
0.05,7134,95,595316,83.43601962158374,6
0.05,7135,95,595411,83.43764013452915,7
0.05,7136,23,595434,83.4291719209752,10
0.05,7137,-46,595388,83.41103950686467,10
0.05,7138,92,595480,83.41224261100994,9
0.05,7139,17,595497,83.40294117647059,16
0.05,7140,96,595593,83.40470522335808,6
0.05,7141,94,595687,83.40618874264912,7
0.05,7142,96,595783,83.40795184096318,6
0.05,7143,96,595879,83.40971444568869,6
0.05,7144,94,595973,83.41119664100769,7
0.05,7145,92,596065,83.41239854464035,9
0.05,7146,95,596160,83.41401986847629,7
0.05,7147,94,596254,83.41550083939563,7
0.05,7148,94,596348,83.41698139599944,7
0.05,7149,94,596442,83.41846153846154,7
0.05,7150,92,596534,83.4196615857922,9
0.05,7151,92,596626,83.42086129753915,9
0.05,7152,92,596718,83.42206067384315,10
0.05,7153,94,596812,83.42353927872519,7
0.05,7154,95,596907,83.42515723270441,7
0.05,7155,90,596997,83.42607602012298,11
0.05,7156,22,597019,83.41749336314098,10
0.05,7157,95,597114,83.41911148365465,6
0.05,7158,94,597208,83.42058946780277,7
0.05,7159,25,597233,83.41243016759776,8
0.05,7160,95,597328,83.41404831727412,6
0.05,7161,94,597422,83.41552638927674,7
0.05,7162,96,597518,83.41728326120341,6
0.05,7163,95,597613,83.41890005583473,6
0.05,7164,94,597707,83.42037683182136,7
0.05,7165,93,597800,83.42171364778119,8
0.05,7166,94,597894,83.42318961908748,7
0.05,7167,94,597988,83.42466517857143,7
0.05,7168,94,598082,83.42614032640536,8
0.05,7169,93,598175,83.42747559274756,8
0.05,7170,91,598266,83.42853158555292,10
0.05,7171,94,598360,83.43000557724484,7
0.05,7172,94,598454,83.43147915795343,7
0.05,7173,92,598546,83.43267354335099,9
0.05,7174,95,598641,83.43428571428572,6
0.05,7175,94,598735,83.43575808249722,7
0.05,7176,95,598830,83.43736937439041,7
0.05,7177,93,598923,83.43870158818612,9
0.05,7178,96,599019,83.44045131633932,6
0.05,7179,24,599043,83.43217270194987,8
0.05,7180,93,599136,83.43350508285754,9
0.05,7181,94,599230,83.43497632971317,7
0.05,7182,94,599324,83.4364471669219,7
0.05,7183,96,599420,83.43819599109132,6
0.05,7184,96,599516,83.43994432846208,6
0.05,7185,23,599539,83.43153353743389,9
0.05,7186,95,599634,83.4331431751774,7
0.05,7187,93,599727,83.43447412353923,8
0.05,7188,92,599819,83.43566560022256,9
0.05,7189,95,599914,83.43727399165508,8
0.05,7190,96,600010,83.43902099847031,6
0.05,7191,91,600101,83.44007230255839,10
0.05,7192,96,600197,83.44181843458918,6
0.05,7193,94,600291,83.44328607172643,7
0.05,7194,94,600385,83.4447533009034,7
0.05,7195,94,600479,83.44622012229016,7
0.05,7196,94,600573,83.4476865360567,7
0.05,7197,93,600666,83.44901361489302,8
0.05,7198,92,600758,83.45020141686345,9
0.05,7199,93,600851,83.45152777777778,8
0.05,7200,-46,600805,83.43355089570893,9
0.05,7201,95,600900,83.43515690086087,7
0.05,7202,26,600926,83.42718311814522,6
0.05,7203,94,601020,83.42865074958357,7
0.05,7204,95,601115,83.43025676613463,6
0.05,7205,93,601208,83.4315847904524,8
0.05,7206,94,601302,83.43305120022201,7
0.05,7207,91,601393,83.43410099889012,10
0.05,7208,23,601416,83.42571785268414,9
0.05,7209,23,601439,83.41733703190013,9
0.05,7210,93,601532,83.41866592705588,8
0.05,7211,94,601626,83.42013311148087,7
0.05,7212,25,601651,83.4120338278109,7
0.05,7213,92,601743,83.41322428611034,9
0.05,7214,96,601839,83.41496881496882,6
0.05,7215,94,601933,83.4164356984479,7
0.05,7216,26,601959,83.40847997783013,6
0.05,7217,92,602051,83.40967026877252,9
0.05,7218,96,602147,83.41141432331348,6
0.05,7219,26,602173,83.40346260387811,6
0.05,7220,96,602269,83.4052070350367,6
0.05,7221,95,602364,83.40681251730823,6
0.05,7222,95,602459,83.40841755503253,6
0.05,7223,91,602550,83.40946843853821,10
0.05,7224,94,602644,83.41093425605537,7
0.05,7225,95,602739,83.41253805701633,6
0.05,7226,92,602831,83.41372630413726,9
0.05,7227,94,602925,83.41519092418373,8
0.05,7228,94,603019,83.41665513902338,7
0.05,7229,96,603115,83.41839557399723,6
0.05,7230,91,603206,83.41944406029594,10
0.05,7231,94,603300,83.42090707964601,8
0.05,7232,27,603327,83.41310659477395,6
0.05,7233,93,603420,83.41443184959911,8
0.05,7234,94,603514,83.41589495507948,8
0.05,7235,94,603608,83.41735765616363,7
0.05,7236,24,603632,83.4091474367832,8
0.05,7237,94,603726,83.41061066592981,7
0.05,7238,94,603820,83.41207349081365,7
0.05,7239,23,603843,83.40372928176795,9
0.05,7240,95,603938,83.40533075542052,6
0.05,7241,95,604033,83.40693178679922,6
0.05,7242,23,604056,83.39859174375259,9
0.05,7243,94,604150,83.40005521811155,7
0.05,7244,92,604242,83.40124223602484,9
0.05,7245,94,604336,83.40270494065692,7
0.05,7246,94,604430,83.40416724161722,8
0.05,7247,27,604457,83.39638520971303,6
0.05,7248,94,604551,83.3978479790316,7
0.05,7249,95,604646,83.39944827586207,6
0.05,7250,90,604736,83.40035857123155,11
0.05,7251,95,604831,83.40195808052951,6
0.05,7252,94,604925,83.40341927478285,8
0.05,7253,96,605021,83.40515577612352,6
0.05,7254,94,605115,83.4066161268091,7
0.05,7255,92,605207,83.40780044101433,9
0.05,7256,95,605302,83.40939782279179,6
0.05,7257,94,605396,83.41085698539543,7
0.05,7258,95,605491,83.41245350599256,6
0.05,7259,23,605514,83.40413223140496,9
0.05,7260,95,605609,83.40572923839692,7
0.05,7261,24,605633,83.39754888460479,8
0.05,7262,25,605658,83.38950846757538,8
0.05,7263,91,605749,83.39055616740089,10
0.05,7264,91,605840,83.39160357880247,10
0.05,7265,90,605930,83.39251307459399,11
0.05,7266,94,606024,83.39397275354341,8
0.05,7267,94,606118,83.39543203082003,7
0.05,7268,93,606211,83.39675333608474,8
0.05,7269,95,606306,83.39834938101788,8
0.05,7270,96,606402,83.4000825195984,6
0.05,7271,94,606496,83.40154015401541,7
0.05,7272,94,606590,83.40299738759796,7
0.05,7273,96,606686,83.40472917239484,6
0.05,7274,94,606780,83.40618556701031,7
0.05,7275,95,606875,83.40777899945024,6
0.05,7276,96,606971,83.40950941321974,6
0.05,7277,94,607065,83.41096455070074,7
0.05,7278,94,607159,83.4124192883638,8
0.05,7279,96,607255,83.41414835164835,6
0.05,7280,96,607351,83.41587693998078,6
0.05,7281,92,607443,83.41705575391376,9
0.05,7282,94,607537,83.41850885624056,7
0.05,7283,92,607629,83.41968698517299,9
0.05,7284,91,607720,83.42072752230611,10
0.05,7285,96,607816,83.42245402141093,6
0.05,7286,95,607911,83.42404281597365,7
0.05,7287,94,608005,83.42549396267837,7
0.05,7288,88,608093,83.42612155302511,13
0.05,7289,89,608182,83.42688614540467,13
0.05,7290,94,608276,83.4283363050336,7
0.05,7291,91,608367,83.42937465715853,10
0.05,7292,94,608461,83.4308240778829,7
0.05,7293,94,608555,83.43227310117905,7
0.05,7294,96,608651,83.43399588759424,6
0.05,7295,94,608745,83.43544407894737,8
0.05,7296,93,608838,83.43675483075236,10
0.05,7297,93,608931,83.43806522334886,8
0.05,7298,94,609025,83.4395122619537,7
0.05,7299,25,609050,83.43150684931507,8
0.05,7300,94,609144,83.43295438980961,7
0.05,7301,94,609238,83.43440153382635,7
0.05,7302,25,609263,83.42640010954402,7
0.05,7303,27,609290,83.41867469879519,6
0.05,7304,95,609385,83.42026009582477,6
0.05,7305,94,609479,83.42170818505338,8
0.05,7306,94,609573,83.42315587792528,8
0.05,7307,96,609669,83.42487684729063,6
0.05,7308,95,609764,83.42646052811602,6
0.05,7309,90,609854,83.42735978112175,12
0.05,7310,25,609879,83.41936807550266,8
0.05,7311,96,609975,83.4210886214442,6
0.05,7312,21,609996,83.4125529878299,12
0.05,7313,95,610091,83.41413727098715,6
0.05,7314,94,610185,83.41558441558442,7
0.05,7315,92,610277,83.4167577911427,9
0.05,7316,23,610300,83.40850075167418,9
0.05,7317,95,610395,83.41008472260181,6
0.05,7318,93,610488,83.41139499931684,8
0.05,7319,95,610583,83.4129781420765,6
0.05,7320,94,610677,83.41442425898101,8
0.05,7321,94,610771,83.41586998087953,7
0.05,7322,23,610794,83.40761982793937,10
0.05,7323,94,610888,83.40906608410704,7
0.05,7324,93,610981,83.41037542662116,8
0.05,7325,94,611075,83.41182091182091,7
0.05,7326,94,611169,83.41326600245667,7
0.05,7327,92,611261,83.41443777292577,9
0.05,7328,93,611354,83.41574566789467,8
0.05,7329,95,611449,83.41732605729877,6
0.05,7330,95,611544,83.4189060155504,6
0.05,7331,95,611639,83.42048554282597,7
0.05,7332,95,611734,83.42206463930178,6
0.05,7333,96,611830,83.42377965639487,6
0.05,7334,90,611920,83.42467620995228,11
0.05,7335,94,612014,83.42611777535441,7
0.05,7336,94,612108,83.42755894779883,7
0.05,7337,95,612203,83.42913600436086,6
0.05,7338,94,612297,83.43057637280283,7
0.05,7339,94,612391,83.43201634877384,7
0.05,7340,96,612487,83.4337283748808,6
0.05,7341,94,612581,83.43516752928358,7
0.05,7342,22,612603,83.42680103499931,11
0.05,7343,94,612697,83.42824074074075,8
0.05,7344,93,612790,83.42954390742001,8
0.05,7345,95,612885,83.43111897631364,6
0.05,7346,96,612981,83.43282972641894,6
0.05,7347,90,613071,83.43372346216658,13
0.05,7348,94,613165,83.43516124642808,7
0.05,7349,92,613257,83.43632653061225,9
0.05,7350,95,613352,83.43789960549586,6
0.05,7351,94,613446,83.43933623503808,7
0.05,7352,26,613472,83.43152454780362,6
0.05,7353,94,613566,83.43296165352189,7
0.05,7354,90,613656,83.4338545207342,11
0.05,7355,95,613751,83.43542686242523,6
0.05,7356,92,613843,83.43659100176703,9
0.05,7357,96,613939,83.43829845066594,6
0.05,7358,94,614033,83.43973365946461,7
0.05,7359,96,614129,83.4414402173913,6
0.05,7360,22,614151,83.43309332971064,10
0.05,7361,94,614245,83.43452866069003,7
0.05,7362,90,614335,83.43542034496808,11
0.05,7363,95,614430,83.4369907658881,6
0.05,7364,94,614524,83.43842498302783,7
0.05,7365,96,614620,83.44013032853653,6
0.05,7366,25,614645,83.43219763811592,8
0.05,7367,92,614737,83.43336047774159,9
0.05,7368,96,614833,83.43506581625729,6
0.05,7369,94,614927,83.43649932157395,7
0.05,7370,96,615023,83.4382037715371,6
0.05,7371,91,615114,83.4392295170917,10
0.05,7372,94,615208,83.44066187440662,7
0.05,7373,-51,615157,83.4224301600217,14
0.05,7374,95,615252,83.424,6
0.05,7375,96,615348,83.42570498915401,6
0.05,7376,92,615440,83.42686729022638,9
0.05,7377,96,615536,83.42857142857143,6
0.05,7378,95,615631,83.43013958530966,7
0.05,7379,18,615649,83.42127371273713,16
0.05,7380,25,615674,83.41335862349275,8
0.05,7381,95,615769,83.41492820373882,6
0.05,7382,96,615865,83.41663280509277,6
0.05,7383,93,615958,83.4179306608884,8
0.05,7384,93,616051,83.41922816519973,8
0.05,7385,93,616144,83.42052531816951,8
0.05,7386,93,616237,83.42182211994043,10
0.05,7387,95,616332,83.42338927991338,6
0.05,7388,95,616427,83.42495601569901,6
0.05,7389,93,616520,83.42625169147496,8
0.05,7390,95,616615,83.42781761601948,6
0.05,7391,92,616707,83.42897727272727,9
0.05,7392,89,616796,83.42973082645746,12
0.05,7393,21,616817,83.42128753043008,11
0.05,7394,91,616908,83.42231237322515,10
0.05,7395,93,617001,83.4236073553272,8
0.05,7396,95,617096,83.42517236717588,6
0.05,7397,90,617186,83.42606109759394,11
0.05,7398,94,617280,83.42749020137856,7
0.05,7399,94,617374,83.42891891891892,7
0.05,7400,94,617468,83.43034725037157,7
0.05,7401,95,617563,83.43191029451499,6
0.05,7402,92,617655,83.43306767526678,9
0.05,7403,92,617747,83.43422474338196,9
0.05,7404,94,617841,83.4356515867657,7
0.05,7405,95,617936,83.4372130704834,6
0.05,7406,25,617961,83.4293236127987,7
0.05,7407,93,618054,83.43061555075595,8
0.05,7408,95,618149,83.43217708192739,6
0.05,7409,94,618243,83.4336032388664,7
0.05,7410,92,618335,83.43475914181622,9
0.05,7411,95,618430,83.4363194819212,8
0.05,7412,94,618524,83.43774450290032,7
0.05,7413,92,618616,83.4388993795522,9
0.05,7414,-49,618567,83.4210384356035,12
0.05,7415,94,618661,83.42246494066882,8
0.05,7416,94,618755,83.4238910610759,7
0.05,7417,22,618777,83.41561067673227,10
0.05,7418,94,618871,83.41703733656827,7
0.05,7419,23,618894,83.4088948787062,9
0.05,7420,96,618990,83.41059156447918,6
0.05,7421,92,619082,83.41174885475613,10
0.05,7422,95,619177,83.41330998248687,6
0.05,7423,19,619196,83.40463362068965,13
0.05,7424,94,619290,83.4060606060606,7
0.05,7425,24,619314,83.39806086722326,9
0.05,7426,95,619409,83.39962299717249,6
0.05,7427,95,619504,83.40118470651589,6
0.05,7428,92,619596,83.40234217256696,9
0.05,7429,93,619689,83.40363391655451,8
0.05,7430,23,619712,83.3955053155699,9
0.05,7431,95,619807,83.39706673842842,6
0.05,7432,91,619898,83.39808960043051,10
0.05,7433,96,619994,83.39978477266612,6
0.05,7434,94,620088,83.40121049092131,7
0.05,7435,23,620111,83.39308768154922,9
0.05,7436,95,620206,83.39464837972301,6
0.05,7437,94,620300,83.39607421349825,7
0.05,7438,91,620391,83.39709638392257,10
0.05,7439,92,620483,83.39825268817204,9
0.05,7440,93,620576,83.39954307216772,8
0.05,7441,93,620669,83.40083310937919,9
0.05,7442,95,620764,83.40239150880022,6
0.05,7443,94,620858,83.40381515314347,7
0.05,7444,92,620950,83.40496977837475,9
0.05,7445,95,621045,83.40652699435938,6
0.05,7446,94,621139,83.40794950986975,7
0.05,7447,26,621165,83.40024167561762,6
0.05,7448,95,621260,83.4017988991811,6
0.05,7449,95,621355,83.40335570469799,6
0.05,7450,93,621448,83.40464367199034,8
0.05,7451,94,621542,83.40606548577563,7
0.05,7452,94,621636,83.40748691801959,7
0.05,7453,96,621732,83.40917628119131,6
0.05,7454,96,621828,83.41086519114688,6
0.05,7455,96,621924,83.41255364806867,6
0.05,7456,94,622018,83.4139734477672,8
0.05,7457,93,622111,83.41525878251542,10
0.05,7458,94,622205,83.4166778388524,7
0.05,7459,95,622300,83.41823056300268,6
0.05,7460,94,622394,83.41964884063799,8
0.05,7461,94,622488,83.42106673813991,7
0.05,7462,95,622583,83.4226182500335,7
0.05,7463,94,622677,83.42403536977491,7
0.05,7464,94,622771,83.42545210984595,7
0.05,7465,24,622795,83.41749263327083,8
0.05,7466,94,622889,83.41890987009508,7
0.05,7467,93,622982,83.42019282271023,8
0.05,7468,96,623078,83.42187709198018,6
0.05,7469,93,623171,83.4231593038822,10
0.05,7470,94,623265,83.42457502342391,7
0.05,7471,90,623355,83.42545503211991,11
0.05,7472,95,623450,83.42700388063696,6
0.05,7473,94,623544,83.42841851752743,7
0.05,7474,25,623569,83.42060200668897,7
0.05,7475,93,623662,83.4218833600856,8
0.05,7476,94,623756,83.42329811421693,7
0.05,7477,94,623850,83.42471248997057,7
0.05,7478,89,623939,83.42545794892365,13
0.05,7479,94,624033,83.426871657754,7
0.05,7480,96,624129,83.42855233257586,6
0.05,7481,94,624223,83.42996524993318,8
0.05,7482,95,624318,83.4315114258987,7
0.05,7483,96,624414,83.43319080705506,6
0.05,7484,95,624509,83.43473613894456,6
0.05,7485,94,624603,83.4361474752872,7
0.05,7486,96,624699,83.43782556431147,6
0.05,7487,95,624794,83.43936965811966,8
0.05,7488,96,624890,83.44104686874083,6
0.05,7489,94,624984,83.44245660881175,7
0.05,7490,95,625079,83.4439994660259,6
0.05,7491,94,625173,83.4454084356647,7
0.05,7492,95,625268,83.44695048712131,6
0.05,7493,96,625364,83.44862556712036,6
0.05,7494,95,625459,83.4501667778519,6
0.05,7495,96,625555,83.45184098185699,6
0.05,7496,94,625649,83.45324796585301,7
0.05,7497,95,625744,83.45478794345159,6
0.05,7498,94,625838,83.45619415922123,7
0.05,7499,95,625933,83.45773333333334,6
0.05,7500,25,625958,83.44994000799893,7
0.05,7501,94,626052,83.45134630765129,7
0.05,7502,94,626146,83.45275223244036,7
0.05,7503,96,626242,83.45442430703625,6
0.05,7504,94,626336,83.45582944703531,7
0.05,7505,96,626432,83.45750066613375,6
0.05,7506,93,626525,83.45877181297456,8
0.05,7507,92,626617,83.45990942994139,9
0.05,7508,25,626642,83.45212411772539,7
0.05,7509,94,626736,83.45352862849533,7
0.05,7510,93,626829,83.45479962721342,9
0.05,7511,90,626919,83.45567092651757,12
0.05,7512,25,626944,83.44789032343937,7
0.05,7513,93,627037,83.44916156507853,9
0.05,7514,91,627128,83.45016633399867,10
0.05,7515,95,627223,83.45170303352847,7
0.05,7516,96,627319,83.45337235599308,6
0.05,7517,95,627414,83.45490822027135,6
0.05,7518,91,627505,83.45591169038435,10
0.05,7519,96,627601,83.45757978723404,6
0.05,7520,93,627694,83.45884855737269,9
0.05,7521,95,627789,83.46038287689444,6
0.05,7522,92,627881,83.46151801143161,10
0.05,7523,94,627975,83.46291866028709,7
0.05,7524,96,628071,83.46458471760798,6
0.05,7525,95,628166,83.46611745947382,6
0.05,7526,96,628262,83.4677826491298,6
0.05,7527,95,628357,83.4693145589798,6
0.05,7528,95,628452,83.47084606189401,6
0.05,7529,93,628545,83.47211155378486,8
0.05,7530,94,628639,83.47350949409109,7
0.05,7531,93,628732,83.47477429633564,8
0.05,7532,93,628825,83.47603876277711,8
0.05,7533,27,628852,83.46854260684896,6
0.05,7534,94,628946,83.4699402786994,8
0.05,7535,92,629038,83.47107218683652,9
0.05,7536,94,629132,83.47246915218257,8
0.05,7537,94,629226,83.47386574688247,7
0.05,7538,92,629318,83.47499668391033,9
0.05,7539,90,629408,83.47586206896551,11
0.05,7540,94,629502,83.47725765813553,7
0.05,7541,90,629592,83.47812251392203,11
0.05,7542,93,629685,83.47938486013523,8
0.05,7543,94,629779,83.4807794273595,7
0.05,7544,94,629873,83.48217362491717,7
0.05,7545,95,629968,83.48369997349589,7
0.05,7546,94,630062,83.48509341460183,7
0.05,7547,94,630156,83.48648648648648,7
0.05,7548,95,630251,83.48801165717313,6
0.05,7549,96,630347,83.48966887417218,6
0.05,7550,91,630438,83.4906634882797,10
0.05,7551,94,630532,83.49205508474576,7
0.05,7552,95,630627,83.49357871044619,6
0.05,7553,96,630723,83.49523431294678,6
0.05,7554,94,630817,83.49662475182,7
0.05,7555,96,630913,83.49827951296983,6
0.05,7556,94,631007,83.49966918089189,7
0.05,7557,94,631101,83.50105848107965,7
0.05,7558,92,631193,83.50218282841645,9
0.05,7559,95,631288,83.5037037037037,7
0.05,7560,95,631383,83.5052241766962,6
0.05,7561,-50,631333,83.48756942607775,13
0.05,7562,92,631425,83.48869496231654,9
0.05,7563,94,631519,83.49008461131676,8
0.05,7564,94,631613,83.49147389292796,7
0.05,7565,94,631707,83.4928628072958,7
0.05,7566,26,631733,83.48526496630105,7
0.05,7567,93,631826,83.4865221987315,8
0.05,7568,25,631851,83.478795085216,7
0.05,7569,94,631945,83.48018494055482,8
0.05,7570,94,632039,83.48157442874125,7
0.05,7571,92,632131,83.48269941891178,9
0.05,7572,96,632227,83.48435230423874,6
0.05,7573,95,632322,83.48587272247161,6
0.05,7574,94,632416,83.4872607260726,7
0.05,7575,94,632510,83.48864836325238,7
0.05,7576,95,632605,83.49016761251154,8
0.05,7577,89,632694,83.49089469517023,12
0.05,7578,96,632790,83.4925451906584,6
0.05,7579,95,632885,83.49406332453826,7
0.05,7580,94,632979,83.49544914918876,8
0.05,7581,95,633074,83.49696649960433,6
0.05,7582,95,633169,83.49848344982198,6
0.05,7583,94,633263,83.49986814345992,7
0.05,7584,21,633284,83.49162821357943,11
0.05,7585,94,633378,83.49301344582125,7
0.05,7586,95,633473,83.49453011730591,7
0.05,7587,93,633566,83.49578281497101,8
0.05,7588,92,633658,83.49690341283437,10
0.05,7589,94,633752,83.49828722002636,7
0.05,7590,95,633847,83.49980239757608,6
0.05,7591,91,633938,83.50079030558483,10
0.05,7592,94,634032,83.5021730541288,7
0.05,7593,92,634124,83.50329207268896,9
0.05,7594,95,634219,83.50480579328506,7
0.05,7595,95,634314,83.50631911532385,6
0.05,7596,93,634407,83.50756877714888,8
0.05,7597,94,634501,83.50894972361148,7
0.05,7598,96,634597,83.51059349914462,6
0.05,7599,93,634690,83.51184210526316,8
0.05,7600,95,634785,83.51335350611761,6
0.05,7601,91,634876,83.51433833201789,10
0.05,7602,94,634970,83.51571747994213,7
0.05,7603,93,635063,83.5169647553919,8
0.05,7604,25,635088,83.50927021696252,7
0.05,7605,94,635182,83.51064948724691,7
0.05,7606,93,635275,83.51189693703168,9
0.05,7607,96,635371,83.51353838065195,6
0.05,7608,94,635465,83.5149165461953,7
0.05,7609,95,635560,83.51642575558476,6
0.05,7610,22,635582,83.50834318749179,11
0.05,7611,94,635676,83.50972149238045,7
0.05,7612,96,635772,83.51136214370156,6
0.05,7613,24,635796,83.50354609929079,8
0.05,7614,95,635891,83.50505581089953,6
0.05,7615,95,635986,83.50656512605042,6
0.05,7616,94,636080,83.50794275961665,8
0.05,7617,92,636172,83.50905749540561,9
0.05,7618,23,636195,83.5011156319727,9
0.05,7619,95,636290,83.50262467191601,8
0.05,7620,93,636383,83.50387088308621,8
0.05,7621,27,636410,83.49645762267122,6
0.05,7622,95,636505,83.49796667978487,8
0.05,7623,93,636598,83.4992130115425,8
0.05,7624,92,636690,83.50032786885247,10
0.05,7625,92,636782,83.50144243377918,9
0.05,7626,92,636874,83.50255670643766,9
0.05,7627,92,636966,83.50367068694284,9
0.05,7628,94,637060,83.50504653296632,7
0.05,7629,94,637154,83.50642201834863,8
0.05,7630,25,637179,83.49875507797144,7
0.05,7631,95,637274,83.50026205450733,6
0.05,7632,23,637297,83.49233590986506,10
0.05,7633,95,637392,83.49384333246005,6
0.05,7634,94,637486,83.49521938441389,7
0.05,7635,95,637581,83.49672603457307,6
0.05,7636,94,637675,83.49810134869713,7
0.05,7637,93,637768,83.4993453783713,8
0.05,7638,94,637862,83.50071998952743,7
0.05,7639,94,637956,83.50209424083769,7
0.05,7640,94,638050,83.5034681324434,7
0.05,7641,23,638073,83.495550902905,9
0.05,7642,18,638091,83.4869815517467,14
0.05,7643,94,638185,83.48835688121403,7
0.05,7644,94,638279,83.48973185088293,7
0.05,7645,96,638375,83.49136803557415,6
0.05,7646,94,638469,83.49274225186348,7
0.05,7647,94,638563,83.49411610878661,7
0.05,7648,94,638657,83.49548960648451,7
0.05,7649,93,638750,83.49673202614379,10
0.05,7650,91,638841,83.49771271729186,10
0.05,7651,90,638931,83.4985624673288,11
0.05,7652,94,639025,83.499934666144,7
0.05,7653,92,639117,83.5010452051215,9
0.05,7654,94,639211,83.50241672109732,7
0.05,7655,91,639302,83.5033960292581,10
0.05,7656,93,639395,83.50463628052762,8
0.05,7657,96,639491,83.50626795507965,6
0.05,7658,92,639583,83.50737694215955,9
0.05,7659,95,639678,83.5088772845953,6
0.05,7660,90,639768,83.50972457903669,11
0.05,7661,91,639859,83.51070216653615,10
0.05,7662,93,639952,83.5119404932794,8
0.05,7663,92,640044,83.51304801670146,9
0.05,7664,95,640139,83.51454664057404,6
0.05,7665,95,640234,83.51604487346725,6
0.05,7666,92,640326,83.51715142819877,9
0.05,7667,93,640419,83.51838810641628,8
0.05,7668,94,640513,83.51975485721736,7
0.05,7669,93,640606,83.52099087353325,8
0.05,7670,95,640701,83.52248728979272,6
0.05,7671,94,640795,83.52385297184567,7
0.05,7672,94,640889,83.5252182979278,7
0.05,7673,24,640913,83.51746155850925,8
0.05,7674,93,641006,83.51869706840391,8
0.05,7675,96,641102,83.52032308494007,6
0.05,7676,92,641194,83.5214276410056,9
0.05,7677,93,641287,83.52266215160198,8
0.05,7678,96,641383,83.52428701653861,6
0.05,7679,94,641477,83.52565104166666,8
0.05,7680,94,641571,83.5270147116261,7
0.05,7681,96,641667,83.52863837542307,6
0.05,7682,92,641759,83.52974098659378,9
0.05,7683,94,641853,83.53110359187923,7
0.05,7684,94,641947,83.53246584255042,7
0.05,7685,94,642041,83.53382773874577,8
0.05,7686,95,642136,83.53531937036556,6
0.05,7687,95,642231,83.53681061394381,6
0.05,7688,92,642323,83.5379113018598,9
0.05,7689,95,642418,83.53940182054616,6
0.05,7690,94,642512,83.54076192952802,7
0.05,7691,90,642602,83.54160166406656,11
0.05,7692,94,642696,83.54296113349798,7
0.05,7693,95,642791,83.54445022095139,6
0.05,7694,94,642885,83.5458089668616,8
0.05,7695,94,642979,83.54716735966736,7
0.05,7696,95,643074,83.54865532025464,7
0.05,7697,94,643168,83.55001299038712,8
0.05,7698,94,643262,83.55137030783219,9
0.05,7699,93,643355,83.5525974025974,8
0.05,7700,96,643451,83.55421373847553,6
0.05,7701,92,643543,83.55531030901065,10
0.05,7702,94,643637,83.55666623393483,8
0.05,7703,96,643733,83.55828141225338,6
0.05,7704,91,643824,83.55924724205062,10
0.05,7705,92,643916,83.56034259018946,9
0.05,7706,84,644000,83.56039963669392,18
0.05,7707,94,644094,83.56175402179554,7
0.05,7708,94,644188,83.56310805551952,7
0.05,7709,94,644282,83.56446173800259,8
0.05,7710,94,644376,83.5658150693814,7
0.05,7711,93,644469,83.56703838174273,8
0.05,7712,93,644562,83.56826137689615,8
0.05,7713,93,644655,83.569484054965,9
0.05,7714,92,644747,83.57057679844459,9
0.05,7715,94,644841,83.57192846034215,7
0.05,7716,92,644933,83.57302060386161,9
0.05,7717,94,645027,83.57437159885981,7
0.05,7718,95,645122,83.57585179427387,6
0.05,7719,95,645217,83.57733160621761,6
0.05,7720,95,645312,83.57881103484004,6
0.05,7721,94,645406,83.58016058016058,8
0.05,7722,92,645498,83.58125080927101,9
0.05,7723,93,645591,83.58247022268255,9
0.05,7724,26,645617,83.57501618122977,6
0.05,7725,93,645710,83.57623608594356,8
0.05,7726,91,645801,83.57719684224149,10
0.05,7727,95,645896,83.57867494824016,6
0.05,7728,96,645992,83.58028205459956,6
0.05,7729,96,646088,83.58188874514877,6
0.05,7730,90,646178,83.58271892381322,12
0.05,7731,94,646272,83.5840662183135,7
0.05,7732,95,646367,83.58554248027933,7
0.05,7733,93,646460,83.58675976208947,9
0.05,7734,95,646555,83.58823529411765,6
0.05,7735,95,646650,83.58971044467425,6
0.05,7736,95,646745,83.5911852139072,8
0.05,7737,94,646839,83.59253036960455,7
0.05,7738,95,646934,83.59400439333247,6
0.05,7739,94,647028,83.5953488372093,7
0.05,7740,94,647122,83.59669293372949,8
0.05,7741,96,647218,83.59829501420822,6
0.05,7742,94,647312,83.59963838305566,7
0.05,7743,94,647406,83.60098140495867,7
0.05,7744,-54,647352,83.58321497740478,18
0.05,7745,92,647444,83.58430157500645,9
0.05,7746,23,647467,83.5764812185362,10
0.05,7747,94,647561,83.57782653588022,8
0.05,7748,95,647656,83.5793005549103,6
0.05,7749,94,647750,83.58064516129032,7
0.05,7750,94,647844,83.5819894207199,8
0.05,7751,91,647935,83.5829463364293,10
0.05,7752,95,648030,83.58441893460596,6
0.05,7753,95,648125,83.58589115295331,7
0.05,7754,95,648220,83.5873629916183,6
0.05,7755,94,648314,83.5887055183084,7
0.05,7756,95,648409,83.59017661467063,6
0.05,7757,94,648503,83.59151843258572,7
0.05,7758,96,648599,83.59311766980281,6
0.05,7759,90,648689,83.59394329896907,11
0.05,7760,95,648784,83.59541296224714,6
0.05,7761,90,648874,83.59623808296831,11
0.05,7762,96,648970,83.59783588818756,6
0.05,7763,95,649065,83.59930448222566,7
0.05,7764,94,649159,83.60064391500322,7
0.05,7765,94,649253,83.60198300283287,8
0.05,7766,96,649349,83.60357924552595,6
0.05,7767,94,649443,83.6049176107106,7
0.05,7768,94,649537,83.60625563135538,7
0.05,7769,95,649632,83.607722007722,6
0.05,7770,23,649655,83.59992278985973,9
0.05,7771,96,649751,83.60151827071539,6
0.05,7772,93,649844,83.60272738968223,8
0.05,7773,95,649939,83.60419346539747,6
0.05,7774,95,650034,83.60565916398714,6
0.05,7775,92,650126,83.60673868312757,9
0.05,7776,92,650218,83.60781792464961,10
0.05,7777,94,650312,83.60915402417073,7
0.05,7778,95,650407,83.61061833140506,7
0.05,7779,95,650502,83.61208226221079,7
0.05,7780,95,650597,83.61354581673307,6
0.05,7781,96,650693,83.61513749678745,6
0.05,7782,92,650785,83.61621482718746,9
0.05,7783,93,650878,83.61742034943474,8
0.05,7784,96,650974,83.61901091843288,6
0.05,7785,94,651068,83.62034420755202,7
0.05,7786,95,651163,83.62180557339155,6
0.05,7787,93,651256,83.62300975860298,8
0.05,7788,94,651350,83.62434202079857,7
0.05,7789,93,651443,83.62554557124518,9
0.05,7790,94,651537,83.62687716596072,7
0.05,7791,94,651631,83.62820841889118,7
0.05,7792,93,651724,83.62941100988066,8
0.05,7793,94,651818,83.63074159609957,7
0.05,7794,95,651913,83.63220012828737,6
0.05,7795,92,652005,83.6332734735762,9
0.05,7796,94,652099,83.63460305245607,7
0.05,7797,94,652193,83.63593229033086,7
0.05,7798,92,652285,83.63700474419798,9
0.05,7799,93,652378,83.63820512820513,8
0.05,7800,94,652472,83.63953339315472,7
0.05,7801,95,652567,83.64098948987439,8
0.05,7802,94,652661,83.64231705754197,7
0.05,7803,94,652755,83.64364428498206,7
0.05,7804,96,652851,83.64522741832158,6
0.05,7805,95,652946,83.64668203945683,6
0.05,7806,95,653041,83.64813628794671,6
0.05,7807,94,653135,83.64946209016394,7
0.05,7808,94,653229,83.65078755282366,8
0.05,7809,95,653324,83.65224071702944,6
0.05,7810,96,653420,83.65382153373447,6
0.05,7811,94,653514,83.65514592933948,7
0.05,7812,94,653608,83.65646998592091,7
0.05,7813,94,653702,83.6577937036089,8
0.05,7814,95,653797,83.65924504158669,8
0.05,7815,93,653890,83.66044012282498,8
0.05,7816,92,653982,83.66150697198414,9
0.05,7817,95,654077,83.66295727807623,6
0.05,7818,91,654168,83.66389563882849,10
0.05,7819,94,654262,83.66521739130435,7
0.05,7820,93,654355,83.66641094489196,8
0.05,7821,93,654448,83.66760419330095,8
0.05,7822,96,654544,83.66918062124505,6
0.05,7823,25,654569,83.66168200408998,7
0.05,7824,96,654665,83.66325878594249,6
0.05,7825,94,654759,83.66457960644007,7
0.05,7826,94,654853,83.665900089434,7
0.05,7827,94,654947,83.66722023505365,7
0.05,7828,95,655042,83.66866777366202,6
0.05,7829,95,655137,83.67011494252874,6
0.05,7830,91,655228,83.67105095134721,10
0.05,7831,95,655323,83.67249744637385,6
0.05,7832,93,655416,83.67368824205285,8
0.05,7833,96,655512,83.67526167985703,6
0.05,7834,94,655606,83.6765794511806,8
0.05,7835,93,655699,83.67776927003574,9
0.05,7836,90,655789,83.67857598570882,12
0.05,7837,95,655884,83.68002041337076,6
0.05,7838,91,655975,83.68095420334227,10
0.05,7839,93,656068,83.68214285714286,8
0.05,7840,96,656164,83.68371381201378,6
0.05,7841,90,656254,83.68451925529202,11
0.05,7842,94,656348,83.68583450210379,7
0.05,7843,95,656443,83.68727689954105,6
0.05,7844,93,656536,83.68846398980243,8
0.05,7845,26,656562,83.68111139434106,7
0.05,7846,95,656657,83.6825538422327,6
0.05,7847,94,656751,83.68386850152905,7
0.05,7848,94,656845,83.68518282583769,7
0.05,7849,25,656870,83.67770700636943,7
0.05,7850,96,656966,83.6792765252834,6
0.05,7851,94,657060,83.68059093224656,7
0.05,7852,95,657155,83.68203234432701,6
0.05,7853,27,657182,83.67481538069774,6
0.05,7854,95,657277,83.67625716104392,7
0.05,7855,93,657370,83.67744399185337,9
0.05,7856,95,657465,83.67888507063765,6
0.05,7857,93,657558,83.68007126495291,8
0.05,7858,94,657652,83.6813844000509,7
0.05,7859,89,657741,83.6820610687023,12
0.05,7860,92,657833,83.68311919603104,9
0.05,7861,95,657928,83.68455863647927,6
0.05,7862,24,657952,83.6769680783416,8
0.05,7863,95,658047,83.67840793489319,7
0.05,7864,95,658142,83.67984742530197,6
0.05,7865,94,658236,83.68115942028986,7
0.05,7866,14,658250,83.6723020211008,19
0.05,7867,96,658346,83.67386883579054,6
0.05,7868,-46,658300,83.65738975727538,9
0.05,7869,96,658396,83.658958068615,6
0.05,7870,95,658491,83.66039893279125,6
0.05,7871,27,658518,83.6532012195122,6
0.05,7872,94,658612,83.6545154324908,7
0.05,7873,94,658706,83.65582931165862,7
0.05,7874,95,658801,83.65726984126984,6
0.05,7875,94,658895,83.65858303707466,8
0.05,7876,22,658917,83.65075536371715,10
0.05,7877,96,659013,83.65232292460016,6
0.05,7878,96,659109,83.65389008757457,6
0.05,7879,94,659203,83.65520304568528,8
0.05,7880,91,659294,83.65613500824769,11
0.05,7881,25,659319,83.64869322506978,7
0.05,7882,27,659346,83.64150704046683,6
0.05,7883,94,659440,83.64282090309487,8
0.05,7884,27,659467,83.63563728598605,6
0.05,7885,94,659561,83.6369515597261,8
0.05,7886,95,659656,83.63839229111196,7
0.05,7887,-117,659539,83.61295638945234,11
0.05,7888,94,659633,83.61427303840792,7
0.05,7889,22,659655,83.60646387832699,10
0.05,7890,93,659748,83.60765428969712,8
0.05,7891,92,659840,83.60871768879878,9
0.05,7892,95,659935,83.61016090206512,6
0.05,7893,95,660030,83.6116037496833,6
0.05,7894,96,660126,83.61317289423685,6
0.05,7895,92,660218,83.61423505572442,9
0.05,7896,96,660314,83.61580346967203,6
0.05,7897,89,660403,83.61648518612307,13
0.05,7898,93,660496,83.61767312318015,8
0.05,7899,94,660590,83.61898734177215,7
0.05,7900,94,660684,83.62030122769269,7
0.05,7901,95,660779,83.62174133130853,6
0.05,7902,94,660873,83.62305453625206,7
0.05,7903,95,660968,83.6244939271255,6
0.05,7904,95,661063,83.62593295382669,6
0.05,7905,94,661157,83.6272451302808,7
0.05,7906,95,661252,83.6286834450487,6
0.05,7907,94,661346,83.62999494183106,7
0.05,7908,94,661440,83.63130610696675,7
0.05,7909,90,661530,83.63211125158028,11
0.05,7910,26,661556,83.62482619137909,8
0.05,7911,92,661648,83.62588473205258,9
0.05,7912,96,661744,83.6274485024643,6
0.05,7913,96,661840,83.62901187768512,6
0.05,7914,90,661930,83.6298168035376,11
0.05,7915,93,662023,83.6310005053057,8
0.05,7916,92,662115,83.63205759757484,9
0.05,7917,94,662209,83.63336701187168,7
0.05,7918,25,662234,83.62596287410027,8
0.05,7919,83,662317,83.62588383838384,18
0.05,7920,96,662413,83.62744602954173,6
0.05,7921,94,662507,83.62875536480686,7
0.05,7922,94,662601,83.63006436955699,7
0.05,7923,94,662695,83.63137304391721,7
0.05,7924,94,662789,83.63268138801261,8
0.05,7925,94,662883,83.63398940196821,7
0.05,7926,92,662975,83.63504478365081,10
0.05,7927,95,663070,83.63647830474268,6
0.05,7928,96,663166,83.63803758355404,6
0.05,7929,95,663261,83.63947036569988,6
0.05,7930,96,663357,83.64102887403858,6
0.05,7931,96,663453,83.64258698940999,6
0.05,7932,93,663546,83.6437665448128,8
0.05,7933,94,663640,83.6450718427023,7
0.05,7934,25,663665,83.6376811594203,7
0.05,7935,94,663759,83.6389868951613,7
0.05,7936,94,663853,83.64029230187728,8
0.05,7937,94,663947,83.64159737969261,7
0.05,7938,96,664043,83.64315404962842,6
0.05,7939,93,664136,83.64433249370278,8
0.05,7940,93,664229,83.64551064097721,8
0.05,7941,95,664324,83.64694031730043,6
0.05,7942,95,664419,83.64836963363969,6
0.05,7943,94,664513,83.64967270896274,7
0.05,7944,94,664607,83.6509754562618,7
0.05,7945,95,664702,83.65240372514472,6
0.05,7946,94,664796,83.65370580093116,7
0.05,7947,91,664887,83.65463009562154,10
0.05,7948,94,664981,83.65593156371871,7
0.05,7949,94,665075,83.65723270440252,7
0.05,7950,95,665170,83.65865928813986,6
0.05,7951,93,665263,83.65983400402415,9
0.05,7952,96,665359,83.66138564063876,6
0.05,7953,91,665450,83.66230827256726,10
0.05,7954,96,665546,83.66385920804525,6
0.05,7955,92,665638,83.6649069884364,9
0.05,7956,96,665734,83.66645720749025,6
0.05,7957,95,665829,83.66788137723046,6
0.05,7958,96,665925,83.66943083301922,6
0.05,7959,92,666017,83.67047738693468,9
0.05,7960,96,666113,83.67202612737093,6
0.05,7961,24,666137,83.66453152474253,8
0.05,7962,91,666228,83.66545271882457,11
0.05,7963,96,666324,83.66700150678051,6
0.05,7964,92,666416,83.66804770872568,9
0.05,7965,93,666509,83.66921918152147,10
0.05,7966,26,666535,83.66198067026484,6
0.05,7967,95,666630,83.66340361445783,7
0.05,7968,94,666724,83.66470071527168,7
0.05,7969,96,666820,83.66624843161857,6
0.05,7970,96,666916,83.66779575962866,6
0.05,7971,91,667007,83.66871550426492,10
0.05,7972,95,667102,83.67013671140097,7
0.05,7973,93,667195,83.67130674692751,9
0.05,7974,94,667289,83.67260188087775,7
0.05,7975,93,667382,83.67377131394183,8
0.05,7976,19,667401,83.66566378337721,13
0.05,7977,94,667495,83.66695913762848,7
0.05,7978,95,667590,83.66837949617747,6
0.05,7979,93,667683,83.66954887218046,8
0.05,7980,94,667777,83.67084325272522,7
0.05,7981,93,667870,83.67201202706089,8
0.05,7982,94,667964,83.67330577477139,7
0.05,7983,94,668058,83.67459919839679,8
0.05,7984,95,668153,83.67601753287414,6
0.05,7985,25,668178,83.66867017280241,7
0.05,7986,94,668272,83.66996369099788,7
0.05,7987,95,668367,83.67138207310967,6
0.05,7988,92,668459,83.67242458380272,9
0.05,7989,89,668548,83.67309136420526,13
0.05,7990,27,668575,83.6659992491553,6
0.05,7991,93,668668,83.66716716716716,8
0.05,7992,94,668762,83.66845990241461,7
0.05,7993,95,668857,83.66987740805604,8
0.05,7994,95,668952,83.67129455909944,7
0.05,7995,92,669044,83.67233616808404,9
0.05,7996,96,669140,83.67387770413906,6
0.05,7997,94,669234,83.67516879219805,7
0.05,7998,93,669327,83.67633454181772,8
0.05,7999,94,669421,83.677625,7
0.05,8000,25,669446,83.6702912135983,7
0.05,8001,94,669540,83.67158210447388,7
0.05,8002,92,669632,83.67262276646258,9
0.05,8003,94,669726,83.67391304347827,8
0.05,8004,94,669820,83.67520299812617,7
0.05,8005,92,669912,83.67624281788659,9
0.05,8006,-47,669865,83.65992256775321,10
0.05,8007,24,669889,83.65247252747253,8
0.05,8008,94,669983,83.65376451492071,7
0.05,8009,89,670072,83.65443196004993,13
0.05,8010,92,670164,83.65547372363001,9
0.05,8011,93,670257,83.65664003994009,8
0.05,8012,95,670352,83.65805565955323,6
0.05,8013,24,670376,83.65061142999751,8
0.05,8014,91,670467,83.65152838427947,10
0.05,8015,94,670561,83.65281936127745,7
0.05,8016,94,670655,83.65411001621554,7
0.05,8017,91,670746,83.65502619107009,10
0.05,8018,95,670841,83.65644095273726,6
0.05,8019,95,670936,83.657855361596,6
0.05,8020,94,671030,83.65914474504426,7
0.05,8021,96,671126,83.6606831214161,6
0.05,8022,24,671150,83.65324691511903,8
0.05,8023,93,671243,83.65441176470588,8
0.05,8024,94,671337,83.65570093457944,7
0.05,8025,92,671429,83.65674059307251,9
0.05,8026,94,671523,83.6580291516133,8
0.05,8027,94,671617,83.65931738913801,7
0.05,8028,93,671710,83.66048075725494,9
0.05,8029,93,671803,83.66164383561645,8
0.05,8030,94,671897,83.66293114182542,7
0.05,8031,94,671991,83.66421812749005,7
0.05,8032,27,672018,83.65716419768455,6
0.05,8033,96,672114,83.65870052277819,6
0.05,8034,94,672208,83.65998755444929,7
0.05,8035,94,672302,83.66127426580388,10
0.05,8036,94,672396,83.66256065696156,7
0.05,8037,96,672492,83.66409554615576,6
0.05,8038,25,672517,83.65679810921756,7
0.05,8039,94,672611,83.65808457711442,7
0.05,8040,22,672633,83.6504166148489,10
0.05,8041,95,672728,83.65182790350659,7
0.05,8042,96,672824,83.65336317294542,6
0.05,8043,95,672919,83.65477374440577,6
0.05,8044,93,673012,83.65593536357986,9
0.05,8045,96,673108,83.657469550087,7
0.05,8046,94,673202,83.65875481545918,7
0.05,8047,92,673294,83.65979125248509,9
0.05,8048,93,673387,83.66095167101503,9
0.05,8049,92,673479,83.66198757763975,10
0.05,8050,95,673574,83.66339585144702,6
0.05,8051,94,673668,83.66467958271237,8
0.05,8052,95,673763,83.6660871724823,6
0.05,8053,94,673857,83.66737025080705,7
0.05,8054,93,673950,83.6685288640596,9
0.05,8055,94,674044,83.66981132075472,7
0.05,8056,94,674138,83.67109345910389,8
0.05,8057,94,674232,83.67237527922562,7
0.05,8058,95,674327,83.67378086611242,7
0.05,8059,94,674421,83.67506203473945,7
0.05,8060,93,674514,83.6762188314105,8
0.05,8061,90,674604,83.6770032250062,11
0.05,8062,26,674630,83.66984993178717,8
0.05,8063,94,674724,83.67113095238095,8
0.05,8064,92,674816,83.67216367017978,9
0.05,8065,93,674909,83.67332010909992,8
0.05,8066,95,675004,83.67472418495103,6
0.05,8067,27,675031,83.66769955379276,6
0.05,8068,95,675126,83.66910397818813,6
0.05,8069,95,675221,83.67050805452293,6
0.05,8070,94,675315,83.67178788254243,7
0.05,8071,92,675407,83.6728196233895,9
0.05,8072,93,675500,83.6739749783228,8
0.05,8073,93,675593,83.67513004706466,10
0.05,8074,93,675686,83.67628482972137,8
0.05,8075,27,675713,83.66926696384348,6
0.05,8076,96,675809,83.67079361148942,6
0.05,8077,92,675901,83.67182470908641,9
0.05,8078,92,675993,83.67285555142963,9
0.05,8079,95,676088,83.67425742574257,6
0.05,8080,95,676183,83.67565895309987,7
0.05,8081,94,676277,83.67693640188072,7
0.05,8082,94,676371,83.67821353457875,7
0.05,8083,94,676465,83.67949035131123,7
0.05,8084,94,676559,83.68076685219542,7
0.05,8085,96,676655,83.68229037843186,6
0.05,8086,94,676749,83.68356621738593,7
0.05,8087,93,676842,83.68471810089021,8
0.05,8088,94,676936,83.68599332426753,7
0.05,8089,95,677031,83.68739184177997,6
0.05,8090,95,677126,83.68879001359535,6
0.05,8091,24,677150,83.68141374196738,8
0.05,8092,93,677243,83.682565179785,8
0.05,8093,95,677338,83.68396342970101,6
0.05,8094,90,677428,83.68474366893143,11
0.05,8095,93,677521,83.6858942687747,8
0.05,8096,96,677617,83.68741509200939,6
0.05,8097,89,677706,83.68807112867374,12
0.05,8098,92,677798,83.6890974194345,10
0.05,8099,92,677890,83.69012345679012,9
0.05,8100,92,677982,83.69114924083446,9
0.05,8101,93,678075,83.6922981979758,8
0.05,8102,27,678102,83.68530174009626,6
0.05,8103,95,678197,83.68669792694965,6
0.05,8104,95,678292,83.68809376927823,7
0.05,8105,96,678388,83.68961263261781,6
0.05,8106,95,678483,83.69100777106205,7
0.05,8107,92,678575,83.69203256043414,9
0.05,8108,25,678600,83.68479467258602,8
0.05,8109,94,678694,83.68606658446363,7
0.05,8110,92,678786,83.68709160399457,9
0.05,8111,96,678882,83.68860946745562,6
0.05,8112,91,678973,83.68951066190066,11
0.05,8113,94,679067,83.69078136554104,8
0.05,8114,92,679159,83.69180529882932,9
0.05,8115,25,679184,83.68457368161656,7
0.05,8116,95,679279,83.6859677220648,6
0.05,8117,26,679305,83.67886178861788,6
0.05,8118,92,679397,83.6798866855524,9
0.05,8119,95,679492,83.68128078817735,6
0.05,8120,94,679586,83.68255140992488,7
0.05,8121,94,679680,83.68382171878848,7
0.05,8122,92,679772,83.68484550043088,9
0.05,8123,23,679795,83.6773756770064,9
0.05,8124,27,679822,83.6704,6
0.05,8125,95,679917,83.67179424070883,7
0.05,8126,94,680011,83.67306509166974,8
0.05,8127,93,680104,83.6742125984252,8
0.05,8128,94,680198,83.67548283921762,7
0.05,8129,92,680290,83.67650676506766,9
0.05,8130,92,680382,83.67753043906039,9
0.05,8131,93,680475,83.67867683226758,9
0.05,8132,95,680570,83.68006885528095,6
0.05,8133,-118,680452,83.65527415785591,12
0.05,8134,93,680545,83.65642286416718,10
0.05,8135,92,680637,83.65744837758112,9
0.05,8136,94,680731,83.65871942976527,8
0.05,8137,93,680824,83.65986728926026,8
0.05,8138,93,680917,83.66101486669125,8
0.05,8139,92,681009,83.66203931203931,9
0.05,8140,-46,680963,83.64611227121975,9
0.05,8141,92,681055,83.64713829525915,9
0.05,8142,90,681145,83.64791845757092,11
0.05,8143,26,681171,83.64083988212181,7
0.05,8144,90,681261,83.64162062615101,11
0.05,8145,94,681355,83.64289221703903,7
0.05,8146,95,681450,83.64428624033387,6
0.05,8147,92,681542,83.6453117329406,9
0.05,8148,94,681636,83.6465824027488,7
0.05,8149,94,681730,83.6478527607362,7
0.05,8150,94,681824,83.64912280701755,7
0.05,8151,92,681916,83.65014720314034,9
0.05,8152,92,682008,83.65117134797008,9
0.05,8153,96,682104,83.65268579838116,6
0.05,8154,94,682198,83.65395462906193,7
0.05,8155,96,682294,83.65546836684649,6
0.05,8156,94,682388,83.65673654529851,7
0.05,8157,91,682479,83.6576366756558,10
0.05,8158,93,682572,83.65878171344528,8
0.05,8159,94,682666,83.66004901960784,7
0.05,8160,96,682762,83.66156108320058,6
0.05,8161,92,682854,83.66258270031855,9
0.05,8162,94,682948,83.66384907509494,8
0.05,8163,96,683044,83.66536011758942,6
0.05,8164,92,683136,83.66638089406001,9
0.05,8165,91,683227,83.66727896154788,10
0.05,8166,90,683317,83.66805436512796,11
0.05,8167,94,683411,83.66931929480901,7
0.05,8168,95,683506,83.67070632880402,6
0.05,8169,95,683601,83.67209302325581,6
0.05,8170,96,683697,83.6736017623302,6
0.05,8171,94,683791,83.67486539402839,7
0.05,8172,26,683817,83.66780863819895,7
0.05,8173,94,683911,83.66907266943969,7
0.05,8174,94,684005,83.6703363914373,10
0.05,8175,92,684097,83.67135518590997,9
0.05,8176,95,684192,83.67274061391709,6
0.05,8177,95,684287,83.6741257031059,6
0.05,8178,95,684382,83.67551045360068,6
0.05,8179,25,684407,83.66833740831296,8
0.05,8180,93,684500,83.66947805891701,9
0.05,8181,94,684594,83.67074065020778,7
0.05,8182,95,684689,83.67212513748014,6
0.05,8183,90,684779,83.67289833822092,11
0.05,8184,90,684869,83.67367135003055,11
0.05,8185,94,684963,83.67493281211826,8
0.05,8186,95,685058,83.67631611090754,6
0.05,8187,95,685153,83.67769907181241,6
0.05,8188,92,685245,83.67871534985957,9
0.05,8189,91,685336,83.67960927960928,10
0.05,8190,94,685430,83.68086924673422,7
0.05,8191,95,685525,83.6822509765625,6
0.05,8192,93,685618,83.68338825826926,8
0.05,8193,96,685714,83.68489138393947,6
0.05,8194,93,685807,83.68602806589384,8
0.05,8195,92,685899,83.68704245973646,10
0.05,8196,94,685993,83.68830059777967,8
0.05,8197,94,686087,83.68955842888509,7
0.05,8198,92,686179,83.69057202097817,9
0.05,8199,96,686275,83.6920731707317,6
0.05,8200,94,686369,83.69333008169735,7
0.05,8201,94,686463,83.6945866861741,7
0.05,8202,94,686557,83.69584298427405,7
0.05,8203,89,686646,83.69648951730863,14
0.05,8204,96,686742,83.6979890310786,6
0.05,8205,92,686834,83.69900073117232,9
0.05,8206,95,686929,83.70037772633118,7
0.05,8207,95,687024,83.70175438596492,6
0.05,8208,93,687117,83.70288707516141,8
0.05,8209,95,687212,83.70426309378806,6
0.05,8210,94,687306,83.70551698940446,7
0.05,8211,93,687399,83.70664880662446,8
0.05,8212,91,687490,83.70753683185194,10
0.05,8213,93,687583,83.70866812758705,8
0.05,8214,95,687678,83.71004260499087,6
0.05,8215,94,687772,83.71129503407984,7
0.05,8216,95,687867,83.71266885724717,6
0.05,8217,92,687959,83.71367729374543,9
0.05,8218,92,688051,83.71468548485217,10
0.05,8219,92,688143,83.71569343065694,9
0.05,8220,89,688232,83.71633621213964,12
0.05,8221,93,688325,83.717465336901,8
0.05,8222,95,688420,83.71883740727229,7
0.05,8223,95,688515,83.72020914396887,6
0.05,8224,92,688607,83.72121580547112,9
0.05,8225,95,688702,83.72258691952347,6
0.05,8226,93,688795,83.72371459827397,8
0.05,8227,94,688889,83.72496353913466,7
0.05,8228,96,688985,83.72645521934622,6
0.05,8229,91,689076,83.7273390036452,10
0.05,8230,94,689170,83.72858704896124,7
0.05,8231,92,689262,83.7295918367347,9
0.05,8232,94,689356,83.73083930523504,7
0.05,8233,96,689452,83.73232936604323,6
0.05,8234,94,689546,83.73357619914997,7
0.05,8235,94,689640,83.73482272948033,7
0.05,8236,93,689733,83.73594755372102,8
0.05,8237,95,689828,83.73731488225297,6
0.05,8238,21,689849,83.72970020633572,11
0.05,8239,93,689942,83.73082524271845,8
0.05,8240,90,690032,83.73158597257614,11
0.05,8241,94,690126,83.73283183693279,7
0.05,8242,95,690221,83.73419871406041,8
0.05,8243,96,690317,83.73568655992237,6
0.05,8244,93,690410,83.73681018799272,8
0.05,8245,92,690502,83.73781227261702,10
0.05,8246,94,690596,83.73905662665211,7
0.05,8247,93,690689,83.74017943743938,9
0.05,8248,-44,690645,83.7246939022912,8
0.05,8249,93,690738,83.72581818181818,8
0.05,8250,92,690830,83.72682099139499,9
0.05,8251,93,690923,83.72794474066893,8
0.05,8252,94,691017,83.72918938567794,7
0.05,8253,94,691111,83.73043372910104,7
0.05,8254,93,691204,83.73155663234404,10
0.05,8255,91,691295,83.73243701550388,10
0.05,8256,94,691389,83.7336805135037,7
0.05,8257,94,691483,83.73492371034149,7
0.05,8258,95,691578,83.73628768616055,8
0.05,8259,89,691667,83.73692493946731,12
0.05,8260,94,691761,83.73816729209538,7
0.05,8261,93,691854,83.73928830791576,8
0.05,8262,95,691949,83.74065109524386,8
0.05,8263,93,692042,83.7417715392062,8
0.05,8264,96,692138,83.74325468844525,6
0.05,8265,93,692231,83.74437454633438,8
0.05,8266,95,692326,83.74573605902988,6
0.05,8267,89,692415,83.74637155297533,12
0.05,8268,92,692507,83.74736969403797,9
0.05,8269,93,692600,83.7484885126965,8
0.05,8270,94,692694,83.74972796517955,7
0.05,8271,92,692786,83.75072533849129,9
0.05,8272,95,692881,83.75208509609573,6
0.05,8273,94,692975,83.75332366449118,8
0.05,8274,95,693070,83.75468277945619,6
0.05,8275,94,693164,83.75592073465442,7
0.05,8276,93,693257,83.75703757400024,8
0.05,8277,93,693350,83.75815414351293,8
0.05,8278,95,693445,83.7595120183597,6
0.05,8279,94,693539,83.76074879227053,7
0.05,8280,95,693634,83.76210602584229,7
0.05,8281,94,693728,83.76334218787733,7
0.05,8282,91,693819,83.76421586381745,10
0.05,8283,94,693913,83.7654514727185,7
0.05,8284,95,694008,83.76680748340374,6
0.05,8285,93,694101,83.76792179580015,9
0.05,8286,96,694197,83.76939785205744,6
0.05,8287,94,694291,83.77063223938224,7
0.05,8288,91,694382,83.77150440342622,10
0.05,8289,95,694477,83.77285886610375,6
0.05,8290,91,694568,83.7737305512001,10
0.05,8291,94,694662,83.77496382054993,7
0.05,8292,96,694758,83.77643795972507,6
0.05,8293,95,694853,83.7777911743429,8
0.05,8294,95,694948,83.77914406268836,6
0.05,8295,94,695042,83.78037608486018,7
0.05,8296,96,695138,83.7818488610341,6
0.05,8297,94,695232,83.78308026030369,7
0.05,8298,94,695326,83.78431136281479,7
0.05,8299,94,695420,83.7855421686747,7
0.05,8300,94,695514,83.7867726779906,9
0.05,8301,94,695608,83.78800289086966,7
0.05,8302,91,695699,83.78887149223172,10
0.05,8303,96,695795,83.79034200385357,6
0.05,8304,96,695891,83.79181216134859,6
0.05,8305,94,695985,83.79304117505417,7
0.05,8306,94,696079,83.79426989286144,7
0.05,8307,94,696173,83.79549831487722,8
0.05,8308,94,696267,83.79672644120834,7
0.05,8309,94,696361,83.79795427196149,7
0.05,8310,94,696455,83.79918180724341,7
0.05,8311,94,696549,83.80040904716073,7
0.05,8312,94,696643,83.80163599182004,7
0.05,8313,92,696735,83.8026220832331,9
0.05,8314,92,696827,83.80360793746242,10
0.05,8315,95,696922,83.80495430495431,6
0.05,8316,94,697016,83.80618011302153,7
0.05,8317,92,697108,83.80716518393845,10
0.05,8318,92,697200,83.80815001803101,9
0.05,8319,95,697295,83.8094951923077,6
0.05,8320,94,697389,83.8107198654008,7
0.05,8321,92,697481,83.81170391732756,9
0.05,8322,93,697574,83.8128078817734,8
0.05,8323,94,697668,83.81403171552138,7
0.05,8324,95,697763,83.81537537537538,6
0.05,8325,96,697859,83.81683881815998,6
0.05,8326,96,697955,83.81830190945118,6
0.05,8327,96,698051,83.8197646493756,6
0.05,8328,94,698145,83.82098691319486,7
0.05,8329,95,698240,83.82232893157263,6
0.05,8330,96,698336,83.82379066138519,6
0.05,8331,96,698432,83.82525204032645,6
0.05,8332,93,698525,83.82635305412217,9
0.05,8333,27,698552,83.81953443724503,6
0.05,8334,90,698642,83.82027594481104,11
0.05,8335,96,698738,83.82173704414588,6
0.05,8336,93,698831,83.82283795130142,8
0.05,8337,92,698923,83.82381866154954,9
0.05,8338,95,699018,83.82515889195348,6
0.05,8339,93,699111,83.82625899280576,9
0.05,8340,94,699205,83.82747871957798,7
0.05,8341,94,699299,83.82869815391993,8
0.05,8342,93,699392,83.82979743497543,8
0.05,8343,96,699488,83.83125599232982,6
0.05,8344,96,699584,83.83271420011984,6
0.05,8345,92,699676,83.83369278696381,9
0.05,8346,90,699766,83.83443153228706,11
0.05,8347,94,699860,83.83564925730714,7
0.05,8348,96,699956,83.8371062402683,6
0.05,8349,92,700048,83.83808383233533,10
0.05,8350,93,700141,83.8391809364148,8
0.05,8351,94,700235,83.84039750957854,7
0.05,8352,94,700329,83.84161379145218,7
0.05,8353,94,700423,83.84282978214029,7
0.05,8354,92,700515,83.84380610412926,10
0.05,8355,95,700610,83.84514121589277,6
0.05,8356,94,700704,83.84635634797176,7
0.05,8357,96,700800,83.8478104809763,6
0.05,8358,94,700894,83.84902500299079,7
0.05,8359,94,700988,83.85023923444976,7
0.05,8360,94,701082,83.85145317545748,7
0.05,8361,92,701174,83.85242764888783,10
0.05,8362,94,701268,83.85364103790506,7
0.05,8363,94,701362,83.85485413677667,7
0.05,8364,94,701456,83.8560669456067,7
0.05,8365,93,701549,83.85715993306239,8
0.05,8366,93,701642,83.8582526592566,8
0.05,8367,94,701736,83.85946462715106,7
0.05,8368,92,701828,83.86043732823515,9
0.05,8369,91,701919,83.86129032258064,10
0.05,8370,94,702013,83.8625014932505,8
0.05,8371,96,702109,83.86395126612518,6
0.05,8372,95,702204,83.8652812611967,6
0.05,8373,94,702298,83.86649152137569,7
0.05,8374,94,702392,83.86770149253731,7
0.05,8375,94,702486,83.8689111747851,7
0.05,8376,90,702576,83.86964307031157,11
0.05,8377,93,702669,83.8707328718071,8
0.05,8378,89,702758,83.87134502923976,12
0.05,8379,93,702851,83.87243436754177,8
0.05,8380,94,702945,83.87364276339339,7
0.05,8381,95,703040,83.87497017418278,6
0.05,8382,95,703135,83.87629726828105,6
0.05,8383,91,703226,83.87714694656489,10
0.05,8384,93,703319,83.87823494335122,9
0.05,8385,-44,703275,83.86298592892916,8
0.05,8386,96,703371,83.86443305115058,6
0.05,8387,95,703466,83.86576061039581,6
0.05,8388,94,703560,83.86696864942186,7
0.05,8389,93,703653,83.86805721096543,9
0.05,8390,96,703749,83.86950303897032,6
0.05,8391,94,703843,83.87071020019066,7
0.05,8392,85,703928,83.8708447515787,16
0.05,8393,91,704019,83.87169406719084,10
0.05,8394,95,704114,83.87301965455629,6
0.05,8395,95,704209,83.87434492615532,7
0.05,8396,88,704297,83.87483625104204,13
0.05,8397,93,704390,83.87592283877113,9
0.05,8398,96,704486,83.87736635313728,6
0.05,8399,94,704580,83.87857142857143,7
0.05,8400,96,704676,83.88001428401381,6
0.05,8401,93,704769,83.88109973815759,11
0.05,8402,21,704790,83.87361656551232,11
0.05,8403,94,704884,83.87482151356497,7
0.05,8404,94,704978,83.8760261748959,7
0.05,8405,96,705074,83.87746847489888,6
0.05,8406,93,705167,83.87855358629713,8
0.05,8407,92,705259,83.8795195052331,9
0.05,8408,93,705352,83.88060411463908,8
0.05,8409,95,705447,83.88192627824019,6
0.05,8410,96,705543,83.88336701937938,6
0.05,8411,93,705636,83.88445078459344,8
0.05,8412,96,705732,83.88589088315702,6
0.05,8413,92,705824,83.88685524126456,9
0.05,8414,94,705918,83.88805704099822,8
0.05,8415,95,706013,83.88937737642586,7
0.05,8416,92,706105,83.89034097659498,10
0.05,8417,93,706198,83.89142314088858,8
0.05,8418,92,706290,83.8923862691531,9
0.05,8419,94,706384,83.89358669833729,7
0.05,8420,95,706479,83.89490559315996,7
0.05,8421,93,706572,83.89598670149608,9
0.05,8422,94,706666,83.89718627567375,7
0.05,8423,93,706759,83.89826685660019,8
0.05,8424,93,706852,83.8993471810089,8
0.05,8425,95,706947,83.90066460954189,6
0.05,8426,93,707040,83.90174439302243,9
0.05,8427,94,707134,83.90294257237778,7
0.05,8428,94,707228,83.90414046743386,7
0.05,8429,94,707322,83.90533807829182,7
0.05,8430,95,707417,83.90665401494485,6
0.05,8431,92,707509,83.90761385199241,9
0.05,8432,94,707603,83.90881062492589,7
0.05,8433,96,707699,83.91024424946644,6
0.05,8434,93,707792,83.9113218731476,8
0.05,8435,91,707883,83.91216216216216,10
0.05,8436,93,707976,83.91323930306982,9
0.05,8437,27,708003,83.90649442995971,6
0.05,8438,95,708098,83.90780898210689,6
0.05,8439,96,708194,83.90924170616114,6
0.05,8440,94,708288,83.9104371519962,7
0.05,8441,93,708381,83.91151385927505,8
0.05,8442,90,708471,83.91223498756366,11
0.05,8443,95,708566,83.91354808147797,7
0.05,8444,96,708662,83.9149792776791,6
0.05,8445,96,708758,83.91641013497514,6
0.05,8446,94,708852,83.9176038830354,7
0.05,8447,92,708944,83.91856060606061,9
0.05,8448,94,709038,83.91975381701977,7
0.05,8449,96,709134,83.92118343195266,6
0.05,8450,87,709221,83.9215477458289,15
0.05,8451,92,709313,83.92250354945575,9
0.05,8452,95,709408,83.92381403052171,6
0.05,8453,95,709503,83.92512420156139,7
0.05,8454,92,709595,83.92607924305145,9
0.05,8455,94,709689,83.92727057710502,7
0.05,8456,96,709785,83.92869811990067,6
0.05,8457,95,709880,83.93000709387562,7
0.05,8458,96,709976,83.93143397564724,6
0.05,8459,93,710069,83.93250591016549,10
0.05,8460,93,710162,83.93357759130126,8
0.05,8461,93,710255,83.93464901914442,8
0.05,8462,91,710346,83.93548387096774,10
0.05,8463,94,710440,83.9366729678639,7
0.05,8464,92,710532,83.93762551683402,9
0.05,8465,93,710625,83.93869596031183,8
0.05,8466,93,710718,83.93976615093894,8
0.05,8467,25,710743,83.9328058573453,8
0.05,8468,94,710837,83.93399456842603,7
0.05,8469,92,710929,83.9349468713105,10
0.05,8470,92,711021,83.93589894935663,9
0.05,8471,94,711115,83.93708687440981,7
0.05,8472,96,711211,83.93851056296471,6
0.05,8473,90,711301,83.93922586735899,11
0.05,8474,94,711395,83.94041297935104,7
0.05,8475,95,711490,83.94171779141104,6
0.05,8476,94,711584,83.94290432936181,8
0.05,8477,96,711680,83.94432649209719,6
0.05,8478,93,711773,83.94539450406887,8
0.05,8479,95,711868,83.94669811320755,6
0.05,8480,93,711961,83.94776559367999,8
0.05,8481,94,712055,83.94895071917001,7
0.05,8482,95,712150,83.95025344807262,6
0.05,8483,93,712243,83.95132013201321,9
0.05,8484,93,712336,83.95238656452564,8
0.05,8485,96,712432,83.95380626914918,6
0.05,8486,93,712525,83.95487215741723,8
0.05,8487,94,712619,83.95605560791707,7
0.05,8488,92,712711,83.95700318058664,9
0.05,8489,94,712805,83.95818610129564,7
0.05,8490,95,712900,83.95948651513368,6
0.05,8491,93,712993,83.96055110692416,8
0.05,8492,95,713088,83.96185093606499,6
0.05,8493,94,713182,83.96303272898517,8
0.05,8494,95,713277,83.96433195997646,6
0.05,8495,94,713371,83.9655131826742,7
0.05,8496,92,713463,83.96645875014711,9
0.05,8497,93,713556,83.9675217698282,8
0.05,8498,96,713652,83.96893752206142,6
0.05,8499,92,713744,83.96988235294117,11
0.05,8500,95,713839,83.9711798611928,7
0.05,8501,94,713933,83.97235944483651,7
0.05,8502,95,714028,83.97365635658004,7
0.05,8503,95,714123,83.97495296331138,6
0.05,8504,95,714218,83.97624926513815,6
0.05,8505,94,714312,83.97742769809547,7
0.05,8506,96,714408,83.97884095450806,6
0.05,8507,93,714501,83.97990126939351,8
0.05,8508,93,714594,83.980961335057,8
0.05,8509,96,714690,83.98237367802585,6
0.05,8510,93,714783,83.98343320408883,8
0.05,8511,95,714878,83.98472744360902,6
0.05,8512,94,714972,83.98590391166451,7
0.05,8513,95,715067,83.987197556965,6
0.05,8514,93,715160,83.98825601879037,8
0.05,8515,95,715255,83.98954908407703,6
0.05,8516,94,715349,83.99072443348597,8
0.05,8517,94,715443,83.99189950692652,7
0.05,8518,95,715538,83.9931916891654,6
0.05,8519,92,715630,83.99413145539906,9
0.05,8520,90,715720,83.9948362868208,11
0.05,8521,93,715813,83.99589298286787,8
0.05,8522,94,715907,83.99706676053033,7
0.05,8523,94,716001,83.99824026278742,7
0.05,8524,96,716097,83.99964809384164,6
0.05,8525,95,716192,84.00093830635703,6
0.05,8526,93,716285,84.00199366717486,8
0.05,8527,95,716380,84.00328330206379,6
0.05,8528,96,716476,84.00468988158049,6
0.05,8529,94,716570,84.00586166471278,7
0.05,8530,95,716665,84.0071503926855,6
0.05,8531,89,716754,84.00773558368495,12
0.05,8532,96,716850,84.00914098206961,6
0.05,8533,90,716940,84.0098429810171,11
0.05,8534,96,717036,84.01124780316344,6
0.05,8535,96,717132,84.01265229615746,6
0.05,8536,94,717226,84.01382218577955,7
0.05,8537,96,717322,84.01522604825486,6
0.05,8538,95,717417,84.01651247218643,6
0.05,8539,95,717512,84.01779859484778,6
0.05,8540,92,717604,84.0187331694181,9
0.05,8541,91,717695,84.01955045656754,10
0.05,8542,92,717787,84.02048460728082,9
0.05,8543,95,717882,84.02176966292134,6
0.05,8544,91,717973,84.02258630778233,10
0.05,8545,94,718067,84.02375380294875,7
0.05,8546,92,718159,84.02468702468703,9
0.05,8547,93,718252,84.02573701450632,8
0.05,8548,90,718342,84.02643584044918,11
0.05,8549,95,718437,84.02771929824561,6
0.05,8550,90,718527,84.02841772892059,12
0.05,8551,94,718621,84.0295837231057,7
0.05,8552,96,718717,84.03098328072022,6
0.05,8553,94,718811,84.03214870236147,7
0.05,8554,93,718904,84.03319696084161,8
0.05,8555,94,718998,84.03436185133239,7
0.05,8556,90,719088,84.03505901601028,11
0.05,8557,92,719180,84.03598971722366,9
0.05,8558,95,719275,84.037270709195,6
0.05,8559,94,719369,84.03843457943925,8
0.05,8560,92,719461,84.03936456021493,9
0.05,8561,94,719555,84.04052791403878,7
0.05,8562,95,719650,84.04180777764802,6
0.05,8563,94,719744,84.0429705744979,7
0.05,8564,94,719838,84.04413309982486,7
0.05,8565,24,719862,84.03712351155733,8
0.05,8566,88,719950,84.03758608614451,13
0.05,8567,92,720042,84.03851540616246,9
0.05,8568,94,720136,84.03967790874081,9
0.05,8569,95,720231,84.04095682613769,6
0.05,8570,94,720325,84.04211877260529,8
0.05,8571,94,720419,84.04328044797013,7
0.05,8572,89,720508,84.04385862591859,12
0.05,8573,94,720602,84.04501982738512,7
0.05,8574,90,720692,84.04571428571428,11
0.05,8575,93,720785,84.04675839552239,8
0.05,8576,93,720878,84.04780226186313,9
0.05,8577,94,720972,84.04896246211239,7
0.05,8578,95,721067,84.05023895558924,6
0.05,8579,94,721161,84.0513986013986,7
0.05,8580,92,721253,84.05232490385735,9
0.05,8581,93,721346,84.05336751340013,9
0.05,8582,96,721442,84.05475940813236,6
0.05,8583,96,721538,84.05615097856477,6
0.05,8584,96,721634,84.05754222481072,6
0.05,8585,96,721730,84.05893314698346,6
0.05,8586,93,721823,84.05997437987656,8
0.05,8587,94,721917,84.06113181183046,7
0.05,8588,94,722011,84.06228897426942,8
0.05,8589,94,722105,84.06344586728754,7
0.05,8590,92,722197,84.06436968920964,9
0.05,8591,95,722292,84.06564245810056,6
0.05,8592,96,722388,84.06703130455021,6
0.05,8593,94,722482,84.06818710728415,8
0.05,8594,92,722574,84.06910994764398,10
0.05,8595,94,722668,84.07026523964635,7
0.05,8596,90,722758,84.07095498429685,11
0.05,8597,95,722853,84.07222609909282,6
0.05,8598,94,722947,84.07338062565415,7
0.05,8599,92,723039,84.0743023255814,9
0.05,8600,96,723135,84.07568887338681,6
0.05,8601,96,723231,84.07707509881423,6
0.05,8602,94,723325,84.07822852493317,7
0.05,8603,90,723415,84.07891678289168,11
0.05,8604,95,723510,84.08018593840791,6
0.05,8605,94,723604,84.08133860097607,7
0.05,8606,92,723696,84.0822586266992,9
0.05,8607,92,723788,84.0831784386617,10
0.05,8608,93,723881,84.08421419444767,8
0.05,8609,94,723975,84.08536585365853,8
0.05,8610,95,724070,84.08663337591453,6
0.05,8611,93,724163,84.08766836971668,8
0.05,8612,94,724257,84.08881922675026,7
0.05,8613,89,724346,84.08938936614813,12
0.05,8614,94,724440,84.09053975623912,7
0.05,8615,94,724534,84.09168987929434,7
0.05,8616,94,724628,84.09283973540676,7
0.05,8617,95,724723,84.09410536087259,7
0.05,8618,95,724818,84.09537069265576,6
0.05,8619,93,724911,84.09640371229699,8
0.05,8620,94,725005,84.09755248811042,7
0.05,8621,92,725097,84.09846903270703,9
0.05,8622,94,725191,84.09961730256292,7
0.05,8623,92,725283,84.10053339517626,9
0.05,8624,95,725378,84.10179710144928,6
0.05,8625,92,725470,84.10271272895896,9
0.05,8626,94,725564,84.10385997449866,8
0.05,8627,94,725658,84.10500695410292,8
0.05,8628,92,725750,84.10592189129679,9
0.05,8629,94,725844,84.10706836616454,7
0.05,8630,91,725935,84.10786699107867,10
0.05,8631,91,726026,84.10866543095459,10
0.05,8632,88,726114,84.10911618209197,13
0.05,8633,93,726207,84.11014593467686,8
0.05,8634,93,726300,84.11117544875506,9
0.05,8635,94,726394,84.11232051875868,7
0.05,8636,95,726489,84.11358110455019,7
0.05,8637,93,726582,84.1146098633943,8
0.05,8638,92,726674,84.11552262993402,9
0.05,8639,92,726766,84.11643518518518,9
0.05,8640,94,726860,84.1175789839139,8
0.05,8641,94,726954,84.11872251793567,7
0.05,8642,94,727048,84.11986578734236,7
0.05,8643,93,727141,84.12089310504396,8
0.05,8644,94,727235,84.12203585887796,7
0.05,8645,95,727330,84.1232940087902,6
0.05,8646,93,727423,84.12432057360934,8
0.05,8647,93,727516,84.12534690101758,8
0.05,8648,91,727607,84.12614175049139,10
0.05,8649,95,727702,84.12739884393064,6
0.05,8650,94,727796,84.12854005317304,7
0.05,8651,95,727891,84.1297965788257,6
0.05,8652,95,727986,84.13105281405294,6
0.05,8653,94,728080,84.13219320545413,7
0.05,8654,96,728176,84.13356441363374,6
0.05,8655,95,728271,84.13481977818854,6
0.05,8656,91,728362,84.13561279889107,10
0.05,8657,94,728456,84.13675213675214,8
0.05,8658,95,728551,84.13800669823306,6
0.05,8659,93,728644,84.13903002309469,8
0.05,8660,95,728739,84.14028403186698,6
0.05,8661,96,728835,84.14165319787578,6
0.05,8662,95,728930,84.14290661433684,8
0.05,8663,94,729024,84.14404432132964,7
0.05,8664,96,729120,84.14541257934218,6
0.05,8665,95,729215,84.14666512808678,7
0.05,8666,92,729307,84.14757124725972,9
0.05,8667,95,729402,84.14882325796032,6
0.05,8668,91,729493,84.14961356557849,10
0.05,8669,93,729586,84.15063437139561,8
0.05,8670,92,729678,84.15153961480799,9
0.05,8671,93,729771,84.15255996309963,9
0.05,8672,96,729867,84.15392597717053,6
0.05,8673,95,729962,84.15517638920913,6
0.05,8674,95,730057,84.1564265129683,7
0.05,8675,93,730150,84.15744582757031,8
0.05,8676,94,730244,84.15858015443125,7
0.05,8677,96,730340,84.15994468771606,6
0.05,8678,95,730435,84.16119368590851,6
0.05,8679,93,730528,84.16221198156683,8
0.05,8680,94,730622,84.16334523672388,9
0.05,8681,94,730716,84.1644782308224,7
0.05,8682,94,730810,84.16561096395255,8
0.05,8683,95,730905,84.16685859051128,6
0.05,8684,94,730999,84.16799078871618,8
0.05,8685,94,731093,84.1691227262261,7
0.05,8686,95,731188,84.17036951767008,6
0.05,8687,96,731284,84.17173112338858,6
0.05,8688,93,731377,84.17274715157095,8
0.05,8689,94,731471,84.17387802071346,7
0.05,8690,95,731566,84.17512369117478,6
0.05,8691,92,731658,84.17602393005062,10
0.05,8692,94,731752,84.17715403197975,7
0.05,8693,92,731844,84.17805383022774,9
0.05,8694,92,731936,84.17895342150662,9
0.05,8695,93,732029,84.17996780128794,8
0.05,8696,94,732123,84.18109692997585,7
0.05,8697,94,732217,84.18222579903426,7
0.05,8698,94,732311,84.1833544085527,7
0.05,8699,91,732402,84.18413793103448,10
0.05,8700,93,732495,84.18515113205379,8
0.05,8701,94,732589,84.18627901631808,7
0.05,8702,95,732684,84.18752154429507,6
0.05,8703,94,732778,84.18864889705883,8
0.05,8704,95,732873,84.18989086731763,6
0.05,8705,95,732968,84.1911325522628,6
0.05,8706,94,733062,84.19225910187205,7
0.05,8707,95,733157,84.19350022967386,6
0.05,8708,96,733253,84.19485589619933,6
0.05,8709,95,733348,84.19609644087257,7
0.05,8710,93,733441,84.19710710595798,8
0.05,8711,94,733535,84.19823232323232,7
0.05,8712,94,733629,84.19935728222197,7
0.05,8713,94,733723,84.20048198301583,7
0.05,8714,94,733817,84.2016064257028,7
0.05,8715,93,733910,84.2026158788435,9
0.05,8716,95,734005,84.2038545371114,6
0.05,8717,-48,733957,84.18869006652902,11
0.05,8718,18,733975,84.18109874985663,14
0.05,8719,93,734068,84.18211009174311,8
0.05,8720,94,734162,84.1832358674464,7
0.05,8721,95,734257,84.18447603760606,6
0.05,8722,93,734350,84.18548664450304,8
0.05,8723,95,734445,84.18672627235213,6
0.05,8724,94,734539,84.18785100286533,7
0.05,8725,94,734633,84.18897547559018,8
0.05,8726,94,734727,84.19009969061533,8
0.05,8727,94,734821,84.19122364802934,7
0.05,8728,92,734913,84.19211822660098,9
0.05,8729,92,735005,84.1930126002291,9
0.05,8730,95,735100,84.19425037223685,7
0.05,8731,94,735194,84.19537333944113,7
0.05,8732,93,735287,84.1963815412802,8
0.05,8733,93,735380,84.19738951225098,8
0.05,8734,95,735475,84.19862621637093,6
0.05,8735,96,735571,84.19997710622711,6
0.05,8736,92,735663,84.20086986379764,9
0.05,8737,94,735757,84.20199130235751,7
0.05,8738,94,735851,84.20311248426593,7
0.05,8739,94,735945,84.20423340961098,7
0.05,8740,94,736039,84.20535407848072,7
0.05,8741,93,736132,84.20636010066346,9
0.05,8742,93,736225,84.20736589271417,8
0.05,8743,93,736318,84.20837145471181,8
0.05,8744,93,736411,84.20937678673528,8
0.05,8745,94,736505,84.21049622684656,7
0.05,8746,94,736599,84.21161541099805,7
0.05,8747,96,736695,84.21296296296296,6
0.05,8748,95,736790,84.21419590810379,7
0.05,8749,93,736883,84.2152,8
0.05,8750,92,736975,84.21608958976117,9
0.05,8751,88,737063,84.21652193784278,13
0.05,8752,94,737157,84.21763966640009,7
0.05,8753,93,737250,84.21864290610007,8
0.05,8754,94,737344,84.21976013706454,7
0.05,8755,90,737434,84.22042028323435,11
0.05,8756,94,737528,84.22153705606944,7
0.05,8757,95,737623,84.22276775519525,6
0.05,8758,92,737715,84.22365566845531,10
0.05,8759,95,737810,84.22488584474885,6
0.05,8760,94,737904,84.2260015979911,7
0.05,8761,95,737999,84.22723122574754,6
0.05,8762,25,738024,84.22047244094489,8
0.05,8763,95,738119,84.22170241898677,6
0.05,8764,95,738214,84.22293211637194,6
0.05,8765,90,738304,84.22359114761579,11
0.05,8766,94,738398,84.22470628493213,7
0.05,8767,95,738493,84.22593521897811,8
0.05,8768,95,738588,84.2271638727335,6
0.05,8769,94,738682,84.22827822120867,7
0.05,8770,92,738774,84.22916429141489,9
0.05,8771,92,738866,84.23005015959872,10
0.05,8772,94,738960,84.23116379801664,7
0.05,8773,94,739054,84.23227718258491,9
0.05,8774,85,739139,84.23236467236467,16
0.05,8775,93,739232,84.23336371923428,8
0.05,8776,94,739326,84.23447647259884,8
0.05,8777,93,739419,84.23547505126453,8
0.05,8778,94,739513,84.23658731062764,7
0.05,8779,27,739540,84.23006833712984,6
0.05,8780,94,739634,84.23118095888852,7
0.05,8781,92,739726,84.23206558870417,9
0.05,8782,24,739750,84.22520778777184,9
0.05,8783,92,739842,84.22609289617486,9
0.05,8784,90,739932,84.226750142288,11
0.05,8785,95,740027,84.22797632597315,6
0.05,8786,96,740123,84.22931603505178,6
0.05,8787,96,740219,84.23065543923532,6
0.05,8788,91,740310,84.23142564569348,10
0.05,8789,95,740405,84.23265073947668,6
0.05,8790,93,740498,84.23364804914117,8
0.05,8791,91,740589,84.23441765241128,10
0.05,8792,92,740681,84.23530080746048,9
0.05,8793,95,740776,84.2365249033432,7
0.05,8794,94,740870,84.23763501989767,8
0.05,8795,92,740962,84.23851750795816,9
0.05,8796,96,741058,84.23985449585086,6
0.05,8797,-50,741008,84.22459649920437,13
0.05,8798,94,741102,84.22570746675758,7
0.05,8799,96,741198,84.22704545454546,6
0.05,8800,94,741292,84.22815589137598,7
0.05,8801,90,741382,84.22881163371962,11
0.05,8802,94,741476,84.22992161763035,7
0.05,8803,94,741570,84.23103134938664,7
0.05,8804,94,741664,84.2321408290744,7
0.05,8805,94,741758,84.23325005677947,7
0.05,8806,94,741852,84.23435903258772,7
0.05,8807,94,741946,84.23546775658492,7
0.05,8808,94,742040,84.23657622885685,7
0.05,8809,94,742134,84.23768444948922,7
0.05,8810,94,742228,84.2387924185677,7
0.05,8811,93,742321,84.23978665456197,8
0.05,8812,93,742414,84.24078066492682,9
0.05,8813,94,742508,84.24188790560471,7
0.05,8814,91,742599,84.24265456608055,10
0.05,8815,94,742693,84.24376134301271,8
0.05,8816,94,742787,84.24486786888964,7
0.05,8817,96,742883,84.24620095259696,6
0.05,8818,95,742978,84.24742034244245,6
0.05,8819,94,743072,84.24852607709751,7
0.05,8820,94,743166,84.2496315610475,8
0.05,8821,91,743257,84.25039673543414,10
0.05,8822,93,743350,84.25138841663833,8
0.05,8823,93,743443,84.25237987307344,8
0.05,8824,96,743539,84.25371104815864,6
0.05,8825,94,743633,84.25481531837752,9
0.05,8826,94,743727,84.25591933839357,7
0.05,8827,95,743822,84.25713638423198,7
0.05,8828,95,743917,84.25835315437762,6
0.05,8829,93,744010,84.25934314835787,8
0.05,8830,92,744102,84.26021968067036,9
0.05,8831,95,744197,84.2614356884058,8
0.05,8832,96,744293,84.26276463262765,6
0.05,8833,90,744383,84.26341408195609,11
0.05,8834,91,744474,84.2641765704584,10
0.05,8835,92,744566,84.26505205975555,9
0.05,8836,96,744662,84.26637999321036,6
0.05,8837,94,744756,84.26748133061778,7
0.05,8838,94,744850,84.26858241882566,7
0.05,8839,93,744943,84.2695701357466,8
0.05,8840,88,745031,84.26999208234362,13
0.05,8841,95,745126,84.2712056095906,6
0.05,8842,95,745221,84.27241886237702,6
0.05,8843,93,745314,84.27340569877883,8
0.05,8844,94,745408,84.27450537026569,7
0.05,8845,93,745501,84.27549174768257,9
0.05,8846,90,745591,84.2761388041144,11
0.05,8847,94,745685,84.27723779385171,7
0.05,8848,95,745780,84.27844954232117,6
0.05,8849,93,745873,84.27943502824859,8
0.05,8850,93,745966,84.28042029149249,8
0.05,8851,94,746060,84.28151830094893,7
0.05,8852,89,746149,84.28205128205128,12
0.05,8853,95,746244,84.28326180257511,7
0.05,8854,95,746339,84.28447204968944,6
0.05,8855,94,746433,84.28556910569105,7
0.05,8856,96,746529,84.28689172406007,6
0.05,8857,94,746623,84.28798825920072,7
0.05,8858,94,746717,84.28908454678857,7
0.05,8859,96,746813,84.29040632054176,6
0.05,8860,96,746909,84.29172779595983,6
0.05,8861,90,746999,84.29237192507334,11
0.05,8862,93,747092,84.2933543946745,8
0.05,8863,94,747186,84.29444945848375,7
0.05,8864,95,747281,84.2956570783982,6
0.05,8865,92,747373,84.29652605459057,9
0.05,8866,94,747467,84.2976203902109,7
0.05,8867,94,747561,84.2987144790257,7
0.05,8868,93,747654,84.29969556883528,8
0.05,8869,27,747681,84.29323562570463,7
0.05,8870,92,747773,84.29410438507496,9
0.05,8871,93,747866,84.29508566275925,8
0.05,8872,92,747958,84.29595401780684,9
0.05,8873,95,748053,84.2971602434077,6
0.05,8874,94,748147,84.29825352112677,7
0.05,8875,94,748241,84.29934655250112,8
0.05,8876,93,748334,84.30032668694379,8
0.05,8877,95,748429,84.30153187654878,6
0.05,8878,93,748522,84.30251154409281,8
0.05,8879,93,748615,84.303490990991,8
0.05,8880,93,748708,84.30447021731787,8
0.05,8881,96,748804,84.30578698491331,6
0.05,8882,92,748896,84.306653157717,9
0.05,8883,95,748991,84.30785682125169,6
0.05,8884,95,749086,84.30906021384355,8
0.05,8885,93,749179,84.31003826243528,9
0.05,8886,96,749275,84.31135366265332,6
0.05,8887,94,749369,84.31244374437443,8
0.05,8888,93,749462,84.31342108223647,8
0.05,8889,25,749487,84.30674915635545,8
0.05,8890,95,749582,84.30795186143291,6
0.05,8891,94,749676,84.30904183535762,9
0.05,8892,94,749770,84.31013156415158,7
0.05,8893,96,749866,84.3114459185968,6
0.05,8894,95,749961,84.31264755480608,8
0.05,8895,93,750054,84.31362410071942,8
0.05,8896,93,750147,84.31460042711026,9
0.05,8897,92,750239,84.31546414924702,9
0.05,8898,93,750332,84.31644004944376,8
0.05,8899,95,750427,84.3176404494382,6
0.05,8900,95,750522,84.31884057971014,6
0.05,8901,95,750617,84.32004044035048,7
0.05,8902,94,750711,84.32112770976076,7
0.05,8903,94,750805,84.32221473495058,8
0.05,8904,93,750898,84.32318921953959,8
0.05,8905,93,750991,84.32416348529081,8
0.05,8906,91,751082,84.32491298978331,10
0.05,8907,17,751099,84.31735518634935,15
0.05,8908,93,751192,84.3183297788753,8
0.05,8909,93,751285,84.31930415263749,8
0.05,8910,93,751378,84.32027830770957,8
0.05,8911,93,751471,84.32125224416517,9
0.05,8912,93,751564,84.32222596207787,8
0.05,8913,94,751658,84.32331164460399,7
0.05,8914,94,751752,84.32439708356702,7
0.05,8915,94,751846,84.3254822790489,7
0.05,8916,94,751940,84.32656723113155,7
0.05,8917,94,752034,84.32765193989684,8
0.05,8918,93,752127,84.32862428523377,8
0.05,8919,94,752221,84.32970852017937,7
0.05,8920,94,752315,84.33079251205022,7
0.05,8921,96,752411,84.33210042591347,6
0.05,8922,94,752505,84.33318390675781,8
0.05,8923,92,752597,84.33404303003138,9
0.05,8924,95,752692,84.3352380952381,7
0.05,8925,94,752786,84.3363208604078,7
0.05,8926,94,752880,84.3374033829954,7
0.05,8927,95,752975,84.33859767025089,7
0.05,8928,94,753069,84.33967969537463,7
0.05,8929,92,753161,84.34053751399776,9
0.05,8930,93,753254,84.34150711006606,8
0.05,8931,94,753348,84.34258844603673,7
0.05,8932,91,753439,84.34333370648159,10
0.05,8933,95,753534,84.34452652787105,6
0.05,8934,92,753626,84.34538332400672,9
0.05,8935,94,753720,84.34646374216652,7
0.05,8936,87,753807,84.3467606579389,14
0.05,8937,94,753901,84.34784068024166,7
0.05,8938,95,753996,84.34903233023829,6
0.05,8939,96,754092,84.3503355704698,6
0.05,8940,94,754186,84.35141483055587,8
0.05,8941,96,754282,84.35271751286066,6
0.05,8942,94,754376,84.35379626523537,7
0.05,8943,94,754470,84.35487477638641,7
0.05,8944,92,754562,84.35572945779765,9
0.05,8945,93,754655,84.35669572993517,8
0.05,8946,94,754749,84.3577735553817,7
0.05,8947,95,754844,84.3589628967367,6
0.05,8948,93,754937,84.35992848362946,8
0.05,8949,91,755028,84.36067039106145,10
0.05,8950,91,755119,84.3614121327226,12
0.05,8951,93,755212,84.36237712243074,8
0.05,8952,94,755306,84.3634535909751,7
0.05,8953,96,755402,84.364753182935,6
0.05,8954,93,755495,84.36571747627023,8
0.05,8955,95,755590,84.36690486824475,6
0.05,8956,94,755684,84.3679803505638,7
0.05,8957,94,755778,84.36905559276624,8
0.05,8958,94,755872,84.37013059493248,7
0.05,8959,94,755966,84.37120535714286,7
0.05,8960,93,756059,84.37216828478964,8
0.05,8961,93,756152,84.37313099754519,8
0.05,8962,92,756244,84.37398192569452,9
0.05,8963,92,756336,84.3748326639893,9
0.05,8964,95,756431,84.37601784718349,6
0.05,8965,95,756526,84.37720276600491,7
0.05,8966,93,756619,84.3781643805063,8
0.05,8967,94,756713,84.3792372881356,7
0.05,8968,95,756808,84.38042145166685,8
0.05,8969,94,756902,84.38149386845039,7
0.05,8970,89,756991,84.38200869468287,12
0.05,8971,94,757085,84.3830806954971,7
0.05,8972,94,757179,84.38415245737211,7
0.05,8973,95,757274,84.38533541341654,6
0.05,8974,18,757292,84.37793871866295,14
0.05,8975,93,757385,84.37889928698752,8
0.05,8976,93,757478,84.37985964130556,8
0.05,8977,96,757574,84.38115393183337,6
0.05,8978,94,757668,84.38222519211493,7
0.05,8979,94,757762,84.38329621380846,7
0.05,8980,92,757854,84.38414430464313,9
0.05,8981,95,757949,84.3853262079715,7
0.05,8982,21,757970,84.37827006567962,11
0.05,8983,86,758056,84.37845057880676,15
0.05,8984,27,758083,84.37206455203116,6
0.05,8985,93,758176,84.37302470509681,9
0.05,8986,96,758272,84.37431845999778,6
0.05,8987,95,758367,84.37550066755674,6
0.05,8988,94,758461,84.37657136500167,7
0.05,8989,96,758557,84.37786429365963,6
0.05,8990,94,758651,84.3789344900456,7
0.05,8991,94,758745,84.38000444839858,7
0.05,8992,93,758838,84.38096297119982,8
0.05,8993,96,758934,84.3822548365577,6
0.05,8994,90,759024,84.3828793774319,11
0.05,8995,96,759120,84.38417074255224,6
0.05,8996,91,759211,84.38490607980438,10
0.05,8997,96,759307,84.3861969326517,6
0.05,8998,94,759401,84.38726525169463,7
0.05,8999,92,759493,84.38811111111112,9
0.05,9000,95,759588,84.38929007888012,6
0.05,9001,92,759680,84.3901355254388,9
0.05,9002,94,759774,84.39120293235588,7
0.05,9003,94,759868,84.39227010217681,7
0.05,9004,93,759961,84.39322598556357,8
0.05,9005,93,760054,84.39418165667333,8
0.05,9006,95,760149,84.39535916509382,6
0.05,9007,91,760240,84.39609236234459,10
0.05,9008,94,760334,84.39715839715839,7
0.05,9009,94,760428,84.39822419533851,7
0.05,9010,96,760524,84.39951170791255,6
0.05,9011,94,760618,84.4005770084332,7
0.05,9012,86,760704,84.40075446577167,15
0.05,9013,95,760799,84.40193033059685,6
0.05,9014,94,760893,84.40299500831946,7
0.05,9015,94,760987,84.4040594498669,7
0.05,9016,96,761083,84.40534545857824,6
0.05,9017,93,761176,84.40629851408295,10
0.05,9018,94,761270,84.40736223528107,7
0.05,9019,88,761358,84.40776053215077,13
0.05,9020,92,761450,84.40860215053763,9
0.05,9021,94,761544,84.4096652626912,7
0.05,9022,96,761640,84.41094979496842,6
0.05,9023,95,761735,84.41212322695036,6
0.05,9024,94,761829,84.41318559556787,7
0.05,9025,94,761923,84.41424772878351,7
0.05,9026,92,762015,84.41508806912596,9
0.05,9027,92,762107,84.41592822330527,9
0.05,9028,95,762202,84.41710045409236,6
0.05,9029,94,762296,84.41816168327796,7
0.05,9030,94,762390,84.41922267744435,7
0.05,9031,94,762484,84.42028343666962,7
0.05,9032,94,762578,84.42134396103177,8
0.05,9033,92,762670,84.42218286473323,9
0.05,9034,96,762766,84.42346430547869,6
0.05,9035,95,762861,84.4246347941567,6
0.05,9036,96,762957,84.4259156799823,6
0.05,9037,95,763052,84.42708563841558,6
0.05,9038,94,763146,84.42814470627282,7
0.05,9039,94,763240,84.429203539823,9
0.05,9040,94,763334,84.4302621391439,7
0.05,9041,22,763356,84.42335766423358,10
0.05,9042,93,763449,84.42430609311069,8
0.05,9043,22,763471,84.41740380362671,10
0.05,9044,93,763564,84.41835268103925,8
0.05,9045,96,763660,84.41963298695556,6
0.05,9046,94,763754,84.42069194208025,7
0.05,9047,95,763849,84.42186118479222,6
0.05,9048,95,763944,84.42303016907945,6
0.05,9049,95,764039,84.42419889502763,6
0.05,9050,23,764062,84.4174124406143,9
0.05,9051,95,764157,84.41858152894388,6
0.05,9052,94,764251,84.41963989837623,7
0.05,9053,91,764342,84.42036668875635,10
0.05,9054,94,764436,84.42142462727774,7
0.05,9055,91,764527,84.42215106007068,10
0.05,9056,96,764623,84.42342939163078,6
0.05,9057,93,764716,84.42437624199603,8
0.05,9058,95,764811,84.42554365824043,6
0.05,9059,93,764904,84.42649006622517,8
0.05,9060,94,764998,84.42754662840746,8
0.05,9061,93,765091,84.42849260648863,8
0.05,9062,90,765181,84.42910735959396,11
0.05,9063,95,765276,84.43027360988526,6
0.05,9064,94,765370,84.43132928847214,7
0.05,9065,93,765463,84.43227443194353,8
0.05,9066,95,765558,84.43343994706078,6
0.05,9067,95,765653,84.4346052051169,6
0.05,9068,93,765746,84.43554967471607,8
0.05,9069,96,765842,84.43682469680265,6
0.05,9070,94,765936,84.43787895491126,8
0.05,9071,94,766030,84.43893298059965,7
0.05,9072,94,766124,84.43998677394467,7
0.05,9073,93,766217,84.44093013004188,9
0.05,9074,94,766311,84.44198347107438,7
0.05,9075,96,766407,84.44325694138386,6
0.05,9076,94,766501,84.4443097939848,8
0.05,9077,94,766595,84.44536241462878,7
0.05,9078,92,766687,84.44619451481441,9
0.05,9079,94,766781,84.44724669603524,7
0.05,9080,93,766874,84.44818852549278,8
0.05,9081,95,766969,84.44935036335609,6
0.05,9082,87,767056,84.44963117912584,14
0.05,9083,95,767151,84.4507926023778,6
0.05,9084,94,767245,84.45184369840396,7
0.05,9085,89,767334,84.45234426590359,12
0.05,9086,96,767430,84.45361505447342,6
0.05,9087,95,767525,84.45477552816901,8
0.05,9088,92,767617,84.45560567719221,9
0.05,9089,91,767708,84.45632563256325,10
0.05,9090,92,767800,84.45715542844572,9
0.05,9091,95,767895,84.45831500219974,6
0.05,9092,93,767988,84.45925437149455,8
0.05,9093,91,768079,84.45997360897294,10
0.05,9094,96,768175,84.4612424409016,6
0.05,9095,94,768269,84.4622911169745,7
0.05,9096,95,768364,84.46344948884247,6
0.05,9097,93,768457,84.46438777753352,8
0.05,9098,91,768548,84.4651060556105,10
0.05,9099,94,768642,84.46615384615384,7
0.05,9100,91,768733,84.46687177233271,10
0.05,9101,93,768826,84.46780927268732,8
0.05,9102,27,768853,84.46149621004065,6
0.05,9103,27,768880,84.45518453427066,6
0.05,9104,94,768974,84.4562328390994,7
0.05,9105,92,769066,84.45706127827806,9
0.05,9106,96,769162,84.45832875809816,6
0.05,9107,94,769256,84.45937637241985,7
0.05,9108,93,769349,84.46031397518938,8
0.05,9109,94,769443,84.46136114160264,7
0.05,9110,92,769535,84.46218856327516,9
0.05,9111,96,769631,84.46345478489903,6
0.05,9112,95,769726,84.46461099528146,6
0.05,9113,94,769820,84.46565723063419,8
0.05,9114,94,769914,84.46670323642348,7
0.05,9115,92,770006,84.46752961825362,9
0.05,9116,95,770101,84.46868487441044,7
0.05,9117,92,770193,84.46951085764422,10
0.05,9118,96,770289,84.47077530430968,7
0.05,9119,93,770382,84.47171052631579,8
0.05,9120,96,770478,84.47297445455543,6
0.05,9121,94,770572,84.47401885551415,7
0.05,9122,92,770664,84.47484380138113,9
0.05,9123,93,770757,84.47577816747041,8
0.05,9124,94,770851,84.47682191780822,7
0.05,9125,94,770945,84.4778654394039,7
0.05,9126,93,771038,84.4787991673058,8
0.05,9127,94,771132,84.47984224364592,7
0.05,9128,94,771226,84.48088509146676,7
0.05,9129,94,771320,84.48192771084338,7
0.05,9130,94,771414,84.48297010185084,7
0.05,9131,94,771508,84.48401226456417,7
0.05,9132,90,771598,84.48461622686959,11
0.05,9133,92,771690,84.4854390190497,9
0.05,9134,96,771786,84.48669950738916,6
0.05,9135,93,771879,84.48763134851139,8
0.05,9136,91,771970,84.48834409543613,10
0.05,9137,93,772063,84.48927555263734,8
0.05,9138,94,772157,84.49031622715833,7
0.05,9139,96,772253,84.49157549234135,6
0.05,9140,-44,772209,84.47751887102068,8
0.05,9141,90,772299,84.47812294902647,11
0.05,9142,94,772393,84.47916438805643,7
0.05,9143,93,772486,84.48009623797026,8
0.05,9144,95,772581,84.48124658283214,7
0.05,9145,95,772676,84.48239667614257,6
0.05,9146,92,772768,84.48321854159833,9
0.05,9147,94,772862,84.4842588543944,7
0.05,9148,96,772958,84.48551754290087,6
0.05,9149,92,773050,84.48633879781421,9
0.05,9150,95,773145,84.4874877062616,6
0.05,9151,95,773240,84.48863636363636,7
0.05,9152,95,773335,84.48978477002076,6
0.05,9153,96,773431,84.49104216735853,6
0.05,9154,94,773525,84.49208083014746,7
0.05,9155,92,773617,84.4929008300568,9
0.05,9156,93,773710,84.49382985694004,8
0.05,9157,92,773802,84.49464948678751,10
0.05,9158,92,773894,84.49546893765695,9
0.05,9159,94,773988,84.49650655021834,7
0.05,9160,25,774013,84.49001200742278,8
0.05,9161,94,774107,84.49104998908535,7
0.05,9162,96,774203,84.49230601331442,6
0.05,9163,95,774298,84.49345264076823,6
0.05,9164,94,774392,84.49448990725587,7
0.05,9165,94,774486,84.49552694741436,7
0.05,9166,94,774580,84.49656376131777,7
0.05,9167,94,774674,84.49760034904014,7
0.05,9168,96,774770,84.4988548369506,6
0.05,9169,94,774864,84.49989094874591,7
0.05,9170,94,774958,84.50092683458729,7
0.05,9171,96,775054,84.50218054949848,6
0.05,9172,96,775150,84.50343399106072,6
0.05,9173,95,775245,84.5045781556573,6
0.05,9174,92,775337,84.50539509536785,9
0.05,9175,94,775431,84.5064298169137,7
0.05,9176,92,775523,84.5072463768116,9
0.05,9177,93,775616,84.50817171497059,8
0.05,9178,95,775711,84.50931474016778,6
0.05,9179,94,775805,84.510348583878,7
0.05,9180,96,775901,84.51160004356824,6
0.05,9181,94,775995,84.51263341319974,7
0.05,9182,94,776089,84.5136665577698,7
0.05,9183,96,776185,84.51491724738676,6
0.05,9184,96,776281,84.51616766467066,6
0.05,9185,96,776377,84.51741780971042,6
0.05,9186,96,776473,84.51866768259497,6
0.05,9187,92,776565,84.51948193295603,9
0.05,9188,96,776661,84.52073130917401,6
0.05,9189,94,776755,84.52176278563657,8
0.05,9190,90,776845,84.52235882928952,11
0.05,9191,92,776937,84.5231723237598,9
0.05,9192,94,777031,84.5242031980855,7
0.05,9193,95,777126,84.52534261474875,6
0.05,9194,91,777217,84.52604676454595,10
0.05,9195,92,777309,84.52685950413223,9
0.05,9196,94,777403,84.5278895291943,7
0.05,9197,92,777495,84.52870189171558,9
0.05,9198,93,777588,84.52962278508534,8
0.05,9199,96,777684,84.53086956521739,6
0.05,9200,95,777779,84.53200739050104,6
0.05,9201,94,777873,84.5330362964573,7
0.05,9202,91,777964,84.53373899815277,10
0.05,9203,94,778058,84.53476749239461,8
0.05,9204,92,778150,84.5355784899511,9
0.05,9205,95,778245,84.53671518574842,6
0.05,9206,94,778339,84.53774302161399,8
0.05,9207,25,778364,84.53127715030408,7
0.05,9208,92,778456,84.53208817461179,9
0.05,9209,94,778550,84.53311617806732,7
0.05,9210,94,778644,84.53414395831072,7
0.05,9211,93,778737,84.53506296135475,8
0.05,9212,95,778832,84.53619884945186,6
0.05,9213,95,778927,84.53733449099197,6
0.05,9214,95,779022,84.53846988605534,6
0.05,9215,90,779112,84.5390625,11
0.05,9216,95,779207,84.54019746121297,6
0.05,9217,94,779301,84.541223692775,7
0.05,9218,95,779396,84.54235817333767,7
0.05,9219,93,779489,84.54327548806941,8
0.05,9220,94,779583,84.54430105194665,7
0.05,9221,95,779678,84.54543482975494,6
0.05,9222,94,779772,84.54645993711374,7
0.05,9223,96,779868,84.54770164787512,6
0.05,9224,94,779962,84.54872628726287,7
0.05,9225,93,780055,84.54964231519618,8
0.05,9226,95,780150,84.55077489975073,6
0.05,9227,94,780244,84.55179887299524,8
0.05,9228,92,780336,84.55260591613393,10
0.05,9229,94,780430,84.55362946912243,8
0.05,9230,95,780525,84.55476113097173,6
0.05,9231,26,780551,84.5484185441941,8
0.05,9232,88,780639,84.54879237517599,13
0.05,9233,90,780729,84.54938271604938,11
0.05,9234,91,780820,84.55008121277747,11
0.05,9235,94,780914,84.55110437418796,8
0.05,9236,93,781007,84.55201905380535,8
0.05,9237,90,781097,84.55260878978133,11
0.05,9238,93,781190,84.55352310856154,8
0.05,9239,96,781286,84.5547619047619,6
0.05,9240,94,781380,84.55578400605995,7
0.05,9241,90,781470,84.55637307942004,11
0.05,9242,91,781561,84.55707021529807,10
0.05,9243,94,781655,84.55809173517957,8
0.05,9244,95,781750,84.559221200649,8
0.05,9245,91,781841,84.55991780229289,10
0.05,9246,93,781934,84.56083053963448,8
0.05,9247,95,782029,84.56195934256056,6
0.05,9248,94,782123,84.56297978159802,7
0.05,9249,94,782217,84.564,7
0.05,9250,87,782304,84.56426332288402,14
0.05,9251,94,782398,84.5652831820147,8
0.05,9252,95,782493,84.56641089376419,6
0.05,9253,94,782587,84.56743030041063,7
0.05,9254,95,782682,84.56855753646677,6
0.05,9255,92,782774,84.56936041486604,9
0.05,9256,96,782870,84.57059522523495,6
0.05,9257,91,782961,84.57128969539858,10
0.05,9258,94,783055,84.57230802462469,7
0.05,9259,96,783151,84.57354211663068,6
0.05,9260,93,783244,84.57445200302344,8
0.05,9261,88,783332,84.57482185273159,14
0.05,9262,89,783421,84.57529957897009,12
0.05,9263,94,783515,84.57631692573402,7
0.05,9264,95,783610,84.5774419859687,6
0.05,9265,87,783697,84.57770343190158,14
0.05,9266,94,783791,84.57872018992123,7
0.05,9267,96,783887,84.57995252481658,6
0.05,9268,96,783983,84.58118459380731,6
0.05,9269,94,784077,84.5822006472492,8
0.05,9270,23,784100,84.57555819221227,9
0.05,9271,94,784194,84.57657463330457,7
0.05,9272,94,784288,84.57759085517093,7
0.05,9273,95,784383,84.57871468621954,6
0.05,9274,89,784472,84.57919137466307,12
0.05,9275,94,784566,84.58020698576973,7
0.05,9276,94,784660,84.5812223779239,8
0.05,9277,94,784754,84.58223755119639,7
0.05,9278,94,784848,84.58325250565794,7
0.05,9279,96,784944,84.5844827586207,6
0.05,9280,86,785030,84.58463527637107,15
0.05,9281,94,785124,84.58564964447318,7
0.05,9282,95,785219,84.58677151782828,7
0.05,9283,94,785313,84.58778543731151,7
0.05,9284,94,785407,84.58879913839526,7
0.05,9285,95,785502,84.58992031014431,6
0.05,9286,95,785597,84.59104124044363,6
0.05,9287,94,785691,84.59205426356588,7
0.05,9288,96,785787,84.59328237700505,6
0.05,9289,93,785880,84.59418729817007,8
0.05,9290,92,785972,84.59498439349909,9
0.05,9291,96,786068,84.59621179509256,7
0.05,9292,94,786162,84.59722371677607,7
0.05,9293,95,786257,84.59834301700022,6
0.05,9294,96,786353,84.59956966110812,6
0.05,9295,90,786443,84.60015060240964,11
0.05,9296,96,786539,84.60137678821125,6
0.05,9297,94,786633,84.60238761023876,7
0.05,9298,94,786727,84.60339821486181,7
0.05,9299,94,786821,84.60440860215054,7
0.05,9300,95,786916,84.60552628749596,6
0.05,9301,93,787009,84.60642872500537,8
0.05,9302,96,787105,84.60765344512522,6
0.05,9303,94,787199,84.60866294067068,7
0.05,9304,94,787293,84.60967221923697,7
0.05,9305,95,787388,84.6107887384483,6
0.05,9306,94,787482,84.61179757172022,7
0.05,9307,94,787576,84.61280618822518,7
0.05,9308,94,787670,84.61381458803308,7
0.05,9309,93,787763,84.61471535982814,8
0.05,9310,92,787855,84.61550853828804,9
0.05,9311,96,787951,84.61673109965636,6
0.05,9312,94,788045,84.61773864490497,8
0.05,9313,95,788140,84.61885333905948,6
0.05,9314,92,788232,84.61964573268921,9
0.05,9315,95,788327,84.62075998282525,6
0.05,9316,92,788419,84.62155200171729,9
0.05,9317,95,788514,84.62266580811333,6
0.05,9318,94,788608,84.62367206781843,8
0.05,9319,95,788703,84.62478540772533,6
0.05,9320,94,788797,84.62579122411758,7
0.05,9321,90,788887,84.6263677322463,11
0.05,9322,93,788980,84.62726590153385,8
0.05,9323,92,789072,84.62805662805663,9
0.05,9324,91,789163,84.62873994638069,10
0.05,9325,92,789255,84.62953034527129,9
0.05,9326,94,789349,84.63053500589686,7
0.05,9327,95,789444,84.63164665523156,6
0.05,9328,96,789540,84.63286525887018,6
0.05,9329,96,789636,84.63408360128618,6
0.05,9330,94,789730,84.63508734326439,8
0.05,9331,95,789825,84.63619802828975,6
0.05,9332,91,789916,84.63687988856745,10
0.05,9333,92,790008,84.6376687379473,9
0.05,9334,92,790100,84.63845741831815,9
0.05,9335,92,790192,84.63924592973436,9
0.05,9336,92,790284,84.64003427225019,9
0.05,9337,89,790373,84.64050117798244,14
0.05,9338,95,790468,84.64161045079773,6
0.05,9339,88,790556,84.64197002141327,13
0.05,9340,93,790649,84.64286478963709,8
0.05,9341,95,790744,84.643973453222,7
0.05,9342,94,790838,84.64497484747939,8
0.05,9343,95,790933,84.64608304794521,6
0.05,9344,94,791027,84.64708400214018,7
0.05,9345,95,791122,84.64819173978172,6
0.05,9346,94,791216,84.6491922541992,7
0.05,9347,96,791312,84.65040650406505,6
0.05,9348,92,791404,84.65119264092417,9
0.05,9349,93,791497,84.65208556149733,8
0.05,9350,94,791591,84.65308523152603,7
0.05,9351,94,791685,84.65408468776732,7
0.05,9352,96,791781,84.65529776542286,6
0.05,9353,94,791875,84.65629677143468,7
0.05,9354,89,791964,84.65676109032603,12
0.05,9355,87,792051,84.65701154339462,15
0.05,9356,92,792143,84.65779630223362,9
0.05,9357,94,792237,84.65879461423381,7
0.05,9358,96,792333,84.66000641094134,6
0.05,9359,92,792425,84.6607905982906,9
0.05,9360,93,792518,84.66168144429014,9
0.05,9361,93,792611,84.66257209997863,9
0.05,9362,27,792638,84.65641354266795,6
0.05,9363,92,792730,84.65719777872704,9
0.05,9364,90,792820,84.65776828617192,12
0.05,9365,95,792915,84.65887251761691,7
0.05,9366,94,793009,84.65986975552471,7
0.05,9367,91,793100,84.66054654141759,10
0.05,9368,94,793194,84.66154338776818,7
0.05,9369,94,793288,84.66254002134471,7
0.05,9370,94,793382,84.66353644221535,8
0.05,9371,94,793476,84.66453265044814,7
0.05,9372,93,793569,84.6654219566841,8
0.05,9373,93,793662,84.66631107318113,8
0.05,9374,94,793756,84.66730666666666,7
0.05,9375,94,793850,84.66830204778157,7
0.05,9376,92,793942,84.66908392876186,9
0.05,9377,92,794034,84.66986564299424,9
0.05,9378,95,794129,84.67096705405693,7
0.05,9379,94,794223,84.67196162046908,7
0.05,9380,96,794319,84.6731691717301,6
0.05,9381,95,794414,84.67426987849073,6
0.05,9382,93,794507,84.67515719919002,8
0.05,9383,94,794601,84.67615089514067,7
0.05,9384,96,794697,84.67735748534896,6
0.05,9385,94,794791,84.67835073513744,8
0.05,9386,96,794887,84.67955683391925,6
0.05,9387,27,794914,84.67341286749041,6
0.05,9388,95,795009,84.67451272766003,7
0.05,9389,26,795035,84.66826411075613,7
0.05,9390,94,795129,84.6692578000213,7
0.05,9391,94,795223,84.67025127768314,7
0.05,9392,87,795310,84.67049930799531,14
0.05,9393,94,795404,84.67149244198424,8
0.05,9394,92,795496,84.67227248536456,9
0.05,9395,94,795590,84.67326521924223,7
0.05,9396,95,795685,84.67436415877408,6
0.05,9397,93,795778,84.6752500532028,8
0.05,9398,94,795872,84.67624215342057,7
0.05,9399,27,795899,84.67010638297873,6
0.05,9400,92,795991,84.67088607594937,9
0.05,9401,94,796085,84.67187832376091,7
0.05,9402,96,796181,84.67308305859832,6
0.05,9403,94,796275,84.67407486176096,8
0.05,9404,94,796369,84.67506645401382,7
0.05,9405,92,796461,84.67584520518818,9
0.05,9406,93,796554,84.67673009461039,8
0.05,9407,96,796650,84.67793367346938,6
0.05,9408,94,796744,84.6789244340525,7
0.05,9409,93,796837,84.6798087141339,8
0.05,9410,96,796933,84.68101158219105,6
0.05,9411,93,797026,84.68189545261369,8
0.05,9412,92,797118,84.68267289918198,9
0.05,9413,94,797212,84.68366263012534,8
0.05,9414,92,797304,84.68443972384493,9
0.05,9415,93,797397,84.68532285471538,8
0.05,9416,96,797493,84.68652437081873,7
0.05,9417,95,797588,84.68761945211297,6
0.05,9418,96,797684,84.68882046926426,6
0.05,9419,92,797776,84.6895966029724,9
0.05,9420,94,797870,84.6905848636026,8
0.05,9421,96,797966,84.69178518361282,7
0.05,9422,95,798061,84.69287912554388,6
0.05,9423,90,798151,84.69344227504244,11
0.05,9424,92,798243,84.6942175066313,9
0.05,9425,94,798337,84.69520475281138,7
0.05,9426,87,798424,84.69544924154026,14
0.05,9427,94,798518,84.69643614764531,7
0.05,9428,92,798610,84.69721073284548,9
0.05,9429,94,798704,84.698197242842,7
0.05,9430,27,798731,84.69207931290426,6
0.05,9431,94,798825,84.69306615776081,7
0.05,9432,94,798919,84.69405279338493,7
0.05,9433,92,799011,84.69482722069112,9
0.05,9434,96,799107,84.69602543720191,6
0.05,9435,92,799199,84.69679949130987,9
0.05,9436,96,799295,84.69799724488715,6
0.05,9437,-46,799249,84.68414918414918,9
0.05,9438,95,799344,84.68524208072888,6
0.05,9439,96,799440,84.6864406779661,7
0.05,9440,96,799536,84.68763902129012,7
0.05,9441,92,799628,84.68841347172209,9
0.05,9442,94,799722,84.68939955522609,7
0.05,9443,94,799816,84.69038542990258,7
0.05,9444,94,799910,84.6913710958179,7
0.05,9445,94,800004,84.69235655303832,7
0.05,9446,95,800099,84.69344765534032,6
0.05,9447,94,800193,84.69443268416596,7
0.05,9448,96,800289,84.69562916710763,6
0.05,9449,96,800385,84.6968253968254,6
0.05,9450,94,800479,84.69780975558142,8
0.05,9451,93,800572,84.69868810833685,8
0.05,9452,91,800663,84.69935470221094,10
0.05,9453,93,800756,84.70023270573303,8
0.05,9454,92,800848,84.70100475938656,9
0.05,9455,92,800940,84.7017766497462,9
0.05,9456,94,801034,84.70275986042085,7
0.05,9457,95,801129,84.70384859378304,6
0.05,9458,27,801156,84.69774817634,6
0.05,9459,90,801246,84.69830866807611,11
0.05,9460,93,801339,84.69918613254413,8
0.05,9461,95,801434,84.7002747833439,6
0.05,9462,92,801526,84.7010461798584,9
0.05,9463,93,801619,84.70192307692308,8
0.05,9464,96,801715,84.70311674590597,6
0.05,9465,95,801810,84.70420452144518,6
0.05,9466,89,801899,84.70465828668004,12
0.05,9467,91,801990,84.70532319391636,10
0.05,9468,94,802084,84.7063047840321,7
0.05,9469,94,802178,84.70728616684266,8
0.05,9470,96,802274,84.70847851335657,6
0.05,9471,95,802369,84.70956503378379,7
0.05,9472,94,802463,84.71054576163834,7
0.05,9473,94,802557,84.71152628245726,7
0.05,9474,94,802651,84.71250659630607,7
0.05,9475,95,802746,84.7135922330097,6
0.05,9476,94,802840,84.71457212197953,7
0.05,9477,94,802934,84.71555180417809,8
0.05,9478,96,803030,84.7167422723916,6
0.05,9479,91,803121,84.71740506329114,10
0.05,9480,93,803214,84.71827866258833,8
0.05,9481,92,803306,84.71904661463826,9
0.05,9482,94,803400,84.7200253084467,7
0.05,9483,94,803494,84.72100379586672,7
0.05,9484,94,803588,84.72198207696363,7
0.05,9485,94,803682,84.72296015180265,7
0.05,9486,94,803776,84.72393802044904,7
0.05,9487,95,803871,84.72502107925801,7
0.05,9488,94,803965,84.72599852460743,8
0.05,9489,92,804057,84.72676501580611,9
0.05,9490,94,804151,84.7277420714361,8
0.05,9491,27,804178,84.72166034555416,6
0.05,9492,95,804273,84.72274307384389,8
0.05,9493,95,804368,84.72382557404677,6
0.05,9494,93,804461,84.7246972090574,8
0.05,9495,94,804555,84.72567396798652,7
0.05,9496,93,804648,84.72654522480784,8
0.05,9497,92,804740,84.72731101284481,9
0.05,9498,96,804836,84.72849773660386,6
0.05,9499,92,804928,84.72926315789474,9
0.05,9500,92,805020,84.73002841806125,9
0.05,9501,92,805112,84.73079351715428,9
0.05,9502,94,805206,84.73176891507944,8
0.05,9503,92,805298,84.73253367003367,9
0.05,9504,94,805392,84.7335086796423,7
0.05,9505,96,805488,84.73469387755102,6
0.05,9506,96,805584,84.73587882612811,7
0.05,9507,94,805678,84.73685317627262,7
0.05,9508,96,805774,84.73803764854348,6
0.05,9509,90,805864,84.73859095688749,11
0.05,9510,94,805958,84.73956471454106,7
0.05,9511,95,806053,84.74064339781329,6
0.05,9512,27,806080,84.73457374119626,6
0.05,9513,94,806174,84.73554761404246,7
0.05,9514,93,806267,84.7364161849711,9
0.05,9515,96,806363,84.73759983186213,6
0.05,9516,96,806459,84.73878323000946,6
0.05,9517,92,806551,84.73954612313511,9
0.05,9518,96,806647,84.74072906817943,6
0.05,9519,93,806740,84.74159663865547,8
0.05,9520,94,806834,84.74256905787207,8
0.05,9521,94,806928,84.74354127284184,8
0.05,9522,93,807021,84.74440827470335,8
0.05,9523,92,807113,84.74517009659807,10
0.05,9524,95,807208,84.7462467191601,6
0.05,9525,92,807300,84.74700818811674,9
0.05,9526,94,807394,84.74797942689199,7
0.05,9527,95,807489,84.74905541561712,6
0.05,9528,90,807579,84.74960646447686,11
0.05,9529,95,807674,84.75068205666317,6
0.05,9530,96,807770,84.75186234393033,6
0.05,9531,96,807866,84.75304238355015,6
0.05,9532,92,807958,84.75380258050981,9
0.05,9533,93,808051,84.75466750576882,8
0.05,9534,94,808145,84.75563712637651,7
0.05,9535,96,808241,84.75681627516778,6
0.05,9536,94,808335,84.75778546712803,7
0.05,9537,92,808427,84.75854476829524,9
0.05,9538,96,808523,84.75972324142992,6
0.05,9539,93,808616,84.76058700209644,8
0.05,9540,94,808710,84.76155539251651,7
0.05,9541,92,808802,84.76231398029763,9
0.05,9542,89,808891,84.76275804254428,12
0.05,9543,93,808984,84.76362112321878,8
0.05,9544,96,809080,84.7647983237297,6
0.05,9545,96,809176,84.76597527760319,6
0.05,9546,95,809271,84.76704723997067,6
0.05,9547,95,809366,84.76811897779639,7
0.05,9548,93,809459,84.76898104513562,8
0.05,9549,95,809554,84.77005235602094,6
0.05,9550,94,809648,84.77101874149304,7
0.05,9551,95,809743,84.77208961474037,6
0.05,9552,21,809764,84.7654140060714,12
0.05,9553,94,809858,84.76638057358174,7
0.05,9554,95,809953,84.76745159602302,6
0.05,9555,94,810047,84.76841774801171,8
0.05,9556,95,810142,84.76948833315895,6
0.05,9557,94,810236,84.7704540698891,7
0.05,9558,94,810330,84.77141960456115,7
0.05,9559,88,810418,84.77175732217573,16
0.05,9560,92,810510,84.77251333542516,10
0.05,9561,95,810605,84.77358293244092,6
0.05,9562,94,810699,84.77454773606608,7
0.05,9563,92,810791,84.77530322040987,9
0.05,9564,93,810884,84.77616309461578,8
0.05,9565,95,810979,84.77723186284759,6
0.05,9566,96,811075,84.778404933626,6
0.05,9567,94,811169,84.77936872909699,7
0.05,9568,93,811262,84.78022781899885,8
0.05,9569,96,811358,84.78140020898641,6
0.05,9570,96,811454,84.782572353986,6
0.05,9571,90,811544,84.78311742582532,11
0.05,9572,96,811640,84.78428914655802,6
0.05,9573,96,811736,84.78546062251932,6
0.05,9574,92,811828,84.7862140992167,10
0.05,9575,95,811923,84.78728070175438,6
0.05,9576,92,812015,84.78803383105357,9
0.05,9577,94,812109,84.78899561495093,7
0.05,9578,94,812203,84.78995719803737,7
0.05,9579,91,812294,84.79060542797495,10
0.05,9580,96,812390,84.79177538879031,6
0.05,9581,92,812482,84.7925276560217,9
0.05,9582,94,812576,84.79348846916415,7
0.05,9583,92,812668,84.79424040066777,9
0.05,9584,92,812760,84.79499217527386,9
0.05,9585,94,812854,84.795952430628,7
0.05,9586,95,812949,84.79701679357463,6
0.05,9587,95,813044,84.79808093450146,6
0.05,9588,96,813140,84.79924913963917,6
0.05,9589,93,813233,84.80010427528676,8
0.05,9590,92,813325,84.80085496819936,9
0.05,9591,94,813419,84.8018140116764,7
0.05,9592,94,813513,84.80277285520692,7
0.05,9593,91,813604,84.80341880341881,11
0.05,9594,89,813693,84.8038561750912,12
0.05,9595,96,813789,84.80502292621925,6
0.05,9596,92,813881,84.80577263728249,9
0.05,9597,94,813975,84.80673056886852,10
0.05,9598,93,814068,84.80758412334619,8
0.05,9599,94,814162,84.80854166666667,7
0.05,9600,93,814255,84.80939485470263,8
0.05,9601,89,814344,84.80983128514893,12
0.05,9602,92,814436,84.81058002707488,9
0.05,9603,96,814532,84.81174510620575,6
0.05,9604,93,814625,84.81259760541384,8
0.05,9605,94,814719,84.81355402873204,7
0.05,9606,96,814815,84.81471843447486,6
0.05,9607,94,814909,84.81567443796835,8
0.05,9608,94,815003,84.81663024248101,7
0.05,9609,90,815093,84.8171696149844,11
0.05,9610,94,815187,84.81812506502965,7
0.05,9611,96,815283,84.8192883895131,6
0.05,9612,95,815378,84.82034744616665,8
0.05,9613,95,815473,84.82140628250468,6
0.05,9614,94,815567,84.82236089443577,7
0.05,9615,94,815661,84.8233153078203,7
0.05,9616,95,815756,84.82437350525112,7
0.05,9617,89,815845,84.82480765231857,12
0.05,9618,96,815941,84.82596943549225,6
0.05,9619,93,816034,84.82681912681913,8
0.05,9620,93,816127,84.82766864151336,8
0.05,9621,94,816221,84.8286219081272,8
0.05,9622,95,816316,84.8296788943157,7
0.05,9623,92,816408,84.83042394014963,10
0.05,9624,17,816425,84.82337662337662,16
0.05,9625,94,816519,84.82432993974652,7
0.05,9626,92,816611,84.8250753090267,11
0.05,9627,94,816705,84.82602825093477,7
0.05,9628,94,816799,84.82698099491121,7
0.05,9629,93,816892,84.82782969885774,9
0.05,9630,95,816987,84.82888588931576,6
0.05,9631,93,817080,84.8297342192691,9
0.05,9632,94,817174,84.8306861829129,7
0.05,9633,96,817270,84.83184554702096,6
0.05,9634,92,817362,84.83258951738453,9
0.05,9635,94,817456,84.8335408883354,7
0.05,9636,92,817548,84.8342845283802,9
0.05,9637,94,817642,84.83523552604275,7
0.05,9638,91,817733,84.83587509077705,12
0.05,9639,96,817829,84.83703319502075,6
0.05,9640,95,817924,84.83808733533866,6
0.05,9641,94,818018,84.839037544078,7
0.05,9642,92,818110,84.83978015140517,9
0.05,9643,94,818204,84.84072998755703,7
0.05,9644,96,818300,84.84188698807672,6
0.05,9645,94,818394,84.84283640887415,7
0.05,9646,93,818487,84.84368197367057,9
0.05,9647,93,818580,84.84452736318408,8
0.05,9648,93,818673,84.84537257746916,8
0.05,9649,94,818767,84.84632124352332,8
0.05,9650,93,818860,84.84716609677754,8
0.05,9651,96,818956,84.84832159138003,6
0.05,9652,94,819050,84.84926965710142,7
0.05,9653,96,819146,84.85042469442718,6
0.05,9654,94,819240,84.85137234593475,7
0.05,9655,92,819332,84.85211267605634,9
0.05,9656,95,819427,84.85316350833592,9
0.05,9657,94,819521,84.85411058190101,7
0.05,9658,90,819611,84.85464333781965,11
0.05,9659,91,819702,84.85527950310559,10
0.05,9660,96,819798,84.85643308146155,6
0.05,9661,96,819894,84.85758642103085,6
0.05,9662,95,819989,84.85863603435786,6
0.05,9663,94,820083,84.85958195364239,7
0.05,9664,92,820175,84.86032074495603,9
0.05,9665,92,820267,84.86105938340575,10
0.05,9666,95,820362,84.8621082031654,6
0.05,9667,92,820454,84.8628465039305,9
0.05,9668,94,820548,84.86379149860379,7
0.05,9669,95,820643,84.86483971044467,6
0.05,9670,94,820737,84.86578430358804,7
0.05,9671,94,820831,84.86672870140612,7
0.05,9672,95,820926,84.86777628450325,6
0.05,9673,-45,820881,84.85435187099442,10
0.05,9674,94,820975,84.85529715762274,7
0.05,9675,93,821068,84.85613890037206,9
0.05,9676,94,821162,84.85708380696497,7
0.05,9677,25,821187,84.85089894606324,8
0.05,9678,93,821280,84.85174088232256,8
0.05,9679,93,821373,84.8525826446281,8
0.05,9680,96,821469,84.8537341183762,6
0.05,9681,94,821563,84.85467878537493,7
0.05,9682,96,821659,84.85582980481256,6
0.05,9683,96,821755,84.85698058653449,6
0.05,9684,93,821848,84.85782137325762,8
0.05,9685,95,821943,84.85886846995663,6
0.05,9686,94,822037,84.85981211933519,7
0.05,9687,96,822133,84.86096201486374,6
0.05,9688,92,822225,84.86169883372897,9
0.05,9689,94,822319,84.86264189886481,7
0.05,9690,96,822415,84.86379114642452,6
0.05,9691,94,822509,84.86473380107304,7
0.05,9692,94,822603,84.86567626121943,7
0.05,9693,94,822697,84.86661852692387,7
0.05,9694,93,822790,84.867457452295,8
0.05,9695,92,822882,84.86819306930693,9
0.05,9696,94,822976,84.8691347839538,7
0.05,9697,96,823072,84.87028253248093,6
0.05,9698,93,823165,84.8711207340963,8
0.05,9699,94,823259,84.8720618556701,7
0.05,9700,92,823351,84.87279661890527,9
0.05,9701,92,823443,84.87353123067409,9
0.05,9702,91,823534,84.8741626301144,10
0.05,9703,92,823626,84.87489694971146,10
0.05,9704,93,823719,84.8757341576507,8
0.05,9705,95,823814,84.87677725118483,7
0.05,9706,95,823909,84.87782012980324,6
0.05,9707,25,823934,84.87165224557066,8
0.05,9708,94,824028,84.87259244000413,7
0.05,9709,94,824122,84.8735324407827,7
0.05,9710,94,824216,84.87447224796622,7
0.05,9711,94,824310,84.8754118616145,7
0.05,9712,90,824400,84.87593946257593,11
0.05,9713,94,824494,84.8768787317274,7
0.05,9714,94,824588,84.87781780751415,7
0.05,9715,96,824684,84.87896253602305,6
0.05,9716,95,824779,84.88000411649686,7
0.05,9717,92,824871,84.88073677711463,9
0.05,9718,91,824962,84.88136639571972,10
0.05,9719,95,825057,84.88240740740741,7
0.05,9720,95,825152,84.88344820491719,8
0.05,9721,93,825245,84.8842830693273,8
0.05,9722,93,825338,84.88511776200761,8
0.05,9723,92,825430,84.88584944467297,9
0.05,9724,93,825523,84.88668380462725,8
0.05,9725,93,825616,84.88751799300843,8
0.05,9726,20,825636,84.88084712655495,14
0.05,9727,95,825731,84.88188733552632,7
0.05,9728,96,825827,84.8830301161476,6
0.05,9729,91,825918,84.88365878725591,10
0.05,9730,92,826010,84.88439009351556,10
0.05,9731,95,826105,84.8854295108919,6
0.05,9732,95,826200,84.88646871468201,7
0.05,9733,96,826296,84.88761043764126,6
0.05,9734,95,826391,84.88864920390344,6
0.05,9735,95,826486,84.88968775677897,7
0.05,9736,95,826581,84.89072609633357,6
0.05,9737,92,826673,84.8914561511604,9
0.05,9738,94,826767,84.89239141595647,7
0.05,9739,94,826861,84.89332648870636,7
0.05,9740,94,826955,84.89426136946925,8
0.05,9741,95,827050,84.89529870663108,6
0.05,9742,96,827146,84.89643846864415,6
0.05,9743,96,827242,84.89757799671592,6
0.05,9744,92,827334,84.89830682401231,9
0.05,9745,95,827429,84.89934332033654,7
0.05,9746,92,827521,84.90007181696933,9
0.05,9747,95,827616,84.90110791957325,6
0.05,9748,94,827710,84.90204123499846,7
0.05,9749,95,827805,84.90307692307692,6
0.05,9750,96,827901,84.90421495231259,6
0.05,9751,95,827996,84.90525020508613,8
0.05,9752,95,828091,84.90628524556547,7
0.05,9753,92,828183,84.90701250768916,9
0.05,9754,96,828279,84.90814966683752,6
0.05,9755,95,828374,84.90918409184091,6
0.05,9756,95,828469,84.9102183048068,6
0.05,9757,96,828565,84.91135478581677,6
0.05,9758,94,828659,84.91228609488677,7
0.05,9759,94,828753,84.91321721311475,7
0.05,9760,94,828847,84.91414814055936,9
0.05,9761,94,828941,84.91507887727924,7
0.05,9762,93,829034,84.91590699580047,8
0.05,9763,93,829127,84.9167349446948,8
0.05,9764,95,829222,84.91776753712237,6
0.05,9765,94,829316,84.91869752201515,7
0.05,9766,91,829407,84.91932015972151,10
0.05,9767,93,829500,84.92014742014742,8
0.05,9768,96,829596,84.92128160507728,6
0.05,9769,94,829690,84.92221084953941,8
0.05,9770,90,829780,84.92273052911678,12
0.05,9771,95,829875,84.92376176831765,6
0.05,9772,92,829967,84.92448582830247,9
0.05,9773,95,830062,84.92551667689789,6
0.05,9774,92,830154,84.92624040920717,9
0.05,9775,96,830250,84.92737315875614,6
0.05,9776,96,830346,84.9285056765879,6
0.05,9777,95,830441,84.92953569237062,6
0.05,9778,94,830535,84.93046323754986,7
0.05,9779,96,830631,84.93159509202454,6
0.05,9780,93,830724,84.93241999795522,8
0.05,9781,93,830817,84.93324473522797,8
0.05,9782,27,830844,84.92732290708372,6
0.05,9783,89,830933,84.92773916598529,12
0.05,9784,95,831028,84.92876852324987,6
0.05,9785,93,831121,84.92959329654609,8
0.05,9786,96,831217,84.93072443036681,6
0.05,9787,96,831313,84.9318553330609,6
0.05,9788,90,831403,84.9323730718153,11
0.05,9789,95,831498,84.93340143003064,6
0.05,9790,94,831592,84.93432744357062,7
0.05,9791,96,831688,84.93545751633987,6
0.05,9792,94,831782,84.93638313080773,7
0.05,9793,95,831877,84.9374106595875,7
0.05,9794,96,831973,84.93854007146503,6
0.05,9795,91,832064,84.939158840343,10
0.05,9796,92,832156,84.9398795549658,9
0.05,9797,94,832250,84.94080424576444,7
0.05,9798,92,832342,84.94152464537197,11
0.05,9799,94,832436,84.94244897959183,7
0.05,9800,90,832526,84.94296500357106,11
0.05,9801,21,832547,84.93644154254234,11
0.05,9802,96,832643,84.93757013159237,6
0.05,9803,94,832737,84.93849449204406,8
0.05,9804,95,832832,84.9395206527282,6
0.05,9805,96,832928,84.94064858250051,6
0.05,9806,91,833019,84.94126644233711,10
0.05,9807,92,833111,84.94198613376835,9
0.05,9808,94,833205,84.94290957284127,7
0.05,9809,91,833296,84.94352701325178,10
0.05,9810,89,833385,84.94394047497707,13
0.05,9811,92,833477,84.9446596004892,10
0.05,9812,94,833571,84.9455823907062,7
0.05,9813,94,833665,84.94650499286733,7
0.05,9814,94,833759,84.94742740703006,7
0.05,9815,95,833854,84.94845150774246,6
0.05,9816,94,833948,84.94937353570337,7
0.05,9817,91,834039,84.94998981462619,10
0.05,9818,91,834130,84.95060596802118,10
0.05,9819,94,834224,84.95152749490835,7
0.05,9820,94,834318,84.95244883413095,7
0.05,9821,94,834412,84.95336998574628,7
0.05,9822,95,834507,84.95439275170519,6
0.05,9823,93,834600,84.95521172638436,8
0.05,9824,94,834694,84.95613231552163,7
0.05,9825,95,834789,84.95715448809281,6
0.05,9826,93,834882,84.95797293171873,8
0.05,9827,94,834976,84.95889295889296,7
0.05,9828,96,835072,84.96001627835996,6
0.05,9829,94,835166,84.96093591047813,7
0.05,9830,93,835259,84.96175363645611,8
0.05,9831,92,835351,84.96246948738812,9
0.05,9832,94,835445,84.96338858944371,7
0.05,9833,92,835537,84.96410412853366,9
0.05,9834,92,835629,84.9648195221149,9
0.05,9835,94,835723,84.9657381049207,7
0.05,9836,96,835819,84.96685981498425,6
0.05,9837,92,835911,84.96757471030698,9
0.05,9838,21,835932,84.96107327980486,11
0.05,9839,90,836022,84.96158536585367,12
0.05,9840,95,836117,84.96260542627782,6
0.05,9841,95,836212,84.96362527941476,6
0.05,9842,94,836306,84.96454333028548,7
0.05,9843,94,836400,84.96546119463633,7
0.05,9844,94,836494,84.96637887252412,7
0.05,9845,96,836590,84.96749949217957,6
0.05,9846,94,836684,84.96841677668326,7
0.05,9847,93,836777,84.96923233143785,8
0.05,9848,95,836872,84.97025078688192,6
0.05,9849,92,836964,84.97096446700507,9
0.05,9850,96,837060,84.97208405238047,6
0.05,9851,91,837151,84.97269589930978,11
0.05,9852,88,837239,84.97300314624988,13
0.05,9853,94,837333,84.97391922062107,7
0.05,9854,93,837426,84.97473363774733,8
0.05,9855,95,837521,84.97575081168831,6
0.05,9856,91,837612,84.97636197626052,10
0.05,9857,94,837706,84.97727733820247,7
0.05,9858,89,837795,84.97768536362715,12
0.05,9859,95,837890,84.9787018255578,6
0.05,9860,95,837985,84.97971808133049,7
0.05,9861,94,838079,84.98063273169743,7
0.05,9862,94,838173,84.98154719659333,7
0.05,9863,93,838266,84.9823600973236,9
0.05,9864,93,838359,84.98317283324886,8
0.05,9865,94,838453,84.9840867626191,7
0.05,9866,26,838479,84.97810884767406,7
0.05,9867,92,838571,84.97882042967167,9
0.05,9868,93,838664,84.97963319485257,9
0.05,9869,95,838759,84.9806484295846,6
0.05,9870,94,838853,84.98156215175767,7
0.05,9871,95,838948,84.98257698541329,6
0.05,9872,91,839039,84.98318646814545,10
0.05,9873,91,839130,84.98379582742557,10
0.05,9874,94,839224,84.9847088607595,7
0.05,9875,88,839312,84.98501417577967,13
0.05,9876,94,839406,84.98592690088084,7
0.05,9877,94,839500,84.98683944118243,8
0.05,9878,94,839594,84.98775179674055,7
0.05,9879,94,839688,84.98866396761133,7
0.05,9880,94,839782,84.98957595385083,7
0.05,9881,94,839876,84.99048775551508,7
0.05,9882,91,839967,84.99109582110695,11
0.05,9883,91,840058,84.99170376365844,10
0.05,9884,94,840152,84.99261507334344,7
0.05,9885,94,840246,84.99352619866478,7
0.05,9886,96,840342,84.99463942550824,6
0.05,9887,90,840432,84.99514563106796,11
0.05,9888,94,840526,84.99605622408737,7
0.05,9889,93,840619,84.99686552072801,8
0.05,9890,93,840712,84.99767465372561,9
0.05,9891,93,840805,84.9984836231298,8
0.05,9892,96,840901,84.99959567370868,6
0.05,9893,93,840994,85.00040428542552,8
0.05,9894,94,841088,85.00131379484588,7
0.05,9895,93,841181,85.00212206952304,8
0.05,9896,95,841276,85.0031322623017,7
0.05,9897,95,841371,85.00414225095979,6
0.05,9898,95,841466,85.00515203555915,6
0.05,9899,96,841562,85.00626262626263,6
0.05,9900,93,841655,85.00706999293001,9
0.05,9901,94,841749,85.007978186225,8
0.05,9902,95,841844,85.00898717560335,6
0.05,9903,94,841938,85.00989499192245,7
0.05,9904,96,842034,85.01100454316003,6
0.05,9905,93,842127,85.01181102362204,8
0.05,9906,94,842221,85.01271828000404,8
0.05,9907,25,842246,85.00666128381106,8
0.05,9908,94,842340,85.00756887677869,7
0.05,9909,94,842434,85.00847628657921,8
0.05,9910,96,842530,85.00958530925234,6
0.05,9911,94,842624,85.01049233252623,7
0.05,9912,93,842717,85.01129829516796,8
0.05,9913,94,842811,85.01220496267904,7
0.05,9914,95,842906,85.013212304589,6
0.05,9915,93,842999,85.01401774909237,8
0.05,9916,95,843094,85.01502470505193,6
0.05,9917,95,843189,85.01603145795524,6
0.05,9918,94,843283,85.01693719124911,7
0.05,9919,94,843377,85.01784274193548,7
0.05,9920,94,843471,85.01874811006955,7
0.05,9921,91,843562,85.01935093731103,12
0.05,9922,95,843657,85.02035674695152,6
0.05,9923,92,843749,85.02106005642887,9
0.05,9924,92,843841,85.02176322418136,9
0.05,9925,95,843936,85.02276848680233,6
0.05,9926,94,844030,85.02367281152412,7
0.05,9927,94,844124,85.0245769540693,7
0.05,9928,94,844218,85.0254809144929,7
0.05,9929,96,844314,85.02658610271904,6
0.05,9930,94,844408,85.02748967878361,7
0.05,9931,91,844499,85.02809101892872,10
0.05,9932,96,844595,85.02919561059096,6
0.05,9933,92,844687,85.02989732232736,9
0.05,9934,94,844781,85.03080020130851,7
0.05,9935,93,844874,85.03160225442834,8
0.05,9936,92,844966,85.03230351212639,9
0.05,9937,96,845062,85.03340712416986,6
0.05,9938,95,845157,85.03440990039239,6
0.05,9939,94,845251,85.03531187122736,8
0.05,9940,96,845347,85.03641484760084,6
0.05,9941,95,845442,85.03741701870851,7
0.05,9942,96,845538,85.03851956150055,6
0.05,9943,91,845629,85.03911906677394,11
0.05,9944,94,845723,85.04002011060835,7
0.05,9945,93,845816,85.04082043032375,8
0.05,9946,92,845908,85.04152005629838,9
0.05,9947,95,846003,85.0425211097708,7
0.05,9948,96,846099,85.04362247462056,6
0.05,9949,90,846189,85.04412060301507,12
0.05,9950,96,846285,85.04522158577028,6
0.05,9951,92,846377,85.04592041800643,9
0.05,9952,91,846468,85.0465186375967,10
0.05,9953,95,846563,85.04751858549326,6
0.05,9954,96,846659,85.04861878453039,6
0.05,9955,93,846752,85.04941743672157,8
0.05,9956,94,846846,85.0503163603495,7
0.05,9957,92,846938,85.05101425989155,10
0.05,9958,92,847030,85.05171201927904,9
0.05,9959,94,847124,85.05261044176707,7
0.05,9960,96,847220,85.05370946692099,6
0.05,9961,95,847315,85.05470788998193,8
0.05,9962,93,847408,85.05550536986851,8
0.05,9963,92,847500,85.05620232838217,9
0.05,9964,93,847593,85.05699949824385,8
0.05,9965,89,847682,85.05739514348785,13
0.05,9966,90,847772,85.05789104043343,12
0.05,9967,27,847799,85.05206661316213,6
0.05,9968,93,847892,85.05286387802187,8
0.05,9969,93,847985,85.05366098294884,8
0.05,9970,94,848079,85.05455821883461,7
0.05,9971,95,848174,85.05555555555556,6
0.05,9972,94,848268,85.05645242153815,8
0.05,9973,94,848362,85.05734910767997,7
0.05,9974,95,848457,85.05834586466166,7
0.05,9975,95,848552,85.05934242181235,6
0.05,9976,93,848645,85.0601383181317,8
0.05,9977,96,848741,85.06123471637602,6
0.05,9978,93,848834,85.06203026355347,8
0.05,9979,94,848928,85.06292585170341,7
0.05,9980,93,849021,85.06372107003307,8
0.05,9981,94,849115,85.06461630935684,7
0.05,9982,92,849207,85.06531102874888,10
0.05,9983,94,849301,85.06620592948718,7
0.05,9984,88,849389,85.06649974962444,13
0.05,9985,92,849481,85.06719407170038,9
0.05,9986,96,849577,85.06828877540804,6
0.05,9987,94,849671,85.06918301962355,7
0.05,9988,96,849767,85.07027730503555,6
0.05,9989,94,849861,85.07117117117117,8
0.05,9990,96,849957,85.07226503853468,6
0.05,9991,93,850050,85.0730584467574,8
0.05,9992,96,850146,85.07415190633444,6
0.05,9993,96,850242,85.07524514708825,6
0.05,9994,91,850333,85.07583791895948,10
0.05,9995,93,850426,85.0766306522609,8
0.05,9996,94,850520,85.07752325697709,7
0.05,9997,94,850614,85.07841568313663,7
0.05,9998,25,850639,85.07240724072408,8
0.05,9999,95,850734,85.0734,6
