0.2,0,-179,-179,-179.0,169
0.2,1,-1,-180,-90.0,33
0.2,2,81,-99,-33.0,43
0.2,3,11,-88,-22.0,49
0.2,4,1,-87,-17.4,108
0.2,5,-19,-106,-17.666666666666668,118
0.2,6,-132,-238,-34.0,45
0.2,7,82,-156,-19.5,58
0.2,8,-125,-281,-31.22222222222222,25
0.2,9,20,-261,-26.1,12
0.2,10,-6,-267,-24.272727272727273,120
0.2,11,96,-171,-14.25,7
0.2,12,16,-155,-11.923076923076923,45
0.2,13,94,-61,-4.357142857142857,7
0.2,14,6,-55,-3.6666666666666665,70
0.2,15,78,23,1.4375,61
0.2,16,14,37,2.176470588235294,72
0.2,17,24,61,3.388888888888889,18
0.2,18,15,76,4.0,34
0.2,19,94,170,8.5,22
0.2,20,96,266,12.666666666666666,11
0.2,21,93,359,16.318181818181817,10
0.2,22,-47,312,13.565217391304348,11
0.2,23,94,406,16.916666666666668,19
0.2,24,24,430,17.2,18
0.2,25,92,522,20.076923076923077,9
0.2,26,6,528,19.555555555555557,38
0.2,27,96,624,22.285714285714285,7
0.2,28,90,714,24.620689655172413,12
0.2,29,94,808,26.933333333333334,9
0.2,30,13,821,26.483870967741936,24
0.2,31,95,916,28.625,10
0.2,32,93,1009,30.575757575757574,9
0.2,33,-54,955,28.08823529411765,18
0.2,34,21,976,27.885714285714286,13
0.2,35,88,1064,29.555555555555557,25
0.2,36,22,1086,29.35135135135135,10
0.2,37,93,1179,31.026315789473685,10
0.2,38,83,1262,32.35897435897436,33
0.2,39,89,1351,33.775,12
0.2,40,95,1446,35.26829268292683,6
0.2,41,19,1465,34.88095238095238,16
0.2,42,92,1557,36.2093023255814,19
0.2,43,19,1576,35.81818181818182,20
0.2,44,95,1671,37.13333333333333,10
0.2,45,83,1754,38.130434782608695,43
0.2,46,94,1848,39.319148936170215,7
0.2,47,92,1940,40.416666666666664,13
0.2,48,94,2034,41.51020408163265,7
0.2,49,95,2129,42.58,10
0.2,50,27,2156,42.27450980392157,9
0.2,51,91,2247,43.21153846153846,10
0.2,52,22,2269,42.81132075471698,20
0.2,53,93,2362,43.74074074074074,27
0.2,54,96,2458,44.69090909090909,9
0.2,55,25,2483,44.339285714285715,21
0.2,56,93,2576,45.19298245614035,16
0.2,57,95,2671,46.05172413793103,12
0.2,58,88,2759,46.76271186440678,13
0.2,59,92,2851,47.516666666666666,9
0.2,60,24,2875,47.131147540983605,10
0.2,61,94,2969,47.88709677419355,19
0.2,62,91,3060,48.57142857142857,15
0.2,63,93,3153,49.265625,14
0.2,64,93,3246,49.93846153846154,14
0.2,65,94,3340,50.60606060606061,22
0.2,66,92,3432,51.223880597014926,16
0.2,67,95,3527,51.86764705882353,6
0.2,68,96,3623,52.507246376811594,7
0.2,69,95,3718,53.114285714285714,6
0.2,70,27,3745,52.74647887323944,8
0.2,71,94,3839,53.31944444444444,7
0.2,72,95,3934,53.89041095890411,7
0.2,73,89,4023,54.36486486486486,12
0.2,74,26,4049,53.986666666666665,20
0.2,75,95,4144,54.526315789473685,8
0.2,76,94,4238,55.03896103896104,10
0.2,77,94,4332,55.53846153846154,9
0.2,78,24,4356,55.139240506329116,14
0.2,79,94,4450,55.625,10
0.2,80,92,4542,56.074074074074076,18
0.2,81,21,4563,55.646341463414636,14
0.2,82,93,4656,56.096385542168676,8
0.2,83,90,4746,56.5,18
0.2,84,92,4838,56.917647058823526,17
0.2,85,96,4934,57.372093023255815,6
0.2,86,-51,4883,56.12643678160919,15
0.2,87,92,4975,56.53409090909091,27
0.2,88,94,5069,56.95505617977528,11
0.2,89,94,5163,57.36666666666667,9
0.2,90,94,5257,57.76923076923077,9
0.2,91,96,5353,58.18478260869565,8
0.2,92,95,5448,58.58064516129032,8
0.2,93,96,5544,58.97872340425532,9
0.2,94,89,5633,59.294736842105266,12
0.2,95,93,5726,59.645833333333336,8
0.2,96,94,5820,60.0,8
0.2,97,96,5916,60.36734693877551,6
0.2,98,24,5940,60.0,9
0.2,99,94,6034,60.34,7
0.2,100,87,6121,60.603960396039604,14
0.2,101,27,6148,60.27450980392157,7
0.2,102,82,6230,60.48543689320388,19
0.2,103,25,6255,60.14423076923077,11
0.2,104,-53,6202,59.06666666666667,32
0.2,105,94,6296,59.39622641509434,7
0.2,106,94,6390,59.7196261682243,9
0.2,107,93,6483,60.02777777777778,8
0.2,108,94,6577,60.3394495412844,21
0.2,109,87,6664,60.58181818181818,15
0.2,110,93,6757,60.873873873873876,11
0.2,111,19,6776,60.5,14
0.2,112,91,6867,60.769911504424776,10
0.2,113,95,6962,61.07017543859649,6
0.2,114,93,7055,61.34782608695652,8
0.2,115,25,7080,61.03448275862069,8
0.2,116,93,7173,61.30769230769231,8
0.2,117,91,7264,61.559322033898304,11
0.2,118,95,7359,61.84033613445378,7
0.2,119,94,7453,62.108333333333334,8
0.2,120,95,7548,62.3801652892562,6
0.2,121,92,7640,62.622950819672134,9
0.2,122,91,7731,62.853658536585364,10
0.2,123,23,7754,62.53225806451613,10
0.2,124,94,7848,62.784,7
0.2,125,95,7943,63.03968253968254,7
0.2,126,96,8039,63.2992125984252,6
0.2,127,93,8132,63.53125,9
0.2,128,96,8228,63.78294573643411,6
0.2,129,92,8320,64.0,9
0.2,130,89,8409,64.19083969465649,12
0.2,131,94,8503,64.41666666666667,7
0.2,132,17,8520,64.06015037593986,15
0.2,133,91,8611,64.26119402985074,10
0.2,134,25,8636,63.97037037037037,8
0.2,135,94,8730,64.19117647058823,7
0.2,136,94,8824,64.4087591240876,7
0.2,137,93,8917,64.6159420289855,9
0.2,138,92,9009,64.81294964028777,9
0.2,139,85,9094,64.95714285714286,16
0.2,140,95,9189,65.17021276595744,6
0.2,141,95,9284,65.38028169014085,7
0.2,142,91,9375,65.55944055944056,10
0.2,143,89,9464,65.72222222222223,12
0.2,144,92,9556,65.90344827586208,10
0.2,145,93,9649,66.08904109589041,9
0.2,146,89,9738,66.24489795918367,12
0.2,147,90,9828,66.4054054054054,12
0.2,148,94,9922,66.59060402684564,7
0.2,149,25,9947,66.31333333333333,8
0.2,150,95,10042,66.50331125827815,6
0.2,151,90,10132,66.65789473684211,11
0.2,152,94,10226,66.83660130718954,7
0.2,153,93,10319,67.00649350649351,8
0.2,154,92,10411,67.16774193548387,9
0.2,155,94,10505,67.33974358974359,8
0.2,156,94,10599,67.50955414012739,7
0.2,157,92,10691,67.66455696202532,9
0.2,158,89,10780,67.79874213836477,12
0.2,159,91,10871,67.94375,10
0.2,160,91,10962,68.08695652173913,10
0.2,161,93,11055,68.24074074074075,9
0.2,162,92,11147,68.38650306748467,9
0.2,163,-60,11087,67.60365853658537,27
0.2,164,91,11178,67.74545454545455,11
0.2,165,94,11272,67.90361445783132,7
0.2,166,87,11359,68.01796407185628,14
0.2,167,-47,11312,67.33333333333333,12
0.2,168,91,11403,67.4733727810651,10
0.2,169,89,11492,67.6,12
0.2,170,92,11584,67.74269005847954,9
0.2,171,90,11674,67.87209302325581,11
0.2,172,95,11769,68.02890173410404,7
0.2,173,95,11864,68.183908045977,7
0.2,174,90,11954,68.30857142857143,11
0.2,175,94,12048,68.45454545454545,7
0.2,176,95,12143,68.6045197740113,6
0.2,177,91,12234,68.73033707865169,10
0.2,178,88,12322,68.83798882681565,13
0.2,179,88,12410,68.94444444444444,13
0.2,180,93,12503,69.07734806629834,8
0.2,181,91,12594,69.1978021978022,10
0.2,182,27,12621,68.9672131147541,7
0.2,183,94,12715,69.10326086956522,7
0.2,184,95,12810,69.24324324324324,6
0.2,185,93,12903,69.37096774193549,8
0.2,186,84,12987,69.44919786096257,17
0.2,187,21,13008,69.19148936170212,11
0.2,188,95,13103,69.32804232804233,6
0.2,189,93,13196,69.45263157894736,8
0.2,190,23,13219,69.20942408376963,9
0.2,191,95,13314,69.34375,6
0.2,192,93,13407,69.46632124352331,8
0.2,193,89,13496,69.56701030927834,12
0.2,194,90,13586,69.67179487179487,11
0.2,195,90,13676,69.77551020408163,11
0.2,196,94,13770,69.8984771573604,7
0.2,197,25,13795,69.67171717171718,9
0.2,198,94,13889,69.79396984924622,7
0.2,199,92,13981,69.905,9
0.2,200,92,14073,70.01492537313433,10
0.2,201,88,14161,70.10396039603961,13
0.2,202,96,14257,70.23152709359606,6
0.2,203,19,14276,69.98039215686275,15
0.2,204,90,14366,70.0780487804878,11
0.2,205,93,14459,70.18932038834951,8
0.2,206,92,14551,70.29468599033817,9
0.2,207,84,14635,70.36057692307692,17
0.2,208,96,14731,70.48325358851675,6
0.2,209,94,14825,70.5952380952381,7
0.2,210,87,14912,70.67298578199052,14
0.2,211,93,15005,70.77830188679245,8
0.2,212,94,15099,70.88732394366197,7
0.2,213,92,15191,70.98598130841121,9
0.2,214,91,15282,71.07906976744187,10
0.2,215,92,15374,71.17592592592592,9
0.2,216,95,15469,71.28571428571429,7
0.2,217,94,15563,71.38990825688073,10
0.2,218,91,15654,71.47945205479452,10
0.2,219,94,15748,71.58181818181818,7
0.2,220,19,15767,71.34389140271493,13
0.2,221,95,15862,71.45045045045045,6
0.2,222,15,15877,71.19730941704036,17
0.2,223,86,15963,71.26339285714286,18
0.2,224,96,16059,71.37333333333333,6
0.2,225,12,16071,71.11061946902655,20
0.2,226,26,16097,70.91189427312776,7
0.2,227,94,16191,71.01315789473684,7
0.2,228,90,16281,71.09606986899563,11
0.2,229,95,16376,71.2,6
0.2,230,88,16464,71.27272727272727,13
0.2,231,94,16558,71.37068965517241,8
0.2,232,88,16646,71.44206008583691,13
0.2,233,92,16738,71.52991452991454,9
0.2,234,94,16832,71.62553191489361,7
0.2,235,96,16928,71.72881355932203,6
0.2,236,-44,16884,71.24050632911393,8
0.2,237,87,16971,71.30672268907563,14
0.2,238,95,17066,71.40585774058577,7
0.2,239,83,17149,71.45416666666667,18
0.2,240,94,17243,71.54771784232365,7
0.2,241,92,17335,71.63223140495867,9
0.2,242,88,17423,71.69958847736625,13
0.2,243,93,17516,71.78688524590164,8
0.2,244,91,17607,71.86530612244898,10
0.2,245,92,17699,71.94715447154472,9
0.2,246,91,17790,72.02429149797571,10
0.2,247,91,17881,72.1008064516129,11
0.2,248,92,17973,72.18072289156626,9
0.2,249,94,18067,72.268,7
0.2,250,94,18161,72.35458167330677,7
0.2,251,86,18247,72.40873015873017,15
0.2,252,93,18340,72.4901185770751,9
0.2,253,93,18433,72.57086614173228,10
0.2,254,95,18528,72.65882352941176,6
0.2,255,93,18621,72.73828125,9
0.2,256,88,18709,72.7976653696498,13
0.2,257,91,18800,72.86821705426357,10
0.2,258,92,18892,72.94208494208495,11
0.2,259,94,18986,73.02307692307693,7
0.2,260,94,19080,73.10344827586206,7
0.2,261,91,19171,73.17175572519083,11
0.2,262,91,19262,73.23954372623574,10
0.2,263,89,19351,73.29924242424242,12
0.2,264,94,19445,73.37735849056604,7
0.2,265,93,19538,73.45112781954887,8
0.2,266,96,19634,73.53558052434457,6
0.2,267,94,19728,73.61194029850746,7
0.2,268,95,19823,73.6914498141264,6
0.2,269,88,19911,73.74444444444444,14
0.2,270,91,20002,73.80811808118081,10
0.2,271,94,20096,73.88235294117646,8
0.2,272,88,20184,73.93406593406593,13
0.2,273,93,20277,74.0036496350365,9
0.2,274,92,20369,74.0690909090909,9
0.2,275,94,20463,74.1413043478261,8
0.2,276,96,20559,74.2202166064982,7
0.2,277,95,20654,74.29496402877697,6
0.2,278,96,20750,74.37275985663082,6
0.2,279,93,20843,74.43928571428572,8
0.2,280,20,20863,74.24555160142349,13
0.2,281,89,20952,74.29787234042553,12
0.2,282,94,21046,74.36749116607774,8
0.2,283,93,21139,74.4330985915493,8
0.2,284,92,21231,74.49473684210527,9
0.2,285,95,21326,74.56643356643356,6
0.2,286,90,21416,74.62020905923345,11
0.2,287,22,21438,74.4375,11
0.2,288,89,21527,74.4878892733564,12
0.2,289,91,21618,74.54482758620689,11
0.2,290,78,21696,74.55670103092784,23
0.2,291,23,21719,74.38013698630137,9
0.2,292,93,21812,74.44368600682594,9
0.2,293,20,21832,74.25850340136054,13
0.2,294,94,21926,74.32542372881356,8
0.2,295,86,22012,74.36486486486487,15
0.2,296,93,22105,74.42760942760943,8
0.2,297,92,22197,74.48657718120805,9
0.2,298,94,22291,74.55183946488295,7
0.2,299,95,22386,74.62,8
0.2,300,95,22481,74.68770764119601,7
0.2,301,92,22573,74.74503311258277,9
0.2,302,93,22666,74.8052805280528,8
0.2,303,27,22693,74.64802631578948,6
0.2,304,84,22777,74.67868852459016,17
0.2,305,93,22870,74.73856209150327,8
0.2,306,94,22964,74.8013029315961,8
0.2,307,92,23056,74.85714285714286,9
0.2,308,94,23150,74.91909385113269,7
0.2,309,94,23244,74.98064516129033,8
0.2,310,96,23340,75.04823151125402,6
0.2,311,23,23363,74.88141025641026,9
0.2,312,92,23455,74.93610223642173,9
0.2,313,96,23551,75.0031847133758,7
0.2,314,91,23642,75.05396825396825,10
0.2,315,94,23736,75.11392405063292,7
0.2,316,94,23830,75.17350157728707,7
0.2,317,86,23916,75.20754716981132,15
0.2,318,95,24011,75.26959247648902,6
0.2,319,89,24100,75.3125,12
0.2,320,94,24194,75.37071651090342,8
0.2,321,87,24281,75.40683229813665,14
0.2,322,95,24376,75.46749226006192,6
0.2,323,95,24471,75.52777777777777,6
0.2,324,95,24566,75.58769230769231,6
0.2,325,93,24659,75.64110429447852,8
0.2,326,94,24753,75.69724770642202,8
0.2,327,96,24849,75.75914634146342,7
0.2,328,94,24943,75.8145896656535,7
0.2,329,92,25035,75.86363636363636,9
0.2,330,95,25130,75.9214501510574,6
0.2,331,94,25224,75.97590361445783,7
0.2,332,94,25318,76.03003003003003,7
0.2,333,93,25411,76.08083832335329,10
0.2,334,94,25505,76.13432835820896,7
0.2,335,91,25596,76.17857142857143,10
0.2,336,94,25690,76.23145400593472,8
0.2,337,94,25784,76.28402366863905,7
0.2,338,93,25877,76.33333333333333,9
0.2,339,96,25973,76.39117647058823,6
0.2,340,26,25999,76.2434017595308,7
0.2,341,91,26090,76.28654970760233,11
0.2,342,24,26114,76.134110787172,9
0.2,343,93,26207,76.18313953488372,8
0.2,344,93,26300,76.23188405797102,8
0.2,345,94,26394,76.28323699421965,7
0.2,346,89,26483,76.31988472622479,12
0.2,347,91,26574,76.36206896551724,11
0.2,348,90,26664,76.40114613180516,11
0.2,349,93,26757,76.44857142857143,8
0.2,350,92,26849,76.4928774928775,10
0.2,351,96,26945,76.54829545454545,6
0.2,352,96,27041,76.60339943342777,6
0.2,353,94,27135,76.65254237288136,8
0.2,354,87,27222,76.68169014084508,14
0.2,355,91,27313,76.72191011235955,10
0.2,356,93,27406,76.76750700280112,8
0.2,357,89,27495,76.80167597765363,12
0.2,358,85,27580,76.82451253481894,16
0.2,359,94,27674,76.87222222222222,7
0.2,360,96,27770,76.92520775623268,6
0.2,361,96,27866,76.97790055248619,6
0.2,362,93,27959,77.02203856749311,9
0.2,363,95,28054,77.07142857142857,7
0.2,364,90,28144,77.10684931506849,11
0.2,365,94,28238,77.15300546448087,7
0.2,366,93,28331,77.19618528610354,8
0.2,367,89,28420,77.22826086956522,12
0.2,368,91,28511,77.26558265582656,10
0.2,369,94,28605,77.3108108108108,7
0.2,370,96,28701,77.3611859838275,6
0.2,371,92,28793,77.40053763440861,9
0.2,372,93,28886,77.44235924932975,8
0.2,373,95,28981,77.48930481283422,6
0.2,374,89,29070,77.52,12
0.2,375,94,29164,77.56382978723404,7
0.2,376,93,29257,77.60477453580901,8
0.2,377,96,29353,77.65343915343915,6
0.2,378,-44,29309,77.33245382585751,8
0.2,379,23,29332,77.18947368421053,10
0.2,380,89,29421,77.22047244094489,12
0.2,381,94,29515,77.26439790575917,7
0.2,382,94,29609,77.30809399477806,8
0.2,383,94,29703,77.3515625,7
0.2,384,21,29724,77.20519480519481,13
0.2,385,94,29818,77.24870466321244,9
0.2,386,96,29914,77.29715762273902,7
0.2,387,96,30010,77.34536082474227,6
0.2,388,92,30102,77.38303341902314,10
0.2,389,90,30192,77.41538461538461,11
0.2,390,87,30279,77.43989769820972,14
0.2,391,93,30372,77.4795918367347,8
0.2,392,-45,30327,77.16793893129771,9
0.2,393,90,30417,77.2005076142132,11
0.2,394,94,30511,77.24303797468355,7
0.2,395,95,30606,77.28787878787878,7
0.2,396,96,30702,77.33501259445843,6
0.2,397,24,30726,77.20100502512562,10
0.2,398,95,30821,77.24561403508773,6
0.2,399,95,30916,77.29,6
0.2,400,23,30939,77.15461346633417,11
0.2,401,95,31034,77.19900497512438,7
0.2,402,94,31128,77.24069478908189,8
0.2,403,91,31219,77.27475247524752,11
0.2,404,92,31311,77.31111111111112,10
0.2,405,94,31405,77.35221674876847,7
0.2,406,92,31497,77.38820638820638,9
0.2,407,27,31524,77.26470588235294,8
0.2,408,27,31551,77.14180929095355,6
0.2,409,86,31637,77.16341463414633,15
0.2,410,93,31730,77.20194647201946,8
0.2,411,94,31824,77.24271844660194,9
0.2,412,95,31919,77.28571428571429,6
0.2,413,94,32013,77.32608695652173,7
0.2,414,90,32103,77.3566265060241,11
0.2,415,88,32191,77.38221153846153,13
0.2,416,92,32283,77.41726618705036,9
0.2,417,94,32377,77.45693779904306,7
0.2,418,82,32459,77.46778042959427,19
0.2,419,95,32554,77.50952380952381,7
0.2,420,93,32647,77.54631828978623,8
0.2,421,95,32742,77.58767772511848,7
0.2,422,88,32830,77.61229314420804,13
0.2,423,88,32918,77.63679245283019,13
0.2,424,95,33013,77.67764705882352,7
0.2,425,94,33107,77.71596244131456,7
0.2,426,95,33202,77.75644028103045,6
0.2,427,85,33287,77.7733644859813,16
0.2,428,96,33383,77.81585081585082,6
0.2,429,95,33478,77.85581395348837,6
0.2,430,92,33570,77.88863109048724,9
0.2,431,95,33665,77.92824074074075,6
0.2,432,93,33758,77.96304849884527,8
0.2,433,96,33854,78.00460829493088,6
0.2,434,-48,33806,77.71494252873563,12
0.2,435,94,33900,77.75229357798165,7
0.2,436,87,33987,77.77345537757436,14
0.2,437,94,34081,77.81050228310502,7
0.2,438,89,34170,77.83599088838268,12
0.2,439,92,34262,77.86818181818182,9
0.2,440,96,34358,77.9092970521542,6
0.2,441,90,34448,77.9366515837104,11
0.2,442,92,34540,77.96839729119638,10
0.2,443,95,34635,78.00675675675676,6
0.2,444,94,34729,78.04269662921348,7
0.2,445,95,34824,78.08071748878923,6
0.2,446,94,34918,78.11633109619687,7
0.2,447,90,35008,78.14285714285714,11
0.2,448,91,35099,78.17149220489978,10
0.2,449,93,35192,78.20444444444445,8
0.2,450,83,35275,78.21507760532151,18
0.2,451,93,35368,78.24778761061947,9
0.2,452,94,35462,78.28256070640177,8
0.2,453,19,35481,78.15198237885463,14
0.2,454,94,35575,78.18681318681318,7
0.2,455,93,35668,78.21929824561404,8
0.2,456,92,35760,78.24945295404814,9
0.2,457,91,35851,78.27729257641921,10
0.2,458,95,35946,78.31372549019608,6
0.2,459,96,36042,78.35217391304347,6
0.2,460,94,36136,78.38611713665944,7
0.2,461,95,36231,78.42207792207792,6
0.2,462,87,36318,78.44060475161987,14
0.2,463,92,36410,78.46982758620689,10
0.2,464,94,36504,78.50322580645161,8
0.2,465,88,36592,78.52360515021459,13
0.2,466,94,36686,78.55674518201285,7
0.2,467,90,36776,78.58119658119658,13
0.2,468,95,36871,78.61620469083155,7
0.2,469,93,36964,78.6468085106383,8
0.2,470,94,37058,78.67940552016985,7
0.2,471,94,37152,78.71186440677967,7
0.2,472,94,37246,78.74418604651163,7
0.2,473,92,37338,78.77215189873418,10
0.2,474,92,37430,78.8,9
0.2,475,91,37521,78.82563025210084,10
0.2,476,18,37539,78.69811320754717,14
0.2,477,92,37631,78.72594142259415,9
0.2,478,94,37725,78.75782881002088,8
0.2,479,87,37812,78.775,14
0.2,480,86,37898,78.79002079002079,15
0.2,481,91,37989,78.81535269709543,10
0.2,482,25,38014,78.70393374741201,8
0.2,483,89,38103,78.72520661157024,13
0.2,484,90,38193,78.74845360824742,11
0.2,485,87,38280,78.76543209876543,16
0.2,486,23,38303,78.65092402464066,10
0.2,487,25,38328,78.54098360655738,8
0.2,488,93,38421,78.57055214723927,10
0.2,489,94,38515,78.60204081632654,8
0.2,490,94,38609,78.63340122199592,7
0.2,491,90,38699,78.65650406504065,11
0.2,492,96,38795,78.69168356997972,6
0.2,493,95,38890,78.7246963562753,7
0.2,494,87,38977,78.74141414141414,14
0.2,495,94,39071,78.77217741935483,7
0.2,496,95,39166,78.80482897384306,7
0.2,497,92,39258,78.83132530120481,9
0.2,498,27,39285,78.72745490981964,6
0.2,499,93,39378,78.756,9
0.2,500,93,39471,78.78443113772455,8
0.2,501,91,39562,78.80876494023904,10
0.2,502,-45,39517,78.56262425447316,8
0.2,503,96,39613,78.59722222222223,6
0.2,504,94,39707,78.62772277227722,7
0.2,505,88,39795,78.64624505928853,14
0.2,506,95,39890,78.6785009861933,7
0.2,507,90,39980,78.7007874015748,11
0.2,508,92,40072,78.72691552062868,10
0.2,509,92,40164,78.75294117647059,9
0.2,510,93,40257,78.78082191780823,8
0.2,511,93,40350,78.80859375,8
0.2,512,95,40445,78.8401559454191,7
0.2,513,95,40540,78.8715953307393,6
0.2,514,94,40634,78.9009708737864,7
0.2,515,95,40729,78.93217054263566,8
0.2,516,94,40823,78.96131528046422,7
0.2,517,93,40916,78.98841698841699,8
0.2,518,93,41009,79.01541425818883,8
0.2,519,93,41102,79.04230769230769,8
0.2,520,91,41193,79.06525911708253,10
0.2,521,87,41280,79.08045977011494,14
0.2,522,96,41376,79.11281070745697,6
0.2,523,96,41472,79.14503816793894,6
0.2,524,95,41567,79.1752380952381,6
0.2,525,91,41658,79.1977186311787,10
0.2,526,93,41751,79.22390891840607,8
0.2,527,89,41840,79.24242424242425,12
0.2,528,93,41933,79.26843100189036,9
0.2,529,22,41955,79.16037735849056,11
0.2,530,95,42050,79.19020715630886,7
0.2,531,92,42142,79.21428571428571,9
0.2,532,94,42236,79.24202626641652,9
0.2,533,94,42330,79.26966292134831,8
0.2,534,88,42418,79.28598130841121,13
0.2,535,93,42511,79.31156716417911,8
0.2,536,91,42602,79.33333333333333,10
0.2,537,95,42697,79.36245353159852,6
0.2,538,95,42792,79.39146567717997,7
0.2,539,93,42885,79.41666666666667,8
0.2,540,92,42977,79.43992606284658,9
0.2,541,24,43001,79.33763837638377,9
0.2,542,92,43093,79.3609576427256,9
0.2,543,91,43184,79.38235294117646,11
0.2,544,94,43278,79.4091743119266,8
0.2,545,96,43374,79.43956043956044,6
0.2,546,91,43465,79.46069469835466,10
0.2,547,86,43551,79.47262773722628,15
0.2,548,84,43635,79.48087431693989,17
0.2,549,93,43728,79.50545454545454,8
0.2,550,96,43824,79.53539019963702,6
0.2,551,93,43917,79.55978260869566,8
0.2,552,95,44012,79.5877034358047,6
0.2,553,94,44106,79.61371841155234,8
0.2,554,94,44200,79.63963963963964,7
0.2,555,86,44286,79.65107913669065,15
0.2,556,95,44381,79.6786355475763,7
0.2,557,27,44408,79.584229390681,6
0.2,558,93,44501,79.60822898032201,8
0.2,559,92,44593,79.63035714285714,9
0.2,560,27,44620,79.53654188948306,6
0.2,561,18,44638,79.42704626334519,14
0.2,562,90,44728,79.44582593250443,11
0.2,563,92,44820,79.46808510638297,10
0.2,564,91,44911,79.48849557522124,10
0.2,565,95,45006,79.51590106007068,6
0.2,566,94,45100,79.54144620811287,7
0.2,567,96,45196,79.57042253521126,6
0.2,568,85,45281,79.57996485061511,16
0.2,569,90,45371,79.5982456140351,11
0.2,570,96,45467,79.62697022767075,6
0.2,571,91,45558,79.64685314685315,10
0.2,572,95,45653,79.67364746945898,6
0.2,573,18,45671,79.56620209059234,16
0.2,574,95,45766,79.59304347826087,6
0.2,575,93,45859,79.61631944444444,8
0.2,576,94,45953,79.64124783362219,7
0.2,577,93,46046,79.66435986159169,9
0.2,578,89,46135,79.68048359240069,12
0.2,579,95,46230,79.70689655172414,6
0.2,580,89,46319,79.72289156626506,13
0.2,581,93,46412,79.74570446735395,8
0.2,582,95,46507,79.77186963979416,7
0.2,583,90,46597,79.78938356164383,11
0.2,584,95,46692,79.81538461538462,7
0.2,585,90,46782,79.83276450511946,11
0.2,586,95,46877,79.85860306643953,7
0.2,587,95,46972,79.8843537414966,7
0.2,588,92,47064,79.90492359932088,9
0.2,589,94,47158,79.92881355932204,7
0.2,590,19,47177,79.82571912013536,14
0.2,591,88,47265,79.83952702702703,13
0.2,592,92,47357,79.86003372681282,9
0.2,593,91,47448,79.87878787878788,10
0.2,594,27,47475,79.78991596638656,6
0.2,595,94,47569,79.81375838926175,7
0.2,596,93,47662,79.8358458961474,8
0.2,597,91,47753,79.85451505016722,10
0.2,598,96,47849,79.88146911519199,6
0.2,599,94,47943,79.905,8
0.2,600,93,48036,79.92678868552413,9
0.2,601,92,48128,79.9468438538206,10
0.2,602,91,48219,79.96517412935323,10
0.2,603,92,48311,79.98509933774834,11
0.2,604,94,48405,80.00826446280992,7
0.2,605,94,48499,80.03135313531354,7
0.2,606,92,48591,80.0510708401977,10
0.2,607,91,48682,80.06907894736842,10
0.2,608,90,48772,80.08538587848933,11
0.2,609,95,48867,80.10983606557377,6
0.2,610,83,48950,80.11456628477904,18
0.2,611,87,49037,80.12581699346406,14
0.2,612,93,49130,80.1468189233279,9
0.2,613,85,49215,80.15472312703584,16
0.2,614,93,49308,80.17560975609756,8
0.2,615,93,49401,80.19642857142857,9
0.2,616,92,49493,80.21555915721231,10
0.2,617,25,49518,80.12621359223301,8
0.2,618,26,49544,80.03877221324717,7
0.2,619,-50,49494,79.82903225806452,14
0.2,620,94,49588,79.85185185185185,7
0.2,621,86,49674,79.86173633440515,16
0.2,622,91,49765,79.87961476725522,11
0.2,623,90,49855,79.89583333333333,11
0.2,624,93,49948,79.9168,8
0.2,625,94,50042,79.93929712460064,8
0.2,626,91,50133,79.95693779904306,10
0.2,627,93,50226,79.97770700636943,9
0.2,628,87,50313,79.98887122416534,16
0.2,629,94,50407,80.0111111111111,7
0.2,630,95,50502,80.03486529318542,7
0.2,631,93,50595,80.05537974683544,8
0.2,632,93,50688,80.07582938388626,9
0.2,633,91,50779,80.09305993690852,11
0.2,634,25,50804,80.00629921259842,8
0.2,635,95,50899,80.02987421383648,8
0.2,636,94,50993,80.05180533751962,7
0.2,637,94,51087,80.07366771159874,7
0.2,638,96,51183,80.09859154929578,6
0.2,639,89,51272,80.1125,12
0.2,640,93,51365,80.13260530421216,8
0.2,641,92,51457,80.15109034267913,9
0.2,642,-55,51402,79.94090202177294,21
0.2,643,93,51495,79.9611801242236,8
0.2,644,93,51588,79.98139534883721,8
0.2,645,96,51684,80.0061919504644,6
0.2,646,94,51778,80.02782071097373,7
0.2,647,88,51866,80.04012345679013,15
0.2,648,94,51960,80.06163328197226,7
0.2,649,20,51980,79.96923076923076,13
0.2,650,91,52071,79.98617511520737,12
0.2,651,92,52163,80.00460122699387,9
0.2,652,92,52255,80.02297090352221,12
0.2,653,92,52347,80.04128440366972,9
0.2,654,25,52372,79.95725190839694,8
0.2,655,84,52456,79.96341463414635,18
0.2,656,84,52540,79.96955859969559,17
0.2,657,87,52627,79.98024316109422,14
0.2,658,95,52722,80.00303490136571,6
0.2,659,90,52812,80.01818181818182,11
0.2,660,92,52904,80.03630862329803,9
0.2,661,96,53000,80.06042296072508,7
0.2,662,94,53094,80.08144796380091,7
0.2,663,94,53188,80.10240963855422,7
0.2,664,95,53283,80.12481203007519,8
0.2,665,94,53377,80.14564564564564,8
0.2,666,90,53467,80.16041979010495,11
0.2,667,93,53560,80.17964071856288,9
0.2,668,93,53653,80.19880418535126,8
0.2,669,93,53746,80.2179104477612,8
0.2,670,95,53841,80.23994038748137,6
0.2,671,94,53935,80.26041666666667,7
0.2,672,91,54026,80.27637444279347,10
0.2,673,84,54110,80.28189910979229,17
0.2,674,94,54204,80.30222222222223,7
0.2,675,93,54297,80.32100591715977,8
0.2,676,94,54391,80.34121122599704,7
0.2,677,26,54417,80.26106194690266,7
0.2,678,89,54506,80.2739322533137,12
0.2,679,92,54598,80.29117647058824,9
0.2,680,92,54690,80.30837004405286,9
0.2,681,23,54713,80.22434017595307,10
0.2,682,89,54802,80.23718887262079,12
0.2,683,96,54898,80.26023391812865,6
0.2,684,94,54992,80.28029197080292,7
0.2,685,89,55081,80.2930029154519,12
0.2,686,93,55174,80.31149927219796,8
0.2,687,27,55201,80.23401162790698,6
0.2,688,23,55224,80.15094339622641,10
0.2,689,89,55313,80.16376811594203,12
0.2,690,93,55406,80.18234442836469,10
0.2,691,92,55498,80.19942196531792,9
0.2,692,87,55585,80.2092352092352,14
0.2,693,89,55674,80.22190201729107,12
0.2,694,93,55767,80.24028776978417,8
0.2,695,94,55861,80.26005747126437,7
0.2,696,91,55952,80.27546628407461,10
0.2,697,95,56047,80.29656160458453,6
0.2,698,92,56139,80.31330472103004,9
0.2,699,88,56227,80.32428571428571,13
0.2,700,89,56316,80.33666191155493,12
0.2,701,91,56407,80.35185185185185,10
0.2,702,24,56431,80.27169274537695,9
0.2,703,96,56527,80.2940340909091,7
0.2,704,92,56619,80.31063829787234,9
0.2,705,-46,56573,80.13172804532577,10
0.2,706,96,56669,80.15417256011315,6
0.2,707,88,56757,80.16525423728814,13
0.2,708,94,56851,80.18476727785614,8
0.2,709,95,56946,80.2056338028169,6
0.2,710,88,57034,80.21659634317862,13
0.2,711,93,57127,80.23455056179775,8
0.2,712,86,57213,80.24263674614306,15
0.2,713,94,57307,80.26190476190476,7
0.2,714,95,57402,80.28251748251748,6
0.2,715,94,57496,80.30167597765363,7
0.2,716,94,57590,80.3207810320781,9
0.2,717,90,57680,80.33426183844011,11
0.2,718,88,57768,80.34492350486788,13
0.2,719,23,57791,80.26527777777778,10
0.2,720,93,57884,80.28294036061027,8
0.2,721,25,57909,80.20637119113573,7
0.2,722,93,58002,80.2240663900415,8
0.2,723,96,58098,80.24585635359117,6
0.2,724,93,58191,80.26344827586207,8
0.2,725,82,58273,80.26584022038567,19
0.2,726,95,58368,80.28610729023384,6
0.2,727,83,58451,80.28983516483517,18
0.2,728,93,58544,80.30727023319616,8
0.2,729,94,58638,80.32602739726028,8
0.2,730,77,58715,80.32147742818057,24
0.2,731,92,58807,80.33743169398907,9
0.2,732,92,58899,80.35334242837654,11
0.2,733,94,58993,80.37193460490464,7
0.2,734,91,59084,80.38639455782312,10
0.2,735,92,59176,80.40217391304348,9
0.2,736,95,59271,80.42198100407056,6
0.2,737,92,59363,80.43766937669376,9
0.2,738,96,59459,80.45872801082544,6
0.2,739,93,59552,80.47567567567567,8
0.2,740,95,59647,80.49527665317139,7
0.2,741,93,59740,80.5121293800539,9
0.2,742,22,59762,80.43337819650067,11
0.2,743,92,59854,80.4489247311828,9
0.2,744,93,59947,80.46577181208053,8
0.2,745,82,60029,80.46782841823057,19
0.2,746,96,60125,80.48862115127176,6
0.2,747,95,60220,80.50802139037434,6
0.2,748,95,60315,80.52736982643525,7
0.2,749,14,60329,80.43866666666666,18
0.2,750,92,60421,80.45406125166444,9
0.2,751,95,60516,80.47340425531915,6
0.2,752,-121,60395,80.20584329349269,16
0.2,753,24,60419,80.13129973474801,11
0.2,754,80,60499,80.13112582781457,21
0.2,755,94,60593,80.1494708994709,7
0.2,756,94,60687,80.16776750330251,8
0.2,757,91,60778,80.1820580474934,10
0.2,758,94,60872,80.20026350461133,7
0.2,759,91,60963,80.21447368421053,10
0.2,760,-46,60917,80.04862023653088,10
0.2,761,93,61010,80.06561679790026,9
0.2,762,92,61102,80.08125819134993,9
0.2,763,24,61126,80.00785340314137,10
0.2,764,90,61216,80.02091503267974,11
0.2,765,95,61311,80.04046997389034,6
0.2,766,92,61403,80.05606258148632,9
0.2,767,81,61484,80.05729166666667,20
0.2,768,94,61578,80.07542262678804,7
0.2,769,95,61673,80.09480519480519,7
0.2,770,90,61763,80.1076523994812,11
0.2,771,93,61856,80.12435233160622,9
0.2,772,94,61950,80.14230271668822,8
0.2,773,94,62044,80.16020671834626,7
0.2,774,94,62138,80.17806451612903,8
0.2,775,87,62225,80.1868556701031,14
0.2,776,95,62320,80.20592020592021,6
0.2,777,95,62415,80.22493573264782,7
0.2,778,91,62506,80.2387676508344,10
0.2,779,92,62598,80.25384615384615,10
0.2,780,93,62691,80.27016645326505,8
0.2,781,91,62782,80.28388746803068,10
0.2,782,94,62876,80.30140485312899,7
0.2,783,90,62966,80.31377551020408,12
0.2,784,95,63061,80.33248407643312,7
0.2,785,96,63157,80.35241730279898,6
0.2,786,92,63249,80.36721728081322,9
0.2,787,95,63344,80.38578680203045,7
0.2,788,87,63431,80.39416983523448,15
0.2,789,96,63527,80.41392405063291,6
0.2,790,93,63620,80.42983565107458,8
0.2,791,26,63646,80.36111111111111,7
0.2,792,90,63736,80.37326607818412,11
0.2,793,94,63830,80.39042821158691,7
0.2,794,92,63922,80.40503144654087,9
0.2,795,23,63945,80.33291457286433,9
0.2,796,96,64041,80.35257214554579,6
0.2,797,85,64126,80.35839598997494,16
0.2,798,93,64219,80.37421777221527,9
0.2,799,93,64312,80.39,8
0.2,800,94,64406,80.40699126092385,7
0.2,801,94,64500,80.42394014962593,7
0.2,802,91,64591,80.43711083437111,10
0.2,803,94,64685,80.45398009950249,7
0.2,804,87,64772,80.46211180124223,17
0.2,805,27,64799,80.39578163771712,7
0.2,806,24,64823,80.32589838909541,9
0.2,807,89,64912,80.33663366336634,12
0.2,808,95,65007,80.35475896168109,6
0.2,809,95,65102,80.37283950617284,6
0.2,810,92,65194,80.38717632552404,10
0.2,811,24,65218,80.31773399014779,8
0.2,812,94,65312,80.33456334563346,7
0.2,813,87,65399,80.34275184275184,14
0.2,814,96,65495,80.36196319018404,6
0.2,815,18,65513,80.28553921568627,16
0.2,816,95,65608,80.30354957160343,6
0.2,817,91,65699,80.31662591687042,11
0.2,818,93,65792,80.33211233211233,8
0.2,819,22,65814,80.2609756097561,12
0.2,820,91,65905,80.27405602923264,11
0.2,821,25,65930,80.20681265206812,7
0.2,822,93,66023,80.22235722964763,9
0.2,823,18,66041,80.14684466019418,15
0.2,824,93,66134,80.16242424242424,8
0.2,825,87,66221,80.17070217917676,14
0.2,826,90,66311,80.1825876662636,11
0.2,827,93,66404,80.19806763285024,8
0.2,828,93,66497,80.21351025331725,10
0.2,829,91,66588,80.22650602409638,11
0.2,830,92,66680,80.24067388688327,9
0.2,831,96,66776,80.25961538461539,6
0.2,832,94,66870,80.27611044417768,7
0.2,833,92,66962,80.29016786570743,9
0.2,834,89,67051,80.30059880239521,12
0.2,835,95,67146,80.31818181818181,6
0.2,836,92,67238,80.3321385902031,9
0.2,837,92,67330,80.34606205250597,9
0.2,838,94,67424,80.36233611442194,7
0.2,839,88,67512,80.37142857142857,13
0.2,840,93,67605,80.38644470868014,9
0.2,841,94,67699,80.40261282660333,7
0.2,842,92,67791,80.41637010676156,9
0.2,843,92,67883,80.43009478672985,9
0.2,844,91,67974,80.44260355029586,10
0.2,845,90,68064,80.45390070921985,11
0.2,846,89,68153,80.46399055489965,12
0.2,847,91,68244,80.47641509433963,10
0.2,848,90,68334,80.48763250883393,11
0.2,849,91,68425,80.5,12
0.2,850,84,68509,80.50411280846063,17
0.2,851,21,68530,80.43427230046949,11
0.2,852,92,68622,80.44783118405627,9
0.2,853,90,68712,80.45901639344262,11
0.2,854,92,68804,80.47251461988304,9
0.2,855,94,68898,80.48831775700934,7
0.2,856,92,68990,80.50175029171528,10
0.2,857,89,69079,80.51165501165501,12
0.2,858,95,69174,80.52852153667055,6
0.2,859,91,69265,80.54069767441861,13
0.2,860,95,69360,80.55749128919861,6
0.2,861,93,69453,80.57192575406033,9
0.2,862,94,69547,80.58748551564311,7
0.2,863,94,69641,80.60300925925925,9
0.2,864,94,69735,80.61849710982659,7
0.2,865,94,69829,80.63394919168591,7
0.2,866,90,69919,80.64475201845444,11
0.2,867,84,70003,80.64861751152074,17
0.2,868,95,70098,80.66513233601842,6
0.2,869,89,70187,80.67471264367816,12
0.2,870,93,70280,80.68886337543054,8
0.2,871,94,70374,80.70412844036697,8
0.2,872,91,70465,80.71592210767469,10
0.2,873,94,70559,80.73112128146452,7
0.2,874,94,70653,80.74628571428572,7
0.2,875,94,70747,80.76141552511416,7
0.2,876,93,70840,80.77537058152794,8
0.2,877,93,70933,80.78929384965832,8
0.2,878,92,71025,80.80204778156997,9
0.2,879,94,71119,80.81704545454545,7
0.2,880,91,71210,80.82860385925085,10
0.2,881,-46,71164,80.68480725623583,9
0.2,882,93,71257,80.69875424688561,8
0.2,883,94,71351,80.71380090497738,8
0.2,884,-47,71304,80.56949152542373,10
0.2,885,96,71400,80.58690744920993,6
0.2,886,95,71495,80.6031567080045,6
0.2,887,92,71587,80.615990990991,11
0.2,888,91,71678,80.62767154105737,10
0.2,889,95,71773,80.64382022471911,6
0.2,890,18,71791,80.57351290684625,14
0.2,891,96,71887,80.59080717488789,6
0.2,892,89,71976,80.60022396416574,13
0.2,893,94,72070,80.6152125279642,7
0.2,894,93,72163,80.6290502793296,8
0.2,895,88,72251,80.63727678571429,13
0.2,896,90,72341,80.64771460423634,11
0.2,897,85,72426,80.65256124721604,16
0.2,898,92,72518,80.66518353726363,9
0.2,899,90,72608,80.67555555555556,11
0.2,900,95,72703,80.6914539400666,7
0.2,901,83,72786,80.6940133037694,18
0.2,902,27,72813,80.63455149501661,6
0.2,903,94,72907,80.64933628318585,7
0.2,904,96,73003,80.66629834254144,6
0.2,905,93,73096,80.67991169977925,8
0.2,906,93,73189,80.69349503858875,8
0.2,907,91,73280,80.70484581497797,10
0.2,908,86,73366,80.71067106710672,15
0.2,909,87,73453,80.71758241758242,14
0.2,910,95,73548,80.73326015367728,6
0.2,911,95,73643,80.74890350877193,6
0.2,912,94,73737,80.76341730558597,7
0.2,913,94,73831,80.77789934354486,8
0.2,914,92,73923,80.79016393442623,9
0.2,915,95,74018,80.8056768558952,8
0.2,916,91,74109,80.81679389312977,10
0.2,917,94,74203,80.83115468409586,7
0.2,918,92,74295,80.84330794341676,9
0.2,919,91,74386,80.85434782608695,10
0.2,920,91,74477,80.86536373507057,10
0.2,921,92,74569,80.87744034707158,9
0.2,922,90,74659,80.88732394366197,11
0.2,923,22,74681,80.82359307359307,10
0.2,924,-45,74636,80.68756756756757,10
0.2,925,90,74726,80.6976241900648,11
0.2,926,93,74819,80.71089536138079,8
0.2,927,92,74911,80.72306034482759,9
0.2,928,93,75004,80.73627556512379,8
0.2,929,-46,74958,80.6,10
0.2,930,87,75045,80.60687432867884,14
0.2,931,91,75136,80.61802575107296,10
0.2,932,93,75229,80.63129689174706,8
0.2,933,-119,75110,80.41755888650964,15
0.2,934,92,75202,80.42994652406418,9
0.2,935,95,75297,80.44551282051282,6
0.2,936,94,75391,80.45997865528281,8
0.2,937,94,75485,80.47441364605544,8
0.2,938,91,75576,80.48562300319489,10
0.2,939,95,75671,80.50106382978723,7
0.2,940,93,75764,80.51434643995749,8
0.2,941,95,75859,80.52972399150742,6
0.2,942,93,75952,80.54294803817604,8
0.2,943,19,75971,80.47775423728814,14
0.2,944,91,76062,80.4888888888889,11
0.2,945,90,76152,80.49894291754757,11
0.2,946,93,76245,80.51214361140444,10
0.2,947,94,76339,80.52637130801688,7
0.2,948,93,76432,80.5395152792413,8
0.2,949,95,76527,80.55473684210526,6
0.2,950,87,76614,80.5615141955836,14
0.2,951,94,76708,80.57563025210084,7
0.2,952,94,76802,80.5897166841553,8
0.2,953,91,76893,80.6006289308176,10
0.2,954,96,76989,80.61675392670158,6
0.2,955,96,77085,80.63284518828452,6
0.2,956,85,77170,80.63740856844305,16
0.2,957,95,77265,80.65240083507307,7
0.2,958,93,77358,80.66527632950991,8
0.2,959,92,77450,80.67708333333333,9
0.2,960,94,77544,80.69094693028096,7
0.2,961,95,77639,80.70582120582121,6
0.2,962,89,77728,80.71443406022846,12
0.2,963,94,77822,80.72821576763485,7
0.2,964,26,77848,80.67150259067357,7
0.2,965,95,77943,80.6863354037267,6
0.2,966,22,77965,80.62564632885211,11
0.2,967,91,78056,80.63636363636364,10
0.2,968,91,78147,80.6470588235294,10
0.2,969,91,78238,80.65773195876288,10
0.2,970,71,78309,80.64778578784758,30
0.2,971,95,78404,80.66255144032922,6
0.2,972,94,78498,80.67625899280576,7
0.2,973,92,78590,80.68788501026694,9
0.2,974,95,78685,80.7025641025641,7
0.2,975,23,78708,80.64344262295081,10
0.2,976,91,78799,80.65404298874104,10
0.2,977,94,78893,80.6676891615542,7
0.2,978,95,78988,80.682328907048,7
0.2,979,91,79079,80.69285714285714,10
0.2,980,92,79171,80.70438328236493,9
0.2,981,86,79257,80.70977596741344,16
0.2,982,94,79351,80.7232960325534,7
0.2,983,96,79447,80.73882113821138,6
0.2,984,92,79539,80.7502538071066,9
0.2,985,90,79629,80.75963488843813,11
0.2,986,91,79720,80.77001013171225,10
0.2,987,25,79745,80.71356275303644,8
0.2,988,80,79825,80.71284125379171,21
0.2,989,93,79918,80.72525252525253,8
0.2,990,92,80010,80.73662966700303,10
0.2,991,89,80099,80.74495967741936,13
0.2,992,25,80124,80.68882175226587,8
0.2,993,92,80216,80.70020120724347,9
0.2,994,91,80307,80.7105527638191,10
0.2,995,94,80401,80.72389558232932,8
0.2,996,92,80493,80.73520561685055,9
0.2,997,88,80581,80.74248496993988,14
0.2,998,92,80673,80.75375375375376,9
0.2,999,93,80766,80.766,8
0.2,1000,22,80788,80.70729270729271,12
0.2,1001,92,80880,80.7185628742515,9
0.2,1002,94,80974,80.73180458624128,8
0.2,1003,91,81065,80.74203187250995,10
0.2,1004,94,81159,80.75522388059701,7
0.2,1005,23,81182,80.69781312127236,10
0.2,1006,96,81278,80.71300893743793,6
0.2,1007,91,81369,80.72321428571429,10
0.2,1008,21,81390,80.66402378592666,11
0.2,1009,27,81417,80.6108910891089,6
0.2,1010,91,81508,80.62116716122651,10
0.2,1011,92,81600,80.63241106719367,9
0.2,1012,95,81695,80.64659427443237,6
0.2,1013,90,81785,80.65581854043393,12
0.2,1014,90,81875,80.66502463054188,11
0.2,1015,90,81965,80.6742125984252,11
0.2,1016,93,82058,80.68633235004917,8
0.2,1017,93,82151,80.6984282907662,8
0.2,1018,25,82176,80.64376840039255,8
0.2,1019,87,82263,80.65,14
0.2,1020,88,82351,80.65719882468169,13
0.2,1021,93,82444,80.6692759295499,8
0.2,1022,92,82536,80.68035190615836,10
0.2,1023,94,82630,80.693359375,7
0.2,1024,95,82725,80.70731707317073,6
0.2,1025,95,82820,80.72124756335283,6
0.2,1026,92,82912,80.73222979552094,9
0.2,1027,25,82937,80.67801556420234,8
0.2,1028,95,83032,80.69193391642371,7
0.2,1029,92,83124,80.70291262135922,9
0.2,1030,92,83216,80.71387002909796,9
0.2,1031,90,83306,80.72286821705427,11
0.2,1032,94,83400,80.73572120038722,7
0.2,1033,95,83495,80.74951644100581,7
0.2,1034,89,83584,80.75748792270531,12
0.2,1035,90,83674,80.76640926640927,11
0.2,1036,94,83768,80.7791706846673,7
0.2,1037,95,83863,80.79287090558766,6
0.2,1038,92,83955,80.8036573628489,9
0.2,1039,94,84049,80.81634615384615,7
0.2,1040,93,84142,80.82804995196926,8
0.2,1041,96,84238,80.8426103646833,6
0.2,1042,94,84332,80.85522531160115,8
0.2,1043,96,84428,80.86973180076629,6
0.2,1044,96,84524,80.88421052631578,6
0.2,1045,93,84617,80.89579349904398,8
0.2,1046,85,84702,80.89971346704871,16
0.2,1047,95,84797,80.9131679389313,6
0.2,1048,91,84888,80.92278360343184,10
0.2,1049,95,84983,80.93619047619048,7
0.2,1050,89,85072,80.94386298763082,12
0.2,1051,22,85094,80.88783269961978,11
0.2,1052,94,85188,80.9002849002849,7
0.2,1053,94,85282,80.91271347248576,7
0.2,1054,23,85305,80.85781990521328,10
0.2,1055,93,85398,80.86931818181819,8
0.2,1056,96,85494,80.88363292336803,6
0.2,1057,88,85582,80.89035916824197,13
0.2,1058,93,85675,80.90179414542021,8
0.2,1059,96,85771,80.91603773584906,6
0.2,1060,95,85866,80.92931196983977,9
0.2,1061,93,85959,80.94067796610169,8
0.2,1062,94,86053,80.95296331138287,7
0.2,1063,87,86140,80.95864661654136,14
0.2,1064,92,86232,80.96901408450704,9
0.2,1065,95,86327,80.98217636022514,6
0.2,1066,24,86351,80.92877225866917,9
0.2,1067,95,86446,80.94194756554307,7
0.2,1068,82,86528,80.94293732460243,19
0.2,1069,95,86623,80.95607476635514,6
0.2,1070,94,86717,80.96825396825396,7
0.2,1071,84,86801,80.97108208955224,17
0.2,1072,96,86897,80.98508853681267,6
0.2,1073,94,86991,80.99720670391062,8
0.2,1074,94,87085,81.0093023255814,7
0.2,1075,89,87174,81.01672862453532,12
0.2,1076,92,87266,81.02692664809656,10
0.2,1077,92,87358,81.03710575139146,9
0.2,1078,93,87451,81.04819277108433,8
0.2,1079,95,87546,81.06111111111112,7
0.2,1080,93,87639,81.07215541165587,9
0.2,1081,93,87732,81.08317929759704,8
0.2,1082,94,87826,81.09510618651893,7
0.2,1083,95,87921,81.10793357933579,6
0.2,1084,94,88015,81.11981566820276,7
0.2,1085,94,88109,81.1316758747698,8
0.2,1086,25,88134,81.08003679852806,8
0.2,1087,91,88225,81.08915441176471,10
0.2,1088,94,88319,81.1010101010101,7
0.2,1089,23,88342,81.04770642201835,10
0.2,1090,94,88436,81.05957836846929,7
0.2,1091,92,88528,81.06959706959707,9
0.2,1092,95,88623,81.08234217749313,7
0.2,1093,89,88712,81.08957952468008,12
0.2,1094,95,88807,81.10228310502283,6
0.2,1095,93,88900,81.11313868613139,8
0.2,1096,92,88992,81.12306289881495,9
0.2,1097,21,89013,81.06830601092896,13
0.2,1098,87,89100,81.073703366697,14
0.2,1099,94,89194,81.08545454545454,8
0.2,1100,18,89212,81.02815622161671,14
0.2,1101,93,89305,81.03901996370236,8
0.2,1102,27,89332,80.99002719854941,6
0.2,1103,95,89427,81.00271739130434,7
0.2,1104,86,89513,81.00723981900452,15
0.2,1105,94,89607,81.01898734177215,7
0.2,1106,94,89701,81.03071364046974,7
0.2,1107,92,89793,81.04061371841155,9
0.2,1108,92,89885,81.05049594229035,10
0.2,1109,20,89905,80.99549549549549,13
0.2,1110,93,89998,81.00630063006301,8
0.2,1111,94,90092,81.0179856115108,8
0.2,1112,94,90186,81.02964959568733,7
0.2,1113,94,90280,81.04129263913823,7
0.2,1114,-119,90161,80.86188340807175,14
0.2,1115,94,90255,80.8736559139785,7
0.2,1116,92,90347,80.88361683079678,9
0.2,1117,96,90443,80.89713774597496,6
0.2,1118,89,90532,80.90437890974084,12
0.2,1119,89,90621,80.91160714285714,12
0.2,1120,92,90713,80.92149866190901,9
0.2,1121,94,90807,80.93315508021391,7
0.2,1122,91,90898,80.94211932324131,10
0.2,1123,25,90923,80.89234875444839,8
0.2,1124,27,90950,80.84444444444445,6
0.2,1125,93,91043,80.85523978685613,8
0.2,1126,94,91137,80.86690328305235,7
0.2,1127,93,91230,80.87765957446808,9
0.2,1128,93,91323,80.88839681133747,8
0.2,1129,92,91415,80.89823008849558,10
0.2,1130,96,91511,80.91158267020336,6
0.2,1131,93,91604,80.92226148409894,8
0.2,1132,19,91623,80.8676081200353,14
0.2,1133,86,91709,80.87213403880071,17
0.2,1134,95,91804,80.88458149779736,7
0.2,1135,94,91898,80.89612676056338,7
0.2,1136,92,91990,80.90589270008795,9
0.2,1137,93,92083,80.91652021089631,8
0.2,1138,90,92173,80.9244951712028,11
0.2,1139,94,92267,80.9359649122807,8
0.2,1140,91,92358,80.94478527607362,10
0.2,1141,92,92450,80.95446584938703,9
0.2,1142,83,92533,80.95625546806649,18
0.2,1143,90,92623,80.96416083916084,11
0.2,1144,21,92644,80.9117903930131,12
0.2,1145,94,92738,80.92321116928447,8
0.2,1146,95,92833,80.93548387096774,7
0.2,1147,92,92925,80.9451219512195,9
0.2,1148,27,92952,80.8981723237598,6
0.2,1149,90,93042,80.90608695652173,11
0.2,1150,92,93134,80.9157254561251,9
0.2,1151,94,93228,80.92708333333333,7
0.2,1152,92,93320,80.9366869037294,9
0.2,1153,96,93416,80.94974003466204,6
0.2,1154,95,93511,80.96190476190476,7
0.2,1155,93,93604,80.97231833910034,8
0.2,1156,27,93631,80.9256698357822,6
0.2,1157,91,93722,80.93436960276338,10
0.2,1158,91,93813,80.94305435720449,10
0.2,1159,91,93904,80.95172413793104,10
0.2,1160,92,93996,80.96124031007751,9
0.2,1161,93,94089,80.97160068846816,8
0.2,1162,85,94174,80.97506448839209,16
0.2,1163,95,94269,80.98711340206185,8
0.2,1164,14,94283,80.92961373390558,18
0.2,1165,93,94376,80.93996569468267,8
0.2,1166,94,94470,80.95115681233933,8
0.2,1167,91,94561,80.9597602739726,10
0.2,1168,89,94650,80.9666381522669,12
0.2,1169,91,94741,80.97521367521368,10
0.2,1170,95,94836,80.98719043552519,9
0.2,1171,85,94921,80.99061433447099,16
0.2,1172,91,95012,80.99914748508098,10
0.2,1173,91,95103,81.00766609880749,10
0.2,1174,23,95126,80.95829787234042,10
0.2,1175,94,95220,80.96938775510205,7
0.2,1176,93,95313,80.97960917587086,9
0.2,1177,89,95402,80.98641765704583,12
0.2,1178,91,95493,80.99491094147582,10
0.2,1179,89,95582,81.00169491525423,12
0.2,1180,92,95674,81.01100762066045,9
0.2,1181,90,95764,81.01861252115059,11
0.2,1182,95,95859,81.03043110735419,6
0.2,1183,90,95949,81.03800675675676,11
0.2,1184,94,96043,81.04894514767932,7
0.2,1185,89,96132,81.05564924114671,12
0.2,1186,91,96223,81.06402695871947,10
0.2,1187,86,96309,81.06818181818181,15
0.2,1188,90,96399,81.07569386038688,11
0.2,1189,95,96494,81.0873949579832,7
0.2,1190,95,96589,81.09907640638119,6
0.2,1191,26,96615,81.05285234899328,7
0.2,1192,92,96707,81.06202849958089,9
0.2,1193,92,96799,81.071189279732,9
0.2,1194,92,96891,81.08033472803348,9
0.2,1195,91,96982,81.0886287625418,10
0.2,1196,94,97076,81.09941520467837,7
0.2,1197,94,97170,81.110183639399,7
0.2,1198,94,97264,81.1209341117598,7
0.2,1199,94,97358,81.13166666666666,8
0.2,1200,91,97449,81.1398834304746,10
0.2,1201,-117,97332,80.97504159733776,14
0.2,1202,94,97426,80.98586866167913,8
0.2,1203,94,97520,80.99667774086379,7
0.2,1204,91,97611,81.00497925311204,10
0.2,1205,92,97703,81.01409618573798,9
0.2,1206,93,97796,81.02402651201325,8
0.2,1207,94,97890,81.03476821192054,8
0.2,1208,92,97982,81.04383788254756,9
0.2,1209,23,98005,80.99586776859505,10
0.2,1210,91,98096,81.00412881915771,10
0.2,1211,94,98190,81.01485148514851,7
0.2,1212,92,98282,81.02390766694147,9
0.2,1213,96,98378,81.03624382207579,6
0.2,1214,25,98403,80.99012345679013,8
0.2,1215,92,98495,80.99917763157895,9
0.2,1216,96,98591,81.01150369761709,6
0.2,1217,92,98683,81.02052545155993,9
0.2,1218,93,98776,81.03035274815423,8
0.2,1219,93,98869,81.04016393442623,8
0.2,1220,27,98896,80.995904995905,6
0.2,1221,93,98989,81.00572831423895,8
0.2,1222,23,99012,80.95829926410467,10
0.2,1223,87,99099,80.96323529411765,14
0.2,1224,95,99194,80.97469387755102,8
0.2,1225,93,99287,80.98450244698205,8
0.2,1226,95,99382,80.9959250203749,7
0.2,1227,87,99469,81.00081433224756,14
0.2,1228,92,99561,81.00976403580147,9
0.2,1229,94,99655,81.02032520325203,7
0.2,1230,93,99748,81.03005686433794,8
0.2,1231,93,99841,81.03977272727273,8
0.2,1232,94,99935,81.05028386050284,7
0.2,1233,93,100028,81.05996758508914,10
0.2,1234,27,100055,81.01619433198381,6
0.2,1235,95,100150,81.02750809061489,6
0.2,1236,96,100246,81.03961196443008,6
0.2,1237,95,100341,81.05088852988692,6
0.2,1238,91,100432,81.0589184826473,11
0.2,1239,96,100528,81.07096774193549,6
0.2,1240,93,100621,81.08058017727639,8
0.2,1241,83,100704,81.08212560386474,19
0.2,1242,91,100795,81.09010458567981,11
0.2,1243,90,100885,81.09726688102894,11
0.2,1244,92,100977,81.10602409638554,10
0.2,1245,95,101072,81.11717495987159,6
0.2,1246,86,101158,81.12109061748195,15
0.2,1247,92,101250,81.1298076923077,9
0.2,1248,93,101343,81.13931144915932,8
0.2,1249,89,101432,81.1456,12
0.2,1250,89,101521,81.15187849720223,14
0.2,1251,88,101609,81.15734824281151,13
0.2,1252,95,101704,81.16839584996009,7
0.2,1253,91,101795,81.1762360446571,10
0.2,1254,91,101886,81.18406374501993,10
0.2,1255,92,101978,81.19267515923566,9
0.2,1256,93,102071,81.20206841686556,8
0.2,1257,96,102167,81.21383147853736,6
0.2,1258,93,102260,81.22319301032566,8
0.2,1259,95,102355,81.23412698412699,6
0.2,1260,-49,102306,81.13084853291039,12
0.2,1261,93,102399,81.14025356576862,8
0.2,1262,91,102490,81.14806017418844,11
0.2,1263,94,102584,81.15822784810126,7
0.2,1264,93,102677,81.16758893280632,8
0.2,1265,88,102765,81.17298578199052,13
0.2,1266,96,102861,81.18468823993686,6
0.2,1267,96,102957,81.19637223974763,6
0.2,1268,90,103047,81.2033096926714,11
0.2,1269,20,103067,81.15511811023622,13
0.2,1270,94,103161,81.1652242328875,7
0.2,1271,93,103254,81.1745283018868,9
0.2,1272,87,103341,81.17910447761194,14
0.2,1273,88,103429,81.18445839874411,15
0.2,1274,90,103519,81.1913725490196,11
0.2,1275,96,103615,81.20297805642633,7
0.2,1276,91,103706,81.21064996084573,10
0.2,1277,95,103801,81.22143974960876,6
0.2,1278,6,103807,81.16262705238468,27
0.2,1279,-48,103759,81.06171875,12
0.2,1280,20,103779,81.01405152224824,12
0.2,1281,94,103873,81.02418096723869,7
0.2,1282,88,103961,81.02961808261887,13
0.2,1283,90,104051,81.03660436137072,11
0.2,1284,95,104146,81.04747081712063,7
0.2,1285,91,104237,81.0552099533437,11
0.2,1286,93,104330,81.06449106449107,8
0.2,1287,92,104422,81.07298136645963,10
0.2,1288,92,104514,81.08145849495733,9
0.2,1289,93,104607,81.0906976744186,8
0.2,1290,93,104700,81.09992254066616,8
0.2,1291,90,104790,81.10681114551083,13
0.2,1292,90,104880,81.11368909512761,11
0.2,1293,96,104976,81.12519319938175,6
0.2,1294,90,105066,81.13204633204633,11
0.2,1295,95,105161,81.14274691358025,6
0.2,1296,93,105254,81.15188897455667,8
0.2,1297,24,105278,81.10785824345146,9
0.2,1298,94,105372,81.11778290993071,7
0.2,1299,93,105465,81.12692307692308,8
0.2,1300,95,105560,81.13758647194466,7
0.2,1301,25,105585,81.09447004608295,8
0.2,1302,96,105681,81.10590943975441,6
0.2,1303,88,105769,81.1111963190184,13
0.2,1304,92,105861,81.11954022988506,10
0.2,1305,91,105952,81.1271056661562,10
0.2,1306,94,106046,81.13695485845447,8
0.2,1307,95,106141,81.14755351681957,6
0.2,1308,95,106236,81.1581359816654,9
0.2,1309,88,106324,81.16335877862595,13
0.2,1310,93,106417,81.1723874904653,8
0.2,1311,91,106508,81.1798780487805,10
0.2,1312,26,106534,81.13785224676313,7
0.2,1313,95,106629,81.14840182648402,6
0.2,1314,92,106721,81.15665399239543,9
0.2,1315,88,106809,81.16185410334346,13
0.2,1316,96,106905,81.17312072892939,6
0.2,1317,93,106998,81.18209408194234,8
0.2,1318,94,107092,81.1918119787718,8
0.2,1319,23,107115,81.14772727272727,10
0.2,1320,96,107211,81.15897047691143,6
0.2,1321,91,107302,81.16641452344932,10
0.2,1322,91,107393,81.17384731670445,10
0.2,1323,92,107485,81.18202416918429,9
0.2,1324,89,107574,81.18792452830189,12
0.2,1325,95,107669,81.19834087481146,6
0.2,1326,89,107758,81.20422004521477,12
0.2,1327,21,107779,81.15888554216868,13
0.2,1328,89,107868,81.16478555304741,12
0.2,1329,17,107885,81.11654135338345,17
0.2,1330,88,107973,81.12171299774606,13
0.2,1331,91,108064,81.12912912912913,10
0.2,1332,20,108084,81.08327081770443,13
0.2,1333,92,108176,81.09145427286357,9
0.2,1334,94,108270,81.10112359550561,8
0.2,1335,96,108366,81.1122754491018,6
0.2,1336,26,108392,81.07105459985041,7
0.2,1337,91,108483,81.07847533632287,10
0.2,1338,22,108505,81.03435399551904,10
0.2,1339,95,108600,81.04477611940298,7
0.2,1340,92,108692,81.05294556301267,10
0.2,1341,95,108787,81.06333830104322,6
0.2,1342,19,108806,81.01712583767684,13
0.2,1343,96,108902,81.02827380952381,7
0.2,1344,94,108996,81.03791821561339,8
0.2,1345,91,109087,81.04531946508172,11
0.2,1346,94,109181,81.05493689680772,7
0.2,1347,95,109276,81.06528189910979,6
0.2,1348,94,109370,81.07487027427725,7
0.2,1349,92,109462,81.08296296296297,9
0.2,1350,91,109553,81.09030347890452,10
0.2,1351,23,109576,81.04733727810651,10
0.2,1352,88,109664,81.05247597930524,13
0.2,1353,94,109758,81.06203840472674,7
0.2,1354,16,109774,81.0140221402214,16
0.2,1355,94,109868,81.023598820059,7
0.2,1356,24,109892,80.98157700810611,9
0.2,1357,93,109985,80.99042709867452,8
0.2,1358,89,110074,80.9963208241354,12
0.2,1359,89,110163,81.00220588235294,12
0.2,1360,96,110259,81.01322556943424,6
0.2,1361,94,110353,81.02276064610867,8
0.2,1362,25,110378,80.98165810711666,9
0.2,1363,19,110397,80.93621700879766,15
0.2,1364,88,110485,80.94139194139194,13
0.2,1365,88,110573,80.94655929721816,13
0.2,1366,88,110661,80.95171909290417,14
0.2,1367,94,110755,80.96125730994152,8
0.2,1368,94,110849,80.97078159240321,7
0.2,1369,17,110866,80.92408759124088,15
0.2,1370,88,110954,80.92924872355944,13
0.2,1371,94,111048,80.93877551020408,7
0.2,1372,91,111139,80.94610342316096,11
0.2,1373,25,111164,80.90538573508006,8
0.2,1374,96,111260,80.91636363636364,6
0.2,1375,94,111354,80.92587209302326,8
0.2,1376,-49,111305,80.83151779230211,12
0.2,1377,87,111392,80.83599419448475,15
0.2,1378,89,111481,80.84191443074691,12
0.2,1379,93,111574,80.85072463768115,8
0.2,1380,95,111669,80.86097031136858,7
0.2,1381,91,111760,80.86830680173661,11
0.2,1382,94,111854,80.87780187997107,7
0.2,1383,94,111948,80.88728323699422,8
0.2,1384,94,112042,80.89675090252707,7
0.2,1385,91,112133,80.9040404040404,10
0.2,1386,90,112223,80.91059841384282,12
0.2,1387,90,112313,80.9171469740634,11
0.2,1388,92,112405,80.9251259899208,9
0.2,1389,91,112496,80.93237410071943,10
0.2,1390,15,112511,80.88497483824587,17
0.2,1391,91,112602,80.89224137931035,10
0.2,1392,25,112627,80.85211773151471,9
0.2,1393,96,112723,80.86298421807747,6
0.2,1394,95,112818,80.8731182795699,6
0.2,1395,95,112913,80.88323782234957,6
0.2,1396,93,113006,80.89191123836792,11
0.2,1397,89,113095,80.89771101573676,12
0.2,1398,92,113187,80.90564689063616,9
0.2,1399,94,113281,80.915,7
0.2,1400,94,113375,80.9243397573162,8
0.2,1401,91,113466,80.93152639087019,10
0.2,1402,92,113558,80.93941553813258,9
0.2,1403,25,113583,80.89957264957265,8
0.2,1404,88,113671,80.90462633451958,13
0.2,1405,92,113763,80.91251778093883,9
0.2,1406,91,113854,80.91968727789623,12
0.2,1407,25,113879,80.8799715909091,8
0.2,1408,95,113974,80.88999290276791,6
0.2,1409,93,114067,80.89858156028369,8
0.2,1410,95,114162,80.90857547838412,6
0.2,1411,93,114255,80.9171388101983,10
0.2,1412,90,114345,80.92356687898089,12
0.2,1413,95,114440,80.93352192362093,7
0.2,1414,94,114534,80.94275618374559,7
0.2,1415,93,114627,80.95127118644068,8
0.2,1416,94,114721,80.9604798870854,7
0.2,1417,95,114816,80.9703808180536,6
0.2,1418,94,114910,80.97956307258633,8
0.2,1419,90,115000,80.98591549295774,11
0.2,1420,92,115092,80.99366643209008,9
0.2,1421,94,115186,81.0028129395218,7
0.2,1422,89,115275,81.00843288826422,12
0.2,1423,91,115366,81.01544943820225,10
0.2,1424,95,115461,81.02526315789474,8
0.2,1425,94,115555,81.03436185133239,8
0.2,1426,94,115649,81.04344779257183,8
0.2,1427,95,115744,81.0532212885154,6
0.2,1428,94,115838,81.06228131560532,8
0.2,1429,96,115934,81.07272727272728,6
0.2,1430,92,116026,81.08036338225017,9
0.2,1431,91,116117,81.0872905027933,10
0.2,1432,93,116210,81.09560362875087,8
0.2,1433,92,116302,81.10320781032078,9
0.2,1434,93,116395,81.11149825783973,8
0.2,1435,95,116490,81.12116991643454,6
0.2,1436,85,116575,81.12386917188587,16
0.2,1437,93,116668,81.13212795549374,8
0.2,1438,95,116763,81.14176511466296,8
0.2,1439,92,116855,81.14930555555556,9
0.2,1440,96,116951,81.15961138098542,6
0.2,1441,21,116972,81.11789181692095,11
0.2,1442,24,116996,81.07830907830908,9
0.2,1443,22,117018,81.03739612188366,11
0.2,1444,94,117112,81.04636678200691,7
0.2,1445,86,117198,81.04979253112033,15
0.2,1446,23,117221,81.00967519004837,10
0.2,1447,95,117316,81.01933701657458,6
0.2,1448,-53,117263,80.92684610075915,18
0.2,1449,94,117357,80.93586206896552,7
0.2,1450,92,117449,80.9434872501723,9
0.2,1451,92,117541,80.95110192837465,9
0.2,1452,94,117635,80.96008258774948,7
0.2,1453,95,117730,80.9697386519945,6
0.2,1454,96,117826,80.98006872852234,6
0.2,1455,95,117921,80.9896978021978,6
0.2,1456,92,118013,80.99725463280714,9
0.2,1457,93,118106,81.00548696844993,8
0.2,1458,89,118195,81.01096641535298,12
0.2,1459,94,118289,81.01986301369863,7
0.2,1460,90,118379,81.02600958247776,11
0.2,1461,96,118475,81.03625170998632,6
0.2,1462,94,118569,81.04511278195488,7
0.2,1463,95,118664,81.05464480874316,7
0.2,1464,92,118756,81.06211604095563,9
0.2,1465,87,118843,81.06616643929058,14
0.2,1466,95,118938,81.07566462167689,7
0.2,1467,91,119029,81.08242506811989,10
0.2,1468,95,119124,81.0918992511913,6
0.2,1469,93,119217,81.1,9
0.2,1470,93,119310,81.10808973487424,9
0.2,1471,90,119400,81.11413043478261,11
0.2,1472,95,119495,81.1235573659199,7
0.2,1473,94,119589,81.13229308005427,7
0.2,1474,91,119680,81.13898305084746,10
0.2,1475,94,119774,81.14769647696477,7
0.2,1476,94,119868,81.1563981042654,7
0.2,1477,90,119958,81.16238159675237,11
0.2,1478,89,120047,81.16768086544963,12
0.2,1479,95,120142,81.17702702702702,8
0.2,1480,-52,120090,81.08710330857528,16
0.2,1481,93,120183,81.09514170040485,8
0.2,1482,27,120210,81.05866486850978,6
0.2,1483,15,120225,81.01415094339623,17
0.2,1484,90,120315,81.02020202020202,12
0.2,1485,94,120409,81.02893674293405,7
0.2,1486,94,120503,81.03765971755212,7
0.2,1487,92,120595,81.04502688172043,9
0.2,1488,92,120687,81.05238415043654,9
0.2,1489,91,120778,81.05906040268457,10
0.2,1490,27,120805,81.02280348759221,6
0.2,1491,94,120899,81.03150134048258,7
0.2,1492,80,120979,81.03081044876089,21
0.2,1493,94,121073,81.03949129852744,7
0.2,1494,92,121165,81.04682274247492,9
0.2,1495,15,121180,81.00267379679144,21
0.2,1496,20,121200,80.96192384769539,12
0.2,1497,89,121289,80.96728971962617,13
0.2,1498,25,121314,80.92995330220147,8
0.2,1499,82,121396,80.93066666666667,19
0.2,1500,94,121490,80.93937375083277,8
0.2,1501,94,121584,80.94806924101198,9
0.2,1502,95,121679,80.95741849634065,7
0.2,1503,95,121774,80.96675531914893,6
0.2,1504,93,121867,80.97475083056479,8
0.2,1505,92,121959,80.9820717131474,9
0.2,1506,89,122048,80.98739216987393,12
0.2,1507,27,122075,80.95159151193634,6
0.2,1508,96,122171,80.96156394963552,6
0.2,1509,92,122263,80.96887417218544,9
0.2,1510,21,122284,80.92918596955658,12
0.2,1511,94,122378,80.93783068783068,7
0.2,1512,94,122472,80.94646397884996,7
0.2,1513,95,122567,80.9557463672391,6
0.2,1514,95,122662,80.96501650165017,6
0.2,1515,14,122676,80.92084432717678,18
0.2,1516,91,122767,80.92748846407383,10
0.2,1517,95,122862,80.93675889328063,7
0.2,1518,89,122951,80.94206714944042,12
0.2,1519,92,123043,80.94934210526316,9
0.2,1520,93,123136,80.95726495726495,9
0.2,1521,92,123228,80.96452036793693,9
0.2,1522,89,123317,80.96979645436639,12
0.2,1523,20,123337,80.92979002624672,13
0.2,1524,93,123430,80.9377049180328,9
0.2,1525,92,123522,80.94495412844037,9
0.2,1526,90,123612,80.950884086444,11
0.2,1527,92,123704,80.95811518324608,9
0.2,1528,92,123796,80.96533682145193,9
0.2,1529,94,123890,80.97385620915033,8
0.2,1530,16,123906,80.93141737426518,16
0.2,1531,95,124001,80.94060052219321,6
0.2,1532,92,124093,80.9478147423353,10
0.2,1533,89,124182,80.95306388526727,12
0.2,1534,91,124273,80.95960912052118,10
0.2,1535,93,124366,80.96744791666667,8
0.2,1536,92,124458,80.97462589459987,9
0.2,1537,92,124550,80.98179453836151,9
0.2,1538,25,124575,80.94541910331384,8
0.2,1539,89,124664,80.95064935064936,12
0.2,1540,93,124757,80.95846852693056,8
0.2,1541,95,124852,80.96757457846952,6
0.2,1542,95,124947,80.97666882696046,6
0.2,1543,92,125039,80.98380829015544,9
0.2,1544,92,125131,80.99093851132686,9
0.2,1545,95,125226,81.0,6
0.2,1546,93,125319,81.00775694893342,8
0.2,1547,85,125404,81.01033591731266,17
0.2,1548,94,125498,81.0187217559716,7
0.2,1549,90,125588,81.02451612903226,11
0.2,1550,95,125683,81.03352675693101,6
0.2,1551,96,125779,81.04317010309278,6
0.2,1552,94,125873,81.05151320025756,7
0.2,1553,88,125961,81.05598455598455,13
0.2,1554,92,126053,81.06302250803859,9
0.2,1555,94,126147,81.07133676092545,7
0.2,1556,91,126238,81.07771355170199,10
0.2,1557,94,126332,81.08600770218229,7
0.2,1558,20,126352,81.04682488774856,14
0.2,1559,93,126445,81.05448717948718,8
0.2,1560,84,126529,81.05637411915438,17
0.2,1561,94,126623,81.06466069142125,7
0.2,1562,91,126714,81.07101727447217,10
0.2,1563,95,126809,81.07992327365729,6
0.2,1564,88,126897,81.08434504792332,15
0.2,1565,91,126988,81.09067688378033,10
0.2,1566,92,127080,81.09763880025527,9
0.2,1567,95,127175,81.10650510204081,6
0.2,1568,94,127269,81.11472275334609,7
0.2,1569,93,127362,81.12229299363058,9
0.2,1570,95,127457,81.13112667091025,7
0.2,1571,93,127550,81.13867684478372,8
0.2,1572,94,127644,81.14685314685315,7
0.2,1573,93,127737,81.15438373570521,8
0.2,1574,27,127764,81.12,6
0.2,1575,25,127789,81.08439086294416,8
0.2,1576,89,127878,81.08941027266962,12
0.2,1577,92,127970,81.09632446134347,9
0.2,1578,90,128060,81.10196326789107,11
0.2,1579,95,128155,81.11075949367088,6
0.2,1580,93,128248,81.11827956989248,9
0.2,1581,85,128333,81.12073324905184,16
0.2,1582,95,128428,81.1295009475679,8
0.2,1583,96,128524,81.13888888888889,6
0.2,1584,91,128615,81.14511041009463,10
0.2,1585,25,128640,81.10970996216898,7
0.2,1586,88,128728,81.11405166981727,13
0.2,1587,95,128823,81.12279596977329,8
0.2,1588,94,128917,81.13089993706734,9
0.2,1589,92,129009,81.1377358490566,9
0.2,1590,87,129096,81.1414204902577,14
0.2,1591,90,129186,81.14698492462311,11
0.2,1592,89,129275,81.15191462649089,12
0.2,1593,95,129370,81.16060225846925,7
0.2,1594,92,129462,81.16739811912225,9
0.2,1595,92,129554,81.17418546365914,9
0.2,1596,89,129643,81.17908578584847,12
0.2,1597,94,129737,81.18710888610764,8
0.2,1598,21,129758,81.1494684177611,12
0.2,1599,94,129852,81.1575,7
0.2,1600,91,129943,81.1636477201749,11
0.2,1601,83,130026,81.16479400749064,18
0.2,1602,94,130120,81.17280099812851,7
0.2,1603,93,130213,81.18017456359102,8
0.2,1604,95,130308,81.18878504672897,7
0.2,1605,22,130330,81.1519302615193,11
0.2,1606,27,130357,81.11823273179839,6
0.2,1607,95,130452,81.1268656716418,7
0.2,1608,94,130546,81.13486637663145,7
0.2,1609,96,130642,81.14409937888199,7
0.2,1610,94,130736,81.15207945375543,7
0.2,1611,83,130819,81.15322580645162,18
0.2,1612,89,130908,81.15809051456912,13
0.2,1613,22,130930,81.12143742255266,11
0.2,1614,91,131021,81.12755417956656,11
0.2,1615,86,131107,81.1305693069307,15
0.2,1616,90,131197,81.1360544217687,11
0.2,1617,93,131290,81.1433868974042,8
0.2,1618,92,131382,81.15009264978382,9
0.2,1619,93,131475,81.1574074074074,8
0.2,1620,93,131568,81.16471314003701,8
0.2,1621,93,131661,81.17200986436498,8
0.2,1622,92,131753,81.17868145409734,9
0.2,1623,92,131845,81.1853448275862,9
0.2,1624,92,131937,81.192,10
0.2,1625,92,132029,81.19864698646987,9
0.2,1626,92,132121,81.20528580208973,10
0.2,1627,94,132215,81.21314496314497,8
0.2,1628,94,132309,81.22099447513813,8
0.2,1629,94,132403,81.22883435582823,8
0.2,1630,93,132496,81.23605150214593,8
0.2,1631,95,132591,81.24448529411765,6
0.2,1632,95,132686,81.25290875688916,6
0.2,1633,92,132778,81.25948592411261,9
0.2,1634,91,132869,81.26544342507646,10
0.2,1635,95,132964,81.27383863080685,7
0.2,1636,94,133058,81.28161270616982,8
0.2,1637,88,133146,81.28571428571429,13
0.2,1638,93,133239,81.2928615009152,8
0.2,1639,91,133330,81.29878048780488,10
0.2,1640,94,133424,81.30652041438148,7
0.2,1641,89,133513,81.31120584652862,12
0.2,1642,92,133605,81.31771150334754,9
0.2,1643,95,133700,81.32603406326034,7
0.2,1644,96,133796,81.33495440729483,6
0.2,1645,87,133883,81.33839611178615,14
0.2,1646,95,133978,81.34669095324833,7
0.2,1647,94,134072,81.35436893203884,7
0.2,1648,91,134163,81.36021831412978,10
0.2,1649,93,134256,81.36727272727273,8
0.2,1650,89,134345,81.37189582071471,12
0.2,1651,91,134436,81.37772397094432,11
0.2,1652,93,134529,81.38475499092559,8
0.2,1653,27,134556,81.35187424425635,6
0.2,1654,92,134648,81.3583081570997,9
0.2,1655,94,134742,81.3659420289855,7
0.2,1656,93,134835,81.3729631864816,8
0.2,1657,20,134855,81.33594692400483,13
0.2,1658,90,134945,81.34116937914406,11
0.2,1659,93,135038,81.34819277108434,8
0.2,1660,95,135133,81.35641180012041,7
0.2,1661,94,135227,81.36401925391095,8
0.2,1662,95,135322,81.37221888153938,6
0.2,1663,96,135418,81.38100961538461,7
0.2,1664,23,135441,81.34594594594594,9
0.2,1665,94,135535,81.35354141656663,7
0.2,1666,93,135628,81.36052789442111,8
0.2,1667,92,135720,81.36690647482014,10
0.2,1668,93,135813,81.37387657279808,8
0.2,1669,81,135894,81.37365269461078,20
0.2,1670,27,135921,81.34111310592459,6
0.2,1671,95,136016,81.34928229665071,7
0.2,1672,95,136111,81.35744172145846,6
0.2,1673,94,136205,81.36499402628435,7
0.2,1674,88,136293,81.36895522388059,13
0.2,1675,25,136318,81.33532219570405,8
0.2,1676,93,136411,81.34227787716159,9
0.2,1677,87,136498,81.34564958283671,14
0.2,1678,95,136593,81.35378201310304,6
0.2,1679,93,136686,81.36071428571428,8
0.2,1680,89,136775,81.36525877453896,12
0.2,1681,95,136870,81.37336504161712,7
0.2,1682,94,136964,81.38086749851456,8
0.2,1683,92,137056,81.38717339667458,10
0.2,1684,93,137149,81.39406528189912,8
0.2,1685,88,137237,81.39798339264532,13
0.2,1686,96,137333,81.40663900414938,6
0.2,1687,92,137425,81.41291469194313,9
0.2,1688,87,137512,81.4162226169331,14
0.2,1689,94,137606,81.42366863905326,7
0.2,1690,96,137702,81.43228858663512,6
0.2,1691,23,137725,81.39775413711584,12
0.2,1692,90,137815,81.40283520378027,11
0.2,1693,93,137908,81.40968122786305,9
0.2,1694,94,138002,81.41710914454278,7
0.2,1695,94,138096,81.4245283018868,8
0.2,1696,94,138190,81.43193871538008,8
0.2,1697,95,138285,81.43992932862191,6
0.2,1698,89,138374,81.44437904649794,12
0.2,1699,94,138468,81.45176470588235,7
0.2,1700,25,138493,81.4185773074662,10
0.2,1701,93,138586,81.42538190364277,9
0.2,1702,94,138680,81.43276570757487,7
0.2,1703,92,138772,81.43896713615024,9
0.2,1704,92,138864,81.44516129032257,10
0.2,1705,93,138957,81.45193434935521,8
0.2,1706,94,139051,81.45928529584066,8
0.2,1707,94,139145,81.46662763466043,7
0.2,1708,95,139240,81.47454651843184,7
0.2,1709,93,139333,81.4812865497076,8
0.2,1710,92,139425,81.48743424897721,10
0.2,1711,94,139519,81.4947429906542,7
0.2,1712,89,139608,81.49912434325745,12
0.2,1713,89,139697,81.50350058343057,12
0.2,1714,90,139787,81.50845481049562,11
0.2,1715,87,139874,81.51165501165501,14
0.2,1716,92,139966,81.51776354105999,9
0.2,1717,96,140062,81.52619324796275,6
0.2,1718,-44,140018,81.45317044793485,8
0.2,1719,92,140110,81.45930232558139,9
0.2,1720,90,140200,81.46426496223125,12
0.2,1721,93,140293,81.47096399535424,9
0.2,1722,91,140384,81.47649448636099,10
0.2,1723,92,140476,81.48259860788863,9
0.2,1724,91,140567,81.48811594202898,11
0.2,1725,92,140659,81.49420625724218,9
0.2,1726,96,140755,81.5026056745802,6
0.2,1727,87,140842,81.50578703703704,14
0.2,1728,93,140935,81.51243493348757,8
0.2,1729,94,141029,81.51965317919075,7
0.2,1730,95,141124,81.52744078567302,9
0.2,1731,94,141218,81.53464203233257,7
0.2,1732,95,141313,81.54241200230814,6
0.2,1733,93,141406,81.54901960784314,8
0.2,1734,-50,141356,81.47319884726225,14
0.2,1735,86,141442,81.4758064516129,15
0.2,1736,93,141535,81.48244099021301,9
0.2,1737,92,141627,81.4884925201381,9
0.2,1738,95,141722,81.49626221966648,7
0.2,1739,94,141816,81.50344827586207,7
0.2,1740,21,141837,81.46869615163699,11
0.2,1741,92,141929,81.47474167623422,9
0.2,1742,91,142020,81.4802065404475,10
0.2,1743,94,142114,81.48738532110092,8
0.2,1744,24,142138,81.45444126074499,9
0.2,1745,84,142222,81.45589919816724,17
0.2,1746,94,142316,81.46307956496852,7
0.2,1747,96,142412,81.47139588100687,6
0.2,1748,91,142503,81.47684391080618,10
0.2,1749,95,142598,81.48457142857143,7
0.2,1750,94,142692,81.49171901770417,7
0.2,1751,94,142786,81.49885844748859,8
0.2,1752,92,142878,81.50484883057615,9
0.2,1753,83,142961,81.50570125427593,18
0.2,1754,91,143052,81.5111111111111,11
0.2,1755,94,143146,81.51822323462414,7
0.2,1756,94,143240,81.52532726237905,7
0.2,1757,95,143335,81.532992036405,7
0.2,1758,90,143425,81.53780557134736,11
0.2,1759,25,143450,81.50568181818181,7
0.2,1760,90,143540,81.51050539466212,11
0.2,1761,82,143622,81.51078320090807,19
0.2,1762,93,143715,81.5173000567215,10
0.2,1763,17,143732,81.48072562358277,16
0.2,1764,89,143821,81.48498583569405,12
0.2,1765,92,143913,81.49093997734994,9
0.2,1766,91,144004,81.49632144878325,10
0.2,1767,93,144097,81.50282805429865,8
0.2,1768,92,144189,81.5087620124364,9
0.2,1769,96,144285,81.51694915254237,7
0.2,1770,94,144379,81.52399774138904,10
0.2,1771,95,144474,81.53160270880362,6
0.2,1772,93,144567,81.53807106598985,8
0.2,1773,92,144659,81.54396843291995,9
0.2,1774,89,144748,81.54816901408451,12
0.2,1775,93,144841,81.55461711711712,8
0.2,1776,92,144933,81.56049521665729,9
0.2,1777,94,145027,81.56749156355455,7
0.2,1778,91,145118,81.57279370432828,10
0.2,1779,92,145210,81.57865168539325,9
0.2,1780,93,145303,81.58506457046603,10
0.2,1781,91,145394,81.59034792368125,10
0.2,1782,96,145490,81.59842961301177,6
0.2,1783,95,145585,81.60594170403587,7
0.2,1784,93,145678,81.61232492997199,8
0.2,1785,92,145770,81.61814109742441,9
0.2,1786,88,145858,81.6217123670957,13
0.2,1787,91,145949,81.62695749440716,10
0.2,1788,25,145974,81.5953046394634,8
0.2,1789,95,146069,81.60279329608939,7
0.2,1790,92,146161,81.60859854829704,10
0.2,1791,94,146255,81.61551339285714,7
0.2,1792,-48,146207,81.54322364751813,12
0.2,1793,92,146299,81.54905239687848,9
0.2,1794,95,146394,81.55654596100278,7
0.2,1795,92,146486,81.56236080178174,9
0.2,1796,95,146581,81.5698386199221,6
0.2,1797,94,146675,81.57675194660735,7
0.2,1798,91,146766,81.58198999444136,10
0.2,1799,84,146850,81.58333333333333,17
0.2,1800,-50,146800,81.51027207107163,14
0.2,1801,89,146889,81.51442841287458,12
0.2,1802,95,146984,81.52190793122574,6
0.2,1803,95,147079,81.52937915742794,6
0.2,1804,93,147172,81.53573407202217,8
0.2,1805,91,147263,81.54097452934663,10
0.2,1806,88,147351,81.54454897620366,13
0.2,1807,92,147443,81.55033185840708,9
0.2,1808,94,147537,81.55721393034825,7
0.2,1809,94,147631,81.56408839779006,8
0.2,1810,94,147725,81.57095527332966,7
0.2,1811,92,147817,81.57671081677704,9
0.2,1812,93,147910,81.58301158301158,8
0.2,1813,93,148003,81.58930540242558,8
0.2,1814,94,148097,81.59614325068871,7
0.2,1815,94,148191,81.60297356828194,8
0.2,1816,90,148281,81.60759493670886,11
0.2,1817,94,148375,81.61441144114411,10
0.2,1818,94,148469,81.62122045079714,8
0.2,1819,18,148487,81.58626373626373,14
0.2,1820,96,148583,81.5941790225151,6
0.2,1821,86,148669,81.59659714599341,15
0.2,1822,90,148759,81.60120680197477,11
0.2,1823,93,148852,81.60745614035088,8
0.2,1824,94,148946,81.61424657534246,7
0.2,1825,95,149041,81.62157721796277,7
0.2,1826,91,149132,81.62671045429666,10
0.2,1827,94,149226,81.63347921225383,7
0.2,1828,94,149320,81.64024056861673,7
0.2,1829,91,149411,81.64535519125683,10
0.2,1830,94,149505,81.65210267613325,7
0.2,1831,91,149596,81.65720524017468,10
0.2,1832,20,149616,81.62356792144026,12
0.2,1833,17,149633,81.58833151581243,16
0.2,1834,92,149725,81.59400544959128,9
0.2,1835,94,149819,81.60076252723312,7
0.2,1836,95,149914,81.60805661404464,7
0.2,1837,94,150008,81.61479869423286,7
0.2,1838,95,150103,81.62207721587819,6
0.2,1839,93,150196,81.62826086956522,9
0.2,1840,95,150291,81.63552417164584,7
0.2,1841,23,150314,81.60369163952225,9
0.2,1842,94,150408,81.61041779707,7
0.2,1843,96,150504,81.6182212581345,6
0.2,1844,96,150600,81.6260162601626,6
0.2,1845,92,150692,81.63163596966415,9
0.2,1846,94,150786,81.63833243096914,7
0.2,1847,90,150876,81.64285714285714,11
0.2,1848,19,150895,81.60897782585181,14
0.2,1849,-51,150844,81.5372972972973,16
0.2,1850,92,150936,81.54294975688816,9
0.2,1851,94,151030,81.54967602591793,7
0.2,1852,92,151122,81.55531570426335,9
0.2,1853,93,151215,81.56148867313915,8
0.2,1854,96,151311,81.56927223719677,6
0.2,1855,92,151403,81.57489224137932,9
0.2,1856,85,151488,81.5767366720517,16
0.2,1857,94,151582,81.58342303552206,8
0.2,1858,90,151672,81.58795051102743,11
0.2,1859,93,151765,81.59408602150538,8
0.2,1860,89,151854,81.5980655561526,12
0.2,1861,14,151868,81.56176154672396,19
0.2,1862,92,151960,81.56736446591519,9
0.2,1863,94,152054,81.57403433476395,7
0.2,1864,26,152080,81.54423592493298,8
0.2,1865,14,152094,81.50803858520901,20
0.2,1866,91,152185,81.51312265666846,10
0.2,1867,91,152276,81.51820128479658,10
0.2,1868,94,152370,81.52487961476726,7
0.2,1869,90,152460,81.52941176470588,11
0.2,1870,90,152550,81.53393907001603,11
0.2,1871,95,152645,81.54113247863248,6
0.2,1872,92,152737,81.54671649759744,9
0.2,1873,89,152826,81.55069370330843,12
0.2,1874,94,152920,81.55733333333333,7
0.2,1875,87,153007,81.56023454157783,14
0.2,1876,93,153100,81.56632924880128,8
0.2,1877,23,153123,81.53514376996804,9
0.2,1878,93,153216,81.54124534326769,8
0.2,1879,93,153309,81.54734042553191,8
0.2,1880,85,153394,81.5491759702286,16
0.2,1881,91,153485,81.55419766206164,10
0.2,1882,87,153572,81.5570897503983,14
0.2,1883,87,153659,81.5599787685775,14
0.2,1884,95,153754,81.56710875331565,6
0.2,1885,95,153849,81.57423117709438,7
0.2,1886,88,153937,81.5776364599894,14
0.2,1887,92,154029,81.58315677966101,10
0.2,1888,93,154122,81.58920063525674,9
0.2,1889,94,154216,81.5957671957672,7
0.2,1890,94,154310,81.602326811211,7
0.2,1891,92,154402,81.60782241014799,9
0.2,1892,92,154494,81.61331220285261,9
0.2,1893,92,154586,81.61879619852165,9
0.2,1894,94,154680,81.62532981530343,7
0.2,1895,23,154703,81.59440928270043,10
0.2,1896,87,154790,81.59725882973116,14
0.2,1897,94,154884,81.60379346680716,9
0.2,1898,92,154976,81.60926803580833,9
0.2,1899,93,155069,81.61526315789473,8
0.2,1900,90,155159,81.61967385586533,11
0.2,1901,95,155254,81.6267087276551,7
0.2,1902,94,155348,81.63321071991592,7
0.2,1903,96,155444,81.64075630252101,6
0.2,1904,96,155540,81.64829396325459,7
0.2,1905,25,155565,81.61857292759706,7
0.2,1906,95,155660,81.6255899318301,6
0.2,1907,96,155756,81.63312368972747,6
0.2,1908,92,155848,81.63855421686748,9
0.2,1909,94,155942,81.64502617801047,8
0.2,1910,23,155965,81.61433804290947,9
0.2,1911,22,155987,81.5831589958159,12
0.2,1912,94,156081,81.58964976476739,7
0.2,1913,91,156172,81.59456635318705,10
0.2,1914,90,156262,81.59895561357702,12
0.2,1915,94,156356,81.6054279749478,7
0.2,1916,87,156443,81.60824204486177,15
0.2,1917,96,156539,81.61574556830031,6
0.2,1918,95,156634,81.62272016675352,6
0.2,1919,85,156719,81.62447916666666,17
0.2,1920,92,156811,81.62988027069235,10
0.2,1921,92,156903,81.63527575442248,9
0.2,1922,94,156997,81.64170566822673,7
0.2,1923,88,157085,81.64501039501039,13
0.2,1924,90,157175,81.64935064935065,11
0.2,1925,90,157265,81.65368639667705,11
0.2,1926,23,157288,81.62324857291127,9
0.2,1927,83,157371,81.62396265560166,18
0.2,1928,93,157464,81.6298600311042,8
0.2,1929,95,157559,81.63678756476683,6
0.2,1930,90,157649,81.64111859140341,11
0.2,1931,95,157744,81.648033126294,6
0.2,1932,94,157838,81.65442317640972,7
0.2,1933,92,157930,81.65977249224406,9
0.2,1934,94,158024,81.66614987080104,8
0.2,1935,96,158120,81.67355371900827,6
0.2,1936,85,158205,81.67527103768714,16
0.2,1937,93,158298,81.6811145510836,9
0.2,1938,95,158393,81.68798349664776,6
0.2,1939,86,158479,81.690206185567,15
0.2,1940,18,158497,81.65739309634209,14
0.2,1941,26,158523,81.62873326467559,6
0.2,1942,93,158616,81.63458569222851,8
0.2,1943,92,158708,81.63991769547324,10
0.2,1944,14,158722,81.6051413881748,20
0.2,1945,93,158815,81.61099691675231,8
0.2,1946,95,158910,81.61787365177196,7
0.2,1947,92,159002,81.62320328542094,9
0.2,1948,91,159093,81.62801436634172,10
0.2,1949,94,159187,81.63435897435897,7
0.2,1950,96,159283,81.6417221937468,6
0.2,1951,94,159377,81.64805327868852,7
0.2,1952,95,159472,81.65488991295443,6
0.2,1953,90,159562,81.65916069600819,11
0.2,1954,89,159651,81.66291560102302,12
0.2,1955,92,159743,81.66820040899796,10
0.2,1956,95,159838,81.67501277465509,6
0.2,1957,-47,159791,81.60929519918284,11
0.2,1958,93,159884,81.61510974987239,8
0.2,1959,94,159978,81.62142857142857,7
0.2,1960,96,160074,81.628760836308,6
0.2,1961,92,160166,81.63404689092762,9
0.2,1962,93,160259,81.63983698420785,8
0.2,1963,91,160350,81.64460285132382,11
0.2,1964,27,160377,81.61679389312977,6
0.2,1965,94,160471,81.62309257375381,7
0.2,1966,95,160566,81.62989323843416,6
0.2,1967,25,160591,81.60111788617886,8
0.2,1968,86,160677,81.60335195530726,15
0.2,1969,90,160767,81.60761421319798,11
0.2,1970,92,160859,81.61288685946221,9
0.2,1971,96,160955,81.62018255578093,6
0.2,1972,90,161045,81.62442980233148,11
0.2,1973,90,161135,81.62867274569402,11
0.2,1974,94,161229,81.63493670886076,7
0.2,1975,90,161319,81.63917004048584,12
0.2,1976,91,161410,81.64390490642387,10
0.2,1977,91,161501,81.64863498483317,10
0.2,1978,88,161589,81.65184436584133,13
0.2,1979,94,161683,81.65808080808081,7
0.2,1980,94,161777,81.66431095406361,8
0.2,1981,25,161802,81.63572149344097,8
0.2,1982,94,161896,81.64195663136661,7
0.2,1983,93,161989,81.6476814516129,8
0.2,1984,22,162011,81.6176322418136,11
0.2,1985,94,162105,81.62386706948641,7
0.2,1986,92,162197,81.62908907901358,9
0.2,1987,83,162280,81.62977867203219,18
0.2,1988,94,162374,81.63599798893917,7
0.2,1989,94,162468,81.64221105527638,8
0.2,1990,93,162561,81.64791562029131,8
0.2,1991,90,162651,81.65210843373494,11
0.2,1992,91,162742,81.65679879578525,10
0.2,1993,94,162836,81.6629889669007,7
0.2,1994,94,162930,81.66917293233082,7
0.2,1995,22,162952,81.63927855711422,11
0.2,1996,95,163047,81.64596895343014,7
0.2,1997,94,163141,81.65215215215215,7
0.2,1998,92,163233,81.65732866433217,9
0.2,1999,91,163324,81.662,10
0.2,2000,24,163348,81.63318340829585,9
0.2,2001,-129,163219,81.52797202797203,23
0.2,2002,89,163308,81.5317024463305,12
0.2,2003,96,163404,81.53892215568862,6
0.2,2004,25,163429,81.51072319201995,8
0.2,2005,94,163523,81.51694915254237,8
0.2,2006,94,163617,81.52316890881913,7
0.2,2007,96,163713,81.53037848605578,6
0.2,2008,92,163805,81.53558984569437,9
0.2,2009,93,163898,81.54129353233832,8
0.2,2010,90,163988,81.54549975136747,11
0.2,2011,92,164080,81.5506958250497,9
0.2,2012,93,164173,81.55638350720318,8
0.2,2013,90,164263,81.56057596822244,13
0.2,2014,90,164353,81.56476426799007,11
0.2,2015,93,164446,81.5704365079365,8
0.2,2016,94,164540,81.5765989092712,8
0.2,2017,89,164629,81.5802775024777,12
0.2,2018,94,164723,81.5864289252105,7
0.2,2019,23,164746,81.55742574257425,9
0.2,2020,93,164839,81.56308758040574,8
0.2,2021,94,164933,81.56923837784372,9
0.2,2022,95,165028,81.57587740978744,6
0.2,2023,92,165120,81.58102766798419,9
0.2,2024,95,165215,81.58765432098765,7
0.2,2025,88,165303,81.59081934846989,14
0.2,2026,95,165398,81.59743463246177,6
0.2,2027,96,165494,81.60453648915187,6
0.2,2028,21,165515,81.57466732380483,11
0.2,2029,22,165537,81.54532019704433,11
0.2,2030,96,165633,81.55243722304283,6
0.2,2031,94,165727,81.55856299212599,9
0.2,2032,89,165816,81.56222331529759,14
0.2,2033,91,165907,81.56686332350048,10
0.2,2034,93,166000,81.57248157248158,8
0.2,2035,22,166022,81.54322200392927,11
0.2,2036,91,166113,81.54786450662739,15
0.2,2037,94,166207,81.55397448478901,7
0.2,2038,95,166302,81.56056890632664,7
0.2,2039,95,166397,81.5671568627451,7
0.2,2040,92,166489,81.57226849583537,10
0.2,2041,12,166501,81.53819784524975,20
0.2,2042,94,166595,81.54429760156633,7
0.2,2043,93,166688,81.54990215264188,8
0.2,2044,96,166784,81.55696821515892,6
0.2,2045,25,166809,81.52932551319648,7
0.2,2046,91,166900,81.53395212506106,10
0.2,2047,90,166990,81.5380859375,11
0.2,2048,94,167084,81.54416788677403,7
0.2,2049,94,167178,81.55024390243902,7
0.2,2050,93,167271,81.55582642613359,12
0.2,2051,92,167363,81.56091617933723,10
0.2,2052,89,167452,81.56453969800292,12
0.2,2053,95,167547,81.57108081791625,7
0.2,2054,94,167641,81.5771289537713,7
0.2,2055,94,167735,81.58317120622569,7
0.2,2056,21,167756,81.55371900826447,12
0.2,2057,90,167846,81.5578231292517,11
0.2,2058,94,167940,81.56386595434677,7
0.2,2059,91,168031,81.56844660194174,11
0.2,2060,93,168124,81.57399320718098,12
0.2,2061,95,168219,81.58050436469448,6
0.2,2062,86,168305,81.58264663111973,15
0.2,2063,93,168398,81.58817829457364,8
0.2,2064,92,168490,81.59322033898304,9
0.2,2065,93,168583,81.59874152952565,8
0.2,2066,21,168604,81.56942428640542,12
0.2,2067,94,168698,81.57543520309478,7
0.2,2068,95,168793,81.58192363460608,7
0.2,2069,93,168886,81.58743961352657,8
0.2,2070,87,168973,81.59005311443747,14
0.2,2071,-46,168927,81.5284749034749,10
0.2,2072,93,169020,81.53400868306802,8
0.2,2073,90,169110,81.5380906460945,14
0.2,2074,90,169200,81.5421686746988,11
0.2,2075,95,169295,81.54865125240848,8
0.2,2076,95,169390,81.55512758786712,8
0.2,2077,90,169480,81.55919153031762,11
0.2,2078,92,169572,81.56421356421356,9
0.2,2079,94,169666,81.57019230769231,7
0.2,2080,89,169755,81.57376261412783,12
0.2,2081,91,169846,81.57829010566763,10
0.2,2082,-54,169792,81.51320211233798,19
0.2,2083,92,169884,81.51823416506718,9
0.2,2084,94,169978,81.5242206235012,7
0.2,2085,86,170064,81.52636625119847,15
0.2,2086,94,170158,81.53234307618591,8
0.2,2087,95,170253,81.53879310344827,6
0.2,2088,94,170347,81.5447582575395,7
0.2,2089,93,170440,81.55023923444976,8
0.2,2090,93,170533,81.5557149689144,8
0.2,2091,91,170624,81.56022944550669,10
0.2,2092,93,170717,81.56569517439083,8
0.2,2093,93,170810,81.57115568290354,8
0.2,2094,95,170905,81.57756563245823,6
0.2,2095,-49,170856,81.51526717557252,12
0.2,2096,93,170949,81.52074391988555,9
0.2,2097,89,171038,81.52430886558628,12
0.2,2098,93,171131,81.52977608384946,8
0.2,2099,93,171224,81.5352380952381,9
0.2,2100,90,171314,81.53926701570681,11
0.2,2101,94,171408,81.54519505233111,7
0.2,2102,91,171499,81.54969091773657,10
0.2,2103,18,171517,81.5194866920152,18
0.2,2104,88,171605,81.52256532066508,17
0.2,2105,89,171694,81.52611585944919,12
0.2,2106,91,171785,81.53061224489795,11
0.2,2107,94,171879,81.5365275142315,8
0.2,2108,94,171973,81.54243717401611,7
0.2,2109,95,172068,81.54881516587677,6
0.2,2110,93,172161,81.55423969682614,8
0.2,2111,94,172255,81.56013257575758,7
0.2,2112,93,172348,81.56554661618551,9
0.2,2113,92,172440,81.57048249763481,9
0.2,2114,94,172534,81.57635933806147,7
0.2,2115,87,172621,81.5789224952741,14
0.2,2116,91,172712,81.58337269721304,10
0.2,2117,25,172737,81.55665722379604,7
0.2,2118,95,172832,81.56300141576216,6
0.2,2119,93,172925,81.56839622641509,8
0.2,2120,88,173013,81.57142857142857,14
0.2,2121,95,173108,81.57775683317625,6
0.2,2122,90,173198,81.58172397550636,11
0.2,2123,94,173292,81.58757062146893,8
0.2,2124,88,173380,81.59058823529412,15
0.2,2125,93,173473,81.59595484477893,8
0.2,2126,94,173567,81.60178655383169,8
0.2,2127,89,173656,81.60526315789474,12
0.2,2128,20,173676,81.57632691404415,12
0.2,2129,92,173768,81.581220657277,9
0.2,2130,94,173862,81.58704833411544,8
0.2,2131,94,173956,81.59287054409006,7
0.2,2132,92,174048,81.59774964838256,10
0.2,2133,94,174142,81.60356138706655,7
0.2,2134,95,174237,81.60983606557377,6
0.2,2135,94,174331,81.61563670411985,7
0.2,2136,94,174425,81.621431913898,7
0.2,2137,91,174516,81.62581852198316,10
0.2,2138,94,174610,81.63160355306218,7
0.2,2139,22,174632,81.603738317757,11
0.2,2140,93,174725,81.60906118636152,8
0.2,2141,25,174750,81.58263305322129,7
0.2,2142,89,174839,81.58609426038264,12
0.2,2143,93,174932,81.59141791044776,8
0.2,2144,89,175021,81.59487179487179,13
0.2,2145,95,175116,81.60111835973905,7
0.2,2146,91,175207,81.60549604098742,11
0.2,2147,92,175299,81.61033519553072,10
0.2,2148,91,175390,81.61470451372732,10
0.2,2149,93,175483,81.62,8
0.2,2150,93,175576,81.62529056252906,8
0.2,2151,92,175668,81.63011152416357,9
0.2,2152,96,175764,81.63678588016721,6
0.2,2153,93,175857,81.64206128133705,8
0.2,2154,95,175952,81.64825986078887,7
0.2,2155,93,176045,81.65352504638219,8
0.2,2156,91,176136,81.65785813630042,10
0.2,2157,95,176231,81.66404077849862,6
0.2,2158,95,176326,81.67021769337656,6
0.2,2159,92,176418,81.675,9
0.2,2160,78,176496,81.67329939842665,23
0.2,2161,95,176591,81.67946345975948,6
0.2,2162,26,176617,81.6537216828479,8
0.2,2163,91,176708,81.65804066543438,10
0.2,2164,87,176795,81.66050808314088,14
0.2,2165,91,176886,81.66481994459834,10
0.2,2166,92,176978,81.66958929395477,9
0.2,2167,92,177070,81.67435424354244,9
0.2,2168,94,177164,81.68003688335638,7
0.2,2169,92,177256,81.68479262672811,10
0.2,2170,95,177351,81.69092584062643,6
0.2,2171,91,177442,81.69521178637201,10
0.2,2172,94,177536,81.70087436723423,7
0.2,2173,27,177563,81.67571297148115,6
0.2,2174,90,177653,81.67954022988506,11
0.2,2175,92,177745,81.68428308823529,9
0.2,2176,92,177837,81.68902158934313,9
0.2,2177,87,177924,81.69146005509641,14
0.2,2178,95,178019,81.69756769160165,6
0.2,2179,95,178114,81.70366972477065,7
0.2,2180,95,178209,81.70976616231087,7
0.2,2181,93,178302,81.71494042163152,8
0.2,2182,94,178396,81.72056802565277,8
0.2,2183,94,178490,81.72619047619048,7
0.2,2184,95,178585,81.73226544622426,6
0.2,2185,26,178611,81.70677035681611,8
0.2,2186,19,178630,81.67809785093736,15
0.2,2187,92,178722,81.68281535648994,9
0.2,2188,92,178814,81.68752855185016,10
0.2,2189,95,178909,81.69360730593607,8
0.2,2190,93,179002,81.69876768598813,8
0.2,2191,94,179096,81.7043795620438,7
0.2,2192,25,179121,81.67852257181943,9
0.2,2193,94,179215,81.6841385597083,7
0.2,2194,95,179310,81.69020501138952,6
0.2,2195,93,179403,81.69535519125684,8
0.2,2196,19,179422,81.66681838871187,13
0.2,2197,96,179518,81.67333939945405,6
0.2,2198,83,179601,81.67394270122783,18
0.2,2199,25,179626,81.64818181818181,8
0.2,2200,92,179718,81.65288505224898,9
0.2,2201,95,179813,81.6589464123524,7
0.2,2202,90,179903,81.66273263731276,11
0.2,2203,94,179997,81.66833030852995,7
0.2,2204,95,180092,81.67437641723356,6
0.2,2205,87,180179,81.67679057116953,14
0.2,2206,94,180273,81.6823742637064,7
0.2,2207,92,180365,81.68704710144928,9
0.2,2208,92,180457,81.69171570846537,9
0.2,2209,92,180549,81.69638009049774,9
0.2,2210,95,180644,81.70239710538218,6
0.2,2211,93,180737,81.70750452079567,9
0.2,2212,94,180831,81.713059195662,7
0.2,2213,93,180924,81.71815718157181,8
0.2,2214,14,180938,81.68758465011287,19
0.2,2215,91,181029,81.6917870036101,10
0.2,2216,94,181123,81.69733874605322,7
0.2,2217,93,181216,81.702434625789,9
0.2,2218,93,181309,81.70752591257323,8
0.2,2219,94,181403,81.71306306306306,7
0.2,2220,94,181497,81.71859522737506,8
0.2,2221,95,181592,81.72457245724573,7
0.2,2222,94,181686,81.73009446693658,7
0.2,2223,95,181781,81.73606115107914,6
0.2,2224,95,181876,81.74202247191012,6
0.2,2225,96,181972,81.74842767295597,6
0.2,2226,94,182066,81.75392905253705,7
0.2,2227,94,182160,81.75942549371634,9
0.2,2228,92,182252,81.76401973979362,9
0.2,2229,91,182343,81.76816143497757,10
0.2,2230,93,182436,81.77319587628865,8
0.2,2231,86,182522,81.77508960573476,15
0.2,2232,91,182613,81.77922077922078,10
0.2,2233,90,182703,81.7829006266786,11
0.2,2234,95,182798,81.78881431767338,7
0.2,2235,92,182890,81.79338103756709,9
0.2,2236,94,182984,81.79883772910148,7
0.2,2237,87,183071,81.8011617515639,14
0.2,2238,95,183166,81.80705672175078,7
0.2,2239,94,183260,81.8125,7
0.2,2240,94,183354,81.81793842034806,7
0.2,2241,94,183448,81.82337198929527,8
0.2,2242,94,183542,81.82880071333037,7
0.2,2243,95,183637,81.83467023172905,6
0.2,2244,90,183727,81.83830734966593,11
0.2,2245,92,183819,81.84283170080143,9
0.2,2246,93,183912,81.84779706275033,8
0.2,2247,91,184003,81.85186832740213,10
0.2,2248,94,184097,81.85726989773232,7
0.2,2249,94,184191,81.86266666666667,7
0.2,2250,96,184287,81.86894713460684,6
0.2,2251,87,184374,81.87122557726465,14
0.2,2252,93,184467,81.87616511318242,9
0.2,2253,92,184559,81.88065661047027,9
0.2,2254,95,184654,81.88647450110865,6
0.2,2255,95,184749,81.89228723404256,7
0.2,2256,94,184843,81.89765175011077,7
0.2,2257,92,184935,81.90212577502214,9
0.2,2258,92,185027,81.90659583886675,9
0.2,2259,94,185121,81.91194690265486,8
0.2,2260,93,185214,81.91685095090668,8
0.2,2261,93,185307,81.92175066312997,8
0.2,2262,94,185401,81.92708793636766,7
0.2,2263,90,185491,81.93065371024736,11
0.2,2264,94,185585,81.93598233995586,7
0.2,2265,91,185676,81.93998234774934,10
0.2,2266,95,185771,81.94574327304808,6
0.2,2267,92,185863,81.95017636684304,9
0.2,2268,89,185952,81.95328338475099,12
0.2,2269,21,185973,81.92643171806168,12
0.2,2270,91,186064,81.93042712461471,11
0.2,2271,20,186084,81.90316901408451,12
0.2,2272,88,186172,81.90585129784426,13
0.2,2273,96,186268,81.91204925241864,6
0.2,2274,93,186361,81.91692307692308,8
0.2,2275,92,186453,81.9213532513181,9
0.2,2276,93,186546,81.9262187088274,9
0.2,2277,90,186636,81.9297629499561,12
0.2,2278,91,186727,81.93374286967969,10
0.2,2279,96,186823,81.93991228070175,6
0.2,2280,87,186910,81.94213064445418,15
0.2,2281,94,187004,81.94741454864155,7
0.2,2282,95,187099,81.95313184406483,8
0.2,2283,92,187191,81.95753064798599,9
0.2,2284,94,187285,81.96280087527353,7
0.2,2285,90,187375,81.96631671041119,12
0.2,2286,94,187469,81.971578487101,7
0.2,2287,94,187563,81.97683566433567,8
0.2,2288,90,187653,81.98034076015728,11
0.2,2289,23,187676,81.95458515283843,11
0.2,2290,91,187767,81.95853339153209,10
0.2,2291,93,187860,81.96335078534031,8
0.2,2292,91,187951,81.9672917575229,10
0.2,2293,93,188044,81.97210113339146,8
0.2,2294,12,188056,81.94161220043573,20
0.2,2295,90,188146,81.9451219512195,11
0.2,2296,93,188239,81.94993469743143,8
0.2,2297,96,188335,81.95604873803308,6
0.2,2298,88,188423,81.95867768595042,13
0.2,2299,94,188517,81.96391304347826,7
0.2,2300,21,188538,81.9374185136897,12
0.2,2301,95,188633,81.94309296264119,7
0.2,2302,-119,188514,81.8558402084238,16
0.2,2303,92,188606,81.86024305555556,13
0.2,2304,94,188700,81.86550976138828,8
0.2,2305,27,188727,81.8417172593235,6
0.2,2306,90,188817,81.84525357607282,11
0.2,2307,87,188904,81.8474870017331,14
0.2,2308,92,188996,81.85188393243828,9
0.2,2309,95,189091,81.85757575757576,8
0.2,2310,92,189183,81.86196451752488,9
0.2,2311,94,189277,81.86721453287197,7
0.2,2312,87,189364,81.8694336359706,14
0.2,2313,89,189453,81.87251512532411,12
0.2,2314,92,189545,81.8768898488121,9
0.2,2315,92,189637,81.88126079447323,11
0.2,2316,93,189730,81.88605955977557,10
0.2,2317,96,189826,81.89214840379637,6
0.2,2318,27,189853,81.8684777921518,6
0.2,2319,94,189947,81.87370689655172,7
0.2,2320,96,190043,81.8797931925894,6
0.2,2321,93,190136,81.88458225667527,8
0.2,2322,95,190231,81.8902281532501,6
0.2,2323,93,190324,81.89500860585198,8
0.2,2324,94,190418,81.90021505376345,7
0.2,2325,93,190511,81.90498710232158,8
0.2,2326,89,190600,81.90803609798023,12
0.2,2327,95,190695,81.91365979381443,6
0.2,2328,95,190790,81.91927866036926,6
0.2,2329,95,190885,81.92489270386267,6
0.2,2330,94,190979,81.93007293007292,7
0.2,2331,90,191069,81.9335334476844,11
0.2,2332,94,191163,81.93870552936134,9
0.2,2333,95,191258,81.94430162810626,7
0.2,2334,93,191351,81.94903640256959,10
0.2,2335,93,191444,81.95376712328768,8
0.2,2336,91,191535,81.9576379974326,10
0.2,2337,16,191551,81.92942686056459,17
0.2,2338,93,191644,81.93415989739205,8
0.2,2339,94,191738,81.93931623931624,8
0.2,2340,94,191832,81.94446817599317,7
0.2,2341,90,191922,81.94790777113577,12
0.2,2342,86,192008,81.94963721724285,15
0.2,2343,92,192100,81.95392491467577,9
0.2,2344,93,192193,81.9586353944563,8
0.2,2345,92,192285,81.96291560102301,9
0.2,2346,91,192376,81.96676608436302,13
0.2,2347,27,192403,81.94335604770016,6
0.2,2348,87,192490,81.94550872711793,14
0.2,2349,92,192582,81.94978723404256,9
0.2,2350,88,192670,81.9523606975755,13
0.2,2351,93,192763,81.95705782312925,8
0.2,2352,21,192784,81.93115172120697,12
0.2,2353,95,192879,81.93670348343245,8
0.2,2354,92,192971,81.94097664543524,10
0.2,2355,95,193066,81.946519524618,7
0.2,2356,89,193155,81.94951209164192,13
0.2,2357,94,193249,81.95462256149278,7
0.2,2358,92,193341,81.95888088172954,9
0.2,2359,94,193435,81.96398305084746,7
0.2,2360,94,193529,81.96908089792461,7
0.2,2361,92,193621,81.97332768839966,10
0.2,2362,92,193713,81.97757088446889,9
0.2,2363,96,193809,81.98350253807106,6
0.2,2364,94,193903,81.98858350951375,7
0.2,2365,94,193997,81.99366018596788,8
0.2,2366,87,194084,81.99577524292353,14
0.2,2367,94,194178,82.0008445945946,7
0.2,2368,89,194267,82.00379907133812,12
0.2,2369,94,194361,82.00886075949367,8
0.2,2370,23,194384,81.98397300716996,10
0.2,2371,90,194474,81.98735244519393,11
0.2,2372,92,194566,81.99157184997893,9
0.2,2373,94,194660,81.9966301600674,8
0.2,2374,94,194754,82.00168421052632,7
0.2,2375,92,194846,82.00589225589225,9
0.2,2376,94,194940,82.01093815734119,7
0.2,2377,96,195036,82.01682085786375,6
0.2,2378,91,195127,82.02059688944935,10
0.2,2379,90,195217,82.02394957983194,11
0.2,2380,92,195309,82.02813943721125,9
0.2,2381,94,195403,82.03316540722082,7
0.2,2382,90,195493,82.03650860260176,11
0.2,2383,96,195589,82.04236577181209,6
0.2,2384,88,195677,82.04486373165618,13
0.2,2385,86,195763,82.04652137468567,17
0.2,2386,92,195855,82.05069124423963,10
0.2,2387,95,195950,82.05611390284757,6
0.2,2388,95,196045,82.06153202176642,6
0.2,2389,91,196136,82.06527196652719,10
0.2,2390,92,196228,82.06942701798411,9
0.2,2391,96,196324,82.0752508361204,7
0.2,2392,94,196418,82.08023401587965,7
0.2,2393,91,196509,82.08395989974937,10
0.2,2394,94,196603,82.08893528183717,7
0.2,2395,94,196697,82.09390651085143,7
0.2,2396,93,196790,82.09845640383813,8
0.2,2397,92,196882,82.1025854879066,9
0.2,2398,96,196978,82.10837849103794,6
0.2,2399,91,197069,82.11208333333333,10
0.2,2400,95,197164,82.11745106205747,7
0.2,2401,91,197255,82.12114904246461,11
0.2,2402,89,197344,82.12401165210154,12
0.2,2403,95,197439,82.1293677204659,7
0.2,2404,87,197526,82.13139293139294,14
0.2,2405,-44,197482,82.07896924355778,8
0.2,2406,92,197574,82.08309098462817,10
0.2,2407,91,197665,82.08679401993355,10
0.2,2408,96,197761,82.0925695309257,6
0.2,2409,94,197855,82.09751037344398,7
0.2,2410,92,197947,82.10161758606387,9
0.2,2411,93,198040,82.10613598673301,9
0.2,2412,91,198131,82.10982179859097,11
0.2,2413,26,198157,82.08657829328915,7
0.2,2414,88,198245,82.08902691511388,13
0.2,2415,87,198332,82.09105960264901,14
0.2,2416,94,198426,82.09598676044683,7
0.2,2417,95,198521,82.10132340777503,6
0.2,2418,21,198542,82.07606448945846,12
0.2,2419,95,198637,82.08140495867768,6
0.2,2420,89,198726,82.08426270136307,12
0.2,2421,94,198820,82.08918249380677,7
0.2,2422,95,198915,82.09451093685514,6
0.2,2423,95,199010,82.09983498349835,6
0.2,2424,96,199106,82.10556701030927,6
0.2,2425,94,199200,82.11046990931574,7
0.2,2426,90,199290,82.11372064276885,11
0.2,2427,88,199378,82.11614497528831,13
0.2,2428,88,199466,82.11856731165088,13
0.2,2429,90,199556,82.12181069958848,12
0.2,2430,94,199650,82.12669683257919,7
0.2,2431,24,199674,82.10279605263158,9
0.2,2432,89,199763,82.10563090834361,12
0.2,2433,96,199859,82.11133935907971,7
0.2,2434,25,199884,82.08788501026694,8
0.2,2435,94,199978,82.0927750410509,7
0.2,2436,91,200069,82.09643003693066,10
0.2,2437,92,200161,82.10049220672683,9
0.2,2438,96,200257,82.10619106191062,6
0.2,2439,94,200351,82.11106557377049,8
0.2,2440,86,200437,82.1126587464154,15
0.2,2441,93,200530,82.11711711711712,8
0.2,2442,94,200624,82.12198117069177,7
0.2,2443,92,200716,82.12602291325696,9
0.2,2444,92,200808,82.13006134969325,11
0.2,2445,84,200892,82.13082583810302,17
0.2,2446,95,200987,82.13608500204332,7
0.2,2447,93,201080,82.140522875817,9
0.2,2448,87,201167,82.14250714577379,14
0.2,2449,95,201262,82.14775510204082,6
0.2,2450,85,201347,82.14891880864953,16
0.2,2451,93,201440,82.15334420880913,8
0.2,2452,91,201531,82.15695067264573,11
0.2,2453,94,201625,82.16177669111654,9
0.2,2454,94,201719,82.16659877800407,7
0.2,2455,96,201815,82.17223127035831,6
0.2,2456,27,201842,82.14977614977614,6
0.2,2457,94,201936,82.15459723352319,7
0.2,2458,95,202031,82.15982106547376,6
0.2,2459,26,202057,82.1369918699187,9
0.2,2460,95,202152,82.14221861032101,6
0.2,2461,92,202244,82.14622258326564,9
0.2,2462,95,202339,82.1514413317093,7
0.2,2463,93,202432,82.15584415584415,8
0.2,2464,92,202524,82.15983772819473,9
0.2,2465,94,202618,82.1646390916464,7
0.2,2466,92,202710,82.16862586137009,11
0.2,2467,26,202736,82.14586709886548,6
0.2,2468,93,202829,82.15026326447955,9
0.2,2469,87,202916,82.15222672064777,14
0.2,2470,88,203004,82.15459328207204,13
0.2,2471,90,203094,82.15776699029126,11
0.2,2472,20,203114,82.13263243024666,13
0.2,2473,94,203208,82.13742926434924,7
0.2,2474,90,203298,82.14060606060606,14
0.2,2475,94,203392,82.1453957996769,8
0.2,2476,94,203486,82.15018167137667,7
0.2,2477,96,203582,82.15577078288943,6
0.2,2478,95,203677,82.1609519967729,7
0.2,2479,89,203766,82.16370967741935,15
0.2,2480,24,203790,82.14026602176541,8
0.2,2481,95,203885,82.14544721998388,6
0.2,2482,83,203968,82.14579138139348,19
0.2,2483,95,204063,82.15096618357488,6
0.2,2484,92,204155,82.15492957746478,9
0.2,2485,23,204178,82.1311343523733,10
0.2,2486,89,204267,82.13389626055489,12
0.2,2487,25,204292,82.11093247588424,8
0.2,2488,96,204388,82.11651265568501,6
0.2,2489,92,204480,82.12048192771084,9
0.2,2490,93,204573,82.12484945804897,9
0.2,2491,94,204667,82.12961476725522,7
0.2,2492,93,204760,82.13397513036502,8
0.2,2493,88,204848,82.13632718524458,13
0.2,2494,91,204939,82.13987975951903,10
0.2,2495,94,205033,82.14463141025641,7
0.2,2496,93,205126,82.14897877452944,11
0.2,2497,92,205218,82.1529223378703,10
0.2,2498,95,205313,82.15806322529012,6
0.2,2499,94,205407,82.1628,7
0.2,2500,27,205434,82.14074370251899,6
0.2,2501,90,205524,82.14388489208633,12
0.2,2502,94,205618,82.14862165401519,7
0.2,2503,91,205709,82.15215654952077,10
0.2,2504,95,205804,82.15728542914172,7
0.2,2505,93,205897,82.16161213088587,8
0.2,2506,93,205990,82.16593538093339,9
0.2,2507,93,206083,82.17025518341308,8
0.2,2508,93,206176,82.1745715424472,8
0.2,2509,92,206268,82.17848605577689,9
0.2,2510,92,206360,82.18239745121465,9
0.2,2511,93,206453,82.18670382165605,8
0.2,2512,87,206540,82.18861918026263,14
0.2,2513,93,206633,82.19291964996022,8
0.2,2514,24,206657,82.16978131212724,9
0.2,2515,86,206743,82.17130365659777,15
0.2,2516,90,206833,82.17441398490266,11
0.2,2517,94,206927,82.1791104050834,7
0.2,2518,92,207019,82.18300913060739,9
0.2,2519,93,207112,82.18730158730159,8
0.2,2520,27,207139,82.16541055136851,6
0.2,2521,95,207234,82.17049960348929,8
0.2,2522,96,207330,82.17598097502973,6
0.2,2523,92,207422,82.17987321711568,9
0.2,2524,95,207517,82.1849504950495,7
0.2,2525,96,207613,82.1904196357878,6
0.2,2526,92,207705,82.19430154333202,10
0.2,2527,94,207799,82.19897151898734,8
0.2,2528,93,207892,82.20324238829576,8
0.2,2529,88,207980,82.20553359683794,13
0.2,2530,21,208001,82.18135124456737,12
0.2,2531,95,208096,82.18641390205372,7
0.2,2532,25,208121,82.16383734701934,9
0.2,2533,88,208209,82.16614048934491,13
0.2,2534,96,208305,82.17159763313609,6
0.2,2535,92,208397,82.17547318611987,9
0.2,2536,93,208490,82.17973985021679,8
0.2,2537,92,208582,82.18360914105595,9
0.2,2538,92,208674,82.18747538400945,10
0.2,2539,95,208769,82.19251968503937,7
0.2,2540,93,208862,82.19677292404565,8
0.2,2541,93,208955,82.20102281667978,8
0.2,2542,27,208982,82.17931576877703,6
0.2,2543,88,209070,82.18160377358491,14
0.2,2544,24,209094,82.15874263261297,9
0.2,2545,20,209114,82.13432835820896,12
0.2,2546,96,209210,82.13977228111504,6
0.2,2547,96,209306,82.14521193092622,6
0.2,2548,94,209400,82.14986269125147,8
0.2,2549,91,209491,82.15333333333334,11
0.2,2550,93,209584,82.15758526068208,8
0.2,2551,94,209678,82.16222570532915,9
0.2,2552,91,209769,82.16568742655699,11
0.2,2553,94,209863,82.17032106499609,7
0.2,2554,92,209955,82.17416829745596,9
0.2,2555,92,210047,82.17801251956182,10
0.2,2556,91,210138,82.18146265154478,10
0.2,2557,95,210233,82.18647380766224,6
0.2,2558,90,210323,82.1895271590465,11
0.2,2559,95,210418,82.19453125,7
0.2,2560,92,210510,82.1983600156189,9
0.2,2561,90,210600,82.20140515222482,11
0.2,2562,23,210623,82.17830667186891,10
0.2,2563,94,210717,82.18291731669267,8
0.2,2564,24,210741,82.16023391812865,8
0.2,2565,91,210832,82.16367887763056,10
0.2,2566,88,210920,82.16595247370472,13
0.2,2567,96,211016,82.17133956386293,6
0.2,2568,94,211110,82.17594394706111,7
0.2,2569,94,211204,82.18054474708171,7
0.2,2570,95,211299,82.1855309218203,6
0.2,2571,93,211392,82.18973561430793,9
0.2,2572,26,211418,82.16789739603576,6
0.2,2573,93,211511,82.17210567210567,8
0.2,2574,95,211606,82.17708737864078,8
0.2,2575,89,211695,82.17973602484471,13
0.2,2576,92,211787,82.18354675979822,10
0.2,2577,93,211880,82.1877424359969,8
0.2,2578,86,211966,82.18922062815045,15
0.2,2579,88,212054,82.19147286821705,13
0.2,2580,95,212149,82.19643549012011,6
0.2,2581,94,212243,82.20100697134005,7
0.2,2582,96,212339,82.2063492063492,6
0.2,2583,92,212431,82.21013931888545,9
0.2,2584,95,212526,82.21508704061895,7
0.2,2585,92,212618,82.21887084300077,9
0.2,2586,93,212711,82.2230382682644,9
0.2,2587,88,212799,82.22527047913447,13
0.2,2588,95,212894,82.23020471224412,9
0.2,2589,92,212986,82.23397683397684,9
0.2,2590,91,213077,82.23736009262834,10
0.2,2591,89,213166,82.23996913580247,13
0.2,2592,90,213256,82.24296182028539,12
0.2,2593,90,213346,82.24595219737857,11
0.2,2594,96,213442,82.25125240847784,6
0.2,2595,17,213459,82.22611710323575,15
0.2,2596,23,213482,82.20331151328456,11
0.2,2597,93,213575,82.20746728252502,9
0.2,2598,94,213669,82.21200461716045,7
0.2,2599,94,213763,82.21653846153846,7
0.2,2600,91,213854,82.21991541714725,10
0.2,2601,96,213950,82.22521137586472,6
0.2,2602,92,214042,82.22896657702651,9
0.2,2603,91,214133,82.23233486943164,11
0.2,2604,92,214225,82.23608445297505,9
0.2,2605,96,214321,82.24136607828089,6
0.2,2606,93,214414,82.24549290372074,8
0.2,2607,96,214510,82.25076687116564,6
0.2,2608,93,214603,82.25488692985819,10
0.2,2609,96,214699,82.26015325670498,6
0.2,2610,96,214795,82.26541554959786,6
0.2,2611,93,214888,82.26952526799387,8
0.2,2612,27,214915,82.24837351703023,6
0.2,2613,25,214940,82.22647283856159,7
0.2,2614,93,215033,82.23059273422562,9
0.2,2615,94,215127,82.23509174311927,8
0.2,2616,91,215218,82.23844096293466,10
0.2,2617,96,215314,82.24369747899159,6
0.2,2618,89,215403,82.24627720504009,12
0.2,2619,93,215496,82.2503816793893,8
0.2,2620,92,215588,82.25410148798169,9
0.2,2621,93,215681,82.2581998474447,8
0.2,2622,94,215775,82.26267632481891,9
0.2,2623,25,215800,82.24085365853658,8
0.2,2624,92,215892,82.24457142857143,9
0.2,2625,94,215986,82.24904798172125,7
0.2,2626,88,216074,82.2512371526456,13
0.2,2627,94,216168,82.25570776255708,7
0.2,2628,94,216262,82.26017497147204,7
0.2,2629,91,216353,82.26349809885932,10
0.2,2630,91,216444,82.26681870011403,12
0.2,2631,88,216532,82.26899696048632,13
0.2,2632,93,216625,82.27307254082795,8
0.2,2633,92,216717,82.27676537585421,9
0.2,2634,94,216811,82.28121442125237,8
0.2,2635,25,216836,82.25948406676783,10
0.2,2636,92,216928,82.26317785362154,9
0.2,2637,96,217024,82.26838514025778,6
0.2,2638,94,217118,82.2728306176582,7
0.2,2639,92,217210,82.27651515151516,9
0.2,2640,93,217303,82.28057553956835,8
0.2,2641,94,217397,82.28501135503406,7
0.2,2642,89,217486,82.2875520242149,12
0.2,2643,26,217512,82.26626323751891,7
0.2,2644,92,217604,82.26994328922495,9
0.2,2645,89,217693,82.27248677248677,12
0.2,2646,86,217779,82.2738949754439,15
0.2,2647,96,217875,82.27907854984895,6
0.2,2648,94,217969,82.28350320875802,7
0.2,2649,95,218064,82.28830188679245,6
0.2,2650,90,218154,82.29121086382497,11
0.2,2651,86,218240,82.29260935143289,15
0.2,2652,93,218333,82.2966453071994,9
0.2,2653,15,218348,82.2712886209495,18
0.2,2654,90,218438,82.27419962335216,11
0.2,2655,92,218530,82.27786144578313,10
0.2,2656,94,218624,82.2822732404968,7
0.2,2657,95,218719,82.28705793829947,7
0.2,2658,95,218814,82.29183903723204,6
0.2,2659,95,218909,82.29661654135339,6
0.2,2660,94,219003,82.3010146561443,7
0.2,2661,91,219094,82.30428249436514,10
0.2,2662,94,219188,82.30867442733759,7
0.2,2663,90,219278,82.31156156156156,11
0.2,2664,90,219368,82.31444652908067,11
0.2,2665,90,219458,82.31732933233309,11
0.2,2666,92,219550,82.320959880015,9
0.2,2667,94,219644,82.32533733133434,8
0.2,2668,90,219734,82.32821281378794,13
0.2,2669,95,219829,82.33295880149812,8
0.2,2670,93,219922,82.33695245226507,8
0.2,2671,25,219947,82.31549401197604,8
0.2,2672,91,220038,82.31874298540966,10
0.2,2673,91,220129,82.32198952879581,10
0.2,2674,94,220223,82.32635514018692,7
0.2,2675,94,220317,82.33071748878923,8
0.2,2676,93,220410,82.33470302577513,8
0.2,2677,92,220502,82.33831217326363,9
0.2,2678,91,220593,82.34154535274357,10
0.2,2679,93,220686,82.3455223880597,8
0.2,2680,21,220707,82.32264080566952,11
0.2,2681,11,220718,82.29604772557792,22
0.2,2682,92,220810,82.29966455460305,10
0.2,2683,17,220827,82.27533532041728,16
0.2,2684,90,220917,82.2782122905028,11
0.2,2685,93,221010,82.28220402084885,8
0.2,2686,86,221096,82.28358764421287,15
0.2,2687,95,221191,82.28831845238095,6
0.2,2688,88,221279,82.29044254369654,13
0.2,2689,27,221306,82.26988847583642,6
0.2,2690,92,221398,82.27350427350427,10
0.2,2691,96,221494,82.27860326894502,6
0.2,2692,96,221590,82.28369847753434,6
0.2,2693,90,221680,82.28656273199704,11
0.2,2694,94,221774,82.2909090909091,7
0.2,2695,23,221797,82.26891691394658,9
0.2,2696,94,221891,82.2732665925102,7
0.2,2697,94,221985,82.27761304670126,7
0.2,2698,25,222010,82.25639125602075,8
0.2,2699,95,222105,82.2611111111111,6
0.2,2700,95,222200,82.26582747130692,6
0.2,2701,91,222291,82.26905995558845,14
0.2,2702,95,222386,82.27376988531262,7
0.2,2703,85,222471,82.27477810650888,16
0.2,2704,23,222494,82.25286506469502,9
0.2,2705,95,222589,82.25757575757575,6
0.2,2706,91,222680,82.26080531954193,10
0.2,2707,90,222770,82.26366322008863,11
0.2,2708,91,222861,82.26688815060908,10
0.2,2709,92,222953,82.27047970479705,9
0.2,2710,89,223042,82.27296200663962,12
0.2,2711,91,223133,82.27617994100295,10
0.2,2712,94,223227,82.28050129008477,7
0.2,2713,92,223319,82.28408253500369,9
0.2,2714,24,223343,82.26261510128913,9
0.2,2715,90,223433,82.26546391752578,11
0.2,2716,23,223456,82.24365108575635,12
0.2,2717,94,223550,82.24797645327446,8
0.2,2718,88,223638,82.25009194556823,13
0.2,2719,95,223733,82.2547794117647,7
0.2,2720,90,223823,82.25762587284086,11
0.2,2721,85,223908,82.25863335782513,16
0.2,2722,18,223926,82.23503488799119,15
0.2,2723,89,224015,82.23751835535977,12
0.2,2724,93,224108,82.24146788990825,8
0.2,2725,90,224198,82.24431401320616,11
0.2,2726,94,224292,82.24862486248625,8
0.2,2727,94,224386,82.25293255131965,7
0.2,2728,93,224479,82.25687064858923,8
0.2,2729,92,224571,82.26043956043956,10
0.2,2730,90,224661,82.26327352618088,11
0.2,2731,94,224755,82.26756954612006,7
0.2,2732,87,224842,82.26930113428467,14
0.2,2733,91,224933,82.27249451353329,10
0.2,2734,93,225026,82.2764168190128,8
0.2,2735,95,225121,82.28106725146199,6
0.2,2736,93,225214,82.28498355864085,8
0.2,2737,88,225302,82.28707085463843,13
0.2,2738,95,225397,82.29171230376049,6
0.2,2739,90,225487,82.29452554744526,11
0.2,2740,92,225579,82.29806639912441,9
0.2,2741,-48,225531,82.25054704595186,12
0.2,2742,95,225626,82.2551950419249,6
0.2,2743,90,225716,82.25801749271137,11
0.2,2744,91,225807,82.26120218579236,12
0.2,2745,-46,225761,82.21449380917699,10
0.2,2746,94,225855,82.21878412813979,7
0.2,2747,24,225879,82.1975982532751,9
0.2,2748,93,225972,82.2015278283012,8
0.2,2749,95,226067,82.20618181818182,6
0.2,2750,92,226159,82.20974191203199,9
0.2,2751,95,226254,82.21438953488372,8
0.2,2752,91,226345,82.21758082092263,10
0.2,2753,25,226370,82.19680464778504,9
0.2,2754,86,226456,82.19818511796733,15
0.2,2755,94,226550,82.20246734397678,8
0.2,2756,92,226642,82.20602103735945,9
0.2,2757,91,226733,82.20920957215374,10
0.2,2758,95,226828,82.21384559623051,8
0.2,2759,93,226921,82.2177536231884,8
0.2,2760,94,227015,82.22202100688156,8
0.2,2761,94,227109,82.22628530050687,7
0.2,2762,83,227192,82.22656532754253,18
0.2,2763,93,227285,82.23046309696093,8
0.2,2764,96,227381,82.23544303797469,6
0.2,2765,96,227477,82.24041937816341,6
0.2,2766,95,227572,82.24503071919045,7
0.2,2767,12,227584,82.21965317919076,20
0.2,2768,27,227611,82.19971108703503,6
0.2,2769,92,227703,82.20324909747292,9
0.2,2770,94,227797,82.2075063154096,7
0.2,2771,25,227822,82.18686868686869,8
0.2,2772,95,227917,82.19148936170212,7
0.2,2773,95,228012,82.19610670511896,7
0.2,2774,95,228107,82.20072072072072,6
0.2,2775,92,228199,82.20425072046109,9
0.2,2776,93,228292,82.20813827871804,8
0.2,2777,90,228382,82.21094312455004,11
0.2,2778,93,228475,82.21482547679021,8
0.2,2779,94,228569,82.21906474820143,7
0.2,2780,94,228663,82.22330097087378,8
0.2,2781,95,228758,82.22789360172538,7
0.2,2782,89,228847,82.2303269852677,12
0.2,2783,93,228940,82.23419540229885,8
0.2,2784,93,229033,82.23806104129264,8
0.2,2785,95,229128,82.24264178033022,6
0.2,2786,93,229221,82.2465016146394,8
0.2,2787,95,229316,82.25107604017217,6
0.2,2788,91,229407,82.25421297956257,10
0.2,2789,90,229497,82.25698924731182,12
0.2,2790,95,229592,82.26155499820852,6
0.2,2791,95,229687,82.26611747851003,6
0.2,2792,92,229779,82.26960257787326,9
0.2,2793,94,229873,82.27380100214747,7
0.2,2794,95,229968,82.27835420393559,6
0.2,2795,94,230062,82.28254649499284,8
0.2,2796,92,230154,82.2860207365034,10
0.2,2797,24,230178,82.26518942101501,10
0.2,2798,92,230270,82.26866738120758,9
0.2,2799,96,230366,82.27357142857143,6
0.2,2800,85,230451,82.27454480542663,16
0.2,2801,80,230531,82.27373304782299,21
0.2,2802,94,230625,82.27791651801641,7
0.2,2803,93,230718,82.28174037089872,8
0.2,2804,94,230812,82.28591800356506,7
0.2,2805,93,230905,82.28973627940128,8
0.2,2806,96,231001,82.2946205913787,6
0.2,2807,24,231025,82.27386039886039,10
0.2,2808,92,231117,82.27732289070843,12
0.2,2809,94,231211,82.28149466192171,7
0.2,2810,95,231306,82.28601921024547,6
0.2,2811,91,231397,82.28911806543385,10
0.2,2812,25,231422,82.26875222182723,7
0.2,2813,94,231516,82.27292110874201,7
0.2,2814,94,231610,82.27708703374778,9
0.2,2815,93,231703,82.28089488636364,8
0.2,2816,95,231798,82.28541001064963,6
0.2,2817,25,231823,82.26508161816892,8
0.2,2818,95,231918,82.26959914863427,6
0.2,2819,93,232011,82.27340425531915,8
0.2,2820,93,232104,82.27720666430343,8
0.2,2821,95,232199,82.28171509567683,7
0.2,2822,94,232293,82.28586609989372,8
0.2,2823,87,232380,82.28753541076487,14
0.2,2824,94,232474,82.2916814159292,8
0.2,2825,94,232568,82.29582448690729,7
0.2,2826,95,232663,82.30031835868412,6
0.2,2827,94,232757,82.30445544554455,8
0.2,2828,87,232844,82.30611523506539,14
0.2,2829,94,232938,82.31024734982333,7
0.2,2830,93,233031,82.31402331331685,8
0.2,2831,90,233121,82.3167372881356,11
0.2,2832,93,233214,82.32050829509355,8
0.2,2833,91,233305,82.32357092448835,10
0.2,2834,25,233330,82.30335097001763,8
0.2,2835,96,233426,82.30818053596614,6
0.2,2836,95,233521,82.31265421219598,6
0.2,2837,24,233545,82.29210711768852,9
0.2,2838,92,233637,82.29552659387109,9
0.2,2839,94,233731,82.29964788732394,7
0.2,2840,21,233752,82.27807110172475,11
0.2,2841,94,233846,82.28219563687544,7
0.2,2842,94,233940,82.28631727048892,7
0.2,2843,93,234033,82.29008438818565,8
0.2,2844,25,234058,82.26994727592268,8
0.2,2845,95,234153,82.27442023893184,8
0.2,2846,92,234245,82.27783631893222,9
0.2,2847,94,234339,82.28195224719101,7
0.2,2848,92,234431,82.28536328536329,13
0.2,2849,95,234526,82.2898245614035,7
0.2,2850,91,234617,82.29287969133637,10
0.2,2851,27,234644,82.273492286115,6
0.2,2852,94,234738,82.27760252365931,7
0.2,2853,20,234758,82.25578135949544,14
0.2,2854,92,234850,82.25919439579685,10
0.2,2855,23,234873,82.23844537815125,9
0.2,2856,17,234890,82.21561078053902,16
0.2,2857,90,234980,82.21833449965011,12
0.2,2858,95,235075,82.22280517663519,8
0.2,2859,89,235164,82.22517482517482,12
0.2,2860,88,235252,82.22719328905977,15
0.2,2861,95,235347,82.23165618448637,6
0.2,2862,95,235442,82.23611596227734,6
0.2,2863,85,235527,82.23708100558659,16
0.2,2864,-188,235339,82.14275741710297,14
0.2,2865,93,235432,82.14654570830426,8
0.2,2866,93,235525,82.15033135681898,8
0.2,2867,94,235619,82.1544630404463,7
0.2,2868,23,235642,82.13384454513768,10
0.2,2869,96,235738,82.13867595818816,6
0.2,2870,95,235833,82.14315569487984,6
0.2,2871,93,235926,82.14693593314763,8
0.2,2872,96,236022,82.15175774451792,6
0.2,2873,93,236115,82.15553235908142,8
0.2,2874,92,236207,82.15895652173913,10
0.2,2875,90,236297,82.16168289290681,11
0.2,2876,92,236389,82.16510253736531,9
0.2,2877,90,236479,82.16782487838778,11
0.2,2878,93,236572,82.17158735672109,8
0.2,2879,93,236665,82.17534722222223,8
0.2,2880,89,236754,82.17771607080874,12
0.2,2881,85,236839,82.17869535045108,16
0.2,2882,95,236934,82.18314255983351,6
0.2,2883,93,237027,82.1868932038835,8
0.2,2884,93,237120,82.19064124783363,9
0.2,2885,24,237144,82.17047817047818,9
0.2,2886,92,237236,82.17388292344995,9
0.2,2887,95,237331,82.17832409972299,7
0.2,2888,96,237427,82.18310834198685,6
0.2,2889,-193,237234,82.0878892733564,18
0.2,2890,91,237325,82.09097198201314,10
0.2,2891,89,237414,82.09336099585062,12
0.2,2892,95,237509,82.0978223297615,7
0.2,2893,92,237601,82.10124395300622,9
0.2,2894,94,237695,82.10535405872193,7
0.2,2895,88,237783,82.10738950276243,13
0.2,2896,85,237868,82.10838798757335,16
0.2,2897,17,237885,82.08592132505176,15
0.2,2898,88,237973,82.08796136598828,13
0.2,2899,95,238068,82.09241379310345,6
0.2,2900,93,238161,82.09617373319546,8
0.2,2901,91,238252,82.09924190213646,10
0.2,2902,90,238342,82.10196348604892,12
0.2,2903,92,238434,82.10537190082644,9
0.2,2904,96,238530,82.11015490533563,6
0.2,2905,94,238624,82.11424638678596,7
0.2,2906,94,238718,82.11833505331957,7
0.2,2907,94,238812,82.12242090784044,8
0.2,2908,93,238905,82.12616019250602,8
0.2,2909,93,238998,82.12989690721649,11
0.2,2910,93,239091,82.13363105462041,8
0.2,2911,92,239183,82.13701923076923,10
0.2,2912,94,239277,82.14109165808445,7
0.2,2913,94,239371,82.14516129032258,7
0.2,2914,94,239465,82.1492281303602,7
0.2,2915,18,239483,82.12722908093278,15
0.2,2916,91,239574,82.13027082619129,11
0.2,2917,85,239659,82.131254283756,16
0.2,2918,96,239755,82.13600548132922,6
0.2,2919,90,239845,82.13869863013699,11
0.2,2920,95,239940,82.1431016775077,7
0.2,2921,82,240022,82.14305270362765,19
0.2,2922,85,240107,82.14403010605542,16
0.2,2923,92,240199,82.14740082079344,9
0.2,2924,91,240290,82.15042735042735,10
0.2,2925,88,240378,82.15242652084757,13
0.2,2926,93,240471,82.15613255893406,8
0.2,2927,94,240565,82.16017759562841,7
0.2,2928,93,240658,82.1638784568112,9
0.2,2929,94,240752,82.1679180887372,8
0.2,2930,86,240838,82.16922552030024,15
0.2,2931,90,240928,82.1718963165075,11
0.2,2932,21,240949,82.1510398908967,12
0.2,2933,91,241040,82.15405589638719,10
0.2,2934,93,241133,82.15775127768313,9
0.2,2935,94,241227,82.16178474114442,7
0.2,2936,24,241251,82.14198161389173,9
0.2,2937,89,241340,82.14431586113002,14
0.2,2938,95,241435,82.14869003062266,6
0.2,2939,19,241454,82.12721088435374,14
0.2,2940,93,241547,82.13090785447127,8
0.2,2941,93,241640,82.13460231135282,8
0.2,2942,93,241733,82.13829425756032,9
0.2,2943,88,241821,82.14028532608695,13
0.2,2944,93,241914,82.14397283531409,8
0.2,2945,86,242000,82.14528173794976,15
0.2,2946,96,242096,82.14998303359349,6
0.2,2947,86,242182,82.15128900949796,15
0.2,2948,92,242274,82.15462868769075,9
0.2,2949,91,242365,82.15762711864407,12
0.2,2950,91,242456,82.16062351745171,10
0.2,2951,95,242551,82.164972899729,6
0.2,2952,96,242647,82.16965797494073,6
0.2,2953,93,242740,82.17332430602573,8
0.2,2954,95,242835,82.17766497461929,6
0.2,2955,90,242925,82.18031123139377,11
0.2,2956,94,243019,82.18430842069665,8
0.2,2957,95,243114,82.18864097363083,6
0.2,2958,92,243206,82.19195674214262,9
0.2,2959,88,243294,82.19391891891892,13
0.2,2960,91,243385,82.1968929415738,10
0.2,2961,94,243479,82.20087778528021,7
0.2,2962,93,243572,82.20452244346946,9
0.2,2963,88,243660,82.20647773279352,13
0.2,2964,88,243748,82.20843170320404,13
0.2,2965,93,243841,82.21207012811868,9
0.2,2966,94,243935,82.21604314122008,7
0.2,2967,91,244026,82.21900269541779,10
0.2,2968,95,244121,82.22330751094644,6
0.2,2969,87,244208,82.22491582491583,14
0.2,2970,94,244302,82.22887916526422,7
0.2,2971,95,244397,82.23317631224765,6
0.2,2972,95,244492,82.23747056844938,7
0.2,2973,90,244582,82.24008069939475,11
0.2,2974,96,244678,82.24470588235295,6
0.2,2975,86,244764,82.24596774193549,15
0.2,2976,94,244858,82.24991602284179,8
0.2,2977,95,244953,82.25419744795164,6
0.2,2978,93,245046,82.25780463242698,8
0.2,2979,94,245140,82.26174496644295,7
0.2,2980,90,245230,82.26434082522644,12
0.2,2981,20,245250,82.24346076458752,13
0.2,2982,95,245345,82.24773717733825,6
0.2,2983,95,245440,82.2520107238606,6
0.2,2984,91,245531,82.25494137353434,11
0.2,2985,95,245626,82.25920964501005,6
0.2,2986,91,245717,82.2621359223301,10
0.2,2987,95,245812,82.26639892904953,8
0.2,2988,19,245831,82.2452325192372,14
0.2,2989,91,245922,82.24816053511705,10
0.2,2990,93,246015,82.25175526579739,8
0.2,2991,94,246109,82.25568181818181,7
0.2,2992,92,246201,82.25893752088206,9
0.2,2993,95,246296,82.26319305277221,6
0.2,2994,20,246316,82.2424040066778,13
0.2,2995,92,246408,82.2456608811749,9
0.2,2996,95,246503,82.24991658324991,6
0.2,2997,92,246595,82.25316877918613,9
0.2,2998,94,246689,82.25708569523174,8
0.2,2999,93,246782,82.26066666666667,8
0.2,3000,91,246873,82.2635788070643,10
0.2,3001,95,246968,82.26782145236508,6
0.2,3002,27,246995,82.24941724941725,6
0.2,3003,27,247022,82.23102529960053,7
0.2,3004,92,247114,82.23427620632279,9
0.2,3005,95,247209,82.23852295409182,6
0.2,3006,93,247302,82.24210176255404,8
0.2,3007,94,247396,82.24601063829788,8
0.2,3008,94,247490,82.24991691591892,7
0.2,3009,23,247513,82.23023255813953,9
0.2,3010,94,247607,82.23414148123547,8
0.2,3011,92,247699,82.23738379814077,9
0.2,3012,93,247792,82.24095585794889,10
0.2,3013,95,247887,82.24518911745189,6
0.2,3014,95,247982,82.24941956882256,7
0.2,3015,94,248076,82.25331564986737,7
0.2,3016,21,248097,82.23301292674843,12
0.2,3017,83,248180,82.23326706428098,18
0.2,3018,91,248271,82.23617091752236,11
0.2,3019,92,248363,82.23940397350994,9
0.2,3020,95,248458,82.24362793776895,7
0.2,3021,95,248553,82.24784910655195,6
0.2,3022,95,248648,82.25206748263315,6
0.2,3023,91,248739,82.25496031746032,10
0.2,3024,92,248831,82.25818181818182,9
0.2,3025,25,248856,82.23925974884335,8
0.2,3026,84,248940,82.2398414271556,17
0.2,3027,94,249034,82.24372523117569,7
0.2,3028,93,249127,82.2472763288214,8
0.2,3029,93,249220,82.25082508250826,9
0.2,3030,93,249313,82.25437149455625,9
0.2,3031,95,249408,82.25857519788919,8
0.2,3032,92,249500,82.26178700956149,10
0.2,3033,90,249590,82.26433750823995,11
0.2,3034,-61,249529,82.21713344316309,25
0.2,3035,95,249624,82.22134387351778,6
0.2,3036,96,249720,82.22588080342443,6
0.2,3037,93,249813,82.22942725477287,8
0.2,3038,95,249908,82.23362948338269,6
0.2,3039,94,250002,82.2375,7
0.2,3040,93,250095,82.24103913186453,8
0.2,3041,96,250191,82.24556213017752,6
0.2,3042,94,250285,82.24942490962866,7
0.2,3043,91,250376,82.25229960578187,10
0.2,3044,92,250468,82.25550082101806,9
0.2,3045,85,250553,82.25640183847669,16
0.2,3046,89,250642,82.25861503117821,12
0.2,3047,94,250736,82.26246719160105,7
0.2,3048,94,250830,82.26631682518858,7
0.2,3049,93,250923,82.26983606557377,8
0.2,3050,93,251016,82.27335299901672,8
0.2,3051,86,251102,82.2745740498034,15
0.2,3052,93,251195,82.27808712741566,8
0.2,3053,95,251290,82.28225278323511,7
0.2,3054,89,251379,82.28445171849427,12
0.2,3055,83,251462,82.28468586387434,18
0.2,3056,94,251556,82.28851815505398,8
0.2,3057,89,251645,82.29071288423806,12
0.2,3058,93,251738,82.29421379535796,9
0.2,3059,91,251829,82.29705882352941,10
0.2,3060,95,251924,82.30120875530872,7
0.2,3061,92,252016,82.30437622468975,11
0.2,3062,95,252111,82.30852105778648,6
0.2,3063,94,252205,82.3123368146214,7
0.2,3064,89,252294,82.31451876019575,12
0.2,3065,94,252388,82.31833007175473,7
0.2,3066,93,252481,82.32181284642974,8
0.2,3067,95,252576,82.32594524119948,6
0.2,3068,94,252670,82.32974910394265,7
0.2,3069,92,252762,82.3328990228013,10
0.2,3070,95,252857,82.3370237707587,6
0.2,3071,92,252949,82.34016927083333,9
0.2,3072,94,253043,82.34396355353076,7
0.2,3073,90,253133,82.34645413142485,11
0.2,3074,94,253227,82.35024390243902,9
0.2,3075,93,253320,82.35370611183355,8
0.2,3076,89,253409,82.35586610334741,12
0.2,3077,93,253502,82.35932423651722,8
0.2,3078,96,253598,82.36375446573562,6
0.2,3079,23,253621,82.34448051948051,10
0.2,3080,95,253716,82.34858812074002,6
0.2,3081,94,253810,82.35236859182349,7
0.2,3082,85,253895,82.35322737593253,16
0.2,3083,90,253985,82.35570687418937,11
0.2,3084,92,254077,82.35883306320908,9
0.2,3085,92,254169,82.36195722618277,9
0.2,3086,93,254262,82.36540330417881,8
0.2,3087,86,254348,82.36658031088083,15
0.2,3088,94,254442,82.37034639041761,8
0.2,3089,91,254533,82.37313915857605,10
0.2,3090,25,254558,82.3545778065351,8
0.2,3091,91,254649,82.35737386804657,10
0.2,3092,92,254741,82.36049143226641,9
0.2,3093,95,254836,82.36457659987072,7
0.2,3094,19,254855,82.34410339256866,13
0.2,3095,94,254949,82.34786821705427,7
0.2,3096,96,255045,82.35227639651275,6
0.2,3097,88,255133,82.35409941897998,13
0.2,3098,91,255224,82.3568893191352,10
0.2,3099,94,255318,82.36064516129032,8
0.2,3100,94,255412,82.36439858110288,7
0.2,3101,96,255508,82.36879432624113,6
0.2,3102,94,255602,82.37254270061231,7
0.2,3103,90,255692,82.375,11
0.2,3104,86,255778,82.37616747181964,15
0.2,3105,85,255863,82.37701223438506,16
0.2,3106,95,255958,82.38107499195365,7
0.2,3107,92,256050,82.38416988416988,11
0.2,3108,85,256135,82.3850112576391,16
0.2,3109,95,256230,82.38906752411576,6
0.2,3110,24,256254,82.37029893924783,8
0.2,3111,94,256348,82.37403598971723,7
0.2,3112,87,256435,82.37552200449727,14
0.2,3113,89,256524,82.37764932562621,12
0.2,3114,89,256613,82.37977528089888,12
0.2,3115,91,256704,82.38254172015404,11
0.2,3116,93,256797,82.385948026949,8
0.2,3117,91,256888,82.38871071199488,10
0.2,3118,88,256976,82.39050977877525,13
0.2,3119,91,257067,82.39326923076923,10
0.2,3120,94,257161,82.39698814482537,7
0.2,3121,90,257251,82.39942344650865,12
0.2,3122,95,257346,82.40345821325649,6
0.2,3123,93,257439,82.40685019206146,8
0.2,3124,25,257464,82.38848,8
0.2,3125,86,257550,82.38963531669866,15
0.2,3126,92,257642,82.39270866645347,9
0.2,3127,92,257734,82.3957800511509,9
0.2,3128,96,257830,82.40012783636945,6
0.2,3129,93,257923,82.40351437699681,8
0.2,3130,95,258018,82.40753752794635,7
0.2,3131,91,258109,82.41028097062579,10
0.2,3132,95,258204,82.41429939355251,7
0.2,3133,94,258298,82.41799617102744,7
0.2,3134,88,258386,82.41977671451356,13
0.2,3135,94,258480,82.4234693877551,7
0.2,3136,21,258501,82.40388906598662,12
0.2,3137,96,258597,82.40822179732314,6
0.2,3138,93,258690,82.41159604969735,8
0.2,3139,94,258784,82.41528662420382,7
0.2,3140,87,258871,82.41674625915313,14
0.2,3141,87,258958,82.41820496499045,14
0.2,3142,81,259039,82.41775373846643,20
0.2,3143,96,259135,82.4220737913486,8
0.2,3144,90,259225,82.42448330683625,11
0.2,3145,92,259317,82.42752701843611,9
0.2,3146,95,259412,82.43152208452494,7
0.2,3147,95,259507,82.43551461245235,6
0.2,3148,92,259599,82.43855192124484,9
0.2,3149,93,259692,82.44190476190477,8
0.2,3150,93,259785,82.44525547445255,9
0.2,3151,94,259879,82.44892131979695,7
0.2,3152,94,259973,82.45258483983508,7
0.2,3153,-127,259846,82.3861762840837,21
0.2,3154,88,259934,82.38795562599049,13
0.2,3155,94,260028,82.3916349809886,9
0.2,3156,96,260124,82.39594551789673,6
0.2,3157,96,260220,82.40025332488916,6
0.2,3158,86,260306,82.4013928458373,15
0.2,3159,94,260400,82.40506329113924,7
0.2,3160,95,260495,82.40904776969313,6
0.2,3161,93,260588,82.41239721695129,8
0.2,3162,93,260681,82.41574454631679,8
0.2,3163,93,260774,82.41908975979773,8
0.2,3164,96,260870,82.42338072669826,6
0.2,3165,92,260962,82.42640555906506,9
0.2,3166,91,261053,82.42911272497632,10
0.2,3167,22,261075,82.41003787878788,11
0.2,3168,90,261165,82.41243294414642,11
0.2,3169,93,261258,82.41577287066247,10
0.2,3170,91,261349,82.41847997477137,11
0.2,3171,95,261444,82.42244640605297,7
0.2,3172,96,261540,82.42672549637567,6
0.2,3173,94,261634,82.43037177063643,7
0.2,3174,94,261728,82.4340157480315,7
0.2,3175,93,261821,82.43734256926952,8
0.2,3176,92,261913,82.44035253383696,9
0.2,3177,95,262008,82.44430459408433,8
0.2,3178,89,262097,82.44636678200692,12
0.2,3179,92,262189,82.44937106918239,10
0.2,3180,84,262273,82.44985853505187,17
0.2,3181,95,262368,82.45380263984916,7
0.2,3182,92,262460,82.45680175934653,9
0.2,3183,93,262553,82.46011306532664,10
0.2,3184,90,262643,82.4624803767661,11
0.2,3185,24,262667,82.44413057124922,9
0.2,3186,90,262757,82.44650141198619,11
0.2,3187,94,262851,82.45012547051444,7
0.2,3188,93,262944,82.45343367826905,8
0.2,3189,96,263040,82.4576802507837,6
0.2,3190,-44,262996,82.4180507677844,8
0.2,3191,91,263087,82.42073934837093,12
0.2,3192,93,263180,82.42405261509552,8
0.2,3193,92,263272,82.42705072010018,9
0.2,3194,24,263296,82.40876369327074,8
0.2,3195,-49,263247,82.36764705882354,13
0.2,3196,93,263340,82.3709727869878,8
0.2,3197,94,263434,82.37460913070669,7
0.2,3198,93,263527,82.37793060331353,8
0.2,3199,90,263617,82.3803125,11
0.2,3200,96,263713,82.38456732271165,6
0.2,3201,91,263804,82.38725796377264,10
0.2,3202,92,263896,82.39025913206369,9
0.2,3203,18,263914,82.37016229712859,14
0.2,3204,95,264009,82.37410296411856,7
0.2,3205,96,264105,82.37835308796008,7
0.2,3206,94,264199,82.38197692547553,8
0.2,3207,95,264294,82.3859102244389,6
0.2,3208,93,264387,82.38921782486756,8
0.2,3209,20,264407,82.36978193146417,12
0.2,3210,89,264496,82.37184677670507,12
0.2,3211,90,264586,82.37422166874222,11
0.2,3212,88,264674,82.37597261126673,13
0.2,3213,94,264768,82.37958929682638,7
0.2,3214,22,264790,82.36080870917574,12
0.2,3215,91,264881,82.36349502487562,10
0.2,3216,95,264976,82.36742306496735,7
0.2,3217,84,265060,82.36793039154755,17
0.2,3218,86,265146,82.3690587138863,15
0.2,3219,95,265241,82.37298136645963,7
0.2,3220,89,265330,82.37503880782366,12
0.2,3221,91,265421,82.37771570453134,10
0.2,3222,95,265516,82.38163201985728,6
0.2,3223,85,265601,82.3824441687345,18
0.2,3224,91,265692,82.38511627906976,10
0.2,3225,91,265783,82.38778673279603,10
0.2,3226,94,265877,82.39138518748064,9
0.2,3227,92,265969,82.39436183395291,9
0.2,3228,90,266059,82.39671724992257,11
0.2,3229,95,266154,82.40061919504645,8
0.2,3230,91,266245,82.40328071804394,10
0.2,3231,89,266334,82.40532178217822,13
0.2,3232,90,266424,82.40767089390658,12
0.2,3233,92,266516,82.41063698206555,10
0.2,3234,90,266606,82.41298299845441,11
0.2,3235,94,266700,82.41656365883807,8
0.2,3236,89,266789,82.41859746679023,12
0.2,3237,89,266878,82.42063001852996,12
0.2,3238,91,266969,82.42327878974993,10
0.2,3239,93,267062,82.42654320987654,8
0.2,3240,92,267154,82.42949706880593,9
0.2,3241,88,267242,82.43121529919803,13
0.2,3242,93,267335,82.43447425223559,8
0.2,3243,94,267429,82.43803945745992,7
0.2,3244,89,267518,82.44006163328197,12
0.2,3245,89,267607,82.44208256315466,13
0.2,3246,26,267633,82.42469972282106,6
0.2,3247,90,267723,82.42703201970443,11
0.2,3248,27,267750,82.40997229916897,7
0.2,3249,96,267846,82.41415384615385,6
0.2,3250,90,267936,82.41648723469702,11
0.2,3251,-53,267883,82.37484624846249,17
0.2,3252,92,267975,82.37780510298187,9
0.2,3253,86,268061,82.37891825445605,16
0.2,3254,92,268153,82.38187403993855,12
0.2,3255,94,268247,82.38544226044226,7
0.2,3256,93,268340,82.38870125882714,10
0.2,3257,95,268435,82.39257213014119,6
0.2,3258,93,268528,82.39582694077939,8
0.2,3259,92,268620,82.39877300613497,10
0.2,3260,94,268714,82.40233057344373,7
0.2,3261,85,268799,82.40312691600245,16
0.2,3262,95,268894,82.40698743487589,6
0.2,3263,94,268988,82.41053921568627,7
0.2,3264,96,269084,82.41470137825421,6
0.2,3265,92,269176,82.41763625229639,9
0.2,3266,94,269270,82.4211815120906,7
0.2,3267,24,269294,82.40330477356181,9
0.2,3268,91,269385,82.40593453655552,10
0.2,3269,85,269470,82.40672782874617,16
0.2,3270,90,269560,82.40904922042189,11
0.2,3271,93,269653,82.41228606356968,8
0.2,3272,96,269749,82.41643751909564,6
0.2,3273,92,269841,82.41936469150886,9
0.2,3274,24,269865,82.40152671755725,10
0.2,3275,89,269954,82.4035409035409,12
0.2,3276,25,269979,82.38602380225817,8
0.2,3277,18,269997,82.36638194020745,14
0.2,3278,94,270091,82.36992985666362,7
0.2,3279,95,270186,82.37378048780488,9
0.2,3280,93,270279,82.37701920146297,8
0.2,3281,94,270373,82.3805606337599,7
0.2,3282,94,270467,82.38409990862016,7
0.2,3283,87,270554,82.38550548112059,14
0.2,3284,93,270647,82.38873668188737,8
0.2,3285,93,270740,82.39196591600731,8
0.2,3286,95,270835,82.39580164283541,8
0.2,3287,-50,270785,82.35553527980535,15
0.2,3288,93,270878,82.35877166311948,8
0.2,3289,93,270971,82.36200607902735,8
0.2,3290,95,271066,82.36584624734124,8
0.2,3291,94,271160,82.36938031591738,7
0.2,3292,92,271252,82.37230488915883,9
0.2,3293,90,271342,82.3746205221615,11
0.2,3294,96,271438,82.37875569044006,6
0.2,3295,90,271528,82.38106796116504,11
0.2,3296,95,271623,82.38489535941765,6
0.2,3297,96,271719,82.3890236506974,6
0.2,3298,96,271815,82.393149439224,6
0.2,3299,91,271906,82.39575757575757,10
0.2,3300,91,271997,82.39836413208118,10
0.2,3301,95,272092,82.40218049666869,7
0.2,3302,94,272186,82.40569179533757,9
0.2,3303,22,272208,82.38740920096852,11
0.2,3304,89,272297,82.3894099848714,12
0.2,3305,95,272392,82.39322444041137,6
0.2,3306,84,272476,82.39371031146054,17
0.2,3307,92,272568,82.39661426844015,9
0.2,3308,96,272664,82.40072529465095,6
0.2,3309,94,272758,82.40422960725076,7
0.2,3310,89,272847,82.40622168529146,12
0.2,3311,92,272939,82.40911835748793,9
0.2,3312,95,273034,82.41291880470872,6
0.2,3313,95,273129,82.41671695835848,6
0.2,3314,22,273151,82.39849170437405,11
0.2,3315,91,273242,82.40108564535585,11
0.2,3316,87,273329,82.40247211335544,14
0.2,3317,93,273422,82.40566606389392,8
0.2,3318,95,273517,82.40946068092799,6
0.2,3319,91,273608,82.41204819277108,10
0.2,3320,93,273701,82.41523637458597,8
0.2,3321,92,273793,82.41812161348585,9
0.2,3322,95,273888,82.42190791453505,6
0.2,3323,94,273982,82.42539109506619,7
0.2,3324,93,274075,82.42857142857143,9
0.2,3325,95,274170,82.43235117257967,7
0.2,3326,93,274263,82.43552750225429,8
0.2,3327,94,274357,82.43900240384616,9
0.2,3328,94,274451,82.44247521778311,7
0.2,3329,91,274542,82.44504504504505,10
0.2,3330,93,274635,82.44821374962474,8
0.2,3331,90,274725,82.45048019207682,13
0.2,3332,91,274816,82.45304530453045,10
0.2,3333,93,274909,82.45620875824835,9
0.2,3334,93,275002,82.45937031484257,8
0.2,3335,91,275093,82.4619304556355,10
0.2,3336,94,275187,82.46538807311957,7
0.2,3337,95,275282,82.46914319952067,6
0.2,3338,26,275308,82.45223120694818,6
0.2,3339,91,275399,82.45479041916168,10
0.2,3340,87,275486,82.45615085303801,14
0.2,3341,90,275576,82.45840813883902,11
0.2,3342,90,275666,82.46066407418486,11
0.2,3343,95,275761,82.46441387559808,6
0.2,3344,88,275849,82.4660687593423,13
0.2,3345,87,275936,82.46742378959952,14
0.2,3346,94,276030,82.47086943531521,7
0.2,3347,94,276124,82.47431302270012,7
0.2,3348,88,276212,82.4759629740221,13
0.2,3349,90,276302,82.47820895522388,11
0.2,3350,93,276395,82.48134885108922,8
0.2,3351,90,276485,82.48359188544153,11
0.2,3352,91,276576,82.48613182224874,10
0.2,3353,94,276670,82.48956469886703,7
0.2,3354,82,276752,82.48941877794337,19
0.2,3355,94,276846,82.49284862932062,7
0.2,3356,92,276938,82.49568066726243,9
0.2,3357,95,277033,82.49940440738534,6
0.2,3358,92,277125,82.50223280738315,9
0.2,3359,95,277220,82.50595238095238,6
0.2,3360,92,277312,82.50877714965785,9
0.2,3361,96,277408,82.51279000594884,6
0.2,3362,94,277502,82.51620576865893,7
0.2,3363,92,277594,82.51902497027348,9
0.2,3364,6,277600,82.4962852897474,28
0.2,3365,92,277692,82.49910873440285,9
0.2,3366,94,277786,82.50252450252451,8
0.2,3367,27,277813,82.48604513064133,6
0.2,3368,95,277908,82.48975957257346,6
0.2,3369,94,278002,82.49317507418398,7
0.2,3370,94,278096,82.49658854939187,7
0.2,3371,94,278190,82.5,8
0.2,3372,89,278279,82.50192706789208,12
0.2,3373,91,278370,82.50444576170717,10
0.2,3374,96,278466,82.50844444444445,7
0.2,3375,91,278557,82.51095971563981,10
0.2,3376,92,278649,82.51376961800415,9
0.2,3377,88,278737,82.5153937240971,13
0.2,3378,90,278827,82.51760875998816,11
0.2,3379,93,278920,82.52071005917159,9
0.2,3380,93,279013,82.52380952380952,9
0.2,3381,94,279107,82.52720283855707,7
0.2,3382,94,279201,82.53059414720663,7
0.2,3383,91,279292,82.53309692671395,10
0.2,3384,90,279382,82.53530280649926,13
0.2,3385,91,279473,82.53780271707029,13
0.2,3386,89,279562,82.53971065839977,12
0.2,3387,89,279651,82.54161747343565,12
0.2,3388,92,279743,82.54440838005311,9
0.2,3389,24,279767,82.52713864306784,10
0.2,3390,91,279858,82.52963727514008,10
0.2,3391,25,279883,82.51267688679245,8
0.2,3392,95,279978,82.51635720601237,8
0.2,3393,95,280073,82.52003535651149,6
0.2,3394,88,280161,82.52164948453608,13
0.2,3395,24,280185,82.50441696113074,9
0.2,3396,95,280280,82.50809537827494,6
0.2,3397,95,280375,82.5117716303708,6
0.2,3398,93,280468,82.51485731097381,8
0.2,3399,96,280564,82.51882352941176,6
0.2,3400,84,280648,82.5192590414584,17
0.2,3401,96,280744,82.52322163433274,6
0.2,3402,96,280840,82.52718189832501,6
0.2,3403,93,280933,82.53025851938895,8
0.2,3404,22,280955,82.51248164464023,11
0.2,3405,95,281050,82.51614797416325,8
0.2,3406,91,281141,82.51863809803346,10
0.2,3407,96,281237,82.52259389671362,6
0.2,3408,90,281327,82.52478732766207,11
0.2,3409,94,281421,82.52815249266862,7
0.2,3410,94,281515,82.53151568454999,7
0.2,3411,94,281609,82.53487690504103,7
0.2,3412,92,281701,82.53765016114855,10
0.2,3413,92,281793,82.54042179261863,9
0.2,3414,94,281887,82.54377745241581,7
0.2,3415,95,281982,82.54742388758783,7
0.2,3416,95,282077,82.55106818846942,6
0.2,3417,93,282170,82.55412521942657,8
0.2,3418,85,282255,82.5548405966657,16
0.2,3419,89,282344,82.55672514619883,12
0.2,3420,96,282440,82.5606547793043,6
0.2,3421,91,282531,82.56312098188194,12
0.2,3422,91,282622,82.56558574349985,10
0.2,3423,87,282709,82.56688084112149,14
0.2,3424,93,282802,82.56992700729927,8
0.2,3425,93,282895,82.57297139521307,9
0.2,3426,96,282991,82.57688940764517,6
0.2,3427,94,283085,82.58022170361727,8
0.2,3428,94,283179,82.583552055993,7
0.2,3429,90,283269,82.58571428571429,11
0.2,3430,96,283365,82.58962401632178,6
0.2,3431,92,283457,82.59236596736596,9
0.2,3432,87,283544,82.59364986891931,14
0.2,3433,92,283636,82.59638905066977,10
0.2,3434,94,283730,82.59970887918486,7
0.2,3435,93,283823,82.60273573923166,9
0.2,3436,90,283913,82.60488798370672,11
0.2,3437,96,284009,82.60878417684701,6
0.2,3438,91,284100,82.61122419307938,10
0.2,3439,93,284193,82.6142441860465,8
0.2,3440,92,284285,82.6169718105202,9
0.2,3441,94,284379,82.62027890761185,7
0.2,3442,93,284472,82.62329363926808,8
0.2,3443,93,284565,82.62630662020906,8
0.2,3444,93,284658,82.62931785195936,8
0.2,3445,90,284748,82.63145676146256,13
0.2,3446,25,284773,82.61473745285755,7
0.2,3447,90,284863,82.61687935034803,11
0.2,3448,11,284874,82.59611481588867,22
0.2,3449,21,284895,82.57826086956521,12
0.2,3450,88,284983,82.5798319327731,13
0.2,3451,93,285076,82.58285052143685,9
0.2,3452,27,285103,82.56675354763973,6
0.2,3453,93,285196,82.56977417486972,8
0.2,3454,-52,285144,82.53082489146165,16
0.2,3455,92,285236,82.53356481481481,9
0.2,3456,96,285332,82.53746022562916,6
0.2,3457,23,285355,82.52024291497976,11
0.2,3458,94,285449,82.52356172304134,7
0.2,3459,96,285545,82.52745664739885,6
0.2,3460,91,285636,82.52990465183473,10
0.2,3461,95,285731,82.53350664355864,7
0.2,3462,94,285825,82.53681778804504,7
0.2,3463,24,285849,82.51991916859123,9
0.2,3464,95,285944,82.52352092352092,6
0.2,3465,94,286038,82.5268320830929,7
0.2,3466,89,286127,82.52869916354197,12
0.2,3467,90,286217,82.53085351787774,11
0.2,3468,84,286301,82.53127702507928,17
0.2,3469,27,286328,82.51527377521614,6
0.2,3470,96,286424,82.51915874387784,6
0.2,3471,96,286520,82.52304147465438,6
0.2,3472,89,286609,82.5249064209617,12
0.2,3473,94,286703,82.52820955670697,7
0.2,3474,91,286794,82.53064748201439,10
0.2,3475,90,286884,82.53279631760644,14
0.2,3476,94,286978,82.53609433419615,7
0.2,3477,96,287074,82.53996549741231,6
0.2,3478,95,287169,82.54354699626329,6
0.2,3479,89,287258,82.54540229885058,13
0.2,3480,20,287278,82.52743464521689,12
0.2,3481,95,287373,82.53101665709363,6
0.2,3482,27,287400,82.51507321274764,7
0.2,3483,93,287493,82.51808266360506,8
0.2,3484,87,287580,82.51936872309899,14
0.2,3485,89,287669,82.52122776821572,12
0.2,3486,95,287764,82.52480642386006,6
0.2,3487,87,287851,82.52608944954129,14
0.2,3488,87,287938,82.5273717397535,14
0.2,3489,94,288032,82.53065902578797,8
0.2,3490,91,288123,82.53308507590948,10
0.2,3491,92,288215,82.53579610538374,9
0.2,3492,94,288309,82.53907815631263,8
0.2,3493,95,288404,82.54264453348597,6
0.2,3494,91,288495,82.54506437768241,10
0.2,3495,95,288590,82.54862700228833,7
0.2,3496,96,288686,82.55247354875608,6
0.2,3497,93,288779,82.55546026300743,8
0.2,3498,94,288873,82.55873106601886,8
0.2,3499,88,288961,82.56028571428571,13
0.2,3500,89,289050,82.56212510711225,14
0.2,3501,83,289133,82.56225014277555,19
0.2,3502,92,289225,82.56494433342849,9
0.2,3503,90,289315,82.56706621004567,12
0.2,3504,90,289405,82.56918687589159,11
0.2,3505,96,289501,82.57301768397033,7
0.2,3506,96,289597,82.57684630738522,6
0.2,3507,91,289688,82.57924743443557,10
0.2,3508,94,289782,82.58250213736108,8
0.2,3509,88,289870,82.58404558404558,13
0.2,3510,95,289965,82.5875818855027,6
0.2,3511,96,290061,82.59140091116173,6
0.2,3512,92,290153,82.59407913464275,9
0.2,3513,96,290249,82.59789413773477,6
0.2,3514,95,290344,82.60142247510669,6
0.2,3515,96,290440,82.6052332195677,6
0.2,3516,94,290534,82.60847313050895,7
0.2,3517,92,290626,82.61114269471291,9
0.2,3518,93,290719,82.61409491332765,8
0.2,3519,94,290813,82.61732954545455,7
0.2,3520,95,290908,82.62084635046861,7
0.2,3521,25,290933,82.60448608745031,8
0.2,3522,87,291020,82.60573374964518,14
0.2,3523,90,291110,82.6078320090806,11
0.2,3524,95,291205,82.6113475177305,8
0.2,3525,91,291296,82.6137266023823,10
0.2,3526,95,291391,82.61723844627161,6
0.2,3527,95,291486,82.62074829931973,6
0.2,3528,95,291581,82.62425616321904,6
0.2,3529,21,291602,82.60679886685553,12
0.2,3530,89,291691,82.60860945907675,12
0.2,3531,91,291782,82.6109852774632,10
0.2,3532,94,291876,82.61420888763091,7
0.2,3533,87,291963,82.61544991511036,14
0.2,3534,92,292055,82.61810466760961,9
0.2,3535,-48,292007,82.58116515837104,12
0.2,3536,92,292099,82.58382810291208,9
0.2,3537,95,292194,82.58733747880159,8
0.2,3538,92,292286,82.58999717434304,9
0.2,3539,95,292381,82.59350282485876,6
0.2,3540,93,292474,82.59644168314036,8
0.2,3541,89,292563,82.59824957651044,12
0.2,3542,87,292650,82.59949195596951,14
0.2,3543,94,292744,82.60270880361173,7
0.2,3544,95,292839,82.60620592383638,6
0.2,3545,92,292931,82.60885504794135,9
0.2,3546,92,293023,82.61150267831971,9
0.2,3547,95,293118,82.61499436302142,7
0.2,3548,95,293213,82.61848408002254,6
0.2,3549,92,293305,82.62112676056339,9
0.2,3550,94,293399,82.62433117431709,7
0.2,3551,95,293494,82.62781531531532,6
0.2,3552,89,293583,82.62960878131157,12
0.2,3553,92,293675,82.63224535734383,9
0.2,3554,92,293767,82.63488045007033,9
0.2,3555,-52,293715,82.59701912260968,16
0.2,3556,92,293807,82.5996626370537,9
0.2,3557,92,293899,82.60230466554243,9
0.2,3558,89,293988,82.6041022759202,14
0.2,3559,13,294001,82.58455056179776,19
0.2,3560,94,294095,82.58775624824487,7
0.2,3561,94,294189,82.59096013475576,7
0.2,3562,89,294278,82.59275891103003,12
0.2,3563,83,294361,82.59287317620651,18
0.2,3564,22,294383,82.5758765778401,11
0.2,3565,94,294477,82.5790802019069,7
0.2,3566,94,294571,82.58228202971685,8
0.2,3567,89,294660,82.58408071748879,12
0.2,3568,83,294743,82.5841972541328,18
0.2,3569,27,294770,82.56862745098039,6
0.2,3570,86,294856,82.56958835060207,15
0.2,3571,91,294947,82.57194848824189,10
0.2,3572,94,295041,82.57514693534844,7
0.2,3573,92,295133,82.57778399552322,9
0.2,3574,91,295224,82.58013986013987,10
0.2,3575,90,295314,82.58221476510067,12
0.2,3576,88,295402,82.58372938216382,14
0.2,3577,95,295497,82.58719955282281,7
0.2,3578,91,295588,82.58955015367421,10
0.2,3579,94,295682,82.5927374301676,7
0.2,3580,93,295775,82.59564367495113,8
0.2,3581,94,295869,82.59882747068677,7
0.2,3582,92,295961,82.60145129779514,10
0.2,3583,20,295981,82.583984375,12
0.2,3584,95,296076,82.58744769874477,6
0.2,3585,27,296103,82.57194645844953,6
0.2,3586,94,296197,82.5751324226373,8
0.2,3587,86,296283,82.57608695652173,15
0.2,3588,17,296300,82.55781554750627,15
0.2,3589,95,296395,82.56128133704735,6
0.2,3590,94,296489,82.56446672236146,7
0.2,3591,95,296584,82.56792873051225,6
0.2,3592,93,296677,82.57083217367102,8
0.2,3593,94,296771,82.5740122426266,7
0.2,3594,94,296865,82.57719054242003,7
0.2,3595,88,296953,82.57869855394883,13
0.2,3596,92,297045,82.581317764804,9
0.2,3597,92,297137,82.58393551973319,9
0.2,3598,91,297228,82.58627396499027,10
0.2,3599,92,297320,82.58888888888889,10
0.2,3600,95,297415,82.59233546237157,6
0.2,3601,92,297507,82.59494725152693,9
0.2,3602,94,297601,82.59811268387455,7
0.2,3603,87,297688,82.59933407325194,14
0.2,3604,87,297775,82.6005547850208,15
0.2,3605,92,297867,82.60316139767055,9
0.2,3606,94,297961,82.60632104241752,7
0.2,3607,89,298050,82.60809312638581,12
0.2,3608,89,298139,82.60986422831809,12
0.2,3609,22,298161,82.59307479224377,10
0.2,3610,94,298255,82.59623373026862,7
0.2,3611,93,298348,82.59911406423035,9
0.2,3612,93,298441,82.60199280376419,8
0.2,3613,88,298529,82.60348644161594,13
0.2,3614,89,298618,82.60525587828492,12
0.2,3615,94,298712,82.60840707964601,7
0.2,3616,94,298806,82.61155653856787,7
0.2,3617,27,298833,82.59618573797678,6
0.2,3618,95,298928,82.59961315280464,6
0.2,3619,80,299008,82.59889502762431,21
0.2,3620,93,299101,82.6017674675504,8
0.2,3621,94,299195,82.60491441192711,8
0.2,3622,95,299290,82.60833563345294,6
0.2,3623,95,299385,82.61175496688742,6
0.2,3624,96,299481,82.61544827586206,6
0.2,3625,93,299574,82.61831218974076,8
0.2,3626,94,299668,82.62145023435346,7
0.2,3627,93,299761,82.62431091510474,8
0.2,3628,96,299857,82.62799669330394,6
0.2,3629,95,299952,82.63140495867769,7
0.2,3630,87,300039,82.63260809694299,14
0.2,3631,96,300135,82.6362885462555,6
0.2,3632,90,300225,82.63831544178365,12
0.2,3633,92,300317,82.6408915795267,9
0.2,3634,96,300413,82.64456671251719,6
0.2,3635,95,300508,82.64796479647964,7
0.2,3636,92,300600,82.65053615617266,9
0.2,3637,94,300694,82.6536558548653,7
0.2,3638,93,300787,82.65649903819731,10
0.2,3639,26,300813,82.64093406593406,8
0.2,3640,24,300837,82.62482834386158,9
0.2,3641,94,300931,82.6279516749039,7
0.2,3642,94,301025,82.63107329124348,7
0.2,3643,95,301120,82.63446761800219,6
0.2,3644,95,301215,82.63786008230453,6
0.2,3645,95,301310,82.64125068568293,6
0.2,3646,94,301404,82.64436523169728,7
0.2,3647,81,301485,82.6439144736842,20
0.2,3648,27,301512,82.62866538777747,6
0.2,3649,95,301607,82.63205479452054,8
0.2,3650,94,301701,82.63516844700082,7
0.2,3651,95,301796,82.63855421686748,6
0.2,3652,94,301890,82.64166438543663,7
0.2,3653,-50,301840,82.60536398467433,14
0.2,3654,89,301929,82.60711354309166,12
0.2,3655,92,302021,82.60968271334792,9
0.2,3656,95,302116,82.61307082307903,8
0.2,3657,88,302204,82.61454346637507,13
0.2,3658,91,302295,82.61683520087456,10
0.2,3659,90,302385,82.6188524590164,11
0.2,3660,91,302476,82.6211417645452,10
0.2,3661,22,302498,82.60458765701803,11
0.2,3662,92,302590,82.60715260715261,9
0.2,3663,86,302676,82.60807860262008,15
0.2,3664,87,302763,82.60927694406548,14
0.2,3665,94,302857,82.61238406983088,7
0.2,3666,93,302950,82.61521679847287,8
0.2,3667,94,303044,82.61832061068702,8
0.2,3668,94,303138,82.62142273098937,7
0.2,3669,92,303230,82.62397820163488,9
0.2,3670,92,303322,82.62653228003269,9
0.2,3671,92,303414,82.62908496732027,11
0.2,3672,22,303436,82.61257827389055,11
0.2,3673,91,303527,82.61486118671748,11
0.2,3674,25,303552,82.59918367346938,7
0.2,3675,91,303643,82.60146898803046,10
0.2,3676,95,303738,82.60484090290998,6
0.2,3677,22,303760,82.5883632408918,11
0.2,3678,95,303855,82.59173688502311,6
0.2,3679,88,303943,82.59320652173913,13
0.2,3680,92,304035,82.5957620211899,9
0.2,3681,94,304129,82.59885931558935,7
0.2,3682,89,304218,82.60059733912571,12
0.2,3683,93,304311,82.60342019543974,8
0.2,3684,89,304400,82.60515603799186,12
0.2,3685,84,304484,82.60553445469344,17
0.2,3686,94,304578,82.6086248982913,7
0.2,3687,91,304669,82.61090021691975,12
0.2,3688,27,304696,82.59582542694497,6
0.2,3689,92,304788,82.59837398373983,9
0.2,3690,96,304884,82.60200487672718,6
0.2,3691,93,304977,82.60482123510293,8
0.2,3692,90,305067,82.6068237205524,11
0.2,3693,95,305162,82.61017866811045,7
0.2,3694,91,305253,82.61244925575102,10
0.2,3695,93,305346,82.61525974025975,8
0.2,3696,91,305437,82.61752772518258,10
0.2,3697,-57,305380,82.57977285018929,21
0.2,3698,94,305474,82.58286023249526,7
0.2,3699,95,305569,82.58621621621622,6
0.2,3700,88,305657,82.58767900567415,13
0.2,3701,95,305752,82.59103187466235,7
0.2,3702,93,305845,82.59384283013773,8
0.2,3703,27,305872,82.57883369330453,6
0.2,3704,96,305968,82.58245614035087,6
0.2,3705,92,306060,82.58499730167296,9
0.2,3706,89,306149,82.5867278122471,12
0.2,3707,94,306243,82.58980582524272,7
0.2,3708,87,306330,82.59099487732543,14
0.2,3709,93,306423,82.59380053908356,8
0.2,3710,85,306508,82.59444893559687,16
0.2,3711,94,306602,82.59752155172414,8
0.2,3712,-56,306546,82.56019391327767,22
0.2,3713,95,306641,82.56354334948843,6
0.2,3714,95,306736,82.56689098250337,8
0.2,3715,92,306828,82.56942949407966,9
0.2,3716,94,306922,82.57250470809792,7
0.2,3717,92,307014,82.57504034427112,10
0.2,3718,94,307108,82.57811239580532,8
0.2,3719,92,307200,82.58064516129032,9
0.2,3720,94,307294,82.58371405536147,7
0.2,3721,94,307388,82.58678130037615,7
0.2,3722,94,307482,82.58984689766318,7
0.2,3723,92,307574,82.59237379162191,9
0.2,3724,18,307592,82.57503355704698,15
0.2,3725,89,307681,82.57675791733763,12
0.2,3726,93,307774,82.57955460155621,9
0.2,3727,95,307869,82.58288626609442,6
0.2,3728,95,307964,82.58621614373827,6
0.2,3729,95,308059,82.58954423592493,6
0.2,3730,91,308150,82.59179844545699,11
0.2,3731,94,308244,82.59485530546624,8
0.2,3732,96,308340,82.5984462898473,6
0.2,3733,95,308435,82.60176754151044,8
0.2,3734,93,308528,82.6045515394913,8
0.2,3735,96,308624,82.60813704496788,6
0.2,3736,92,308716,82.6106502542146,9
0.2,3737,95,308811,82.6139646869984,6
0.2,3738,95,308906,82.6172773468842,6
0.2,3739,25,308931,82.60187165775402,8
0.2,3740,96,309027,82.60545308740978,6
0.2,3741,96,309123,82.60903260288616,7
0.2,3742,19,309142,82.59203847181405,14
0.2,3743,92,309234,82.59455128205128,9
0.2,3744,21,309255,82.5781041388518,12
0.2,3745,95,309350,82.58142018152697,6
0.2,3746,91,309441,82.58366693354684,10
0.2,3747,94,309535,82.5867129135539,7
0.2,3748,83,309618,82.58682315284075,18
0.2,3749,90,309708,82.5888,11
0.2,3750,89,309797,82.59050919754732,12
0.2,3751,95,309892,82.59381663113007,7
0.2,3752,95,309987,82.59712230215827,7
0.2,3753,93,310080,82.59989344698988,8
0.2,3754,91,310171,82.60213049267644,11
0.2,3755,95,310266,82.60543130990415,6
0.2,3756,94,310360,82.6084642001597,7
0.2,3757,91,310451,82.61069717935072,10
0.2,3758,92,310543,82.61319499866985,9
0.2,3759,23,310566,82.59734042553191,10
0.2,3760,90,310656,82.59930869449614,11
0.2,3761,96,310752,82.60287081339713,6
0.2,3762,90,310842,82.60483656656923,11
0.2,3763,92,310934,82.60733262486717,9
0.2,3764,87,311021,82.60849933598938,14
0.2,3765,22,311043,82.59240573552842,11
0.2,3766,94,311137,82.59543403238652,9
0.2,3767,96,311233,82.598991507431,6
0.2,3768,95,311328,82.60228177235341,6
0.2,3769,93,311421,82.6050397877984,8
0.2,3770,25,311446,82.58976398833201,8
0.2,3771,91,311537,82.59199363732768,10
0.2,3772,92,311629,82.59448714550756,9
0.2,3773,95,311724,82.59777424483306,6
0.2,3774,91,311815,82.6,10
0.2,3775,27,311842,82.58527542372882,6
0.2,3776,95,311937,82.58856235107228,6
0.2,3777,89,312026,82.59025939650608,12
0.2,3778,94,312120,82.59327864514422,9
0.2,3779,86,312206,82.59417989417989,15
0.2,3780,91,312297,82.59640306797144,10
0.2,3781,21,312318,82.58011634056055,11
0.2,3782,92,312410,82.58260639703938,9
0.2,3783,14,312424,82.56448202959831,18
0.2,3784,95,312519,82.5677675033025,7
0.2,3785,14,312533,82.54965662968833,18
0.2,3786,89,312622,82.5513599155004,13
0.2,3787,96,312718,82.55491024287223,6
0.2,3788,94,312812,82.55793085246766,7
0.2,3789,91,312903,82.56015831134565,11
0.2,3790,95,312998,82.56343972566606,8
0.2,3791,90,313088,82.56540084388186,12
0.2,3792,94,313182,82.56841550224097,8
0.2,3793,95,313277,82.57169214549289,8
0.2,3794,92,313369,82.5741765480896,9
0.2,3795,11,313380,82.55532139093783,21
0.2,3796,93,313473,82.55807216223334,8
0.2,3797,96,313569,82.56161137440758,6
0.2,3798,87,313656,82.56277967886285,14
0.2,3799,91,313747,82.565,10
0.2,3800,92,313839,82.56748224151539,10
0.2,3801,94,313933,82.570489216202,8
0.2,3802,95,314028,82.57375755982119,6
0.2,3803,87,314115,82.57492113564669,14
0.2,3804,94,314209,82.57792378449409,7
0.2,3805,89,314298,82.57961114030478,12
0.2,3806,95,314393,82.58287365379564,6
0.2,3807,91,314484,82.58508403361344,10
0.2,3808,93,314577,82.5878183250197,8
0.2,3809,95,314672,82.59107611548556,7
0.2,3810,25,314697,82.5759643138284,9
0.2,3811,24,314721,82.5605981112277,9
0.2,3812,24,314745,82.54523996852872,9
0.2,3813,91,314836,82.54745673833246,10
0.2,3814,93,314929,82.55019659239842,8
0.2,3815,93,315022,82.55293501048219,8
0.2,3816,86,315108,82.55383809274299,15
0.2,3817,-49,315059,82.5193818753274,12
0.2,3818,95,315154,82.52264990835297,7
0.2,3819,95,315249,82.52591623036649,7
0.2,3820,27,315276,82.51138445433132,6
0.2,3821,24,315300,82.49607535321822,8
0.2,3822,95,315395,82.49934606330108,6
0.2,3823,95,315490,82.5026150627615,7
0.2,3824,95,315585,82.50588235294117,7
0.2,3825,90,315675,82.50784108729744,11
0.2,3826,93,315768,82.51058270185524,8
0.2,3827,-48,315720,82.47648902821317,12
0.2,3828,96,315816,82.48002089318359,7
0.2,3829,95,315911,82.48328981723238,6
0.2,3830,96,316007,82.48681806316888,6
0.2,3831,87,316094,82.48799582463465,16
0.2,3832,91,316185,82.49021654056874,10
0.2,3833,95,316280,82.49347939488784,6
0.2,3834,92,316372,82.49595827900913,9
0.2,3835,18,316390,82.47914494264859,14
0.2,3836,92,316482,82.48162627052385,9
0.2,3837,92,316574,82.48410630536738,9
0.2,3838,94,316668,82.48710601719198,7
0.2,3839,93,316761,82.48984375,8
0.2,3840,92,316853,82.49231970840927,9
0.2,3841,89,316942,82.49401353461738,12
0.2,3842,91,317033,82.49622690606297,10
0.2,3843,95,317128,82.49947970863684,7
0.2,3844,96,317224,82.50299089726919,6
0.2,3845,91,317315,82.50520020800832,10
0.2,3846,93,317408,82.50792825578372,8
0.2,3847,93,317501,82.51065488565489,8
0.2,3848,94,317595,82.51363990646921,9
0.2,3849,95,317690,82.51688311688312,6
0.2,3850,95,317785,82.52012464294988,7
0.2,3851,90,317875,82.52206645898235,13
0.2,3852,88,317963,82.52348819101998,13
0.2,3853,92,318055,82.52594706798132,9
0.2,3854,94,318149,82.52892347600519,7
0.2,3855,95,318244,82.53215767634855,6
0.2,3856,95,318339,82.53539019963702,6
0.2,3857,89,318428,82.53706583722136,12
0.2,3858,93,318521,82.53977714433792,8
0.2,3859,94,318615,82.54274611398964,7
0.2,3860,96,318711,82.54623154623155,6
0.2,3861,85,318796,82.54686690833765,16
0.2,3862,89,318885,82.54853740616102,12
0.2,3863,94,318979,82.5515010351967,7
0.2,3864,94,319073,82.55446313065977,8
0.2,3865,94,319167,82.5574236937403,7
0.2,3866,90,319257,82.55934833204034,11
0.2,3867,94,319351,82.56230610134436,7
0.2,3868,89,319440,82.56397001809253,13
0.2,3869,94,319534,82.56692506459949,9
0.2,3870,88,319622,82.56832859726168,13
0.2,3871,92,319714,82.57076446280992,9
0.2,3872,88,319802,82.57216627937,13
0.2,3873,94,319896,82.57511615900877,7
0.2,3874,96,319992,82.5785806451613,6
0.2,3875,95,320087,82.58178534571724,6
0.2,3876,93,320180,82.58447253030694,8
0.2,3877,96,320276,82.587931923672,6
0.2,3878,94,320370,82.59087393658159,7
0.2,3879,89,320459,82.59252577319587,12
0.2,3880,95,320554,82.59572275186808,6
0.2,3881,89,320643,82.59737248840804,12
0.2,3882,-48,320595,82.56373937677054,12
0.2,3883,94,320689,82.56668383110195,7
0.2,3884,89,320778,82.56833976833977,12
0.2,3885,93,320871,82.57102418939783,8
0.2,3886,93,320964,82.57370722922562,8
0.2,3887,92,321056,82.57613168724279,9
0.2,3888,96,321152,82.57958344047313,6
0.2,3889,94,321246,82.58251928020566,7
0.2,3890,93,321339,82.5851966075559,8
0.2,3891,95,321434,82.58838643371017,7
0.2,3892,95,321529,82.59157462111482,6
0.2,3893,96,321625,82.59501797637391,6
0.2,3894,23,321648,82.57971758664955,11
0.2,3895,24,321672,82.564681724846,10
0.2,3896,92,321764,82.56710289966641,9
0.2,3897,92,321856,82.56952283222165,9
0.2,3898,86,321942,82.5704026673506,15
0.2,3899,91,322033,82.5725641025641,10
0.2,3900,92,322125,82.57498077416047,9
0.2,3901,90,322215,82.57688364941056,13
0.2,3902,88,322303,82.57827312323853,13
0.2,3903,92,322395,82.58068647540983,11
0.2,3904,87,322482,82.58181818181818,14
0.2,3905,90,322572,82.58371735791091,11
0.2,3906,90,322662,82.58561556181213,11
0.2,3907,86,322748,82.58648925281474,17
0.2,3908,94,322842,82.58940905602456,7
0.2,3909,96,322938,82.59283887468031,6
0.2,3910,25,322963,82.57811301457427,7
0.2,3911,94,323057,82.5810327198364,7
0.2,3912,26,323083,82.56657296192179,7
0.2,3913,91,323174,82.5687276443536,10
0.2,3914,91,323265,82.57088122605364,10
0.2,3915,91,323356,82.57303370786516,11
0.2,3916,94,323450,82.57595098289508,9
0.2,3917,95,323545,82.57912200102093,7
0.2,3918,95,323640,82.58229140086758,7
0.2,3919,95,323735,82.58545918367346,6
0.2,3920,27,323762,82.57128283601122,6
0.2,3921,89,323851,82.57292197858236,12
0.2,3922,96,323947,82.57634463420851,6
0.2,3923,90,324037,82.5782364933741,11
0.2,3924,86,324123,82.57910828025477,15
0.2,3925,26,324149,82.56469689251146,7
0.2,3926,90,324239,82.56659027247262,11
0.2,3927,89,324328,82.56822810590631,13
0.2,3928,95,324423,82.57139221175872,6
0.2,3929,95,324518,82.57455470737914,7
0.2,3930,92,324610,82.57695242940727,9
0.2,3931,94,324704,82.57985757884029,7
0.2,3932,96,324800,82.58326976862446,6
0.2,3933,92,324892,82.58566344687341,9
0.2,3934,94,324986,82.58856416772554,7
0.2,3935,92,325078,82.59095528455285,9
0.2,3936,96,325174,82.59436118872237,6
0.2,3937,93,325267,82.59700355510411,8
0.2,3938,96,325363,82.6004061944656,6
0.2,3939,82,325445,82.6002538071066,19
0.2,3940,94,325539,82.60314640954073,7
0.2,3941,13,325552,82.58548959918824,20
0.2,3942,93,325645,82.58813086482374,8
0.2,3943,94,325739,82.59102434077079,7
0.2,3944,23,325762,82.57591888466413,10
0.2,3945,93,325855,82.57856056766346,9
0.2,3946,91,325946,82.58069419812516,10
0.2,3947,94,326040,82.58358662613982,8
0.2,3948,85,326125,82.58419853127374,17
0.2,3949,95,326220,82.5873417721519,6
0.2,3950,24,326244,82.57251328777525,8
0.2,3951,91,326335,82.57464574898785,10
0.2,3952,96,326431,82.57804199342272,6
0.2,3953,91,326522,82.58017197774406,10
0.2,3954,92,326614,82.58255372945638,10
0.2,3955,93,326707,82.58518705763397,8
0.2,3956,92,326799,82.58756633813495,9
0.2,3957,93,326892,82.59019706922689,8
0.2,3958,91,326983,82.59232129325588,10
0.2,3959,90,327073,82.59419191919191,11
0.2,3960,91,327164,82.59631406210553,10
0.2,3961,22,327186,82.58101968702675,10
0.2,3962,93,327279,82.58364875094625,8
0.2,3963,-54,327225,82.54919273461151,17
0.2,3964,95,327320,82.55233291298865,6
0.2,3965,92,327412,82.55471507816439,9
0.2,3966,95,327507,82.55785228132089,7
0.2,3967,91,327598,82.55997983870968,10
0.2,3968,90,327688,82.56185437137817,11
0.2,3969,96,327784,82.56523929471032,6
0.2,3970,95,327879,82.56837068748426,6
0.2,3971,94,327973,82.57124874118831,8
0.2,3972,95,328068,82.57437704505412,7
0.2,3973,96,328164,82.57775541016608,6
0.2,3974,90,328254,82.57962264150943,11
0.2,3975,93,328347,82.58224346076459,8
0.2,3976,93,328440,82.58486296203168,8
0.2,3977,93,328533,82.58748114630468,9
0.2,3978,91,328624,82.58959537572254,10
0.2,3979,92,328716,82.59195979899498,9
0.2,3980,88,328804,82.59331826174328,13
0.2,3981,88,328892,82.59467604218986,13
0.2,3982,89,328981,82.5962842078835,12
0.2,3983,90,329071,82.59814257028113,11
0.2,3984,93,329164,82.60075282308658,9
0.2,3985,90,329254,82.60260913196187,11
0.2,3986,-54,329200,82.56834712816654,17
0.2,3987,93,329293,82.570962888666,8
0.2,3988,20,329313,82.55527701178241,13
0.2,3989,92,329405,82.55764411027569,9
0.2,3990,92,329497,82.56001002255074,9
0.2,3991,94,329591,82.562875751503,7
0.2,3992,93,329684,82.56548960681192,9
0.2,3993,22,329706,82.55032548823235,11
0.2,3994,92,329798,82.55269086357947,9
0.2,3995,92,329890,82.55505505505505,9
0.2,3996,88,329978,82.55641731298473,13
0.2,3997,96,330074,82.55977988994498,6
0.2,3998,21,330095,82.54438609652414,11
0.2,3999,95,330190,82.5475,7
0.2,4000,93,330283,82.55011247188203,8
0.2,4001,92,330375,82.55247376311844,9
0.2,4002,91,330466,82.55458406195353,10
0.2,4003,93,330559,82.5571928071928,8
0.2,4004,88,330647,82.5585518102372,13
0.2,4005,94,330741,82.56140788816775,7
0.2,4006,94,330835,82.56426254055403,8
0.2,4007,25,330860,82.5499001996008,7
0.2,4008,87,330947,82.55101022698928,15
0.2,4009,94,331041,82.55386533665835,7
0.2,4010,92,331133,82.55622039391673,9
0.2,4011,92,331225,82.55857427716849,13
0.2,4012,95,331320,82.56167455768751,6
0.2,4013,85,331405,82.56228201295465,16
0.2,4014,19,331424,82.5464508094645,13
0.2,4015,92,331516,82.5488047808765,9
0.2,4016,94,331610,82.55165546427682,7
0.2,4017,19,331629,82.5358387257342,14
0.2,4018,91,331720,82.5379447623787,11
0.2,4019,91,331811,82.54004975124379,10
0.2,4020,90,331901,82.54190499875652,11
0.2,4021,94,331995,82.54475385380408,9
0.2,4022,91,332086,82.54685558041263,11
0.2,4023,96,332182,82.55019880715706,6
0.2,4024,93,332275,82.5527950310559,8
0.2,4025,95,332370,82.5558867362146,6
0.2,4026,95,332465,82.55897690588527,7
0.2,4027,94,332559,82.56181727904668,7
0.2,4028,90,332649,82.56366344005957,11
0.2,4029,86,332735,82.56451612903226,15
0.2,4030,92,332827,82.56685685934012,9
0.2,4031,91,332918,82.56894841269842,12
0.2,4032,94,333012,82.57178279196629,8
0.2,4033,94,333106,82.5746157659891,7
0.2,4034,95,333201,82.57769516728625,6
0.2,4035,92,333293,82.58002973240832,9
0.2,4036,91,333384,82.58211543225167,10
0.2,4037,19,333403,82.56636948984647,15
0.2,4038,88,333491,82.56771478088636,13
0.2,4039,96,333587,82.5710396039604,6
0.2,4040,93,333680,82.57362039099233,8
0.2,4041,93,333773,82.57619990103909,8
0.2,4042,93,333866,82.57877813504822,8
0.2,4043,93,333959,82.58135509396637,8
0.2,4044,95,334054,82.58442521631645,8
0.2,4045,94,334148,82.58724666337123,7
0.2,4046,92,334240,82.58957252285644,9
0.2,4047,92,334332,82.59189723320158,9
0.2,4048,85,334417,82.59249197332674,16
0.2,4049,92,334509,82.59481481481481,9
0.2,4050,91,334600,82.59688965687485,10
0.2,4051,95,334695,82.59995064165844,6
0.2,4052,95,334790,82.60301011596349,6
0.2,4053,94,334884,82.60582141095215,7
0.2,4054,18,334902,82.58988902589395,14
0.2,4055,90,334992,82.59171597633136,11
0.2,4056,94,335086,82.59452797633719,7
0.2,4057,95,335181,82.59758501724988,6
0.2,4058,23,335204,82.5829021926583,11
0.2,4059,92,335296,82.58522167487685,10
0.2,4060,87,335383,82.58630879093819,15
0.2,4061,92,335475,82.58862629246677,10
0.2,4062,96,335571,82.59192714742801,6
0.2,4063,90,335661,82.59375,11
0.2,4064,-50,335611,82.56113161131611,14
0.2,4065,93,335704,82.56369896704378,8
0.2,4066,93,335797,82.56626506024097,8
0.2,4067,92,335889,82.56858407079646,9
0.2,4068,94,335983,82.57139346276726,7
0.2,4069,95,336078,82.57444717444717,6
0.2,4070,94,336172,82.57725374600835,7
0.2,4071,87,336259,82.57833988212181,14
0.2,4072,21,336280,82.56322121286522,12
0.2,4073,94,336374,82.56602847324497,7
0.2,4074,93,336467,82.56858895705521,8
0.2,4075,27,336494,82.5549558390579,6
0.2,4076,-51,336443,82.52219769438312,16
0.2,4077,93,336536,82.52476704266797,8
0.2,4078,93,336629,82.5273351311596,8
0.2,4079,16,336645,82.51102941176471,17
0.2,4080,93,336738,82.51359960793923,8
0.2,4081,92,336830,82.51592356687898,9
0.2,4082,86,336916,82.51677687974528,15
0.2,4083,95,337011,82.51983349657199,6
0.2,4084,89,337100,82.52141982864137,12
0.2,4085,90,337190,82.52325012236906,11
0.2,4086,89,337279,82.52483484218253,12
0.2,4087,89,337368,82.52641878669276,12
0.2,4088,94,337462,82.52922474932747,8
0.2,4089,88,337550,82.53056234718827,14
0.2,4090,95,337645,82.53361036421413,6
0.2,4091,95,337740,82.5366568914956,9
0.2,4092,87,337827,82.53774737356463,14
0.2,4093,27,337854,82.52418172936004,6
0.2,4094,92,337946,82.52649572649572,9
0.2,4095,91,338037,82.528564453125,10
0.2,4096,95,338132,82.53160849402002,6
0.2,4097,92,338224,82.53391898487067,9
0.2,4098,22,338246,82.51915101244207,11
0.2,4099,95,338341,82.52219512195121,6
0.2,4100,94,338435,82.52499390392587,7
0.2,4101,94,338529,82.52779132130668,7
0.2,4102,89,338618,82.52936875456983,12
0.2,4103,25,338643,82.51535087719299,8
0.2,4104,94,338737,82.51814859926918,7
0.2,4105,92,338829,82.52045786653677,10
0.2,4106,92,338921,82.52276600925249,9
0.2,4107,92,339013,82.52507302823759,9
0.2,4108,92,339105,82.52737892431249,9
0.2,4109,91,339196,82.52944038929441,10
0.2,4110,93,339289,82.53198735100949,8
0.2,4111,91,339380,82.534046692607,10
0.2,4112,94,339474,82.53683442742523,7
0.2,4113,93,339567,82.5393777345649,8
0.2,4114,93,339660,82.5419198055893,8
0.2,4115,94,339754,82.544703595724,7
0.2,4116,21,339775,82.52975467573476,12
0.2,4117,94,339869,82.53254006799418,7
0.2,4118,93,339962,82.53508133042,8
0.2,4119,24,339986,82.52087378640776,8
0.2,4120,94,340080,82.52365930599369,7
0.2,4121,95,340175,82.52668607472101,7
0.2,4122,92,340267,82.52898374969682,9
0.2,4123,88,340355,82.53031037827353,13
0.2,4124,21,340376,82.51539393939395,11
0.2,4125,89,340465,82.51696558410083,15
0.2,4126,18,340483,82.50133268718197,14
0.2,4127,93,340576,82.50387596899225,8
0.2,4128,94,340670,82.50666020828288,7
0.2,4129,91,340761,82.50871670702179,10
0.2,4130,94,340855,82.5114984265311,7
0.2,4131,89,340944,82.51306873184899,12
0.2,4132,94,341038,82.51584805226229,8
0.2,4133,21,341059,82.50096758587324,11
0.2,4134,88,341147,82.50229746070133,13
0.2,4135,94,341241,82.50507736943908,7
0.2,4136,90,341331,82.50688905003626,11
0.2,4137,90,341421,82.50869985500242,11
0.2,4138,92,341513,82.51099299347669,9
0.2,4139,94,341607,82.51376811594203,8
0.2,4140,92,341699,82.51605892296547,9
0.2,4141,94,341793,82.51883148237566,7
0.2,4142,95,341888,82.52184407434227,6
0.2,4143,92,341980,82.52413127413128,9
0.2,4144,89,342069,82.52569360675513,12
0.2,4145,94,342163,82.52846116739026,7
0.2,4146,94,342257,82.53122739329636,7
0.2,4147,92,342349,82.53351012536162,9
0.2,4148,95,342444,82.53651482284889,6
0.2,4149,94,342538,82.53927710843374,7
0.2,4150,95,342633,82.54227896892316,7
0.2,4151,96,342729,82.54552023121387,6
0.2,4152,22,342751,82.5309414880809,10
0.2,4153,94,342845,82.5337024554646,7
0.2,4154,94,342939,82.53646209386281,8
0.2,4155,94,343033,82.53922040423484,7
0.2,4156,92,343125,82.54149627134953,9
0.2,4157,88,343213,82.54280904280904,14
0.2,4158,86,343299,82.54364029814859,15
0.2,4159,21,343320,82.52884615384616,12
0.2,4160,90,343410,82.53064167267483,11
0.2,4161,94,343504,82.53339740509371,7
0.2,4162,95,343599,82.53639202498198,6
0.2,4163,94,343693,82.53914505283382,7
0.2,4164,95,343788,82.5421368547419,6
0.2,4165,95,343883,82.54512722035525,6
0.2,4166,91,343974,82.5471562275018,10
0.2,4167,94,344068,82.54990403071017,7
0.2,4168,27,344095,82.53657951547133,7
0.2,4169,92,344187,82.53884892086332,10
0.2,4170,91,344278,82.54087748741308,10
0.2,4171,91,344369,82.54290508149569,11
0.2,4172,93,344462,82.54541097531752,11
0.2,4173,93,344555,82.54791566842357,8
0.2,4174,95,344650,82.55089820359281,7
0.2,4175,93,344743,82.55340038314176,8
0.2,4176,94,344837,82.55614077088819,7
0.2,4177,21,344858,82.5414073719483,14
0.2,4178,95,344953,82.54438860971524,8
0.2,4179,93,345046,82.54688995215311,8
0.2,4180,94,345140,82.54962927529299,8
0.2,4181,95,345235,82.55260640841702,6
0.2,4182,84,345319,82.55295242648816,17
0.2,4183,95,345414,82.55592734225621,7
0.2,4184,91,345505,82.55794504181601,10
0.2,4185,96,345601,82.56115623506928,6
0.2,4186,-48,345553,82.52997372820636,12
0.2,4187,90,345643,82.53175740210123,11
0.2,4188,95,345738,82.53473382668895,6
0.2,4189,89,345827,82.53627684964201,12
0.2,4190,95,345922,82.53925077547125,7
0.2,4191,93,346015,82.5417461832061,9
0.2,4192,93,346108,82.54424040066777,8
0.2,4193,92,346200,82.54649499284693,11
0.2,4194,91,346291,82.54851013110846,12
0.2,4195,94,346385,82.55123927550048,8
0.2,4196,89,346474,82.55277579223255,13
0.2,4197,93,346567,82.55526441162458,8
0.2,4198,92,346659,82.55751369373661,10
0.2,4199,90,346749,82.55928571428572,11
0.2,4200,27,346776,82.54606046179481,6
0.2,4201,86,346862,82.5468824369348,15
0.2,4202,91,346953,82.54889364739472,10
0.2,4203,93,347046,82.55137963843958,8
0.2,4204,19,347065,82.53626634958383,13
0.2,4205,96,347161,82.53946742748455,6
0.2,4206,95,347256,82.5424292845258,6
0.2,4207,91,347347,82.5444391634981,11
0.2,4208,86,347433,82.54526015680685,15
0.2,4209,87,347520,82.54631828978623,14
0.2,4210,94,347614,82.54903823319877,7
0.2,4211,26,347640,82.53561253561253,6
0.2,4212,85,347725,82.53619748397816,16
0.2,4213,94,347819,82.5389178927385,7
0.2,4214,94,347913,82.54163701067615,7
0.2,4215,19,347932,82.52656546489564,13
0.2,4216,91,348023,82.52857481622006,10
0.2,4217,95,348118,82.53153153153153,6
0.2,4218,91,348209,82.53353875325907,10
0.2,4219,87,348296,82.5345971563981,14
0.2,4220,90,348386,82.53636579009714,11
0.2,4221,93,348479,82.5388441496921,9
0.2,4222,93,348572,82.54132133554346,8
0.2,4223,25,348597,82.52769886363636,8
0.2,4224,92,348689,82.52994082840236,9
0.2,4225,94,348783,82.53265499290109,7
0.2,4226,95,348878,82.53560444759877,7
0.2,4227,94,348972,82.53831598864711,8
0.2,4228,94,349066,82.5410262473398,7
0.2,4229,96,349162,82.54420803782506,6
0.2,4230,89,349251,82.54573386906169,12
0.2,4231,95,349346,82.54867674858222,6
0.2,4232,90,349436,82.55043704228679,11
0.2,4233,90,349526,82.55219650448748,11
0.2,4234,96,349622,82.55537190082644,6
0.2,4235,23,349645,82.54131255901794,9
0.2,4236,91,349736,82.54330894500826,10
0.2,4237,24,349760,82.52949504483247,11
0.2,4238,94,349854,82.53220099079972,7
0.2,4239,93,349947,82.53466981132075,9
0.2,4240,94,350041,82.53737326102335,7
0.2,4241,87,350128,82.53842527109853,14
0.2,4242,93,350221,82.54089087909497,8
0.2,4243,86,350307,82.54170593779453,15
0.2,4244,93,350400,82.54416961130742,8
0.2,4245,92,350492,82.54639660857278,10
0.2,4246,95,350587,82.54932893807394,6
0.2,4247,22,350609,82.53507532956685,10
0.2,4248,93,350702,82.53753824429278,9
0.2,4249,91,350793,82.5395294117647,10
0.2,4250,93,350886,82.54199011997177,8
0.2,4251,95,350981,82.54492003762935,6
0.2,4252,95,351076,82.54784857747472,6
0.2,4253,96,351172,82.55101081335214,6
0.2,4254,92,351264,82.55323149236193,9
0.2,4255,93,351357,82.55568609022556,8
0.2,4256,92,351449,82.55790462767207,9
0.2,4257,96,351545,82.56106153123532,6
0.2,4258,91,351636,82.56304296783283,10
0.2,4259,24,351660,82.54929577464789,9
0.2,4260,96,351756,82.55245247594462,6
0.2,4261,95,351851,82.55537306428907,6
0.2,4262,94,351945,82.55805770584095,7
0.2,4263,95,352040,82.5609756097561,8
0.2,4264,95,352135,82.56389214536928,7
0.2,4265,87,352222,82.56493202062822,14
0.2,4266,94,352316,82.5676119053199,7
0.2,4267,23,352339,82.55365510777882,10
0.2,4268,16,352355,82.53806512063716,16
0.2,4269,92,352447,82.54028103044496,9
0.2,4270,96,352543,82.54343245141654,6
0.2,4271,92,352635,82.54564606741573,9
0.2,4272,91,352726,82.54762461970512,11
0.2,4273,22,352748,82.5334581188582,11
0.2,4274,94,352842,82.53614035087719,7
0.2,4275,88,352930,82.53741814780169,14
0.2,4276,26,352956,82.52419920505027,6
0.2,4277,93,353049,82.52664796633941,10
0.2,4278,85,353134,82.52722598738023,16
0.2,4279,90,353224,82.52897196261682,11
0.2,4280,92,353316,82.53118430273301,9
0.2,4281,92,353408,82.53339560952826,9
0.2,4282,92,353500,82.53560588372636,9
0.2,4283,84,353584,82.5359477124183,17
0.2,4284,93,353677,82.53838973162193,8
0.2,4285,91,353768,82.54036397573495,10
0.2,4286,93,353861,82.54280382551902,8
0.2,4287,-44,353817,82.51329291044776,8
0.2,4288,94,353911,82.51597108883189,8
0.2,4289,95,354006,82.51888111888113,6
0.2,4290,92,354098,82.52109065485901,9
0.2,4291,95,354193,82.5239981360671,6
0.2,4292,92,354285,82.52620545073376,9
0.2,4293,94,354379,82.52887750349325,7
0.2,4294,93,354472,82.53131548311991,8
0.2,4295,95,354567,82.53421787709497,6
0.2,4296,93,354660,82.53665347917152,8
0.2,4297,20,354680,82.52210330386227,13
0.2,4298,93,354773,82.52454059083507,9
0.2,4299,96,354869,82.52767441860465,6
0.2,4300,91,354960,82.5296442687747,10
0.2,4301,92,355052,82.53184565318456,11
0.2,4302,91,355143,82.53381361840576,10
0.2,4303,94,355237,82.53647769516729,8
0.2,4304,90,355327,82.53821138211381,11
0.2,4305,94,355421,82.54087320018579,7
0.2,4306,93,355514,82.54330160204319,8
0.2,4307,88,355602,82.54456824512535,13
0.2,4308,94,355696,82.54722673474124,7
0.2,4309,89,355785,82.54872389791183,12
0.2,4310,92,355877,82.55091626072837,9
0.2,4311,94,355971,82.55357142857143,7
0.2,4312,92,356063,82.55576165082309,9
0.2,4313,94,356157,82.55841446453408,8
0.2,4314,23,356180,82.54461181923523,10
0.2,4315,91,356271,82.54657089898053,10
0.2,4316,93,356364,82.54899235580264,9
0.2,4317,96,356460,82.5521074571561,6
0.2,4318,25,356485,82.538782125492,9
0.2,4319,24,356509,82.52523148148148,9
0.2,4320,95,356604,82.52811849109003,6
0.2,4321,96,356700,82.53123553910227,6
0.2,4322,90,356790,82.53296321998612,11
0.2,4323,27,356817,82.52012025901942,6
0.2,4324,95,356912,82.52300578034682,7
0.2,4325,96,357008,82.52612112806287,6
0.2,4326,19,357027,82.51143979662584,14
0.2,4327,95,357122,82.51432532347505,6
0.2,4328,20,357142,82.4998844998845,12
0.2,4329,94,357236,82.50254041570439,8
0.2,4330,90,357326,82.50427153082428,13
0.2,4331,94,357420,82.50692520775624,7
0.2,4332,94,357514,82.50957765981998,7
0.2,4333,92,357606,82.51176742039686,9
0.2,4334,91,357697,82.51372549019608,10
0.2,4335,90,357787,82.51545202952029,11
0.2,4336,95,357882,82.51833064330182,6
0.2,4337,21,357903,82.50414937759336,12
0.2,4338,90,357993,82.50587693016824,12
0.2,4339,92,358085,82.50806451612904,9
0.2,4340,95,358180,82.51094217922137,6
0.2,4341,93,358273,82.51335789958544,8
0.2,4342,22,358295,82.49942436104075,11
0.2,4343,91,358386,82.5013812154696,10
0.2,4344,95,358481,82.5042577675489,7
0.2,4345,76,358557,82.50276115968707,25
0.2,4346,93,358650,82.50517598343686,8
0.2,4347,94,358744,82.50781968721252,7
0.2,4348,95,358839,82.51069211312945,7
0.2,4349,93,358932,82.51310344827586,8
0.2,4350,88,359020,82.51436451390485,14
0.2,4351,95,359115,82.51723345588235,7
0.2,4352,92,359207,82.51941189983918,9
0.2,4353,19,359226,82.50482315112541,14
0.2,4354,21,359247,82.49070034443169,13
0.2,4355,91,359338,82.49265381083563,10
0.2,4356,93,359431,82.49506541198072,8
0.2,4357,95,359526,82.49793483249196,6
0.2,4358,93,359619,82.50034411562285,8
0.2,4359,89,359708,82.50183486238532,12
0.2,4360,91,359799,82.50378353588627,11
0.2,4361,24,359823,82.49037138927098,9
0.2,4362,94,359917,82.49300939720376,7
0.2,4363,96,360013,82.49610449129239,6
0.2,4364,94,360107,82.4987399770905,7
0.2,4365,-50,360057,82.4683921209345,14
0.2,4366,92,360149,82.4705747652851,9
0.2,4367,91,360240,82.47252747252747,10
0.2,4368,92,360332,82.47470817120623,9
0.2,4369,91,360423,82.4766590389016,10
0.2,4370,93,360516,82.47906657515443,8
0.2,4371,90,360606,82.4807868252516,13
0.2,4372,89,360695,82.48227761262291,12
0.2,4373,90,360785,82.48399634202103,11
0.2,4374,93,360878,82.4864,8
0.2,4375,22,360900,82.47257769652651,11
0.2,4376,96,360996,82.47566826593557,7
0.2,4377,96,361092,82.47875742348104,6
0.2,4378,94,361186,82.48138844485042,7
0.2,4379,95,361281,82.48424657534247,6
0.2,4380,92,361373,82.4864186258845,9
0.2,4381,86,361459,82.48722044728434,16
0.2,4382,94,361553,82.48984713666438,7
0.2,4383,92,361645,82.49201642335767,9
0.2,4384,25,361670,82.47890535917902,8
0.2,4385,95,361765,82.48176014591883,7
0.2,4386,95,361860,82.48461363118304,6
0.2,4387,90,361950,82.48632634457611,11
0.2,4388,94,362044,82.48894964684439,7
0.2,4389,94,362138,82.49157175398634,8
0.2,4390,94,362232,82.49419266681849,7
0.2,4391,25,362257,82.48110200364299,9
0.2,4392,89,362346,82.48258593216481,12
0.2,4393,94,362440,82.48520710059172,7
0.2,4394,95,362535,82.48805460750853,6
0.2,4395,-47,362488,82.45859872611464,10
0.2,4396,91,362579,82.46054127814419,10
0.2,4397,95,362674,82.46339245111415,6
0.2,4398,83,362757,82.46351443509889,18
0.2,4399,88,362845,82.46477272727273,14
0.2,4400,91,362936,82.46671211088389,10
0.2,4401,96,363032,82.46978646069968,6
0.2,4402,95,363127,82.4726322961617,6
0.2,4403,93,363220,82.47502270663034,8
0.2,4404,94,363314,82.47763904653803,8
0.2,4405,95,363409,82.48048116205175,7
0.2,4406,19,363428,82.46607669616519,13
0.2,4407,88,363516,82.46733212341198,13
0.2,4408,92,363608,82.4694942163756,9
0.2,4409,95,363703,82.47233560090703,6
0.2,4410,93,363796,82.4747222851961,8
0.2,4411,93,363889,82.47710788757932,8
0.2,4412,85,363974,82.47767958305008,16
0.2,4413,93,364067,82.4800634345265,8
0.2,4414,92,364159,82.48221970554927,9
0.2,4415,91,364250,82.48414855072464,11
0.2,4416,94,364344,82.4867557165497,8
0.2,4417,90,364434,82.4884563150747,11
0.2,4418,94,364528,82.49106132609188,7
0.2,4419,91,364619,82.49298642533937,10
0.2,4420,92,364711,82.49513684686723,9
0.2,4421,95,364806,82.49796472184532,6
0.2,4422,27,364833,82.48541713768935,6
0.2,4423,21,364854,82.47151898734177,12
0.2,4424,83,364937,82.4716384180791,18
0.2,4425,96,365033,82.47469498418437,6
0.2,4426,23,365056,82.46126044725548,10
0.2,4427,93,365149,82.46364046973802,8
0.2,4428,92,365241,82.46579363287424,9
0.2,4429,91,365332,82.46772009029345,10
0.2,4430,92,365424,82.46987136086662,9
0.2,4431,91,365515,82.47179602888086,10
0.2,4432,91,365606,82.47371982855854,11
0.2,4433,94,365700,82.47631935047362,7
0.2,4434,93,365793,82.47869222096956,8
0.2,4435,95,365888,82.48151487826871,6
0.2,4436,92,365980,82.48366013071896,9
0.2,4437,22,366002,82.47003154574132,13
0.2,4438,93,366095,82.4724036945258,9
0.2,4439,96,366191,82.47545045045045,6
0.2,4440,95,366286,82.47827065976132,6
0.2,4441,95,366381,82.4810895992796,6
0.2,4442,22,366403,82.46747693000225,11
0.2,4443,94,366497,82.47007200720073,7
0.2,4444,94,366591,82.4726659167604,7
0.2,4445,93,366684,82.47503373819163,9
0.2,4446,95,366779,82.47785023611424,7
0.2,4447,88,366867,82.4790917266187,13
0.2,4448,95,366962,82.48190604630254,6
0.2,4449,89,367051,82.48337078651686,12
0.2,4450,93,367144,82.48573354302404,8
0.2,4451,84,367228,82.48607367475292,17
0.2,4452,92,367320,82.48821019537391,9
0.2,4453,94,367414,82.49079479119892,7
0.2,4454,94,367508,82.49337822671156,7
0.2,4455,95,367603,82.49618491921005,6
0.2,4456,93,367696,82.49854161992371,8
0.2,4457,90,367786,82.5002243158367,11
0.2,4458,93,367879,82.50257905359946,8
0.2,4459,95,367974,82.50538116591929,9
0.2,4460,78,368052,82.50437121721588,23
0.2,4461,92,368144,82.50649932765576,9
0.2,4462,87,368231,82.50750616177459,16
0.2,4463,95,368326,82.5103046594982,6
0.2,4464,94,368420,82.51287793952967,7
0.2,4465,94,368514,82.5154500671742,7
0.2,4466,95,368609,82.51824490709649,6
0.2,4467,25,368634,82.50537153088631,8
0.2,4468,88,368722,82.50660102931305,13
0.2,4469,91,368813,82.50850111856823,10
0.2,4470,94,368907,82.51107134869157,7
0.2,4471,94,369001,82.51364042933811,7
0.2,4472,94,369095,82.51620836127879,7
0.2,4473,90,369185,82.51788109074654,11
0.2,4474,93,369278,82.52022346368715,9
0.2,4475,95,369373,82.52301161751564,6
0.2,4476,89,369462,82.52445834264016,12
0.2,4477,94,369556,82.52702099151406,7
0.2,4478,93,369649,82.52935923197143,8
0.2,4479,89,369738,82.53080357142858,12
0.2,4480,95,369833,82.5335862530685,7
0.2,4481,95,369928,82.5363676929942,6
0.2,4482,95,370023,82.53914789203658,6
0.2,4483,89,370112,82.54058876003569,13
0.2,4484,95,370207,82.54336677814939,6
0.2,4485,25,370232,82.5305394560856,8
0.2,4486,22,370254,82.51704925339871,10
0.2,4487,24,370278,82.50401069518716,9
0.2,4488,27,370305,82.49164624638004,6
0.2,4489,92,370397,82.49376391982183,9
0.2,4490,86,370483,82.49454464484525,16
0.2,4491,95,370578,82.4973285841496,6
0.2,4492,94,370672,82.4998887157801,7
0.2,4493,93,370765,82.50222518914107,9
0.2,4494,96,370861,82.50522803114572,7
0.2,4495,89,370950,82.50667259786476,12
0.2,4496,91,371041,82.50856126306427,10
0.2,4497,88,371129,82.50978212538907,13
0.2,4498,91,371220,82.51166925983551,10
0.2,4499,90,371310,82.51333333333334,11
0.2,4500,90,371400,82.51499666740725,11
0.2,4501,20,371420,82.50111061750333,13
0.2,4502,95,371515,82.50388629802355,8
0.2,4503,87,371602,82.50488454706927,14
0.2,4504,93,371695,82.5072142064373,8
0.2,4505,95,371790,82.50998668442077,8
0.2,4506,94,371884,82.51253605502552,7
0.2,4507,92,371976,82.51464063886424,9
0.2,4508,96,372072,82.51763140385894,6
0.2,4509,88,372160,82.51884700665188,13
0.2,4510,27,372187,82.50653956994014,6
0.2,4511,94,372281,82.50908687943263,8
0.2,4512,94,372375,82.51163306004875,7
0.2,4513,26,372401,82.49911386796633,7
0.2,4514,86,372487,82.49988925802879,15
0.2,4515,93,372580,82.5022143489814,8
0.2,4516,92,372672,82.50431702457384,9
0.2,4517,24,372696,82.49136786188579,9
0.2,4518,94,372790,82.49391458287232,7
0.2,4519,96,372886,82.49690265486726,6
0.2,4520,84,372970,82.49723512497235,17
0.2,4521,92,373062,82.49933657673596,9
0.2,4522,96,373158,82.50232146805217,6
0.2,4523,94,373252,82.50486295313881,9
0.2,4524,95,373347,82.50762430939227,6
0.2,4525,90,373437,82.50927971718957,11
0.2,4526,90,373527,82.51093439363817,11
0.2,4527,96,373623,82.51391342756183,6
0.2,4528,94,373717,82.51644954736145,8
0.2,4529,94,373811,82.51898454746137,7
0.2,4530,90,373901,82.52063562127566,11
0.2,4531,94,373995,82.52316857899382,7
0.2,4532,94,374089,82.52570041914846,7
0.2,4533,90,374179,82.52734891927658,11
0.2,4534,94,374273,82.52987872105844,7
0.2,4535,94,374367,82.5324074074074,7
0.2,4536,90,374457,82.53405333921093,11
0.2,4537,93,374550,82.53635962979286,8
0.2,4538,-47,374503,82.50782110597048,10
0.2,4539,95,374598,82.51057268722467,6
0.2,4540,24,374622,82.4976877339793,11
0.2,4541,90,374712,82.4993394980185,11
0.2,4542,91,374803,82.50121065375302,10
0.2,4543,93,374896,82.50352112676056,8
0.2,4544,94,374990,82.50605060506051,7
0.2,4545,93,375083,82.50835899692036,9
0.2,4546,89,375172,82.50978667253133,13
0.2,4547,96,375268,82.5127528583993,6
0.2,4548,93,375361,82.51505825456144,9
0.2,4549,94,375455,82.51758241758242,9
0.2,4550,95,375550,82.52032520325203,6
0.2,4551,94,375644,82.52284710017575,7
0.2,4552,94,375738,82.52536788930375,7
0.2,4553,90,375828,82.52700922266139,11
0.2,4554,93,375921,82.52930845225028,9
0.2,4555,85,376006,82.52985074626865,17
0.2,4556,94,376100,82.53236778582401,7
0.2,4557,94,376194,82.53488372093024,8
0.2,4558,91,376285,82.53674051327046,10
0.2,4559,90,376375,82.53837719298245,11
0.2,4560,94,376469,82.54089015566761,7
0.2,4561,92,376561,82.54296361245068,9
0.2,4562,95,376656,82.5456936226167,6
0.2,4563,85,376741,82.54623137598598,16
0.2,4564,92,376833,82.54830230010953,9
0.2,4565,94,376927,82.55081033727552,7
0.2,4566,96,377023,82.55375520035034,6
0.2,4567,88,377111,82.55494746059544,13
0.2,4568,93,377204,82.55723353031298,8
0.2,4569,26,377230,82.54485776805252,7
0.2,4570,91,377321,82.54670750382849,10
0.2,4571,95,377416,82.54943132108487,7
0.2,4572,93,377509,82.55171659741964,8
0.2,4573,91,377600,82.55356362046349,11
0.2,4574,25,377625,82.54098360655738,8
0.2,4575,94,377719,82.54348776223776,7
0.2,4576,89,377808,82.54489840506882,12
0.2,4577,93,377901,82.54718217562254,8
0.2,4578,94,377995,82.54968333697313,8
0.2,4579,15,378010,82.5349344978166,17
0.2,4580,23,378033,82.52193844138834,9
0.2,4581,17,378050,82.50763858577041,15
0.2,4582,95,378145,82.51036439013747,7
0.2,4583,93,378238,82.51265270506109,9
0.2,4584,96,378334,82.51559432933479,6
0.2,4585,95,378429,82.51831661578719,8
0.2,4586,90,378519,82.51994767822106,11
0.2,4587,90,378609,82.52157802964254,11
0.2,4588,94,378703,82.52407932011332,7
0.2,4589,84,378787,82.52440087145969,17
0.2,4590,89,378876,82.52581137007188,12
0.2,4591,93,378969,82.52809233449477,8
0.2,4592,89,379058,82.52950141519703,12
0.2,4593,92,379150,82.53156290814105,9
0.2,4594,91,379241,82.53340587595213,10
0.2,4595,92,379333,82.53546562228024,10
0.2,4596,90,379423,82.53708940613444,11
0.2,4597,92,379515,82.5391474554154,9
0.2,4598,91,379606,82.54098717112416,12
0.2,4599,94,379700,82.54347826086956,7
0.2,4600,96,379796,82.54640295587916,6
0.2,4601,87,379883,82.54737070838766,15
0.2,4602,96,379979,82.55029328698674,6
0.2,4603,94,380073,82.55278019113814,7
0.2,4604,90,380163,82.55439739413681,11
0.2,4605,86,380249,82.5551454624403,16
0.2,4606,90,380339,82.55676144996744,11
0.2,4607,94,380433,82.55924479166667,7
0.2,4608,91,380524,82.56107615534823,10
0.2,4609,-51,380473,82.53210412147506,14
0.2,4610,91,380564,82.53394057688138,10
0.2,4611,92,380656,82.5359930615785,9
0.2,4612,94,380750,82.53847821374377,8
0.2,4613,94,380844,82.5409622886866,8
0.2,4614,93,380937,82.54322860238354,8
0.2,4615,95,381032,82.54592720970537,7
0.2,4616,94,381126,82.54840805717998,7
0.2,4617,96,381222,82.55132091814639,6
0.2,4618,21,381243,82.5379952370643,12
0.2,4619,92,381335,82.54004329004329,9
0.2,4620,91,381426,82.54187405323523,10
0.2,4621,92,381518,82.54392038078754,11
0.2,4622,91,381609,82.54574951330305,10
0.2,4623,92,381701,82.54779411764706,10
0.2,4624,89,381790,82.54918918918919,12
0.2,4625,94,381884,82.5516645049719,8
0.2,4626,93,381977,82.55392262805273,8
0.2,4627,91,382068,82.55574762316336,10
0.2,4628,94,382162,82.55821991790883,7
0.2,4629,95,382257,82.5609071274298,6
0.2,4630,94,382351,82.56337724033686,8
0.2,4631,95,382446,82.5660621761658,7
0.2,4632,87,382533,82.5670192100151,14
0.2,4633,21,382554,82.55373327578765,11
0.2,4634,95,382649,82.5564185544768,6
0.2,4635,93,382742,82.55867126833478,8
0.2,4636,90,382832,82.56027604054346,11
0.2,4637,90,382922,82.5618801207417,12
0.2,4638,94,383016,82.56434576417331,8
0.2,4639,94,383110,82.56681034482759,7
0.2,4640,96,383206,82.56970480499892,6
0.2,4641,96,383302,82.57259801809565,7
0.2,4642,17,383319,82.55847512384234,17
0.2,4643,94,383413,82.56093884582256,8
0.2,4644,94,383507,82.56340150699677,7
0.2,4645,94,383601,82.56586310804994,7
0.2,4646,94,383695,82.56832364966645,8
0.2,4647,21,383716,82.55507745266782,13
0.2,4648,95,383811,82.55775435577543,7
0.2,4649,94,383905,82.56021505376344,8
0.2,4650,83,383988,82.56030961083638,18
0.2,4651,95,384083,82.56298366294067,6
0.2,4652,94,384177,82.56544165054804,7
0.2,4653,93,384270,82.56768371293511,9
0.2,4654,86,384356,82.56842105263158,15
0.2,4655,25,384381,82.55605670103093,8
0.2,4656,94,384475,82.55851406484861,8
0.2,4657,95,384570,82.56118505796479,6
0.2,4658,95,384665,82.56385490448594,6
0.2,4659,93,384758,82.56609442060086,8
0.2,4660,94,384852,82.568547521991,7
0.2,4661,90,384942,82.57014157014157,11
0.2,4662,90,385032,82.57173493459146,11
0.2,4663,96,385128,82.5746140651801,6
0.2,4664,96,385224,82.5774919614148,6
0.2,4665,90,385314,82.57908272610374,11
0.2,4666,94,385408,82.5815298907221,7
0.2,4667,88,385496,82.58269065981148,13
0.2,4668,87,385583,82.58363675305205,14
0.2,4669,95,385678,82.58629550321199,7
0.2,4670,95,385773,82.58895311496468,7
0.2,4671,89,385862,82.59032534246575,12
0.2,4672,94,385956,82.5927669591269,7
0.2,4673,93,386049,82.59499358151476,8
0.2,4674,91,386140,82.59679144385026,12
0.2,4675,94,386234,82.59923011120615,7
0.2,4676,92,386326,82.60124011118238,9
0.2,4677,92,386418,82.60324925181702,10
0.2,4678,92,386510,82.60525753366103,9
0.2,4679,95,386605,82.60790598290598,9
0.2,4680,96,386701,82.61076693014313,7
0.2,4681,94,386795,82.61319948739855,7
0.2,4682,94,386889,82.61563100576554,7
0.2,4683,94,386983,82.61806148590948,7
0.2,4684,91,387074,82.61985058697972,10
0.2,4685,92,387166,82.62185232607767,10
0.2,4686,95,387261,82.62449327928313,6
0.2,4687,94,387355,82.62691979522184,7
0.2,4688,95,387450,82.62955854126679,7
0.2,4689,90,387540,82.63113006396588,11
0.2,4690,92,387632,82.63312726497549,11
0.2,4691,94,387726,82.63554987212277,7
0.2,4692,22,387748,82.62262944811421,11
0.2,4693,92,387840,82.6246271836387,9
0.2,4694,93,387933,82.62683706070287,8
0.2,4695,93,388026,82.62904599659285,8
0.2,4696,93,388119,82.63125399190973,8
0.2,4697,93,388212,82.63346104725414,9
0.2,4698,89,388301,82.63481591828048,12
0.2,4699,25,388326,82.62255319148936,8
0.2,4700,92,388418,82.62454796851733,9
0.2,4701,92,388510,82.62654189706508,9
0.2,4702,93,388603,82.62874760790984,9
0.2,4703,93,388696,82.63095238095238,9
0.2,4704,93,388789,82.63315621679065,8
0.2,4705,90,388879,82.6347216319592,11
0.2,4706,13,388892,82.6199277671553,20
0.2,4707,94,388986,82.62234494477485,7
0.2,4708,90,389076,82.62391165852623,11
0.2,4709,91,389167,82.62569002123142,10
0.2,4710,94,389261,82.62810443642539,7
0.2,4711,92,389353,82.63009337860781,9
0.2,4712,87,389440,82.63102058137068,15
0.2,4713,90,389530,82.63258379295715,11
0.2,4714,94,389624,82.63499469777307,8
0.2,4715,88,389712,82.63613231552164,13
0.2,4716,95,389807,82.63875344498622,6
0.2,4717,94,389901,82.64116150911403,9
0.2,4718,21,389922,82.62809917355372,11
0.2,4719,96,390018,82.63093220338983,6
0.2,4720,90,390108,82.63249311586529,11
0.2,4721,93,390201,82.63468869123253,8
0.2,4722,89,390290,82.63603641753123,12
0.2,4723,94,390384,82.63844199830652,8
0.2,4724,21,390405,82.62539682539682,11
0.2,4725,92,390497,82.62738044858231,9
0.2,4726,23,390520,82.61476623651365,9
0.2,4727,94,390614,82.61717428087987,7
0.2,4728,92,390706,82.61915838443646,9
0.2,4729,95,390801,82.62177589852008,8
0.2,4730,91,390892,82.62354681885436,10
0.2,4731,96,390988,82.62637362637362,6
0.2,4732,91,391079,82.62814282695965,10
0.2,4733,88,391167,82.62927756653993,13
0.2,4734,92,391259,82.63125659978881,10
0.2,4735,94,391353,82.6336570945946,8
0.2,4736,25,391378,82.62149039476462,8
0.2,4737,96,391474,82.62431405656395,6
0.2,4738,90,391564,82.62587043680101,11
0.2,4739,92,391656,82.62784810126583,9
0.2,4740,91,391747,82.62961400548407,10
0.2,4741,25,391772,82.61746098692535,8
0.2,4742,90,391862,82.6190174994729,12
0.2,4743,88,391950,82.62015177065767,13
0.2,4744,90,392040,82.62170706006323,11
0.2,4745,94,392134,82.62410450906026,10
0.2,4746,91,392225,82.62586896987571,10
0.2,4747,93,392318,82.62805391743892,8
0.2,4748,94,392412,82.63044851547694,8
0.2,4749,22,392434,82.61768421052632,10
0.2,4750,89,392523,82.6190275731425,13
0.2,4751,95,392618,82.621632996633,8
0.2,4752,20,392638,82.60845781611614,13
0.2,4753,91,392729,82.61022297013042,10
0.2,4754,23,392752,82.59768664563617,10
0.2,4755,94,392846,82.60008410428932,7
0.2,4756,95,392941,82.60269077149464,7
0.2,4757,92,393033,82.6046658259773,9
0.2,4758,92,393125,82.60664005043077,9
0.2,4759,94,393219,82.60903361344538,7
0.2,4760,95,393314,82.61163621088006,7
0.2,4761,90,393404,82.61318773624528,11
0.2,4762,94,393498,82.6155784169641,7
0.2,4763,93,393591,82.61775818639798,9
0.2,4764,93,393684,82.6199370409234,8
0.2,4765,95,393779,82.6225346202266,6
0.2,4766,93,393872,82.62471155863226,8
0.2,4767,90,393962,82.62625838926175,11
0.2,4768,22,393984,82.61354581673307,12
0.2,4769,20,394004,82.60041928721174,12
0.2,4770,96,394100,82.60322783483547,6
0.2,4771,94,394194,82.60561609388097,9
0.2,4772,80,394274,82.60507018646554,22
0.2,4773,93,394367,82.60724759111856,8
0.2,4774,90,394457,82.60879581151832,12
0.2,4775,93,394550,82.6109715242881,8
0.2,4776,93,394643,82.61314632614612,8
0.2,4777,92,394735,82.61511092507325,9
0.2,4778,93,394828,82.61728395061728,8
0.2,4779,92,394920,82.61924686192468,9
0.2,4780,91,395011,82.62099979083874,10
0.2,4781,94,395105,82.62337933918863,7
0.2,4782,26,395131,82.61154087392849,7
0.2,4783,93,395224,82.61371237458194,9
0.2,4784,93,395317,82.6158829676071,8
0.2,4785,93,395410,82.61805265357292,8
0.2,4786,94,395504,82.62043033214957,7
0.2,4787,77,395581,82.61925647451963,24
0.2,4788,90,395671,82.62079766130717,11
0.2,4789,88,395759,82.62192066805845,13
0.2,4790,86,395845,82.622625756627,15
0.2,4791,95,395940,82.62520868113522,7
0.2,4792,94,396034,82.62758189025662,7
0.2,4793,94,396128,82.6299541093033,7
0.2,4794,90,396218,82.63149113660063,11
0.2,4795,92,396310,82.63344453711426,9
0.2,4796,96,396406,82.6362309776944,6
0.2,4797,95,396501,82.63880783659859,7
0.2,4798,95,396596,82.64138362158783,6
0.2,4799,92,396688,82.64333333333333,9
0.2,4800,92,396780,82.64528223286815,9
0.2,4801,95,396875,82.6478550603915,8
0.2,4802,92,396967,82.64980220695399,9
0.2,4803,91,397058,82.65154038301415,10
0.2,4804,90,397148,82.65306971904266,11
0.2,4805,94,397242,82.65543071161049,7
0.2,4806,93,397335,82.65758269190763,10
0.2,4807,93,397428,82.65973377703827,9
0.2,4808,96,397524,82.66250779787897,6
0.2,4809,96,397620,82.66528066528066,6
0.2,4810,85,397705,82.66576595302432,16
0.2,4811,91,397796,82.66749792186201,10
0.2,4812,94,397890,82.66985248285893,8
0.2,4813,93,397983,82.6719983381803,8
0.2,4814,85,398068,82.67248182762201,16
0.2,4815,95,398163,82.6750415282392,6
0.2,4816,93,398256,82.67718496989828,8
0.2,4817,94,398350,82.67953507679535,7
0.2,4818,87,398437,82.68043162481843,14
0.2,4819,91,398528,82.68215767634855,10
0.2,4820,94,398622,82.68450528935905,8
0.2,4821,95,398717,82.68705931148901,7
0.2,4822,92,398809,82.68899025502799,9
0.2,4823,96,398905,82.6917495854063,6
0.2,4824,95,399000,82.69430051813471,7
0.2,4825,94,399094,82.69664318276006,7
0.2,4826,95,399189,82.69919204474829,6
0.2,4827,94,399283,82.70153272576637,7
0.2,4828,96,399379,82.70428660178091,6
0.2,4829,90,399469,82.70579710144928,11
0.2,4830,96,399565,82.70854895466778,6
0.2,4831,92,399657,82.71047185430463,10
0.2,4832,94,399751,82.71280777984688,7
0.2,4833,95,399846,82.71534960695077,6
0.2,4834,91,399937,82.71706308169597,10
0.2,4835,87,400024,82.71794871794872,14
0.2,4836,95,400119,82.72048790572669,6
0.2,4837,9,400128,82.70525010334849,23
0.2,4838,94,400222,82.70758421161398,7
0.2,4839,27,400249,82.69607438016529,6
0.2,4840,92,400341,82.69799628175997,9
0.2,4841,90,400431,82.69950433705081,11
0.2,4842,93,400524,82.70163122031798,8
0.2,4843,92,400616,82.70355078447564,9
0.2,4844,93,400709,82.70567595459237,8
0.2,4845,95,400804,82.70821295914156,8
0.2,4846,89,400893,82.7095110377553,12
0.2,4847,92,400985,82.71142739273927,9
0.2,4848,24,401009,82.69931944730872,9
0.2,4849,94,401103,82.70164948453608,7
0.2,4850,91,401194,82.70336013193156,10
0.2,4851,96,401290,82.70610057708161,6
0.2,4852,94,401384,82.70842777663302,7
0.2,4853,93,401477,82.71054800164812,8
0.2,4854,92,401569,82.7124613800206,9
0.2,4855,94,401663,82.71478583196046,7
0.2,4856,92,401755,82.71669754992794,9
0.2,4857,91,401846,82.71840263482915,13
0.2,4858,25,401871,82.70652397612677,8
0.2,4859,96,401967,82.70925925925926,6
0.2,4860,96,402063,82.71199341699239,6
0.2,4861,95,402158,82.7145207733443,6
0.2,4862,94,402252,82.71684145589143,7
0.2,4863,87,402339,82.71772203947368,14
0.2,4864,94,402433,82.72004110996917,7
0.2,4865,94,402527,82.7223592272914,7
0.2,4866,95,402622,82.72488185740703,7
0.2,4867,92,402714,82.72678718159409,9
0.2,4868,88,402802,82.72787019921955,14
0.2,4869,94,402896,82.73018480492813,7
0.2,4870,87,402983,82.73106138369944,14
0.2,4871,93,403076,82.73316912972085,8
0.2,4872,95,403171,82.7356864354607,6
0.2,4873,95,403266,82.73820270824784,6
0.2,4874,19,403285,82.7251282051282,15
0.2,4875,88,403373,82.72621000820345,13
0.2,4876,93,403466,82.72831658806643,8
0.2,4877,24,403490,82.71627716277163,9
0.2,4878,95,403585,82.71879483500717,7
0.2,4879,90,403675,82.7202868852459,11
0.2,4880,94,403769,82.72259782831387,7
0.2,4881,94,403863,82.72490782466203,7
0.2,4882,93,403956,82.72701208273602,9
0.2,4883,93,404049,82.72911547911548,8
0.2,4884,93,404142,82.73121801432958,9
0.2,4885,91,404233,82.73291035611952,10
0.2,4886,93,404326,82.73501125434827,8
0.2,4887,88,404414,82.73608837970541,13
0.2,4888,91,404505,82.73777868684803,10
0.2,4889,93,404598,82.7398773006135,8
0.2,4890,95,404693,82.74238397055817,6
0.2,4891,25,404718,82.73058053965659,8
0.2,4892,85,404803,82.7310443490701,16
0.2,4893,92,404895,82.73293829178586,11
0.2,4894,93,404988,82.73503575076609,8
0.2,4895,93,405081,82.73713235294117,8
0.2,4896,24,405105,82.72513783949357,9
0.2,4897,89,405194,82.72641894650877,12
0.2,4898,94,405288,82.72872014696877,8
0.2,4899,92,405380,82.73061224489796,9
0.2,4900,82,405462,82.73046317078148,21
0.2,4901,27,405489,82.71909424724602,6
0.2,4902,94,405583,82.72139506424638,7
0.2,4903,94,405677,82.72369494290375,7
0.2,4904,91,405768,82.72538226299694,10
0.2,4905,91,405859,82.72706889523033,10
0.2,4906,92,405951,82.72895863052781,9
0.2,4907,95,406046,82.73145884270579,7
0.2,4908,90,406136,82.7329394988796,11
0.2,4909,94,406230,82.73523421588595,7
0.2,4910,95,406325,82.7377316228874,6
0.2,4911,96,406421,82.7404315960912,6
0.2,4912,17,406438,82.72705068186444,15
0.2,4913,95,406533,82.72954822954823,6
0.2,4914,93,406626,82.73163784333673,8
0.2,4915,91,406717,82.73331977217249,10
0.2,4916,94,406811,82.73561114500711,7
0.2,4917,94,406905,82.73790158601058,8
0.2,4918,-45,406860,82.71193331978044,9
0.2,4919,94,406954,82.71422764227643,9
0.2,4920,94,407048,82.71652103231051,7
0.2,4921,95,407143,82.71901665989435,7
0.2,4922,93,407236,82.7211050172659,8
0.2,4923,83,407319,82.72116165718927,18
0.2,4924,92,407411,82.72304568527919,9
0.2,4925,94,407505,82.72533495736906,7
0.2,4926,90,407595,82.72681144712807,12
0.2,4927,21,407616,82.71428571428571,12
0.2,4928,89,407705,82.71556096571312,12
0.2,4929,87,407792,82.71643002028398,14
0.2,4930,92,407884,82.71831271547353,9
0.2,4931,90,407974,82.71978913219789,12
0.2,4932,93,408067,82.72187309953375,9
0.2,4933,96,408163,82.72456424807459,7
0.2,4934,96,408259,82.72725430597771,7
0.2,4935,83,408342,82.7273095623987,18
0.2,4936,94,408436,82.72959287016407,7
0.2,4937,96,408532,82.73228027541515,7
0.2,4938,92,408624,82.73415671188499,10
0.2,4939,84,408708,82.73441295546559,17
0.2,4940,95,408803,82.73689536531067,6
0.2,4941,93,408896,82.73897207608256,8
0.2,4942,92,408988,82.74084564029941,9
0.2,4943,96,409084,82.74352750809061,6
0.2,4944,93,409177,82.74560161779576,8
0.2,4945,86,409263,82.74625960372018,15
0.2,4946,96,409359,82.74893875075803,6
0.2,4947,96,409455,82.7516168148747,6
0.2,4948,94,409549,82.75388967468176,7
0.2,4949,93,409642,82.7559595959596,8
0.2,4950,92,409734,82.75782670167644,9
0.2,4951,95,409829,82.76029886914378,6
0.2,4952,90,409919,82.76176054916212,11
0.2,4953,96,410015,82.76443278159063,6
0.2,4954,89,410104,82.7656912209889,12
0.2,4955,94,410198,82.76795803066989,7
0.2,4956,93,410291,82.77002219084123,9
0.2,4957,95,410386,82.77248890681726,7
0.2,4958,86,410472,82.77313974591651,15
0.2,4959,85,410557,82.77358870967743,16
0.2,4960,93,410650,82.7756500705503,8
0.2,4961,93,410743,82.77771060056429,9
0.2,4962,89,410832,82.77896433608704,12
0.2,4963,93,410925,82.78102336825141,9
0.2,4964,92,411017,82.78288016112789,9
0.2,4965,90,411107,82.78433346757954,11
0.2,4966,94,411201,82.7865915039259,7
0.2,4967,92,411293,82.78844605475041,9
0.2,4968,92,411385,82.79029985912659,9
0.2,4969,96,411481,82.79295774647888,6
0.2,4970,92,411573,82.79480989740495,9
0.2,4971,94,411667,82.79706355591311,8
0.2,4972,19,411686,82.78423486828876,14
0.2,4973,94,411780,82.78648974668275,7
0.2,4974,92,411872,82.78834170854272,9
0.2,4975,93,411965,82.79039389067525,8
0.2,4976,92,412057,82.79224432388989,9
0.2,4977,17,412074,82.7790277219767,15
0.2,4978,93,412167,82.7810805382607,9
0.2,4979,96,412263,82.78373493975904,7
0.2,4980,27,412290,82.77253563541457,7
0.2,4981,90,412380,82.77398635086311,11
0.2,4982,94,412474,82.77623921332531,7
0.2,4983,24,412498,82.76444622792937,9
0.2,4984,95,412593,82.76690070210631,6
0.2,4985,91,412684,82.76855194544726,10
0.2,4986,83,412767,82.76859835572489,20
0.2,4987,94,412861,82.77085004009624,7
0.2,4988,95,412956,82.7733012627781,6
0.2,4989,91,413047,82.7749498997996,10
0.2,4990,95,413142,82.77739931877379,7
0.2,4991,96,413238,82.78004807692308,6
0.2,4992,95,413333,82.78249549369117,6
0.2,4993,17,413350,82.76932318782539,16
0.2,4994,94,413444,82.77157157157157,9
0.2,4995,92,413536,82.77341873498798,10
0.2,4996,94,413630,82.77566539923954,8
0.2,4997,95,413725,82.7781112444978,7
0.2,4998,93,413818,82.78015603120625,8
0.2,4999,94,413912,82.7824,7
0.2,5000,16,413928,82.76904619076184,16
0.2,5001,90,414018,82.77049180327869,13
0.2,5002,92,414110,82.77233659804118,9
0.2,5003,89,414199,82.77358113509193,12
0.2,5004,94,414293,82.77582417582417,7
0.2,5005,93,414386,82.77786656012785,8
0.2,5006,93,414479,82.77990812861994,8
0.2,5007,91,414570,82.78154952076677,10
0.2,5008,92,414662,82.78338989818327,9
0.2,5009,87,414749,82.78423153692614,14
0.2,5010,94,414843,82.78646976651368,7
0.2,5011,90,414933,82.78790901835595,11
0.2,5012,89,415022,82.78914821464193,13
0.2,5013,90,415112,82.79058635819705,11
0.2,5014,93,415205,82.7926221335992,9
0.2,5015,83,415288,82.792663476874,18
0.2,5016,92,415380,82.79449870440503,9
0.2,5017,88,415468,82.79553607014746,14
0.2,5018,22,415490,82.78342299262802,12
0.2,5019,94,415584,82.78565737051792,7
0.2,5020,95,415679,82.78809002190799,7
0.2,5021,91,415770,82.78972520908005,10
0.2,5022,94,415864,82.79195699781008,7
0.2,5023,93,415957,82.79398885350318,8
0.2,5024,93,416050,82.79601990049751,8
0.2,5025,94,416144,82.7982491046558,8
0.2,5026,93,416237,82.80027849612095,8
0.2,5027,92,416329,82.80210819411296,9
0.2,5028,27,416356,82.79101212964804,6
0.2,5029,95,416451,82.7934393638171,7
0.2,5030,27,416478,82.78234943351222,6
0.2,5031,89,416567,82.78358505564388,12
0.2,5032,93,416660,82.78561494138685,8
0.2,5033,25,416685,82.7741358760429,7
0.2,5034,95,416780,82.77656405163853,6
0.2,5035,91,416871,82.77819698173154,11
0.2,5036,92,416963,82.78002779432202,9
0.2,5037,96,417059,82.78265184597062,6
0.2,5038,91,417150,82.78428259575313,10
0.2,5039,94,417244,82.78650793650793,7
0.2,5040,94,417338,82.78873239436619,7
0.2,5041,17,417355,82.77568425228084,16
0.2,5042,91,417446,82.77731509022408,11
0.2,5043,23,417469,82.76546391752578,10
0.2,5044,96,417565,82.76808721506443,6
0.2,5045,94,417659,82.77031311930241,7
0.2,5046,92,417751,82.77214186645531,9
0.2,5047,87,417838,82.7729793977813,14
0.2,5048,95,417933,82.77540106951872,7
0.2,5049,95,418028,82.77782178217822,7
0.2,5050,95,418123,82.78024153632944,6
0.2,5051,16,418139,82.76702296120348,16
0.2,5052,93,418232,82.76904809024342,8
0.2,5053,95,418327,82.77146814404432,8
0.2,5054,90,418417,82.77289812067261,11
0.2,5055,94,418511,82.77511867088607,7
0.2,5056,87,418598,82.77595412299783,14
0.2,5057,88,418686,82.77698695136418,13
0.2,5058,23,418709,82.7651709824076,10
0.2,5059,96,418805,82.76778656126483,6
0.2,5060,96,418901,82.77040110650069,6
0.2,5061,94,418995,82.77261951797709,7
0.2,5062,94,419089,82.77483705313055,7
0.2,5063,94,419183,82.77705371248025,7
0.2,5064,92,419275,82.77887462981244,9
0.2,5065,90,419365,82.78030003947887,11
0.2,5066,25,419390,82.76889678310637,8
0.2,5067,92,419482,82.7707182320442,10
0.2,5068,95,419577,82.7731307950286,7
0.2,5069,93,419670,82.77514792899409,9
0.2,5070,95,419765,82.7775586669296,7
0.2,5071,93,419858,82.77957413249212,8
0.2,5072,94,419952,82.78178592548788,7
0.2,5073,92,420044,82.7836026803311,10
0.2,5074,94,420138,82.78581280788177,7
0.2,5075,92,420230,82.78762805358551,9
0.2,5076,93,420323,82.7896395509159,8
0.2,5077,89,420412,82.79086254430878,12
0.2,5078,27,420439,82.77987792872612,6
0.2,5079,94,420533,82.78208661417322,7
0.2,5080,93,420626,82.78409761857903,8
0.2,5081,24,420650,82.77253049980322,9
0.2,5082,93,420743,82.77454259295692,9
0.2,5083,94,420837,82.77675059008655,8
0.2,5084,23,420860,82.76499508357915,10
0.2,5085,95,420955,82.7674007078254,6
0.2,5086,94,421049,82.76960880676234,7
0.2,5087,95,421144,82.77201257861635,6
0.2,5088,94,421238,82.7742189035174,7
0.2,5089,94,421332,82.77642436149313,7
0.2,5090,86,421418,82.77705755254371,15
0.2,5091,94,421512,82.77926158680283,8
0.2,5092,93,421605,82.7812684076183,8
0.2,5093,93,421698,82.78327444051826,8
0.2,5094,92,421790,82.78508341511285,9
0.2,5095,94,421884,82.787284144427,7
0.2,5096,92,421976,82.78909162252306,9
0.2,5097,93,422069,82.79109454688113,8
0.2,5098,20,422089,82.77878015297117,13
0.2,5099,90,422179,82.78019607843137,11
0.2,5100,88,422267,82.78121936875122,13
0.2,5101,93,422360,82.78322226577812,9
0.2,5102,95,422455,82.78561630413482,8
0.2,5103,93,422548,82.78761755485894,8
0.2,5104,94,422642,82.7898139079334,7
0.2,5105,96,422738,82.79240109674892,6
0.2,5106,92,422830,82.79420403367926,9
0.2,5107,92,422922,82.79600626468284,9
0.2,5108,91,423013,82.79761205715404,10
0.2,5109,91,423104,82.79921722113502,11
0.2,5110,95,423199,82.80160438270397,6
0.2,5111,22,423221,82.78971048513301,12
0.2,5112,-51,423170,82.76354390768628,14
0.2,5113,94,423264,82.7657411028549,7
0.2,5114,91,423355,82.76735092864125,10
0.2,5115,94,423449,82.76954652071932,7
0.2,5116,87,423536,82.7703732655853,14
0.2,5117,92,423628,82.77217663149668,9
0.2,5118,88,423716,82.77319789021293,14
0.2,5119,93,423809,82.7751953125,8
0.2,5120,94,423903,82.77738722905683,7
0.2,5121,92,423995,82.77918781725889,9
0.2,5122,27,424022,82.76829982432169,6
0.2,5123,94,424116,82.77049180327869,7
0.2,5124,95,424211,82.77287804878048,6
0.2,5125,90,424301,82.77428794381584,11
0.2,5126,96,424397,82.77686756387752,6
0.2,5127,93,424490,82.77886115444618,9
0.2,5128,96,424586,82.78143887697406,6
0.2,5129,93,424679,82.78343079922027,8
0.2,5130,93,424772,82.78542194503996,10
0.2,5131,96,424868,82.7879968823071,6
0.2,5132,93,424961,82.78998636275082,9
0.2,5133,87,425048,82.79080638878068,14
0.2,5134,22,425070,82.77896786757546,11
0.2,5135,93,425163,82.78095794392523,8
0.2,5136,96,425259,82.78353124391668,6
0.2,5137,90,425349,82.78493577267419,12
0.2,5138,92,425441,82.78672893559059,9
0.2,5139,26,425467,82.77568093385214,7
0.2,5140,95,425562,82.77805874343512,6
0.2,5141,93,425655,82.78004667444574,9
0.2,5142,92,425747,82.78183939335018,9
0.2,5143,96,425843,82.78440902021772,6
0.2,5144,95,425938,82.78678328474247,6
0.2,5145,88,426026,82.78779634667703,13
0.2,5146,91,426117,82.78939187876433,10
0.2,5147,93,426210,82.79137529137529,9
0.2,5148,92,426302,82.7931637211109,9
0.2,5149,90,426392,82.79456310679612,11
0.2,5150,96,426488,82.79712677150069,6
0.2,5151,92,426580,82.79891304347827,9
0.2,5152,90,426670,82.8003104987386,11
0.2,5153,88,426758,82.80131936360108,13
0.2,5154,92,426850,82.8031037827352,9
0.2,5155,94,426944,82.80527540729247,7
0.2,5156,94,427038,82.80744618964515,9
0.2,5157,95,427133,82.80981000387747,6
0.2,5158,95,427228,82.81217290172513,6
0.2,5159,94,427322,82.81434108527132,7
0.2,5160,92,427414,82.816120906801,9
0.2,5161,22,427436,82.80433940333204,11
0.2,5162,94,427530,82.80650784427658,7
0.2,5163,92,427622,82.80828814872191,9
0.2,5164,92,427714,82.81006776379478,9
0.2,5165,91,427805,82.81165311653116,10
0.2,5166,90,427895,82.81304431972131,11
0.2,5167,88,427983,82.81404798761609,13
0.2,5168,94,428077,82.81621203327529,7
0.2,5169,95,428172,82.81856866537717,7
0.2,5170,96,428268,82.82111777219106,6
0.2,5171,86,428354,82.82173240525908,15
0.2,5172,90,428444,82.82312004639475,11
0.2,5173,95,428539,82.82547352145342,6
0.2,5174,90,428629,82.82685990338165,11
0.2,5175,88,428717,82.82785935085008,13
0.2,5176,92,428809,82.82963106045973,9
0.2,5177,95,428904,82.83198146002317,6
0.2,5178,24,428928,82.82062174164896,9
0.2,5179,96,429024,82.82316602316602,6
0.2,5180,96,429120,82.8257093225246,6
0.2,5181,80,429200,82.8251640293323,21
0.2,5182,85,429285,82.82558363881921,16
0.2,5183,92,429377,82.82735339506173,9
0.2,5184,90,429467,82.82873674059788,11
0.2,5185,90,429557,82.83011955264173,11
0.2,5186,86,429643,82.83073067283594,15
0.2,5187,85,429728,82.83114880493446,16
0.2,5188,94,429822,82.83330121410677,7
0.2,5189,93,429915,82.83526011560694,8
0.2,5190,93,430008,82.83721826237719,8
0.2,5191,96,430104,82.83975346687211,6
0.2,5192,87,430191,82.84055459272098,14
0.2,5193,94,430285,82.84270311898344,7
0.2,5194,94,430379,82.84485081809432,9
0.2,5195,96,430475,82.84738260200155,6
0.2,5196,89,430564,82.84856648066192,12
0.2,5197,94,430658,82.85071181223547,7
0.2,5198,92,430750,82.85247162915945,9
0.2,5199,24,430774,82.84115384615384,9
0.2,5200,96,430870,82.84368390694097,6
0.2,5201,94,430964,82.84582852748943,9
0.2,5202,93,431057,82.8477801268499,8
0.2,5203,93,431150,82.84973097617218,8
0.2,5204,94,431244,82.85187319884726,8
0.2,5205,94,431338,82.85401459854015,7
0.2,5206,95,431433,82.85634722488957,6
0.2,5207,87,431520,82.85714285714286,14
0.2,5208,96,431616,82.85966596275676,7
0.2,5209,91,431707,82.86122840690979,10
0.2,5210,92,431799,82.8629821531376,10
0.2,5211,92,431891,82.86473522640061,9
0.2,5212,92,431983,82.86648762708613,9
0.2,5213,92,432075,82.86823935558112,9
0.2,5214,90,432165,82.86960690316396,11
0.2,5215,95,432260,82.87193251533742,7
0.2,5216,95,432355,82.87425723595936,6
0.2,5217,92,432447,82.87600613261786,9
0.2,5218,94,432541,82.87813757424794,7
0.2,5219,93,432634,82.88007662835248,9
0.2,5220,90,432724,82.88144033710017,12
0.2,5221,96,432820,82.88395250861738,6
0.2,5222,91,432911,82.88550641393834,11
0.2,5223,94,433005,82.88763399693721,7
0.2,5224,20,433025,82.8755980861244,13
0.2,5225,92,433117,82.87734404898583,9
0.2,5226,94,433211,82.87947197245073,7
0.2,5227,93,433304,82.8814078041316,8
0.2,5228,90,433394,82.8827691719258,11
0.2,5229,89,433483,82.88393881453155,12
0.2,5230,91,433574,82.88549034601415,11
0.2,5231,92,433666,82.88723241590215,10
0.2,5232,91,433757,82.88878272501434,10
0.2,5233,94,433851,82.89090561711883,7
0.2,5234,92,433943,82.89264565425025,9
0.2,5235,94,434037,82.89476699770817,7
0.2,5236,94,434131,82.89688753102922,7
0.2,5237,93,434224,82.89881634211531,8
0.2,5238,95,434319,82.90112616911624,6
0.2,5239,94,434413,82.90324427480915,7
0.2,5240,92,434505,82.90497996565541,9
0.2,5241,95,434600,82.9072872949256,6
0.2,5242,20,434620,82.89528895670418,15
0.2,5243,94,434714,82.89740655987795,7
0.2,5244,88,434802,82.89837940896092,13
0.2,5245,93,434895,82.90030499428136,9
0.2,5246,-48,434847,82.87535734705546,12
0.2,5247,94,434941,82.87747713414635,8
0.2,5248,92,435033,82.8792150885883,9
0.2,5249,88,435121,82.88019047619048,13
0.2,5250,94,435215,82.88230813178443,7
0.2,5251,92,435307,82.88404417364814,9
0.2,5252,95,435402,82.88635065676756,7
0.2,5253,94,435496,82.88846593071945,8
0.2,5254,93,435589,82.89039010466223,8
0.2,5255,24,435613,82.87918569254185,8
0.2,5256,95,435708,82.8814913448735,6
0.2,5257,93,435801,82.88341574743248,8
0.2,5258,24,435825,82.87221905305191,9
0.2,5259,95,435920,82.8745247148289,6
0.2,5260,22,435942,82.86295381106254,11
0.2,5261,90,436032,82.8643101482326,11
0.2,5262,95,436127,82.86661599847996,6
0.2,5263,95,436222,82.86892097264437,6
0.2,5264,92,436314,82.87065527065528,9
0.2,5265,93,436407,82.87257880744399,8
0.2,5266,85,436492,82.87298272261249,16
0.2,5267,90,436582,82.87433561123765,11
0.2,5268,92,436674,82.87606756500284,11
0.2,5269,92,436766,82.87779886148007,9
0.2,5270,92,436858,82.87952950104345,9
0.2,5271,96,436954,82.88201820940819,6
0.2,5272,95,437049,82.88431632846577,7
0.2,5273,93,437142,82.88623435722411,8
0.2,5274,91,437233,82.88777251184834,10
0.2,5275,88,437321,82.88874147081123,13
0.2,5276,91,437412,82.89027856736783,10
0.2,5277,90,437502,82.89162561576354,11
0.2,5278,94,437596,82.89372987308202,7
0.2,5279,91,437687,82.89526515151515,12
0.2,5280,93,437780,82.89717856466578,9
0.2,5281,83,437863,82.89719803104884,18
0.2,5282,91,437954,82.89873178118494,10
0.2,5283,93,438047,82.90064345193035,10
0.2,5284,93,438140,82.90255439924314,11
0.2,5285,94,438234,82.90465380249717,7
0.2,5286,94,438328,82.90675241157557,7
0.2,5287,95,438423,82.90903933434191,6
0.2,5288,92,438515,82.91075817734921,9
0.2,5289,92,438607,82.91247637051039,9
0.2,5290,92,438699,82.91419391419392,10
0.2,5291,18,438717,82.90192743764172,15
0.2,5292,95,438812,82.9042131116569,6
0.2,5293,94,438906,82.90630902908954,7
0.2,5294,91,438997,82.90783758262512,10
0.2,5295,95,439092,82.91012084592145,6
0.2,5296,90,439182,82.9114593165943,11
0.2,5297,91,439273,82.91298603246508,10
0.2,5298,94,439367,82.91507831666353,7
0.2,5299,91,439458,82.91660377358491,10
0.2,5300,95,439553,82.91888322957932,6
0.2,5301,91,439644,82.92040739343643,10
0.2,5302,27,439671,82.90986234207053,6
0.2,5303,94,439765,82.9119532428356,7
0.2,5304,94,439859,82.91404335532516,7
0.2,5305,90,439949,82.91537881643423,11
0.2,5306,92,440041,82.91709063501037,9
0.2,5307,95,440136,82.91936699321778,6
0.2,5308,92,440228,82.92107741570918,9
0.2,5309,94,440322,82.9231638418079,8
0.2,5310,88,440410,82.92411975145923,13
0.2,5311,79,440489,82.92338102409639,22
0.2,5312,96,440585,82.92584227366837,7
0.2,5313,92,440677,82.9275498682725,9
0.2,5314,92,440769,82.92925682031985,9
0.2,5315,95,440864,82.93152746425883,6
0.2,5316,96,440960,82.93398533007336,7
0.2,5317,21,440981,82.92233922527267,12
0.2,5318,95,441076,82.92460988907689,6
0.2,5319,93,441169,82.9265037593985,8
0.2,5320,93,441262,82.92839691787258,8
0.2,5321,92,441354,82.93010146561443,9
0.2,5322,93,441447,82.93199323689649,8
0.2,5323,93,441540,82.93388429752066,9
0.2,5324,95,441635,82.93615023474179,6
0.2,5325,91,441726,82.93766428839655,10
0.2,5326,86,441812,82.93823915900131,15
0.2,5327,94,441906,82.94031531531532,7
0.2,5328,17,441923,82.9279414524301,16
0.2,5329,88,442011,82.92889305816135,13
0.2,5330,25,442036,82.91802663665354,8
0.2,5331,91,442127,82.9195423855964,10
0.2,5332,25,442152,82.90868179261204,8
0.2,5333,95,442247,82.91094863142108,6
0.2,5334,95,442342,82.91321462043112,7
0.2,5335,93,442435,82.91510494752623,8
0.2,5336,23,442458,82.90387858347385,11
0.2,5337,91,442549,82.90539527913076,10
0.2,5338,95,442644,82.90766061060124,8
0.2,5339,94,442738,82.90973782771536,7
0.2,5340,87,442825,82.91050365100169,14
0.2,5341,86,442911,82.91108199176338,15
0.2,5342,88,442999,82.91203443758188,13
0.2,5343,94,443093,82.91410928143712,8
0.2,5344,90,443183,82.91543498596819,11
0.2,5345,95,443278,82.91769547325103,6
0.2,5346,92,443370,82.91939405273986,9
0.2,5347,93,443463,82.9212789827973,9
0.2,5348,93,443556,82.92316320807628,8
0.2,5349,20,443576,82.91140186915888,13
0.2,5350,95,443671,82.9136609979443,7
0.2,5351,23,443694,82.902466367713,10
0.2,5352,96,443790,82.90491313282271,6
0.2,5353,93,443883,82.90679865521106,8
0.2,5354,95,443978,82.90905695611578,6
0.2,5355,90,444068,82.91038088125467,12
0.2,5356,94,444162,82.9124509986933,7
0.2,5357,90,444252,82.91377379619261,11
0.2,5358,94,444346,82.91584250793058,7
0.2,5359,95,444441,82.91809701492538,6
0.2,5360,95,444536,82.92035068084313,6
0.2,5361,95,444631,82.92260350615442,6
0.2,5362,91,444722,82.9241096401268,10
0.2,5363,89,444811,82.92524235645041,12
0.2,5364,91,444902,82.92674743709226,10
0.2,5365,96,444998,82.9291837495341,6
0.2,5366,94,445092,82.93124650642817,7
0.2,5367,95,445187,82.93349478390462,8
0.2,5368,-50,445137,82.90873533246415,13
0.2,5369,89,445226,82.9098696461825,12
0.2,5370,93,445319,82.91174827778812,8
0.2,5371,91,445410,82.9132539091586,11
0.2,5372,91,445501,82.91475898008561,11
0.2,5373,92,445593,82.91644957201339,9
0.2,5374,23,445616,82.90530232558139,9
0.2,5375,92,445708,82.90699404761905,9
0.2,5376,91,445799,82.9084991631021,10
0.2,5377,93,445892,82.91037560431387,8
0.2,5378,-46,445846,82.88641011340398,10
0.2,5379,85,445931,82.8868029739777,16
0.2,5380,95,446026,82.88905407916744,7
0.2,5381,94,446120,82.89111854329245,7
0.2,5382,96,446216,82.89355378041984,6
0.2,5383,91,446307,82.89505943536405,14
0.2,5384,91,446398,82.89656453110491,10
0.2,5385,95,446493,82.89881173412552,7
0.2,5386,95,446588,82.90105810284017,7
0.2,5387,89,446677,82.90219005196734,12
0.2,5388,92,446769,82.90387827055112,9
0.2,5389,95,446864,82.90612244897959,6
0.2,5390,96,446960,82.90855128918568,6
0.2,5391,94,447054,82.91060830860535,7
0.2,5392,27,447081,82.90024105321713,6
0.2,5393,95,447176,82.90248424175009,8
0.2,5394,92,447268,82.90417052826692,9
0.2,5395,92,447360,82.9058561897702,9
0.2,5396,93,447453,82.9077265147304,8
0.2,5397,91,447544,82.90922563912561,10
0.2,5398,20,447564,82.89757362474532,13
0.2,5399,89,447653,82.8987037037037,12
0.2,5400,92,447745,82.90038881688577,9
0.2,5401,91,447836,82.90188818955943,10
0.2,5402,96,447932,82.90431241902647,6
0.2,5403,95,448027,82.90655070318283,8
0.2,5404,95,448122,82.90878815911194,7
0.2,5405,94,448216,82.91083980762116,8
0.2,5406,92,448308,82.91252080636212,9
0.2,5407,94,448402,82.91457100591715,7
0.2,5408,95,448497,82.91680532445923,6
0.2,5409,95,448592,82.91903881700554,6
0.2,5410,94,448686,82.92108667529108,8
0.2,5411,95,448781,82.92331855136733,6
0.2,5412,95,448876,82.92554960280806,6
0.2,5413,91,448967,82.92704100480236,10
0.2,5414,94,449061,82.92908587257618,7
0.2,5415,93,449154,82.93094534711965,8
0.2,5416,27,449181,82.92062026952188,6
0.2,5417,94,449275,82.92266519010705,7
0.2,5418,19,449294,82.91086916405241,14
0.2,5419,96,449390,82.91328413284133,6
0.2,5420,92,449482,82.91496033942077,9
0.2,5421,22,449504,82.90372556252305,10
0.2,5422,95,449599,82.90595611285266,6
0.2,5423,96,449695,82.90837020648968,6
0.2,5424,93,449788,82.91023041474655,9
0.2,5425,91,449879,82.91172134168816,14
0.2,5426,87,449966,82.91247466371844,14
0.2,5427,93,450059,82.91433308769344,9
0.2,5428,87,450146,82.9150856511328,14
0.2,5429,91,450237,82.91657458563536,10
0.2,5430,82,450319,82.91640581844965,19
0.2,5431,19,450338,82.90463917525773,14
0.2,5432,95,450433,82.90686545186821,6
0.2,5433,94,450527,82.9089068825911,7
0.2,5434,90,450617,82.91021159153634,11
0.2,5435,93,450710,82.9120676968359,8
0.2,5436,94,450804,82.91410704432592,8
0.2,5437,94,450898,82.91614564178006,7
0.2,5438,91,450989,82.91763191763192,10
0.2,5439,86,451075,82.91819852941177,16
0.2,5440,91,451166,82.9196838816394,10
0.2,5441,92,451258,82.92135244395443,9
0.2,5442,95,451353,82.92357155980157,6
0.2,5443,92,451445,82.92523879500368,9
0.2,5444,95,451540,82.92745638200184,6
0.2,5445,95,451635,82.92967315460889,6
0.2,5446,94,451729,82.9317055259776,7
0.2,5447,93,451822,82.93355359765052,8
0.2,5448,95,451917,82.93576803083134,6
0.2,5449,94,452011,82.93779816513762,7
0.2,5450,95,452106,82.94001100715465,6
0.2,5451,95,452201,82.94222303741746,6
0.2,5452,92,452293,82.94388410049514,9
0.2,5453,25,452318,82.93325999266594,9
0.2,5454,90,452408,82.93455545371219,11
0.2,5455,92,452500,82.93621700879766,9
0.2,5456,96,452596,82.93861095840205,6
0.2,5457,23,452619,82.92762916819348,9
0.2,5458,94,452713,82.92965744641876,7
0.2,5459,96,452809,82.93205128205128,6
0.2,5460,89,452898,82.93316242446438,13
0.2,5461,85,452983,82.93354082753571,16
0.2,5462,88,453071,82.93446824089328,13
0.2,5463,93,453164,82.93631039531479,8
0.2,5464,94,453258,82.93833485818847,7
0.2,5465,90,453348,82.93962678375412,11
0.2,5466,94,453442,82.94164989939638,7
0.2,5467,94,453536,82.94367227505487,9
0.2,5468,91,453627,82.94514536478333,10
0.2,5469,92,453719,82.94680073126142,9
0.2,5470,96,453815,82.94918662036191,6
0.2,5471,93,453908,82.95102339181287,8
0.2,5472,91,453999,82.95249406175772,10
0.2,5473,90,454089,82.95378151260505,11
0.2,5474,26,454115,82.94337899543379,7
0.2,5475,95,454210,82.94558071585098,6
0.2,5476,93,454303,82.94741646886982,9
0.2,5477,87,454390,82.94815626140927,14
0.2,5478,91,454481,82.94962584413214,10
0.2,5479,94,454575,82.95164233576642,7
0.2,5480,94,454669,82.95365809158912,8
0.2,5481,95,454764,82.95585552717986,7
0.2,5482,11,454775,82.94273208097756,21
0.2,5483,94,454869,82.94474835886214,7
0.2,5484,26,454895,82.93436645396535,6
0.2,5485,94,454989,82.93638352169158,7
0.2,5486,25,455014,82.92582467650811,8
0.2,5487,94,455108,82.92784256559767,7
0.2,5488,27,455135,82.91765348879578,6
0.2,5489,93,455228,82.91948998178506,8
0.2,5490,19,455247,82.90784920779457,14
0.2,5491,93,455340,82.90968681718864,9
0.2,5492,95,455435,82.91188785727289,7
0.2,5493,27,455462,82.90171095740808,6
0.2,5494,20,455482,82.89026387625114,13
0.2,5495,93,455575,82.89210334788937,10
0.2,5496,90,455665,82.89339639803529,11
0.2,5497,94,455759,82.8954165150964,7
0.2,5498,95,455854,82.89761774868158,7
0.2,5499,85,455939,82.898,16
0.2,5500,94,456033,82.900018178513,9
0.2,5501,96,456129,82.90239912758997,6
0.2,5502,92,456221,82.90405233508996,9
0.2,5503,19,456240,82.89244186046511,15
0.2,5504,93,456333,82.89427792915531,8
0.2,5505,88,456421,82.89520523065747,14
0.2,5506,95,456516,82.89740330488469,6
0.2,5507,95,456611,82.89960058097313,6
0.2,5508,92,456703,82.90125249591577,9
0.2,5509,93,456796,82.90308529945554,8
0.2,5510,93,456889,82.90491743785157,9
0.2,5511,95,456984,82.90711175616836,6
0.2,5512,94,457078,82.90912388898965,7
0.2,5513,96,457174,82.91149800507799,6
0.2,5514,94,457268,82.91350861287398,8
0.2,5515,94,457362,82.91551849166062,7
0.2,5516,87,457449,82.91625883632409,14
0.2,5517,92,457541,82.91790503805727,9
0.2,5518,94,457635,82.91991302772242,7
0.2,5519,96,457731,82.92228260869565,6
0.2,5520,91,457822,82.92374569824307,10
0.2,5521,92,457914,82.92538935168417,9
0.2,5522,20,457934,82.91399601665762,13
0.2,5523,94,458028,82.91600289645184,8
0.2,5524,94,458122,82.91800904977376,7
0.2,5525,94,458216,82.92001447701773,7
0.2,5526,96,458312,82.92238103853809,6
0.2,5527,23,458335,82.91154124457309,10
0.2,5528,91,458426,82.91300415988425,10
0.2,5529,91,458517,82.91446654611211,10
0.2,5530,96,458613,82.91683239920448,7
0.2,5531,92,458705,82.91847433116413,9
0.2,5532,96,458801,82.92083860473522,6
0.2,5533,88,458889,82.92175641488977,13
0.2,5534,95,458984,82.92393857271907,7
0.2,5535,90,459074,82.92521676300578,11
0.2,5536,92,459166,82.92685569803143,9
0.2,5537,94,459260,82.92885518237631,8
0.2,5538,90,459350,82.93013179274237,12
0.2,5539,89,459439,82.93122743682311,12
0.2,5540,88,459527,82.932142212597,14
0.2,5541,27,459554,82.9220498015157,6
0.2,5542,93,459647,82.9238679415479,8
0.2,5543,83,459730,82.92388167388168,18
0.2,5544,93,459823,82.92569882777276,9
0.2,5545,94,459917,82.92769563649478,7
0.2,5546,93,460010,82.92951144762935,8
0.2,5547,94,460104,82.93150684931507,7
0.2,5548,94,460198,82.93350153180754,7
0.2,5549,95,460293,82.93567567567568,6
0.2,5550,92,460385,82.9373085930463,10
0.2,5551,90,460475,82.93858069164266,11
0.2,5552,88,460563,82.93949216639655,13
0.2,5553,95,460658,82.94166366582643,7
0.2,5554,93,460751,82.94347434743474,8
0.2,5555,92,460843,82.94510439164867,9
0.2,5556,95,460938,82.94727370883571,7
0.2,5557,90,461028,82.94854264123785,11
0.2,5558,92,461120,82.9501708940457,9
0.2,5559,90,461210,82.95143884892086,11
0.2,5560,94,461304,82.95342564286999,7
0.2,5561,-50,461254,82.92952175476448,14
0.2,5562,92,461346,82.931152255977,9
0.2,5563,89,461435,82.9322429906542,12
0.2,5564,90,461525,82.93351302785265,11
0.2,5565,91,461616,82.93496227093065,10
0.2,5566,88,461704,82.93587210346686,13
0.2,5567,93,461797,82.93767959770115,8
0.2,5568,93,461890,82.9394864428084,8
0.2,5569,94,461984,82.94147217235188,7
0.2,5570,90,462074,82.94273918506552,11
0.2,5571,91,462165,82.94418521177315,11
0.2,5572,25,462190,82.93378790597524,8
0.2,5573,82,462272,82.93362038033727,19
0.2,5574,88,462360,82.93452914798206,13
0.2,5575,85,462445,82.93489956958393,16
0.2,5576,89,462534,82.93598708983325,12
0.2,5577,88,462622,82.93689494442452,13
0.2,5578,92,462714,82.93851944792974,11
0.2,5579,95,462809,82.94068100358423,6
0.2,5580,96,462905,82.94302096398495,6
0.2,5581,26,462931,82.9328197778574,8
0.2,5582,95,463026,82.93498119290705,7
0.2,5583,96,463122,82.93732091690545,6
0.2,5584,95,463217,82.93948075201432,7
0.2,5585,92,463309,82.94110275689223,9
0.2,5586,95,463404,82.94326114193665,6
0.2,5587,93,463497,82.94506084466714,9
0.2,5588,93,463590,82.94685990338164,8
0.2,5589,91,463681,82.94830053667263,10
0.2,5590,91,463772,82.9497406546235,11
0.2,5591,95,463867,82.951895565093,6
0.2,5592,93,463960,82.95369211514392,8
0.2,5593,90,464050,82.95495173400072,11
0.2,5594,96,464146,82.95728328865059,6
0.2,5595,95,464241,82.95943531093639,6
0.2,5596,94,464335,82.96140789708772,7
0.2,5597,92,464427,82.96302250803859,9
0.2,5598,23,464450,82.95231291302018,12
0.2,5599,95,464545,82.95446428571428,7
0.2,5600,90,464635,82.95572219246563,11
0.2,5601,92,464727,82.95733666547662,10
0.2,5602,92,464819,82.95895056219882,9
0.2,5603,90,464909,82.96020699500357,11
0.2,5604,94,465003,82.96217662801071,7
0.2,5605,90,465093,82.9634320371031,11
0.2,5606,95,465188,82.96557874085964,8
0.2,5607,92,465280,82.96718972895863,9
0.2,5608,93,465373,82.96897842752719,8
0.2,5609,94,465467,82.97094474153297,7
0.2,5610,91,465558,82.97237569060773,10
0.2,5611,89,465647,82.97344975053457,13
0.2,5612,94,465741,82.97541421699626,7
0.2,5613,94,465835,82.9773779836124,7
0.2,5614,93,465928,82.97916295636688,8
0.2,5615,95,466023,82.98130341880342,6
0.2,5616,94,466117,82.98326508812534,7
0.2,5617,93,466210,82.98504805980777,9
0.2,5618,94,466304,82.98700836447766,8
0.2,5619,89,466393,82.98807829181494,12
0.2,5620,27,466420,82.97811777263833,6
0.2,5621,93,466513,82.97990039131982,8
0.2,5622,91,466604,82.98132669393563,10
0.2,5623,87,466691,82.9820412517781,14
0.2,5624,91,466782,82.98346666666667,10
0.2,5625,93,466875,82.98524706718806,8
0.2,5626,91,466966,82.9866714057224,10
0.2,5627,92,467058,82.98827292110875,10
0.2,5628,95,467153,82.9904068218156,6
0.2,5629,95,467248,82.99253996447602,6
0.2,5630,89,467337,82.99360681939265,12
0.2,5631,92,467429,82.9952059659091,9
0.2,5632,95,467524,82.99733712053968,6
0.2,5633,93,467617,82.99911253106141,8
0.2,5634,91,467708,83.00053238686779,10
0.2,5635,90,467798,83.00177430801988,11
0.2,5636,96,467894,83.0040801844953,6
0.2,5637,92,467986,83.0056757715502,9
0.2,5638,93,468079,83.00744812910091,9
0.2,5639,92,468171,83.00904255319149,9
0.2,5640,94,468265,83.01099095904982,7
0.2,5641,88,468353,83.01187522155264,13
0.2,5642,94,468447,83.01382243487507,8
0.2,5643,95,468542,83.01594613749114,6
0.2,5644,92,468634,83.01753764393268,9
0.2,5645,95,468729,83.01965993623804,6
0.2,5646,91,468820,83.0210731361785,10
0.2,5647,74,468894,83.01947592067988,27
0.2,5648,90,468984,83.02071163037706,14
0.2,5649,93,469077,83.0224778761062,8
0.2,5650,95,469172,83.02459741638648,6
0.2,5651,24,469196,83.0141542816702,9
0.2,5652,93,469289,83.01592075004423,9
0.2,5653,90,469379,83.01715599575522,11
0.2,5654,89,469468,83.0182139699381,12
0.2,5655,88,469556,83.01909476661952,13
0.2,5656,94,469650,83.02103588474456,9
0.2,5657,94,469744,83.02297631671969,7
0.2,5658,94,469838,83.02491606290864,7
0.2,5659,91,469929,83.02632508833922,10
0.2,5660,96,470025,83.02861685214626,6
0.2,5661,-49,469976,83.00529848110209,13
0.2,5662,93,470069,83.00706339396079,8
0.2,5663,90,470159,83.00829802259886,12
0.2,5664,93,470252,83.01006178287732,8
0.2,5665,82,470334,83.00988351570773,19
0.2,5666,88,470422,83.0107640727016,14
0.2,5667,94,470516,83.01270289343684,8
0.2,5668,95,470611,83.01481742811784,6
0.2,5669,93,470704,83.01657848324515,8
0.2,5670,93,470797,83.01833891729854,9
0.2,5671,84,470881,83.0185119887165,17
0.2,5672,88,470969,83.019390093425,13
0.2,5673,87,471056,83.02009164610504,14
0.2,5674,93,471149,83.02185022026431,9
0.2,5675,94,471243,83.0237843551797,8
0.2,5676,93,471336,83.0255416593271,8
0.2,5677,95,471431,83.02765058119056,7
0.2,5678,94,471525,83.0295826730058,7
0.2,5679,92,471617,83.03116197183098,9
0.2,5680,96,471713,83.03344481605352,6
0.2,5681,94,471807,83.03537486800423,7
0.2,5682,92,471899,83.0369523139187,9
0.2,5683,92,471991,83.03852920478536,9
0.2,5684,95,472086,83.04063324538258,7
0.2,5685,90,472176,83.04185719310587,11
0.2,5686,18,472194,83.03042025672586,16
0.2,5687,92,472286,83.03199718706048,9
0.2,5688,95,472381,83.03410089646687,7
0.2,5689,94,472475,83.0360281195079,7
0.2,5690,93,472568,83.03777894921807,10
0.2,5691,95,472663,83.03988053408293,7
0.2,5692,85,472748,83.04022483751976,16
0.2,5693,94,472842,83.04214963119072,8
0.2,5694,25,472867,83.03195785776997,8
0.2,5695,92,472959,83.03353230337079,10
0.2,5696,90,473049,83.0347551342812,11
0.2,5697,92,473141,83.03632853632854,10
0.2,5698,94,473235,83.03825232496929,7
0.2,5699,94,473329,83.04017543859649,7
0.2,5700,22,473351,83.02946851429574,11
0.2,5701,19,473370,83.01823921431077,14
0.2,5702,24,473394,83.0078905839032,8
0.2,5703,94,473488,83.00981767180926,8
0.2,5704,94,473582,83.01174408413672,7
0.2,5705,88,473670,83.01261829652996,13
0.2,5706,93,473763,83.0143683196075,8
0.2,5707,87,473850,83.01506657323056,14
0.2,5708,92,473942,83.01664039236293,9
0.2,5709,95,474037,83.01873905429072,6
0.2,5710,95,474132,83.02083698126422,6
0.2,5711,96,474228,83.02310924369748,6
0.2,5712,94,474322,83.02503063189218,7
0.2,5713,92,474414,83.0266013300665,9
0.2,5714,93,474507,83.02834645669292,8
0.2,5715,96,474603,83.03061581525543,6
0.2,5716,94,474697,83.0325345460906,7
0.2,5717,94,474791,83.03445260580622,7
0.2,5718,91,474882,83.03584542752229,10
0.2,5719,84,474966,83.03601398601398,18
0.2,5720,92,475058,83.03758084251005,9
0.2,5721,27,475085,83.02778748689269,6
0.2,5722,93,475178,83.02952996680062,8
0.2,5723,90,475268,83.03074772886093,11
0.2,5724,96,475364,83.03301310043668,6
0.2,5725,17,475381,83.02148096402375,15
0.2,5726,91,475472,83.02287410511612,10
0.2,5727,93,475565,83.02461592178771,8
0.2,5728,94,475659,83.02653168092162,8
0.2,5729,94,475753,83.02844677137871,7
0.2,5730,84,475837,83.0286162973303,17
0.2,5731,92,475929,83.03018143754362,9
0.2,5732,94,476023,83.03209488923774,7
0.2,5733,94,476117,83.03400767352633,7
0.2,5734,92,476209,83.0355710549259,9
0.2,5735,96,476305,83.03783124128313,7
0.2,5736,96,476401,83.04009063970716,6
0.2,5737,93,476494,83.04182642035552,8
0.2,5738,92,476586,83.04338734971249,10
0.2,5739,-47,476539,83.02073170731707,11
0.2,5740,94,476633,83.0226441386518,8
0.2,5741,92,476725,83.02420759317312,9
0.2,5742,95,476820,83.02629287828661,6
0.2,5743,90,476910,83.0275069637883,11
0.2,5744,23,476933,83.01705831157528,10
0.2,5745,82,477015,83.01688130873652,19
0.2,5746,96,477111,83.01914042108926,6
0.2,5747,95,477206,83.02122477383438,7
0.2,5748,94,477300,83.02313445816664,8
0.2,5749,93,477393,83.02486956521739,8
0.2,5750,92,477485,83.0264301860546,9
0.2,5751,95,477580,83.02851182197496,6
0.2,5752,93,477673,83.03024508951852,10
0.2,5753,91,477764,83.0316301703163,10
0.2,5754,26,477790,83.02172024326673,8
0.2,5755,94,477884,83.02362751911049,7
0.2,5756,93,477977,83.02536043077993,8
0.2,5757,91,478068,83.02674539770754,10
0.2,5758,93,478161,83.02847716617468,8
0.2,5759,90,478251,83.0296875,11
0.2,5760,95,478346,83.0317653185211,7
0.2,5761,92,478438,83.03332176327665,10
0.2,5762,85,478523,83.03366302273122,16
0.2,5763,95,478618,83.03573907009022,7
0.2,5764,90,478708,83.03694709453599,12
0.2,5765,94,478802,83.03884842178286,9
0.2,5766,94,478896,83.040749089648,7
0.2,5767,87,478983,83.04143550624133,14
0.2,5768,93,479076,83.04316172646907,8
0.2,5769,96,479172,83.04540727902946,6
0.2,5770,93,479265,83.04713221278809,8
0.2,5771,92,479357,83.0486832986833,9
0.2,5772,21,479378,83.0379352156591,11
0.2,5773,94,479472,83.03983373744371,7
0.2,5774,23,479495,83.02943722943724,10
0.2,5775,84,479579,83.02960526315789,17
0.2,5776,94,479673,83.03150424095551,7
0.2,5777,93,479766,83.03322949117342,8
0.2,5778,20,479786,83.02232220107285,14
0.2,5779,84,479870,83.02249134948097,17
0.2,5780,94,479964,83.02439024390245,7
0.2,5781,90,480054,83.0255966793497,11
0.2,5782,93,480147,83.0273214594501,8
0.2,5783,24,480171,83.01711618257261,8
0.2,5784,95,480266,83.01918755401901,6
0.2,5785,25,480291,83.00916004147943,8
0.2,5786,93,480384,83.01088646967341,9
0.2,5787,91,480475,83.01226675881134,10
0.2,5788,95,480570,83.01433753670754,7
0.2,5789,91,480661,83.01571675302245,10
0.2,5790,91,480752,83.0170954930064,11
0.2,5791,89,480841,83.01812845303867,13
0.2,5792,96,480937,83.02036941135853,6
0.2,5793,93,481030,83.02209181912323,8
0.2,5794,92,481122,83.02364106988783,9
0.2,5795,96,481218,83.02587991718427,7
0.2,5796,93,481311,83.02760048300846,9
0.2,5797,93,481404,83.02932045532943,8
0.2,5798,94,481498,83.03121227797897,7
0.2,5799,26,481524,83.02137931034483,7
0.2,5800,93,481617,83.02309946560938,8
0.2,5801,90,481707,83.02430196483971,11
0.2,5802,92,481799,83.02584869894882,9
0.2,5803,90,481889,83.02705031013095,11
0.2,5804,90,481979,83.02825150732127,11
0.2,5805,88,482067,83.02910781949707,14
0.2,5806,94,482161,83.0309970724987,8
0.2,5807,91,482252,83.03236914600551,10
0.2,5808,96,482348,83.03460148046135,6
0.2,5809,93,482441,83.03631669535284,8
0.2,5810,94,482535,83.03820340733093,7
0.2,5811,89,482624,83.03922918100481,12
0.2,5812,91,482715,83.04059865817995,10
0.2,5813,83,482798,83.0405916752666,18
0.2,5814,96,482894,83.04282029234737,6
0.2,5815,16,482910,83.03129298486932,17
0.2,5816,88,482998,83.03214715489084,13
0.2,5817,25,483023,83.02217256789275,8
0.2,5818,95,483118,83.0242309675202,6
0.2,5819,92,483210,83.02577319587628,9
0.2,5820,94,483304,83.02765847792476,7
0.2,5821,94,483398,83.02954311233253,7
0.2,5822,90,483488,83.03074016829812,11
0.2,5823,93,483581,83.03245192307692,8
0.2,5824,94,483675,83.0343347639485,7
0.2,5825,84,483759,83.03450051493306,17
0.2,5826,96,483855,83.03672558778102,6
0.2,5827,95,483950,83.03877831159917,6
0.2,5828,94,484044,83.04065877509007,8
0.2,5829,94,484138,83.04253859348199,8
0.2,5830,94,484232,83.04441776710684,7
0.2,5831,93,484325,83.04612482853224,8
0.2,5832,88,484413,83.04697411280645,14
0.2,5833,24,484437,83.03685293109359,11
0.2,5834,92,484529,83.03838903170522,9
0.2,5835,94,484623,83.04026730637423,7
0.2,5836,93,484716,83.04197361658386,8
0.2,5837,96,484812,83.04419321685509,6
0.2,5838,96,484908,83.04641205685905,6
0.2,5839,22,484930,83.03595890410959,11
0.2,5840,95,485025,83.03800719054956,6
0.2,5841,94,485119,83.03988360150633,7
0.2,5842,92,485211,83.04141708026698,9
0.2,5843,25,485236,83.03148528405202,8
0.2,5844,88,485324,83.03233532934132,14
0.2,5845,90,485414,83.03352719808416,11
0.2,5846,94,485508,83.03540277065161,7
0.2,5847,94,485602,83.03727770177838,7
0.2,5848,91,485693,83.03863908360404,10
0.2,5849,92,485785,83.04017094017094,9
0.2,5850,88,485873,83.04101862929414,13
0.2,5851,91,485964,83.04237867395761,10
0.2,5852,91,486055,83.0437382538869,10
0.2,5853,92,486147,83.04526819268877,9
0.2,5854,91,486238,83.0466268146883,10
0.2,5855,94,486332,83.04849726775956,7
0.2,5856,95,486427,83.05053781799556,6
0.2,5857,24,486451,83.04045749402526,11
0.2,5858,92,486543,83.04198668714798,9
0.2,5859,-47,486496,83.019795221843,11
0.2,5860,95,486591,83.02183927657396,7
0.2,5861,94,486685,83.0237120436711,7
0.2,5862,90,486775,83.02490192734095,11
0.2,5863,90,486865,83.02609140518418,11
0.2,5864,94,486959,83.02796248934357,9
0.2,5865,94,487053,83.02983293556086,7
0.2,5866,94,487147,83.03170274416226,7
0.2,5867,96,487243,83.03391274710293,6
0.2,5868,93,487336,83.03561083659908,8
0.2,5869,82,487418,83.03543441226576,19
0.2,5870,88,487506,83.03628002043945,13
0.2,5871,89,487595,83.03729564032697,13
0.2,5872,15,487610,83.02571088029967,17
0.2,5873,94,487704,83.02757916241062,7
0.2,5874,96,487800,83.02978723404256,6
0.2,5875,95,487895,83.03182437031994,6
0.2,5876,91,487986,83.03318019397652,11
0.2,5877,78,488064,83.03232391970057,23
0.2,5878,90,488154,83.0335091001871,11
0.2,5879,82,488236,83.03333333333333,19
0.2,5880,95,488331,83.03536813467097,6
0.2,5881,96,488427,83.03757225433526,6
0.2,5882,89,488516,83.03858575556688,12
0.2,5883,94,488610,83.04044867437118,7
0.2,5884,89,488699,83.04146134239592,12
0.2,5885,92,488791,83.0429833503228,10
0.2,5886,90,488881,83.04416510956345,11
0.2,5887,94,488975,83.04602581521739,8
0.2,5888,93,489068,83.04771608082866,8
0.2,5889,92,489160,83.04923599320882,9
0.2,5890,92,489252,83.05075538957732,9
0.2,5891,85,489337,83.0510862186015,16
0.2,5892,-47,489290,83.02901747836417,10
0.2,5893,85,489375,83.02935188327112,16
0.2,5894,91,489466,83.03070398642917,10
0.2,5895,93,489559,83.03239484396201,9
0.2,5896,95,489654,83.034424283534,7
0.2,5897,81,489735,83.03407934893184,20
0.2,5898,94,489829,83.0359382946262,8
0.2,5899,93,489922,83.03762711864407,8
0.2,5900,93,490015,83.03931537027623,8
0.2,5901,88,490103,83.04015587936293,13
0.2,5902,94,490197,83.04201253599865,7
0.2,5903,92,490289,83.0435298102981,9
0.2,5904,89,490378,83.04453852667231,12
0.2,5905,23,490401,83.03437182526244,9
0.2,5906,93,490494,83.03605891315388,8
0.2,5907,93,490587,83.03774542992552,8
0.2,5908,95,490682,83.03976984261297,7
0.2,5909,94,490776,83.04162436548224,8
0.2,5910,92,490868,83.0431399086449,9
0.2,5911,95,490963,83.04516238159675,6
0.2,5912,79,491042,83.04447826822256,23
0.2,5913,90,491132,83.04565437943862,11
0.2,5914,94,491226,83.04750633981403,7
0.2,5915,95,491321,83.04952670723462,7
0.2,5916,93,491414,83.05120838262633,8
0.2,5917,92,491506,83.05272051368706,10
0.2,5918,94,491600,83.05457002872107,7
0.2,5919,94,491694,83.05641891891892,7
0.2,5920,92,491786,83.05792940381693,10
0.2,5921,92,491878,83.05943937858831,9
0.2,5922,89,491967,83.06044234340706,12
0.2,5923,-48,491919,83.03831870357867,13
0.2,5924,92,492011,83.0398312236287,9
0.2,5925,94,492105,83.04168072899088,7
0.2,5926,93,492198,83.04336089083854,10
0.2,5927,89,492287,83.0443657219973,12
0.2,5928,94,492381,83.04621352673301,7
0.2,5929,91,492472,83.04755480607082,10
0.2,5930,91,492563,83.04889563311414,10
0.2,5931,94,492657,83.05074173971678,7
0.2,5932,94,492751,83.05258722400134,7
0.2,5933,89,492840,83.0535894843276,12
0.2,5934,94,492934,83.05543386689132,9
0.2,5935,95,493029,83.05744609164421,6
0.2,5936,90,493119,83.05861546235472,11
0.2,5937,86,493205,83.05911081172111,16
0.2,5938,90,493295,83.06027950833473,11
0.2,5939,93,493388,83.06195286195286,10
0.2,5940,94,493482,83.06379397407844,8
0.2,5941,88,493570,83.06462470548637,13
0.2,5942,27,493597,83.05519098098604,6
0.2,5943,91,493688,83.05652759084792,10
0.2,5944,95,493783,83.05853658536586,7
0.2,5945,87,493870,83.05919946182307,16
0.2,5946,89,493959,83.0601984193711,12
0.2,5947,90,494049,83.06136516476127,11
0.2,5948,88,494137,83.0621953269457,13
0.2,5949,-126,494011,83.02705882352942,23
0.2,5950,90,494101,83.02823054948747,11
0.2,5951,93,494194,83.0299059139785,9
0.2,5952,95,494289,83.0319166806652,6
0.2,5953,86,494375,83.0324151830702,15
0.2,5954,93,494468,83.03408900083963,9
0.2,5955,93,494561,83.03576225654803,8
0.2,5956,95,494656,83.03777068994461,8
0.2,5957,92,494748,83.0392749244713,9
0.2,5958,93,494841,83.04094646752812,8
0.2,5959,95,494936,83.04295302013423,7
0.2,5960,93,495029,83.04462338533803,8
0.2,5961,94,495123,83.04646091915464,7
0.2,5962,92,495215,83.04796243501593,9
0.2,5963,91,495306,83.04929577464789,10
0.2,5964,94,495400,83.05113160100586,7
0.2,5965,91,495491,83.0524639624539,10
0.2,5966,94,495585,83.05429864253394,7
0.2,5967,92,495677,83.05579758713137,9
0.2,5968,92,495769,83.05729602948567,9
0.2,5969,94,495863,83.05912897822445,7
0.2,5970,94,495957,83.0609613130129,7
0.2,5971,95,496052,83.0629604822505,6
0.2,5972,95,496147,83.06495898208605,7
0.2,5973,87,496234,83.06561767659859,14
0.2,5974,93,496327,83.06728033472804,8
0.2,5975,91,496418,83.06860776439089,10
0.2,5976,92,496510,83.07010205788858,9
0.2,5977,89,496599,83.07109401137504,12
0.2,5978,85,496684,83.07141662485365,16
0.2,5979,94,496778,83.0732441471572,7
0.2,5980,92,496870,83.07473666610935,9
0.2,5981,91,496961,83.076061517887,10
0.2,5982,91,497052,83.07738592679257,10
0.2,5983,89,497141,83.0783756684492,12
0.2,5984,92,497233,83.07986633249791,9
0.2,5985,91,497324,83.0811894420314,10
0.2,5986,93,497417,83.08284616669451,8
0.2,5987,94,497511,83.08466933867736,7
0.2,5988,88,497599,83.08549006511939,13
0.2,5989,92,497691,83.08697829716193,9
0.2,5990,93,497784,83.08863294942414,8
0.2,5991,92,497876,83.09012016021362,9
0.2,5992,25,497901,83.08042716502587,9
0.2,5993,89,497990,83.08141474808141,12
0.2,5994,93,498083,83.08306922435362,8
0.2,5995,93,498176,83.08472314876585,8
0.2,5996,95,498271,83.0867100216775,6
0.2,5997,96,498367,83.0888629543181,6
0.2,5998,86,498453,83.08934822470411,15
0.2,5999,88,498541,83.09016666666666,13
0.2,6000,95,498636,83.09215130811532,6
0.2,6001,92,498728,83.09363545484838,10
0.2,6002,90,498818,83.09478594036315,11
0.2,6003,96,498914,83.09693537641573,7
0.2,6004,96,499010,83.09908409658618,6
0.2,6005,96,499106,83.1012321012321,6
0.2,6006,88,499194,83.10204761112035,13
0.2,6007,24,499218,83.09221038615179,9
0.2,6008,92,499310,83.09369279414211,9
0.2,6009,96,499406,83.09584026622296,6
0.2,6010,90,499496,83.0969888537681,12
0.2,6011,91,499587,83.09830339321357,10
0.2,6012,90,499677,83.0994511890903,12
0.2,6013,94,499771,83.10126371799136,7
0.2,6014,93,499864,83.10290939318371,8
0.2,6015,95,499959,83.10488696808511,6
0.2,6016,27,499986,83.09556257271065,6
0.2,6017,93,500079,83.09720837487538,8
0.2,6018,94,500173,83.09901977072603,7
0.2,6019,95,500268,83.10099667774087,6
0.2,6020,94,500362,83.10280684271716,8
0.2,6021,95,500457,83.10478246429757,7
0.2,6022,95,500552,83.10675742985224,8
0.2,6023,86,500638,83.10723771580345,15
0.2,6024,88,500726,83.10804979253112,13
0.2,6025,95,500821,83.11002323265848,6
0.2,6026,93,500914,83.11166417786627,8
0.2,6027,94,501008,83.1134704711347,8
0.2,6028,93,501101,83.11511030021562,8
0.2,6029,94,501195,83.11691542288557,8
0.2,6030,91,501286,83.11822251699553,10
0.2,6031,94,501380,83.12002652519894,8
0.2,6032,95,501475,83.12199569036963,6
0.2,6033,94,501569,83.1237984753066,7
0.2,6034,17,501586,83.11284175642088,16
0.2,6035,92,501678,83.11431411530815,9
0.2,6036,96,501774,83.11644856716913,6
0.2,6037,93,501867,83.11808545876119,8
0.2,6038,90,501957,83.11922503725782,11
0.2,6039,96,502053,83.12135761589404,6
0.2,6040,23,502076,83.11140539645754,11
0.2,6041,9,502085,83.09913935782853,23
0.2,6042,90,502175,83.10028131722655,11
0.2,6043,94,502269,83.10208471211118,8
0.2,6044,92,502361,83.10355665839536,9
0.2,6045,91,502452,83.10486271915316,10
0.2,6046,92,502544,83.1063337191996,9
0.2,6047,91,502635,83.10763888888889,11
0.2,6048,93,502728,83.1092742602083,8
0.2,6049,93,502821,83.11090909090909,9
0.2,6050,90,502911,83.11204759543877,11
0.2,6051,95,503006,83.11401189689359,8
0.2,6052,94,503100,83.11581034197918,9
0.2,6053,92,503192,83.1172778328378,9
0.2,6054,25,503217,83.10767960363336,8
0.2,6055,95,503312,83.10964332892999,6
0.2,6056,85,503397,83.10995542347698,16
0.2,6057,95,503492,83.11191812479366,6
0.2,6058,95,503587,83.11388017824723,8
0.2,6059,95,503682,83.11584158415842,7
0.2,6060,96,503778,83.11796733212341,6
0.2,6061,89,503867,83.1189376443418,12
0.2,6062,90,503957,83.12007257133432,11
0.2,6063,95,504052,83.12203166226912,6
0.2,6064,94,504146,83.12382522671064,7
0.2,6065,90,504236,83.12495878667985,11
0.2,6066,22,504258,83.11488379759354,11
0.2,6067,93,504351,83.11651285431773,8
0.2,6068,95,504446,83.11847091777888,6
0.2,6069,20,504466,83.10807248764415,13
0.2,6070,92,504558,83.10953714379839,9
0.2,6071,93,504651,83.11116600790514,8
0.2,6072,94,504745,83.11295899884736,8
0.2,6073,96,504841,83.1150806717155,6
0.2,6074,95,504936,83.11703703703704,8
0.2,6075,93,505029,83.11866359447005,8
0.2,6076,92,505121,83.12012506170808,10
0.2,6077,86,505207,83.12059888121092,15
0.2,6078,89,505296,83.12156604704721,12
0.2,6079,93,505389,83.12319078947368,8
0.2,6080,94,505483,83.12497944417036,7
0.2,6081,90,505573,83.12610983229202,11
0.2,6082,95,505668,83.12806181160612,6
0.2,6083,27,505695,83.11883629191321,6
0.2,6084,93,505788,83.12046014790468,8
0.2,6085,25,505813,83.11091028590207,8
0.2,6086,95,505908,83.11286347954658,8
0.2,6087,94,506002,83.1146517739816,9
0.2,6088,92,506094,83.1161110198719,9
0.2,6089,24,506118,83.1064039408867,9
0.2,6090,90,506208,83.10753570842226,11
0.2,6091,92,506300,83.10899540380828,9
0.2,6092,96,506396,83.11111111111111,6
0.2,6093,91,506487,83.11240564489663,11
0.2,6094,94,506581,83.11419196062346,7
0.2,6095,21,506602,83.10400262467192,11
0.2,6096,-48,506554,83.08249958996228,11
0.2,6097,96,506650,83.08461790751066,6
0.2,6098,93,506743,83.08624364649943,8
0.2,6099,94,506837,83.08803278688525,7
0.2,6100,89,506926,83.08900180298312,13
0.2,6101,23,506949,83.07915437561455,10
0.2,6102,91,507040,83.08045223660496,10
0.2,6103,92,507132,83.0819134993447,9
0.2,6104,95,507227,83.08386568386568,6
0.2,6105,17,507244,83.07304290861448,15
0.2,6106,96,507340,83.07515965285738,6
0.2,6107,95,507435,83.07711198428291,7
0.2,6108,90,507525,83.07824521198232,11
0.2,6109,95,507620,83.08019639934534,6
0.2,6110,95,507715,83.08214694812634,6
0.2,6111,94,507809,83.0839332460733,7
0.2,6112,94,507903,83.0857189595943,7
0.2,6113,91,507994,83.08701341184168,10
0.2,6114,94,508088,83.08879803761243,8
0.2,6115,93,508181,83.09041857423152,9
0.2,6116,90,508271,83.09154814451529,11
0.2,6117,94,508365,83.09333115397189,7
0.2,6118,93,508458,83.09495015525412,8
0.2,6119,25,508483,83.08545751633987,8
0.2,6120,24,508507,83.07580460709035,9
0.2,6121,94,508601,83.07758902319503,7
0.2,6122,96,508697,83.07969949371223,6
0.2,6123,96,508793,83.08180927498367,6
0.2,6124,92,508885,83.08326530612244,9
0.2,6125,94,508979,83.08504733920992,8
0.2,6126,95,509074,83.0869920026114,6
0.2,6127,92,509166,83.08844647519582,9
0.2,6128,93,509259,83.09006363191385,8
0.2,6129,92,509351,83.09151712887439,11
0.2,6130,91,509442,83.09280704615887,10
0.2,6131,94,509536,83.09458577951729,7
0.2,6132,91,509627,83.09587477580304,10
0.2,6133,92,509719,83.09732637756765,9
0.2,6134,85,509804,83.09763651181744,16
0.2,6135,92,509896,83.09908735332463,9
0.2,6136,23,509919,83.08929444353919,10
0.2,6137,94,510013,83.09107201042684,10
0.2,6138,96,510109,83.0931747841668,7
0.2,6139,93,510202,83.09478827361563,10
0.2,6140,94,510296,83.0965640775118,8
0.2,6141,90,510386,83.09768804949528,11
0.2,6142,93,510479,83.09930001627869,8
0.2,6143,94,510573,83.10107421875,7
0.2,6144,96,510669,83.10317331163547,6
0.2,6145,88,510757,83.10397006182883,13
0.2,6146,79,510836,83.10330242394664,25
0.2,6147,96,510932,83.10540013012361,6
0.2,6148,89,511021,83.10635875752155,12
0.2,6149,90,511111,83.10747967479675,11
0.2,6150,87,511198,83.10811250203218,14
0.2,6151,95,511293,83.1100455136541,8
0.2,6152,96,511389,83.11214041930765,6
0.2,6153,93,511482,83.1137471563211,8
0.2,6154,92,511574,83.11519090170593,9
0.2,6155,94,511668,83.11695906432749,7
0.2,6156,95,511763,83.11888906935195,8
0.2,6157,96,511859,83.1209808379344,7
0.2,6158,93,511952,83.12258483520051,10
0.2,6159,94,512046,83.12435064935065,8
0.2,6160,89,512135,83.12530433371207,12
0.2,6161,94,512229,83.12706913339825,7
0.2,6162,91,512320,83.12834658445563,10
0.2,6163,91,512411,83.1296236210253,12
0.2,6164,85,512496,83.12992700729927,17
0.2,6165,94,512590,83.13168991242297,8
0.2,6166,20,512610,83.12145289443814,12
0.2,6167,93,512703,83.12305447470817,8
0.2,6168,96,512799,83.12514183822337,6
0.2,6169,95,512894,83.12706645056726,7
0.2,6170,96,512990,83.12915248744126,6
0.2,6171,93,513083,83.13075178224238,8
0.2,6172,95,513178,83.13267455046169,7
0.2,6173,25,513203,83.12325882734046,8
0.2,6174,94,513297,83.12502024291499,8
0.2,6175,93,513390,83.12661917098445,8
0.2,6176,93,513483,83.12821758135017,8
0.2,6177,87,513570,83.12884428617676,14
0.2,6178,90,513660,83.12995630360899,11
0.2,6179,96,513756,83.13203883495146,6
0.2,6180,94,513850,83.13379712020709,8
0.2,6181,26,513876,83.12455516014235,7
0.2,6182,21,513897,83.11450752062106,11
0.2,6183,93,513990,83.11610608020699,8
0.2,6184,88,514078,83.11689571544058,13
0.2,6185,-53,514025,83.09489169091496,18
0.2,6186,95,514120,83.0968159043155,6
0.2,6187,88,514208,83.09760827407887,13
0.2,6188,93,514301,83.09920827274196,8
0.2,6189,92,514393,83.10064620355412,9
0.2,6190,11,514404,83.0890001615248,21
0.2,6191,22,514426,83.07913436692506,11
0.2,6192,93,514519,83.08073631519457,8
0.2,6193,87,514606,83.08136906683887,14
0.2,6194,88,514694,83.0821630347054,13
0.2,6195,94,514788,83.08392511297612,7
0.2,6196,94,514882,83.08568662255931,7
0.2,6197,78,514960,83.08486608583414,23
0.2,6198,27,514987,83.07581868043233,6
0.2,6199,90,515077,83.07693548387097,11
0.2,6200,84,515161,83.07708434123529,17
0.2,6201,23,515184,83.06739761367301,11
0.2,6202,96,515280,83.06948250846365,6
0.2,6203,94,515374,83.0712443584784,8
0.2,6204,94,515468,83.07300564061241,8
0.2,6205,24,515492,83.06348694811473,8
0.2,6206,93,515585,83.06508780409216,8
0.2,6207,93,515678,83.0666881443299,8
0.2,6208,94,515772,83.06844902560799,8
0.2,6209,92,515864,83.06988727858293,9
0.2,6210,19,515883,83.0595717275801,14
0.2,6211,95,515978,83.06149388280747,7
0.2,6212,-48,515930,83.04039916304522,13
0.2,6213,94,516024,83.04216285806244,7
0.2,6214,14,516038,83.03105390185036,20
0.2,6215,90,516128,83.03217503217503,11
0.2,6216,95,516223,83.03410004825479,6
0.2,6217,85,516308,83.03441621100032,16
0.2,6218,91,516399,83.03569705740473,12
0.2,6219,92,516491,83.0371382636656,9
0.2,6220,88,516579,83.03793602314741,13
0.2,6221,86,516665,83.03841208614594,15
0.2,6222,87,516752,83.03904869034228,14
0.2,6223,23,516775,83.02940231362467,10
0.2,6224,91,516866,83.0306827309237,10
0.2,6225,23,516889,83.02104079665916,9
0.2,6226,92,516981,83.02248273647021,9
0.2,6227,91,517072,83.02376364804111,10
0.2,6228,95,517167,83.02568630598812,7
0.2,6229,89,517256,83.02664526484752,12
0.2,6230,22,517278,83.0168512277323,13
0.2,6231,22,517300,83.00706033376123,11
0.2,6232,94,517394,83.00882400128349,7
0.2,6233,87,517481,83.00946422842476,15
0.2,6234,90,517571,83.01058540497193,11
0.2,6235,90,517661,83.01170622193715,11
0.2,6236,94,517755,83.01346801346801,7
0.2,6237,95,517850,83.01538954793203,9
0.2,6238,93,517943,83.01698990222792,8
0.2,6239,19,517962,83.00673076923077,13
0.2,6240,95,518057,83.00865245954174,8
0.2,6241,92,518149,83.01009291893624,9
0.2,6242,94,518243,83.01185327566876,8
0.2,6243,94,518337,83.01361306854581,7
0.2,6244,95,518432,83.01553242594075,7
0.2,6245,89,518521,83.01649055395453,13
0.2,6246,19,518540,83.00624299663839,15
0.2,6247,93,518633,83.00784250960308,8
0.2,6248,93,518726,83.00944151064171,8
0.2,6249,91,518817,83.01072,10
0.2,6250,92,518909,83.01215805471125,9
0.2,6251,88,518997,83.01295585412667,14
0.2,6252,77,519074,83.01199424276348,24
0.2,6253,88,519162,83.01279181323953,13
0.2,6254,20,519182,83.00271782573941,13
0.2,6255,94,519276,83.00447570332481,7
0.2,6256,94,519370,83.0062330190187,7
0.2,6257,88,519458,83.00703100031959,14
0.2,6258,95,519553,83.00894711615274,6
0.2,6259,90,519643,83.01006389776357,11
0.2,6260,88,519731,83.01086088484267,13
0.2,6261,93,519824,83.0124560843181,9
0.2,6262,93,519917,83.01405077438928,9
0.2,6263,92,520009,83.0154853128991,9
0.2,6264,93,520102,83.0170790103751,8
0.2,6265,93,520195,83.01867219917013,8
0.2,6266,95,520290,83.02058401148875,6
0.2,6267,86,520376,83.02105934907466,15
0.2,6268,88,520464,83.0218535651619,13
0.2,6269,92,520556,83.02328548644338,10
0.2,6270,91,520647,83.0245574868442,10
0.2,6271,92,520739,83.02598852040816,9
0.2,6272,95,520834,83.0278973377969,7
0.2,6273,94,520928,83.0296461587504,7
0.2,6274,94,521022,83.03139442231075,7
0.2,6275,95,521117,83.03330146590184,6
0.2,6276,94,521211,83.03504859009081,7
0.2,6277,92,521303,83.03647658489965,9
0.2,6278,93,521396,83.03806338588947,8
0.2,6279,95,521491,83.03996815286624,6
0.2,6280,90,521581,83.04107626174176,11
0.2,6281,-49,521532,83.02005730659026,13
0.2,6282,95,521627,83.02196402992202,7
0.2,6283,92,521719,83.0233927434755,9
0.2,6284,93,521812,83.0249801113763,8
0.2,6285,95,521907,83.02688514158447,7
0.2,6286,93,522000,83.0284714490218,8
0.2,6287,95,522095,83.03037531806616,6
0.2,6288,92,522187,83.03180155827636,9
0.2,6289,85,522272,83.03211446740859,16
0.2,6290,94,522366,83.03385789222699,9
0.2,6291,91,522457,83.03512396694215,11
0.2,6292,92,522549,83.0365485460035,9
0.2,6293,92,522641,83.0379726723864,9
0.2,6294,91,522732,83.03923749007149,11
0.2,6295,94,522826,83.04097839898348,7
0.2,6296,92,522918,83.04240114340162,9
0.2,6297,90,523008,83.04350587488092,11
0.2,6298,92,523100,83.04492776631211,9
0.2,6299,91,523191,83.04619047619047,10
0.2,6300,16,523207,83.03554991271227,17
0.2,6301,94,523301,83.03728974928595,7
0.2,6302,96,523397,83.03934634301126,6
0.2,6303,88,523485,83.04013324873097,13
0.2,6304,91,523576,83.04139571768438,10
0.2,6305,94,523670,83.04313352362828,7
0.2,6306,94,523764,83.04487077850008,8
0.2,6307,91,523855,83.04613189600508,11
0.2,6308,90,523945,83.04723411000158,11
0.2,6309,93,524038,83.04881141045959,8
0.2,6310,82,524120,83.04864522262716,19
0.2,6311,27,524147,83.03976552598226,6
0.2,6312,94,524241,83.0415016632346,7
0.2,6313,93,524334,83.04307887234717,9
0.2,6314,86,524420,83.04354711005543,15
0.2,6315,95,524515,83.04544015199494,7
0.2,6316,96,524611,83.04749089757796,6
0.2,6317,92,524703,83.04890788224121,10
0.2,6318,94,524797,83.05064092419687,7
0.2,6319,90,524887,83.05174050632911,11
0.2,6320,92,524979,83.0531561461794,9
0.2,6321,95,525074,83.05504587155963,7
0.2,6322,-49,525025,83.03416099952554,13
0.2,6323,93,525118,83.03573687539532,8
0.2,6324,95,525213,83.03762845849802,7
0.2,6325,94,525307,83.03936136579198,7
0.2,6326,91,525398,83.04061956693536,10
0.2,6327,92,525490,83.04203539823008,10
0.2,6328,23,525513,83.03254858587455,9
0.2,6329,87,525600,83.03317535545024,16
0.2,6330,93,525693,83.03474964460591,8
0.2,6331,92,525785,83.03616550852811,9
0.2,6332,90,525875,83.0372651192168,11
0.2,6333,94,525969,83.03899589516892,8
0.2,6334,92,526061,83.04041041831097,9
0.2,6335,91,526152,83.04166666666667,10
0.2,6336,91,526243,83.0429225185419,10
0.2,6337,92,526335,83.04433575260335,10
0.2,6338,92,526427,83.0457485407793,9
0.2,6339,23,526450,83.03627760252365,10
0.2,6340,91,526541,83.03753351206434,10
0.2,6341,91,526632,83.03878902554399,11
0.2,6342,94,526726,83.0405171054706,7
0.2,6343,89,526815,83.04145649432535,12
0.2,6344,94,526909,83.04318360914105,9
0.2,6345,90,526999,83.04427986132997,11
0.2,6346,93,527092,83.04584843233023,8
0.2,6347,93,527185,83.04741650913674,8
0.2,6348,91,527276,83.04866908174516,10
0.2,6349,92,527368,83.05007874015747,9
0.2,6350,24,527392,83.04078097937332,9
0.2,6351,94,527486,83.04250629722922,7
0.2,6352,88,527574,83.04328663623485,13
0.2,6353,94,527668,83.04501101668241,7
0.2,6354,27,527695,83.03619197482297,6
0.2,6355,89,527784,83.03713027061045,12
0.2,6356,93,527877,83.0386974988202,10
0.2,6357,92,527969,83.04010695187166,9
0.2,6358,19,527988,83.030036169209,14
0.2,6359,86,528074,83.03050314465409,15
0.2,6360,91,528165,83.03175601320547,11
0.2,6361,94,528259,83.03348003772399,7
0.2,6362,88,528347,83.03426056891404,13
0.2,6363,94,528441,83.03598365807669,7
0.2,6364,92,528533,83.03739198743126,9
0.2,6365,94,528627,83.03911404335533,7
0.2,6366,95,528722,83.04099261818753,6
0.2,6367,92,528814,83.04239949748744,9
0.2,6368,93,528907,83.04396294551735,8
0.2,6369,92,528999,83.04536891679749,9
0.2,6370,95,529094,83.04724533040338,6
0.2,6371,89,529183,83.04817953546767,12
0.2,6372,94,529277,83.04989800721795,7
0.2,6373,92,529369,83.0513021650455,9
0.2,6374,27,529396,83.04250980392158,6
0.2,6375,93,529489,83.04407151819322,8
0.2,6376,88,529577,83.04484867492552,13
0.2,6377,95,529672,83.04672311069301,6
0.2,6378,93,529765,83.0482834300047,9
0.2,6379,92,529857,83.04968652037617,9
0.2,6380,22,529879,83.04011910358878,10
0.2,6381,94,529973,83.04183641491696,8
0.2,6382,95,530068,83.04370985430049,6
0.2,6383,16,530084,83.03320802005013,17
0.2,6384,95,530179,83.0350822239624,6
0.2,6385,83,530262,83.03507673034764,22
0.2,6386,-52,530210,83.01393455456396,15
0.2,6387,92,530302,83.01534126487164,9
0.2,6388,91,530393,83.01659101580842,10
0.2,6389,92,530485,83.01799687010954,9
0.2,6390,96,530581,83.02002816460647,6
0.2,6391,93,530674,83.02158948685857,9
0.2,6392,92,530766,83.02299389957766,9
0.2,6393,27,530793,83.0142320925868,6
0.2,6394,95,530888,83.01610633307271,7
0.2,6395,92,530980,83.01751094434022,9
0.2,6396,96,531076,83.01954040956699,8
0.2,6397,95,531171,83.02141294154423,7
0.2,6398,95,531266,83.02328488826379,6
0.2,6399,24,531290,83.0140625,8
0.2,6400,94,531384,83.01577878456492,8
0.2,6401,89,531473,83.0167135270228,12
0.2,6402,95,531568,83.01858503826331,7
0.2,6403,94,531662,83.02029981261711,8
0.2,6404,89,531751,83.02123341139735,12
0.2,6405,94,531845,83.02294723696535,7
0.2,6406,93,531938,83.02450444825972,9
0.2,6407,95,532033,83.02637328339576,7
0.2,6408,93,532126,83.02792947417694,8
0.2,6409,93,532219,83.02948517940717,8
0.2,6410,87,532306,83.03010450787708,14
0.2,6411,95,532401,83.03197130380536,6
0.2,6412,95,532496,83.0338375175425,7
0.2,6413,-49,532447,83.01325226067976,12
0.2,6414,96,532543,83.01527669524552,6
0.2,6415,91,532634,83.01652119700748,10
0.2,6416,87,532721,83.01714196665108,14
0.2,6417,25,532746,83.00810221252726,8
0.2,6418,95,532841,83.00997040037389,6
0.2,6419,94,532935,83.01168224299066,7
0.2,6420,87,533022,83.0123033795359,16
0.2,6421,96,533118,83.01432575521645,7
0.2,6422,88,533206,83.01510197726918,13
0.2,6423,89,533295,83.01603362391033,12
0.2,6424,94,533389,83.01774319066148,7
0.2,6425,95,533484,83.01960784313725,6
0.2,6426,19,533503,83.00964680255173,13
0.2,6427,87,533590,83.01026757934038,14
0.2,6428,92,533682,83.01166588894074,9
0.2,6429,95,533777,83.0135303265941,7
0.2,6430,92,533869,83.01492769398227,9
0.2,6431,92,533961,83.01632462686567,9
0.2,6432,93,534054,83.01787657391574,8
0.2,6433,93,534147,83.01942803854523,8
0.2,6434,91,534238,83.02066822066823,10
0.2,6435,94,534332,83.02237414543194,7
0.2,6436,89,534421,83.0233027807985,12
0.2,6437,91,534512,83.02454178316248,10
0.2,6438,88,534600,83.02531448982761,13
0.2,6439,96,534696,83.02732919254659,6
0.2,6440,96,534792,83.02934326967862,6
0.2,6441,85,534877,83.02964917727414,16
0.2,6442,88,534965,83.03042061151638,13
0.2,6443,90,535055,83.03150217256362,11
0.2,6444,95,535150,83.033359193173,6
0.2,6445,92,535242,83.03475023270245,9
0.2,6446,91,535333,83.0359857297968,12
0.2,6447,95,535428,83.037841191067,6
0.2,6448,15,535443,83.02729105287642,19
0.2,6449,88,535531,83.02806201550388,13
0.2,6450,93,535624,83.02960781274221,8
0.2,6451,91,535715,83.03084314941104,11
0.2,6452,91,535806,83.03207810320781,10
0.2,6453,95,535901,83.03393244499536,8
0.2,6454,94,535995,83.03563129357087,8
0.2,6455,93,536088,83.03717472118959,9
0.2,6456,96,536184,83.03918228279387,6
0.2,6457,23,536207,83.0298854134407,11
0.2,6458,89,536296,83.03080972286732,12
0.2,6459,92,536388,83.03219814241486,9
0.2,6460,93,536481,83.03374090698034,8
0.2,6461,86,536567,83.03419993809966,15
0.2,6462,93,536660,83.03574191551911,8
0.2,6463,92,536752,83.0371287128713,9
0.2,6464,93,536845,83.03866976024749,8
0.2,6465,93,536938,83.04021033096195,8
0.2,6466,96,537034,83.04221431884955,6
0.2,6467,25,537059,83.03324056895485,8
0.2,6468,92,537151,83.03462668109445,10
0.2,6469,96,537247,83.03663060278207,6
0.2,6470,94,537341,83.03832483387421,7
0.2,6471,27,537368,83.02966625463536,6
0.2,6472,94,537462,83.03136103815851,7
0.2,6473,93,537555,83.03290083410565,8
0.2,6474,92,537647,83.03428571428572,9
0.2,6475,91,537738,83.03551575046325,11
0.2,6476,93,537831,83.03705419175544,8
0.2,6477,94,537925,83.03874652670578,7
0.2,6478,92,538017,83.0401296496373,9
0.2,6479,87,538104,83.04074074074074,14
0.2,6480,92,538196,83.04212312914673,9
0.2,6481,94,538290,83.04381363776612,7
0.2,6482,93,538383,83.04534937528922,9
0.2,6483,85,538468,83.04565083281925,16
0.2,6484,92,538560,83.04703161141094,10
0.2,6485,94,538654,83.04872032069072,8
0.2,6486,94,538748,83.05040850932635,7
0.2,6487,20,538768,83.04069050554871,13
0.2,6488,22,538790,83.03128371089537,10
0.2,6489,95,538885,83.0331278890601,6
0.2,6490,91,538976,83.0343552611308,10
0.2,6491,91,539067,83.03558225508318,10
0.2,6492,93,539160,83.03711689511782,8
0.2,6493,86,539246,83.03757314444103,16
0.2,6494,96,539342,83.0395688991532,6
0.2,6495,87,539429,83.04017857142857,14
0.2,6496,96,539525,83.04217331075881,6
0.2,6497,86,539611,83.04262850107726,15
0.2,6498,89,539700,83.04354516079397,12
0.2,6499,91,539791,83.04476923076923,10
0.2,6500,93,539884,83.04630056914321,9
0.2,6501,93,539977,83.04783143648108,8
0.2,6502,91,540068,83.04905428263878,10
0.2,6503,94,540162,83.05073800738008,8
0.2,6504,94,540256,83.05242121445042,7
0.2,6505,89,540345,83.05333538272365,13
0.2,6506,94,540439,83.05501767327493,7
0.2,6507,90,540529,83.0560848186847,11
0.2,6508,94,540623,83.05776616991858,7
0.2,6509,94,540717,83.0594470046083,7
0.2,6510,90,540807,83.06051297803717,11
0.2,6511,94,540901,83.06219287469287,8
0.2,6512,94,540995,83.06387225548902,7
0.2,6513,92,541087,83.06524408965305,9
0.2,6514,86,541173,83.06569455103607,15
0.2,6515,95,541268,83.06752608962553,6
0.2,6516,94,541362,83.06920362129814,7
0.2,6517,91,541453,83.07042037434796,10
0.2,6518,93,541546,83.07194354962418,9
0.2,6519,20,541566,83.0622699386503,12
0.2,6520,25,541591,83.05336604815213,8
0.2,6521,89,541680,83.05427782888684,12
0.2,6522,89,541769,83.05518933006286,12
0.2,6523,94,541863,83.0568669527897,7
0.2,6524,94,541957,83.05854406130268,7
0.2,6525,17,541974,83.04842169782408,16
0.2,6526,93,542067,83.04994637658955,8
0.2,6527,91,542158,83.05116421568627,11
0.2,6528,94,542252,83.05284117016389,7
0.2,6529,91,542343,83.0540581929556,10
0.2,6530,93,542436,83.05558107487369,8
0.2,6531,93,542529,83.05710349050827,8
0.2,6532,95,542624,83.05893157814174,6
0.2,6533,94,542718,83.06060606060606,7
0.2,6534,93,542811,83.06212700841623,8
0.2,6535,22,542833,83.05278457772337,10
0.2,6536,96,542929,83.05476518280557,6
0.2,6537,91,543020,83.05598042214744,10
0.2,6538,90,543110,83.05704236121731,11
0.2,6539,93,543203,83.0585626911315,8
0.2,6540,90,543293,83.05962391071702,11
0.2,6541,92,543385,83.06099052277591,9
0.2,6542,92,543477,83.06235671710225,9
0.2,6543,94,543571,83.06402811735941,7
0.2,6544,92,543663,83.0653934300993,9
0.2,6545,93,543756,83.06691109074244,8
0.2,6546,89,543845,83.06781732091034,12
0.2,6547,92,543937,83.0691814294441,9
0.2,6548,88,544025,83.06993434112078,13
0.2,6549,90,544115,83.07099236641221,11
0.2,6550,93,544208,83.07250801404366,8
0.2,6551,93,544301,83.0740231990232,8
0.2,6552,90,544391,83.07508011597741,11
0.2,6553,91,544482,83.07628928898383,11
0.2,6554,-45,544437,83.05675057208238,9
0.2,6555,95,544532,83.05857230018304,8
0.2,6556,94,544626,83.06024096385542,8
0.2,6557,93,544719,83.06175663311986,9
0.2,6558,89,544808,83.06266199115719,12
0.2,6559,93,544901,83.06417682926829,9
0.2,6560,22,544923,83.05486968449931,11
0.2,6561,90,545013,83.05592807071015,11
0.2,6562,94,545107,83.05759561176292,7
0.2,6563,22,545129,83.04829372333943,11
0.2,6564,93,545222,83.04980959634425,8
0.2,6565,95,545317,83.0516296070667,6
0.2,6566,92,545409,83.05299223389676,9
0.2,6567,94,545503,83.05465895249695,7
0.2,6568,95,545598,83.05647739381945,8
0.2,6569,96,545694,83.05844748858448,6
0.2,6570,96,545790,83.06041698371632,6
0.2,6571,94,545884,83.06208155812539,7
0.2,6572,96,545980,83.06404990111061,6
0.2,6573,91,546071,83.06525707331913,11
0.2,6574,93,546164,83.06676806083651,8
0.2,6575,94,546258,83.06843065693431,9
0.2,6576,96,546354,83.07039683746389,6
0.2,6577,96,546450,83.07236242018851,6
0.2,6578,92,546542,83.07371941024472,9
0.2,6579,92,546634,83.07507598784194,9
0.2,6580,95,546729,83.07688801094059,8
0.2,6581,92,546821,83.07824369492556,9
0.2,6582,83,546904,83.07823180920553,19
0.2,6583,94,546998,83.07989064398542,7
0.2,6584,92,547090,83.08124525436598,9
0.2,6585,91,547181,83.08244761615548,11
0.2,6586,91,547272,83.08364961287384,10
0.2,6587,91,547363,83.08485124468731,10
0.2,6588,96,547459,83.08681135225376,6
0.2,6589,90,547549,83.08786039453717,11
0.2,6590,21,547570,83.07844029737521,11
0.2,6591,93,547663,83.07994538834951,9
0.2,6592,86,547749,83.08038829061125,15
0.2,6593,93,547842,83.08189262966333,9
0.2,6594,93,547935,83.08339651250948,10
0.2,6595,92,548027,83.08474833232262,9
0.2,6596,88,548115,83.08549340609368,13
0.2,6597,13,548128,83.07487117308276,19
0.2,6598,88,548216,83.07561751780572,13
0.2,6599,24,548240,83.06666666666666,9
0.2,6600,94,548334,83.06832298136646,7
0.2,6601,96,548430,83.07028173280824,6
0.2,6602,87,548517,83.07087687414811,14
0.2,6603,94,548611,83.07253179890975,7
0.2,6604,94,548705,83.07418622255867,7
0.2,6605,87,548792,83.07478050257342,15
0.2,6606,88,548880,83.07552595731799,13
0.2,6607,27,548907,83.06703995157385,6
0.2,6608,92,548999,83.06839158722954,9
0.2,6609,94,549093,83.07004538577912,7
0.2,6610,93,549186,83.07154742096506,8
0.2,6611,94,549280,83.07320024198427,7
0.2,6612,92,549372,83.07455012853471,10
0.2,6613,87,549459,83.07514363471424,14
0.2,6614,91,549550,83.07634164777022,10
0.2,6615,16,549566,83.06620314389359,17
0.2,6616,95,549661,83.06800664953907,6
0.2,6617,95,549756,83.06980961015412,8
0.2,6618,87,549843,83.07040338419701,16
0.2,6619,90,549933,83.0714501510574,11
0.2,6620,93,550026,83.07294970548256,8
0.2,6621,91,550117,83.07414678344911,10
0.2,6622,93,550210,83.07564547788012,8
0.2,6623,23,550233,83.06657608695652,9
0.2,6624,90,550323,83.06762264150943,11
0.2,6625,96,550419,83.06957440386357,6
0.2,6626,95,550514,83.07137467934209,6
0.2,6627,96,550610,83.07332528666264,6
0.2,6628,92,550702,83.0746718962136,9
0.2,6629,27,550729,83.06621417797888,6
0.2,6630,82,550811,83.06605338561303,19
0.2,6631,89,550900,83.06694813027744,12
0.2,6632,96,550996,83.06889793456958,6
0.2,6633,89,551085,83.06979198070546,12
0.2,6634,92,551177,83.07113790504899,9
0.2,6635,95,551272,83.07293550331525,6
0.2,6636,92,551364,83.07428054844056,9
0.2,6637,93,551457,83.0757758360952,9
0.2,6638,94,551551,83.07742129838832,7
0.2,6639,94,551645,83.07906626506023,7
0.2,6640,88,551733,83.07980725794309,14
0.2,6641,93,551826,83.08130081300813,9
0.2,6642,93,551919,83.08279391841036,8
0.2,6643,87,552006,83.08338350391331,14
0.2,6644,92,552098,83.08472535741159,9
0.2,6645,94,552192,83.08636773999397,8
0.2,6646,95,552287,83.08816007221303,7
0.2,6647,94,552381,83.08980144404332,7
0.2,6648,24,552405,83.08091442322154,9
0.2,6649,91,552496,83.0821052631579,10
0.2,6650,85,552581,83.0823936250188,16
0.2,6651,84,552665,83.0825315694528,17
0.2,6652,92,552757,83.08387193747181,9
0.2,6653,95,552852,83.08566275924257,6
0.2,6654,94,552946,83.08730277986476,7
0.2,6655,96,553042,83.08924278846153,6
0.2,6656,95,553137,83.09103199639478,7
0.2,6657,19,553156,83.08140582757585,13
0.2,6658,93,553249,83.08289532962907,8
0.2,6659,21,553270,83.07357357357357,11
0.2,6660,88,553358,83.07431316619126,13
0.2,6661,93,553451,83.0758030621435,8
0.2,6662,95,553546,83.07759267597179,6
0.2,6663,93,553639,83.07908163265306,8
0.2,6664,90,553729,83.0801200300075,11
0.2,6665,92,553821,83.08145814581458,9
0.2,6666,94,553915,83.08309584520774,7
0.2,6667,93,554008,83.08458308338332,8
0.2,6668,93,554101,83.08606987554356,8
0.2,6669,92,554193,83.08740629685157,9
0.2,6670,94,554287,83.0890421226203,7
0.2,6671,94,554381,83.09067745803357,7
0.2,6672,-54,554327,83.07013337329536,18
0.2,6673,94,554421,83.07177105184297,7
0.2,6674,88,554509,83.07250936329588,13
0.2,6675,91,554600,83.07369682444578,10
0.2,6676,92,554692,83.07503369776846,9
0.2,6677,93,554785,83.07651991614256,9
0.2,6678,94,554879,83.0781554124869,7
0.2,6679,89,554968,83.07904191616767,12
0.2,6680,19,554987,83.06945068103578,13
0.2,6681,93,555080,83.07093684525591,8
0.2,6682,23,555103,83.06194822684424,10
0.2,6683,90,555193,83.06298623578695,11
0.2,6684,94,555287,83.06462228870606,7
0.2,6685,94,555381,83.06625785222853,7
0.2,6686,96,555477,83.06819201435621,6
0.2,6687,93,555570,83.06967703349282,9
0.2,6688,95,555665,83.07146060696667,6
0.2,6689,94,555759,83.07309417040359,7
0.2,6690,94,555853,83.07472724555373,7
0.2,6691,93,555946,83.07621040047819,8
0.2,6692,93,556039,83.07769311220679,9
0.2,6693,93,556132,83.07917538093815,8
0.2,6694,96,556228,83.08110530246452,6
0.2,6695,91,556319,83.08228793309438,13
0.2,6696,91,556410,83.08347021054203,10
0.2,6697,89,556499,83.08435353836967,12
0.2,6698,93,556592,83.08583370652336,9
0.2,6699,18,556610,83.07611940298507,15
0.2,6700,94,556704,83.07774958961349,7
0.2,6701,93,556797,83.07923008057297,9
0.2,6702,92,556889,83.08056094286141,9
0.2,6703,81,556970,83.08025059665871,20
0.2,6704,91,557061,83.0814317673378,10
0.2,6705,92,557153,83.08276170593498,9
0.2,6706,91,557244,83.08394214999255,11
0.2,6707,91,557335,83.08512224209899,10
0.2,6708,92,557427,83.0864510359219,9
0.2,6709,94,557521,83.08807749627422,7
0.2,6710,88,557609,83.08880941737446,13
0.2,6711,91,557700,83.08998808104887,10
0.2,6712,16,557716,83.07999404141219,16
0.2,6713,92,557808,83.08132260947275,9
0.2,6714,91,557899,83.0825018615041,10
0.2,6715,88,557987,83.08323406789756,13
0.2,6716,27,558014,83.07488462111061,6
0.2,6717,93,558107,83.07636201250372,8
0.2,6718,95,558202,83.07813662747432,6
0.2,6719,96,558298,83.08005952380952,6
0.2,6720,77,558375,83.07915488766552,24
0.2,6721,20,558395,83.0697709015174,13
0.2,6722,91,558486,83.07095046854083,10
0.2,6723,22,558508,83.06186793575253,10
0.2,6724,93,558601,83.06334572490707,9
0.2,6725,92,558693,83.06467439785905,11
0.2,6726,89,558782,83.06555671175859,12
0.2,6727,22,558804,83.05648038049941,10
0.2,6728,26,558830,83.04800118888393,7
0.2,6729,94,558924,83.04962852897474,7
0.2,6730,93,559017,83.05110681919477,8
0.2,6731,92,559109,83.05243612596554,9
0.2,6732,94,559203,83.0540620822813,7
0.2,6733,96,559299,83.05598455598455,6
0.2,6734,94,559393,83.05760950259837,7
0.2,6735,94,559487,83.05923396674584,8
0.2,6736,92,559579,83.06056108059967,9
0.2,6737,96,559675,83.06248144850103,7
0.2,6738,90,559765,83.06351090666271,11
0.2,6739,94,559859,83.06513353115727,7
0.2,6740,92,559951,83.06645898234683,9
0.2,6741,94,560045,83.06808068822308,8
0.2,6742,89,560134,83.06896040338128,12
0.2,6743,90,560224,83.0699881376038,11
0.2,6744,93,560317,83.07146034099333,8
0.2,6745,92,560409,83.0727838719241,10
0.2,6746,92,560501,83.07410701052319,9
0.2,6747,95,560596,83.07587433313574,7
0.2,6748,95,560691,83.07764113201956,7
0.2,6749,89,560780,83.07851851851852,12
0.2,6750,90,560870,83.07954377129315,11
0.2,6751,94,560964,83.08116113744076,7
0.2,6752,94,561058,83.08277802458167,7
0.2,6753,92,561150,83.08409831211134,12
0.2,6754,93,561243,83.08556624722428,8
0.2,6755,90,561333,83.08658969804618,11
0.2,6756,95,561428,83.0883528192985,6
0.2,6757,92,561520,83.08967150044391,9
0.2,6758,81,561601,83.08936233170587,20
0.2,6759,85,561686,83.0896449704142,16
0.2,6760,22,561708,83.08060937731105,11
0.2,6761,94,561802,83.08222419402544,7
0.2,6762,94,561896,83.08383853319533,7
0.2,6763,90,561986,83.08486102897693,11
0.2,6764,94,562080,83.08647450110865,7
0.2,6765,94,562174,83.08808749630505,7
0.2,6766,94,562268,83.08970001477759,7
0.2,6767,90,562358,83.09072104018912,11
0.2,6768,93,562451,83.09218496085094,8
0.2,6769,93,562544,83.09364844903988,8
0.2,6770,96,562640,83.09555457096441,6
0.2,6771,90,562730,83.09657412876551,11
0.2,6772,95,562825,83.09833161080762,6
0.2,6773,96,562921,83.10023619722469,6
0.2,6774,89,563010,83.10110701107011,12
0.2,6775,92,563102,83.10242030696575,9
0.2,6776,94,563196,83.10402833111996,7
0.2,6777,94,563290,83.1056358807908,7
0.2,6778,94,563384,83.10724295618823,7
0.2,6779,93,563477,83.10870206489676,8
0.2,6780,95,563572,83.11045568500221,6
0.2,6781,94,563666,83.1120613388381,7
0.2,6782,95,563761,83.11381394663128,7
0.2,6783,94,563855,83.11541863207547,7
0.2,6784,87,563942,83.11599115696389,14
0.2,6785,91,564033,83.11715296198055,10
0.2,6786,95,564128,83.11890378665095,6
0.2,6787,95,564223,83.12065409546258,6
0.2,6788,90,564313,83.12166740315216,11
0.2,6789,94,564407,83.12326951399116,8
0.2,6790,96,564503,83.12516566043293,6
0.2,6791,96,564599,83.12706124852768,6
0.2,6792,90,564689,83.12807301634035,11
0.2,6793,93,564782,83.12952605239917,8
0.2,6794,89,564871,83.13038999264165,12
0.2,6795,89,564960,83.1312536786345,12
0.2,6796,90,565050,83.13226423422098,11
0.2,6797,93,565143,83.13371579876434,8
0.2,6798,23,565166,83.12487130460362,10
0.2,6799,92,565258,83.12617647058823,9
0.2,6800,93,565351,83.12762828995736,8
0.2,6801,94,565445,83.12922669803,7
0.2,6802,91,565536,83.13038365427018,10
0.2,6803,92,565628,83.13168724279835,10
0.2,6804,21,565649,83.12255694342396,11
0.2,6805,95,565744,83.12430208639435,6
0.2,6806,93,565837,83.125752901425,8
0.2,6807,94,565931,83.12735017626322,7
0.2,6808,93,566024,83.12880011749155,8
0.2,6809,90,566114,83.12980910425844,11
0.2,6810,24,566138,83.12112758772574,9
0.2,6811,91,566229,83.12228420434528,10
0.2,6812,94,566323,83.1238808160869,7
0.2,6813,94,566417,83.12547695920165,7
0.2,6814,94,566511,83.12707263389582,7
0.2,6815,-49,566462,83.10768779342723,12
0.2,6816,21,566483,83.09857708669503,12
0.2,6817,96,566579,83.10046934584922,6
0.2,6818,92,566671,83.10177445373222,9
0.2,6819,27,566698,83.09354838709677,6
0.2,6820,91,566789,83.09470752089136,10
0.2,6821,94,566883,83.09630606860158,11
0.2,6822,94,566977,83.0979041477356,7
0.2,6823,90,567067,83.09891559202813,11
0.2,6824,93,567160,83.1003663003663,8
0.2,6825,93,567253,83.10181658365074,10
0.2,6826,87,567340,83.10238757873151,14
0.2,6827,90,567430,83.10339777387229,11
0.2,6828,93,567523,83.1048469761312,8
0.2,6829,86,567609,83.10527086383601,15
0.2,6830,90,567699,83.10628019323671,11
0.2,6831,89,567788,83.10714285714286,14
0.2,6832,94,567882,83.10873701156154,7
0.2,6833,93,567975,83.11018437225637,8
0.2,6834,92,568067,83.11148500365765,9
0.2,6835,95,568162,83.1132241076653,6
0.2,6836,23,568185,83.10443176831944,10
0.2,6837,95,568280,83.10617139514478,6
0.2,6838,91,568371,83.1073256324024,10
0.2,6839,93,568464,83.10877192982456,8
0.2,6840,25,568489,83.10027773717293,9
0.2,6841,95,568584,83.10201695410699,6
0.2,6842,96,568680,83.10390179745725,6
0.2,6843,93,568773,83.10534774985389,8
0.2,6844,26,568799,83.09700511322133,7
0.2,6845,94,568893,83.09859772129711,8
0.2,6846,90,568983,83.09960566671535,11
0.2,6847,92,569075,83.10090537383178,9
0.2,6848,88,569163,83.10162067455103,13
0.2,6849,95,569258,83.10335766423357,7
0.2,6850,93,569351,83.10480221865421,9
0.2,6851,86,569437,83.10522475189725,15
0.2,6852,94,569531,83.10681453378082,10
0.2,6853,-117,569414,83.07761890866647,12
0.2,6854,92,569506,83.07892049598833,9
0.2,6855,93,569599,83.0803675612602,8
0.2,6856,87,569686,83.08093918623305,14
0.2,6857,89,569775,83.08180227471566,12
0.2,6858,92,569867,83.08310249307479,9
0.2,6859,89,569956,83.08396501457726,12
0.2,6860,95,570051,83.08570179274159,6
0.2,6861,93,570144,83.08714660448848,9
0.2,6862,94,570238,83.08873670406528,7
0.2,6863,95,570333,83.09047202797203,6
0.2,6864,95,570428,83.09220684632193,6
0.2,6865,95,570523,83.09394115933586,7
0.2,6866,91,570614,83.09509247123925,10
0.2,6867,96,570710,83.09697146185206,7
0.2,6868,89,570799,83.09783083418256,12
0.2,6869,25,570824,83.08937409024745,8
0.2,6870,88,570912,83.09008877892592,13
0.2,6871,95,571007,83.09182188591386,7
0.2,6872,94,571101,83.09340899170668,7
0.2,6873,84,571185,83.09354087867327,17
0.2,6874,26,571211,83.08523636363637,7
0.2,6875,91,571302,83.08638743455498,10
0.2,6876,21,571323,83.07735931365421,12
0.2,6877,93,571416,83.07880197731899,8
0.2,6878,96,571512,83.08068033144352,6
0.2,6879,92,571604,83.08197674418605,9
0.2,6880,91,571695,83.08312745240518,10
0.2,6881,94,571789,83.08471374600407,7
0.2,6882,12,571801,83.07438616882173,21
0.2,6883,93,571894,83.07582800697269,8
0.2,6884,22,571916,83.06695715323167,12
0.2,6885,92,572008,83.06825442927679,9
0.2,6886,74,572082,83.06693770872658,27
0.2,6887,90,572172,83.06794425087108,11
0.2,6888,21,572193,83.05893453331397,12
0.2,6889,84,572277,83.05907111756169,17
0.2,6890,93,572370,83.0605137135394,8
0.2,6891,92,572462,83.06181079512479,10
0.2,6892,90,572552,83.06281735093573,11
0.2,6893,95,572647,83.06454888308674,7
0.2,6894,94,572741,83.06613488034807,7
0.2,6895,94,572835,83.06772041763341,7
0.2,6896,95,572930,83.06945048571843,6
0.2,6897,92,573022,83.07074514351986,10
0.2,6898,95,573117,83.07247427163357,7
0.2,6899,96,573213,83.07434782608695,6
0.2,6900,93,573306,83.07578611795392,8
0.2,6901,93,573399,83.0772239930455,8
0.2,6902,90,573489,83.07822685788787,11
0.2,6903,94,573583,83.079808806489,10
0.2,6904,95,573678,83.08153511947864,6
0.2,6905,95,573773,83.08326093252245,6
0.2,6906,95,573868,83.08498624583756,6
0.2,6907,88,573956,83.0856977417487,13
0.2,6908,93,574049,83.08713272543059,8
0.2,6909,95,574144,83.08885672937771,6
0.2,6910,86,574230,83.0892779626682,15
0.2,6911,90,574320,83.09027777777777,11
0.2,6912,93,574413,83.09171126862434,8
0.2,6913,96,574509,83.093578247035,6
0.2,6914,92,574601,83.09486623282719,9
0.2,6915,88,574689,83.09557547715443,14
0.2,6916,91,574780,83.09671823044673,10
0.2,6917,94,574874,83.09829430471234,7
0.2,6918,94,574968,83.09986992339934,7
0.2,6919,93,575061,83.10130057803468,8
0.2,6920,91,575152,83.10244184366421,10
0.2,6921,88,575240,83.10314937879225,13
0.2,6922,-50,575190,83.08392315470172,15
0.2,6923,95,575285,83.08564413633738,6
0.2,6924,93,575378,83.08707581227436,8
0.2,6925,94,575472,83.08865145827318,7
0.2,6926,95,575567,83.0903710119821,6
0.2,6927,94,575661,83.09194572748268,7
0.2,6928,94,575755,83.09351998845432,7
0.2,6929,95,575850,83.0952380952381,6
0.2,6930,94,575944,83.09681142692253,8
0.2,6931,89,576033,83.09766301211772,12
0.2,6932,93,576126,83.09909130246646,9
0.2,6933,93,576219,83.100519180848,8
0.2,6934,93,576312,83.10194664744051,8
0.2,6935,93,576405,83.10337370242215,9
0.2,6936,92,576497,83.10465619143721,9
0.2,6937,91,576588,83.10579417699626,11
0.2,6938,94,576682,83.10736417351204,8
0.2,6939,94,576776,83.10893371757925,7
0.2,6940,93,576869,83.11035873793402,8
0.2,6941,93,576962,83.11178334773841,9
0.2,6942,92,577054,83.11306351721159,9
0.2,6943,23,577077,83.10440668202764,11
0.2,6944,96,577173,83.10626349892009,6
0.2,6945,92,577265,83.10754391016413,9
0.2,6946,87,577352,83.1081042176479,14
0.2,6947,84,577436,83.10823258491652,17
0.2,6948,21,577457,83.09929486257015,12
0.2,6949,94,577551,83.10086330935252,7
0.2,6950,94,577645,83.10243130484822,8
0.2,6951,95,577740,83.10414269275029,6
0.2,6952,90,577830,83.10513447432763,11
0.2,6953,95,577925,83.10684498130573,7
0.2,6954,88,578013,83.10754852624011,13
0.2,6955,89,578102,83.10839562967223,12
0.2,6956,92,578194,83.10967370993244,9
0.2,6957,91,578285,83.11080770336304,10
0.2,6958,93,578378,83.11222876850123,8
0.2,6959,93,578471,83.11364942528736,8
0.2,6960,93,578564,83.11506967389742,8
0.2,6961,95,578659,83.11677678827922,8
0.2,6962,24,578683,83.10828665804969,9
0.2,6963,25,578708,83.09994256174612,9
0.2,6964,88,578796,83.10064608758076,13
0.2,6965,92,578888,83.1019236290554,10
0.2,6966,94,578982,83.10348787139371,7
0.2,6967,92,579074,83.10476463834672,9
0.2,6968,94,579168,83.10632802410676,7
0.2,6969,92,579260,83.10760401721664,9
0.2,6970,96,579356,83.10945345000717,6
0.2,6971,94,579450,83.11101549053356,7
0.2,6972,92,579542,83.11229026244084,9
0.2,6973,95,579637,83.1139948379696,6
0.2,6974,24,579661,83.10551971326164,9
0.2,6975,-53,579608,83.08600917431193,16
0.2,6976,89,579697,83.0868568152501,12
0.2,6977,89,579786,83.08770421324162,12
0.2,6978,92,579878,83.08898122940249,9
0.2,6979,95,579973,83.09068767908309,7
0.2,6980,93,580066,83.09210714797307,8
0.2,6981,93,580159,83.09352621025494,9
0.2,6982,84,580243,83.09365602176715,17
0.2,6983,90,580333,83.0946449026346,11
0.2,6984,94,580427,83.09620615604868,7
0.2,6985,21,580448,83.08731749212711,12
0.2,6986,22,580470,83.07857449549162,11
0.2,6987,91,580561,83.07970807097882,10
0.2,6988,90,580651,83.08069824009158,11
0.2,6989,96,580747,83.08254649499284,6
0.2,6990,93,580840,83.08396509798312,8
0.2,6991,92,580932,83.08524027459954,10
0.2,6992,93,581025,83.08665808665809,8
0.2,6993,89,581114,83.08750357449242,13
0.2,6994,94,581208,83.0890636168692,7
0.2,6995,96,581304,83.0909090909091,6
0.2,6996,86,581390,83.09132485350865,16
0.2,6997,92,581482,83.09259788511004,9
0.2,6998,91,581573,83.0937276753822,10
0.2,6999,90,581663,83.09471428571429,11
0.2,7000,95,581758,83.09641479788601,6
0.2,7001,95,581853,83.09811482433591,6
0.2,7002,25,581878,83.08981864915036,8
0.2,7003,94,581972,83.09137635636779,7
0.2,7004,92,582064,83.09264810849393,9
0.2,7005,94,582158,83.094204967171,7
0.2,7006,23,582181,83.08562865705723,9
0.2,7007,95,582276,83.08732876712328,7
0.2,7008,94,582370,83.0888857183621,7
0.2,7009,95,582465,83.09058487874465,7
0.2,7010,94,582559,83.09214092140921,8
0.2,7011,88,582647,83.09284084426697,13
0.2,7012,94,582741,83.09439612148866,7
0.2,7013,95,582836,83.09609352723125,6
0.2,7014,90,582926,83.09707769066287,11
0.2,7015,93,583019,83.09848916761688,8
0.2,7016,23,583042,83.08992446914635,11
0.2,7017,87,583129,83.09048161869478,16
0.2,7018,92,583221,83.09175096167546,9
0.2,7019,94,583315,83.09330484330485,8
0.2,7020,94,583409,83.09485828229597,7
0.2,7021,86,583495,83.09527200227855,15
0.2,7022,18,583513,83.08600313256443,15
0.2,7023,87,583600,83.08656036446469,14
0.2,7024,96,583696,83.08839857651246,6
0.2,7025,94,583790,83.08995160831198,8
0.2,7026,90,583880,83.09093496513448,12
0.2,7027,92,583972,83.09220261809904,9
0.2,7028,20,583992,83.08322663252241,13
0.2,7029,95,584087,83.08492176386913,8
0.2,7030,90,584177,83.08590527663206,11
0.2,7031,94,584271,83.08745733788396,7
0.2,7032,94,584365,83.08900895777052,7
0.2,7033,94,584459,83.09056013647995,8
0.2,7034,91,584550,83.09168443496802,10
0.2,7035,92,584642,83.09295054007958,9
0.2,7036,90,584732,83.0939320733267,11
0.2,7037,95,584827,83.09562375674908,6
0.2,7038,93,584920,83.09703082824265,8
0.2,7039,21,584941,83.08821022727273,12
0.2,7040,92,585033,83.08947592671495,9
0.2,7041,94,585127,83.09102527690997,7
0.2,7042,95,585222,83.09271617208576,6
0.2,7043,90,585312,83.09369676320273,11
0.2,7044,94,585406,83.09524485450675,7
0.2,7045,20,585426,83.08629009367017,13
0.2,7046,24,585450,83.0779054916986,9
0.2,7047,24,585474,83.06952326901249,9
0.2,7048,85,585559,83.0697971343453,16
0.2,7049,93,585652,83.07120567375887,9
0.2,7050,94,585746,83.07275563749823,7
0.2,7051,94,585840,83.07430516165627,7
0.2,7052,23,585863,83.06578760811003,9
0.2,7053,95,585958,83.06747944428693,7
0.2,7054,27,585985,83.0595322466336,6
0.2,7055,91,586076,83.06065759637188,10
0.2,7056,94,586170,83.06220773699873,7
0.2,7057,93,586263,83.06361575517144,9
0.2,7058,94,586357,83.06516503754072,7
0.2,7059,96,586453,83.06699716713881,6
0.2,7060,89,586542,83.0678374167965,14
0.2,7061,88,586630,83.06853582554517,13
0.2,7062,93,586723,83.06994195101231,8
0.2,7063,93,586816,83.0713476783692,8
0.2,7064,90,586906,83.07232837933475,11
0.2,7065,89,586995,83.07316727993206,12
0.2,7066,94,587089,83.0747134569124,7
0.2,7067,96,587185,83.07654216185625,6
0.2,7068,25,587210,83.06832649596831,8
0.2,7069,95,587305,83.07001414427157,6
0.2,7070,93,587398,83.07141846980625,10
0.2,7071,94,587492,83.07296380090497,7
0.2,7072,92,587584,83.0742259295914,10
0.2,7073,83,587667,83.07421543681086,18
0.2,7074,93,587760,83.0756183745583,9
0.2,7075,24,587784,83.0672696438666,9
0.2,7076,6,587790,83.05637982195846,26
0.2,7077,94,587884,83.05792596778751,7
0.2,7078,91,587975,83.05904788811979,10
0.2,7079,92,588067,83.06031073446327,9
0.2,7080,94,588161,83.0618556701031,7
0.2,7081,92,588253,83.06311776334368,9
0.2,7082,91,588344,83.06423831709728,10
0.2,7083,92,588436,83.06549971767363,9
0.2,7084,93,588529,83.06690190543402,8
0.2,7085,27,588556,83.0589895568727,6
0.2,7086,93,588649,83.0603922675321,8
0.2,7087,91,588740,83.06151241534988,10
0.2,7088,90,588830,83.06249118352378,11
0.2,7089,94,588924,83.06403385049366,7
0.2,7090,95,589019,83.06571710619095,7
0.2,7091,91,589110,83.0668358714044,10
0.2,7092,94,589204,83.06837727336811,8
0.2,7093,93,589297,83.06977727657176,8
0.2,7094,94,589391,83.07131782945737,8
0.2,7095,88,589479,83.07201240135288,13
0.2,7096,94,589573,83.07355220515711,7
0.2,7097,93,589666,83.0749506903353,9
0.2,7098,94,589760,83.07648964642908,7
0.2,7099,24,589784,83.0681690140845,9
0.2,7100,92,589876,83.06942684128995,9
0.2,7101,93,589969,83.0708251196846,8
0.2,7102,90,590059,83.07180064761368,11
0.2,7103,93,590152,83.0731981981982,9
0.2,7104,95,590247,83.07487684729064,7
0.2,7105,80,590327,83.07444413171967,21
0.2,7106,87,590414,83.07499648234135,14
0.2,7107,91,590505,83.07611142374789,12
0.2,7108,88,590593,83.0768040512027,13
0.2,7109,90,590683,83.07777777777778,11
0.2,7110,22,590705,83.06918858107159,10
0.2,7111,95,590800,83.07086614173228,7
0.2,7112,14,590814,83.06115563053564,18
0.2,7113,90,590904,83.06213100927748,11
0.2,7114,91,590995,83.06324666198172,10
0.2,7115,95,591090,83.06492411467116,6
0.2,7116,95,591185,83.0666010959674,8
0.2,7117,90,591275,83.06757516156223,12
0.2,7118,90,591365,83.0685489535047,11
0.2,7119,95,591460,83.07022471910112,7
0.2,7120,94,591554,83.07175958432805,7
0.2,7121,96,591650,83.0735748385285,6
0.2,7122,88,591738,83.07426646076091,13
0.2,7123,86,591824,83.07467714766985,15
0.2,7124,93,591917,83.0760701754386,8
0.2,7125,95,592012,83.07774347460006,6
0.2,7126,92,592104,83.07899536972079,9
0.2,7127,92,592196,83.08024691358025,9
0.2,7128,94,592290,83.08177865058212,7
0.2,7129,20,592310,83.07293127629734,13
0.2,7130,90,592400,83.07390267844622,11
0.2,7131,94,592494,83.07543466068424,7
0.2,7132,96,592590,83.07724660030843,6
0.2,7133,20,592610,83.06840482197926,13
0.2,7134,94,592704,83.06993693062368,7
0.2,7135,93,592797,83.07132847533633,8
0.2,7136,95,592892,83.0729998598851,6
0.2,7137,94,592986,83.07453068086299,8
0.2,7138,93,593079,83.07592099733856,9
0.2,7139,96,593175,83.07773109243698,6
0.2,7140,94,593269,83.07926060775802,9
0.2,7141,92,593361,83.08050966115934,9
0.2,7142,23,593384,83.07209855802884,10
0.2,7143,95,593479,83.07376819708847,7
0.2,7144,16,593495,83.06438068579426,17
0.2,7145,84,593579,83.06451161488945,17
0.2,7146,87,593666,83.06506226388694,14
0.2,7147,91,593757,83.06617235590375,10
0.2,7148,91,593848,83.06728213736187,10
0.2,7149,92,593940,83.06853146853148,9
0.2,7150,94,594034,83.07006013145015,8
0.2,7151,27,594061,83.06222035794184,6
0.2,7152,91,594152,83.06333007129875,10
0.2,7153,87,594239,83.06388034665922,14
0.2,7154,82,594321,83.06373165618449,19
0.2,7155,95,594416,83.0653996646171,6
0.2,7156,95,594511,83.06706720693028,6
0.2,7157,92,594603,83.0683151718357,9
0.2,7158,94,594697,83.0698421567258,7
0.2,7159,89,594786,83.07067039106146,12
0.2,7160,92,594878,83.07191732998184,9
0.2,7161,96,594974,83.07372242390393,6
0.2,7162,23,594997,83.06533575317604,9
0.2,7163,91,595088,83.06644332774987,10
0.2,7164,92,595180,83.06769016050244,10
0.2,7165,85,595265,83.0679598102149,17
0.2,7166,94,595359,83.06948514022604,7
0.2,7167,88,595447,83.07017299107143,13
0.2,7168,93,595540,83.07155809736365,8
0.2,7169,90,595630,83.07252440725244,11
0.2,7170,22,595652,83.06400780923163,11
0.2,7171,94,595746,83.06553262688232,7
0.2,7172,94,595840,83.06705701937823,7
0.2,7173,91,595931,83.06816281014775,10
0.2,7174,93,596024,83.06954703832753,9
0.2,7175,94,596118,83.07107023411372,9
0.2,7176,95,596213,83.07273233941758,7
0.2,7177,89,596302,83.07355809417665,12
0.2,7178,90,596392,83.07452291405488,11
0.2,7179,90,596482,83.07548746518106,11
0.2,7180,91,596573,83.07659100403843,10
0.2,7181,93,596666,83.07797270955166,8
0.2,7182,90,596756,83.07893637755812,11
0.2,7183,26,596782,83.07099109131403,7
0.2,7184,90,596872,83.07195546276967,11
0.2,7185,92,596964,83.07319788477595,9
0.2,7186,95,597059,83.07485738138305,7
0.2,7187,88,597147,83.07554257095158,14
0.2,7188,91,597238,83.07664487411323,10
0.2,7189,93,597331,83.07802503477052,8
0.2,7190,94,597425,83.07954387428731,7
0.2,7191,94,597519,83.08106229143493,7
0.2,7192,92,597611,83.08230223828723,9
0.2,7193,94,597705,83.0838198498749,7
0.2,7194,93,597798,83.08519805420431,8
0.2,7195,95,597893,83.08685380767093,6
0.2,7196,93,597986,83.08823120744755,8
0.2,7197,93,598079,83.0896082245068,8
0.2,7198,92,598171,83.0908459508265,9
0.2,7199,96,598267,83.09263888888889,6
0.2,7200,96,598363,83.09443132898208,6
0.2,7201,93,598456,83.09580672035545,8
0.2,7202,92,598548,83.09704289879217,10
0.2,7203,90,598638,83.09800111049417,11
0.2,7204,94,598732,83.09951422623179,7
0.2,7205,91,598823,83.10061060227588,13
0.2,7206,93,598916,83.10198418204523,8
0.2,7207,96,599012,83.10377358490567,6
0.2,7208,96,599108,83.10556249133028,6
0.2,7209,91,599199,83.10665742024965,10
0.2,7210,89,599288,83.10747469144363,12
0.2,7211,92,599380,83.10870770937326,10
0.2,7212,89,599469,83.10952446970747,12
0.2,7213,95,599564,83.11117271971167,7
0.2,7214,93,599657,83.11254331254331,8
0.2,7215,91,599748,83.11363636363636,10
0.2,7216,90,599838,83.11459055009007,11
0.2,7217,92,599930,83.11582155721807,9
0.2,7218,93,600023,83.11719074664082,8
0.2,7219,89,600112,83.11800554016621,12
0.2,7220,23,600135,83.10968009970918,10
0.2,7221,86,600221,83.11008031016338,15
0.2,7222,93,600314,83.11144953620379,9
0.2,7223,94,600408,83.11295681063123,8
0.2,7224,96,600504,83.11474048442906,6
0.2,7225,93,600597,83.11610849709383,8
0.2,7226,86,600683,83.11650754116508,15
0.2,7227,93,600776,83.11787493082457,8
0.2,7228,95,600871,83.11951860561626,7
0.2,7229,95,600966,83.12116182572615,6
0.2,7230,93,601059,83.12252800442539,8
0.2,7231,90,601149,83.12347898230088,12
0.2,7232,92,601241,83.12470620765934,9
0.2,7233,95,601336,83.1263478020459,6
0.2,7234,96,601432,83.12812715964064,6
0.2,7235,95,601527,83.12976782752902,6
0.2,7236,82,601609,83.12961171756253,19
0.2,7237,20,601629,83.12088974854932,14
0.2,7238,90,601719,83.12184003315375,11
0.2,7239,90,601809,83.12279005524861,11
0.2,7240,95,601904,83.12443032730286,7
0.2,7241,88,601992,83.12510356255179,13
0.2,7242,95,602087,83.12674306226701,6
0.2,7243,93,602180,83.12810601877416,8
0.2,7244,92,602272,83.12933057280884,9
0.2,7245,23,602295,83.12103229367928,9
0.2,7246,90,602385,83.12198150959017,11
0.2,7247,96,602481,83.1237582781457,6
0.2,7248,93,602574,83.12512070630432,8
0.2,7249,88,602662,83.12579310344827,13
0.2,7250,76,602738,83.12481037098331,25
0.2,7251,89,602827,83.12562051847766,12
0.2,7252,93,602920,83.12698193850821,8
0.2,7253,95,603015,83.12861869313483,6
0.2,7254,85,603100,83.1288766368022,16
0.2,7255,85,603185,83.12913450937155,16
0.2,7256,94,603279,83.1306324927656,8
0.2,7257,91,603370,83.1317167263709,10
0.2,7258,26,603396,83.12384625981541,7
0.2,7259,96,603492,83.12561983471075,6
0.2,7260,84,603576,83.12574025616307,17
0.2,7261,85,603661,83.12599834756266,17
0.2,7262,94,603755,83.12749552526505,7
0.2,7263,91,603846,83.12857929515418,10
0.2,7264,96,603942,83.13035099793531,6
0.2,7265,92,604034,83.13157170382604,9
0.2,7266,94,604128,83.13306729049127,7
0.2,7267,95,604223,83.13470005503578,6
0.2,7268,83,604306,83.13468152428119,18
0.2,7269,-49,604257,83.11650618982118,12
0.2,7270,95,604352,83.11814055838262,7
0.2,7271,95,604447,83.11977447744775,7
0.2,7272,93,604540,83.12113295751409,8
0.2,7273,92,604632,83.12235358812208,9
0.2,7274,94,604726,83.12384879725086,9
0.2,7275,82,604808,83.1236943375481,19
0.2,7276,92,604900,83.12491411295863,9
0.2,7277,96,604996,83.12668315471284,6
0.2,7278,17,605013,83.1175985712323,16
0.2,7279,95,605108,83.11923076923077,7
0.2,7280,91,605199,83.12031314379892,10
0.2,7281,93,605292,83.12166987091459,8
0.2,7282,94,605386,83.12316353151174,7
0.2,7283,93,605479,83.12451949478309,8
0.2,7284,95,605574,83.12614962251202,7
0.2,7285,89,605663,83.12695580565467,13
0.2,7286,94,605757,83.12844792095513,7
0.2,7287,91,605848,83.12952799121844,11
0.2,7288,25,605873,83.12155302510632,8
0.2,7289,93,605966,83.12290809327847,8
0.2,7290,88,606054,83.12357701275545,14
0.2,7291,25,606079,83.11560614371915,8
0.2,7292,94,606173,83.11709858768683,8
0.2,7293,92,606265,83.11831642445846,9
0.2,7294,94,606359,83.11980808773133,7
0.2,7295,93,606452,83.12116228070175,8
0.2,7296,94,606546,83.12265314512814,7
0.2,7297,19,606565,83.11386681282544,17
0.2,7298,93,606658,83.11522126318674,9
0.2,7299,91,606749,83.11630136986301,10
0.2,7300,26,606775,83.10847829064512,6
0.2,7301,27,606802,83.10079430293071,7
0.2,7302,91,606893,83.10187594139394,10
0.2,7303,88,606981,83.10254654983571,13
0.2,7304,90,607071,83.1034907597536,11
0.2,7305,91,607162,83.10457158499864,10
0.2,7306,96,607258,83.10633638976324,6
0.2,7307,93,607351,83.10769020251779,8
0.2,7308,93,607444,83.10904364482145,9
0.2,7309,92,607536,83.11025991792066,9
0.2,7310,93,607629,83.11161263848994,8
0.2,7311,22,607651,83.10325492341357,12
0.2,7312,94,607745,83.10474497470258,8
0.2,7313,95,607840,83.10637134263057,6
0.2,7314,92,607932,83.1075871496924,9
0.2,7315,94,608026,83.10907599781301,8
0.2,7316,94,608120,83.11056443897772,7
0.2,7317,94,608214,83.11205247335337,7
0.2,7318,95,608309,83.11367673179396,6
0.2,7319,25,608334,83.10573770491803,8
0.2,7320,91,608425,83.10681600874197,10
0.2,7321,94,608519,83.10830374214696,7
0.2,7322,24,608543,83.10023214529565,8
0.2,7323,95,608638,83.10185690879301,9
0.2,7324,94,608732,83.10334470989761,7
0.2,7325,95,608827,83.1049686049686,7
0.2,7326,91,608918,83.10604613074928,10
0.2,7327,95,609013,83.1076692139738,7
0.2,7328,93,609106,83.10901896575248,9
0.2,7329,96,609202,83.11077762619372,6
0.2,7330,85,609287,83.111035329423,16
0.2,7331,93,609380,83.11238406983088,9
0.2,7332,96,609476,83.11414155188872,6
0.2,7333,87,609563,83.11467139350968,14
0.2,7334,95,609658,83.11629175187457,7
0.2,7335,94,609752,83.11777535441658,7
0.2,7336,90,609842,83.11871337058743,11
0.2,7337,93,609935,83.12005996184246,8
0.2,7338,88,610023,83.12072489439979,14
0.2,7339,89,610112,83.12152588555858,13
0.2,7340,90,610202,83.12246287971666,11
0.2,7341,95,610297,83.12408063198039,6
0.2,7342,95,610392,83.12569794361977,7
0.2,7343,88,610480,83.12636165577342,13
0.2,7344,91,610571,83.12743362831858,10
0.2,7345,94,610665,83.12891369452764,8
0.2,7346,93,610758,83.13025724785626,8
0.2,7347,90,610848,83.13119216113228,11
0.2,7348,92,610940,83.1323989658457,9
0.2,7349,93,611033,83.13374149659865,8
0.2,7350,94,611127,83.13521969800027,7
0.2,7351,91,611218,83.13628944504897,10
0.2,7352,93,611311,83.1376308989528,8
0.2,7353,93,611404,83.13897198803372,8
0.2,7354,93,611497,83.14031271244052,8
0.2,7355,94,611591,83.14178901576943,7
0.2,7356,93,611684,83.14312899279598,8
0.2,7357,88,611772,83.1437890731177,13
0.2,7358,94,611866,83.14526430221497,10
0.2,7359,93,611959,83.14660326086957,9
0.2,7360,92,612051,83.14780600461894,9
0.2,7361,93,612144,83.14914425427872,9
0.2,7362,94,612238,83.15061795463805,7
0.2,7363,88,612326,83.15127648017382,13
0.2,7364,92,612418,83.15247793618465,10
0.2,7365,94,612512,83.15395058376323,7
0.2,7366,95,612607,83.15555857201032,7
0.2,7367,94,612701,83.15703040173725,7
0.2,7368,90,612791,83.15795901750576,11
0.2,7369,95,612886,83.159565807327,7
0.2,7370,95,612981,83.16117216117216,6
0.2,7371,93,613074,83.16250678241997,8
0.2,7372,90,613164,83.16343415163435,11
0.2,7373,93,613257,83.16476810414972,8
0.2,7374,88,613345,83.16542372881356,13
0.2,7375,90,613435,83.16635032537961,11
0.2,7376,94,613529,83.16781889657042,9
0.2,7377,94,613623,83.16928706966658,7
0.2,7378,91,613714,83.17034828567557,10
0.2,7379,93,613807,83.17168021680217,8
0.2,7380,25,613832,83.16379894323262,9
0.2,7381,89,613921,83.1645895421295,12
0.2,7382,95,614016,83.16619260463226,7
0.2,7383,84,614100,83.16630552546046,17
0.2,7384,89,614189,83.16709546377793,12
0.2,7385,93,614282,83.16842675331709,8
0.2,7386,93,614375,83.16975768241505,8
0.2,7387,94,614469,83.17122360584732,7
0.2,7388,93,614562,83.17255379618352,8
0.2,7389,91,614653,83.17361299052774,10
0.2,7390,95,614748,83.17521309700987,6
0.2,7391,79,614827,83.17464826839827,23
0.2,7392,94,614921,83.17611253888813,7
0.2,7393,93,615014,83.17744116851502,11
0.2,7394,92,615106,83.17863421230561,9
0.2,7395,91,615197,83.1796917252569,10
0.2,7396,93,615290,83.18101933216168,8
0.2,7397,27,615317,83.17342525006758,6
0.2,7398,91,615408,83.17448303824841,12
0.2,7399,22,615430,83.16621621621621,10
0.2,7400,23,615453,83.15808674503445,10
0.2,7401,93,615546,83.15941637395298,8
0.2,7402,93,615639,83.16074564365798,8
0.2,7403,89,615728,83.16153430578066,12
0.2,7404,92,615820,83.16272788656313,9
0.2,7405,93,615913,83.16405617067242,8
0.2,7406,88,616001,83.16470905899824,13
0.2,7407,93,616094,83.16603671706264,8
0.2,7408,89,616183,83.16682413281144,12
0.2,7409,94,616277,83.16828609986504,8
0.2,7410,24,616301,83.1603022534071,9
0.2,7411,88,616389,83.16095520777118,13
0.2,7412,94,616483,83.16241737488197,7
0.2,7413,95,616578,83.1640140275155,6
0.2,7414,92,616670,83.1652056641942,9
0.2,7415,89,616759,83.16599244875944,12
0.2,7416,92,616851,83.1671834973709,9
0.2,7417,96,616947,83.16891345376112,6
0.2,7418,88,617035,83.16956463135193,13
0.2,7419,95,617130,83.1711590296496,7
0.2,7420,93,617223,83.17248349279073,9
0.2,7421,93,617316,83.17380759902991,10
0.2,7422,93,617409,83.17513134851139,8
0.2,7423,88,617497,83.17578125,13
0.2,7424,93,617590,83.17710437710437,8
0.2,7425,93,617683,83.17842714785887,9
0.2,7426,92,617775,83.17961491854047,10
0.2,7427,94,617869,83.18107162089392,8
0.2,7428,96,617965,83.18279714631848,6
0.2,7429,91,618056,83.18384925975774,10
0.2,7430,91,618147,83.18490109002826,10
0.2,7431,93,618240,83.18622174381055,8
0.2,7432,22,618262,83.17799004439661,11
0.2,7433,94,618356,83.17944578961529,7
0.2,7434,91,618447,83.18049764626765,10
0.2,7435,94,618541,83.1819526627219,7
0.2,7436,94,618635,83.1834072878849,7
0.2,7437,94,618729,83.1848615219145,9
0.2,7438,95,618824,83.18644979163867,6
0.2,7439,86,618910,83.18682795698925,15
0.2,7440,21,618931,83.17847063566725,11
0.2,7441,94,619025,83.17992475141091,7
0.2,7442,90,619115,83.18084105871289,11
0.2,7443,91,619206,83.18189145620634,10
0.2,7444,96,619302,83.18361316319678,6
0.2,7445,88,619390,83.18426000537201,13
0.2,7446,93,619483,83.18557808513495,9
0.2,7447,94,619577,83.18703007518798,7
0.2,7448,90,619667,83.18794469056249,11
0.2,7449,91,619758,83.18899328859061,10
0.2,7450,91,619849,83.19004160515367,10
0.2,7451,95,619944,83.19162640901772,6
0.2,7452,96,620040,83.19334496176036,6
0.2,7453,87,620127,83.19385564797425,14
0.2,7454,92,620219,83.19503688799463,10
0.2,7455,92,620311,83.1962178111588,9
0.2,7456,88,620399,83.19686200885074,13
0.2,7457,93,620492,83.19817645481362,8
0.2,7458,88,620580,83.19882021718729,13
0.2,7459,91,620671,83.19986595174262,10
0.2,7460,91,620762,83.20091140597775,10
0.2,7461,90,620852,83.20182256767623,11
0.2,7462,95,620947,83.2034034570548,8
0.2,7463,19,620966,83.19480171489818,15
0.2,7464,93,621059,83.19611520428667,8
0.2,7465,23,621082,83.18805250468792,10
0.2,7466,17,621099,83.17918842908799,15
0.2,7467,93,621192,83.18050348152116,8
0.2,7468,93,621285,83.18181818181819,8
0.2,7469,92,621377,83.18299866131191,10
0.2,7470,25,621402,83.17521081515191,8
0.2,7471,94,621496,83.17665952890792,7
0.2,7472,-59,621437,83.15763414960524,22
0.2,7473,93,621530,83.15895103023816,8
0.2,7474,90,621620,83.15986622073578,11
0.2,7475,93,621713,83.16118245050829,9
0.2,7476,14,621727,83.15193259328608,18
0.2,7477,87,621814,83.15244717838995,14
0.2,7478,95,621909,83.15403128760529,7
0.2,7479,94,622003,83.15548128342246,7
0.2,7480,89,622092,83.15626253174709,13
0.2,7481,87,622179,83.15677626303128,14
0.2,7482,95,622274,83.15835894694641,7
0.2,7483,95,622369,83.15994120791021,7
0.2,7484,95,622464,83.16152304609219,7
0.2,7485,93,622557,83.1628372962864,8
0.2,7486,93,622650,83.16415119540537,9
0.2,7487,94,622744,83.1655982905983,7
0.2,7488,95,622839,83.16717852850847,6
0.2,7489,24,622863,83.1592790387183,9
0.2,7490,94,622957,83.16072620477907,8
0.2,7491,94,623051,83.16217298451681,7
0.2,7492,93,623144,83.16348592019217,8
0.2,7493,89,623233,83.16426474512944,12
0.2,7494,94,623327,83.1657104736491,7
0.2,7495,93,623420,83.16702241195304,9
0.2,7496,95,623515,83.1686007736428,7
0.2,7497,95,623610,83.17017871432382,6
0.2,7498,96,623706,83.17188958527804,6
0.2,7499,92,623798,83.17306666666667,9
0.2,7500,90,623888,83.17397680309293,11
0.2,7501,94,623982,83.17541988802986,7
0.2,7502,93,624075,83.17672930827669,8
0.2,7503,93,624168,83.17803837953092,8
0.2,7504,93,624261,83.17934710193205,8
0.2,7505,92,624353,83.18052224886758,9
0.2,7506,94,624447,83.18196350073265,7
0.2,7507,90,624537,83.1828716036228,11
0.2,7508,93,624630,83.18417898521774,8
0.2,7509,89,624719,83.1849533954727,12
0.2,7510,91,624810,83.18599387564905,10
0.2,7511,91,624901,83.18703407880724,10
0.2,7512,95,624996,83.18860641554639,6
0.2,7513,93,625089,83.18991216396061,9
0.2,7514,94,625183,83.19135063206919,7
0.2,7515,88,625271,83.1919904204364,13
0.2,7516,88,625359,83.19263003857922,13
0.2,7517,92,625451,83.19380154296356,10
0.2,7518,92,625543,83.19497273573613,9
0.2,7519,92,625635,83.19614361702128,10
0.2,7520,94,625729,83.19758010902805,7
0.2,7521,94,625823,83.19901621909067,7
0.2,7522,92,625915,83.20018609597236,10
0.2,7523,93,626008,83.20148856990963,8
0.2,7524,92,626100,83.20265780730897,9
0.2,7525,92,626192,83.20382673398883,9
0.2,7526,93,626285,83.2051282051282,8
0.2,7527,94,626379,83.20656216790648,7
0.2,7528,95,626474,83.20812856953114,6
0.2,7529,94,626568,83.20956175298805,8
0.2,7530,85,626653,83.20979949541893,16
0.2,7531,91,626744,83.21083377588954,10
0.2,7532,95,626839,83.21239877870703,8
0.2,7533,95,626934,83.2139633660738,6
0.2,7534,95,627029,83.21552753815527,6
0.2,7535,94,627123,83.21695859872611,7
0.2,7536,96,627219,83.21865463712352,6
0.2,7537,88,627307,83.21928893605731,13
0.2,7538,91,627398,83.22032099747977,10
0.2,7539,89,627487,83.22108753315649,12
0.2,7540,95,627582,83.22264951597931,6
0.2,7541,90,627672,83.22354813046937,11
0.2,7542,91,627763,83.22457907994166,10
0.2,7543,89,627852,83.22534464475079,12
0.2,7544,93,627945,83.22664015904573,8
0.2,7545,94,628039,83.22806785051684,8
0.2,7546,95,628134,83.2296276666225,7
0.2,7547,27,628161,83.22217806041336,6
0.2,7548,90,628251,83.22307590409326,11
0.2,7549,94,628345,83.22450331125827,7
0.2,7550,93,628438,83.22579790756191,8
0.2,7551,94,628532,83.22722457627118,7
0.2,7552,95,628627,83.22878326492784,8
0.2,7553,95,628722,83.23034154090548,6
0.2,7554,84,628806,83.23044341495698,18
0.2,7555,90,628896,83.23133933298041,11
0.2,7556,90,628986,83.2322350138944,11
0.2,7557,96,629082,83.2339243186028,6
0.2,7558,95,629177,83.23548088371477,7
0.2,7559,90,629267,83.23637566137566,11
0.2,7560,89,629356,83.23713794471631,12
0.2,7561,93,629449,83.23842898704046,8
0.2,7562,93,629542,83.23971968795452,8
0.2,7563,94,629636,83.24114225277631,8
0.2,7564,82,629718,83.24097818902843,19
0.2,7565,90,629808,83.24187153053133,11
0.2,7566,96,629904,83.24355755253073,6
0.2,7567,94,629998,83.24497885835095,8
0.2,7568,92,630090,83.2461355529132,10
0.2,7569,95,630185,83.24768824306473,6
0.2,7570,87,630272,83.24818385946374,14
0.2,7571,93,630365,83.24947173798203,8
0.2,7572,89,630454,83.25023108411462,12
0.2,7573,15,630469,83.24121996303143,18
0.2,7574,91,630560,83.24224422442244,11
0.2,7575,96,630656,83.24392819429778,6
0.2,7576,84,630740,83.24402797941137,17
0.2,7577,94,630834,83.24544734758511,7
0.2,7578,25,630859,83.23776223776224,8
0.2,7579,96,630955,83.23944591029024,6
0.2,7580,20,630975,83.23110407597942,12
0.2,7581,92,631067,83.23226061725138,9
0.2,7582,94,631161,83.23368060134511,7
0.2,7583,88,631249,83.23430907172995,13
0.2,7584,96,631345,83.23599208965062,6
0.2,7585,94,631439,83.23741102030056,8
0.2,7586,25,631464,83.22973507315145,8
0.2,7587,94,631558,83.23115445440169,7
0.2,7588,94,631652,83.23257346158914,7
0.2,7589,90,631742,83.233465085639,11
0.2,7590,94,631836,83.23488341456988,7
0.2,7591,94,631930,83.23630136986301,7
0.2,7592,93,632023,83.23758725141577,9
0.2,7593,94,632117,83.23900447721886,7
0.2,7594,25,632142,83.23133640552996,8
0.2,7595,95,632237,83.23288572933123,8
0.2,7596,90,632327,83.23377649072002,11
0.2,7597,24,632351,83.22598052118978,11
0.2,7598,93,632444,83.22726674562442,9
0.2,7599,92,632536,83.22842105263157,9
0.2,7600,85,632621,83.22865412445731,19
0.2,7601,91,632712,83.22967640094711,10
0.2,7602,93,632805,83.23096146258057,8
0.2,7603,95,632900,83.23250920568123,6
0.2,7604,93,632993,83.23379355687048,8
0.2,7605,91,633084,83.23481462003681,10
0.2,7606,90,633174,83.23570395688182,11
0.2,7607,94,633268,83.23711882229233,7
0.2,7608,96,633364,83.23879616243921,6
0.2,7609,23,633387,83.23088042049935,11
0.2,7610,89,633476,83.2316384180791,12
0.2,7611,95,633571,83.2331844456122,7
0.2,7612,92,633663,83.23433600420334,9
0.2,7613,92,633755,83.23548726030995,9
0.2,7614,93,633848,83.23676953381484,8
0.2,7615,91,633939,83.23778886554622,10
0.2,7616,94,634033,83.23920178547985,8
0.2,7617,23,634056,83.23129430296666,11
0.2,7618,92,634148,83.23244520278251,9
0.2,7619,84,634232,83.23254593175854,17
0.2,7620,91,634323,83.23356514893058,10
0.2,7621,92,634415,83.23471529782209,9
0.2,7622,92,634507,83.23586514495605,10
0.2,7623,91,634598,83.2368835257083,10
0.2,7624,90,634688,83.23777049180327,11
0.2,7625,94,634782,83.23918174665617,7
0.2,7626,93,634875,83.24046151829029,8
0.2,7627,96,634971,83.24213424226534,6
0.2,7628,95,635066,83.24367544894481,6
0.2,7629,93,635159,83.24495412844037,8
0.2,7630,94,635253,83.24636351723234,8
0.2,7631,94,635347,83.24777253668763,9
0.2,7632,93,635440,83.24905017686362,8
0.2,7633,94,635534,83.25045847524234,7
0.2,7634,94,635628,83.25186640471513,7
0.2,7635,94,635722,83.25327396542693,7
0.2,7636,96,635818,83.25494304046092,6
0.2,7637,90,635908,83.25582613249541,12
0.2,7638,93,636001,83.25710171488414,8
0.2,7639,92,636093,83.25824607329842,9
0.2,7640,90,636183,83.25912838633687,11
0.2,7641,91,636274,83.26014132426066,10
0.2,7642,93,636367,83.26141567447337,9
0.2,7643,89,636456,83.26216640502355,12
0.2,7644,93,636549,83.26344015696533,9
0.2,7645,93,636642,83.26471357572586,8
0.2,7646,93,636735,83.26598666143586,8
0.2,7647,91,636826,83.26699790794979,10
0.2,7648,89,636915,83.26774741796314,12
0.2,7649,93,637008,83.26901960784313,8
0.2,7650,91,637099,83.27003006142988,12
0.2,7651,95,637194,83.27156299006796,6
0.2,7652,93,637287,83.27283418267346,8
0.2,7653,22,637309,83.26482884766135,12
0.2,7654,87,637396,83.2653167864141,14
0.2,7655,89,637485,83.266065830721,13
0.2,7656,95,637580,83.26759827608724,6
0.2,7657,96,637676,83.2692609036302,6
0.2,7658,95,637771,83.2707925316621,6
0.2,7659,91,637862,83.27180156657964,10
0.2,7660,94,637956,83.27320193186269,7
0.2,7661,92,638048,83.27434090315845,10
0.2,7662,92,638140,83.27547957718909,9
0.2,7663,95,638235,83.27700939457202,6
0.2,7664,23,638258,83.26914546640575,10
0.2,7665,91,638349,83.27015392642838,10
0.2,7666,95,638444,83.27168383983305,7
0.2,7667,96,638540,83.27334376630151,6
0.2,7668,96,638636,83.27500325987742,6
0.2,7669,93,638729,83.27627118644068,8
0.2,7670,96,638825,83.27792986572807,6
0.2,7671,95,638920,83.27945776850886,6
0.2,7672,90,639010,83.28033363742995,11
0.2,7673,93,639103,83.28160020849622,8
0.2,7674,94,639197,83.282996742671,7
0.2,7675,18,639215,83.27449192287649,15
0.2,7676,87,639302,83.27497720463722,14
0.2,7677,96,639398,83.27663454024486,6
0.2,7678,89,639487,83.27737986717021,12
0.2,7679,92,639579,83.278515625,9
0.2,7680,91,639670,83.2795208957167,10
0.2,7681,94,639764,83.28091642801354,8
0.2,7682,88,639852,83.28153065208903,13
0.2,7683,90,639942,83.2824049973972,12
0.2,7684,85,640027,83.28262849707222,16
0.2,7685,23,640050,83.27478532396565,9
0.2,7686,84,640134,83.27487966697021,17
0.2,7687,90,640224,83.27575442247658,11
0.2,7688,92,640316,83.27688906229679,9
0.2,7689,91,640407,83.2778933680104,10
0.2,7690,88,640495,83.27850734624886,13
0.2,7691,95,640590,83.28003120124805,8
0.2,7692,96,640686,83.28168464838164,6
0.2,7693,94,640780,83.28307772290096,7
0.2,7694,92,640872,83.28421052631579,10
0.2,7695,24,640896,83.27650727650727,9
0.2,7696,94,640990,83.27790048070676,7
0.2,7697,94,641084,83.27929332294103,7
0.2,7698,95,641179,83.2808156903494,6
0.2,7699,90,641269,83.28168831168831,11
0.2,7700,90,641359,83.28256070640177,11
0.2,7701,94,641453,83.28395222020255,7
0.2,7702,92,641545,83.28508373361028,9
0.2,7703,95,641640,83.28660436137072,6
0.2,7704,92,641732,83.28773523685918,9
0.2,7705,93,641825,83.28899558785362,9
0.2,7706,89,641914,83.2897366030881,12
0.2,7707,93,642007,83.29099636741049,9
0.2,7708,92,642099,83.29212608639253,9
0.2,7709,21,642120,83.284046692607,13
0.2,7710,96,642216,83.28569575930489,6
0.2,7711,94,642310,83.28708506224066,10
0.2,7712,90,642400,83.28795539997407,11
0.2,7713,93,642493,83.28921441534872,8
0.2,7714,90,642583,83.2900842514582,11
0.2,7715,93,642676,83.29134266459306,8
0.2,7716,26,642702,83.28391862122587,7
0.2,7717,89,642791,83.2846592381446,14
0.2,7718,93,642884,83.28591786500841,8
0.2,7719,94,642978,83.28730569948186,7
0.2,7720,94,643072,83.28869317445927,8
0.2,7721,91,643163,83.28969178969179,10
0.2,7722,95,643258,83.29120807976174,7
0.2,7723,96,643354,83.2928534438115,6
0.2,7724,86,643440,83.29320388349515,15
0.2,7725,94,643534,83.29458969712658,7
0.2,7726,91,643625,83.29558690306716,10
0.2,7727,92,643717,83.2967132505176,9
0.2,7728,93,643810,83.29796868935179,9
0.2,7729,91,643901,83.29896507115136,10
0.2,7730,95,643996,83.30047859267883,6
0.2,7731,93,644089,83.30173305742369,8
0.2,7732,91,644180,83.30272856588645,10
0.2,7733,92,644272,83.30385311611067,9
0.2,7734,89,644361,83.30458952811894,12
0.2,7735,90,644451,83.3054550155119,11
0.2,7736,86,644537,83.30580328292619,15
0.2,7737,94,644631,83.30718531920392,7
0.2,7738,94,644725,83.3085669983202,7
0.2,7739,94,644819,83.30994832041344,7
0.2,7740,19,644838,83.30164061490764,16
0.2,7741,90,644928,83.30250581245156,11
0.2,7742,94,645022,83.30388738215161,7
0.2,7743,96,645118,83.30552685950413,6
0.2,7744,95,645213,83.30703679793415,6
0.2,7745,91,645304,83.30802995094243,10
0.2,7746,91,645395,83.30902284755389,10
0.2,7747,88,645483,83.30962829117192,13
0.2,7748,88,645571,83.31023357852627,14
0.2,7749,92,645663,83.31135483870968,9
0.2,7750,95,645758,83.31286285640563,6
0.2,7751,89,645847,83.31359649122807,12
0.2,7752,90,645937,83.31445891912809,11
0.2,7753,95,646032,83.31596595305649,7
0.2,7754,94,646126,83.31734364925855,8
0.2,7755,92,646218,83.31846312532232,9
0.2,7756,96,646314,83.32009797602166,6
0.2,7757,90,646404,83.32095901005414,11
0.2,7758,81,646485,83.32065987885036,20
0.2,7759,91,646576,83.32164948453608,10
0.2,7760,90,646666,83.32250998582657,11
0.2,7761,91,646757,83.32349909817057,10
0.2,7762,92,646849,83.32461677186654,10
0.2,7763,91,646940,83.32560535806286,10
0.2,7764,94,647034,83.3269800386349,7
0.2,7765,93,647127,83.32822559876384,10
0.2,7766,94,647221,83.32959958800052,7
0.2,7767,91,647312,83.33058702368692,10
0.2,7768,92,647404,83.33170292186897,9
0.2,7769,91,647495,83.33268983268984,10
0.2,7770,94,647589,83.33406254021361,7
0.2,7771,92,647681,83.3351775604735,9
0.2,7772,95,647776,83.33667824520776,7
0.2,7773,23,647799,83.3289169024955,10
0.2,7774,91,647890,83.3299035369775,10
0.2,7775,92,647982,83.33101851851852,9
0.2,7776,89,648071,83.33174746046033,12
0.2,7777,89,648160,83.33247621496528,12
0.2,7778,91,648251,83.333461884561,10
0.2,7779,94,648345,83.33483290488432,8
0.2,7780,93,648438,83.33607505462022,8
0.2,7781,27,648465,83.32883577486507,6
0.2,7782,95,648560,83.3303353462675,7
0.2,7783,91,648651,83.3313206577595,10
0.2,7784,92,648743,83.33243416827231,9
0.2,7785,87,648830,83.33290521448754,14
0.2,7786,92,648922,83.33401823552074,9
0.2,7787,92,649014,83.3351309707242,9
0.2,7788,94,649108,83.33650019257928,7
0.2,7789,96,649204,83.33812580231066,6
0.2,7790,22,649226,83.33025285585933,11
0.2,7791,95,649321,83.33175051334702,6
0.2,7792,94,649415,83.33311946618761,7
0.2,7793,94,649509,83.33448806774442,8
0.2,7794,94,649603,83.33585631815266,8
0.2,7795,95,649698,83.33735248845562,6
0.2,7796,94,649792,83.33872002052071,7
0.2,7797,92,649884,83.33983072582714,9
0.2,7798,21,649905,83.33183741505322,12
0.2,7799,92,649997,83.33294871794872,9
0.2,7800,25,650022,83.32547109344956,9
0.2,7801,95,650117,83.32696744424507,6
0.2,7802,93,650210,83.32820709983339,10
0.2,7803,94,650304,83.32957457713992,7
0.2,7804,87,650391,83.33004484304932,14
0.2,7805,88,650479,83.33064309505508,15
0.2,7806,93,650572,83.33188164467785,8
0.2,7807,27,650599,83.32466700819673,6
0.2,7808,94,650693,83.32603406326034,7
0.2,7809,27,650720,83.31882202304737,6
0.2,7810,88,650808,83.31942132889515,13
0.2,7811,96,650904,83.321044546851,6
0.2,7812,95,650999,83.32253935748112,6
0.2,7813,27,651026,83.31533145636038,6
0.2,7814,92,651118,83.31644273832373,11
0.2,7815,82,651200,83.31627430910952,19
0.2,7816,83,651283,83.3162338493028,19
0.2,7817,92,651375,83.31734458940906,9
0.2,7818,92,651467,83.31845504540223,9
0.2,7819,93,651560,83.31969309462916,8
0.2,7820,92,651652,83.32080296637258,9
0.2,7821,91,651743,83.3217847097929,10
0.2,7822,93,651836,83.32302185862201,8
0.2,7823,89,651925,83.32374744376278,13
0.2,7824,86,652011,83.324089456869,15
0.2,7825,95,652106,83.32558139534883,8
0.2,7826,91,652197,83.32656190111153,10
0.2,7827,23,652220,83.31885539090445,10
0.2,7828,92,652312,83.31996423553456,9
0.2,7829,91,652403,83.32094508301405,12
0.2,7830,95,652498,83.322436470438,6
0.2,7831,96,652594,83.32405515832482,7
0.2,7832,94,652688,83.325418102898,7
0.2,7833,94,652782,83.32678069951494,7
0.2,7834,94,652876,83.32814294830887,7
0.2,7835,94,652970,83.32950484941297,7
0.2,7836,88,653058,83.33010080387903,13
0.2,7837,92,653150,83.33120694054605,9
0.2,7838,95,653245,83.3326954968746,6
0.2,7839,91,653336,83.33367346938776,10
0.2,7840,93,653429,83.33490626195638,8
0.2,7841,92,653521,83.33601122162713,9
0.2,7842,93,653614,83.33724340175954,9
0.2,7843,24,653638,83.32967873533912,9
0.2,7844,94,653732,83.33103887826641,8
0.2,7845,92,653824,83.33214376752485,9
0.2,7846,93,653917,83.33337581241238,8
0.2,7847,95,654012,83.3348623853211,7
0.2,7848,95,654107,83.33634857943687,7
0.2,7849,93,654200,83.3375796178344,10
0.2,7850,92,654292,83.33868297032225,9
0.2,7851,14,654306,83.32985226693836,18
0.2,7852,94,654400,83.33121100216478,7
0.2,7853,95,654495,83.33269671504965,7
0.2,7854,94,654589,83.33405474220243,8
0.2,7855,92,654681,83.33515784114053,9
0.2,7856,-51,654630,83.31806032836961,15
0.2,7857,94,654724,83.31941969966913,7
0.2,7858,91,654815,83.32039699707342,10
0.2,7859,93,654908,83.32162849872773,8
0.2,7860,96,655004,83.32324131789849,9
0.2,7861,92,655096,83.3243449503943,9
0.2,7862,94,655190,83.32570265801857,7
0.2,7863,89,655279,83.32642421159716,12
0.2,7864,95,655374,83.32790845518119,7
0.2,7865,85,655459,83.3281210272057,16
0.2,7866,93,655552,83.32935045125207,8
0.2,7867,90,655642,83.3301982714794,11
0.2,7868,95,655737,83.33168128097599,6
0.2,7869,87,655824,83.33214739517153,14
0.2,7870,93,655917,83.33337568288654,10
0.2,7871,94,656011,83.3347306910569,7
0.2,7872,92,656103,83.33583132224057,9
0.2,7873,94,656197,83.33718567437136,7
0.2,7874,84,656281,83.33726984126984,17
0.2,7875,88,656369,83.33786185881158,13
0.2,7876,92,656461,83.33896153357877,9
0.2,7877,92,656553,83.34006092916984,10
0.2,7878,90,656643,83.34090620637137,11
0.2,7879,91,656734,83.34187817258884,10
0.2,7880,93,656827,83.34310366704733,8
0.2,7881,95,656922,83.34458259325045,8
0.2,7882,93,657015,83.34580743371812,8
0.2,7883,92,657107,83.34690512430238,9
0.2,7884,96,657203,83.34850982878883,6
0.2,7885,94,657297,83.34986051230028,7
0.2,7886,94,657391,83.3512108533029,7
0.2,7887,95,657486,83.35268762677485,6
0.2,7888,96,657582,83.35429078463683,7
0.2,7889,94,657676,83.35564005069709,7
0.2,7890,87,657763,83.35610188822709,14
0.2,7891,91,657854,83.35707045108971,10
0.2,7892,93,657947,83.358292157608,9
0.2,7893,92,658039,83.35938687610843,9
0.2,7894,82,658121,83.35921469284357,19
0.2,7895,94,658215,83.36056231003039,7
0.2,7896,88,658303,83.36114980372294,13
0.2,7897,88,658391,83.36173714864523,13
0.2,7898,94,658485,83.36308393467527,7
0.2,7899,-119,658366,83.33746835443038,14
0.2,7900,93,658459,83.33869130489812,9
0.2,7901,94,658553,83.34004049607694,8
0.2,7902,94,658647,83.34138934581804,7
0.2,7903,91,658738,83.34235829959515,10
0.2,7904,92,658830,83.34345351043643,9
0.2,7905,86,658916,83.34378952694156,15
0.2,7906,95,659011,83.34526369040091,7
0.2,7907,92,659103,83.34635811836115,9
0.2,7908,19,659122,83.33822227841699,13
0.2,7909,91,659213,83.33919089759797,10
0.2,7910,92,659305,83.34028567816964,9
0.2,7911,94,659399,83.34163296258848,7
0.2,7912,91,659490,83.3426007835208,11
0.2,7913,91,659581,83.34356835986858,10
0.2,7914,96,659677,83.34516740366394,8
0.2,7915,92,659769,83.34626073774633,9
0.2,7916,94,659863,83.34760641657194,7
0.2,7917,96,659959,83.34920434453144,6
0.2,7918,23,659982,83.3415835332744,9
0.2,7919,90,660072,83.34242424242424,11
0.2,7920,92,660164,83.34351723267264,9
0.2,7921,89,660253,83.34423125473366,16
0.2,7922,95,660348,83.34570238546006,8
0.2,7923,90,660438,83.34654215042907,11
0.2,7924,95,660533,83.34801261829654,6
0.2,7925,90,660623,83.34885187988897,11
0.2,7926,27,660650,83.3417434086035,6
0.2,7927,92,660742,83.3428355196771,9
0.2,7928,93,660835,83.34405347458696,8
0.2,7929,93,660928,83.3452711223203,9
0.2,7930,93,661021,83.34648846299332,8
0.2,7931,95,661116,83.34795763993948,6
0.2,7932,92,661208,83.34904827933947,9
0.2,7933,24,661232,83.34156793546761,8
0.2,7934,91,661323,83.34253308128544,10
0.2,7935,92,661415,83.34362399193549,10
0.2,7936,94,661509,83.34496661207005,7
0.2,7937,96,661605,83.34656084656085,6
0.2,7938,89,661694,83.34727295629172,12
0.2,7939,85,661779,83.34748110831234,16
0.2,7940,93,661872,83.34869663770306,8
0.2,7941,91,661963,83.34966003525561,10
0.2,7942,94,662057,83.35100088127912,8
0.2,7943,89,662146,83.35171198388721,12
0.2,7944,93,662239,83.3529263687854,10
0.2,7945,95,662334,83.3543921469922,7
0.2,7946,95,662429,83.35585755631055,8
0.2,7947,92,662521,83.35694514343231,9
0.2,7948,91,662612,83.35790665492515,10
0.2,7949,93,662705,83.35911949685534,8
0.2,7950,93,662798,83.36033203370646,9
0.2,7951,12,662810,83.35135814889335,21
0.2,7952,94,662904,83.35269709543569,7
0.2,7953,91,662995,83.35365853658537,10
0.2,7954,91,663086,83.35461973601508,10
0.2,7955,94,663180,83.35595776772247,8
0.2,7956,86,663266,83.35629005906749,15
0.2,7957,96,663362,83.3578788640362,7
0.2,7958,95,663457,83.35934162583239,6
0.2,7959,95,663552,83.3608040201005,6
0.2,7960,92,663644,83.36188920989825,9
0.2,7961,88,663732,83.36247174076865,13
0.2,7962,92,663824,83.36355644857466,9
0.2,7963,94,663918,83.36489201406329,7
0.2,7964,93,664011,83.36610169491526,8
0.2,7965,92,664103,83.36718553853879,9
0.2,7966,93,664196,83.36839462783983,8
0.2,7967,92,664288,83.36947791164658,9
0.2,7968,95,664383,83.37093738235663,6
0.2,7969,95,664478,83.3723964868256,6
0.2,7970,89,664567,83.37310249654999,12
0.2,7971,19,664586,83.36502759658806,14
0.2,7972,96,664682,83.36661231656842,7
0.2,7973,94,664776,83.36794582392777,7
0.2,7974,14,664790,83.35924764890282,18
0.2,7975,95,664885,83.36070712136409,7
0.2,7976,20,664905,83.35276419706656,12
0.2,7977,86,664991,83.35309601403861,15
0.2,7978,94,665085,83.35443037974683,7
0.2,7979,88,665173,83.35501253132833,13
0.2,7980,91,665264,83.35597042977071,10
0.2,7981,95,665359,83.35742921573541,7
0.2,7982,96,665455,83.35901290241763,7
0.2,7983,89,665544,83.35971943887776,12
0.2,7984,89,665633,83.36042579837195,12
0.2,7985,91,665724,83.36138241923366,10
0.2,7986,94,665818,83.36271441091775,7
0.2,7987,94,665912,83.36404606910365,7
0.2,7988,19,665931,83.35598948554262,13
0.2,7989,93,666024,83.35719649561952,8
0.2,7990,94,666118,83.35852834438744,8
0.2,7991,90,666208,83.35935935935936,11
0.2,7992,93,666301,83.36056549480796,8
0.2,7993,91,666392,83.36152114085564,10
0.2,7994,94,666486,83.36285178236398,8
0.2,7995,79,666565,83.36230615307653,22
0.2,7996,86,666651,83.36263598849568,15
0.2,7997,94,666745,83.36396599149788,7
0.2,7998,23,666768,83.35641955244405,10
0.2,7999,91,666859,83.357375,10
0.2,8000,87,666946,83.3578302712161,14
0.2,8001,95,667041,83.35928517870532,10
0.2,8002,90,667131,83.36011495689117,11
0.2,8003,-49,667082,83.34357821089455,13
0.2,8004,95,667177,83.34503435352904,6
0.2,8005,93,667270,83.34624031976018,8
0.2,8006,94,667364,83.34757087548395,7
0.2,8007,90,667454,83.3484015984016,13
0.2,8008,22,667476,83.34074166562617,10
0.2,8009,96,667572,83.34232209737827,6
0.2,8010,95,667667,83.34377730620398,7
0.2,8011,93,667760,83.34498252621069,8
0.2,8012,23,667783,83.33745164108323,10
0.2,8013,25,667808,83.33017219865236,8
0.2,8014,94,667902,83.33150343106675,7
0.2,8015,94,667996,83.33283433133732,7
0.2,8016,96,668092,83.33441436946488,6
0.2,8017,86,668178,83.33474681965578,15
0.2,8018,93,668271,83.33595211372989,8
0.2,8019,96,668367,83.33753117206983,6
0.2,8020,87,668454,83.33798778207206,14
0.2,8021,91,668545,83.33894290700573,10
0.2,8022,-49,668496,83.32244796210894,13
0.2,8023,93,668589,83.32365403788634,8
0.2,8024,93,668682,83.32485981308412,8
0.2,8025,94,668776,83.32618988288064,8
0.2,8026,91,668867,83.32714588264606,10
0.2,8027,93,668960,83.32835077229696,8
0.2,8028,93,669053,83.32955536181342,8
0.2,8029,89,669142,83.33026151930261,12
0.2,8030,94,669236,83.33159008840742,8
0.2,8031,91,669327,83.33254482071713,10
0.2,8032,90,669417,83.33337482883107,12
0.2,8033,94,669511,83.33470251431416,8
0.2,8034,91,669602,83.33565650280025,10
0.2,8035,93,669695,83.33685913389746,8
0.2,8036,93,669788,83.33806146572104,9
0.2,8037,92,669880,83.3391390893257,9
0.2,8038,87,669967,83.33959447692499,14
0.2,8039,90,670057,83.34042288557214,11
0.2,8040,95,670152,83.34187290138043,7
0.2,8041,90,670242,83.34270082069138,11
0.2,8042,87,670329,83.343155538978,14
0.2,8043,91,670420,83.34410740924913,10
0.2,8044,93,670513,83.34530764449968,9
0.2,8045,89,670602,83.34601043997017,12
0.2,8046,95,670697,83.34745868025351,7
0.2,8047,93,670790,83.34865805168987,9
0.2,8048,83,670873,83.34861473474966,19
0.2,8049,92,670965,83.34968944099379,9
0.2,8050,90,671055,83.35051546391753,11
0.2,8051,91,671146,83.3514654744163,10
0.2,8052,94,671240,83.3527877809512,8
0.2,8053,24,671264,83.34541842562702,9
0.2,8054,94,671358,83.34674115456238,7
0.2,8055,88,671446,83.34731876861966,14
0.2,8056,92,671538,83.34839270199826,9
0.2,8057,92,671630,83.34946636882601,9
0.2,8058,94,671724,83.35078793895025,7
0.2,8059,93,671817,83.35198511166253,8
0.2,8060,96,671913,83.35355414960922,6
0.2,8061,89,672002,83.35425452741255,12
0.2,8062,92,672094,83.35532680143866,9
0.2,8063,90,672184,83.3561507936508,11
0.2,8064,94,672278,83.3574705517669,7
0.2,8065,94,672372,83.35878998264319,7
0.2,8066,94,672466,83.3601090864014,7
0.2,8067,93,672559,83.36130391670798,8
0.2,8068,94,672653,83.36262238195563,7
0.2,8069,21,672674,83.3548946716233,12
0.2,8070,93,672767,83.35608970387808,8
0.2,8071,91,672858,83.35703666997027,11
0.2,8072,24,672882,83.34968413229282,8
0.2,8073,94,672976,83.35100322021303,7
0.2,8074,82,673058,83.3508359133127,20
0.2,8075,92,673150,83.35190688459633,9
0.2,8076,91,673241,83.35285378234494,10
0.2,8077,89,673330,83.35355285961872,12
0.2,8078,85,673415,83.35375665305112,16
0.2,8079,96,673511,83.35532178217822,6
0.2,8080,95,673606,83.35676277688405,6
0.2,8081,90,673696,83.35758475624846,11
0.2,8082,94,673790,83.3589013979958,7
0.2,8083,92,673882,83.35997031172687,9
0.2,8084,91,673973,83.360915275201,10
0.2,8085,93,674066,83.36210734603017,8
0.2,8086,93,674159,83.36329912204774,9
0.2,8087,89,674248,83.36399604352127,12
0.2,8088,96,674344,83.36555816540982,6
0.2,8089,90,674434,83.3663782447466,11
0.2,8090,92,674526,83.36744530960327,9
0.2,8091,93,674619,83.36863568956994,8
0.2,8092,94,674713,83.36994933893489,7
0.2,8093,91,674804,83.37089201877934,10
0.2,8094,22,674826,83.3633106856084,11
0.2,8095,94,674920,83.36462450592886,7
0.2,8096,95,675015,83.36606150426084,9
0.2,8097,94,675109,83.36737466040998,8
0.2,8098,93,675202,83.36856402024941,8
0.2,8099,95,675297,83.37,6
0.2,8100,26,675323,83.36291815825207,7
0.2,8101,90,675413,83.36373734880276,11
0.2,8102,89,675502,83.36443292607676,12
0.2,8103,86,675588,83.36475814412636,15
0.2,8104,96,675684,83.36631708821714,6
0.2,8105,92,675776,83.36738218603503,9
0.2,8106,21,675797,83.35968915751819,11
0.2,8107,92,675889,83.36075481006414,9
0.2,8108,93,675982,83.36194351954619,8
0.2,8109,89,676071,83.36263871763255,12
0.2,8110,94,676165,83.36395019109851,7
0.2,8111,96,676261,83.36550788954635,6
0.2,8112,91,676352,83.36644890915814,11
0.2,8113,88,676440,83.36701996549175,13
0.2,8114,94,676534,83.3683302526186,7
0.2,8115,88,676622,83.36890093642188,13
0.2,8116,81,676703,83.36860909202908,20
0.2,8117,94,676797,83.369918699187,7
0.2,8118,94,676891,83.37122798374185,7
0.2,8119,92,676983,83.37229064039408,10
0.2,8120,27,677010,83.36534909493905,7
0.2,8121,95,677105,83.36678158089141,7
0.2,8122,92,677197,83.36784439246584,9
0.2,8123,95,677292,83.36927621861152,7
0.2,8124,23,677315,83.36184615384616,10
0.2,8125,94,677409,83.36315530396259,7
0.2,8126,90,677499,83.3639719453673,11
0.2,8127,91,677590,83.36491141732283,10
0.2,8128,95,677685,83.36634272358224,6
0.2,8129,27,677712,83.35940959409594,6
0.2,8130,94,677806,83.36071823883901,7
0.2,8131,27,677833,83.35378750614855,6
0.2,8132,93,677926,83.35497356449035,9
0.2,8133,91,678017,83.35591344971724,10
0.2,8134,87,678104,83.35636140135219,14
0.2,8135,91,678195,83.35730088495575,10
0.2,8136,88,678283,83.35787145139486,13
0.2,8137,91,678374,83.35881051855493,10
0.2,8138,93,678467,83.35999508539133,8
0.2,8139,92,678559,83.36105651105652,9
0.2,8140,93,678652,83.36224051099373,8
0.2,8141,90,678742,83.36305576025546,11
0.2,8142,92,678834,83.36411641901019,9
0.2,8143,95,678929,83.36554518664047,7
0.2,8144,93,679022,83.36672805402087,8
0.2,8145,89,679111,83.36741959243801,12
0.2,8146,91,679202,83.36835645022708,10
0.2,8147,27,679229,83.3614383897889,7
0.2,8148,96,679325,83.36298932384342,6
0.2,8149,94,679419,83.36429447852761,7
0.2,8150,95,679514,83.36572199730094,6
0.2,8151,94,679608,83.36702649656526,7
0.2,8152,95,679703,83.36845333006255,7
0.2,8153,95,679798,83.36987981358843,6
0.2,8154,91,679889,83.37081545064378,10
0.2,8155,92,679981,83.37187346738597,9
0.2,8156,94,680075,83.3731764128969,7
0.2,8157,94,680169,83.37447903898014,7
0.2,8158,96,680265,83.37602647383258,6
0.2,8159,94,680359,83.37732843137255,9
0.2,8160,89,680448,83.37801739982845,12
0.2,8161,92,680540,83.37907375643225,9
0.2,8162,90,680630,83.3798848462575,11
0.2,8163,87,680717,83.38032827045566,14
0.2,8164,91,680808,83.38126148193508,10
0.2,8165,91,680899,83.38219446485428,10
0.2,8166,94,680993,83.3834945512428,7
0.2,8167,24,681017,83.37622428991185,10
0.2,8168,95,681112,83.37764720284001,6
0.2,8169,82,681194,83.37747858017136,19
0.2,8170,92,681286,83.37853383918737,9
0.2,8171,94,681380,83.37983357807147,8
0.2,8172,94,681474,83.3811329988988,7
0.2,8173,93,681567,83.3823097626621,8
0.2,8174,94,681661,83.38360856269114,7
0.2,8175,93,681754,83.38478473581213,8
0.2,8176,94,681848,83.38608291549468,7
0.2,8177,95,681943,83.38750305698214,8
0.2,8178,89,682032,83.38818926519134,12
0.2,8179,96,682128,83.38973105134474,6
0.2,8180,94,682222,83.39102799168806,7
0.2,8181,92,682314,83.39208017599609,9
0.2,8182,93,682407,83.3932543077111,8
0.2,8183,23,682430,83.38587487781037,10
0.2,8184,96,682526,83.38741600488699,6
0.2,8185,87,682613,83.38785731737111,14
0.2,8186,94,682707,83.3891535360938,7
0.2,8187,93,682800,83.39032730825599,8
0.2,8188,96,682896,83.39186713884479,6
0.2,8189,89,682985,83.3925518925519,12
0.2,8190,93,683078,83.3937248199243,10
0.2,8191,13,683091,83.3851318359375,19
0.2,8192,91,683182,83.38606127181741,10
0.2,8193,95,683277,83.38747864290944,7
0.2,8194,93,683370,83.38865161683954,8
0.2,8195,93,683463,83.3898243045388,8
0.2,8196,24,683487,83.38257899231427,10
0.2,8197,88,683575,83.38314222981215,13
0.2,8198,88,683663,83.38370532991829,13
0.2,8199,90,683753,83.38451219512196,11
0.2,8200,22,683775,83.37702719180588,11
0.2,8201,94,683869,83.3783223603999,7
0.2,8202,94,683963,83.37961721321467,7
0.2,8203,92,684055,83.38066796684544,9
0.2,8204,95,684150,83.38208409506399,6
0.2,8205,92,684242,83.38313429198148,10
0.2,8206,92,684334,83.38418423297185,9
0.2,8207,95,684429,83.38559941520468,6
0.2,8208,95,684524,83.38701425264954,6
0.2,8209,89,684613,83.38769792935445,12
0.2,8210,95,684708,83.38911216660577,6
0.2,8211,23,684731,83.38175840233804,9
0.2,8212,94,684825,83.38305126019725,8
0.2,8213,89,684914,83.3837350864378,14
0.2,8214,89,685003,83.38441874619598,12
0.2,8215,94,685097,83.38571080817917,7
0.2,8216,25,685122,83.37860533041255,8
0.2,8217,95,685217,83.3800194694573,6
0.2,8218,93,685310,83.38118992578173,8
0.2,8219,95,685405,83.38260340632604,8
0.2,8220,24,685429,83.37538012407249,10
0.2,8221,85,685514,83.3755777183167,16
0.2,8222,91,685605,83.37650492520977,11
0.2,8223,87,685692,83.37694552529183,14
0.2,8224,95,685787,83.37835866261398,6
0.2,8225,27,685814,83.37150498419645,6
0.2,8226,95,685909,83.37291843928529,6
0.2,8227,81,685990,83.37263004375303,20
0.2,8228,93,686083,83.3737999756957,9
0.2,8229,94,686177,83.37509113001215,7
0.2,8230,94,686271,83.37638197059896,7
0.2,8231,93,686364,83.37755102040816,8
0.2,8232,91,686455,83.3784768614114,10
0.2,8233,96,686551,83.38000971581249,6
0.2,8234,92,686643,83.38105646630237,9
0.2,8235,95,686738,83.38246721709568,7
0.2,8236,91,686829,83.38339201165473,11
0.2,8237,23,686852,83.37606215100753,10
0.2,8238,93,686945,83.37723024638912,8
0.2,8239,92,687037,83.37827669902913,9
0.2,8240,90,687127,83.37908020871254,11
0.2,8241,95,687222,83.38049017228828,7
0.2,8242,81,687303,83.38020138299163,20
0.2,8243,90,687393,83.38100436681222,11
0.2,8244,94,687487,83.38229229836264,7
0.2,8245,95,687582,83.383701188455,7
0.2,8246,93,687675,83.38486722444526,8
0.2,8247,91,687766,83.38579049466537,10
0.2,8248,93,687859,83.38695599466602,8
0.2,8249,93,687952,83.3881212121212,8
0.2,8250,91,688043,83.38904375227246,11
0.2,8251,95,688138,83.3904507998061,6
0.2,8252,85,688223,83.39064582576033,16
0.2,8253,90,688313,83.39144657135934,11
0.2,8254,94,688407,83.39273167777105,8
0.2,8255,96,688503,83.39425872093024,6
0.2,8256,91,688594,83.3951798474022,10
0.2,8257,84,688678,83.39525308791475,17
0.2,8258,90,688768,83.39605279089479,11
0.2,8259,93,688861,83.39721549636803,8
0.2,8260,94,688955,83.39849897106888,7
0.2,8261,92,689047,83.39954006293875,12
0.2,8262,90,689137,83.40033885997822,11
0.2,8263,87,689224,83.40077444336883,14
0.2,8264,90,689314,83.40157289776164,11
0.2,8265,96,689410,83.40309702395355,6
0.2,8266,22,689432,83.39566952945445,10
0.2,8267,93,689525,83.39683115626512,8
0.2,8268,91,689616,83.39775063490144,10
0.2,8269,94,689710,83.39903264812575,7
0.2,8270,95,689805,83.40043525571274,6
0.2,8271,25,689830,83.3933752417795,8
0.2,8272,96,689926,83.39489906926146,6
0.2,8273,85,690011,83.39509306260575,16
0.2,8274,93,690104,83.39625377643505,8
0.2,8275,95,690199,83.39765587240213,6
0.2,8276,94,690293,83.3989368128549,8
0.2,8277,-53,690240,83.38245953128775,16
0.2,8278,93,690333,83.3836212102911,9
0.2,8279,93,690426,83.38478260869566,8
0.2,8280,94,690520,83.38606448496559,7
0.2,8281,89,690609,83.38674233276986,12
0.2,8282,-51,690558,83.37051792828686,15
0.2,8283,95,690653,83.37192177691936,6
0.2,8284,-45,690608,83.35642727821364,9
0.2,8285,94,690702,83.35771180304127,7
0.2,8286,93,690795,83.35887534692893,8
0.2,8287,87,690882,83.35931467181467,14
0.2,8288,94,690976,83.36059838339969,7
0.2,8289,-48,690928,83.34475271411338,12
0.2,8290,89,691017,83.34543480882886,12
0.2,8291,95,691112,83.34684032802701,6
0.2,8292,91,691203,83.34776317376101,11
0.2,8293,96,691299,83.3492886423921,6
0.2,8294,93,691392,83.350452079566,8
0.2,8295,96,691488,83.3519768563163,6
0.2,8296,20,691508,83.34434132819091,12
0.2,8297,18,691526,83.33646661846228,15
0.2,8298,94,691620,83.33775153632968,7
0.2,8299,89,691709,83.33843373493976,12
0.2,8300,93,691802,83.3395976388387,11
0.2,8301,87,691889,83.34003854492893,14
0.2,8302,92,691981,83.34108153679394,9
0.2,8303,92,692073,83.34212427745665,9
0.2,8304,95,692168,83.34352799518362,6
0.2,8305,91,692259,83.34444979532867,10
0.2,8306,94,692353,83.3457325147466,7
0.2,8307,87,692440,83.34617236398653,14
0.2,8308,89,692529,83.3468528102058,12
0.2,8309,94,692623,83.34813477737666,7
0.2,8310,95,692718,83.34953675851281,6
0.2,8311,93,692811,83.35069778633301,8
0.2,8312,96,692907,83.35221941537351,6
0.2,8313,91,692998,83.35313928313688,10
0.2,8314,85,693083,83.35333734215274,16
0.2,8315,91,693174,83.35425685425686,10
0.2,8316,90,693264,83.35505590958279,11
0.2,8317,91,693355,83.35597499398894,10
0.2,8318,94,693449,83.35725447770164,7
0.2,8319,92,693541,83.35829326923077,9
0.2,8320,88,693629,83.35885109962744,13
0.2,8321,26,693655,83.35195866378274,7
0.2,8322,89,693744,83.35263727021507,12
0.2,8323,91,693835,83.35355598270063,10
0.2,8324,93,693928,83.35471471471472,8
0.2,8325,-48,693880,83.33893826567379,12
0.2,8326,93,693973,83.34009847484089,8
0.2,8327,90,694063,83.34089817483189,11
0.2,8328,85,694148,83.34109737063272,17
0.2,8329,95,694243,83.34249699879952,6
0.2,8330,83,694326,83.34245588764854,18
0.2,8331,-51,694275,83.3263322131541,14
0.2,8332,93,694368,83.327493099724,9
0.2,8333,94,694462,83.32877369810416,9
0.2,8334,85,694547,83.32897420515897,16
0.2,8335,94,694641,83.33025431861805,7
0.2,8336,95,694736,83.33165407220822,6
0.2,8337,95,694831,83.33305349004557,6
0.2,8338,89,694920,83.33373306151817,13
0.2,8339,91,695011,83.33465227817746,10
0.2,8340,94,695105,83.33593094353195,7
0.2,8341,94,695199,83.33720930232558,7
0.2,8342,89,695288,83.33788804986216,12
0.2,8343,91,695379,83.33880632790029,10
0.2,8344,93,695472,83.33996405032954,8
0.2,8345,91,695563,83.34088185957344,10
0.2,8346,95,695658,83.3422786629927,6
0.2,8347,95,695753,83.3436751317681,6
0.2,8348,94,695847,83.34495149119655,8
0.2,8349,94,695941,83.34622754491018,8
0.2,8350,93,696034,83.34738354688061,9
0.2,8351,90,696124,83.34818007662835,11
0.2,8352,90,696214,83.34897641565904,12
0.2,8353,89,696303,83.34965286090495,12
0.2,8354,92,696395,83.35068821065231,10
0.2,8355,93,696488,83.35184298707516,8
0.2,8356,95,696583,83.3532368074668,6
0.2,8357,93,696676,83.35439100263221,8
0.2,8358,96,696772,83.35590381624596,6
0.2,8359,94,696866,83.35717703349282,7
0.2,8360,91,696957,83.35809113742376,10
0.2,8361,93,697050,83.35924419995216,8
0.2,8362,-51,696999,83.34317828530432,17
0.2,8363,92,697091,83.34421329507413,9
0.2,8364,93,697184,83.34536760310819,8
0.2,8365,95,697279,83.34676069806359,6
0.2,8366,94,697373,83.3480339428708,7
0.2,8367,95,697468,83.34942638623328,7
0.2,8368,93,697561,83.35057951965587,8
0.2,8369,91,697652,83.35149342891279,10
0.2,8370,90,697742,83.3522876597778,11
0.2,8371,93,697835,83.35344003822264,8
0.2,8372,92,697927,83.35447270990088,9
0.2,8373,88,698015,83.35502746596609,13
0.2,8374,95,698110,83.35641791044776,7
0.2,8375,96,698206,83.35792741165234,8
0.2,8376,96,698302,83.35943655246508,6
0.2,8377,86,698388,83.35975173072332,15
0.2,8378,91,698479,83.36066356367108,10
0.2,8379,91,698570,83.36157517899761,10
0.2,8380,94,698664,83.36284452929245,7
0.2,8381,94,698758,83.364113576712,7
0.2,8382,94,698852,83.36538232136466,7
0.2,8383,94,698946,83.36665076335878,8
0.2,8384,94,699040,83.36791890280263,8
0.2,8385,91,699131,83.36882900071548,10
0.2,8386,93,699224,83.36997734589245,8
0.2,8387,93,699317,83.37112541726276,8
0.2,8388,94,699411,83.37239241864346,7
0.2,8389,91,699502,83.37330154946365,10
0.2,8390,95,699597,83.37468716481945,6
0.2,8391,95,699692,83.37607244995233,6
0.2,8392,90,699782,83.37686167043965,15
0.2,8393,94,699876,83.37812723373838,7
0.2,8394,93,699969,83.37927337701012,8
0.2,8395,91,700060,83.38018103858981,10
0.2,8396,90,700150,83.38096939383114,11
0.2,8397,94,700244,83.382233865206,7
0.2,8398,90,700334,83.38302178830813,11
0.2,8399,94,700428,83.38428571428571,7
0.2,8400,96,700524,83.38578740626116,6
0.2,8401,93,700617,83.38693168293264,8
0.2,8402,88,700705,83.38748066166845,14
0.2,8403,92,700797,83.388505473584,9
0.2,8404,94,700891,83.38976799524093,7
0.2,8405,92,700983,83.39079229122056,9
0.2,8406,19,701002,83.38313310336625,13
0.2,8407,94,701096,83.38439581351095,7
0.2,8408,93,701189,83.3855393031276,8
0.2,8409,94,701283,83.38680142687276,7
0.2,8410,93,701376,83.38794435857805,8
0.2,8411,94,701470,83.38920589633857,7
0.2,8412,93,701563,83.39034827053369,9
0.2,8413,94,701657,83.39160922272403,9
0.2,8414,91,701748,83.39251336898396,10
0.2,8415,94,701842,83.39377376425855,7
0.2,8416,88,701930,83.39432101698942,13
0.2,8417,93,702023,83.39546210501307,8
0.2,8418,94,702117,83.3967217009146,9
0.2,8419,93,702210,83.3978622327791,8
0.2,8420,94,702304,83.39912124450778,8
0.2,8421,91,702395,83.40002374732842,10
0.2,8422,89,702484,83.40068859076338,12
0.2,8423,94,702578,83.40194681861348,7
0.2,8424,83,702661,83.40189910979228,18
0.2,8425,92,702753,83.40291953477332,9
0.2,8426,95,702848,83.40429571615047,7
0.2,8427,94,702942,83.40555291884195,7
0.2,8428,93,703035,83.40669118519398,9
0.2,8429,88,703123,83.40723606168446,13
0.2,8430,96,703219,83.40872968805598,6
0.2,8431,16,703235,83.40073529411765,17
0.2,8432,93,703328,83.40187359184158,8
0.2,8433,91,703419,83.40277448423049,10
0.2,8434,88,703507,83.4033195020747,13
0.2,8435,93,703600,83.40445708866761,8
0.2,8436,95,703695,83.40583145667891,6
0.2,8437,93,703788,83.40696847594216,9
0.2,8438,91,703879,83.40786823083303,10
0.2,8439,93,703972,83.4090047393365,8
0.2,8440,94,704066,83.4102594479327,9
0.2,8441,94,704160,83.41151385927505,8
0.2,8442,89,704249,83.4121757669075,12
0.2,8443,90,704339,83.41295594504975,11
0.2,8444,95,704434,83.41432800473653,6
0.2,8445,90,704524,83.41510774331044,11
0.2,8446,93,704617,83.41624245294187,8
0.2,8447,95,704712,83.41761363636364,6
0.2,8448,92,704804,83.41862942360042,9
0.2,8449,89,704893,83.4192899408284,12
0.2,8450,93,704986,83.42042361850669,8
0.2,8451,96,705082,83.4219119734974,6
0.2,8452,94,705176,83.42316337395008,8
0.2,8453,78,705254,83.42252188313225,24
0.2,8454,94,705348,83.42377291543465,7
0.2,8455,84,705432,83.42384105960265,17
0.2,8456,95,705527,83.42520988530211,7
0.2,8457,89,705616,83.42586899976354,12
0.2,8458,96,705712,83.42735547937109,6
0.2,8459,95,705807,83.42872340425532,8
0.2,8460,88,705895,83.42926368041603,14
0.2,8461,94,705989,83.43051288111558,7
0.2,8462,94,706083,83.43176178660049,7
0.2,8463,91,706174,83.43265595463139,10
0.2,8464,93,706267,83.43378617838157,8
0.2,8465,93,706360,83.43491613512874,8
0.2,8466,93,706453,83.43604582496752,8
0.2,8467,91,706544,83.43693906471422,10
0.2,8468,85,706629,83.43712362734679,16
0.2,8469,93,706722,83.43825265643447,9
0.2,8470,92,706814,83.43926336914178,9
0.2,8471,95,706909,83.44062795089707,9
0.2,8472,95,707004,83.44199221055116,7
0.2,8473,94,707098,83.44323814019353,7
0.2,8474,87,707185,83.44365781710914,14
0.2,8475,89,707274,83.4443133553563,12
0.2,8476,95,707369,83.44567653651056,6
0.2,8477,94,707463,83.44692144373673,7
0.2,8478,94,707557,83.44816605731808,7
0.2,8479,91,707648,83.44905660377358,11
0.2,8480,86,707734,83.44935738710058,15
0.2,8481,21,707755,83.44199481254421,12
0.2,8482,96,707851,83.44347518566545,7
0.2,8483,92,707943,83.4444837340877,9
0.2,8484,20,707963,83.4370064820271,14
0.2,8485,94,708057,83.43825123733208,7
0.2,8486,21,708078,83.4308943089431,12
0.2,8487,95,708173,83.43225730442978,6
0.2,8488,96,708269,83.43373777830134,6
0.2,8489,16,708285,83.42579505300354,18
0.2,8490,92,708377,83.42680485219644,9
0.2,8491,18,708395,83.41910032972208,14
0.2,8492,95,708490,83.4204639114565,6
0.2,8493,89,708579,83.42112079114669,12
0.2,8494,95,708674,83.42248381400825,6
0.2,8495,91,708765,83.42337570621469,12
0.2,8496,90,708855,83.42414969989407,11
0.2,8497,91,708946,83.42504118616145,10
0.2,8498,95,709041,83.42640310624779,7
0.2,8499,95,709136,83.42776470588235,6
0.2,8500,89,709225,83.42842018586049,14
0.2,8501,79,709304,83.42789931780757,22
0.2,8502,87,709391,83.42831941667647,14
0.2,8503,96,709487,83.42979774223895,6
0.2,8504,93,709580,83.43092298647854,9
0.2,8505,94,709674,83.43216553021396,7
0.2,8506,21,709695,83.42482661337722,11
0.2,8507,94,709789,83.42606958157029,7
0.2,8508,94,709883,83.42731225760959,7
0.2,8509,94,709977,83.42855464159813,7
0.2,8510,94,710071,83.42979673363882,7
0.2,8511,-47,710024,83.41447368421052,11
0.2,8512,94,710118,83.41571713849407,7
0.2,8513,91,710209,83.41660793986375,10
0.2,8514,95,710304,83.41796829125073,7
0.2,8515,26,710330,83.41122592766557,6
0.2,8516,91,710421,83.41211694258541,10
0.2,8517,92,710513,83.41312514674806,9
0.2,8518,90,710603,83.41389834487616,11
0.2,8519,93,710696,83.4150234741784,10
0.2,8520,95,710791,83.4163830536322,7
0.2,8521,90,710881,83.41715559727763,11
0.2,8522,93,710974,83.41827994837499,10
0.2,8523,96,711070,83.41975598310653,6
0.2,8524,95,711165,83.42111436950147,6
0.2,8525,96,711261,83.4225897255454,6
0.2,8526,86,711347,83.42289199014894,15
0.2,8527,94,711441,83.42413227016885,7
0.2,8528,96,711537,83.42560675342948,6
0.2,8529,93,711630,83.42672919109027,8
0.2,8530,96,711726,83.42820302426445,6
0.2,8531,91,711817,83.42909048288796,11
0.2,8532,96,711913,83.4305636938943,6
0.2,8533,88,712001,83.43109913288025,13
0.2,8534,92,712093,83.43210310486234,9
0.2,8535,21,712114,83.42478912839738,11
0.2,8536,95,712209,83.42614501581352,6
0.2,8537,91,712300,83.42703209182478,10
0.2,8538,96,712396,83.42850450872467,6
0.2,8539,92,712488,83.42950819672132,9
0.2,8540,91,712579,83.43039456738087,10
0.2,8541,91,712670,83.43128073050808,10
0.2,8542,94,712764,83.43251785087206,7
0.2,8543,94,712858,83.43375468164794,8
0.2,8544,89,712947,83.43440608543007,12
0.2,8545,91,713038,83.435291364381,10
0.2,8546,91,713129,83.43617643617644,10
0.2,8547,85,713214,83.43635938231165,16
0.2,8548,89,713303,83.43701017662885,12
0.2,8549,94,713397,83.43824561403508,7
0.2,8550,92,713489,83.4392468717109,10
0.2,8551,92,713581,83.44024789522919,9
0.2,8552,92,713673,83.44124868467205,9
0.2,8553,94,713767,83.44248304886602,8
0.2,8554,94,713861,83.4437171244886,7
0.2,8555,94,713955,83.44495091164096,7
0.2,8556,18,713973,83.43730279303495,14
0.2,8557,94,714067,83.43853704136481,7
0.2,8558,93,714160,83.43965416520622,8
0.2,8559,90,714250,83.44042056074767,11
0.2,8560,94,714344,83.44165401238173,7
0.2,8561,84,714428,83.44171922448027,18
0.2,8562,93,714521,83.44283545486395,8
0.2,8563,93,714614,83.44395142456796,8
0.2,8564,94,714708,83.44518388791593,7
0.2,8565,94,714802,83.44641606350689,7
0.2,8566,94,714896,83.44764795144158,7
0.2,8567,92,714988,83.44864612511671,9
0.2,8568,89,715077,83.44929396662387,12
0.2,8569,93,715170,83.45040840140024,8
0.2,8570,90,715260,83.45117255862793,11
0.2,8571,91,715351,83.45205319645358,10
0.2,8572,92,715443,83.4530502741164,10
0.2,8573,96,715539,83.45451364590623,6
0.2,8574,89,715628,83.45516034985422,12
0.2,8575,20,715648,83.44776119402985,12
0.2,8576,26,715674,83.44106330884925,7
0.2,8577,88,715762,83.44159477733737,13
0.2,8578,90,715852,83.44235924932975,11
0.2,8579,90,715942,83.44312354312355,11
0.2,8580,94,716036,83.44435380491784,7
0.2,8581,93,716129,83.44546725704964,8
0.2,8582,94,716223,83.44669695910521,7
0.2,8583,93,716316,83.44780987884437,8
0.2,8584,91,716407,83.44868957483983,11
0.2,8585,84,716491,83.44875378523177,17
0.2,8586,90,716581,83.4495167113078,11
0.2,8587,93,716674,83.45062878435026,9
0.2,8588,94,716768,83.45185702642915,7
0.2,8589,92,716860,83.45285215366705,9
0.2,8590,93,716953,83.45396345012222,8
0.2,8591,95,717048,83.45530726256983,7
0.2,8592,94,717142,83.45653438845572,7
0.2,8593,93,717235,83.45764486851292,8
0.2,8594,93,717328,83.45875509016871,8
0.2,8595,90,717418,83.45951605397859,11
0.2,8596,91,717509,83.46039316040479,10
0.2,8597,91,717600,83.4612700628053,10
0.2,8598,93,717693,83.46237934643563,8
0.2,8599,96,717789,83.46383720930233,6
0.2,8600,93,717882,83.46494593651902,8
0.2,8601,94,717976,83.46617065798651,7
0.2,8602,86,718062,83.46646518656283,15
0.2,8603,92,718154,83.4674569967457,9
0.2,8604,93,718247,83.468564787914,8
0.2,8605,89,718336,83.4692075296305,12
0.2,8606,95,718431,83.47054722899965,6
0.2,8607,94,718525,83.47177044609666,7
0.2,8608,90,718615,83.47252874898362,12
0.2,8609,94,718709,83.47375145180023,7
0.2,8610,92,718801,83.47474160956915,9
0.2,8611,93,718894,83.47584765443567,8
0.2,8612,92,718986,83.47683733890631,9
0.2,8613,95,719081,83.47817506384955,6
0.2,8614,22,719103,83.47103888566454,11
0.2,8615,93,719196,83.47214484679665,8
0.2,8616,94,719290,83.4733666009052,7
0.2,8617,92,719382,83.4743559990717,10
0.2,8618,94,719476,83.47557721313377,8
0.2,8619,90,719566,83.47633410672854,11
0.2,8620,94,719660,83.47755480802691,7
0.2,8621,92,719752,83.47854326142426,9
0.2,8622,94,719846,83.47976342340253,7
0.2,8623,94,719940,83.48098330241187,8
0.2,8624,93,720033,83.48208695652174,8
0.2,8625,92,720125,83.4830744261535,9
0.2,8626,94,720219,83.48429349716008,7
0.2,8627,84,720303,83.48435326842838,18
0.2,8628,94,720397,83.48557190868003,8
0.2,8629,92,720489,83.48655851680185,9
0.2,8630,94,720583,83.48777661916348,8
0.2,8631,96,720679,83.48922613531047,6
0.2,8632,93,720772,83.49032781188463,8
0.2,8633,96,720868,83.49177669678018,6
0.2,8634,94,720962,83.49299363057325,8
0.2,8635,93,721055,83.49409448818898,9
0.2,8636,93,721148,83.49519509088805,9
0.2,8637,93,721241,83.49629543875898,8
0.2,8638,95,721336,83.49762704016669,7
0.2,8639,94,721430,83.4988425925926,7
0.2,8640,94,721524,83.50005786367319,7
0.2,8641,91,721615,83.50092571164082,11
0.2,8642,91,721706,83.50179335878745,10
0.2,8643,95,721801,83.50312355391023,6
0.2,8644,91,721892,83.50399074609601,10
0.2,8645,94,721986,83.50520471894518,7
0.2,8646,90,722076,83.50595582282872,11
0.2,8647,93,722169,83.50705365402405,8
0.2,8648,94,722263,83.50826685165916,8
0.2,8649,91,722354,83.50913294797688,11
0.2,8650,86,722440,83.50942087619929,15
0.2,8651,91,722531,83.51028663892741,11
0.2,8652,95,722626,83.5116144689703,6
0.2,8653,87,722713,83.5120175641322,14
0.2,8654,86,722799,83.51230502599654,15
0.2,8655,89,722888,83.51293900184842,13
0.2,8656,94,722982,83.51415039852142,7
0.2,8657,89,723071,83.51478401478401,14
0.2,8658,95,723166,83.51611040535859,6
0.2,8659,94,723260,83.51732101616628,7
0.2,8660,92,723352,83.5183004272024,9
0.2,8661,90,723442,83.51904871854076,11
0.2,8662,93,723535,83.52014313748124,8
0.2,8663,94,723629,83.52135272391504,8
0.2,8664,91,723720,83.52221581073283,10
0.2,8665,92,723812,83.52319409185321,9
0.2,8666,96,723908,83.52463366793584,7
0.2,8667,93,724001,83.5257268112598,8
0.2,8668,91,724092,83.5265889952705,12
0.2,8669,96,724188,83.5280276816609,6
0.2,8670,94,724282,83.52923538230884,7
0.2,8671,94,724376,83.53044280442805,7
0.2,8672,93,724469,83.53153464775741,9
0.2,8673,93,724562,83.53262623933594,9
0.2,8674,87,724649,83.53302593659943,14
0.2,8675,89,724738,83.53365606270171,12
0.2,8676,89,724827,83.53428604356344,13
0.2,8677,94,724921,83.53549204885918,7
0.2,8678,91,725012,83.53635211429888,10
0.2,8679,79,725091,83.53582949308756,22
0.2,8680,89,725180,83.53645893330261,12
0.2,8681,22,725202,83.52937111264686,11
0.2,8682,24,725226,83.52251525970287,9
0.2,8683,92,725318,83.52349147858129,9
0.2,8684,90,725408,83.52423719055844,11
0.2,8685,94,725502,83.52544324199862,7
0.2,8686,95,725597,83.52676413030966,6
0.2,8687,94,725691,83.52796961325967,7
0.2,8688,94,725785,83.52917481873634,8
0.2,8689,96,725881,83.53060989643268,6
0.2,8690,16,725897,83.5228397192498,16
0.2,8691,87,725984,83.5232397606995,14
0.2,8692,25,726009,83.51650753479811,8
0.2,8693,83,726092,83.51644812514378,19
0.2,8694,88,726180,83.51696377228292,14
0.2,8695,94,726274,83.51816927322908,7
0.2,8696,89,726363,83.51879958606416,12
0.2,8697,90,726453,83.5195447229248,11
0.2,8698,94,726547,83.5207495114381,8
0.2,8699,90,726637,83.52149425287357,11
0.2,8700,92,726729,83.52246868176071,9
0.2,8701,89,726818,83.523098138359,12
0.2,8702,92,726910,83.52407215902562,9
0.2,8703,94,727004,83.52527573529412,7
0.2,8704,94,727098,83.52647903503734,7
0.2,8705,89,727187,83.52710774178728,13
0.2,8706,21,727208,83.51992649592282,12
0.2,8707,94,727302,83.52112999540653,7
0.2,8708,88,727390,83.52164427603628,13
0.2,8709,94,727484,83.52284730195178,7
0.2,8710,26,727510,83.51624382964069,7
0.2,8711,93,727603,83.51733241505968,8
0.2,8712,92,727695,83.51830597957075,9
0.2,8713,93,727788,83.51939407849437,9
0.2,8714,25,727813,83.5126792885829,8
0.2,8715,90,727903,83.5134235888022,11
0.2,8716,96,727999,83.51485602845015,6
0.2,8717,86,728085,83.51514108740537,15
0.2,8718,92,728177,83.51611423328363,11
0.2,8719,93,728270,83.51720183486239,8
0.2,8720,95,728365,83.51851851851852,6
0.2,8721,27,728392,83.51203852327448,6
0.2,8722,94,728486,83.51324085750315,7
0.2,8723,96,728582,83.51467216872994,6
0.2,8724,94,728676,83.51587392550144,7
0.2,8725,89,728765,83.51650240660096,13
0.2,8726,91,728856,83.51735991749742,14
0.2,8727,86,728942,83.51764436296975,16
0.2,8728,85,729027,83.5178141826097,16
0.2,8729,96,729123,83.5192439862543,6
0.2,8730,89,729212,83.51987172145229,12
0.2,8731,91,729303,83.52072835547412,10
0.2,8732,89,729392,83.52135577693805,12
0.2,8733,90,729482,83.52209754980535,11
0.2,8734,90,729572,83.52283915283343,11
0.2,8735,90,729662,83.52358058608058,11
0.2,8736,92,729754,83.52455076113083,9
0.2,8737,93,729847,83.52563515678645,8
0.2,8738,95,729942,83.52694816340542,6
0.2,8739,90,730032,83.52768878718535,11
0.2,8740,-49,729983,83.51252717080426,12
0.2,8741,90,730073,83.5132692747655,11
0.2,8742,90,730163,83.51401120896718,11
0.2,8743,92,730255,83.51498170173834,9
0.2,8744,91,730346,83.515837621498,11
0.2,8745,94,730440,83.51703635947862,7
0.2,8746,94,730534,83.51823482336802,7
0.2,8747,92,730626,83.51920438957475,9
0.2,8748,90,730716,83.51994513658704,12
0.2,8749,95,730811,83.52125714285714,6
0.2,8750,94,730905,83.52245457661982,7
0.2,8751,90,730995,83.52319469835466,11
0.2,8752,94,731089,83.52439163715297,7
0.2,8753,84,731173,83.52444596755768,17
0.2,8754,95,731268,83.52575671045118,6
0.2,8755,90,731358,83.52649611694838,11
0.2,8756,94,731452,83.52769213200868,7
0.2,8757,94,731546,83.52888787394382,7
0.2,8758,25,731571,83.52220573124787,8
0.2,8759,23,731594,83.51529680365297,10
0.2,8760,90,731684,83.51603698207967,11
0.2,8761,87,731771,83.51643460397169,14
0.2,8762,86,731857,83.51671801894328,15
0.2,8763,96,731953,83.51814240073026,6
0.2,8764,90,732043,83.51888191671421,12
0.2,8765,21,732064,83.51174994296144,11
0.2,8766,89,732153,83.51237595528687,12
0.2,8767,92,732245,83.51334397810218,9
0.2,8768,93,732338,83.51442581822329,9
0.2,8769,21,732359,83.5072976054732,11
0.2,8770,91,732450,83.5081518640976,10
0.2,8771,93,732543,83.50923392612859,8
0.2,8772,93,732636,83.51031574147954,8
0.2,8773,91,732727,83.5111693640301,10
0.2,8774,85,732812,83.51133903133903,16
0.2,8775,93,732905,83.51242023701003,9
0.2,8776,91,732996,83.51327332801641,10
0.2,8777,95,733091,83.51458190931875,8
0.2,8778,92,733183,83.51554846793485,9
0.2,8779,92,733275,83.51651480637813,9
0.2,8780,95,733370,83.51782257146111,7
0.2,8781,90,733460,83.51856069232521,11
0.2,8782,96,733556,83.51998178298987,7
0.2,8783,23,733579,83.51309198542805,10
0.2,8784,87,733666,83.5134889015367,15
0.2,8785,89,733755,83.51411336216708,14
0.2,8786,94,733849,83.51530670308411,9
0.2,8787,18,733867,83.50785161583978,14
0.2,8788,94,733961,83.50904539765617,8
0.2,8789,93,734054,83.51012514220706,8
0.2,8790,92,734146,83.5110908884086,10
0.2,8791,94,734240,83.5122838944495,7
0.2,8792,92,734332,83.5132491754805,9
0.2,8793,25,734357,83.5065954059586,8
0.2,8794,93,734450,83.50767481523593,8
0.2,8795,94,734544,83.50886766712142,8
0.2,8796,86,734630,83.50915084687962,15
0.2,8797,95,734725,83.51045692202773,7
0.2,8798,27,734752,83.5040345493806,6
0.2,8799,93,734845,83.50511363636363,8
0.2,8800,89,734934,83.50573798431996,12
0.2,8801,94,735028,83.50693024312656,8
0.2,8802,90,735118,83.50766784050892,11
0.2,8803,91,735209,83.50851885506587,10
0.2,8804,92,735301,83.50948324815445,9
0.2,8805,91,735392,83.51033386327504,11
0.2,8806,87,735479,83.51073010105598,14
0.2,8807,96,735575,83.51214804722979,6
0.2,8808,92,735667,83.51311159041889,9
0.2,8809,92,735759,83.51407491486947,10
0.2,8810,85,735844,83.51424355918738,17
0.2,8811,94,735938,83.51543349977304,7
0.2,8812,88,736026,83.5159423578804,13
0.2,8813,96,736122,83.51735874744725,6
0.2,8814,94,736216,83.51854792966535,7
0.2,8815,95,736311,83.5198502722323,6
0.2,8816,90,736401,83.52058523307247,11
0.2,8817,94,736495,83.52177364481742,7
0.2,8818,93,736588,83.5228483955097,8
0.2,8819,91,736679,83.52369614512472,10
0.2,8820,94,736773,83.52488380002268,7
0.2,8821,93,736866,83.525957832691,8
0.2,8822,89,736955,83.52657826136235,12
0.2,8823,90,737045,83.52731187669991,11
0.2,8824,88,737133,83.52781869688386,13
0.2,8825,92,737225,83.52877860865624,9
0.2,8826,90,737315,83.52951172538802,11
0.2,8827,27,737342,83.52310829179882,6
0.2,8828,91,737433,83.52395514780837,10
0.2,8829,90,737523,83.5246885617214,11
0.2,8830,94,737617,83.5258747593704,8
0.2,8831,-49,737568,83.51086956521739,12
0.2,8832,88,737656,83.51137778784106,13
0.2,8833,93,737749,83.51245189042336,9
0.2,8834,83,737832,83.51239388794568,21
0.2,8835,92,737924,83.51335445903123,9
0.2,8836,26,737950,83.50684621477878,8
0.2,8837,92,738042,83.50780719619823,9
0.2,8838,93,738135,83.5088810951465,8
0.2,8839,92,738227,83.50984162895928,9
0.2,8840,92,738319,83.51080194548128,9
0.2,8841,92,738411,83.51176204478625,9
0.2,8842,95,738506,83.51306117833315,6
0.2,8843,92,738598,83.51402080506558,10
0.2,8844,94,738692,83.5152063312606,7
0.2,8845,93,738785,83.51627854397468,8
0.2,8846,92,738877,83.5172374816322,9
0.2,8847,85,738962,83.51740506329114,16
0.2,8848,95,739057,83.51870267826872,6
0.2,8849,94,739151,83.51988700564972,8
0.2,8850,95,739246,83.52118404700033,6
0.2,8851,94,739340,83.5223678264799,8
0.2,8852,92,739432,83.52332542640913,9
0.2,8853,92,739524,83.52428281002936,9
0.2,8854,94,739618,83.52546583850932,7
0.2,8855,94,739712,83.52664859981932,7
0.2,8856,91,739803,83.52749237890934,10
0.2,8857,91,739894,83.52833596748702,10
0.2,8858,26,739920,83.52184219437859,7
0.2,8859,90,740010,83.52257336343115,11
0.2,8860,93,740103,83.5236429296919,8
0.2,8861,93,740196,83.52471225457008,9
0.2,8862,93,740289,83.52578133814735,8
0.2,8863,92,740381,83.52673736462094,9
0.2,8864,94,740475,83.52791878172589,8
0.2,8865,93,740568,83.52898714189037,9
0.2,8866,27,740595,83.52261193188227,6
0.2,8867,82,740677,83.5224402345512,19
0.2,8868,94,740771,83.52362160333747,7
0.2,8869,81,740852,83.52333709131905,20
0.2,8870,26,740878,83.5168526659903,8
0.2,8871,93,740971,83.5179215509468,8
0.2,8872,90,741061,83.51865209061197,11
0.2,8873,90,741151,83.51938246562993,11
0.2,8874,95,741246,83.52067605633803,6
0.2,8875,95,741341,83.52196935556557,6
0.2,8876,93,741434,83.52303706207051,8
0.2,8877,91,741525,83.5238792520838,10
0.2,8878,91,741616,83.52472125239329,10
0.2,8879,92,741708,83.52567567567567,9
0.2,8880,94,741802,83.52685508388694,7
0.2,8881,93,741895,83.52792163927043,8
0.2,8882,91,741986,83.52876280535855,10
0.2,8883,95,742081,83.53005402971634,6
0.2,8884,94,742175,83.5312324141812,7
0.2,8885,88,742263,83.53173531397704,14
0.2,8886,93,742356,83.53280072015303,9
0.2,8887,90,742446,83.53352835283529,11
0.2,8888,92,742538,83.53448081898976,10
0.2,8889,93,742631,83.5355455568054,8
0.2,8890,94,742725,83.53672252839951,7
0.2,8891,95,742820,83.53801169590643,6
0.2,8892,22,742842,83.53109187001012,10
0.2,8893,94,742936,83.53226894535642,7
0.2,8894,96,743032,83.5336706014615,6
0.2,8895,94,743126,83.53484712230215,7
0.2,8896,95,743221,83.5361357761043,6
0.2,8897,24,743245,83.52944481906046,8
0.2,8898,23,743268,83.52264299359479,10
0.2,8899,95,743363,83.52393258426966,8
0.2,8900,92,743455,83.52488484439951,9
0.2,8901,90,743545,83.5256122219726,12
0.2,8902,26,743571,83.51915084802876,8
0.2,8903,93,743664,83.52021563342318,8
0.2,8904,94,743758,83.521392476137,7
0.2,8905,92,743850,83.52234448686279,9
0.2,8906,91,743941,83.52318401257438,10
0.2,8907,94,744035,83.52436012572969,8
0.2,8908,93,744128,83.52542372881356,10
0.2,8909,94,744222,83.52659932659932,8
0.2,8910,92,744314,83.52755021883065,9
0.2,8911,96,744410,83.52894973070018,6
0.2,8912,96,744506,83.53034892853135,6
0.2,8913,89,744595,83.53096253085035,13
0.2,8914,94,744689,83.53213684800897,7
0.2,8915,94,744783,83.53331090174966,7
0.2,8916,92,744875,83.53426040148032,9
0.2,8917,96,744971,83.5356582193317,6
0.2,8918,95,745066,83.536943603543,7
0.2,8919,93,745159,83.53800448430493,8
0.2,8920,88,745247,83.53850465194485,13
0.2,8921,93,745340,83.53956511992827,8
0.2,8922,94,745434,83.54073742015018,7
0.2,8923,85,745519,83.54090094128193,16
0.2,8924,93,745612,83.54196078431373,8
0.2,8925,27,745639,83.53562626036299,6
0.2,8926,89,745728,83.53623837795452,12
0.2,8927,91,745819,83.53707437275986,10
0.2,8928,92,745911,83.5380221749356,9
0.2,8929,26,745937,83.53157894736842,6
0.2,8930,93,746030,83.53263912215877,8
0.2,8931,88,746118,83.53313927451859,14
0.2,8932,94,746212,83.53431098175305,7
0.2,8933,92,746304,83.53525856279383,9
0.2,8934,93,746397,83.53631785114717,8
0.2,8935,93,746490,83.5373769024172,8
0.2,8936,90,746580,83.53810003356831,11
0.2,8937,84,746664,83.53815171179235,18
0.2,8938,94,746758,83.53932207182011,7
0.2,8939,89,746847,83.53993288590604,15
0.2,8940,94,746941,83.54110278492338,7
0.2,8941,92,747033,83.54204875866697,10
0.2,8942,91,747124,83.54288270155429,11
0.2,8943,91,747215,83.54371645796064,10
0.2,8944,94,747309,83.54488541084405,7
0.2,8945,94,747403,83.54605410239213,7
0.2,8946,95,747498,83.54733430200066,6
0.2,8947,94,747592,83.54850245864998,8
0.2,8948,93,747685,83.54955860990054,8
0.2,8949,91,747776,83.55039106145252,10
0.2,8950,94,747870,83.55155848508547,7
0.2,8951,93,747963,83.55261394101876,10
0.2,8952,88,748051,83.55311068915448,13
0.2,8953,91,748142,83.5539423721242,10
0.2,8954,93,748235,83.55499720826354,8
0.2,8955,94,748329,83.55616346583297,9
0.2,8956,92,748421,83.55710617394217,9
0.2,8957,91,748512,83.55793703951775,10
0.2,8958,88,748600,83.55843286081036,13
0.2,8959,24,748624,83.55178571428571,9
0.2,8960,92,748716,83.55272849012387,9
0.2,8961,89,748805,83.55333630885963,12
0.2,8962,89,748894,83.55394399196697,12
0.2,8963,93,748987,83.55499776885318,8
0.2,8964,94,749081,83.55616285554936,7
0.2,8965,94,749175,83.55732768235556,7
0.2,8966,94,749269,83.55849224935876,7
0.2,8967,94,749363,83.55965655664585,7
0.2,8968,95,749458,83.56093209945368,7
0.2,8969,90,749548,83.56164994425863,13
0.2,8970,91,749639,83.56247909932003,11
0.2,8971,91,749730,83.5633080695497,11
0.2,8972,92,749822,83.56424830045692,9
0.2,8973,90,749912,83.56496545576108,11
0.2,8974,86,749998,83.56523676880222,15
0.2,8975,91,750089,83.56606506238859,11
0.2,8976,94,750183,83.56722735880584,7
0.2,8977,93,750276,83.56827801292047,8
0.2,8978,88,750364,83.56877157812674,13
0.2,8979,93,750457,83.56982182628062,10
0.2,8980,90,750547,83.57053780202651,11
0.2,8981,90,750637,83.57125361834781,13
0.2,8982,25,750662,83.56473338528332,8
0.2,8983,93,750755,83.56578361531612,9
0.2,8984,93,750848,83.56683361157485,10
0.2,8985,95,750943,83.56810594257735,7
0.2,8986,20,750963,83.56103260264827,12
0.2,8987,23,750986,83.55429461504228,9
0.2,8988,93,751079,83.55534542218267,8
0.2,8989,89,751168,83.5559510567297,12
0.2,8990,94,751262,83.55711266822378,8
0.2,8991,92,751354,83.55805160142349,9
0.2,8992,94,751448,83.55921272100522,7
0.2,8993,95,751543,83.56048476762285,6
0.2,8994,90,751633,83.56120066703724,11
0.2,8995,94,751727,83.56236104935527,7
0.2,8996,95,751822,83.56363232188507,6
0.2,8997,91,751913,83.56445876861525,10
0.2,8998,92,752005,83.56539615512835,9
0.2,8999,94,752099,83.56655555555555,7
0.2,9000,95,752194,83.56782579713365,7
0.2,9001,24,752218,83.5612086203066,8
0.2,9002,95,752313,83.56247917360879,6
0.2,9003,91,752404,83.56330519768991,10
0.2,9004,94,752498,83.56446418656301,7
0.2,9005,89,752587,83.5650677326227,12
0.2,9006,95,752682,83.56633729321639,8
0.2,9007,95,752777,83.56760657193605,6
0.2,9008,93,752870,83.56865356865357,8
0.2,9009,94,752964,83.56981132075472,7
0.2,9010,88,753052,83.57030296304517,13
0.2,9011,89,753141,83.57090545938749,12
0.2,9012,95,753236,83.57217352712749,7
0.2,9013,93,753329,83.57321943643221,8
0.2,9014,88,753417,83.57371048252912,14
0.2,9015,93,753510,83.57475598935227,8
0.2,9016,20,753530,83.56770544527005,13
0.2,9017,96,753626,83.569084054114,6
0.2,9018,96,753722,83.57046235724582,6
0.2,9019,92,753814,83.57139689578715,10
0.2,9020,94,753908,83.57255293204744,7
0.2,9021,96,754004,83.5739303923742,6
0.2,9022,95,754099,83.57519671949463,7
0.2,9023,90,754189,83.57590868794327,14
0.2,9024,24,754213,83.56930747922438,10
0.2,9025,95,754308,83.57057389762907,6
0.2,9026,88,754396,83.5710645840257,13
0.2,9027,92,754488,83.57199822773593,9
0.2,9028,92,754580,83.57293166463617,9
0.2,9029,93,754673,83.57397563676633,8
0.2,9030,93,754766,83.57501937769904,9
0.2,9031,94,754860,83.57617360496015,8
0.2,9032,95,754955,83.57743828185542,6
0.2,9033,89,755044,83.57803852114235,12
0.2,9034,91,755135,83.57885998893192,10
0.2,9035,94,755229,83.58001328021248,7
0.2,9036,92,755321,83.58094500387297,9
0.2,9037,25,755346,83.57446337685329,9
0.2,9038,93,755439,83.57550614005974,9
0.2,9039,96,755535,83.57688053097345,6
0.2,9040,96,755631,83.57825461785201,6
0.2,9041,95,755726,83.57951780579518,6
0.2,9042,96,755822,83.5808912971359,6
0.2,9043,91,755913,83.58171163202123,11
0.2,9044,92,756005,83.58264234383637,9
0.2,9045,88,756093,83.5831306654875,13
0.2,9046,87,756180,83.58350834530783,14
0.2,9047,91,756271,83.58432802829354,10
0.2,9048,22,756293,83.57752237816334,12
0.2,9049,96,756389,83.57889502762431,6
0.2,9050,96,756485,83.58026737377085,6
0.2,9051,94,756579,83.58141847105612,7
0.2,9052,92,756671,83.58234839279797,10
0.2,9053,96,756767,83.58371990280538,6
0.2,9054,90,756857,83.58442849254556,11
0.2,9055,87,756944,83.58480565371025,14
0.2,9056,92,757036,83.58573479076956,9
0.2,9057,22,757058,83.57893574740561,11
0.2,9058,95,757153,83.58019648967877,6
0.2,9059,94,757247,83.58134657836645,7
0.2,9060,92,757339,83.58227568701027,9
0.2,9061,92,757431,83.5832045905981,10
0.2,9062,87,757518,83.58358159549817,14
0.2,9063,94,757612,83.58473080317741,7
0.2,9064,90,757702,83.58543849972422,11
0.2,9065,89,757791,83.5860357379219,12
0.2,9066,88,757879,83.58652255431785,14
0.2,9067,18,757897,83.57928981032201,16
0.2,9068,96,757993,83.5806593891278,6
0.2,9069,95,758088,83.5819184123484,6
0.2,9070,92,758180,83.58284643368978,9
0.2,9071,93,758273,83.58388447971781,8
0.2,9072,94,758367,83.58503251405268,7
0.2,9073,95,758462,83.58629050033062,6
0.2,9074,94,758556,83.58743801652892,7
0.2,9075,94,758650,83.58858527985898,7
0.2,9076,95,758745,83.58984245896221,6
0.2,9077,26,758771,83.58349856796652,7
0.2,9078,93,758864,83.58453574182178,8
0.2,9079,88,758952,83.58502202643172,13
0.2,9080,17,758969,83.57768968175311,16
0.2,9081,93,759062,83.57872715260956,9
0.2,9082,90,759152,83.57943410767368,11
0.2,9083,93,759245,83.58047115808014,8
0.2,9084,93,759338,83.58150798018713,9
0.2,9085,95,759433,83.58276469293419,6
0.2,9086,94,759527,83.58391108176517,7
0.2,9087,91,759618,83.58472711267606,10
0.2,9088,25,759643,83.57828143910221,8
0.2,9089,91,759734,83.57909790979097,10
0.2,9090,93,759827,83.58013419865802,8
0.2,9091,91,759918,83.58095028596568,10
0.2,9092,94,760012,83.58209611789289,8
0.2,9093,94,760106,83.58324169782274,8
0.2,9094,96,760202,83.5846069268829,6
0.2,9095,15,760217,83.57706684256816,17
0.2,9096,92,760309,83.57799274486095,10
0.2,9097,92,760401,83.57891844361399,9
0.2,9098,92,760493,83.57984393889438,9
0.2,9099,92,760585,83.58076923076923,9
0.2,9100,92,760677,83.58169431930557,9
0.2,9101,93,760770,83.58272907053394,8
0.2,9102,83,760853,83.58266505547621,18
0.2,9103,90,760943,83.58336994727593,11
0.2,9104,95,761038,83.58462383305876,6
0.2,9105,93,761131,83.58565780803866,8
0.2,9106,92,761223,83.58658175030196,9
0.2,9107,89,761312,83.58717610891524,12
0.2,9108,90,761402,83.58788011856406,11
0.2,9109,89,761491,83.58847420417123,12
0.2,9110,93,761584,83.58950718911207,8
0.2,9111,90,761674,83.59021071115014,11
0.2,9112,92,761766,83.59113354548447,9
0.2,9113,92,761858,83.59205617730963,9
0.2,9114,90,761948,83.5927591881514,11
0.2,9115,94,762042,83.593900833699,8
0.2,9116,94,762136,83.59504222880334,7
0.2,9117,91,762227,83.59585435402501,10
0.2,9118,93,762320,83.59688562342362,8
0.2,9119,94,762414,83.59802631578947,8
0.2,9120,94,762508,83.59916675803092,7
0.2,9121,96,762604,83.60052620039465,6
0.2,9122,93,762697,83.60155650553546,8
0.2,9123,95,762792,83.60280578693555,7
0.2,9124,92,762884,83.60372602739726,9
0.2,9125,94,762978,83.60486522024983,7
0.2,9126,95,763073,83.60611372849786,6
0.2,9127,94,763167,83.60725241016652,7
0.2,9128,94,763261,83.60839084237047,7
0.2,9129,94,763355,83.60952902519168,8
0.2,9130,27,763382,83.6033293177089,6
0.2,9131,94,763476,83.60446780551905,7
0.2,9132,18,763494,83.59728457242966,14
0.2,9133,93,763587,83.59831399167943,8
0.2,9134,95,763682,83.59956212370005,6
0.2,9135,95,763777,83.60080998248687,7
0.2,9136,96,763873,83.60216701324286,6
0.2,9137,92,763965,83.60308601444517,10
0.2,9138,92,764057,83.60400481453114,9
0.2,9139,92,764149,83.60492341356674,9
0.2,9140,96,764245,83.60627940050323,6
0.2,9141,94,764339,83.60741632028002,7
0.2,9142,93,764432,83.60844361806846,8
0.2,9143,91,764523,83.60925196850394,11
0.2,9144,90,764613,83.60995079278294,11
0.2,9145,90,764703,83.61064946424666,12
0.2,9146,91,764794,83.61145730840713,10
0.2,9147,94,764888,83.61259291648447,7
0.2,9148,92,764980,83.61350967318833,9
0.2,9149,95,765075,83.61475409836065,7
0.2,9150,91,765166,83.61556114085893,10
0.2,9151,90,765256,83.61625874125875,11
0.2,9152,91,765347,83.61706544302415,10
0.2,9153,94,765441,83.6181996941228,7
0.2,9154,91,765532,83.61900600764609,10
0.2,9155,94,765626,83.62013979903888,7
0.2,9156,90,765716,83.62083651851043,11
0.2,9157,94,765810,83.62196986241537,7
0.2,9158,96,765906,83.62332132328856,6
0.2,9159,92,765998,83.62423580786026,9
0.2,9160,89,766087,83.62482261761816,12
0.2,9161,93,766180,83.62584588517791,8
0.2,9162,95,766275,83.62708719851577,6
0.2,9163,20,766295,83.6201440419031,13
0.2,9164,16,766311,83.61276595744681,17
0.2,9165,89,766400,83.6133536984508,12
0.2,9166,93,766493,83.61437765899421,9
0.2,9167,90,766583,83.61507417102966,12
0.2,9168,92,766675,83.61598865743265,10
0.2,9169,94,766769,83.61712104689204,7
0.2,9170,85,766854,83.61727183513248,16
0.2,9171,87,766941,83.61764064544265,14
0.2,9172,94,767035,83.61877248446528,7
0.2,9173,94,767129,83.6199040767386,7
0.2,9174,24,767153,83.6134059945504,9
0.2,9175,94,767247,83.61453792502179,7
0.2,9176,94,767341,83.61566960880462,7
0.2,9177,90,767431,83.61636522118108,11
0.2,9178,92,767523,83.6172785706504,9
0.2,9179,94,767617,83.61840958605664,7
0.2,9180,90,767707,83.61910467269361,11
0.2,9181,90,767797,83.61979960792856,11
0.2,9182,22,767819,83.61308940433409,10
0.2,9183,91,767910,83.61389372822299,10
0.2,9184,91,768001,83.61469787697332,10
0.2,9185,94,768095,83.61582843457435,7
0.2,9186,94,768189,83.61695874605421,7
0.2,9187,95,768284,83.61819764910753,6
0.2,9188,94,768378,83.61932745674176,7
0.2,9189,86,768464,83.61958650707291,15
0.2,9190,90,768554,83.62028070938962,11
0.2,9191,90,768644,83.62097476066144,11
0.2,9192,92,768736,83.62188621777439,9
0.2,9193,94,768830,83.62301500978899,8
0.2,9194,94,768924,83.62414355628059,7
0.2,9195,95,769019,83.62538060026098,6
0.2,9196,94,769113,83.62650864412308,7
0.2,9197,85,769198,83.62665796912373,16
0.2,9198,93,769291,83.6276769214045,8
0.2,9199,93,769384,83.62869565217392,9
0.2,9200,89,769473,83.62927942614934,12
0.2,9201,95,769568,83.63051510541187,6
0.2,9202,92,769660,83.63142453547756,9
0.2,9203,94,769754,83.63255106475445,8
0.2,9204,90,769844,83.63324280282455,11
0.2,9205,93,769937,83.63426026504453,9
0.2,9206,92,770029,83.63516889323341,9
0.2,9207,92,770121,83.63607732406604,9
0.2,9208,91,770212,83.6368769681833,10
0.2,9209,90,770302,83.63756786102063,11
0.2,9210,95,770397,83.63880143306916,7
0.2,9211,92,770489,83.63970907511941,10
0.2,9212,20,770509,83.63280147617498,12
0.2,9213,94,770603,83.63392663338398,7
0.2,9214,94,770697,83.63505154639175,7
0.2,9215,94,770791,83.63617621527777,7
0.2,9216,85,770876,83.63632418357383,17
0.2,9217,95,770971,83.63755695378607,7
0.2,9218,90,771061,83.63824709838377,11
0.2,9219,93,771154,83.63926247288504,8
0.2,9220,94,771248,83.64038607526298,8
0.2,9221,93,771341,83.6414009976144,8
0.2,9222,92,771433,83.64230727529004,9
0.2,9223,96,771529,83.64364700780573,6
0.2,9224,86,771615,83.64390243902439,15
0.2,9225,95,771710,83.64513331888142,6
0.2,9226,91,771801,83.64593042158882,11
0.2,9227,89,771890,83.64651061985262,12
0.2,9228,93,771983,83.64752410878752,8
0.2,9229,91,772074,83.64832069339111,10
0.2,9230,93,772167,83.64933376665583,9
0.2,9231,94,772261,83.65045493934142,7
0.2,9232,89,772350,83.65103433336944,12
0.2,9233,86,772436,83.6512887156162,15
0.2,9234,91,772527,83.65208446128858,10
0.2,9235,95,772622,83.65331312256389,7
0.2,9236,87,772709,83.65367543574753,14
0.2,9237,94,772803,83.65479541026197,7
0.2,9238,84,772887,83.65483277410975,17
0.2,9239,24,772911,83.64837662337662,9
0.2,9240,94,773005,83.6494968077048,7
0.2,9241,96,773101,83.65083315299718,6
0.2,9242,92,773193,83.6517364492048,9
0.2,9243,93,773286,83.65274772825616,8
0.2,9244,92,773378,83.65365062195781,9
0.2,9245,94,773472,83.65476963011032,8
0.2,9246,94,773566,83.65588839623662,8
0.2,9247,94,773660,83.65700692041523,7
0.2,9248,88,773748,83.65747648394421,13
0.2,9249,89,773837,83.65805405405405,12
0.2,9250,92,773929,83.6589557885634,9
0.2,9251,90,774019,83.65964115866839,12
0.2,9252,25,774044,83.65330163190316,7
0.2,9253,88,774132,83.65377134212233,13
0.2,9254,91,774223,83.65456509994597,10
0.2,9255,95,774318,83.65579083837511,6
0.2,9256,94,774412,83.6569082856217,8
0.2,9257,96,774508,83.65824152084683,6
0.2,9258,96,774604,83.65957446808511,6
0.2,9259,94,774698,83.66069114470842,8
0.2,9260,94,774792,83.66180758017492,7
0.2,9261,90,774882,83.6624919023969,11
0.2,9262,94,774976,83.66360790240742,7
0.2,9263,90,775066,83.66429188255613,12
0.2,9264,88,775154,83.66475984889368,13
0.2,9265,27,775181,83.65864450679905,6
0.2,9266,94,775275,83.65976044027194,7
0.2,9267,87,775362,83.66012084592145,14
0.2,9268,93,775455,83.66112849282555,8
0.2,9269,92,775547,83.66202804746494,10
0.2,9270,94,775641,83.66314313450545,7
0.2,9271,95,775736,83.66436583261432,7
0.2,9272,92,775828,83.66526474711529,9
0.2,9273,87,775915,83.66562432607289,16
0.2,9274,92,776007,83.66652291105122,9
0.2,9275,93,776100,83.66752910737387,8
0.2,9276,94,776194,83.66864288024146,7
0.2,9277,92,776286,83.66954084932098,9
0.2,9278,91,776377,83.67033085461796,12
0.2,9279,94,776471,83.67144396551724,7
0.2,9280,93,776564,83.67244908953776,9
0.2,9281,94,776658,83.67356173238527,7
0.2,9282,92,776750,83.67445868792416,9
0.2,9283,94,776844,83.675570874623,7
0.2,9284,95,776939,83.67679052234787,6
0.2,9285,94,777033,83.67790221839329,7
0.2,9286,93,777126,83.67890599763109,8
0.2,9287,93,777219,83.67990956072352,8
0.2,9288,92,777311,83.68080525352568,9
0.2,9289,91,777402,83.6815931108719,10
0.2,9290,94,777496,83.6827036917447,7
0.2,9291,94,777590,83.68381403357728,7
0.2,9292,94,777684,83.68492413644678,7
0.2,9293,92,777776,83.68581880783302,10
0.2,9294,83,777859,83.68574502420657,18
0.2,9295,92,777951,83.68663941480206,11
0.2,9296,88,778039,83.68710336667742,13
0.2,9297,87,778126,83.68745966874597,14
0.2,9298,96,778222,83.68878374018712,6
0.2,9299,96,778318,83.69010752688172,6
0.2,9300,92,778410,83.69100096763789,9
0.2,9301,91,778501,83.69178671253493,10
0.2,9302,92,778593,83.69267978071589,9
0.2,9303,92,778685,83.69357265692176,9
0.2,9304,91,778776,83.69435787211177,10
0.2,9305,93,778869,83.6953578336557,8
0.2,9306,89,778958,83.69592779628236,12
0.2,9307,92,779050,83.6968199398367,9
0.2,9308,-122,778928,83.67472338597057,17
0.2,9309,94,779022,83.67583243823846,8
0.2,9310,89,779111,83.67640425303405,12
0.2,9311,95,779206,83.67762027491409,6
0.2,9312,96,779302,83.67894341243424,6
0.2,9313,96,779398,83.68026626583638,6
0.2,9314,83,779481,83.68019323671497,19
0.2,9315,92,779573,83.68108630313439,9
0.2,9316,96,779669,83.68240850059031,6
0.2,9317,96,779765,83.68373041425198,6
0.2,9318,96,779861,83.68505204421075,7
0.2,9319,19,779880,83.67811158798283,16
0.2,9320,86,779966,83.678360690913,15
0.2,9321,94,780060,83.67946792533792,8
0.2,9322,96,780156,83.68078944545746,6
0.2,9323,95,780251,83.68200343200343,6
0.2,9324,94,780345,83.68310991957105,8
0.2,9325,94,780439,83.68421616984774,7
0.2,9326,-58,780381,83.6690254100997,22
0.2,9327,94,780475,83.67013293310463,7
0.2,9328,92,780567,83.67102583342266,9
0.2,9329,90,780657,83.67170418006431,11
0.2,9330,92,780749,83.67259672060872,10
0.2,9331,94,780843,83.67370338619803,7
0.2,9332,86,780929,83.67395264116576,15
0.2,9333,95,781024,83.67516605956718,6
0.2,9334,95,781119,83.67637921799678,7
0.2,9335,92,781211,83.6772707797772,9
0.2,9336,93,781304,83.67826925136553,8
0.2,9337,94,781398,83.67937459841508,7
0.2,9338,92,781490,83.68026555305707,9
0.2,9339,92,781582,83.68115631691649,10
0.2,9340,94,781676,83.68226099989295,7
0.2,9341,93,781769,83.68325840291158,8
0.2,9342,95,781864,83.68446965642727,6
0.2,9343,90,781954,83.68514554794521,13
0.2,9344,84,782038,83.68517924023541,17
0.2,9345,91,782129,83.68596190883801,10
0.2,9346,94,782223,83.68706536856746,8
0.2,9347,92,782315,83.68795464270433,9
0.2,9348,90,782405,83.68862979997861,12
0.2,9349,95,782500,83.68983957219251,6
0.2,9350,94,782594,83.69094214522511,7
0.2,9351,93,782687,83.6919375534645,9
0.2,9352,95,782782,83.69314658398375,6
0.2,9353,92,782874,83.6940346375882,9
0.2,9354,95,782969,83.69524318546232,6
0.2,9355,95,783064,83.69645147498932,6
0.2,9356,94,783158,83.69755263439137,7
0.2,9357,96,783254,83.69886727933319,6
0.2,9358,91,783345,83.6996473982263,10
0.2,9359,90,783435,83.70032051282051,11
0.2,9360,24,783459,83.69394295481251,10
0.2,9361,91,783550,83.6947233497116,10
0.2,9362,26,783576,83.68856135853893,7
0.2,9363,92,783668,83.6894489534387,9
0.2,9364,95,783763,83.69065670048052,7
0.2,9365,96,783859,83.6919709587871,6
0.2,9366,90,783949,83.69264438987936,11
0.2,9367,94,784043,83.69374466268147,7
0.2,9368,90,784133,83.69441776070018,11
0.2,9369,96,784229,83.6957310565635,6
0.2,9370,90,784319,83.69640379895422,12
0.2,9371,93,784412,83.6973965002134,11
0.2,9372,94,784506,83.6984956790782,8
0.2,9373,94,784600,83.69959462342649,8
0.2,9374,87,784687,83.69994666666666,14
0.2,9375,88,784775,83.7004052901024,14
0.2,9376,93,784868,83.70139703529914,9
0.2,9377,92,784960,83.70228193644701,10
0.2,9378,92,785052,83.70316664889647,9
0.2,9379,95,785147,83.70437100213219,6
0.2,9380,84,785231,83.70440251572327,17
0.2,9381,96,785327,83.70571306757621,6
0.2,9382,95,785422,83.70691676436108,6
0.2,9383,94,785516,83.7080136402387,7
0.2,9384,93,785609,83.70900372935536,8
0.2,9385,94,785703,83.71010014915832,7
0.2,9386,94,785797,83.71119633535741,8
0.2,9387,93,785890,83.71218576906689,8
0.2,9388,93,785983,83.71317499201193,8
0.2,9389,17,786000,83.70607028753993,15
0.2,9390,94,786094,83.70716643594932,7
0.2,9391,95,786189,83.70836882453152,8
0.2,9392,93,786282,83.70935803257746,9
0.2,9393,96,786378,83.71066638279753,6
0.2,9394,87,786465,83.71101649813731,14
0.2,9395,94,786559,83.71211153682418,7
0.2,9396,94,786653,83.71320634244972,7
0.2,9397,94,786747,83.71430091508832,7
0.2,9398,85,786832,83.71443770613895,16
0.2,9399,92,786924,83.71531914893617,9
0.2,9400,94,787018,83.7164131475375,7
0.2,9401,92,787110,83.71729419272495,9
0.2,9402,26,787136,83.71115601403807,7
0.2,9403,92,787228,83.71203743088047,10
0.2,9404,90,787318,83.71270600744285,11
0.2,9405,92,787410,83.71358707208165,9
0.2,9406,95,787505,83.7147868608483,6
0.2,9407,89,787594,83.71534863945578,13
0.2,9408,93,787687,83.71633542353067,8
0.2,9409,89,787776,83.71689691817215,12
0.2,9410,93,787869,83.7178833280204,8
0.2,9411,94,787963,83.71897577560561,7
0.2,9412,92,788055,83.71985551896313,9
0.2,9413,90,788145,83.72052262587636,11
0.2,9414,90,788235,83.72118959107807,11
0.2,9415,96,788331,83.72249362786746,6
0.2,9416,92,788423,83.72337262397791,9
0.2,9417,95,788518,83.72456997239328,6
0.2,9418,90,788608,83.72523622465229,11
0.2,9419,22,788630,83.71868365180467,13
0.2,9420,20,788650,83.71192017832502,12
0.2,9421,92,788742,83.71279983018468,10
0.2,9422,89,788831,83.7133609253953,12
0.2,9423,92,788923,83.714240237691,9
0.2,9424,94,789017,83.71533156498674,9
0.2,9425,91,789108,83.71610439210694,11
0.2,9426,94,789202,83.71719529012411,8
0.2,9427,95,789297,83.71839202375901,7
0.2,9428,92,789389,83.71927033619684,9
0.2,9429,92,789481,83.72014846235419,9
0.2,9430,92,789573,83.72102640229032,9
0.2,9431,92,789665,83.72190415606447,9
0.2,9432,95,789760,83.72309975617513,7
0.2,9433,95,789855,83.72429510281958,7
0.2,9434,17,789872,83.7172231054584,16
0.2,9435,91,789963,83.71799491309876,10
0.2,9436,93,790056,83.71897848892657,8
0.2,9437,95,790151,83.72017376562832,8
0.2,9438,93,790244,83.72115690221422,8
0.2,9439,94,790338,83.72224576271186,7
0.2,9440,92,790430,83.72312255057727,10
0.2,9441,23,790453,83.71669137894514,9
0.2,9442,89,790542,83.71725087366303,12
0.2,9443,91,790633,83.71802202456587,11
0.2,9444,92,790725,83.71889888830069,9
0.2,9445,93,790818,83.71988143129367,8
0.2,9446,93,790911,83.720863766275,8
0.2,9447,91,791002,83.72163420829806,10
0.2,9448,90,791092,83.72229865594242,11
0.2,9449,96,791188,83.72359788359789,6
0.2,9450,95,791283,83.7247910274045,6
0.2,9451,17,791300,83.71773169699534,15
0.2,9452,90,791390,83.7183962763144,11
0.2,9453,94,791484,83.71948381637402,8
0.2,9454,93,791577,83.7204653622422,8
0.2,9455,94,791671,83.7215524534687,7
0.2,9456,94,791765,83.72263931479327,7
0.2,9457,94,791859,83.72372594628885,7
0.2,9458,95,791954,83.724918067449,6
0.2,9459,94,792048,83.72600422832981,8
0.2,9460,89,792137,83.72656167424162,12
0.2,9461,27,792164,83.72056647643204,6
0.2,9462,89,792253,83.72112437916094,14
0.2,9463,88,792341,83.72157650042266,13
0.2,9464,91,792432,83.72234548335975,10
0.2,9465,92,792524,83.72321994506656,11
0.2,9466,96,792620,83.72451674236822,7
0.2,9467,95,792715,83.7257076468103,6
0.2,9468,93,792808,83.7266870841694,8
0.2,9469,93,792901,83.72766631467793,8
0.2,9470,96,792997,83.72896209481576,7
0.2,9471,82,793079,83.7287795608108,19
0.2,9472,92,793171,83.72965269713924,9
0.2,9473,94,793265,83.73073675321933,7
0.2,9474,87,793352,83.73108179419525,15
0.2,9475,90,793442,83.73174335162516,11
0.2,9476,92,793534,83.73261580668988,9
0.2,9477,92,793626,83.73348807765352,9
0.2,9478,89,793715,83.7340436754932,13
0.2,9479,25,793740,83.72784810126582,8
0.2,9480,96,793836,83.72914249551735,6
0.2,9481,93,793929,83.73012022780004,9
0.2,9482,91,794020,83.7308868501529,10
0.2,9483,94,794114,83.73196963306621,7
0.2,9484,90,794204,83.73263046916183,11
0.2,9485,92,794296,83.73350200295172,9
0.2,9486,91,794387,83.73426794560979,10
0.2,9487,94,794481,83.73534991568297,7
0.2,9488,93,794574,83.73632627252609,8
0.2,9489,89,794663,83.73688092729189,12
0.2,9490,89,794752,83.73743546517754,12
0.2,9491,21,794773,83.73082595870207,11
0.2,9492,90,794863,83.73148635836932,11
0.2,9493,93,794956,83.73246260796293,8
0.2,9494,94,795050,83.7335439705108,7
0.2,9495,86,795136,83.73378264532435,16
0.2,9496,92,795228,83.73465304833105,9
0.2,9497,95,795323,83.73583912402611,6
0.2,9498,91,795414,83.73660385303717,11
0.2,9499,95,795509,83.73778947368422,7
0.2,9500,89,795598,83.7383433322808,12
0.2,9501,95,795693,83.73952852031151,6
0.2,9502,23,795716,83.73313690413553,9
0.2,9503,94,795810,83.73421717171718,7
0.2,9504,86,795896,83.73445554971067,16
0.2,9505,90,795986,83.73511466442247,11
0.2,9506,90,796076,83.73577364047544,11
0.2,9507,95,796171,83.73695835086244,6
0.2,9508,93,796264,83.7379324850142,8
0.2,9509,92,796356,83.73880126182965,9
0.2,9510,91,796447,83.73956471454106,10
0.2,9511,91,796538,83.74032800672835,10
0.2,9512,90,796628,83.74098601913171,12
0.2,9513,93,796721,83.74195921799453,9
0.2,9514,24,796745,83.73568050446663,9
0.2,9515,87,796832,83.73602353930222,15
0.2,9516,93,796925,83.73699695282127,8
0.2,9517,92,797017,83.7378650977096,10
0.2,9518,94,797111,83.73894316629898,7
0.2,9519,90,797201,83.73960084033614,11
0.2,9520,93,797294,83.74057346917341,9
0.2,9521,94,797388,83.7416509136736,7
0.2,9522,87,797475,83.7419930694109,14
0.2,9523,92,797567,83.74286014279714,9
0.2,9524,27,797594,83.73690288713911,6
0.2,9525,94,797688,83.73798026453916,7
0.2,9526,92,797780,83.73884748609215,10
0.2,9527,93,797873,83.73981947942904,8
0.2,9528,92,797965,83.74068632595235,10
0.2,9529,93,798058,83.74165792235047,8
0.2,9530,26,798084,83.73559962228518,7
0.2,9531,91,798175,83.73636172891314,10
0.2,9532,92,798267,83.73722857442569,10
0.2,9533,93,798360,83.73820012586532,8
0.2,9534,92,798452,83.73906659674881,9
0.2,9535,93,798545,83.74003775167785,8
0.2,9536,94,798639,83.74111355772256,7
0.2,9537,95,798734,83.74229398196687,6
0.2,9538,93,798827,83.74326449313345,8
0.2,9539,96,798923,83.74454926624738,6
0.2,9540,95,799018,83.74572895922859,6
0.2,9541,91,799109,83.74648920561727,10
0.2,9542,87,799196,83.74683013727339,15
0.2,9543,93,799289,83.74779966471081,8
0.2,9544,90,799379,83.74845468831849,11
0.2,9545,92,799471,83.74931908652839,9
0.2,9546,91,799562,83.75007855870955,10
0.2,9547,96,799658,83.75136154168412,6
0.2,9548,92,799750,83.75222536391246,9
0.2,9549,94,799844,83.75329842931937,7
0.2,9550,93,799937,83.75426656894567,8
0.2,9551,92,800029,83.75512981574539,9
0.2,9552,93,800122,83.7560975609756,8
0.2,9553,87,800209,83.75643709441071,14
0.2,9554,27,800236,83.75049712192569,6
0.2,9555,96,800332,83.75177898702385,6
0.2,9556,96,800428,83.75306058386523,6
0.2,9557,95,800523,83.7542372881356,6
0.2,9558,95,800618,83.75541374620776,6
0.2,9559,90,800708,83.75606694560669,11
0.2,9560,93,800801,83.75703378307709,8
0.2,9561,92,800893,83.75789583769085,9
0.2,9562,94,800987,83.75896685140646,8
0.2,9563,95,801082,83.76014219991636,8
0.2,9564,94,801176,83.76121275483534,7
0.2,9565,94,801270,83.76228308592934,7
0.2,9566,17,801287,83.75530469321626,16
0.2,9567,89,801376,83.75585284280936,12
0.2,9568,79,801455,83.75535583655554,22
0.2,9569,93,801548,83.75632183908046,8
0.2,9570,90,801638,83.75697419287431,11
0.2,9571,96,801734,83.75825323861262,6
0.2,9572,94,801828,83.75932309620808,7
0.2,9573,93,801921,83.76028828076039,8
0.2,9574,94,802015,83.76135770234987,7
0.2,9575,92,802107,83.76221804511279,9
0.2,9576,96,802203,83.76349587553514,6
0.2,9577,89,802292,83.76404259761955,12
0.2,9578,94,802386,83.7651111807078,7
0.2,9579,93,802479,83.7660751565762,8
0.2,9580,92,802571,83.76693455797934,9
0.2,9581,89,802660,83.76748069296598,12
0.2,9582,93,802753,83.76844411979548,8
0.2,9583,92,802845,83.76930300500835,10
0.2,9584,91,802936,83.77005738132499,10
0.2,9585,94,803030,83.7711245566451,9
0.2,9586,89,803119,83.7716699697507,12
0.2,9587,91,803210,83.77242386316229,10
0.2,9588,93,803303,83.77338617165502,8
0.2,9589,92,803395,83.77424400417101,9
0.2,9590,93,803488,83.77520592221875,8
0.2,9591,95,803583,83.77637614678899,7
0.2,9592,93,803676,83.77733764203064,9
0.2,9593,93,803769,83.77829893683553,8
0.2,9594,91,803860,83.77905158936946,10
0.2,9595,90,803950,83.7796998749479,11
0.2,9596,94,804044,83.78076482234032,7
0.2,9597,93,804137,83.78172535944988,8
0.2,9598,92,804229,83.78258151890822,9
0.2,9599,93,804322,83.78354166666666,8
0.2,9600,94,804416,83.78460577023226,8
0.2,9601,94,804510,83.7856696521558,7
0.2,9602,94,804604,83.78673331250651,7
0.2,9603,96,804700,83.78800499791754,6
0.2,9604,91,804791,83.78875585632483,10
0.2,9605,94,804885,83.7898188632105,7
0.2,9606,94,804979,83.79088164879775,8
0.2,9607,90,805069,83.79152789342214,11
0.2,9608,90,805159,83.79217400353835,11
0.2,9609,23,805182,83.78584807492196,10
0.2,9610,87,805269,83.78618249921965,14
0.2,9611,94,805363,83.78724511027882,7
0.2,9612,87,805450,83.78757931967128,14
0.2,9613,81,805531,83.78728936966924,20
0.2,9614,92,805623,83.78814352574103,10
0.2,9615,90,805713,83.78878951747089,11
0.2,9616,91,805804,83.78953935738797,11
0.2,9617,92,805896,83.79039301310044,9
0.2,9618,94,805990,83.79145441314066,9
0.2,9619,93,806083,83.79241164241164,9
0.2,9620,94,806177,83.7934726119946,8
0.2,9621,94,806271,83.7945333610476,7
0.2,9622,94,806365,83.7955938896394,7
0.2,9623,88,806453,83.79603075644222,14
0.2,9624,95,806548,83.7971948051948,7
0.2,9625,92,806640,83.7980469561604,9
0.2,9626,94,806734,83.79910667913161,7
0.2,9627,92,806826,83.79995845450769,9
0.2,9628,96,806922,83.80122546474192,6
0.2,9629,94,807016,83.80228452751817,7
0.2,9630,95,807111,83.80344720174436,7
0.2,9631,95,807206,83.8046096345515,7
0.2,9632,94,807300,83.80566801619433,8
0.2,9633,95,807395,83.80682997716421,7
0.2,9634,93,807488,83.8077841203944,8
0.2,9635,-53,807435,83.79358655043586,16
0.2,9636,89,807524,83.79412680294698,12
0.2,9637,94,807618,83.79518572317909,7
0.2,9638,95,807713,83.79634816889718,6
0.2,9639,95,807808,83.79751037344398,6
0.2,9640,95,807903,83.79867233689451,6
0.2,9641,94,807997,83.79973034640116,7
0.2,9642,90,808087,83.80037332780255,12
0.2,9643,24,808111,83.79417254251348,8
0.2,9644,92,808203,83.7950233281493,9
0.2,9645,90,808293,83.79566659755339,11
0.2,9646,94,808387,83.79672437027055,7
0.2,9647,92,808479,83.79757462686567,9
0.2,9648,90,808569,83.79821743185822,11
0.2,9649,95,808664,83.79937823834197,7
0.2,9650,95,808759,83.80053880426898,6
0.2,9651,95,808854,83.80169912971405,6
0.2,9652,86,808940,83.80192686211541,15
0.2,9653,91,809031,83.80267246737104,10
0.2,9654,88,809119,83.80310719834283,14
0.2,9655,91,809210,83.80385252692626,10
0.2,9656,91,809301,83.80459770114942,10
0.2,9657,94,809395,83.80565334437772,7
0.2,9658,94,809489,83.80670876902371,8
0.2,9659,95,809584,83.80786749482402,7
0.2,9660,94,809678,83.8089224717938,7
0.2,9661,86,809764,83.80914924446284,15
0.2,9662,93,809857,83.81010038290385,8
0.2,9663,94,809951,83.8111548013245,8
0.2,9664,95,810046,83.81231246766684,6
0.2,9665,94,810140,83.81336643906477,7
0.2,9666,95,810235,83.81452363711597,6
0.2,9667,92,810327,83.81537029375258,9
0.2,9668,91,810418,83.81611335194953,10
0.2,9669,91,810509,83.81685625646328,12
0.2,9670,92,810601,83.81770240926481,9
0.2,9671,96,810697,83.81896195202647,6
0.2,9672,92,810789,83.81980771218856,9
0.2,9673,96,810885,83.82106677692785,6
0.2,9674,88,810973,83.82149870801034,13
0.2,9675,93,811066,83.82244729226953,8
0.2,9676,92,811158,83.82329234266818,9
0.2,9677,88,811246,83.82372390989875,13
0.2,9678,94,811340,83.82477528670317,7
0.2,9679,91,811431,83.82551652892562,10
0.2,9680,94,811525,83.8265675033571,7
0.2,9681,15,811540,83.8194587895063,17
0.2,9682,90,811630,83.82009707735206,12
0.2,9683,87,811717,83.82042544403139,14
0.2,9684,93,811810,83.82137325761487,8
0.2,9685,88,811898,83.821804666529,13
0.2,9686,93,811991,83.82275214204604,8
0.2,9687,90,812081,83.82338976052849,12
0.2,9688,95,812176,83.82454329652182,6
0.2,9689,22,812198,83.81816305469556,12
0.2,9690,96,812294,83.81942008048705,6
0.2,9691,94,812388,83.8204704911267,7
0.2,9692,19,812407,83.81378314247395,13
0.2,9693,94,812501,83.81483391788736,7
0.2,9694,22,812523,83.80845796802475,10
0.2,9695,94,812617,83.80950907590758,7
0.2,9696,88,812705,83.80994121893369,13
0.2,9697,91,812796,83.81068261497217,10
0.2,9698,27,812823,83.80482523971544,6
0.2,9699,94,812917,83.80587628865979,8
0.2,9700,95,813012,83.80703020307185,8
0.2,9701,90,813102,83.80766852195424,11
0.2,9702,93,813195,83.80861589199216,8
0.2,9703,23,813218,83.80234954657872,9
0.2,9704,89,813307,83.80288511076765,12
0.2,9705,90,813397,83.80352359365341,11
0.2,9706,90,813487,83.80416194498815,11
0.2,9707,89,813576,83.80469715698393,13
0.2,9708,90,813666,83.8053352559481,11
0.2,9709,92,813758,83.80617919670443,9
0.2,9710,92,813850,83.80702296364947,9
0.2,9711,94,813944,83.80807248764415,7
0.2,9712,91,814035,83.80881293112324,10
0.2,9713,90,814125,83.80945027794935,11
0.2,9714,22,814147,83.8030880082347,12
0.2,9715,87,814234,83.80341704405105,14
0.2,9716,90,814324,83.80405474940825,11
0.2,9717,91,814415,83.80479522535501,10
0.2,9718,93,814508,83.80574133141269,8
0.2,9719,95,814603,83.80689300411522,7
0.2,9720,96,814699,83.80814730994754,6
0.2,9721,93,814792,83.80909277926352,8
0.2,9722,93,814885,83.81003805409853,8
0.2,9723,89,814974,83.81057178116002,13
0.2,9724,95,815069,83.81172236503856,6
0.2,9725,90,815159,83.81235862636233,11
0.2,9726,96,815255,83.81361159658682,6
0.2,9727,93,815348,83.81455592105263,9
0.2,9728,94,815442,83.81560283687944,7
0.2,9729,83,815525,83.81551901336074,18
0.2,9730,90,815615,83.81615455759942,12
0.2,9731,89,815704,83.81668721742705,12
0.2,9732,94,815798,83.81773348402342,8
0.2,9733,91,815889,83.81847133757962,10
0.2,9734,90,815979,83.8191063174114,11
0.2,9735,91,816070,83.81984387838948,11
0.2,9736,86,816156,83.8200677826846,15
0.2,9737,27,816183,83.81423290203327,6
0.2,9738,94,816277,83.81527877605504,8
0.2,9739,93,816370,83.81622176591375,8
0.2,9740,92,816462,83.81706190329535,9
0.2,9741,80,816542,83.81667008827756,21
0.2,9742,91,816633,83.81740736939341,10
0.2,9743,93,816726,83.81834975369458,8
0.2,9744,93,816819,83.81929194458696,8
0.2,9745,93,816912,83.8202339421301,8
0.2,9746,93,817005,83.8211757463835,8
0.2,9747,91,817096,83.8219121871153,12
0.2,9748,94,817190,83.82295620063596,7
0.2,9749,95,817285,83.82410256410256,6
0.2,9750,92,817377,83.82494103168906,10
0.2,9751,95,817472,83.82608695652173,6
0.2,9752,94,817566,83.82713011381114,8
0.2,9753,95,817661,83.82827557924954,6
0.2,9754,96,817757,83.82952332137366,6
0.2,9755,96,817853,83.83077080770808,6
0.2,9756,92,817945,83.83160807625295,9
0.2,9757,87,818032,83.83193277310924,15
0.2,9758,93,818125,83.8328722205144,10
0.2,9759,95,818220,83.83401639344262,6
0.2,9760,94,818314,83.83505788341358,7
0.2,9761,25,818339,83.82903093628354,8
0.2,9762,88,818427,83.82945815835296,13
0.2,9763,92,818519,83.83029496108152,9
0.2,9764,21,818540,83.82386072708654,12
0.2,9765,94,818634,83.8249027237354,7
0.2,9766,89,818723,83.82543257909286,13
0.2,9767,93,818816,83.82637182637183,8
0.2,9768,91,818907,83.82710615211383,10
0.2,9769,90,818997,83.82773797338793,11
0.2,9770,90,819087,83.8283696653362,11
0.2,9771,90,819177,83.82900122799836,13
0.2,9772,86,819263,83.82922337051059,15
0.2,9773,21,819284,83.82279517086147,12
0.2,9774,94,819378,83.82383631713554,7
0.2,9775,93,819471,83.82477495908347,8
0.2,9776,92,819563,83.82561112815792,9
0.2,9777,92,819655,83.82644712620167,9
0.2,9778,96,819751,83.82769199304633,6
0.2,9779,94,819845,83.82873210633947,7
0.2,9780,90,819935,83.8293630508128,11
0.2,9781,89,820024,83.8298916377019,12
0.2,9782,94,820118,83.83093120719616,7
0.2,9783,89,820207,83.83145952575634,13
0.2,9784,91,820298,83.83219213081247,10
0.2,9785,88,820386,83.83261802575107,14
0.2,9786,-45,820341,83.81945437825686,8
0.2,9787,95,820436,83.8205966489579,6
0.2,9788,88,820524,83.82102359791602,13
0.2,9789,91,820615,83.8217568947906,10
0.2,9790,89,820704,83.82228577264836,12
0.2,9791,82,820786,83.82209967320262,20
0.2,9792,95,820881,83.8232410905749,6
0.2,9793,92,820973,83.82407596487646,9
0.2,9794,96,821069,83.8253190403267,6
0.2,9795,93,821162,83.82625561453655,8
0.2,9796,94,821256,83.82729406961315,7
0.2,9797,88,821344,83.82771994284548,13
0.2,9798,94,821438,83.82875803653434,8
0.2,9799,91,821529,83.82948979591836,10
0.2,9800,88,821617,83.8299153147638,13
0.2,9801,96,821713,83.83115690675372,6
0.2,9802,89,821802,83.83168417831276,12
0.2,9803,92,821894,83.83251733986128,10
0.2,9804,94,821988,83.83355430902601,7
0.2,9805,90,822078,83.83418315317152,11
0.2,9806,94,822172,83.83521974100132,7
0.2,9807,96,822268,83.83646003262643,7
0.2,9808,89,822357,83.83698644102356,12
0.2,9809,93,822450,83.83792048929664,8
0.2,9810,93,822543,83.83885434716134,8
0.2,9811,90,822633,83.83948226661231,11
0.2,9812,-51,822582,83.8257413634974,15
0.2,9813,20,822602,83.81923782351743,12
0.2,9814,94,822696,83.82027508914926,7
0.2,9815,88,822784,83.82070089649552,13
0.2,9816,96,822880,83.82194152999898,6
0.2,9817,94,822974,83.82297820330007,7
0.2,9818,87,823061,83.8233017618902,14
0.2,9819,94,823155,83.82433808553971,7
0.2,9820,90,823245,83.82496690764688,12
0.2,9821,87,823332,83.82529016493586,14
0.2,9822,88,823420,83.82571515830195,13
0.2,9823,89,823509,83.82624185667753,12
0.2,9824,92,823601,83.8270737913486,9
0.2,9825,96,823697,83.82831263993486,6
0.2,9826,95,823792,83.82944947593366,6
0.2,9827,96,823888,83.83068783068784,6
0.2,9828,95,823983,83.83182419371248,6
0.2,9829,91,824074,83.8325534079349,11
0.2,9830,89,824163,83.83307903570339,13
0.2,9831,93,824256,83.8340113913751,9
0.2,9832,90,824346,83.83463846232075,11
0.2,9833,84,824430,83.83465527760829,17
0.2,9834,92,824522,83.83548551093035,9
0.2,9835,93,824615,83.83641724278162,8
0.2,9836,93,824708,83.83734878519874,8
0.2,9837,87,824795,83.83767025818256,14
0.2,9838,94,824889,83.83870312023579,7
0.2,9839,86,824975,83.83892276422765,16
0.2,9840,90,825065,83.83954882633878,11
0.2,9841,93,825158,83.84047957732169,8
0.2,9842,89,825247,83.84100375901656,12
0.2,9843,93,825340,83.84193417310037,9
0.2,9844,95,825435,83.84306754697816,6
0.2,9845,91,825526,83.84379443428804,10
0.2,9846,94,825620,83.84482583527978,7
0.2,9847,96,825716,83.84606011372868,6
0.2,9848,85,825801,83.84617727688091,16
0.2,9849,96,825897,83.84741116751269,6
0.2,9850,93,825990,83.84834027002334,8
0.2,9851,94,826084,83.8493706861551,8
0.2,9852,94,826178,83.85040089312899,8
0.2,9853,92,826270,83.85122792774507,11
0.2,9854,91,826361,83.8519533231862,11
0.2,9855,90,826451,83.8525771103896,12
0.2,9856,90,826541,83.85320077102567,11
0.2,9857,90,826631,83.85382430513289,11
0.2,9858,26,826657,83.84795618216857,6
0.2,9859,90,826747,83.84858012170385,11
0.2,9860,-55,826692,83.83449954365683,18
0.2,9861,91,826783,83.83522612046238,10
0.2,9862,92,826875,83.8360539389638,9
0.2,9863,87,826962,83.83637469586375,14
0.2,9864,90,827052,83.83699949315763,12
0.2,9865,94,827146,83.83802959659437,8
0.2,9866,87,827233,83.83835005574136,14
0.2,9867,94,827327,83.83937981353871,7
0.2,9868,95,827422,83.84051069003952,7
0.2,9869,90,827512,83.84113475177305,11
0.2,9870,91,827603,83.84185999392159,10
0.2,9871,92,827695,83.84268638573744,9
0.2,9872,90,827785,83.84331003747594,11
0.2,9873,92,827877,83.84413611504962,10
0.2,9874,94,827971,83.84516455696202,7
0.2,9875,95,828066,83.84629404617255,6
0.2,9876,94,828160,83.84732206135466,9
0.2,9877,93,828253,83.84824863332659,8
0.2,9878,85,828338,83.84836521915173,16
0.2,9879,27,828365,83.84261133603239,6
0.2,9880,93,828458,83.84353810343083,8
0.2,9881,96,828554,83.84476826553329,6
0.2,9882,95,828649,83.84589699483962,6
0.2,9883,90,828739,83.8465196276811,13
0.2,9884,93,828832,83.84744562468387,8
0.2,9885,93,828925,83.8483714343516,8
0.2,9886,94,829019,83.84939819965611,7
0.2,9887,88,829107,83.84981796116504,14
0.2,9888,96,829203,83.85104661745373,6
0.2,9889,92,829295,83.85187057633973,10
0.2,9890,22,829317,83.84561722778284,10
0.2,9891,95,829412,83.84674484431864,8
0.2,9892,93,829505,83.84767006974629,8
0.2,9893,88,829593,83.84808975136447,14
0.2,9894,88,829681,83.84850934815563,13
0.2,9895,95,829776,83.8496362166532,7
0.2,9896,94,829870,83.85066181671213,8
0.2,9897,89,829959,83.8511820569812,13
0.2,9898,96,830055,83.85240933427619,7
0.2,9899,82,830137,83.85222222222222,19
0.2,9900,95,830232,83.85334814665185,7
0.2,9901,94,830326,83.8543728539689,7
0.2,9902,91,830417,83.85509441583359,10
0.2,9903,91,830508,83.85581583198707,10
0.2,9904,94,830602,83.85683997980817,8
0.2,9905,85,830687,83.85695538057743,16
0.2,9906,94,830781,83.85797920662158,7
0.2,9907,93,830874,83.8589018974566,8
0.2,9908,94,830968,83.85992532041578,7
0.2,9909,91,831059,83.86064581231079,10
0.2,9910,91,831150,83.86136615881344,10
0.2,9911,96,831246,83.86259079903148,6
0.2,9912,86,831332,83.86280641581762,15
0.2,9913,89,831421,83.86332459148679,13
0.2,9914,91,831512,83.86404437720626,10
0.2,9915,94,831606,83.8650665590964,7
0.2,9916,27,831633,83.85933245941312,6
0.2,9917,27,831660,83.85359951603145,7
0.2,9918,92,831752,83.85442080854925,9
0.2,9919,94,831846,83.8554435483871,7
0.2,9920,94,831940,83.85646608204819,7
0.2,9921,94,832034,83.85748840959484,7
0.2,9922,89,832123,83.85800665121435,14
0.2,9923,95,832218,83.85912938331317,6
0.2,9924,94,832312,83.86015113350126,7
0.2,9925,87,832399,83.86046745919806,14
0.2,9926,94,832493,83.86148886874182,7
0.2,9927,85,832578,83.8616035455278,22
0.2,9928,90,832668,83.86222177459966,11
0.2,9929,90,832758,83.86283987915408,11
0.2,9930,89,832847,83.8633571644346,12
0.2,9931,96,832943,83.86457913813935,6
0.2,9932,88,833031,83.86499546964663,13
0.2,9933,89,833120,83.86551238171934,12
0.2,9934,91,833211,83.86623049823855,10
0.2,9935,25,833236,83.86030595813205,7
0.2,9936,95,833331,83.86142699003723,8
0.2,9937,94,833425,83.86244717246932,7
0.2,9938,94,833519,83.86346714961263,7
0.2,9939,23,833542,83.85734406438631,11
0.2,9940,92,833634,83.8581631626597,9
0.2,9941,89,833723,83.85868034600684,13
0.2,9942,88,833811,83.85909685205672,13
0.2,9943,95,833906,83.86021721641191,6
0.2,9944,90,833996,83.86083459024636,11
0.2,9945,91,834087,83.86155238286749,10
0.2,9946,93,834180,83.86247109681311,9
0.2,9947,85,834265,83.86258544431041,17
0.2,9948,88,834353,83.86300130666399,13
0.2,9949,90,834443,83.86361809045226,11
0.2,9950,96,834539,83.86483770475328,6
0.2,9951,93,834632,83.86575562700965,8
0.2,9952,93,834725,83.86667336481463,9
0.2,9953,88,834813,83.86708860759494,13
0.2,9954,93,834906,83.86800602712205,8
0.2,9955,92,834998,83.8688228204098,9
0.2,9956,95,835093,83.86994074520437,6
0.2,9957,90,835183,83.87055633661377,11
0.2,9958,93,835276,83.87147303946179,8
0.2,9959,89,835365,83.87198795180723,12
0.2,9960,96,835461,83.87320550145567,6
0.2,9961,17,835478,83.86649267215418,15
0.2,9962,91,835569,83.86720867208672,10
0.2,9963,26,835595,83.86140104375752,7
0.2,9964,94,835689,83.86241846462619,7
0.2,9965,90,835779,83.8630343166767,11
0.2,9966,94,835873,83.86405136951942,8
0.2,9967,92,835965,83.86486757624398,9
0.2,9968,25,835990,83.85896278463235,8
0.2,9969,94,836084,83.85997993981945,7
0.2,9970,90,836174,83.86059572761008,11
0.2,9971,92,836266,83.86141195346971,9
0.2,9972,95,836361,83.86252882783515,6
0.2,9973,88,836449,83.8629436534991,13
0.2,9974,84,836533,83.86295739348371,17
0.2,9975,93,836626,83.86387329591018,8
0.2,9976,20,836646,83.85747218602786,14
0.2,9977,27,836673,83.85177390258569,6
0.2,9978,93,836766,83.85269065036577,9
0.2,9979,92,836858,83.85350701402805,9
0.2,9980,26,836884,83.84771065023544,6
0.2,9981,93,836977,83.8486275295532,9
0.2,9982,94,837071,83.8496443954723,7
0.2,9983,92,837163,83.85046073717949,9
0.2,9984,93,837256,83.8513770655984,8
0.2,9985,94,837350,83.85239335069097,7
0.2,9986,91,837441,83.85310904175428,11
0.2,9987,94,837535,83.85412494993993,7
0.2,9988,93,837628,83.85504054459906,8
0.2,9989,94,837722,83.85605605605606,7
0.2,9990,87,837809,83.8563707336603,15
0.2,9991,88,837897,83.85678542834268,13
0.2,9992,93,837990,83.8577003902732,8
0.2,9993,93,838083,83.85861516910145,9
0.2,9994,94,838177,83.85962981490745,7
0.2,9995,96,838273,83.86084433773509,6
0.2,9996,94,838367,83.86185855756727,8
0.2,9997,95,838462,83.86297259451891,6
0.2,9998,93,838555,83.86388638863886,8
0.2,9999,93,838648,83.8648,9
