0.2,0,-65,-65,-65.0,32
0.2,1,-62,-127,-63.5,32
0.2,2,14,-113,-37.666666666666664,35
0.2,3,86,-27,-6.75,23
0.2,4,20,-7,-1.4,22
0.2,5,12,5,0.8333333333333334,26
0.2,6,77,82,11.714285714285714,35
0.2,7,95,177,22.125,6
0.2,8,91,268,29.77777777777778,25
0.2,9,81,349,34.9,26
0.2,10,94,443,40.27272727272727,7
0.2,11,94,537,44.75,7
0.2,12,83,620,47.69230769230769,62
0.2,13,94,714,51.0,10
0.2,14,94,808,53.86666666666667,13
0.2,15,91,899,56.1875,10
0.2,16,89,988,58.11764705882353,14
0.2,17,91,1079,59.94444444444444,11
0.2,18,23,1102,58.0,10
0.2,19,96,1198,59.9,6
0.2,20,-49,1149,54.714285714285715,13
0.2,21,91,1240,56.36363636363637,11
0.2,22,87,1327,57.69565217391305,14
0.2,23,14,1341,55.875,18
0.2,24,96,1437,57.48,6
0.2,25,92,1529,58.80769230769231,9
0.2,26,-46,1483,54.925925925925924,10
0.2,27,95,1578,56.357142857142854,6
0.2,28,91,1669,57.55172413793103,11
0.2,29,88,1757,58.56666666666667,14
0.2,30,90,1847,59.58064516129032,12
0.2,31,94,1941,60.65625,7
0.2,32,95,2036,61.696969696969695,7
0.2,33,92,2128,62.588235294117645,11
0.2,34,91,2219,63.4,11
0.2,35,90,2309,64.13888888888889,12
0.2,36,89,2398,64.8108108108108,15
0.2,37,94,2492,65.57894736842105,8
0.2,38,24,2516,64.51282051282051,9
0.2,39,91,2607,65.175,10
0.2,40,95,2702,65.90243902439025,8
0.2,41,91,2793,66.5,10
0.2,42,90,2883,67.04651162790698,12
0.2,43,93,2976,67.63636363636364,8
0.2,44,95,3071,68.24444444444444,6
0.2,45,95,3166,68.82608695652173,6
0.2,46,95,3261,69.38297872340425,8
0.2,47,96,3357,69.9375,6
0.2,48,91,3448,70.36734693877551,12
0.2,49,95,3543,70.86,7
0.2,50,94,3637,71.31372549019608,9
0.2,51,93,3730,71.73076923076923,8
0.2,52,95,3825,72.16981132075472,7
0.2,53,79,3904,72.29629629629629,22
0.2,54,95,3999,72.7090909090909,6
0.2,55,94,4093,73.08928571428571,8
0.2,56,94,4187,73.45614035087719,8
0.2,57,26,4213,72.63793103448276,7
0.2,58,92,4305,72.96610169491525,13
0.2,59,96,4401,73.35,6
0.2,60,91,4492,73.63934426229508,10
0.2,61,88,4580,73.87096774193549,14
0.2,62,92,4672,74.15873015873017,9
0.2,63,95,4767,74.484375,6
0.2,64,94,4861,74.78461538461538,7
0.2,65,93,4954,75.06060606060606,8
0.2,66,96,5050,75.3731343283582,6
0.2,67,93,5143,75.63235294117646,8
0.2,68,90,5233,75.84057971014492,11
0.2,69,93,5326,76.08571428571429,10
0.2,70,88,5414,76.25352112676056,13
0.2,71,93,5507,76.48611111111111,8
0.2,72,89,5596,76.65753424657534,12
0.2,73,95,5691,76.9054054054054,6
0.2,74,94,5785,77.13333333333334,7
0.2,75,93,5878,77.34210526315789,8
0.2,76,90,5968,77.50649350649351,11
0.2,77,89,6057,77.65384615384616,12
0.2,78,93,6150,77.84810126582279,8
0.2,79,90,6240,78.0,11
0.2,80,87,6327,78.11111111111111,15
0.2,81,95,6422,78.3170731707317,7
0.2,82,91,6513,78.46987951807229,10
0.2,83,93,6606,78.64285714285714,8
0.2,84,93,6699,78.81176470588235,8
0.2,85,95,6794,79.0,6
0.2,86,92,6886,79.14942528735632,10
0.2,87,94,6980,79.31818181818181,7
0.2,88,93,7073,79.47191011235955,8
0.2,89,90,7163,79.58888888888889,11
0.2,90,93,7256,79.73626373626374,9
0.2,91,20,7276,79.08695652173913,13
0.2,92,94,7370,79.24731182795699,8
0.2,93,96,7466,79.42553191489361,6
0.2,94,95,7561,79.58947368421053,7
0.2,95,93,7654,79.72916666666667,8
0.2,96,92,7746,79.85567010309278,9
0.2,97,91,7837,79.96938775510205,10
0.2,98,96,7933,80.13131313131314,6
0.2,99,89,8022,80.22,12
0.2,100,94,8116,80.35643564356435,7
0.2,101,94,8210,80.49019607843137,7
0.2,102,87,8297,80.55339805825243,14
0.2,103,94,8391,80.6826923076923,7
0.2,104,91,8482,80.78095238095239,10
0.2,105,92,8574,80.88679245283019,9
0.2,106,90,8664,80.97196261682242,11
0.2,107,93,8757,81.08333333333333,8
0.2,108,92,8849,81.18348623853211,9
0.2,109,87,8936,81.23636363636363,15
0.2,110,25,8961,80.72972972972973,8
0.2,111,90,9051,80.8125,11
0.2,112,92,9143,80.91150442477876,9
0.2,113,92,9235,81.00877192982456,9
0.2,114,93,9328,81.11304347826086,8
0.2,115,90,9418,81.1896551724138,11
0.2,116,94,9512,81.2991452991453,7
0.2,117,22,9534,80.79661016949153,11
0.2,118,86,9620,80.84033613445378,15
0.2,119,93,9713,80.94166666666666,8
0.2,120,96,9809,81.06611570247934,6
0.2,121,94,9903,81.17213114754098,7
0.2,122,92,9995,81.26016260162602,9
0.2,123,92,10087,81.34677419354838,10
0.2,124,95,10182,81.456,6
0.2,125,93,10275,81.54761904761905,8
0.2,126,92,10367,81.62992125984252,9
0.2,127,26,10393,81.1953125,8
0.2,128,96,10489,81.31007751937985,6
0.2,129,91,10580,81.38461538461539,10
0.2,130,20,10600,80.91603053435115,13
0.2,131,-45,10555,79.96212121212122,8
0.2,132,90,10645,80.0375939849624,11
0.2,133,93,10738,80.13432835820896,8
0.2,134,91,10829,80.21481481481482,10
0.2,135,93,10922,80.30882352941177,8
0.2,136,93,11015,80.4014598540146,8
0.2,137,93,11108,80.4927536231884,8
0.2,138,88,11196,80.54676258992805,13
0.2,139,92,11288,80.62857142857143,9
0.2,140,90,11378,80.69503546099291,11
0.2,141,90,11468,80.7605633802817,11
0.2,142,95,11563,80.86013986013987,6
0.2,143,92,11655,80.9375,10
0.2,144,92,11747,81.01379310344828,9
0.2,145,92,11839,81.08904109589041,10
0.2,146,90,11929,81.14965986394557,11
0.2,147,94,12023,81.23648648648648,7
0.2,148,93,12116,81.31543624161074,10
0.2,149,89,12205,81.36666666666666,12
0.2,150,94,12299,81.45033112582782,9
0.2,151,88,12387,81.49342105263158,14
0.2,152,93,12480,81.56862745098039,8
0.2,153,93,12573,81.64285714285714,8
0.2,154,94,12667,81.72258064516129,7
0.2,155,95,12762,81.8076923076923,6
0.2,156,93,12855,81.87898089171975,8
0.2,157,93,12948,81.9493670886076,8
0.2,158,94,13042,82.0251572327044,7
0.2,159,25,13067,81.66875,8
0.2,160,96,13163,81.75776397515529,7
0.2,161,96,13259,81.84567901234568,6
0.2,162,91,13350,81.90184049079754,10
0.2,163,93,13443,81.96951219512195,8
0.2,164,95,13538,82.04848484848485,6
0.2,165,93,13631,82.1144578313253,8
0.2,166,96,13727,82.19760479041916,6
0.2,167,92,13819,82.25595238095238,10
0.2,168,96,13915,82.33727810650888,6
0.2,169,95,14010,82.41176470588235,7
0.2,170,91,14101,82.46198830409357,11
0.2,171,95,14196,82.53488372093024,7
0.2,172,95,14291,82.60693641618496,6
0.2,173,91,14382,82.65517241379311,10
0.2,174,89,14471,82.69142857142857,13
0.2,175,94,14565,82.75568181818181,7
0.2,176,93,14658,82.8135593220339,8
0.2,177,94,14752,82.87640449438203,8
0.2,178,95,14847,82.94413407821229,6
0.2,179,93,14940,83.0,8
0.2,180,91,15031,83.04419889502762,10
0.2,181,95,15126,83.10989010989012,6
0.2,182,95,15221,83.17486338797814,7
0.2,183,95,15316,83.23913043478261,6
0.2,184,90,15406,83.27567567567567,12
0.2,185,93,15499,83.32795698924731,8
0.2,186,94,15593,83.38502673796792,7
0.2,187,91,15684,83.42553191489361,10
0.2,188,90,15774,83.46031746031746,11
0.2,189,91,15865,83.5,10
0.2,190,91,15956,83.53926701570681,10
0.2,191,94,16050,83.59375,7
0.2,192,95,16145,83.65284974093264,7
0.2,193,94,16239,83.70618556701031,7
0.2,194,89,16328,83.73333333333333,12
0.2,195,93,16421,83.78061224489795,8
0.2,196,96,16517,83.84263959390863,6
0.2,197,93,16610,83.88888888888889,8
0.2,198,94,16704,83.93969849246231,7
0.2,199,94,16798,83.99,7
0.2,200,92,16890,84.02985074626865,9
0.2,201,94,16984,84.07920792079207,7
0.2,202,21,17005,83.76847290640394,11
0.2,203,94,17099,83.81862745098039,7
0.2,204,92,17191,83.85853658536585,9
0.2,205,94,17285,83.90776699029126,7
0.2,206,92,17377,83.94685990338164,10
0.2,207,96,17473,84.0048076923077,6
0.2,208,84,17557,84.00478468899522,18
0.2,209,94,17651,84.05238095238096,7
0.2,210,92,17743,84.09004739336493,9
0.2,211,89,17832,84.11320754716981,12
0.2,212,87,17919,84.12676056338029,16
0.2,213,92,18011,84.16355140186916,9
0.2,214,94,18105,84.20930232558139,7
0.2,215,95,18200,84.25925925925925,7
0.2,216,92,18292,84.29493087557604,9
0.2,217,93,18385,84.3348623853211,8
0.2,218,92,18477,84.36986301369863,9
0.2,219,94,18571,84.41363636363636,7
0.2,220,24,18595,84.14027149321267,9
0.2,221,95,18690,84.1891891891892,6
0.2,222,96,18786,84.24215246636771,6
0.2,223,93,18879,84.28125,8
0.2,224,92,18971,84.31555555555556,9
0.2,225,93,19064,84.35398230088495,8
0.2,226,92,19156,84.38766519823788,9
0.2,227,94,19250,84.4298245614035,7
0.2,228,93,19343,84.46724890829694,8
0.2,229,15,19358,84.16521739130435,18
0.2,230,89,19447,84.18614718614718,13
0.2,231,95,19542,84.23275862068965,6
0.2,232,93,19635,84.27038626609442,8
0.2,233,94,19729,84.3119658119658,7
0.2,234,88,19817,84.32765957446809,13
0.2,235,91,19908,84.35593220338983,12
0.2,236,95,20003,84.40084388185655,6
0.2,237,92,20095,84.4327731092437,9
0.2,238,96,20191,84.48117154811716,6
0.2,239,93,20284,84.51666666666667,8
0.2,240,90,20374,84.53941908713693,11
0.2,241,94,20468,84.57851239669421,8
0.2,242,88,20556,84.5925925925926,15
0.2,243,24,20580,84.34426229508196,9
0.2,244,93,20673,84.37959183673469,8
0.2,245,95,20768,84.42276422764228,8
0.2,246,90,20858,84.44534412955466,11
0.2,247,85,20943,84.4475806451613,16
0.2,248,93,21036,84.48192771084338,8
0.2,249,89,21125,84.5,12
0.2,250,94,21219,84.5378486055777,8
0.2,251,93,21312,84.57142857142857,9
0.2,252,93,21405,84.60474308300395,8
0.2,253,27,21432,84.37795275590551,6
0.2,254,91,21523,84.40392156862745,10
0.2,255,90,21613,84.42578125,11
0.2,256,93,21706,84.4591439688716,8
0.2,257,18,21724,84.2015503875969,14
0.2,258,96,21820,84.24710424710425,6
0.2,259,94,21914,84.28461538461538,7
0.2,260,94,22008,84.32183908045977,7
0.2,261,88,22096,84.33587786259542,13
0.2,262,-53,22043,83.81368821292776,17
0.2,263,94,22137,83.85227272727273,7
0.2,264,94,22231,83.89056603773585,7
0.2,265,-47,22184,83.3984962406015,10
0.2,266,93,22277,83.43445692883896,8
0.2,267,93,22370,83.47014925373135,8
0.2,268,95,22465,83.51301115241635,6
0.2,269,90,22555,83.53703703703704,11
0.2,270,92,22647,83.56826568265683,10
0.2,271,94,22741,83.60661764705883,7
0.2,272,91,22832,83.63369963369964,10
0.2,273,88,22920,83.64963503649635,14
0.2,274,94,23014,83.68727272727273,8
0.2,275,91,23105,83.71376811594203,10
0.2,276,25,23130,83.50180505415162,8
0.2,277,94,23224,83.53956834532374,7
0.2,278,94,23318,83.57706093189964,7
0.2,279,95,23413,83.61785714285715,6
0.2,280,89,23502,83.63701067615658,12
0.2,281,96,23598,83.68085106382979,6
0.2,282,95,23693,83.72084805653711,6
0.2,283,91,23784,83.74647887323944,10
0.2,284,91,23875,83.7719298245614,11
0.2,285,94,23969,83.8076923076923,8
0.2,286,90,24059,83.82926829268293,11
0.2,287,94,24153,83.86458333333333,9
0.2,288,92,24245,83.89273356401384,9
0.2,289,91,24336,83.91724137931034,10
0.2,290,93,24429,83.94845360824742,8
0.2,291,94,24523,83.98287671232876,11
0.2,292,93,24616,84.0136518771331,8
0.2,293,94,24710,84.04761904761905,7
0.2,294,94,24804,84.0813559322034,9
0.2,295,92,24896,84.10810810810811,9
0.2,296,94,24990,84.14141414141415,7
0.2,297,95,25085,84.17785234899328,6
0.2,298,84,25169,84.17725752508362,17
0.2,299,90,25259,84.19666666666667,11
0.2,300,90,25349,84.21594684385381,12
0.2,301,94,25443,84.24834437086092,7
0.2,302,-47,25396,83.81518151815182,11
0.2,303,22,25418,83.61184210526316,12
0.2,304,95,25513,83.64918032786885,7
0.2,305,94,25607,83.68300653594771,7
0.2,306,94,25701,83.71661237785017,7
0.2,307,92,25793,83.74350649350649,10
0.2,308,93,25886,83.77346278317152,8
0.2,309,95,25981,83.80967741935484,6
0.2,310,93,26074,83.83922829581994,8
0.2,311,90,26164,83.85897435897436,11
0.2,312,94,26258,83.89137380191693,7
0.2,313,90,26348,83.91082802547771,11
0.2,314,95,26443,83.94603174603175,6
0.2,315,86,26529,83.95253164556962,16
0.2,316,94,26623,83.98422712933754,7
0.2,317,92,26715,84.00943396226415,10
0.2,318,92,26807,84.03448275862068,9
0.2,319,91,26898,84.05625,10
0.2,320,93,26991,84.08411214953271,10
0.2,321,84,27075,84.08385093167702,17
0.2,322,92,27167,84.10835913312694,10
0.2,323,96,27263,84.14506172839506,6
0.2,324,96,27359,84.18153846153847,6
0.2,325,93,27452,84.20858895705521,8
0.2,326,88,27540,84.22018348623853,13
0.2,327,93,27633,84.2469512195122,8
0.2,328,94,27727,84.27659574468085,7
0.2,329,91,27818,84.2969696969697,11
0.2,330,95,27913,84.32930513595166,7
0.2,331,94,28007,84.35843373493977,7
0.2,332,94,28101,84.38738738738739,7
0.2,333,26,28127,84.2125748502994,7
0.2,334,94,28221,84.24179104477612,8
0.2,335,94,28315,84.27083333333333,7
0.2,336,95,28410,84.3026706231454,7
0.2,337,93,28503,84.32840236686391,8
0.2,338,92,28595,84.35103244837758,9
0.2,339,95,28690,84.38235294117646,6
0.2,340,94,28784,84.41055718475073,7
0.2,341,90,28874,84.42690058479532,11
0.2,342,90,28964,84.44314868804665,11
0.2,343,94,29058,84.47093023255815,7
0.2,344,95,29153,84.50144927536232,6
0.2,345,95,29248,84.53179190751445,7
0.2,346,95,29343,84.56195965417868,6
0.2,347,88,29431,84.57183908045977,13
0.2,348,89,29520,84.58452722063038,12
0.2,349,90,29610,84.6,11
0.2,350,93,29703,84.62393162393163,8
0.2,351,95,29798,84.6534090909091,7
0.2,352,91,29889,84.671388101983,10
0.2,353,84,29973,84.66949152542372,17
0.2,354,93,30066,84.69295774647887,8
0.2,355,94,30160,84.71910112359551,7
0.2,356,90,30250,84.73389355742297,11
0.2,357,94,30344,84.75977653631286,8
0.2,358,19,30363,84.57660167130919,13
0.2,359,93,30456,84.6,8
0.2,360,95,30551,84.62880886426593,6
0.2,361,90,30641,84.64364640883979,13
0.2,362,94,30735,84.6694214876033,7
0.2,363,94,30829,84.69505494505495,7
0.2,364,93,30922,84.71780821917808,8
0.2,365,93,31015,84.74043715846994,11
0.2,366,94,31109,84.76566757493188,9
0.2,367,86,31195,84.76902173913044,15
0.2,368,91,31286,84.78590785907859,10
0.2,369,92,31378,84.80540540540541,9
0.2,370,94,31472,84.83018867924528,7
0.2,371,95,31567,84.85752688172043,6
0.2,372,92,31659,84.87667560321715,10
0.2,373,13,31672,84.68449197860963,19
0.2,374,96,31768,84.71466666666667,7
0.2,375,26,31794,84.55851063829788,7
0.2,376,96,31890,84.58885941644563,6
0.2,377,95,31985,84.61640211640211,6
0.2,378,80,32065,84.6042216358839,21
0.2,379,17,32082,84.42631578947369,17
0.2,380,89,32171,84.43832020997375,12
0.2,381,18,32189,84.26439790575917,14
0.2,382,95,32284,84.29242819843343,6
0.2,383,93,32377,84.31510416666667,8
0.2,384,95,32472,84.34285714285714,8
0.2,385,94,32566,84.3678756476684,8
0.2,386,90,32656,84.38242894056847,12
0.2,387,23,32679,84.22422680412372,10
0.2,388,93,32772,84.24678663239075,9
0.2,389,92,32864,84.26666666666667,9
0.2,390,93,32957,84.28900255754476,8
0.2,391,95,33052,84.31632653061224,6
0.2,392,88,33140,84.32569974554707,13
0.2,393,96,33236,84.35532994923858,6
0.2,394,22,33258,84.19746835443038,10
0.2,395,90,33348,84.21212121212122,13
0.2,396,92,33440,84.23173803526448,9
0.2,397,93,33533,84.2537688442211,9
0.2,398,94,33627,84.2781954887218,8
0.2,399,85,33712,84.28,16
0.2,400,87,33799,84.28678304239402,14
0.2,401,90,33889,84.30099502487562,11
0.2,402,90,33979,84.3151364764268,11
0.2,403,96,34075,84.3440594059406,6
0.2,404,93,34168,84.36543209876544,9
0.2,405,94,34262,84.38916256157636,7
0.2,406,94,34356,84.41277641277641,8
0.2,407,88,34444,84.42156862745098,13
0.2,408,91,34535,84.43765281173594,11
0.2,409,89,34624,84.44878048780488,12
0.2,410,94,34718,84.47201946472019,7
0.2,411,94,34812,84.49514563106796,7
0.2,412,94,34906,84.5181598062954,7
0.2,413,94,35000,84.54106280193237,7
0.2,414,95,35095,84.56626506024097,6
0.2,415,94,35189,84.5889423076923,7
0.2,416,95,35284,84.61390887290167,6
0.2,417,96,35380,84.64114832535886,6
0.2,418,96,35476,84.66825775656325,6
0.2,419,89,35565,84.67857142857143,12
0.2,420,93,35658,84.69833729216153,9
0.2,421,93,35751,84.71800947867298,8
0.2,422,93,35844,84.73758865248227,8
0.2,423,91,35935,84.75235849056604,10
0.2,424,92,36027,84.76941176470588,9
0.2,425,95,36122,84.79342723004694,7
0.2,426,90,36212,84.8056206088993,11
0.2,427,95,36307,84.82943925233644,6
0.2,428,94,36401,84.85081585081585,7
0.2,429,94,36495,84.87209302325581,7
0.2,430,-122,36373,84.39211136890951,17
0.2,431,92,36465,84.40972222222223,10
0.2,432,96,36561,84.4364896073903,6
0.2,433,92,36653,84.45391705069125,10
0.2,434,96,36749,84.48045977011495,6
0.2,435,96,36845,84.50688073394495,6
0.2,436,93,36938,84.52631578947368,8
0.2,437,91,37029,84.54109589041096,10
0.2,438,89,37118,84.55125284738041,13
0.2,439,91,37209,84.56590909090909,10
0.2,440,94,37303,84.58730158730158,7
0.2,441,94,37397,84.60859728506787,8
0.2,442,94,37491,84.62979683972912,8
0.2,443,93,37584,84.64864864864865,8
0.2,444,93,37677,84.66741573033708,9
0.2,445,93,37770,84.68609865470852,8
0.2,446,89,37859,84.69574944071589,12
0.2,447,90,37949,84.70758928571429,12
0.2,448,92,38041,84.7238307349666,10
0.2,449,20,38061,84.58,12
0.2,450,92,38153,84.59645232815964,9
0.2,451,90,38243,84.60840707964601,12
0.2,452,96,38339,84.63355408388522,6
0.2,453,95,38434,84.65638766519824,7
0.2,454,17,38451,84.50769230769231,15
0.2,455,85,38536,84.50877192982456,16
0.2,456,93,38629,84.527352297593,9
0.2,457,94,38723,84.54803493449782,7
0.2,458,91,38814,84.56209150326798,11
0.2,459,93,38907,84.58043478260869,8
0.2,460,93,39000,84.59869848156183,8
0.2,461,93,39093,84.61688311688312,10
0.2,462,92,39185,84.63282937365011,9
0.2,463,93,39278,84.65086206896552,9
0.2,464,96,39374,84.6752688172043,6
0.2,465,91,39465,84.68884120171674,10
0.2,466,25,39490,84.5610278372591,8
0.2,467,94,39584,84.58119658119658,7
0.2,468,93,39677,84.59914712153518,8
0.2,469,92,39769,84.61489361702128,11
0.2,470,92,39861,84.63057324840764,9
0.2,471,91,39952,84.64406779661017,10
0.2,472,86,40038,84.64693446088795,15
0.2,473,95,40133,84.66877637130801,8
0.2,474,85,40218,84.66947368421053,16
0.2,475,94,40312,84.6890756302521,8
0.2,476,95,40407,84.71069182389937,6
0.2,477,88,40495,84.71757322175732,13
0.2,478,93,40588,84.7348643006263,8
0.2,479,91,40679,84.74791666666667,10
0.2,480,90,40769,84.75883575883576,12
0.2,481,94,40863,84.77800829875518,7
0.2,482,93,40956,84.79503105590062,9
0.2,483,93,41049,84.81198347107438,8
0.2,484,96,41145,84.83505154639175,6
0.2,485,93,41238,84.85185185185185,8
0.2,486,88,41326,84.85831622176592,13
0.2,487,95,41421,84.87909836065573,6
0.2,488,92,41513,84.89366053169734,9
0.2,489,94,41607,84.91224489795918,7
0.2,490,88,41695,84.91853360488798,14
0.2,491,93,41788,84.9349593495935,10
0.2,492,91,41879,84.947261663286,10
0.2,493,92,41971,84.96153846153847,9
0.2,494,82,42053,84.95555555555555,19
0.2,495,93,42146,84.97177419354838,8
0.2,496,94,42240,84.98993963782696,7
0.2,497,92,42332,85.00401606425703,9
0.2,498,94,42426,85.02204408817636,7
0.2,499,91,42517,85.034,11
0.2,500,96,42613,85.0558882235529,6
0.2,501,95,42708,85.07569721115537,7
0.2,502,90,42798,85.0854870775348,11
0.2,503,94,42892,85.10317460317461,8
0.2,504,92,42984,85.11683168316831,9
0.2,505,90,43074,85.12648221343873,11
0.2,506,93,43167,85.14201183431953,8
0.2,507,95,43262,85.16141732283465,6
0.2,508,94,43356,85.17878192534381,8
0.2,509,94,43450,85.19607843137256,7
0.2,510,95,43545,85.21526418786692,6
0.2,511,92,43637,85.228515625,10
0.2,512,94,43731,85.24561403508773,8
0.2,513,92,43823,85.25875486381322,9
0.2,514,96,43919,85.27961165048544,6
0.2,515,92,44011,85.29263565891473,9
0.2,516,91,44102,85.3036750483559,11
0.2,517,94,44196,85.32046332046332,7
0.2,518,96,44292,85.34104046242774,6
0.2,519,27,44319,85.22884615384615,6
0.2,520,91,44410,85.23992322456814,11
0.2,521,90,44500,85.24904214559388,11
0.2,522,94,44594,85.26577437858509,9
0.2,523,89,44683,85.27290076335878,12
0.2,524,87,44770,85.27619047619048,14
0.2,525,95,44865,85.29467680608364,7
0.2,526,94,44959,85.3111954459203,7
0.2,527,94,45053,85.32765151515152,7
0.2,528,91,45144,85.33837429111531,10
0.2,529,93,45237,85.35283018867925,8
0.2,530,94,45331,85.36911487758945,7
0.2,531,94,45425,85.38533834586467,8
0.2,532,93,45518,85.39962476547842,8
0.2,533,93,45611,85.41385767790263,9
0.2,534,92,45703,85.42616822429906,9
0.2,535,93,45796,85.44029850746269,8
0.2,536,95,45891,85.45810055865921,8
0.2,537,91,45982,85.46840148698885,11
0.2,538,92,46074,85.48051948051948,9
0.2,539,93,46167,85.49444444444444,9
0.2,540,88,46255,85.49907578558225,13
0.2,541,20,46275,85.37822878228782,13
0.2,542,91,46366,85.38858195211786,10
0.2,543,86,46452,85.38970588235294,15
0.2,544,93,46545,85.40366972477064,8
0.2,545,-49,46496,85.15750915750915,13
0.2,546,92,46588,85.17001828153565,10
0.2,547,90,46678,85.17883211678833,11
0.2,548,93,46771,85.19307832422587,8
0.2,549,94,46865,85.2090909090909,9
0.2,550,94,46959,85.22504537205081,7
0.2,551,94,47053,85.2409420289855,7
0.2,552,88,47141,85.24593128390596,14
0.2,553,24,47165,85.13537906137184,8
0.2,554,91,47256,85.14594594594594,10
0.2,555,87,47343,85.14928057553956,14
0.2,556,90,47433,85.15798922800718,11
0.2,557,23,47456,85.04659498207886,10
0.2,558,94,47550,85.06261180679785,7
0.2,559,91,47641,85.07321428571429,10
0.2,560,92,47733,85.0855614973262,14
0.2,561,93,47826,85.09964412811388,9
0.2,562,94,47920,85.11545293072824,8
0.2,563,18,47938,84.99645390070921,14
0.2,564,95,48033,85.0141592920354,6
0.2,565,92,48125,85.02650176678445,9
0.2,566,93,48218,85.04056437389771,8
0.2,567,95,48313,85.0580985915493,6
0.2,568,86,48399,85.0597539543058,17
0.2,569,89,48488,85.06666666666666,12
0.2,570,94,48582,85.08231173380035,7
0.2,571,84,48666,85.08041958041959,17
0.2,572,-56,48610,84.83420593368237,19
0.2,573,94,48704,84.85017421602788,7
0.2,574,93,48797,84.86434782608696,8
0.2,575,90,48887,84.87326388888889,11
0.2,576,91,48978,84.8838821490468,10
0.2,577,87,49065,84.88754325259515,15
0.2,578,95,49160,84.90500863557858,6
0.2,579,93,49253,84.91896551724138,9
0.2,580,90,49343,84.92771084337349,11
0.2,581,96,49439,84.94673539518901,6
0.2,582,94,49533,84.9622641509434,7
0.2,583,90,49623,84.9708904109589,11
0.2,584,92,49715,84.98290598290598,9
0.2,585,92,49807,84.99488054607508,10
0.2,586,95,49902,85.01192504258944,6
0.2,587,95,49997,85.02891156462584,6
0.2,588,92,50089,85.04074702886248,9
0.2,589,94,50183,85.05593220338983,8
0.2,590,92,50275,85.06768189509306,9
0.2,591,19,50294,84.95608108108108,13
0.2,592,27,50321,84.85834738617201,6
0.2,593,94,50415,84.87373737373737,8
0.2,594,95,50510,84.89075630252101,6
0.2,595,94,50604,84.90604026845638,7
0.2,596,89,50693,84.91289782244556,13
0.2,597,93,50786,84.92642140468227,8
0.2,598,96,50882,84.9449081803005,6
0.2,599,96,50978,84.96333333333334,6
0.2,600,83,51061,84.96006655574043,18
0.2,601,95,51156,84.97674418604652,6
0.2,602,92,51248,84.98839137645108,9
0.2,603,96,51344,85.00662251655629,6
0.2,604,92,51436,85.01818181818182,9
0.2,605,91,51527,85.02805280528052,10
0.2,606,86,51613,85.02965403624383,15
0.2,607,91,51704,85.03947368421052,10
0.2,608,95,51799,85.05582922824303,6
0.2,609,93,51892,85.0688524590164,8
0.2,610,94,51986,85.0834697217676,7
0.2,611,90,52076,85.09150326797386,11
0.2,612,96,52172,85.10929853181077,6
0.2,613,91,52263,85.11889250814332,10
0.2,614,94,52357,85.13333333333334,7
0.2,615,19,52376,85.02597402597402,14
0.2,616,90,52466,85.03403565640194,11
0.2,617,91,52557,85.04368932038835,10
0.2,618,93,52650,85.05654281098546,8
0.2,619,93,52743,85.06935483870967,8
0.2,620,24,52767,84.97101449275362,8
0.2,621,88,52855,84.97588424437299,14
0.2,622,94,52949,84.99036918138042,8
0.2,623,94,53043,85.0048076923077,7
0.2,624,93,53136,85.0176,8
0.2,625,95,53231,85.03354632587859,6
0.2,626,95,53326,85.0494417862839,7
0.2,627,90,53416,85.05732484076434,11
0.2,628,95,53511,85.0731319554849,6
0.2,629,92,53603,85.08412698412698,10
0.2,630,90,53693,85.0919175911252,12
0.2,631,91,53784,85.10126582278481,10
0.2,632,96,53880,85.11848341232228,6
0.2,633,95,53975,85.13406940063092,7
0.2,634,90,54065,85.14173228346456,12
0.2,635,87,54152,85.14465408805032,14
0.2,636,96,54248,85.16169544740973,6
0.2,637,95,54343,85.17711598746081,6
0.2,638,94,54437,85.19092331768388,7
0.2,639,95,54532,85.20625,7
0.2,640,93,54625,85.21840873634946,8
0.2,641,90,54715,85.22585669781931,11
0.2,642,94,54809,85.23950233281494,7
0.2,643,93,54902,85.25155279503106,8
0.2,644,92,54994,85.26201550387597,9
0.2,645,93,55087,85.27399380804954,8
0.2,646,89,55176,85.27975270479135,12
0.2,647,83,55259,85.27623456790124,18
0.2,648,93,55352,85.28813559322033,10
0.2,649,90,55442,85.29538461538462,11
0.2,650,89,55531,85.3010752688172,12
0.2,651,88,55619,85.30521472392638,14
0.2,652,94,55713,85.31852986217459,7
0.2,653,85,55798,85.31804281345566,16
0.2,654,94,55892,85.33129770992366,7
0.2,655,92,55984,85.34146341463415,9
0.2,656,89,56073,85.34703196347031,12
0.2,657,96,56169,85.36322188449849,6
0.2,658,95,56264,85.37784522003035,6
0.2,659,93,56357,85.38939393939394,8
0.2,660,92,56449,85.39939485627836,9
0.2,661,93,56542,85.41087613293051,8
0.2,662,96,56638,85.42684766214178,6
0.2,663,-49,56589,85.22439759036145,13
0.2,664,95,56684,85.2390977443609,7
0.2,665,93,56777,85.25075075075075,9
0.2,666,-50,56727,85.04797601199401,14
0.2,667,93,56820,85.05988023952096,8
0.2,668,94,56914,85.07324364723468,7
0.2,669,88,57002,85.07761194029851,13
0.2,670,95,57097,85.09239940387481,7
0.2,671,89,57186,85.09821428571429,12
0.2,672,85,57271,85.09806835066865,16
0.2,673,94,57365,85.1112759643917,7
0.2,674,94,57459,85.12444444444445,7
0.2,675,88,57547,85.12869822485207,13
0.2,676,95,57642,85.14327917282127,7
0.2,677,94,57736,85.15634218289085,7
0.2,678,92,57828,85.16642120765832,10
0.2,679,92,57920,85.17647058823529,9
0.2,680,94,58014,85.18942731277534,7
0.2,681,94,58108,85.20234604105572,7
0.2,682,87,58195,85.20497803806735,16
0.2,683,92,58287,85.21491228070175,9
0.2,684,93,58380,85.22627737226277,10
0.2,685,92,58472,85.23615160349854,9
0.2,686,92,58564,85.24599708879185,9
0.2,687,-48,58516,85.05232558139535,11
0.2,688,-52,58464,84.85341074020319,16
0.2,689,90,58554,84.86086956521739,11
0.2,690,93,58647,84.8726483357453,8
0.2,691,93,58740,84.88439306358381,8
0.2,692,90,58830,84.89177489177489,11
0.2,693,96,58926,84.9077809798271,6
0.2,694,91,59017,84.91654676258993,11
0.2,695,92,59109,84.92672413793103,10
0.2,696,94,59203,84.93974175035868,9
0.2,697,94,59297,84.95272206303724,7
0.2,698,93,59390,84.96423462088698,9
0.2,699,86,59476,84.96571428571428,15
0.2,700,94,59570,84.97860199714694,7
0.2,701,94,59664,84.99145299145299,8
0.2,702,21,59685,84.900426742532,11
0.2,703,94,59779,84.91335227272727,7
0.2,704,95,59874,84.92765957446808,6
0.2,705,93,59967,84.93909348441926,8
0.2,706,88,60055,84.94342291371994,13
0.2,707,92,60147,84.95338983050847,9
0.2,708,23,60170,84.86600846262341,9
0.2,709,96,60266,84.88169014084507,6
0.2,710,93,60359,84.89310829817158,8
0.2,711,92,60451,84.90308988764045,9
0.2,712,23,60474,84.81626928471248,9
0.2,713,96,60570,84.83193277310924,6
0.2,714,94,60664,84.84475524475525,7
0.2,715,93,60757,84.85614525139665,8
0.2,716,90,60847,84.86331938633194,11
0.2,717,94,60941,84.87604456824512,7
0.2,718,93,61034,84.88734353268428,8
0.2,719,93,61127,84.89861111111111,8
0.2,720,19,61146,84.80721220527046,13
0.2,721,95,61241,84.8213296398892,6
0.2,722,-52,61189,84.63208852005532,15
0.2,723,87,61276,84.6353591160221,15
0.2,724,96,61372,84.65103448275862,6
0.2,725,95,61467,84.66528925619835,7
0.2,726,90,61557,84.6726272352132,11
0.2,727,95,61652,84.68681318681318,6
0.2,728,90,61742,84.69410150891632,11
0.2,729,86,61828,84.69589041095891,15
0.2,730,90,61918,84.703146374829,11
0.2,731,94,62012,84.71584699453553,7
0.2,732,88,62100,84.72032742155525,13
0.2,733,95,62195,84.73433242506812,6
0.2,734,95,62290,84.74829931972789,6
0.2,735,93,62383,84.75951086956522,9
0.2,736,92,62475,84.76933514246947,9
0.2,737,93,62568,84.78048780487805,8
0.2,738,92,62660,84.79025710419486,9
0.2,739,14,62674,84.69459459459459,18
0.2,740,91,62765,84.70310391363023,10
0.2,741,94,62859,84.71563342318059,7
0.2,742,91,62950,84.72409152086138,11
0.2,743,90,63040,84.73118279569893,11
0.2,744,95,63135,84.74496644295301,6
0.2,745,94,63229,84.75737265415549,7
0.2,746,93,63322,84.76840696117804,8
0.2,747,94,63416,84.7807486631016,7
0.2,748,94,63510,84.79305740987984,8
0.2,749,91,63601,84.80133333333333,10
0.2,750,93,63694,84.81225033288948,8
0.2,751,26,63720,84.73404255319149,7
0.2,752,95,63815,84.7476759628154,6
0.2,753,94,63909,84.75994694960212,7
0.2,754,94,64003,84.77218543046358,7
0.2,755,94,64097,84.78439153439153,7
0.2,756,94,64191,84.79656538969617,8
0.2,757,91,64282,84.8047493403694,10
0.2,758,94,64376,84.81686429512517,7
0.2,759,91,64467,84.825,10
0.2,760,95,64562,84.83837056504599,6
0.2,761,90,64652,84.84514435695539,11
0.2,762,6,64658,84.74180865006554,26
0.2,763,95,64753,84.75523560209425,6
0.2,764,94,64847,84.7673202614379,8
0.2,765,90,64937,84.77415143603133,11
0.2,766,93,65030,84.78487614080835,8
0.2,767,93,65123,84.79557291666667,9
0.2,768,93,65216,84.80624187256177,8
0.2,769,91,65307,84.81428571428572,10
0.2,770,91,65398,84.82230869001297,10
0.2,771,94,65492,84.83419689119171,7
0.2,772,93,65585,84.84476067270376,8
0.2,773,94,65679,84.85658914728683,7
0.2,774,92,65771,84.8658064516129,10
0.2,775,90,65861,84.87242268041237,11
0.2,776,93,65954,84.88288288288288,9
0.2,777,71,66025,84.8650385604113,30
0.2,778,96,66121,84.8793324775353,6
0.2,779,96,66217,84.89358974358974,6
0.2,780,-45,66172,84.72727272727273,10
0.2,781,95,66267,84.74040920716112,6
0.2,782,86,66353,84.74201787994892,15
0.2,783,95,66448,84.75510204081633,6
0.2,784,94,66542,84.76687898089172,7
0.2,785,93,66635,84.77735368956743,8
0.2,786,90,66725,84.78398983481576,11
0.2,787,89,66814,84.78934010152284,12
0.2,788,89,66903,84.79467680608364,12
0.2,789,93,66996,84.80506329113923,8
0.2,790,27,67023,84.73198482932996,6
0.2,791,93,67116,84.74242424242425,8
0.2,792,90,67206,84.74905422446406,11
0.2,793,93,67299,84.75944584382871,8
0.2,794,93,67392,84.76981132075471,8
0.2,795,93,67485,84.78015075376885,8
0.2,796,19,67504,84.69761606022584,14
0.2,797,92,67596,84.70676691729324,9
0.2,798,89,67685,84.71214017521902,12
0.2,799,90,67775,84.71875,12
0.2,800,89,67864,84.72409488139826,12
0.2,801,90,67954,84.73067331670823,11
0.2,802,90,68044,84.73723536737235,13
0.2,803,95,68139,84.75,6
0.2,804,84,68223,84.74906832298137,18
0.2,805,92,68315,84.75806451612904,10
0.2,806,95,68410,84.77075588599752,6
0.2,807,94,68504,84.78217821782178,7
0.2,808,91,68595,84.78986402966625,12
0.2,809,87,68682,84.7925925925926,14
0.2,810,92,68774,84.80147965474723,9
0.2,811,92,68866,84.8103448275862,10
0.2,812,93,68959,84.82041820418205,8
0.2,813,95,69054,84.83292383292384,6
0.2,814,90,69144,84.83926380368098,11
0.2,815,91,69235,84.8468137254902,11
0.2,816,89,69324,84.85189718482252,12
0.2,817,90,69414,84.85819070904645,11
0.2,818,94,69508,84.86935286935287,7
0.2,819,92,69600,84.8780487804878,9
0.2,820,96,69696,84.89159561510353,6
0.2,821,87,69783,84.89416058394161,14
0.2,822,94,69877,84.90522478736331,8
0.2,823,89,69966,84.91019417475728,12
0.2,824,95,70061,84.92242424242424,6
0.2,825,94,70155,84.93341404358354,7
0.2,826,92,70247,84.94195888754534,9
0.2,827,95,70342,84.95410628019323,7
0.2,828,91,70433,84.96139927623643,10
0.2,829,96,70529,84.97469879518073,6
0.2,830,89,70618,84.97954271961493,13
0.2,831,89,70707,84.984375,12
0.2,832,95,70802,84.99639855942377,8
0.2,833,94,70896,85.00719424460432,7
0.2,834,96,70992,85.02035928143712,6
0.2,835,94,71086,85.0311004784689,7
0.2,836,85,71171,85.0310633213859,16
0.2,837,92,71263,85.03937947494033,10
0.2,838,88,71351,85.04290822407629,13
0.2,839,95,71446,85.0547619047619,6
0.2,840,94,71540,85.0653983353151,8
0.2,841,86,71626,85.06650831353919,15
0.2,842,87,71713,85.06880189798339,15
0.2,843,92,71805,85.07701421800948,9
0.2,844,94,71899,85.08757396449704,8
0.2,845,94,71993,85.09810874704492,9
0.2,846,20,72013,85.02125147579693,13
0.2,847,93,72106,85.03066037735849,8
0.2,848,86,72192,85.03180212014134,15
0.2,849,91,72283,85.03882352941176,10
0.2,850,92,72375,85.0470035252644,9
0.2,851,-47,72328,84.89201877934272,10
0.2,852,95,72423,84.90386869871044,6
0.2,853,94,72517,84.91451990632318,7
0.2,854,95,72612,84.92631578947369,8
0.2,855,27,72639,84.85864485981308,6
0.2,856,92,72731,84.86697782963827,9
0.2,857,95,72826,84.87878787878788,6
0.2,858,93,72919,84.88824214202562,9
0.2,859,91,73010,84.8953488372093,10
0.2,860,20,73030,84.81997677119628,12
0.2,861,92,73122,84.82830626450117,9
0.2,862,94,73216,84.83893395133256,7
0.2,863,93,73309,84.84837962962963,8
0.2,864,94,73403,84.85895953757226,7
0.2,865,96,73499,84.87182448036951,6
0.2,866,93,73592,84.88119953863898,8
0.2,867,92,73684,84.88940092165899,9
0.2,868,92,73776,84.897583429229,9
0.2,869,96,73872,84.9103448275862,6
0.2,870,94,73966,84.92078071182549,7
0.2,871,90,74056,84.92660550458716,12
0.2,872,88,74144,84.93012600229095,13
0.2,873,90,74234,84.93592677345538,11
0.2,874,18,74252,84.85942857142857,14
0.2,875,89,74341,84.86415525114155,12
0.2,876,91,74432,84.87115165336374,10
0.2,877,92,74524,84.87927107061503,9
0.2,878,94,74618,84.8896473265074,7
0.2,879,88,74706,84.89318181818182,13
0.2,880,83,74789,84.89103291713961,19
0.2,881,25,74814,84.82312925170068,8
0.2,882,91,74905,84.83012457531144,11
0.2,883,95,75000,84.84162895927602,6
0.2,884,88,75088,84.845197740113,14
0.2,885,94,75182,84.85553047404063,7
0.2,886,93,75275,84.86471251409245,8
0.2,887,90,75365,84.87049549549549,11
0.2,888,95,75460,84.88188976377953,6
0.2,889,95,75555,84.8932584269663,7
0.2,890,95,75650,84.90460157126824,7
0.2,891,-56,75594,84.74663677130044,19
0.2,892,92,75686,84.75475923852184,9
0.2,893,23,75709,84.68568232662193,9
0.2,894,94,75803,84.69608938547486,7
0.2,895,93,75896,84.70535714285714,8
0.2,896,94,75990,84.71571906354515,7
0.2,897,92,76082,84.7238307349666,9
0.2,898,94,76176,84.73414905450501,8
0.2,899,95,76271,84.74555555555555,6
0.2,900,94,76365,84.7558268590455,7
0.2,901,88,76453,84.75942350332595,13
0.2,902,93,76546,84.76854928017718,8
0.2,903,94,76640,84.77876106194691,7
0.2,904,94,76734,84.7889502762431,7
0.2,905,86,76820,84.79028697571744,15
0.2,906,92,76912,84.79823594266814,9
0.2,907,92,77004,84.80616740088105,9
0.2,908,86,77090,84.80748074807481,15
0.2,909,90,77180,84.81318681318682,12
0.2,910,91,77271,84.81997804610319,11
0.2,911,88,77359,84.8234649122807,13
0.2,912,22,77381,84.75465498357065,10
0.2,913,92,77473,84.76258205689278,9
0.2,914,27,77500,84.69945355191257,6
0.2,915,94,77594,84.70960698689956,8
0.2,916,93,77687,84.71864776444929,8
0.2,917,92,77779,84.72657952069717,9
0.2,918,96,77875,84.73884657236127,6
0.2,919,92,77967,84.74673913043478,9
0.2,920,91,78058,84.75352877307274,10
0.2,921,90,78148,84.75921908893709,12
0.2,922,96,78244,84.77139761646804,6
0.2,923,90,78334,84.77705627705627,11
0.2,924,90,78424,84.78270270270271,11
0.2,925,93,78517,84.79157667386609,8
0.2,926,94,78611,84.8015102481122,7
0.2,927,92,78703,84.80926724137932,9
0.2,928,95,78798,84.82023681377825,7
0.2,929,91,78889,84.82688172043011,10
0.2,930,92,78981,84.83458646616542,9
0.2,931,95,79076,84.84549356223177,6
0.2,932,93,79169,84.85423365487674,9
0.2,933,94,79263,84.86402569593147,7
0.2,934,88,79351,84.86737967914439,13
0.2,935,95,79446,84.87820512820512,6
0.2,936,94,79540,84.88794023479188,7
0.2,937,89,79629,84.89232409381663,12
0.2,938,93,79722,84.90095846645367,8
0.2,939,91,79813,84.90744680851064,10
0.2,940,23,79836,84.84165781083954,10
0.2,941,93,79929,84.85031847133757,8
0.2,942,94,80023,84.86002120890774,7
0.2,943,93,80116,84.86864406779661,8
0.2,944,93,80209,84.87724867724867,8
0.2,945,23,80232,84.81183932346723,10
0.2,946,93,80325,84.82048574445618,8
0.2,947,94,80419,84.83016877637131,7
0.2,948,96,80515,84.84193888303477,6
0.2,949,93,80608,84.85052631578948,8
0.2,950,88,80696,84.85383806519454,13
0.2,951,91,80787,84.86029411764706,10
0.2,952,94,80881,84.86988457502623,7
0.2,953,95,80976,84.88050314465409,6
0.2,954,92,81068,84.88795811518325,9
0.2,955,90,81158,84.89330543933055,12
0.2,956,91,81249,84.89968652037618,11
0.2,957,95,81344,84.91022964509395,6
0.2,958,94,81438,84.91970802919708,7
0.2,959,84,81522,84.91875,17
0.2,960,91,81613,84.92507804370447,10
0.2,961,95,81708,84.93555093555094,6
0.2,962,94,81802,84.94496365524402,7
0.2,963,94,81896,84.95435684647303,7
0.2,964,17,81913,84.8839378238342,16
0.2,965,27,81940,84.824016563147,6
0.2,966,91,82031,84.83040330920372,10
0.2,967,93,82124,84.83884297520662,8
0.2,968,91,82215,84.84520123839009,11
0.2,969,27,82242,84.78556701030928,7
0.2,970,88,82330,84.78887744593203,13
0.2,971,92,82422,84.79629629629629,9
0.2,972,88,82510,84.79958890030832,13
0.2,973,93,82603,84.80800821355236,8
0.2,974,25,82628,84.74666666666667,7
0.2,975,94,82722,84.7561475409836,7
0.2,976,86,82808,84.75742067553736,16
0.2,977,96,82904,84.76891615541922,6
0.2,978,92,82996,84.77630234933606,10
0.2,979,92,83088,84.78367346938775,9
0.2,980,96,83184,84.79510703363914,6
0.2,981,92,83276,84.80244399185337,9
0.2,982,93,83369,84.81078331637843,9
0.2,983,92,83461,84.8180894308943,9
0.2,984,90,83551,84.8233502538071,11
0.2,985,90,83641,84.82860040567951,11
0.2,986,89,83730,84.83282674772036,12
0.2,987,95,83825,84.84311740890688,7
0.2,988,91,83916,84.84934277047523,10
0.2,989,94,84010,84.85858585858585,7
0.2,990,94,84104,84.8678102926337,7
0.2,991,94,84198,84.87701612903226,7
0.2,992,92,84290,84.88418932527694,9
0.2,993,94,84384,84.8933601609658,7
0.2,994,91,84475,84.89949748743719,10
0.2,995,93,84568,84.90763052208835,8
0.2,996,96,84664,84.91875626880642,6
0.2,997,95,84759,84.92885771543087,6
0.2,998,25,84784,84.86886886886887,8
0.2,999,86,84870,84.87,15
0.2,1000,92,84962,84.87712287712287,9
0.2,1001,89,85051,84.8812375249501,12
0.2,1002,93,85144,84.88933200398803,8
0.2,1003,94,85238,84.89840637450199,8
0.2,1004,94,85332,84.90746268656716,8
0.2,1005,95,85427,84.91749502982107,6
0.2,1006,89,85516,84.92154915590864,12
0.2,1007,94,85610,84.93055555555556,8
0.2,1008,82,85692,84.92765113974232,19
0.2,1009,93,85785,84.93564356435644,8
0.2,1010,92,85877,84.94263105835806,9
0.2,1011,88,85965,84.94565217391305,13
0.2,1012,94,86059,84.95459032576505,7
0.2,1013,91,86150,84.96055226824457,10
0.2,1014,94,86244,84.96945812807881,7
0.2,1015,93,86337,84.97736220472441,8
0.2,1016,18,86355,84.91150442477876,15
0.2,1017,-122,86233,84.7082514734774,18
0.2,1018,92,86325,84.71540726202159,9
0.2,1019,91,86416,84.72156862745098,11
0.2,1020,95,86511,84.73163565132224,7
0.2,1021,89,86600,84.7358121330724,12
0.2,1022,92,86692,84.74291300097752,9
0.2,1023,25,86717,84.6845703125,8
0.2,1024,93,86810,84.69268292682926,9
0.2,1025,26,86836,84.63547758284601,8
0.2,1026,92,86928,84.64264849074975,11
0.2,1027,88,87016,84.64591439688716,13
0.2,1028,93,87109,84.65403304178814,8
0.2,1029,94,87203,84.66310679611651,7
0.2,1030,92,87295,84.67022308438409,10
0.2,1031,92,87387,84.67732558139535,9
0.2,1032,92,87479,84.68441432720232,9
0.2,1033,92,87571,84.69148936170212,9
0.2,1034,20,87591,84.62898550724638,14
0.2,1035,92,87683,84.63610038610038,9
0.2,1036,93,87776,84.64416586306653,8
0.2,1037,91,87867,84.65028901734104,10
0.2,1038,94,87961,84.65928777670837,8
0.2,1039,15,87976,84.5923076923077,19
0.2,1040,92,88068,84.59942363112393,10
0.2,1041,94,88162,84.6084452975048,7
0.2,1042,92,88254,84.61553211888783,9
0.2,1043,94,88348,84.62452107279694,7
0.2,1044,-52,88296,84.49377990430622,15
0.2,1045,90,88386,84.49904397705545,11
0.2,1046,90,88476,84.50429799426934,11
0.2,1047,93,88569,84.51240458015268,10
0.2,1048,22,88591,84.45281220209723,10
0.2,1049,94,88685,84.46190476190476,7
0.2,1050,94,88779,84.4709800190295,7
0.2,1051,-190,88589,84.21007604562737,15
0.2,1052,94,88683,84.21937321937322,8
0.2,1053,92,88775,84.22675521821633,9
0.2,1054,-56,88719,84.09383886255924,19
0.2,1055,17,88736,84.03030303030303,15
0.2,1056,87,88823,84.03311258278146,14
0.2,1057,94,88917,84.04253308128544,7
0.2,1058,85,89002,84.04343720491029,16
0.2,1059,90,89092,84.04905660377358,11
0.2,1060,92,89184,84.05655042412818,9
0.2,1061,24,89208,84.0,9
0.2,1062,94,89302,84.00940733772343,8
0.2,1063,90,89392,84.01503759398496,11
0.2,1064,81,89473,84.01220657276995,20
0.2,1065,90,89563,84.01782363977486,12
0.2,1066,92,89655,84.0253045923149,9
0.2,1067,96,89751,84.03651685393258,6
0.2,1068,89,89840,84.04115996258186,12
0.2,1069,96,89936,84.05233644859813,6
0.2,1070,96,90032,84.06349206349206,6
0.2,1071,94,90126,84.07276119402985,7
0.2,1072,91,90217,84.07921714818266,11
0.2,1073,94,90311,84.08845437616387,7
0.2,1074,92,90403,84.09581395348837,10
0.2,1075,90,90493,84.10130111524164,11
0.2,1076,94,90587,84.11049210770659,8
0.2,1077,27,90614,84.05751391465677,6
0.2,1078,95,90709,84.06765523632994,6
0.2,1079,94,90803,84.07685185185186,7
0.2,1080,22,90825,84.01942645698428,12
0.2,1081,93,90918,84.02772643253235,8
0.2,1082,93,91011,84.03601108033241,8
0.2,1083,91,91102,84.04243542435424,11
0.2,1084,94,91196,84.0516129032258,7
0.2,1085,94,91290,84.06077348066299,7
0.2,1086,94,91384,84.06991720331187,8
0.2,1087,93,91477,84.078125,8
0.2,1088,20,91497,84.01928374655647,14
0.2,1089,92,91589,84.02660550458715,9
0.2,1090,94,91683,84.03574702108158,7
0.2,1091,94,91777,84.0448717948718,7
0.2,1092,94,91871,84.05397987191216,7
0.2,1093,95,91966,84.06398537477148,6
0.2,1094,96,92062,84.07488584474886,6
0.2,1095,91,92153,84.08120437956204,10
0.2,1096,91,92244,84.08751139471285,10
0.2,1097,22,92266,84.03096539162112,10
0.2,1098,94,92360,84.04003639672429,8
0.2,1099,93,92453,84.04818181818182,8
0.2,1100,95,92548,84.0581289736603,7
0.2,1101,95,92643,84.06805807622504,6
0.2,1102,93,92736,84.07615593834996,9
0.2,1103,90,92826,84.08152173913044,11
0.2,1104,92,92918,84.08868778280544,9
0.2,1105,96,93014,84.0994575045208,7
0.2,1106,94,93108,84.10840108401084,7
0.2,1107,95,93203,84.11823104693141,7
0.2,1108,95,93298,84.12804328223625,6
0.2,1109,94,93392,84.13693693693693,8
0.2,1110,96,93488,84.14761476147615,6
0.2,1111,93,93581,84.15557553956835,8
0.2,1112,94,93675,84.1644204851752,8
0.2,1113,95,93770,84.17414721723519,6
0.2,1114,93,93863,84.18206278026906,8
0.2,1115,94,93957,84.19086021505376,7
0.2,1116,96,94053,84.20143240823634,6
0.2,1117,95,94148,84.21109123434705,6
0.2,1118,89,94237,84.2153708668454,13
0.2,1119,93,94330,84.22321428571429,8
0.2,1120,91,94421,84.2292595896521,10
0.2,1121,90,94511,84.23440285204991,11
0.2,1122,90,94601,84.23953695458593,11
0.2,1123,89,94690,84.24377224199289,14
0.2,1124,82,94772,84.24177777777778,19
0.2,1125,92,94864,84.2486678507993,9
0.2,1126,94,94958,84.25732031943213,7
0.2,1127,94,95052,84.26595744680851,8
0.2,1128,90,95142,84.2710363153233,12
0.2,1129,94,95236,84.27964601769912,8
0.2,1130,91,95327,84.28558797524315,10
0.2,1131,27,95354,84.23498233215548,6
0.2,1132,90,95444,84.24007060900264,11
0.2,1133,96,95540,84.25044091710758,6
0.2,1134,94,95634,84.2590308370044,7
0.2,1135,92,95726,84.26584507042253,9
0.2,1136,89,95815,84.27000879507476,13
0.2,1137,96,95911,84.28031634446397,6
0.2,1138,24,95935,84.22739244951713,9
0.2,1139,95,96030,84.23684210526316,6
0.2,1140,94,96124,84.24539877300613,7
0.2,1141,88,96212,84.24868651488616,13
0.2,1142,94,96306,84.25721784776903,8
0.2,1143,90,96396,84.26223776223776,11
0.2,1144,90,96486,84.26724890829695,11
0.2,1145,94,96580,84.27574171029669,7
0.2,1146,89,96669,84.27986050566696,12
0.2,1147,88,96757,84.28310104529616,13
0.2,1148,93,96850,84.29068755439512,8
0.2,1149,94,96944,84.29913043478261,7
0.2,1150,95,97039,84.30842745438748,6
0.2,1151,-115,96924,84.13541666666667,10
0.2,1152,14,96938,84.0745880312229,19
0.2,1153,93,97031,84.08232235701907,8
0.2,1154,94,97125,84.0909090909091,7
0.2,1155,-48,97077,83.97664359861592,12
0.2,1156,93,97170,83.98444252376837,8
0.2,1157,94,97264,83.99309153713298,8
0.2,1158,91,97355,83.99913718723037,10
0.2,1159,92,97447,84.00603448275862,9
0.2,1160,88,97535,84.00947459086994,13
0.2,1161,19,97554,83.95352839931154,14
0.2,1162,95,97649,83.96302665520206,6
0.2,1163,95,97744,83.97250859106529,8
0.2,1164,72,97816,83.96223175965665,29
0.2,1165,27,97843,83.91337907375643,6
0.2,1166,91,97934,83.91945158526136,10
0.2,1167,96,98030,83.92979452054794,6
0.2,1168,91,98121,83.93584260051325,11
0.2,1169,91,98212,83.94188034188033,10
0.2,1170,93,98305,83.94961571306575,8
0.2,1171,89,98394,83.95392491467577,12
0.2,1172,94,98488,83.96248934356352,7
0.2,1173,87,98575,83.96507666098807,14
0.2,1174,92,98667,83.97191489361703,9
0.2,1175,91,98758,83.97789115646259,11
0.2,1176,86,98844,83.97960917587086,15
0.2,1177,94,98938,83.98811544991511,7
0.2,1178,94,99032,83.99660729431722,7
0.2,1179,85,99117,83.99745762711865,16
0.2,1180,92,99209,84.00423370025402,9
0.2,1181,96,99305,84.01438240270727,6
0.2,1182,96,99401,84.02451394759088,7
0.2,1183,90,99491,84.0295608108108,12
0.2,1184,22,99513,83.97721518987342,11
0.2,1185,95,99608,83.98650927487353,6
0.2,1186,96,99704,83.9966301600674,6
0.2,1187,94,99798,84.0050505050505,7
0.2,1188,94,99892,84.01345668629101,9
0.2,1189,90,99982,84.01848739495799,12
0.2,1190,93,100075,84.02602854743913,8
0.2,1191,89,100164,84.03020134228188,12
0.2,1192,94,100258,84.03855825649623,8
0.2,1193,94,100352,84.04690117252932,7
0.2,1194,92,100444,84.05355648535564,9
0.2,1195,96,100540,84.06354515050167,6
0.2,1196,95,100635,84.07268170426065,7
0.2,1197,24,100659,84.02253756260434,10
0.2,1198,94,100753,84.03085904920768,7
0.2,1199,94,100847,84.03916666666667,8
0.2,1200,92,100939,84.0457951706911,9
0.2,1201,93,101032,84.05324459234609,8
0.2,1202,96,101128,84.06317539484621,6
0.2,1203,94,101222,84.07142857142857,8
0.2,1204,93,101315,84.07883817427386,8
0.2,1205,93,101408,84.08623548922057,8
0.2,1206,92,101500,84.09279204639603,9
0.2,1207,93,101593,84.1001655629139,8
0.2,1208,94,101687,84.10835401157982,7
0.2,1209,91,101778,84.11404958677686,10
0.2,1210,94,101872,84.12221304706854,8
0.2,1211,91,101963,84.12788778877888,10
0.2,1212,91,102054,84.13355317394888,10
0.2,1213,92,102146,84.14003294892916,9
0.2,1214,21,102167,84.0880658436214,12
0.2,1215,91,102258,84.09375,10
0.2,1216,94,102352,84.10188989317994,8
0.2,1217,89,102441,84.10591133004927,14
0.2,1218,19,102460,84.05250205086136,13
0.2,1219,96,102556,84.0622950819672,6
0.2,1220,93,102649,84.06961506961507,8
0.2,1221,90,102739,84.07446808510639,11
0.2,1222,93,102832,84.0817661488144,8
0.2,1223,96,102928,84.09150326797386,6
0.2,1224,87,103015,84.09387755102041,15
0.2,1225,95,103110,84.10277324632953,6
0.2,1226,95,103205,84.1116544417278,7
0.2,1227,94,103299,84.11970684039088,7
0.2,1228,94,103393,84.12774613506916,8
0.2,1229,93,103486,84.1349593495935,8
0.2,1230,91,103577,84.14053614947197,10
0.2,1231,89,103666,84.14448051948052,12
0.2,1232,90,103756,84.1492295214923,11
0.2,1233,92,103848,84.15559157212317,10
0.2,1234,95,103943,84.16437246963562,8
0.2,1235,93,104036,84.1715210355987,10
0.2,1236,93,104129,84.178658043654,8
0.2,1237,95,104224,84.18739903069466,7
0.2,1238,95,104319,84.19612590799032,8
0.2,1239,27,104346,84.15,6
0.2,1240,87,104433,84.15229653505237,14
0.2,1241,88,104521,84.15539452495975,14
0.2,1242,87,104608,84.15768302493966,14
0.2,1243,93,104701,84.16479099678456,8
0.2,1244,94,104795,84.1726907630522,8
0.2,1245,95,104890,84.18138041733548,6
0.2,1246,94,104984,84.18925421010425,7
0.2,1247,93,105077,84.1963141025641,8
0.2,1248,91,105168,84.2017614091273,10
0.2,1249,91,105259,84.2072,10
0.2,1250,91,105350,84.21262989608313,10
0.2,1251,93,105443,84.21964856230032,8
0.2,1252,94,105537,84.22745411013567,7
0.2,1253,90,105627,84.23205741626795,11
0.2,1254,17,105644,84.17848605577689,15
0.2,1255,91,105735,84.18391719745223,10
0.2,1256,92,105827,84.1901352426412,9
0.2,1257,84,105911,84.1899841017488,17
0.2,1258,89,106000,84.19380460683082,13
0.2,1259,94,106094,84.2015873015873,7
0.2,1260,86,106180,84.203013481364,15
0.2,1261,27,106207,84.15768621236133,6
0.2,1262,94,106301,84.1654790182106,7
0.2,1263,87,106388,84.16772151898734,14
0.2,1264,90,106478,84.17233201581028,11
0.2,1265,25,106503,84.12559241706161,7
0.2,1266,92,106595,84.13180741910024,9
0.2,1267,92,106687,84.13801261829653,9
0.2,1268,89,106776,84.1418439716312,12
0.2,1269,93,106869,84.1488188976378,9
0.2,1270,95,106964,84.1573564122738,7
0.2,1271,95,107059,84.16588050314465,6
0.2,1272,92,107151,84.172034564022,9
0.2,1273,16,107167,84.11852433281005,17
0.2,1274,93,107260,84.12549019607843,8
0.2,1275,90,107350,84.13009404388714,11
0.2,1276,94,107444,84.13782302270947,8
0.2,1277,93,107537,84.14475743348983,8
0.2,1278,92,107629,84.15089913995308,10
0.2,1279,87,107716,84.153125,14
0.2,1280,94,107810,84.1608118657299,7
0.2,1281,93,107903,84.16770670826833,8
0.2,1282,96,107999,84.17692907248636,6
0.2,1283,93,108092,84.18380062305296,8
0.2,1284,93,108185,84.19066147859922,8
0.2,1285,92,108277,84.19673405909798,10
0.2,1286,90,108367,84.2012432012432,11
0.2,1287,94,108461,84.20885093167702,7
0.2,1288,94,108555,84.21644685802949,7
0.2,1289,95,108650,84.2248062015504,6
0.2,1290,93,108743,84.23160340821069,8
0.2,1291,94,108837,84.23916408668731,7
0.2,1292,95,108932,84.24748646558392,6
0.2,1293,96,109028,84.25656877897991,6
0.2,1294,92,109120,84.26254826254826,9
0.2,1295,94,109214,84.27006172839506,7
0.2,1296,93,109307,84.27679259830377,8
0.2,1297,92,109399,84.28274268104776,9
0.2,1298,94,109493,84.29022324865281,7
0.2,1299,92,109585,84.29615384615384,9
0.2,1300,95,109680,84.304381245196,8
0.2,1301,90,109770,84.30875576036867,11
0.2,1302,92,109862,84.31465848042978,9
0.2,1303,94,109956,84.32208588957056,7
0.2,1304,95,110051,84.33026819923371,6
0.2,1305,94,110145,84.33767228177642,9
0.2,1306,94,110239,84.34506503443,8
0.2,1307,93,110332,84.35168195718654,8
0.2,1308,96,110428,84.36058059587471,6
0.2,1309,91,110519,84.36564885496183,10
0.2,1310,19,110538,84.3157894736842,13
0.2,1311,23,110561,84.26905487804878,9
0.2,1312,94,110655,84.27646610814928,7
0.2,1313,26,110681,84.23211567732116,7
0.2,1314,96,110777,84.24106463878327,6
0.2,1315,91,110868,84.24620060790274,10
0.2,1316,93,110961,84.25284738041002,9
0.2,1317,94,111055,84.26024279210925,8
0.2,1318,93,111148,84.26686884003033,9
0.2,1319,17,111165,84.2159090909091,15
0.2,1320,88,111253,84.21877365632096,13
0.2,1321,92,111345,84.22465960665659,9
0.2,1322,95,111440,84.23280423280423,6
0.2,1323,-44,111396,84.13595166163142,8
0.2,1324,95,111491,84.14415094339623,7
0.2,1325,84,111575,84.14404223227753,17
0.2,1326,94,111669,84.15146948003014,8
0.2,1327,86,111755,84.15286144578313,15
0.2,1328,94,111849,84.16027088036117,8
0.2,1329,96,111945,84.16917293233082,6
0.2,1330,90,112035,84.17355371900827,11
0.2,1331,95,112130,84.18168168168168,7
0.2,1332,94,112224,84.18904726181546,7
0.2,1333,90,112314,84.19340329835083,11
0.2,1334,93,112407,84.2,8
0.2,1335,91,112498,84.20508982035928,11
0.2,1336,92,112590,84.21091997008227,9
0.2,1337,93,112683,84.21748878923766,8
0.2,1338,92,112775,84.22330097087378,9
0.2,1339,93,112868,84.22985074626865,8
0.2,1340,95,112963,84.23788217747949,6
0.2,1341,94,113057,84.2451564828614,7
0.2,1342,95,113152,84.25316455696202,7
0.2,1343,92,113244,84.25892857142857,9
0.2,1344,26,113270,84.21561338289963,7
0.2,1345,94,113364,84.22288261515602,8
0.2,1346,90,113454,84.2271714922049,11
0.2,1347,92,113546,84.23293768545994,9
0.2,1348,90,113636,84.23721275018532,11
0.2,1349,91,113727,84.24222222222222,12
0.2,1350,94,113821,84.24944485566247,7
0.2,1351,93,113914,84.25591715976331,8
0.2,1352,94,114008,84.26311899482631,7
0.2,1353,94,114102,84.27031019202363,7
0.2,1354,88,114190,84.2730627306273,13
0.2,1355,95,114285,84.28097345132744,6
0.2,1356,93,114378,84.28739867354459,8
0.2,1357,87,114465,84.28939617083947,14
0.2,1358,91,114556,84.2943340691685,10
0.2,1359,90,114646,84.2985294117647,11
0.2,1360,96,114742,84.30712711241733,6
0.2,1361,92,114834,84.31277533039648,9
0.2,1362,95,114929,84.32061628760088,7
0.2,1363,92,115021,84.32624633431085,10
0.2,1364,23,115044,84.28131868131868,9
0.2,1365,91,115135,84.28623718887262,11
0.2,1366,15,115150,84.23555230431602,17
0.2,1367,95,115245,84.24342105263158,8
0.2,1368,95,115340,84.25127830533236,6
0.2,1369,94,115434,84.25839416058395,7
0.2,1370,88,115522,84.26112326768782,13
0.2,1371,88,115610,84.26384839650146,14
0.2,1372,87,115697,84.26584122359796,14
0.2,1373,91,115788,84.2707423580786,10
0.2,1374,90,115878,84.27490909090909,12
0.2,1375,90,115968,84.27906976744185,11
0.2,1376,94,116062,84.28612926652143,10
0.2,1377,94,116156,84.29317851959361,8
0.2,1378,91,116247,84.29804205946338,10
0.2,1379,95,116342,84.30579710144927,6
0.2,1380,96,116438,84.31426502534396,6
0.2,1381,92,116530,84.31982633863966,9
0.2,1382,94,116624,84.32682574114244,8
0.2,1383,93,116717,84.33309248554913,9
0.2,1384,96,116813,84.34151624548737,6
0.2,1385,93,116906,84.34776334776335,8
0.2,1386,94,117000,84.35472242249459,7
0.2,1387,92,117092,84.36023054755043,9
0.2,1388,92,117184,84.36573074154067,10
0.2,1389,89,117273,84.36906474820144,14
0.2,1390,95,117368,84.37670740474479,8
0.2,1391,95,117463,84.38433908045977,7
0.2,1392,93,117556,84.39052404881551,8
0.2,1393,92,117648,84.39598278335724,9
0.2,1394,91,117739,84.40071684587814,12
0.2,1395,95,117834,84.40830945558739,6
0.2,1396,96,117930,84.41660701503221,6
0.2,1397,96,118026,84.42489270386267,6
0.2,1398,96,118122,84.43316654753396,6
0.2,1399,20,118142,84.38714285714286,12
0.2,1400,94,118236,84.39400428265525,7
0.2,1401,94,118330,84.40085592011413,7
0.2,1402,94,118424,84.40769779044903,8
0.2,1403,94,118518,84.41452991452991,7
0.2,1404,93,118611,84.42064056939502,8
0.2,1405,89,118700,84.42389758179232,12
0.2,1406,88,118788,84.42643923240938,13
0.2,1407,82,118870,84.4247159090909,19
0.2,1408,96,118966,84.43293115684882,6
0.2,1409,91,119057,84.43758865248228,12
0.2,1410,86,119143,84.43869596031183,15
0.2,1411,88,119231,84.44121813031161,13
0.2,1412,95,119326,84.44869072894551,6
0.2,1413,-44,119282,84.35785007072135,8
0.2,1414,88,119370,84.36042402826855,13
0.2,1415,93,119463,84.36652542372882,8
0.2,1416,89,119552,84.36979534227241,12
0.2,1417,94,119646,84.37658674188998,8
0.2,1418,87,119733,84.3784355179704,14
0.2,1419,93,119826,84.38450704225352,8
0.2,1420,91,119917,84.38916256157636,10
0.2,1421,94,120011,84.39592123769339,7
0.2,1422,24,120035,84.353478566409,9
0.2,1423,89,120124,84.3567415730337,12
0.2,1424,92,120216,84.3621052631579,9
0.2,1425,86,120302,84.36325385694249,15
0.2,1426,94,120396,84.37000700770848,7
0.2,1427,94,120490,84.37675070028011,8
0.2,1428,94,120584,84.38348495451365,7
0.2,1429,93,120677,84.38951048951049,8
0.2,1430,95,120772,84.39692522711391,7
0.2,1431,95,120867,84.40432960893855,6
0.2,1432,94,120961,84.41102581995813,7
0.2,1433,91,121052,84.41562064156206,10
0.2,1434,95,121147,84.42299651567944,6
0.2,1435,94,121241,84.42966573816156,7
0.2,1436,95,121336,84.43702157272095,7
0.2,1437,90,121426,84.44089012517385,11
0.2,1438,91,121517,84.44544822793607,10
0.2,1439,92,121609,84.45069444444445,9
0.2,1440,90,121699,84.45454545454545,11
0.2,1441,91,121790,84.45908460471567,10
0.2,1442,95,121885,84.46638946638947,6
0.2,1443,96,121981,84.47437673130194,6
0.2,1444,92,122073,84.47958477508651,9
0.2,1445,89,122162,84.48271092669432,12
0.2,1446,93,122255,84.48859709744299,8
0.2,1447,89,122344,84.49171270718232,13
0.2,1448,93,122437,84.4975845410628,8
0.2,1449,91,122528,84.50206896551724,10
0.2,1450,96,122624,84.50999310820124,6
0.2,1451,92,122716,84.51515151515152,9
0.2,1452,93,122809,84.5209910529938,8
0.2,1453,92,122901,84.52613480055021,10
0.2,1454,95,122996,84.53333333333333,6
0.2,1455,92,123088,84.53846153846153,9
0.2,1456,89,123177,84.54152367879203,12
0.2,1457,94,123271,84.5480109739369,8
0.2,1458,93,123364,84.55380397532556,9
0.2,1459,92,123456,84.55890410958904,9
0.2,1460,96,123552,84.56673511293634,6
0.2,1461,96,123648,84.57455540355677,6
0.2,1462,96,123744,84.58236500341764,7
0.2,1463,94,123838,84.58879781420765,7
0.2,1464,94,123932,84.59522184300342,7
0.2,1465,89,124021,84.59822646657571,12
0.2,1466,95,124116,84.60531697341513,6
0.2,1467,25,124141,84.56471389645776,8
0.2,1468,94,124235,84.571136827774,7
0.2,1469,96,124331,84.57891156462586,6
0.2,1470,95,124426,84.58599592114209,6
0.2,1471,25,124451,84.54551630434783,8
0.2,1472,96,124547,84.55329260013578,6
0.2,1473,94,124641,84.55970149253731,7
0.2,1474,94,124735,84.56610169491526,7
0.2,1475,91,124826,84.57046070460704,11
0.2,1476,89,124915,84.57345971563981,12
0.2,1477,92,125007,84.57848443843031,9
0.2,1478,86,125093,84.57944557133199,15
0.2,1479,94,125187,84.58581081081081,7
0.2,1480,94,125281,84.5921674544227,7
0.2,1481,88,125369,84.5944669365722,14
0.2,1482,96,125465,84.60215778826702,6
0.2,1483,27,125492,84.5633423180593,6
0.2,1484,89,125581,84.56632996632996,13
0.2,1485,90,125671,84.5699865410498,11
0.2,1486,91,125762,84.57431069266981,10
0.2,1487,92,125854,84.57930107526882,9
0.2,1488,91,125945,84.58361316319677,10
0.2,1489,90,126035,84.58724832214764,11
0.2,1490,89,126124,84.59020791415158,16
0.2,1491,89,126213,84.593163538874,12
0.2,1492,92,126305,84.59812458137978,10
0.2,1493,95,126400,84.60508701472557,7
0.2,1494,94,126494,84.6113712374582,7
0.2,1495,92,126586,84.6163101604278,9
0.2,1496,94,126680,84.62257849031396,8
0.2,1497,93,126773,84.62817089452604,9
0.2,1498,96,126869,84.63575717144764,6
0.2,1499,95,126964,84.64266666666667,6
0.2,1500,94,127058,84.64890073284477,7
0.2,1501,88,127146,84.65113182423435,13
0.2,1502,90,127236,84.65469061876247,11
0.2,1503,25,127261,84.61502659574468,8
0.2,1504,92,127353,84.61993355481728,9
0.2,1505,96,127449,84.62749003984064,6
0.2,1506,92,127541,84.63238221632382,9
0.2,1507,95,127636,84.63925729442971,6
0.2,1508,95,127731,84.64612326043738,6
0.2,1509,-56,127675,84.55298013245033,19
0.2,1510,93,127768,84.55857048312376,8
0.2,1511,96,127864,84.56613756613757,6
0.2,1512,96,127960,84.57369464639788,6
0.2,1513,96,128056,84.58124174372523,6
0.2,1514,27,128083,84.54323432343234,6
0.2,1515,94,128177,84.5494722955145,7
0.2,1516,94,128271,84.55570204350693,8
0.2,1517,94,128365,84.56192358366272,7
0.2,1518,26,128391,84.52337063857802,6
0.2,1519,93,128484,84.52894736842106,8
0.2,1520,92,128576,84.53385930309007,9
0.2,1521,93,128669,84.53942181340342,8
0.2,1522,-49,128620,84.45173998686802,12
0.2,1523,96,128716,84.45931758530183,6
0.2,1524,88,128804,84.4616393442623,13
0.2,1525,95,128899,84.46854521625164,6
0.2,1526,96,128995,84.47609692206942,6
0.2,1527,27,129022,84.43848167539267,6
0.2,1528,-44,128978,84.35448005232178,8
0.2,1529,94,129072,84.36078431372549,8
0.2,1530,92,129164,84.365774003919,9
0.2,1531,95,129259,84.37271540469973,6
0.2,1532,94,129353,84.37899543378995,7
0.2,1533,96,129449,84.38657105606258,6
0.2,1534,94,129543,84.3928338762215,8
0.2,1535,93,129636,84.3984375,8
0.2,1536,93,129729,84.40403383214053,8
0.2,1537,86,129815,84.40507152145643,15
0.2,1538,94,129909,84.41130604288499,7
0.2,1539,94,130003,84.41753246753247,7
0.2,1540,93,130096,84.42310188189488,8
0.2,1541,91,130187,84.42736705577173,11
0.2,1542,94,130281,84.43357096565133,7
0.2,1543,92,130373,84.43847150259067,9
0.2,1544,84,130457,84.43818770226537,17
0.2,1545,94,130551,84.44437257438551,7
0.2,1546,26,130577,84.4065934065934,7
0.2,1547,91,130668,84.4108527131783,10
0.2,1548,87,130755,84.4125242091672,15
0.2,1549,89,130844,84.41548387096775,12
0.2,1550,93,130937,84.42101869761444,8
0.2,1551,22,130959,84.38079896907216,12
0.2,1552,92,131051,84.38570508692852,9
0.2,1553,17,131068,84.34234234234235,15
0.2,1554,84,131152,84.34212218649517,17
0.2,1555,91,131243,84.34640102827764,10
0.2,1556,92,131335,84.35131663455363,9
0.2,1557,95,131430,84.3581514762516,6
0.2,1558,91,131521,84.36241180243746,10
0.2,1559,27,131548,84.32564102564102,7
0.2,1560,89,131637,84.32863549007047,12
0.2,1561,91,131728,84.33290653008963,10
0.2,1562,88,131816,84.33525271912988,13
0.2,1563,91,131907,84.33951406649616,10
0.2,1564,94,132001,84.34568690095847,7
0.2,1565,96,132097,84.35312899106003,6
0.2,1566,96,132193,84.36056158264199,6
0.2,1567,95,132288,84.36734693877551,9
0.2,1568,92,132380,84.37221159974506,9
0.2,1569,90,132470,84.37579617834395,11
0.2,1570,92,132562,84.38064926798218,9
0.2,1571,87,132649,84.3823155216285,15
0.2,1572,89,132738,84.38525111252385,12
0.2,1573,95,132833,84.39199491740787,7
0.2,1574,94,132927,84.39809523809524,7
0.2,1575,94,133021,84.40418781725889,8
0.2,1576,90,133111,84.40773620798986,11
0.2,1577,91,133202,84.41191381495564,10
0.2,1578,94,133296,84.4179860671311,7
0.2,1579,95,133391,84.4246835443038,6
0.2,1580,92,133483,84.42947501581277,9
0.2,1581,21,133504,84.38938053097345,11
0.2,1582,94,133598,84.39545167403664,7
0.2,1583,86,133684,84.39646464646465,15
0.2,1584,95,133779,84.40315457413249,7
0.2,1585,-50,133729,84.31841109709963,14
0.2,1586,92,133821,84.32325141776937,9
0.2,1587,93,133914,84.32871536523929,8
0.2,1588,96,134010,84.33606041535558,6
0.2,1589,96,134106,84.3433962264151,6
0.2,1590,93,134199,84.34883720930233,8
0.2,1591,21,134220,84.30904522613065,12
0.2,1592,93,134313,84.31450094161958,8
0.2,1593,87,134400,84.31618569636136,16
0.2,1594,86,134486,84.31724137931035,15
0.2,1595,96,134582,84.32456140350877,6
0.2,1596,93,134675,84.32999373825923,8
0.2,1597,91,134766,84.33416770963704,10
0.2,1598,15,134781,84.29080675422139,17
0.2,1599,92,134873,84.295625,9
0.2,1600,96,134969,84.30293566520925,6
0.2,1601,93,135062,84.3083645443196,8
0.2,1602,94,135156,84.31441048034935,7
0.2,1603,93,135249,84.31982543640898,8
0.2,1604,17,135266,84.27788161993769,15
0.2,1605,93,135359,84.28331257783313,8
0.2,1606,93,135452,84.28873677660236,8
0.2,1607,94,135546,84.29477611940298,8
0.2,1608,95,135641,84.30142945929148,6
0.2,1609,91,135732,84.3055900621118,10
0.2,1610,89,135821,84.30850403476101,12
0.2,1611,95,135916,84.3151364764268,6
0.2,1612,94,136010,84.32114073155611,7
0.2,1613,95,136105,84.32775712515489,7
0.2,1614,93,136198,84.33312693498452,8
0.2,1615,92,136290,84.3378712871287,9
0.2,1616,95,136385,84.34446505875077,6
0.2,1617,94,136479,84.3504326328801,7
0.2,1618,93,136572,84.35577516985794,8
0.2,1619,95,136667,84.36234567901235,6
0.2,1620,92,136759,84.3670573719926,9
0.2,1621,23,136782,84.3292231812577,10
0.2,1622,95,136877,84.33579790511399,6
0.2,1623,96,136973,84.3429802955665,6
0.2,1624,92,137065,84.34769230769231,9
0.2,1625,93,137158,84.3530135301353,8
0.2,1626,94,137252,84.35894283958206,8
0.2,1627,92,137344,84.36363636363636,9
0.2,1628,95,137439,84.37016574585635,6
0.2,1629,91,137530,84.37423312883436,10
0.2,1630,92,137622,84.37890864500307,9
0.2,1631,92,137714,84.38357843137256,9
0.2,1632,82,137796,84.38211879975505,19
0.2,1633,94,137890,84.38800489596083,7
0.2,1634,26,137916,84.35229357798165,7
0.2,1635,88,138004,84.35452322738386,13
0.2,1636,95,138099,84.36102626756261,7
0.2,1637,95,138194,84.36752136752136,6
0.2,1638,90,138284,84.37095790115924,11
0.2,1639,96,138380,84.3780487804878,6
0.2,1640,95,138475,84.38452163315051,6
0.2,1641,19,138494,84.34470158343484,13
0.2,1642,94,138588,84.35057821059038,7
0.2,1643,92,138680,84.35523114355232,9
0.2,1644,95,138775,84.36170212765957,6
0.2,1645,90,138865,84.36512758201701,11
0.2,1646,95,138960,84.37158469945355,8
0.2,1647,94,139054,84.37742718446601,7
0.2,1648,93,139147,84.3826561552456,8
0.2,1649,92,139239,84.38727272727273,9
0.2,1650,96,139335,84.39430648092065,6
0.2,1651,21,139356,84.35593220338983,11
0.2,1652,82,139438,84.35450695704779,20
0.2,1653,92,139530,84.35912938331317,9
0.2,1654,94,139624,84.36495468277946,8
0.2,1655,92,139716,84.3695652173913,10
0.2,1656,90,139806,84.3729631864816,11
0.2,1657,95,139901,84.37937273823884,6
0.2,1658,19,139920,84.33996383363473,13
0.2,1659,94,140014,84.34578313253012,8
0.2,1660,94,140108,84.3515954244431,7
0.2,1661,89,140197,84.35439229843561,12
0.2,1662,88,140285,84.35658448586891,13
0.2,1663,90,140375,84.35997596153847,11
0.2,1664,95,140470,84.36636636636636,6
0.2,1665,92,140562,84.37094837935174,9
0.2,1666,93,140655,84.37612477504499,8
0.2,1667,95,140750,84.38249400479616,6
0.2,1668,89,140839,84.38526063511084,13
0.2,1669,93,140932,84.39041916167665,8
0.2,1670,90,141022,84.393776181927,13
0.2,1671,91,141113,84.39772727272727,10
0.2,1672,84,141197,84.39748953974896,18
0.2,1673,96,141293,84.40442054958184,6
0.2,1674,86,141379,84.40537313432836,15
0.2,1675,20,141399,84.36694510739856,12
0.2,1676,93,141492,84.37209302325581,8
0.2,1677,96,141588,84.37902264600716,6
0.2,1678,25,141613,84.34365693865396,8
0.2,1679,94,141707,84.34940476190476,7
0.2,1680,94,141801,84.35514574657941,8
0.2,1681,91,141892,84.359096313912,11
0.2,1682,93,141985,84.36423054070113,8
0.2,1683,96,142081,84.37114014251782,6
0.2,1684,-45,142036,84.29436201780416,8
0.2,1685,89,142125,84.29715302491103,12
0.2,1686,93,142218,84.30231179608774,8
0.2,1687,22,142240,84.26540284360189,10
0.2,1688,94,142334,84.27116637063351,8
0.2,1689,27,142361,84.23727810650888,6
0.2,1690,87,142448,84.23891188645771,14
0.2,1691,92,142540,84.24349881796691,10
0.2,1692,94,142634,84.24926166568223,8
0.2,1693,91,142725,84.25324675324676,10
0.2,1694,90,142815,84.2566371681416,11
0.2,1695,88,142903,84.25884433962264,13
0.2,1696,91,142994,84.26281673541544,10
0.2,1697,94,143088,84.26855123674912,8
0.2,1698,92,143180,84.2731018246027,10
0.2,1699,92,143272,84.27764705882353,11
0.2,1700,94,143366,84.28336272780717,7
0.2,1701,95,143461,84.28965922444183,7
0.2,1702,23,143484,84.253669994128,9
0.2,1703,94,143578,84.2593896713615,7
0.2,1704,92,143670,84.26392961876833,9
0.2,1705,92,143762,84.26846424384526,9
0.2,1706,-47,143715,84.19156414762742,10
0.2,1707,94,143809,84.19730679156909,8
0.2,1708,91,143900,84.20128730251609,10
0.2,1709,90,143990,84.2046783625731,11
0.2,1710,92,144082,84.20923436586791,9
0.2,1711,91,144173,84.21320093457943,10
0.2,1712,94,144267,84.21891418563924,9
0.2,1713,93,144360,84.22403733955659,8
0.2,1714,94,144454,84.22973760932945,8
0.2,1715,92,144546,84.23426573426573,9
0.2,1716,89,144635,84.23704135119394,14
0.2,1717,93,144728,84.24214202561117,8
0.2,1718,90,144818,84.24549156486329,11
0.2,1719,93,144911,84.25058139534883,8
0.2,1720,21,144932,84.21382916908775,12
0.2,1721,90,145022,84.21718931475029,11
0.2,1722,90,145112,84.22054556006965,11
0.2,1723,86,145198,84.2215777262181,15
0.2,1724,88,145286,84.22376811594202,13
0.2,1725,90,145376,84.2271147161066,11
0.2,1726,92,145468,84.23161551823972,9
0.2,1727,96,145564,84.23842592592592,6
0.2,1728,93,145657,84.2434933487565,8
0.2,1729,95,145752,84.24971098265895,7
0.2,1730,92,145844,84.25418833044483,11
0.2,1731,91,145935,84.2580831408776,10
0.2,1732,95,146030,84.26428159261397,6
0.2,1733,94,146124,84.26989619377163,8
0.2,1734,89,146213,84.27262247838617,12
0.2,1735,94,146307,84.27822580645162,8
0.2,1736,94,146401,84.28382268278641,7
0.2,1737,93,146494,84.28883774453395,8
0.2,1738,95,146589,84.29499712478436,7
0.2,1739,94,146683,84.30057471264368,7
0.2,1740,94,146777,84.30614589316485,7
0.2,1741,92,146869,84.3105625717566,9
0.2,1742,22,146891,84.27481353987378,10
0.2,1743,95,146986,84.2809633027523,6
0.2,1744,15,147001,84.24126074498567,17
0.2,1745,85,147086,84.24169530355097,16
0.2,1746,90,147176,84.24499141385232,12
0.2,1747,25,147201,84.21109839816934,9
0.2,1748,90,147291,84.21440823327616,11
0.2,1749,93,147384,84.21942857142857,8
0.2,1750,94,147478,84.22501427755569,8
0.2,1751,95,147573,84.23116438356165,6
0.2,1752,90,147663,84.2344552196235,11
0.2,1753,23,147686,84.19954389965793,10
0.2,1754,96,147782,84.2062678062678,6
0.2,1755,92,147874,84.21070615034168,9
0.2,1756,92,147966,84.21513944223108,10
0.2,1757,96,148062,84.22184300341297,6
0.2,1758,95,148157,84.22797043774872,7
0.2,1759,92,148249,84.23238636363637,9
0.2,1760,92,148341,84.23679727427599,9
0.2,1761,93,148434,84.24177071509648,8
0.2,1762,86,148520,84.24276800907543,15
0.2,1763,91,148611,84.24659863945578,10
0.2,1764,93,148704,84.2515580736544,8
0.2,1765,94,148798,84.25707814269536,8
0.2,1766,89,148887,84.2597623089983,12
0.2,1767,95,148982,84.2658371040724,6
0.2,1768,92,149074,84.27020915771622,10
0.2,1769,95,149169,84.27627118644068,6
0.2,1770,91,149260,84.28006775832863,11
0.2,1771,27,149287,84.24774266365688,6
0.2,1772,96,149383,84.25437112239143,6
0.2,1773,94,149477,84.25986471251409,8
0.2,1774,95,149572,84.26591549295775,6
0.2,1775,95,149667,84.27195945945945,7
0.2,1776,95,149762,84.2779966235228,6
0.2,1777,93,149855,84.28290213723285,8
0.2,1778,94,149949,84.28836424957842,7
0.2,1779,91,150040,84.29213483146067,10
0.2,1780,95,150135,84.29814710836608,6
0.2,1781,91,150226,84.30190796857464,10
0.2,1782,95,150321,84.3079080201907,6
0.2,1783,91,150412,84.31165919282512,10
0.2,1784,91,150503,84.31540616246498,10
0.2,1785,95,150598,84.32138857782755,6
0.2,1786,95,150693,84.32736429770566,6
0.2,1787,91,150784,84.331096196868,10
0.2,1788,94,150878,84.33650083845724,7
0.2,1789,94,150972,84.34189944134079,7
0.2,1790,94,151066,84.34729201563373,7
0.2,1791,20,151086,84.31138392857143,12
0.2,1792,92,151178,84.31567205800334,9
0.2,1793,96,151274,84.3221850613155,6
0.2,1794,95,151369,84.32813370473538,6
0.2,1795,91,151460,84.33184855233853,10
0.2,1796,93,151553,84.33667223149693,8
0.2,1797,93,151646,84.34149054505005,8
0.2,1798,95,151741,84.34741523068371,6
0.2,1799,95,151836,84.35333333333334,8
0.2,1800,24,151860,84.31982232093281,9
0.2,1801,92,151952,84.32408435072142,9
0.2,1802,95,152047,84.3300055463117,7
0.2,1803,92,152139,84.33425720620842,9
0.2,1804,16,152155,84.29639889196676,16
0.2,1805,90,152245,84.29955703211517,12
0.2,1806,89,152334,84.3021582733813,12
0.2,1807,94,152428,84.3075221238938,8
0.2,1808,94,152522,84.31288004422333,7
0.2,1809,26,152548,84.28066298342542,6
0.2,1810,-56,152492,84.20320265046935,20
0.2,1811,92,152584,84.2075055187638,9
0.2,1812,94,152678,84.21290678433536,7
0.2,1813,96,152774,84.2194046306505,6
0.2,1814,15,152789,84.18126721763086,19
0.2,1815,91,152880,84.18502202643172,10
0.2,1816,88,152968,84.1871216290589,13
0.2,1817,92,153060,84.1914191419142,9
0.2,1818,90,153150,84.19461242440902,11
0.2,1819,95,153245,84.20054945054945,6
0.2,1820,91,153336,84.20428336079077,11
0.2,1821,91,153427,84.20801317233808,10
0.2,1822,96,153523,84.2144816236972,6
0.2,1823,95,153618,84.22039473684211,7
0.2,1824,91,153709,84.22410958904109,10
0.2,1825,88,153797,84.22617743702081,13
0.2,1826,95,153892,84.232074438971,6
0.2,1827,89,153981,84.23468271334792,12
0.2,1828,89,154070,84.23728813559322,12
0.2,1829,94,154164,84.24262295081967,7
0.2,1830,95,154259,84.24849808847624,6
0.2,1831,94,154353,84.25382096069869,7
0.2,1832,93,154446,84.25859247135843,9
0.2,1833,92,154538,84.2628135223555,9
0.2,1834,93,154631,84.2675749318801,8
0.2,1835,93,154724,84.2723311546841,8
0.2,1836,94,154818,84.27762656505172,7
0.2,1837,89,154907,84.28019586507072,12
0.2,1838,93,155000,84.28493746601414,8
0.2,1839,96,155096,84.29130434782608,6
0.2,1840,90,155186,84.2944052145573,11
0.2,1841,88,155274,84.29641693811075,13
0.2,1842,96,155370,84.30276722734672,6
0.2,1843,91,155461,84.30639913232105,10
0.2,1844,92,155553,84.31056910569106,9
0.2,1845,92,155645,84.31473456121343,9
0.2,1846,95,155740,84.32051976177586,6
0.2,1847,93,155833,84.32521645021644,8
0.2,1848,96,155929,84.33153055705787,6
0.2,1849,93,156022,84.33621621621622,8
0.2,1850,95,156117,84.3419773095624,7
0.2,1851,96,156213,84.34827213822894,6
0.2,1852,87,156300,84.3497031840259,14
0.2,1853,89,156389,84.35221143473571,12
0.2,1854,94,156483,84.35741239892184,8
0.2,1855,21,156504,84.32327586206897,12
0.2,1856,90,156594,84.32633279483038,11
0.2,1857,91,156685,84.32992465016146,11
0.2,1858,96,156781,84.33620225927918,6
0.2,1859,87,156868,84.33763440860216,14
0.2,1860,94,156962,84.34282643739925,7
0.2,1861,26,156988,84.31149301825994,7
0.2,1862,92,157080,84.31561996779388,9
0.2,1863,90,157170,84.318669527897,12
0.2,1864,93,157263,84.32332439678284,8
0.2,1865,92,157355,84.32743837084674,9
0.2,1866,90,157445,84.33047670058919,12
0.2,1867,94,157539,84.33565310492506,8
0.2,1868,96,157635,84.34189406099519,6
0.2,1869,89,157724,84.34438502673797,12
0.2,1870,91,157815,84.3479422768573,11
0.2,1871,92,157907,84.35202991452991,9
0.2,1872,90,157997,84.35504538174052,12
0.2,1873,95,158092,84.36072572038421,8
0.2,1874,92,158184,84.3648,9
0.2,1875,94,158278,84.36993603411514,8
0.2,1876,94,158372,84.37506659563132,8
0.2,1877,94,158466,84.38019169329074,7
0.2,1878,95,158561,84.38584353379457,6
0.2,1879,94,158655,84.39095744680851,7
0.2,1880,94,158749,84.39606592238171,7
0.2,1881,88,158837,84.3979808714134,14
0.2,1882,92,158929,84.40201805629314,9
0.2,1883,92,159021,84.40605095541402,9
0.2,1884,93,159114,84.41061007957559,10
0.2,1885,93,159207,84.415164369035,8
0.2,1886,21,159228,84.38155802861685,12
0.2,1887,86,159314,84.38241525423729,16
0.2,1888,89,159403,84.38485971413446,12
0.2,1889,93,159496,84.38941798941799,8
0.2,1890,87,159583,84.39079851930195,14
0.2,1891,90,159673,84.39376321353066,11
0.2,1892,93,159766,84.39830956154252,8
0.2,1893,92,159858,84.40232312565998,10
0.2,1894,96,159954,84.40844327176781,7
0.2,1895,91,160045,84.41191983122363,10
0.2,1896,84,160129,84.41170268845545,17
0.2,1897,93,160222,84.41622760800843,8
0.2,1898,91,160313,84.41969457609268,10
0.2,1899,94,160407,84.42473684210526,7
0.2,1900,95,160502,84.43029984218832,7
0.2,1901,96,160598,84.43638275499474,7
0.2,1902,94,160692,84.44140830267997,7
0.2,1903,92,160784,84.4453781512605,9
0.2,1904,92,160876,84.449343832021,9
0.2,1905,27,160903,84.41920251836306,6
0.2,1906,92,160995,84.42317776612481,9
0.2,1907,92,161087,84.42714884696016,9
0.2,1908,86,161173,84.42797276060764,15
0.2,1909,92,161265,84.43193717277487,9
0.2,1910,94,161359,84.43694400837258,8
0.2,1911,95,161454,84.44246861924687,7
0.2,1912,94,161548,84.44746471510716,8
0.2,1913,91,161639,84.4508881922675,10
0.2,1914,92,161731,84.45483028720626,11
0.2,1915,95,161826,84.46033402922755,6
0.2,1916,94,161920,84.46531038080334,8
0.2,1917,26,161946,84.43482794577685,8
0.2,1918,90,162036,84.43772798332465,11
0.2,1919,95,162131,84.44322916666667,6
0.2,1920,88,162219,84.44508068714211,14
0.2,1921,92,162311,84.44901144640998,9
0.2,1922,92,162403,84.4529381175247,9
0.2,1923,93,162496,84.45738045738045,8
0.2,1924,96,162592,84.46337662337662,6
0.2,1925,94,162686,84.46832814122534,7
0.2,1926,91,162777,84.47171769590037,10
0.2,1927,94,162871,84.47665975103735,7
0.2,1928,94,162965,84.48159668221876,7
0.2,1929,93,163058,84.4860103626943,9
0.2,1930,90,163148,84.48886587260486,11
0.2,1931,94,163242,84.49378881987577,7
0.2,1932,89,163331,84.49612002069323,13
0.2,1933,90,163421,84.49896587383661,11
0.2,1934,92,163513,84.50284237726098,9
0.2,1935,93,163606,84.50723140495867,8
0.2,1936,95,163701,84.5126484254001,6
0.2,1937,94,163795,84.51754385964912,9
0.2,1938,27,163822,84.48788035069623,6
0.2,1939,90,163912,84.49072164948454,11
0.2,1940,92,164004,84.49459041731066,9
0.2,1941,93,164097,84.4989701338826,8
0.2,1942,92,164189,84.50283067421513,9
0.2,1943,96,164285,84.50874485596708,6
0.2,1944,92,164377,84.51259640102828,9
0.2,1945,92,164469,84.516443987667,9
0.2,1946,92,164561,84.52028762198253,9
0.2,1947,92,164653,84.5241273100616,9
0.2,1948,92,164745,84.52796305797845,9
0.2,1949,89,164834,84.53025641025641,12
0.2,1950,22,164856,84.49820604818042,10
0.2,1951,93,164949,84.50256147540983,8
0.2,1952,85,165034,84.50281618023554,16
0.2,1953,80,165114,84.50051177072672,21
0.2,1954,84,165198,84.5002557544757,17
0.2,1955,24,165222,84.46932515337423,10
0.2,1956,94,165316,84.47419519672968,7
0.2,1957,95,165411,84.47957099080695,7
0.2,1958,90,165501,84.48238897396631,13
0.2,1959,94,165595,84.48724489795919,7
0.2,1960,90,165685,84.49005609382968,13
0.2,1961,94,165779,84.49490316004078,7
0.2,1962,93,165872,84.49923586347427,9
0.2,1963,96,165968,84.5050916496945,6
0.2,1964,95,166063,84.51043256997455,7
0.2,1965,22,166085,84.47863682604273,11
0.2,1966,94,166179,84.48347737671581,7
0.2,1967,93,166272,84.48780487804878,8
0.2,1968,96,166368,84.49365159979685,6
0.2,1969,92,166460,84.49746192893402,9
0.2,1970,95,166555,84.50279046169457,6
0.2,1971,-57,166498,84.43103448275862,22
0.2,1972,92,166590,84.43487075519513,9
0.2,1973,93,166683,84.43920972644376,8
0.2,1974,87,166770,84.44050632911393,14
0.2,1975,93,166863,84.44483805668017,8
0.2,1976,94,166957,84.44967121901871,7
0.2,1977,94,167051,84.45449949443882,7
0.2,1978,92,167143,84.45831227892876,9
0.2,1979,96,167239,84.46414141414141,6
0.2,1980,93,167332,84.46845027763756,10
0.2,1981,94,167426,84.47325933400606,8
0.2,1982,95,167521,84.47856782652546,6
0.2,1983,90,167611,84.48135080645162,11
0.2,1984,94,167705,84.48614609571788,7
0.2,1985,94,167799,84.49093655589124,7
0.2,1986,91,167890,84.49421238047307,12
0.2,1987,87,167977,84.49547283702213,16
0.2,1988,89,168066,84.49773755656109,12
0.2,1989,90,168156,84.50050251256282,11
0.2,1990,94,168250,84.50527373179307,7
0.2,1991,93,168343,84.50953815261045,8
0.2,1992,91,168434,84.51279478173608,11
0.2,1993,90,168524,84.51554663991976,11
0.2,1994,15,168539,84.48070175438596,17
0.2,1995,92,168631,84.48446893787575,12
0.2,1996,94,168725,84.48923385077616,7
0.2,1997,-47,168678,84.42342342342343,10
0.2,1998,95,168773,84.42871435717859,6
0.2,1999,92,168865,84.4325,10
0.2,2000,94,168959,84.43728135932034,7
0.2,2001,89,169048,84.43956043956044,14
0.2,2002,93,169141,84.44383424862706,9
0.2,2003,93,169234,84.44810379241517,8
0.2,2004,94,169328,84.45286783042394,7
0.2,2005,94,169422,84.45762711864407,7
0.2,2006,89,169511,84.4598903836572,13
0.2,2007,92,169603,84.46364541832669,9
0.2,2008,94,169697,84.46839223494275,7
0.2,2009,95,169792,84.47363184079602,6
0.2,2010,87,169879,84.47488811536549,14
0.2,2011,93,169972,84.47912524850895,9
0.2,2012,95,170067,84.48435171385991,6
0.2,2013,16,170083,84.45034756703079,17
0.2,2014,89,170172,84.45260545905707,12
0.2,2015,92,170264,84.4563492063492,9
0.2,2016,27,170291,84.42786316311353,6
0.2,2017,88,170379,84.42963330029733,13
0.2,2018,95,170474,84.43486874690441,7
0.2,2019,24,170498,84.4049504950495,9
0.2,2020,95,170593,84.41019297377535,6
0.2,2021,94,170687,84.41493570722058,7
0.2,2022,92,170779,84.41868512110727,10
0.2,2023,88,170867,84.42045454545455,13
0.2,2024,96,170963,84.42617283950618,6
0.2,2025,95,171058,84.43139190523199,6
0.2,2026,89,171147,84.43364578194375,12
0.2,2027,90,171237,84.43639053254438,13
0.2,2028,94,171331,84.44110399211434,8
0.2,2029,94,171425,84.44581280788178,7
0.2,2030,93,171518,84.45002461841457,8
0.2,2031,88,171606,84.4517716535433,14
0.2,2032,23,171629,84.42154451549435,9
0.2,2033,94,171723,84.42625368731564,7
0.2,2034,92,171815,84.42997542997543,11
0.2,2035,85,171900,84.43025540275049,16
0.2,2036,94,171994,84.43495336278842,7
0.2,2037,91,172085,84.43817468105986,11
0.2,2038,91,172176,84.44139283962727,11
0.2,2039,95,172271,84.44656862745099,6
0.2,2040,93,172364,84.45075943165115,8
0.2,2041,91,172455,84.45396669931439,10
0.2,2042,84,172539,84.45374449339207,17
0.2,2043,92,172631,84.45743639921722,9
0.2,2044,25,172656,84.42836185819071,7
0.2,2045,92,172748,84.43206256109482,9
0.2,2046,93,172841,84.43624816805081,10
0.2,2047,91,172932,84.439453125,10
0.2,2048,93,173025,84.44363103953148,8
0.2,2049,94,173119,84.44829268292683,7
0.2,2050,90,173209,84.45099951243296,11
0.2,2051,96,173305,84.4566276803119,6
0.2,2052,95,173400,84.46176327325864,7
0.2,2053,93,173493,84.46592015579357,8
0.2,2054,96,173589,84.47153284671533,6
0.2,2055,95,173684,84.47665369649805,6
0.2,2056,91,173775,84.47982498784638,10
0.2,2057,95,173870,84.4849368318756,6
0.2,2058,92,173962,84.48858669256921,9
0.2,2059,95,174057,84.49368932038836,7
0.2,2060,92,174149,84.4973313925279,9
0.2,2061,90,174239,84.5,11
0.2,2062,92,174331,84.50363548230732,9
0.2,2063,91,174422,84.50678294573643,10
0.2,2064,89,174511,84.5089588377724,12
0.2,2065,15,174526,84.4753146176186,17
0.2,2066,83,174609,84.47460087082729,18
0.2,2067,94,174703,84.47920696324951,7
0.2,2068,96,174799,84.48477525374577,6
0.2,2069,93,174892,84.4888888888889,8
0.2,2070,91,174983,84.49203283437953,10
0.2,2071,90,175073,84.49469111969113,11
0.2,2072,96,175169,84.50024119633382,6
0.2,2073,89,175258,84.50241080038573,12
0.2,2074,93,175351,84.50650602409638,8
0.2,2075,94,175445,84.51107899807322,7
0.2,2076,95,175540,84.51612903225806,6
0.2,2077,96,175636,84.52165543792108,6
0.2,2078,91,175727,84.52477152477152,10
0.2,2079,94,175821,84.52932692307692,7
0.2,2080,90,175911,84.53195579048534,12
0.2,2081,92,176003,84.5355427473583,9
0.2,2082,94,176097,84.54008641382622,8
0.2,2083,85,176182,84.54030710172745,16
0.2,2084,91,176273,84.54340527577938,10
0.2,2085,96,176369,84.54889741131352,6
0.2,2086,91,176460,84.55198850023957,10
0.2,2087,86,176546,84.55268199233717,15
0.2,2088,94,176640,84.55720440402106,7
0.2,2089,94,176734,84.56172248803827,7
0.2,2090,90,176824,84.56432329029172,14
0.2,2091,94,176918,84.56883365200765,7
0.2,2092,91,177009,84.57190635451505,10
0.2,2093,90,177099,84.57449856733524,11
0.2,2094,92,177191,84.57804295942721,9
0.2,2095,17,177208,84.54580152671755,15
0.2,2096,91,177299,84.54887935145446,10
0.2,2097,94,177393,84.55338417540514,8
0.2,2098,91,177484,84.55645545497856,10
0.2,2099,-45,177439,84.4947619047619,10
0.2,2100,92,177531,84.49833412660638,9
0.2,2101,26,177557,84.47050428163654,6
0.2,2102,96,177653,84.47598668568712,7
0.2,2103,92,177745,84.47956273764258,9
0.2,2104,96,177841,84.48503562945368,6
0.2,2105,21,177862,84.45489078822412,11
0.2,2106,95,177957,84.45989558614143,6
0.2,2107,89,178046,84.46204933586338,12
0.2,2108,90,178136,84.46467520151731,11
0.2,2109,95,178231,84.4696682464455,6
0.2,2110,92,178323,84.47323543344386,9
0.2,2111,95,178418,84.4782196969697,7
0.2,2112,93,178511,84.48225272124941,8
0.2,2113,89,178600,84.48438978240303,12
0.2,2114,86,178686,84.48510638297873,15
0.2,2115,89,178775,84.48724007561437,13
0.2,2116,90,178865,84.48984411903638,11
0.2,2117,92,178957,84.49338999055713,9
0.2,2118,89,179046,84.49551675318547,12
0.2,2119,93,179139,84.4995283018868,8
0.2,2120,89,179228,84.5016501650165,12
0.2,2121,94,179322,84.50612629594723,7
0.2,2122,92,179414,84.50965614696185,9
0.2,2123,89,179503,84.5117702448211,12
0.2,2124,92,179595,84.51529411764706,9
0.2,2125,95,179690,84.52022577610536,6
0.2,2126,89,179779,84.5223319228961,12
0.2,2127,91,179870,84.52537593984962,10
0.2,2128,21,179891,84.49553781117896,11
0.2,2129,92,179983,84.49906103286385,9
0.2,2130,92,180075,84.50258094791178,9
0.2,2131,94,180169,84.50703564727955,7
0.2,2132,94,180263,84.51148616971402,7
0.2,2133,92,180355,84.51499531396439,9
0.2,2134,94,180449,84.51943793911008,7
0.2,2135,93,180542,84.52340823970037,8
0.2,2136,93,180635,84.52737482452035,8
0.2,2137,92,180727,84.53086997193638,9
0.2,2138,95,180822,84.53576437587658,6
0.2,2139,93,180915,84.53971962616822,10
0.2,2140,93,181008,84.5436711816908,8
0.2,2141,91,181099,84.546685340803,10
0.2,2142,94,181193,84.55109659356043,8
0.2,2143,94,181287,84.55550373134328,7
0.2,2144,94,181381,84.55990675990677,7
0.2,2145,96,181477,84.56523765144455,6
0.2,2146,89,181566,84.56730321378667,12
0.2,2147,24,181590,84.5391061452514,8
0.2,2148,91,181681,84.54211261051653,10
0.2,2149,92,181773,84.54558139534883,9
0.2,2150,94,181867,84.54997675499767,8
0.2,2151,94,181961,84.55436802973978,7
0.2,2152,92,182053,84.55782628889921,9
0.2,2153,96,182149,84.5631383472609,7
0.2,2154,93,182242,84.56705336426914,8
0.2,2155,91,182333,84.5700371057514,10
0.2,2156,94,182427,84.57440890125174,7
0.2,2157,95,182522,84.57924003707136,6
0.2,2158,95,182617,84.58406669754515,7
0.2,2159,93,182710,84.58796296296296,8
0.2,2160,95,182805,84.59278111985192,6
0.2,2161,85,182890,84.59296947271045,16
0.2,2162,73,182963,84.58760980120203,30
0.2,2163,92,183055,84.59103512014788,9
0.2,2164,94,183149,84.59538106235566,7
0.2,2165,88,183237,84.59695290858726,13
0.2,2166,94,183331,84.60129210890632,7
0.2,2167,93,183424,84.60516605166052,8
0.2,2168,92,183516,84.60857538035961,10
0.2,2169,92,183608,84.61198156682028,10
0.2,2170,87,183695,84.6130815292492,14
0.2,2171,95,183790,84.61786372007367,6
0.2,2172,93,183883,84.6217211228716,8
0.2,2173,89,183972,84.62373505059797,12
0.2,2174,80,184052,84.6216091954023,21
0.2,2175,92,184144,84.625,9
0.2,2176,96,184240,84.63022508038586,7
0.2,2177,93,184333,84.63406795224977,9
0.2,2178,21,184354,84.60486461679669,11
0.2,2179,92,184446,84.60825688073395,9
0.2,2180,90,184536,84.61072902338377,12
0.2,2181,92,184628,84.6141154903758,10
0.2,2182,80,184708,84.61200183234081,22
0.2,2183,95,184803,84.61675824175825,6
0.2,2184,94,184897,84.62105263157895,7
0.2,2185,90,184987,84.62351326623971,11
0.2,2186,96,185083,84.62871513488797,7
0.2,2187,84,185167,84.62842778793419,17
0.2,2188,95,185262,84.63316582914572,6
0.2,2189,18,185280,84.6027397260274,14
0.2,2190,92,185372,84.60611592879964,9
0.2,2191,93,185465,84.60994525547446,8
0.2,2192,94,185559,84.6142270861833,7
0.2,2193,93,185652,84.61804922515952,8
0.2,2194,95,185747,84.62277904328018,6
0.2,2195,95,185842,84.62750455373406,7
0.2,2196,95,185937,84.63222576240328,6
0.2,2197,93,186030,84.63603275705186,8
0.2,2198,92,186122,84.6393815370623,9
0.2,2199,90,186212,84.64181818181818,11
0.2,2200,90,186302,84.64425261244888,11
0.2,2201,95,186397,84.64895549500454,6
0.2,2202,95,186492,84.6536541080345,6
0.2,2203,91,186583,84.65653357531761,10
0.2,2204,94,186677,84.66077097505669,7
0.2,2205,92,186769,84.66409791477788,9
0.2,2206,96,186865,84.66923425464431,6
0.2,2207,93,186958,84.67300724637681,10
0.2,2208,96,187054,84.67813490267089,8
0.2,2209,95,187149,84.68280542986426,7
0.2,2210,92,187241,84.68611488014473,9
0.2,2211,94,187335,84.69032549728752,7
0.2,2212,90,187425,84.692724807953,11
0.2,2213,23,187448,84.66485998193315,10
0.2,2214,93,187541,84.6686230248307,8
0.2,2215,95,187636,84.67328519855596,7
0.2,2216,93,187729,84.67704104645918,9
0.2,2217,91,187820,84.67989179440937,10
0.2,2218,89,187909,84.6818386660658,12
0.2,2219,84,187993,84.68153153153153,17
0.2,2220,94,188087,84.68572714993246,7
0.2,2221,89,188176,84.68766876687668,12
0.2,2222,93,188269,84.69140800719748,8
0.2,2223,93,188362,84.69514388489209,8
0.2,2224,92,188454,84.69842696629213,10
0.2,2225,91,188545,84.70125786163523,10
0.2,2226,89,188634,84.7031881454872,12
0.2,2227,92,188726,84.7064631956912,9
0.2,2228,91,188817,84.7092866756393,10
0.2,2229,95,188912,84.71390134529148,7
0.2,2230,92,189004,84.71716718960107,10
0.2,2231,93,189097,84.72087813620071,8
0.2,2232,93,189190,84.72458575906852,8
0.2,2233,91,189281,84.72739480752014,11
0.2,2234,94,189375,84.73154362416108,7
0.2,2235,89,189464,84.7334525939177,12
0.2,2236,95,189559,84.73804202056326,6
0.2,2237,95,189654,84.74262734584451,6
0.2,2238,93,189747,84.74631531933899,8
0.2,2239,89,189836,84.74821428571428,12
0.2,2240,94,189930,84.75234270414994,8
0.2,2241,92,190022,84.75557537912579,9
0.2,2242,95,190117,84.76014266607223,6
0.2,2243,25,190142,84.73351158645276,9
0.2,2244,-55,190087,84.67126948775055,19
0.2,2245,20,190107,84.64247551202138,12
0.2,2246,90,190197,84.64485981308411,12
0.2,2247,92,190289,84.64813167259787,9
0.2,2248,89,190378,84.65006669630947,12
0.2,2249,89,190467,84.652,12
0.2,2250,93,190560,84.65570857396713,8
0.2,2251,91,190651,84.65852575488455,10
0.2,2252,91,190742,84.66134043497559,10
0.2,2253,95,190837,84.6659272404614,6
0.2,2254,93,190930,84.66962305986696,8
0.2,2255,92,191022,84.67287234042553,9
0.2,2256,17,191039,84.64288879042978,16
0.2,2257,94,191133,84.64703277236492,7
0.2,2258,95,191228,84.65161575918547,6
0.2,2259,96,191324,84.65663716814159,6
0.2,2260,94,191418,84.66076957098629,7
0.2,2261,91,191509,84.66357206012378,10
0.2,2262,89,191598,84.66548828988068,13
0.2,2263,91,191689,84.66828621908127,10
0.2,2264,96,191785,84.67328918322296,6
0.2,2265,94,191879,84.6774051191527,7
0.2,2266,91,191970,84.68019408910455,10
0.2,2267,93,192063,84.68386243386243,8
0.2,2268,93,192156,84.68752754517409,8
0.2,2269,90,192246,84.6898678414097,11
0.2,2270,91,192337,84.69264641127256,10
0.2,2271,94,192431,84.69674295774648,7
0.2,2272,89,192520,84.69863616366037,13
0.2,2273,96,192616,84.70360598065083,6
0.2,2274,94,192710,84.70769230769231,8
0.2,2275,26,192736,84.68189806678383,10
0.2,2276,95,192831,84.68642951251647,7
0.2,2277,96,192927,84.69139596136962,6
0.2,2278,-45,192882,84.63448881088196,8
0.2,2279,96,192978,84.63947368421053,6
0.2,2280,94,193072,84.64357737834283,7
0.2,2281,14,193086,84.61262050832603,18
0.2,2282,93,193179,84.61629434954008,9
0.2,2283,88,193267,84.6177758318739,13
0.2,2284,19,193286,84.5890590809628,13
0.2,2285,90,193376,84.59142607174103,11
0.2,2286,88,193464,84.59291648447748,13
0.2,2287,92,193556,84.59615384615384,10
0.2,2288,93,193649,84.5998252512014,9
0.2,2289,96,193745,84.60480349344978,7
0.2,2290,95,193840,84.60934089917066,6
0.2,2291,92,193932,84.61256544502618,9
0.2,2292,90,194022,84.61491495856956,11
0.2,2293,89,194111,84.61682650392328,12
0.2,2294,94,194205,84.62091503267973,8
0.2,2295,21,194226,84.59320557491289,11
0.2,2296,96,194322,84.5981715280801,6
0.2,2297,96,194418,84.60313315926894,6
0.2,2298,91,194509,84.60591561548499,10
0.2,2299,95,194604,84.61043478260869,6
0.2,2300,94,194698,84.61451542807475,7
0.2,2301,87,194785,84.61555169417898,14
0.2,2302,94,194879,84.61962657403387,7
0.2,2303,89,194968,84.62152777777777,12
0.2,2304,94,195062,84.62559652928417,7
0.2,2305,93,195155,84.62922810060711,9
0.2,2306,93,195248,84.63285652362376,8
0.2,2307,90,195338,84.63518197573657,11
0.2,2308,94,195432,84.63923776526634,9
0.2,2309,90,195522,84.64155844155844,11
0.2,2310,96,195618,84.64647338814366,6
0.2,2311,91,195709,84.6492214532872,10
0.2,2312,95,195804,84.65369649805447,6
0.2,2313,92,195896,84.65687121866897,9
0.2,2314,20,195916,84.62894168466522,13
0.2,2315,91,196007,84.63169257340242,10
0.2,2316,96,196103,84.63659905049633,8
0.2,2317,96,196199,84.64150129421915,6
0.2,2318,90,196289,84.64381198792583,11
0.2,2319,-48,196241,84.58663793103449,11
0.2,2320,92,196333,84.58983196897888,11
0.2,2321,89,196422,84.59173126614986,14
0.2,2322,93,196515,84.59535083943177,8
0.2,2323,26,196541,84.57013769363166,7
0.2,2324,92,196633,84.57333333333334,9
0.2,2325,93,196726,84.57695614789338,8
0.2,2326,27,196753,84.55221314997851,6
0.2,2327,88,196841,84.5536941580756,14
0.2,2328,96,196937,84.55860884499785,6
0.2,2329,94,197031,84.562660944206,8
0.2,2330,92,197123,84.56585156585156,10
0.2,2331,95,197218,84.57032590051458,6
0.2,2332,90,197308,84.57265323617659,12
0.2,2333,92,197400,84.5758354755784,10
0.2,2334,91,197491,84.57858672376874,11
0.2,2335,91,197582,84.58133561643835,10
0.2,2336,88,197670,84.58279845956355,13
0.2,2337,94,197764,84.58682634730539,8
0.2,2338,94,197858,84.5908507909363,7
0.2,2339,89,197947,84.59273504273504,14
0.2,2340,91,198038,84.59547202050406,10
0.2,2341,95,198133,84.5999146029035,6
0.2,2342,96,198229,84.60478019632949,6
0.2,2343,91,198320,84.60750853242321,10
0.2,2344,94,198414,84.61151385927505,7
0.2,2345,95,198509,84.6159420289855,6
0.2,2346,88,198597,84.61738389433319,14
0.2,2347,96,198693,84.62223168654174,6
0.2,2348,93,198786,84.62579821200511,8
0.2,2349,90,198876,84.62808510638298,11
0.2,2350,88,198964,84.6295193534666,13
0.2,2351,94,199058,84.63350340136054,8
0.2,2352,93,199151,84.63705907352316,10
0.2,2353,91,199242,84.63976210705182,10
0.2,2354,93,199335,84.64331210191082,8
0.2,2355,23,199358,84.61714770797963,10
0.2,2356,85,199443,84.61731014000848,16
0.2,2357,94,199537,84.62128922815945,7
0.2,2358,90,199627,84.62356930902925,11
0.2,2359,93,199720,84.62711864406779,9
0.2,2360,92,199812,84.6302414231258,9
0.2,2361,93,199905,84.6337849280271,8
0.2,2362,96,200001,84.63859500634786,6
0.2,2363,96,200097,84.64340101522842,6
0.2,2364,92,200189,84.64651162790697,9
0.2,2365,96,200285,84.6513102282333,7
0.2,2366,94,200379,84.6552598225602,7
0.2,2367,92,200471,84.65836148648648,9
0.2,2368,26,200497,84.63360067539045,7
0.2,2369,91,200588,84.63628691983122,10
0.2,2370,89,200677,84.6381273724167,12
0.2,2371,94,200771,84.6420741989882,8
0.2,2372,96,200867,84.64686051411715,6
0.2,2373,94,200961,84.65080033698399,7
0.2,2374,91,201052,84.65347368421052,10
0.2,2375,89,201141,84.65530303030303,12
0.2,2376,94,201235,84.65923432898612,7
0.2,2377,90,201325,84.66148023549201,12
0.2,2378,93,201418,84.6649852879361,9
0.2,2379,27,201445,84.64075630252101,6
0.2,2380,-54,201391,84.582528349433,17
0.2,2381,92,201483,84.58564231738035,9
0.2,2382,93,201576,84.58917331095257,8
0.2,2383,94,201670,84.59312080536913,7
0.2,2384,93,201763,84.59664570230608,8
0.2,2385,92,201855,84.5997485331098,9
0.2,2386,26,201881,84.57519899455383,6
0.2,2387,85,201966,84.57537688442211,17
0.2,2388,92,202058,84.57848472164085,9
0.2,2389,92,202150,84.581589958159,9
0.2,2390,93,202243,84.58511083228774,8
0.2,2391,87,202330,84.5861204013378,14
0.2,2392,94,202424,84.59005432511492,7
0.2,2393,94,202518,84.59398496240601,7
0.2,2394,90,202608,84.59624217118999,12
0.2,2395,93,202701,84.59974958263773,8
0.2,2396,95,202796,84.60408844388819,6
0.2,2397,95,202891,84.60842368640533,7
0.2,2398,96,202987,84.6131721550646,6
0.2,2399,94,203081,84.61708333333333,7
0.2,2400,96,203177,84.62182423990004,6
0.2,2401,26,203203,84.59741881765196,8
0.2,2402,93,203296,84.60091552226383,10
0.2,2403,95,203391,84.60524126455907,6
0.2,2404,81,203472,84.6037422037422,20
0.2,2405,96,203568,84.60847880299252,6
0.2,2406,88,203656,84.60988782717075,13
0.2,2407,95,203751,84.61420265780731,6
0.2,2408,95,203846,84.61851390618514,7
0.2,2409,93,203939,84.62199170124481,8
0.2,2410,90,204029,84.62422231439237,12
0.2,2411,94,204123,84.62810945273633,8
0.2,2412,95,204218,84.63240779113137,6
0.2,2413,85,204303,84.63256006628004,16
0.2,2414,91,204394,84.6351966873706,10
0.2,2415,88,204482,84.63658940397352,14
0.2,2416,93,204575,84.64004964832436,9
0.2,2417,95,204670,84.64433416046319,6
0.2,2418,94,204764,84.64820173625465,7
0.2,2419,95,204859,84.65247933884298,7
0.2,2420,88,204947,84.65386204047914,13
0.2,2421,-49,204898,84.59867877786952,13
0.2,2422,-57,204841,84.5402393726785,20
0.2,2423,94,204935,84.54414191419141,7
0.2,2424,93,205028,84.54762886597938,8
0.2,2425,90,205118,84.54987633965375,11
0.2,2426,16,205134,84.52163164400494,16
0.2,2427,91,205225,84.52429983525535,10
0.2,2428,-45,205180,84.47097571016879,9
0.2,2429,19,205199,84.4440329218107,16
0.2,2430,-121,205078,84.35952283011106,16
0.2,2431,96,205174,84.36430921052632,6
0.2,2432,95,205269,84.36868064118373,6
0.2,2433,91,205360,84.37140509449466,11
0.2,2434,96,205456,84.37618069815196,7
0.2,2435,86,205542,84.3768472906404,15
0.2,2436,94,205636,84.3807960607304,8
0.2,2437,89,205725,84.38269073010665,12
0.2,2438,90,205815,84.3849938499385,12
0.2,2439,92,205907,84.38811475409837,9
0.2,2440,87,205994,84.38918476034412,14
0.2,2441,88,206082,84.39066339066339,14
0.2,2442,95,206177,84.3950061399918,6
0.2,2443,95,206272,84.39934533551555,6
0.2,2444,90,206362,84.40163599182004,11
0.2,2445,92,206454,84.40474243663124,9
0.2,2446,96,206550,84.40948099713935,6
0.2,2447,87,206637,84.41053921568627,14
0.2,2448,93,206730,84.41404654961208,8
0.2,2449,96,206826,84.41877551020409,6
0.2,2450,91,206917,84.42146062831497,10
0.2,2451,96,207013,84.42618270799348,6
0.2,2452,94,207107,84.4300856094578,8
0.2,2453,95,207202,84.43439282803585,6
0.2,2454,91,207293,84.43706720977596,11
0.2,2455,95,207388,84.4413680781759,7
0.2,2456,90,207478,84.44363044363044,12
0.2,2457,90,207568,84.44589096826688,11
0.2,2458,90,207658,84.44814965433103,11
0.2,2459,96,207754,84.45284552845528,6
0.2,2460,95,207849,84.45713124746038,6
0.2,2461,94,207943,84.46100731112917,7
0.2,2462,92,208035,84.46406820950061,9
0.2,2463,25,208060,84.43993506493507,9
0.2,2464,92,208152,84.44300202839757,9
0.2,2465,84,208236,84.44282238442823,17
0.2,2466,87,208323,84.44385893798136,15
0.2,2467,92,208415,84.4469205834684,9
0.2,2468,87,208502,84.44795463750506,14
0.2,2469,94,208596,84.45182186234818,7
0.2,2470,95,208691,84.45609065155807,6
0.2,2471,94,208785,84.45995145631068,7
0.2,2472,94,208879,84.46380913869794,8
0.2,2473,94,208973,84.46766370250606,8
0.2,2474,88,209061,84.46909090909091,13
0.2,2475,95,209156,84.47334410339256,7
0.2,2476,88,209244,84.47476786435203,13
0.2,2477,22,209266,84.44955609362388,10
0.2,2478,95,209361,84.4538120209762,8
0.2,2479,92,209453,84.45685483870967,10
0.2,2480,91,209544,84.45949214026602,10
0.2,2481,95,209639,84.46373892022562,6
0.2,2482,94,209733,84.46757954087796,7
0.2,2483,20,209753,84.44162640901772,12
0.2,2484,89,209842,84.44346076458753,12
0.2,2485,94,209936,84.4473049074819,7
0.2,2486,91,210027,84.44993968636912,10
0.2,2487,91,210118,84.45257234726688,10
0.2,2488,95,210213,84.4568099638409,8
0.2,2489,93,210306,84.46024096385543,8
0.2,2490,25,210331,84.43637093536732,8
0.2,2491,93,210424,84.43980738362761,8
0.2,2492,94,210518,84.44364219815483,7
0.2,2493,-62,210456,84.38492381716118,29
0.2,2494,94,210550,84.38877755511022,7
0.2,2495,94,210644,84.3926282051282,8
0.2,2496,92,210736,84.39567480977172,10
0.2,2497,15,210751,84.36789431545236,18
0.2,2498,93,210844,84.37134853941576,10
0.2,2499,96,210940,84.376,6
0.2,2500,94,211034,84.37984806077569,7
0.2,2501,91,211125,84.38249400479616,10
0.2,2502,93,211218,84.3859368757491,8
0.2,2503,94,211312,84.38977635782747,7
0.2,2504,94,211406,84.3936127744511,7
0.2,2505,92,211498,84.39664804469274,9
0.2,2506,91,211589,84.39928201037097,10
0.2,2507,90,211679,84.40151515151516,11
0.2,2508,24,211703,84.3774412116381,11
0.2,2509,94,211797,84.38127490039841,9
0.2,2510,89,211886,84.38311429709279,12
0.2,2511,92,211978,84.38614649681529,9
0.2,2512,94,212072,84.3899721448468,7
0.2,2513,90,212162,84.39220365950676,12
0.2,2514,95,212257,84.39642147117296,7
0.2,2515,92,212349,84.39944356120827,9
0.2,2516,91,212440,84.4020659515296,10
0.2,2517,27,212467,84.37926926131851,6
0.2,2518,-50,212417,84.32592298531164,13
0.2,2519,96,212513,84.33055555555555,6
0.2,2520,23,212536,84.30622768742562,10
0.2,2521,89,212625,84.30808881839809,13
0.2,2522,92,212717,84.31113753468094,9
0.2,2523,94,212811,84.31497622820919,7
0.2,2524,94,212905,84.31881188118813,7
0.2,2525,87,212992,84.31987331749802,15
0.2,2526,92,213084,84.3229125445192,9
0.2,2527,93,213177,84.32634493670886,8
0.2,2528,24,213201,84.30249110320284,8
0.2,2529,94,213295,84.30632411067194,7
0.2,2530,96,213391,84.31094429079415,6
0.2,2531,91,213482,84.31358609794628,10
0.2,2532,94,213576,84.31741018555073,7
0.2,2533,94,213670,84.32123125493291,8
0.2,2534,91,213761,84.32386587771204,11
0.2,2535,93,213854,84.32728706624606,8
0.2,2536,96,213950,84.33188805675995,6
0.2,2537,93,214043,84.33530338849488,8
0.2,2538,94,214137,84.33910988578181,7
0.2,2539,94,214231,84.34291338582678,7
0.2,2540,95,214326,84.34710743801652,6
0.2,2541,84,214410,84.34697088906373,17
0.2,2542,23,214433,84.32284703106568,11
0.2,2543,90,214523,84.3250786163522,11
0.2,2544,81,214604,84.3237721021611,22
0.2,2545,94,214698,84.32757266300078,7
0.2,2546,88,214786,84.32901452689438,13
0.2,2547,94,214880,84.33281004709576,7
0.2,2548,94,214974,84.33660258925069,7
0.2,2549,93,215067,84.34,8
0.2,2550,92,215159,84.34300274402196,9
0.2,2551,96,215255,84.34757053291536,6
0.2,2552,88,215343,84.34900117508813,13
0.2,2553,91,215434,84.35160532498043,10
0.2,2554,95,215529,84.35577299412915,6
0.2,2555,89,215618,84.35758998435055,13
0.2,2556,90,215708,84.35979663668361,11
0.2,2557,91,215799,84.36239249413605,10
0.2,2558,93,215892,84.36576787807738,8
0.2,2559,93,215985,84.369140625,8
0.2,2560,90,216075,84.3713393205779,12
0.2,2561,93,216168,84.37470725995315,8
0.2,2562,93,216261,84.37807257120562,10
0.2,2563,90,216351,84.38026521060843,12
0.2,2564,94,216445,84.3840155945419,7
0.2,2565,90,216535,84.38620420888543,12
0.2,2566,90,216625,84.38839111803662,12
0.2,2567,93,216718,84.39174454828661,8
0.2,2568,96,216814,84.39626313740756,6
0.2,2569,95,216909,84.40038910505837,6
0.2,2570,93,217002,84.40373395565928,8
0.2,2571,90,217092,84.4059097978227,11
0.2,2572,90,217182,84.40808394869802,14
0.2,2573,95,217277,84.41219891219892,6
0.2,2574,24,217301,84.38873786407767,9
0.2,2575,93,217394,84.39208074534162,8
0.2,2576,95,217489,84.39619712844393,6
0.2,2577,91,217580,84.39875872769589,10
0.2,2578,94,217674,84.40248158200853,7
0.2,2579,92,217766,84.40542635658915,10
0.2,2580,92,217858,84.40836884928322,9
0.2,2581,95,217953,84.4124709527498,6
0.2,2582,24,217977,84.3890824622532,10
0.2,2583,94,218071,84.39280185758514,7
0.2,2584,89,218160,84.39458413926499,12
0.2,2585,90,218250,84.39675174013921,11
0.2,2586,92,218342,84.39969076149981,9
0.2,2587,91,218433,84.40224111282843,11
0.2,2588,22,218455,84.37813827732715,10
0.2,2589,91,218546,84.38069498069498,10
0.2,2590,93,218639,84.38402161327673,8
0.2,2591,27,218666,84.36188271604938,6
0.2,2592,84,218750,84.36174315464713,17
0.2,2593,93,218843,84.3650732459522,8
0.2,2594,93,218936,84.36840077071291,9
0.2,2595,90,219026,84.37057010785824,14
0.2,2596,94,219120,84.37427801309202,7
0.2,2597,93,219213,84.37759815242494,9
0.2,2598,94,219307,84.38130050019238,7
0.2,2599,22,219329,84.35730769230769,10
0.2,2600,94,219423,84.36101499423299,7
0.2,2601,93,219516,84.36433512682552,8
0.2,2602,94,219610,84.36803688052247,7
0.2,2603,92,219702,84.37096774193549,9
0.2,2604,94,219796,84.3746641074856,7
0.2,2605,92,219888,84.37759017651574,9
0.2,2606,94,219982,84.3812811660913,7
0.2,2607,92,220074,84.38420245398773,9
0.2,2608,88,220162,84.38558834802606,13
0.2,2609,96,220258,84.39003831417625,7
0.2,2610,93,220351,84.39333588663348,8
0.2,2611,92,220443,84.39624808575805,9
0.2,2612,25,220468,84.37351703023344,8
0.2,2613,92,220560,84.37643458301454,9
0.2,2614,89,220649,84.37820267686425,12
0.2,2615,92,220741,84.38111620795107,9
0.2,2616,92,220833,84.3840275124188,10
0.2,2617,92,220925,84.38693659281894,9
0.2,2618,93,221018,84.39022527682322,8
0.2,2619,93,221111,84.39351145038168,8
0.2,2620,91,221202,84.39603204883632,12
0.2,2621,93,221295,84.39931350114416,8
0.2,2622,95,221390,84.40335493709493,6
0.2,2623,93,221483,84.40663109756098,8
0.2,2624,92,221575,84.4095238095238,10
0.2,2625,95,221670,84.41355674028941,6
0.2,2626,81,221751,84.41225732775028,21
0.2,2627,94,221845,84.41590563165906,7
0.2,2628,96,221941,84.42031190566756,6
0.2,2629,96,222037,84.42471482889734,6
0.2,2630,90,222127,84.42683390345876,11
0.2,2631,15,222142,84.40045592705167,17
0.2,2632,27,222169,84.37865552601595,6
0.2,2633,83,222252,84.37813211845102,18
0.2,2634,94,222346,84.38178368121442,7
0.2,2635,93,222439,84.3850531107739,8
0.2,2636,94,222533,84.38869927948426,7
0.2,2637,93,222626,84.39196360879454,9
0.2,2638,90,222716,84.39408866995073,11
0.2,2639,20,222736,84.36969696969697,12
0.2,2640,94,222830,84.37334343051874,7
0.2,2641,87,222917,84.37433762301286,14
0.2,2642,94,223011,84.37797956867196,8
0.2,2643,96,223107,84.3823751891074,6
0.2,2644,93,223200,84.38563327032136,8
0.2,2645,23,223223,84.36243386243386,9
0.2,2646,95,223318,84.36645258783528,6
0.2,2647,95,223413,84.37046827794562,6
0.2,2648,93,223506,84.37372593431483,8
0.2,2649,26,223532,84.35169811320755,8
0.2,2650,27,223559,84.33006412674463,6
0.2,2651,91,223650,84.33257918552036,12
0.2,2652,89,223739,84.33433848473426,12
0.2,2653,88,223827,84.33571966842501,13
0.2,2654,94,223921,84.33935969868173,7
0.2,2655,92,224013,84.34224397590361,9
0.2,2656,-51,223962,84.2913059841927,15
0.2,2657,22,223984,84.267870579383,10
0.2,2658,95,224079,84.27190673185407,7
0.2,2659,94,224173,84.27556390977443,7
0.2,2660,91,224264,84.27809094325441,10
0.2,2661,93,224357,84.28136739293764,11
0.2,2662,94,224451,84.28501689823507,7
0.2,2663,95,224546,84.28903903903904,7
0.2,2664,95,224641,84.29305816135084,6
0.2,2665,89,224730,84.29482370592648,12
0.2,2666,95,224825,84.29883764529434,7
0.2,2667,94,224919,84.30247376311844,7
0.2,2668,94,225013,84.3061071562383,7
0.2,2669,91,225104,84.30861423220973,11
0.2,2670,96,225200,84.31299138899288,6
0.2,2671,21,225221,84.28929640718563,11
0.2,2672,94,225315,84.29292929292929,7
0.2,2673,84,225399,84.29281974569933,17
0.2,2674,93,225492,84.29607476635515,8
0.2,2675,82,225574,84.29521674140508,19
0.2,2676,82,225656,84.29435935748972,20
0.2,2677,88,225744,84.29574309185959,13
0.2,2678,85,225829,84.29600597237776,16
0.2,2679,83,225912,84.2955223880597,19
0.2,2680,94,226006,84.29914211115255,7
0.2,2681,-49,225957,84.24944071588367,13
0.2,2682,95,226052,84.25344763324637,6
0.2,2683,95,226147,84.25745156482861,6
0.2,2684,20,226167,84.23351955307263,12
0.2,2685,92,226259,84.23641102010424,9
0.2,2686,95,226354,84.24041682173427,6
0.2,2687,94,226448,84.24404761904762,8
0.2,2688,94,226542,84.24767571587951,7
0.2,2689,94,226636,84.25130111524163,7
0.2,2690,94,226730,84.25492382014122,7
0.2,2691,92,226822,84.25780089153047,9
0.2,2692,93,226915,84.2610471593019,8
0.2,2693,93,227008,84.26429101707498,8
0.2,2694,88,227096,84.26567717996289,13
0.2,2695,92,227188,84.26854599406528,10
0.2,2696,96,227284,84.27289581015944,6
0.2,2697,91,227375,84.27538917716828,10
0.2,2698,90,227465,84.27751018895887,11
0.2,2699,90,227555,84.27962962962962,11
0.2,2700,95,227650,84.2835986671603,8
0.2,2701,94,227744,84.28719467061435,8
0.2,2702,94,227838,84.29078801331853,7
0.2,2703,18,227856,84.26627218934911,14
0.2,2704,93,227949,84.26950092421441,8
0.2,2705,86,228035,84.27014042867701,15
0.2,2706,85,228120,84.27041004802365,17
0.2,2707,92,228212,84.27326440177252,9
0.2,2708,90,228302,84.27537836840162,12
0.2,2709,93,228395,84.27859778597787,8
0.2,2710,94,228489,84.28218369605311,9
0.2,2711,95,228584,84.28613569321534,6
0.2,2712,96,228680,84.2904533726502,6
0.2,2713,89,228769,84.29218865143699,12
0.2,2714,93,228862,84.29539594843462,8
0.2,2715,90,228952,84.29749631811488,11
0.2,2716,95,229047,84.30143540669856,7
0.2,2717,27,229074,84.280353200883,6
0.2,2718,94,229168,84.2839279146745,7
0.2,2719,90,229258,84.2860294117647,12
0.2,2720,96,229354,84.29033443586917,6
0.2,2721,94,229448,84.29390154298311,8
0.2,2722,92,229540,84.29673154608888,9
0.2,2723,27,229567,84.27569750367107,6
0.2,2724,87,229654,84.27669724770642,14
0.2,2725,86,229740,84.27732942039619,16
0.2,2726,93,229833,84.28052805280528,8
0.2,2727,92,229925,84.283357771261,9
0.2,2728,95,230020,84.28728471967754,6
0.2,2729,90,230110,84.28937728937728,11
0.2,2730,94,230204,84.29293299157818,7
0.2,2731,26,230230,84.27159590043924,7
0.2,2732,86,230316,84.27222832052689,15
0.2,2733,89,230405,84.27395757132406,12
0.2,2734,94,230499,84.27751371115174,7
0.2,2735,89,230588,84.27923976608187,13
0.2,2736,92,230680,84.28206065034709,9
0.2,2737,89,230769,84.28378378378379,12
0.2,2738,91,230860,84.28623585250091,10
0.2,2739,93,230953,84.28941605839417,9
0.2,2740,90,231043,84.29149945275446,11
0.2,2741,85,231128,84.29175784099198,17
0.2,2742,88,231216,84.29310973386802,13
0.2,2743,94,231310,84.2966472303207,7
0.2,2744,96,231406,84.30091074681239,6
0.2,2745,92,231498,84.30371449380918,9
0.2,2746,95,231593,84.30760829996359,7
0.2,2747,94,231687,84.31113537117903,7
0.2,2748,94,231781,84.31465987631866,7
0.2,2749,90,231871,84.31672727272728,11
0.2,2750,93,231964,84.31988367866231,8
0.2,2751,-44,231920,84.27325581395348,8
0.2,2752,91,232011,84.27569923719578,10
0.2,2753,95,232106,84.279593318809,6
0.2,2754,92,232198,84.28239564428313,10
0.2,2755,96,232294,84.2866473149492,6
0.2,2756,18,232312,84.26260428001451,15
0.2,2757,89,232401,84.2643219724438,12
0.2,2758,91,232492,84.2667633200435,10
0.2,2759,94,232586,84.27028985507246,7
0.2,2760,93,232679,84.27345164795364,8
0.2,2761,92,232771,84.2762490948588,9
0.2,2762,92,232863,84.27904451682953,9
0.2,2763,94,232957,84.28256150506512,8
0.2,2764,93,233050,84.28571428571429,8
0.2,2765,95,233145,84.28958785249458,6
0.2,2766,27,233172,84.26888326707626,6
0.2,2767,94,233266,84.27239884393063,7
0.2,2768,92,233358,84.27518959913326,9
0.2,2769,89,233447,84.2768953068592,12
0.2,2770,91,233538,84.27932154456875,11
0.2,2771,90,233628,84.28138528138528,12
0.2,2772,93,233721,84.28452939055175,8
0.2,2773,92,233813,84.28731074260995,10
0.2,2774,91,233904,84.28972972972973,10
0.2,2775,94,233998,84.29322766570606,8
0.2,2776,94,234092,84.29672308246309,7
0.2,2777,88,234180,84.29805615550755,13
0.2,2778,94,234274,84.30154731917956,7
0.2,2779,93,234367,84.3046762589928,8
0.2,2780,96,234463,84.30888169723121,7
0.2,2781,87,234550,84.3098490294752,15
0.2,2782,93,234643,84.31297161336687,8
0.2,2783,23,234666,84.29094827586206,9
0.2,2784,96,234762,84.2951526032316,6
0.2,2785,92,234854,84.29791816223977,9
0.2,2786,94,234948,84.30139935414424,7
0.2,2787,10,234958,84.27474892395983,23
0.2,2788,96,235054,84.27895302975978,6
0.2,2789,91,235145,84.28136200716845,10
0.2,2790,19,235164,84.25797205302759,13
0.2,2791,92,235256,84.26074498567336,9
0.2,2792,91,235347,84.26315789473684,12
0.2,2793,96,235443,84.26735862562634,6
0.2,2794,89,235532,84.2690518783542,12
0.2,2795,92,235624,84.27181688125894,9
0.2,2796,96,235720,84.27601001072578,6
0.2,2797,94,235814,84.2794853466762,7
0.2,2798,91,235905,84.28188638799571,10
0.2,2799,95,236000,84.28571428571429,6
0.2,2800,95,236095,84.28953945019636,8
0.2,2801,80,236175,84.28800856531049,21
0.2,2802,94,236269,84.29147342133429,7
0.2,2803,90,236359,84.2935092724679,11
0.2,2804,94,236453,84.2969696969697,8
0.2,2805,94,236547,84.30042765502495,7
0.2,2806,95,236642,84.30423940149626,6
0.2,2807,21,236663,84.28169515669515,11
0.2,2808,93,236756,84.28479886080456,8
0.2,2809,94,236850,84.28825622775801,8
0.2,2810,93,236943,84.2913553895411,8
0.2,2811,86,237029,84.29196301564723,15
0.2,2812,88,237117,84.29328119445432,13
0.2,2813,90,237207,84.2953091684435,11
0.2,2814,94,237301,84.29875666074601,7
0.2,2815,96,237397,84.30291193181819,6
0.2,2816,92,237489,84.30564430244941,9
0.2,2817,94,237583,84.30908445706174,7
0.2,2818,91,237674,84.31145796381696,10
0.2,2819,93,237767,84.3145390070922,9
0.2,2820,92,237859,84.31726338177951,9
0.2,2821,92,237951,84.31998582565556,9
0.2,2822,94,238045,84.32341480694296,7
0.2,2823,96,238141,84.32754957507082,6
0.2,2824,92,238233,84.33026548672566,9
0.2,2825,94,238327,84.33368719037509,7
0.2,2826,27,238354,84.31340643792005,6
0.2,2827,17,238371,84.28960396039604,15
0.2,2828,94,238465,84.29303640862496,7
0.2,2829,95,238560,84.29681978798587,6
0.2,2830,95,238655,84.3006004945249,8
0.2,2831,96,238751,84.30473163841808,6
0.2,2832,93,238844,84.30780091775503,8
0.2,2833,92,238936,84.3105151729005,9
0.2,2834,94,239030,84.31393298059965,7
0.2,2835,94,239124,84.31734837799718,7
0.2,2836,92,239216,84.3200563976031,9
0.2,2837,10,239226,84.2938689217759,22
0.2,2838,93,239319,84.29693554068334,8
0.2,2839,94,239413,84.30035211267605,7
0.2,2840,94,239507,84.30376627947906,7
0.2,2841,23,239530,84.28219563687544,10
0.2,2842,93,239623,84.28526204713332,8
0.2,2843,91,239714,84.28762306610408,10
0.2,2844,96,239810,84.29173989455184,6
0.2,2845,92,239902,84.29444834855938,9
0.2,2846,93,239995,84.29750614682122,9
0.2,2847,96,240091,84.30161516853933,6
0.2,2848,89,240180,84.3032643032643,12
0.2,2849,94,240274,84.30666666666667,7
0.2,2850,94,240368,84.31006664328306,8
0.2,2851,91,240459,84.31241234221599,10
0.2,2852,92,240551,84.31510690501227,9
0.2,2853,94,240645,84.31850035038542,7
0.2,2854,94,240739,84.32189141856392,7
0.2,2855,93,240832,84.3249299719888,9
0.2,2856,92,240924,84.32761638081904,9
0.2,2857,90,241014,84.3296011196641,11
0.2,2858,95,241109,84.33333333333333,8
0.2,2859,27,241136,84.31328671328671,6
0.2,2860,84,241220,84.31317721076546,17
0.2,2861,27,241247,84.29315164220824,6
0.2,2862,91,241338,84.29549423681453,10
0.2,2863,88,241426,84.29678770949721,13
0.2,2864,93,241519,84.29982547993019,8
0.2,2865,92,241611,84.30251221214236,10
0.2,2866,90,241701,84.30449947680502,11
0.2,2867,93,241794,84.30753138075313,8
0.2,2868,92,241886,84.31021261763681,9
0.2,2869,94,241980,84.31358885017421,7
0.2,2870,90,242070,84.31556948798328,11
0.2,2871,96,242166,84.31963788300835,6
0.2,2872,92,242258,84.32231117298991,9
0.2,2873,94,242352,84.32567849686848,7
0.2,2874,92,242444,84.32834782608695,9
0.2,2875,93,242537,84.33136300417246,9
0.2,2876,95,242632,84.33507125477928,6
0.2,2877,94,242726,84.33842946490618,7
0.2,2878,87,242813,84.33935394234109,14
0.2,2879,96,242909,84.34340277777778,6
0.2,2880,94,243003,84.34675459909754,8
0.2,2881,93,243096,84.34975711311588,8
0.2,2882,94,243190,84.35310440513354,7
0.2,2883,91,243281,84.35540915395285,10
0.2,2884,92,243373,84.3580589254766,9
0.2,2885,89,243462,84.35966735966736,12
0.2,2886,92,243554,84.362313820575,9
0.2,2887,91,243645,84.36461218836565,10
0.2,2888,95,243740,84.36829352717203,6
0.2,2889,93,243833,84.3712802768166,8
0.2,2890,92,243925,84.37391905914909,9
0.2,2891,-46,243879,84.32883817427386,11
0.2,2892,94,243973,84.33218112685793,8
0.2,2893,96,244069,84.33621285418107,7
0.2,2894,94,244163,84.33955094991364,7
0.2,2895,15,244178,84.31560773480663,17
0.2,2896,93,244271,84.31860545391784,8
0.2,2897,90,244361,84.32056590752244,11
0.2,2898,91,244452,84.32286995515695,10
0.2,2899,94,244546,84.32620689655172,8
0.2,2900,90,244636,84.32816270251638,11
0.2,2901,94,244730,84.3314955203308,8
0.2,2902,93,244823,84.33448157078884,8
0.2,2903,-49,244774,84.28856749311295,14
0.2,2904,87,244861,84.28950086058519,14
0.2,2905,95,244956,84.29318651066758,7
0.2,2906,82,245038,84.29239766081871,19
0.2,2907,26,245064,84.27235213204952,7
0.2,2908,89,245153,84.273977311791,12
0.2,2909,93,245246,84.27697594501718,8
0.2,2910,92,245338,84.27962899347304,10
0.2,2911,87,245425,84.28056318681318,15
0.2,2912,21,245446,84.25883968417439,13
0.2,2913,93,245539,84.26183939601921,8
0.2,2914,94,245633,84.26518010291595,7
0.2,2915,22,245655,84.24382716049382,12
0.2,2916,94,245749,84.2471717517998,7
0.2,2917,76,245825,84.24434544208361,25
0.2,2918,95,245920,84.24803014731073,7
0.2,2919,94,246014,84.2513698630137,7
0.2,2920,93,246107,84.2543649435125,8
0.2,2921,95,246202,84.2580424366872,6
0.2,2922,94,246296,84.26137529934998,7
0.2,2923,89,246385,84.26299589603283,12
0.2,2924,93,246478,84.26598290598291,8
0.2,2925,87,246565,84.26691729323308,15
0.2,2926,87,246652,84.26785104202254,14
0.2,2927,93,246745,84.27083333333333,8
0.2,2928,94,246839,84.27415500170707,9
0.2,2929,92,246931,84.27679180887372,9
0.2,2930,92,247023,84.27942681678608,9
0.2,2931,92,247115,84.28206002728513,9
0.2,2932,91,247206,84.28435049437437,10
0.2,2933,92,247298,84.28698023176551,9
0.2,2934,27,247325,84.26746166950596,6
0.2,2935,94,247419,84.27077656675749,7
0.2,2936,94,247513,84.27408920667348,7
0.2,2937,94,247607,84.27739959155889,7
0.2,2938,95,247702,84.28104797550188,7
0.2,2939,23,247725,84.26020408163265,9
0.2,2940,92,247817,84.26283577014621,9
0.2,2941,22,247839,84.24167233174711,12
0.2,2942,19,247858,84.2195039075773,14
0.2,2943,90,247948,84.22146739130434,11
0.2,2944,94,248042,84.22478777589134,7
0.2,2945,94,248136,84.22810590631364,7
0.2,2946,94,248230,84.23142178486597,10
0.2,2947,94,248324,84.23473541383989,7
0.2,2948,94,248418,84.2380467955239,7
0.2,2949,92,248510,84.2406779661017,9
0.2,2950,90,248600,84.24262961707896,12
0.2,2951,86,248686,84.24322493224932,15
0.2,2952,94,248780,84.2465289536065,7
0.2,2953,88,248868,84.24779959377116,13
0.2,2954,90,248958,84.2497461928934,11
0.2,2955,94,249052,84.2530446549391,8
0.2,2956,92,249144,84.25566452485627,9
0.2,2957,18,249162,84.23326572008114,15
0.2,2958,95,249257,84.23690435958093,6
0.2,2959,95,249352,84.24054054054054,6
0.2,2960,94,249446,84.24383654170889,7
0.2,2961,93,249539,84.24679270762998,8
0.2,2962,94,249633,84.25008437394533,7
0.2,2963,94,249727,84.25337381916329,7
0.2,2964,91,249818,84.25564924114671,10
0.2,2965,88,249906,84.25691166554282,13
0.2,2966,91,249997,84.25918436130772,12
0.2,2967,94,250091,84.26246630727763,7
0.2,2968,14,250105,84.23880094307847,18
0.2,2969,93,250198,84.24175084175084,9
0.2,2970,94,250292,84.24503534163581,7
0.2,2971,26,250318,84.22543741588156,8
0.2,2972,93,250411,84.2283888328288,8
0.2,2973,93,250504,84.23133826496301,8
0.2,2974,95,250599,84.23495798319328,8
0.2,2975,93,250692,84.23790322580645,8
0.2,2976,92,250784,84.24051058112194,9
0.2,2977,88,250872,84.24177300201478,13
0.2,2978,92,250964,84.24437730782142,11
0.2,2979,94,251058,84.24765100671141,7
0.2,2980,89,251147,84.24924521972493,12
0.2,2981,90,251237,84.25117370892019,12
0.2,2982,88,251325,84.25243043915522,14
0.2,2983,94,251419,84.25569705093834,7
0.2,2984,94,251513,84.25896147403685,8
0.2,2985,96,251609,84.26289350301407,7
0.2,2986,95,251704,84.26648811516571,7
0.2,2987,92,251796,84.26907630522088,9
0.2,2988,95,251891,84.27266644362663,6
0.2,2989,94,251985,84.27591973244147,7
0.2,2990,89,252074,84.27749916415914,13
0.2,2991,92,252166,84.28008021390374,9
0.2,2992,94,252260,84.2833277647845,7
0.2,2993,89,252349,84.28490313961255,12
0.2,2994,25,252374,84.26510851419032,8
0.2,2995,92,252466,84.26769025367156,9
0.2,2996,95,252561,84.27127127127127,6
0.2,2997,89,252650,84.27284856571048,12
0.2,2998,84,252734,84.27275758586195,17
0.2,2999,83,252817,84.27233333333334,18
0.2,3000,23,252840,84.25191602799067,10
0.2,3001,94,252934,84.25516322451699,7
0.2,3002,90,253024,84.25707625707626,11
0.2,3003,92,253116,84.25965379494008,9
0.2,3004,96,253212,84.26356073211315,6
0.2,3005,89,253301,84.2651363938789,13
0.2,3006,95,253396,84.2687063518457,6
0.2,3007,94,253490,84.27194148936171,8
0.2,3008,93,253583,84.27484214024592,8
0.2,3009,92,253675,84.27740863787375,9
0.2,3010,87,253762,84.2783128528728,14
0.2,3011,92,253854,84.2808764940239,10
0.2,3012,94,253948,84.28410222369732,7
0.2,3013,93,254041,84.28699402786994,8
0.2,3014,93,254134,84.28988391376451,8
0.2,3015,94,254228,84.29310344827586,7
0.2,3016,88,254316,84.29433211799801,13
0.2,3017,96,254412,84.29821073558648,6
0.2,3018,93,254505,84.30109307717787,8
0.2,3019,84,254589,84.30099337748345,17
0.2,3020,95,254684,84.30453492221119,6
0.2,3021,91,254775,84.30675049636002,10
0.2,3022,91,254866,84.30896460469732,10
0.2,3023,91,254957,84.31117724867725,10
0.2,3024,93,255050,84.31404958677686,9
0.2,3025,96,255146,84.31791143423662,6
0.2,3026,92,255238,84.3204492897258,9
0.2,3027,94,255332,84.32364597093792,7
0.2,3028,91,255423,84.32585011554968,11
0.2,3029,95,255518,84.32937293729373,6
0.2,3030,92,255610,84.3319036621577,9
0.2,3031,92,255702,84.3344327176781,9
0.2,3032,92,255794,84.3369601055061,9
0.2,3033,93,255887,84.33981542518129,8
0.2,3034,92,255979,84.34233937397035,11
0.2,3035,94,256073,84.34552042160738,7
0.2,3036,93,256166,84.34837010207441,9
0.2,3037,96,256262,84.35220539828835,6
0.2,3038,87,256349,84.35307666995722,14
0.2,3039,93,256442,84.35592105263157,9
0.2,3040,95,256537,84.35942124301216,6
0.2,3041,92,256629,84.36193293885601,9
0.2,3042,91,256720,84.36411436082813,10
0.2,3043,92,256812,84.36662286465177,9
0.2,3044,94,256906,84.36978653530377,7
0.2,3045,93,256999,84.3726198292843,9
0.2,3046,88,257087,84.37381030521824,13
0.2,3047,93,257180,84.3766404199475,8
0.2,3048,94,257274,84.37979665464087,8
0.2,3049,94,257368,84.38295081967213,7
0.2,3050,88,257456,84.38413634873812,14
0.2,3051,93,257549,84.38695937090432,8
0.2,3052,90,257639,84.38879790370127,12
0.2,3053,94,257733,84.39194499017681,7
0.2,3054,93,257826,84.39476268412439,9
0.2,3055,83,257909,84.39430628272251,20
0.2,3056,26,257935,84.37520444880602,7
0.2,3057,96,258031,84.37900588620013,6
0.2,3058,20,258051,84.35796011768552,13
0.2,3059,92,258143,84.36045751633986,9
0.2,3060,96,258239,84.36426004573669,6
0.2,3061,27,258266,84.34552580013063,6
0.2,3062,22,258288,84.32517140058766,11
0.2,3063,93,258381,84.32800261096605,9
0.2,3064,94,258475,84.33115823817292,8
0.2,3065,94,258569,84.33431180691454,8
0.2,3066,93,258662,84.33713726768829,9
0.2,3067,95,258757,84.34061277705345,7
0.2,3068,88,258845,84.34180514825677,13
0.2,3069,27,258872,84.32312703583062,6
0.2,3070,95,258967,84.32660371214588,6
0.2,3071,93,259060,84.32942708333333,8
0.2,3072,27,259087,84.31077123332248,6
0.2,3073,93,259180,84.31359791802213,8
0.2,3074,91,259271,84.31577235772357,11
0.2,3075,88,259359,84.31697009102731,13
0.2,3076,94,259453,84.32011699707508,7
0.2,3077,93,259546,84.32293697205978,8
0.2,3078,92,259638,84.3254303345242,10
0.2,3079,94,259732,84.32857142857142,7
0.2,3080,93,259825,84.33138591366439,8
0.2,3081,94,259919,84.33452303698897,8
0.2,3082,92,260011,84.33700940642231,9
0.2,3083,89,260100,84.3385214007782,12
0.2,3084,96,260196,84.34230145867099,6
0.2,3085,94,260290,84.3454309786131,7
0.2,3086,25,260315,84.32620667314545,8
0.2,3087,21,260336,84.30569948186529,11
0.2,3088,93,260429,84.30851408222726,8
0.2,3089,-50,260379,84.26504854368932,14
0.2,3090,94,260473,84.26819799417665,8
0.2,3091,95,260568,84.27166882276843,7
0.2,3092,94,260662,84.27481409634659,8
0.2,3093,94,260756,84.27795733678087,7
0.2,3094,93,260849,84.28077544426495,8
0.2,3095,-44,260805,84.23934108527132,8
0.2,3096,94,260899,84.24249273490474,7
0.2,3097,94,260993,84.24564234990316,9
0.2,3098,95,261088,84.24911261697322,7
0.2,3099,20,261108,84.2283870967742,12
0.2,3100,26,261134,84.20960980328927,6
0.2,3101,95,261229,84.21308833010961,6
0.2,3102,27,261256,84.19465033838222,6
0.2,3103,81,261337,84.19362113402062,22
0.2,3104,91,261428,84.19581320450885,11
0.2,3105,92,261520,84.19832582099163,9
0.2,3106,96,261616,84.20212423559704,7
0.2,3107,94,261710,84.2052767052767,7
0.2,3108,92,261802,84.20778385332905,9
0.2,3109,95,261897,84.21125401929261,6
0.2,3110,95,261992,84.21472195435551,8
0.2,3111,94,262086,84.21786632390746,7
0.2,3112,88,262174,84.21908127208481,15
0.2,3113,90,262264,84.22093770070649,11
0.2,3114,92,262356,84.22343499197432,9
0.2,3115,91,262447,84.22560975609755,10
0.2,3116,23,262470,84.20596727622714,10
0.2,3117,20,262490,84.1853752405388,12
0.2,3118,91,262581,84.1875601154216,11
0.2,3119,90,262671,84.18942307692308,11
0.2,3120,92,262763,84.19192566485101,9
0.2,3121,89,262852,84.19346572709802,12
0.2,3122,90,262942,84.19532500800513,11
0.2,3123,94,263036,84.19846350832266,7
0.2,3124,95,263131,84.20192,6
0.2,3125,91,263222,84.20409468969929,11
0.2,3126,94,263316,84.20722737448034,8
0.2,3127,93,263409,84.21003836317135,9
0.2,3128,94,263503,84.21316714605305,8
0.2,3129,92,263595,84.21565495207668,9
0.2,3130,93,263688,84.21846055573299,8
0.2,3131,91,263779,84.22062579821201,10
0.2,3132,88,263867,84.22183210979891,13
0.2,3133,91,263958,84.22399489470325,10
0.2,3134,87,264045,84.22488038277513,14
0.2,3135,95,264140,84.22831632653062,6
0.2,3136,86,264226,84.22888109658909,15
0.2,3137,96,264322,84.23263224984066,6
0.2,3138,90,264412,84.23446957629818,11
0.2,3139,87,264499,84.23535031847133,14
0.2,3140,93,264592,84.23814071951608,8
0.2,3141,88,264680,84.23933800127307,13
0.2,3142,93,264773,84.24212535793828,8
0.2,3143,92,264865,84.24459287531806,10
0.2,3144,14,264879,84.22225755166932,18
0.2,3145,93,264972,84.22504767959313,8
0.2,3146,86,265058,84.22561169367651,16
0.2,3147,95,265153,84.22903430749682,6
0.2,3148,92,265245,84.23150206414735,9
0.2,3149,91,265336,84.2336507936508,10
0.2,3150,96,265432,84.23738495715646,6
0.2,3151,25,265457,84.21859137055837,8
0.2,3152,91,265548,84.22074215033301,10
0.2,3153,91,265639,84.22289156626506,12
0.2,3154,94,265733,84.22599049128368,7
0.2,3155,94,265827,84.22908745247149,7
0.2,3156,91,265918,84.23123218245169,10
0.2,3157,94,266012,84.23432552248258,7
0.2,3158,94,266106,84.23741690408357,7
0.2,3159,94,266200,84.24050632911393,8
0.2,3160,92,266292,84.24296108826321,9
0.2,3161,96,266388,84.24667931688805,6
0.2,3162,78,266466,84.24470439456212,23
0.2,3163,92,266558,84.24715549936789,9
0.2,3164,94,266652,84.25023696682464,7
0.2,3165,94,266746,84.25331648768162,8
0.2,3166,91,266837,84.2554467950742,10
0.2,3167,-127,266710,84.18876262626263,21
0.2,3168,94,266804,84.1918586304828,7
0.2,3169,94,266898,84.19495268138802,7
0.2,3170,93,266991,84.19772942289498,8
0.2,3171,91,267082,84.19987389659521,10
0.2,3172,86,267168,84.20044122281752,15
0.2,3173,92,267260,84.20289855072464,9
0.2,3174,94,267354,84.2059842519685,8
0.2,3175,95,267449,84.20938287153652,7
0.2,3176,90,267539,84.21120553981744,11
0.2,3177,27,267566,84.19320327249842,6
0.2,3178,92,267658,84.19565901226801,9
0.2,3179,92,267750,84.19811320754717,9
0.2,3180,25,267775,84.1795033008488,7
0.2,3181,23,267798,84.16027655562539,10
0.2,3182,25,267823,84.14169022934338,8
0.2,3183,87,267910,84.14258793969849,14
0.2,3184,92,268002,84.14505494505495,9
0.2,3185,94,268096,84.14814814814815,7
0.2,3186,90,268186,84.14998431126452,11
0.2,3187,95,268281,84.15338770388959,6
0.2,3188,94,268375,84.15647538413296,7
0.2,3189,95,268470,84.15987460815047,7
0.2,3190,95,268565,84.16327170166092,6
0.2,3191,95,268660,84.16666666666667,6
0.2,3192,25,268685,84.14813654870028,8
0.2,3193,94,268779,84.15122103944897,7
0.2,3194,94,268873,84.15430359937402,7
0.2,3195,23,268896,84.1351689612015,9
0.2,3196,94,268990,84.13825461370034,7
0.2,3197,92,269082,84.14071294559099,9
0.2,3198,89,269171,84.1422319474836,12
0.2,3199,95,269266,84.145625,7
0.2,3200,86,269352,84.14620431115276,15
0.2,3201,94,269446,84.14928169893817,8
0.2,3202,96,269542,84.15298157976896,6
0.2,3203,92,269634,84.15543071161049,9
0.2,3204,91,269725,84.1575663026521,10
0.2,3205,94,269819,84.16063630692452,8
0.2,3206,93,269912,84.16339257873402,8
0.2,3207,95,270007,84.16677057356608,6
0.2,3208,93,270100,84.16952321595512,8
0.2,3209,92,270192,84.17196261682243,9
0.2,3210,-46,270146,84.13142323263781,10
0.2,3211,86,270232,84.13200498132005,15
0.2,3212,92,270324,84.1344537815126,9
0.2,3213,90,270414,84.13627878033603,12
0.2,3214,91,270505,84.1384136858476,10
0.2,3215,92,270597,84.14085820895522,10
0.2,3216,93,270690,84.14361206092633,8
0.2,3217,96,270786,84.14729645742698,6
0.2,3218,95,270881,84.1506679092886,7
0.2,3219,93,270974,84.15341614906832,8
0.2,3220,92,271066,84.15585221980751,9
0.2,3221,96,271162,84.15952824332713,6
0.2,3222,91,271253,84.16165063605337,10
0.2,3223,90,271343,84.16346153846153,11
0.2,3224,88,271431,84.1646511627907,13
0.2,3225,89,271520,84.16615003099814,12
0.2,3226,90,271610,84.16795785559343,11
0.2,3227,94,271704,84.17100371747212,7
0.2,3228,94,271798,84.17404769278414,8
0.2,3229,92,271890,84.17647058823529,9
0.2,3230,90,271980,84.17827298050139,11
0.2,3231,96,272076,84.1819306930693,6
0.2,3232,94,272170,84.184967522425,7
0.2,3233,96,272266,84.18862090290662,6
0.2,3234,89,272355,84.19010819165379,12
0.2,3235,96,272451,84.19375772558715,6
0.2,3236,93,272544,84.1964782205746,8
0.2,3237,90,272634,84.19827053736874,11
0.2,3238,92,272726,84.2006792219821,9
0.2,3239,89,272815,84.20216049382717,13
0.2,3240,94,272909,84.20518358531318,7
0.2,3241,17,272926,84.18445404071561,15
0.2,3242,94,273020,84.18748072772125,8
0.2,3243,27,273047,84.16985203452528,6
0.2,3244,87,273134,84.17072419106317,14
0.2,3245,94,273228,84.17375231053605,8
0.2,3246,93,273321,84.17647058823529,8
0.2,3247,92,273413,84.17887931034483,9
0.2,3248,86,273499,84.17943982763927,15
0.2,3249,91,273590,84.18153846153847,10
0.2,3250,94,273684,84.18455859735467,7
0.2,3251,96,273780,84.18819188191883,7
0.2,3252,95,273875,84.19151552413157,6
0.2,3253,93,273968,84.19422249539029,9
0.2,3254,94,274062,84.19723502304147,7
0.2,3255,94,274156,84.2002457002457,7
0.2,3256,96,274252,84.20386859072767,6
0.2,3257,92,274344,84.20626151012891,9
0.2,3258,95,274439,84.20957348880025,6
0.2,3259,92,274531,84.21196319018405,9
0.2,3260,96,274627,84.21557804354492,6
0.2,3261,92,274719,84.21796443899449,10
0.2,3262,89,274808,84.21942997241803,12
0.2,3263,76,274884,84.21691176470588,26
0.2,3264,89,274973,84.21837672281777,13
0.2,3265,92,275065,84.22075933864053,9
0.2,3266,96,275161,84.2243648607285,6
0.2,3267,95,275256,84.22766217870257,6
0.2,3268,96,275352,84.23126338329764,6
0.2,3269,90,275442,84.23302752293579,11
0.2,3270,93,275535,84.23570773463773,8
0.2,3271,91,275626,84.2377750611247,10
0.2,3272,96,275722,84.24136877482432,6
0.2,3273,96,275818,84.24496029321931,6
0.2,3274,96,275914,84.24854961832061,6
0.2,3275,95,276009,84.2518315018315,6
0.2,3276,95,276104,84.25511138236192,6
0.2,3277,87,276191,84.25594874923733,16
0.2,3278,93,276284,84.25861543153401,8
0.2,3279,88,276372,84.25975609756098,13
0.2,3280,90,276462,84.26150563852484,11
0.2,3281,92,276554,84.26386349786715,9
0.2,3282,94,276648,84.26682911970758,8
0.2,3283,94,276742,84.26979293544458,9
0.2,3284,91,276833,84.27184170471841,10
0.2,3285,93,276926,84.27449786975046,8
0.2,3286,87,277013,84.27532704593854,14
0.2,3287,96,277109,84.27889294403893,6
0.2,3288,89,277198,84.2803283672849,12
0.2,3289,96,277294,84.2838905775076,6
0.2,3290,86,277380,84.28441203281677,16
0.2,3291,95,277475,84.28766707168894,7
0.2,3292,25,277500,84.26966292134831,8
0.2,3293,86,277586,84.2701882210079,15
0.2,3294,94,277680,84.2731411229135,7
0.2,3295,88,277768,84.27427184466019,13
0.2,3296,94,277862,84.27722171671216,7
0.2,3297,89,277951,84.27865372953305,12
0.2,3298,94,278045,84.28160048499545,7
0.2,3299,92,278137,84.28393939393939,9
0.2,3300,12,278149,84.26204180551348,22
0.2,3301,94,278243,84.26499091459722,7
0.2,3302,94,278337,84.26793823796548,7
0.2,3303,92,278429,84.2702784503632,9
0.2,3304,92,278521,84.27261724659607,10
0.2,3305,90,278611,84.27434966727162,11
0.2,3306,19,278630,84.25461143029936,13
0.2,3307,93,278723,84.25725513905684,8
0.2,3308,91,278814,84.25929283771532,10
0.2,3309,92,278906,84.26163141993958,9
0.2,3310,92,278998,84.26396858954999,9
0.2,3311,89,279087,84.26539855072464,12
0.2,3312,91,279178,84.26743133111984,10
0.2,3313,91,279269,84.26946288473144,12
0.2,3314,96,279365,84.27300150829562,6
0.2,3315,94,279459,84.27593486127864,8
0.2,3316,94,279553,84.27886644558336,7
0.2,3317,93,279646,84.28149487643158,8
0.2,3318,80,279726,84.28020488098825,23
0.2,3319,91,279817,84.28222891566266,11
0.2,3320,93,279910,84.2848539596507,8
0.2,3321,89,279999,84.28627332931968,12
0.2,3322,92,280091,84.28859464339452,9
0.2,3323,93,280184,84.29121540312876,8
0.2,3324,26,280210,84.27368421052631,6
0.2,3325,87,280297,84.27450390859892,14
0.2,3326,92,280389,84.27682596934174,9
0.2,3327,95,280484,84.28004807692308,6
0.2,3328,96,280580,84.283568639231,6
0.2,3329,27,280607,84.26636636636637,6
0.2,3330,24,280631,84.24827379165416,9
0.2,3331,21,280652,84.22929171668667,12
0.2,3332,95,280747,84.23252325232524,6
0.2,3333,-46,280701,84.19346130773845,11
0.2,3334,8,280709,84.17061469265367,24
0.2,3335,96,280805,84.17416067146283,6
0.2,3336,95,280900,84.17740485465987,7
0.2,3337,26,280926,84.15997603355302,6
0.2,3338,23,280949,84.14165917939503,10
0.2,3339,90,281039,84.14341317365269,11
0.2,3340,92,281131,84.14576474109548,10
0.2,3341,84,281215,84.1457211250748,17
0.2,3342,92,281307,84.14807059527371,9
0.2,3343,92,281399,84.15041866028709,9
0.2,3344,91,281490,84.152466367713,10
0.2,3345,88,281578,84.15361625821878,13
0.2,3346,94,281672,84.15655811174186,7
0.2,3347,89,281761,84.15800477897253,12
0.2,3348,94,281855,84.16094356524336,7
0.2,3349,93,281948,84.16358208955224,8
0.2,3350,92,282040,84.16592062071024,9
0.2,3351,27,282067,84.14886634844869,6
0.2,3352,96,282163,84.15240083507307,6
0.2,3353,95,282258,84.15563506261181,6
0.2,3354,93,282351,84.15827123695976,8
0.2,3355,92,282443,84.16060786650775,10
0.2,3356,91,282534,84.16264521894549,10
0.2,3357,94,282628,84.16557474687313,7
0.2,3358,26,282654,84.14825841024114,7
0.2,3359,93,282747,84.15089285714286,8
0.2,3360,91,282838,84.15293067539423,10
0.2,3361,96,282934,84.15645449137418,6
0.2,3362,93,283027,84.15908415105561,8
0.2,3363,22,283049,84.14060642092747,11
0.2,3364,93,283142,84.14323922734027,8
0.2,3365,95,283237,84.14646464646465,6
0.2,3366,95,283332,84.14968814968815,6
0.2,3367,85,283417,84.1499406175772,16
0.2,3368,27,283444,84.13297714455328,6
0.2,3369,94,283538,84.13590504451038,8
0.2,3370,94,283632,84.13883120735687,8
0.2,3371,96,283728,84.14234875444839,6
0.2,3372,92,283820,84.14467832789802,9
0.2,3373,84,283904,84.14463544754001,17
0.2,3374,94,283998,84.14755555555556,7
0.2,3375,94,284092,84.1504739336493,8
0.2,3376,94,284186,84.153390583358,7
0.2,3377,94,284280,84.1563055062167,8
0.2,3378,27,284307,84.1393903521752,6
0.2,3379,94,284401,84.1423076923077,7
0.2,3380,94,284495,84.14522330671399,8
0.2,3381,91,284586,84.14725014784152,10
0.2,3382,94,284680,84.15016257759385,7
0.2,3383,94,284774,84.153073286052,7
0.2,3384,92,284866,84.15539143279173,9
0.2,3385,93,284959,84.15800354400473,8
0.2,3386,90,285049,84.15972837319161,12
0.2,3387,90,285139,84.16145218417945,11
0.2,3388,94,285233,84.16435526704042,7
0.2,3389,95,285328,84.16755162241888,6
0.2,3390,95,285423,84.17074609259805,6
0.2,3391,94,285517,84.17364386792453,7
0.2,3392,89,285606,84.17506631299734,12
0.2,3393,93,285699,84.1776664702416,8
0.2,3394,91,285790,84.17967599410899,10
0.2,3395,86,285876,84.18021201413427,15
0.2,3396,94,285970,84.18310273770975,7
0.2,3397,90,286060,84.18481459682165,11
0.2,3398,92,286152,84.18711385701677,9
0.2,3399,83,286235,84.18676470588235,18
0.2,3400,92,286327,84.1890620405763,10
0.2,3401,94,286421,84.19194591416813,8
0.2,3402,21,286442,84.17337643255951,11
0.2,3403,90,286532,84.17508813160987,11
0.2,3404,95,286627,84.17826725403818,8
0.2,3405,90,286717,84.17997651203758,11
0.2,3406,17,286734,84.16025829175227,15
0.2,3407,94,286828,84.1631455399061,7
0.2,3408,94,286922,84.1660310941625,7
0.2,3409,96,287018,84.16950146627566,6
0.2,3410,90,287108,84.17121078862503,13
0.2,3411,88,287196,84.17233294255568,13
0.2,3412,93,287289,84.17491942572516,9
0.2,3413,91,287380,84.17691857059168,10
0.2,3414,92,287472,84.1792093704246,9
0.2,3415,25,287497,84.16188524590164,8
0.2,3416,94,287591,84.16476441322797,7
0.2,3417,95,287686,84.16793446459918,6
0.2,3418,95,287781,84.17110266159696,7
0.2,3419,92,287873,84.1733918128655,10
0.2,3420,95,287968,84.17655656240865,7
0.2,3421,94,288062,84.17942723553477,7
0.2,3422,94,288156,84.18229623137599,8
0.2,3423,17,288173,84.16267523364486,15
0.2,3424,96,288269,84.16613138686131,6
0.2,3425,89,288358,84.16754232340922,12
0.2,3426,89,288447,84.16895243653342,12
0.2,3427,92,288539,84.17123687281213,9
0.2,3428,19,288558,84.1522309711286,13
0.2,3429,91,288649,84.15422740524781,12
0.2,3430,95,288744,84.1573885164675,7
0.2,3431,94,288838,84.16025641025641,7
0.2,3432,94,288932,84.16312263326536,7
0.2,3433,96,289028,84.16656959813628,6
0.2,3434,92,289120,84.1688500727802,9
0.2,3435,92,289212,84.17112922002329,10
0.2,3436,90,289302,84.17282513820192,11
0.2,3437,92,289394,84.17510180337405,10
0.2,3438,94,289488,84.17795870892701,7
0.2,3439,23,289511,84.16017441860465,10
0.2,3440,91,289602,84.16216216216216,10
0.2,3441,94,289696,84.16502033701336,7
0.2,3442,96,289792,84.16845774034273,7
0.2,3443,92,289884,84.17073170731707,9
0.2,3444,90,289974,84.17242380261249,11
0.2,3445,92,290066,84.17469529889728,10
0.2,3446,91,290157,84.17667536988685,11
0.2,3447,93,290250,84.1792343387471,8
0.2,3448,93,290343,84.18179182371702,8
0.2,3449,94,290437,84.18463768115942,7
0.2,3450,85,290522,84.18487394957984,16
0.2,3451,92,290614,84.18713789107764,9
0.2,3452,92,290706,84.18940052128583,9
0.2,3453,92,290798,84.19166184134338,9
0.2,3454,92,290890,84.19392185238785,9
0.2,3455,94,290984,84.19675925925925,8
0.2,3456,94,291078,84.1995950245878,8
0.2,3457,25,291103,84.18247541931753,8
0.2,3458,92,291195,84.18473547267996,9
0.2,3459,90,291285,84.1864161849711,11
0.2,3460,95,291380,84.1895405952037,6
0.2,3461,93,291473,84.19208549971115,9
0.2,3462,92,291565,84.19434016748484,9
0.2,3463,93,291658,84.19688221709006,8
0.2,3464,90,291748,84.198556998557,11
0.2,3465,94,291842,84.20138488170802,7
0.2,3466,88,291930,84.2024805307182,13
0.2,3467,90,292020,84.20415224913495,11
0.2,3468,93,292113,84.20668780628424,8
0.2,3469,93,292206,84.20922190201729,8
0.2,3470,93,292299,84.21175453759723,8
0.2,3471,25,292324,84.1947004608295,9
0.2,3472,93,292417,84.1972358191765,8
0.2,3473,91,292508,84.19919401266552,10
0.2,3474,91,292599,84.2011510791367,10
0.2,3475,85,292684,84.20138089758343,16
0.2,3476,96,292780,84.20477423065861,6
0.2,3477,96,292876,84.20816561242093,6
0.2,3478,95,292971,84.21126760563381,6
0.2,3479,94,293065,84.21408045977012,7
0.2,3480,94,293159,84.21689169778799,7
0.2,3481,94,293253,84.21970132107984,7
0.2,3482,93,293346,84.22222222222223,8
0.2,3483,96,293442,84.22560275545351,6
0.2,3484,93,293535,84.22812051649929,8
0.2,3485,92,293627,84.23034997131383,9
0.2,3486,96,293723,84.233725265271,6
0.2,3487,89,293812,84.23509174311927,12
0.2,3488,94,293906,84.23789051304098,7
0.2,3489,96,294002,84.24126074498567,6
0.2,3490,91,294093,84.24319679175021,10
0.2,3491,92,294185,84.24541809851088,9
0.2,3492,85,294270,84.24563412539365,16
0.2,3493,91,294361,84.24756725815683,10
0.2,3494,85,294446,84.24778254649499,16
0.2,3495,95,294541,84.2508581235698,7
0.2,3496,93,294634,84.25336002287675,10
0.2,3497,89,294723,84.25471698113208,12
0.2,3498,95,294818,84.25778793941126,8
0.2,3499,90,294908,84.25942857142857,12
0.2,3500,93,295001,84.26192516423879,8
0.2,3501,88,295089,84.26299257567105,14
0.2,3502,91,295180,84.26491578646875,10
0.2,3503,91,295271,84.26683789954338,11
0.2,3504,95,295366,84.26990014265336,7
0.2,3505,96,295462,84.27324586423275,6
0.2,3506,93,295555,84.27573424579413,8
0.2,3507,84,295639,84.27565564424174,18
0.2,3508,91,295730,84.27757195782274,10
0.2,3509,94,295824,84.28034188034188,7
0.2,3510,93,295917,84.28282540586727,9
0.2,3511,92,296009,84.28502277904327,9
0.2,3512,92,296101,84.28721890122402,9
0.2,3513,94,296195,84.2899829254411,7
0.2,3514,88,296283,84.29103840682788,13
0.2,3515,95,296378,84.29408418657566,6
0.2,3516,94,296472,84.29684390105203,8
0.2,3517,95,296567,84.29988629903355,7
0.2,3518,23,296590,84.28246660983234,10
0.2,3519,94,296684,84.28522727272727,7
0.2,3520,88,296772,84.28628230616302,13
0.2,3521,92,296864,84.28847245883021,9
0.2,3522,22,296886,84.27079193868862,10
0.2,3523,94,296980,84.27355278093076,7
0.2,3524,89,297069,84.27489361702128,12
0.2,3525,90,297159,84.27651730005672,11
0.2,3526,93,297252,84.27899064360646,8
0.2,3527,96,297348,84.28231292517007,6
0.2,3528,93,297441,84.28478322470954,8
0.2,3529,92,297533,84.28696883852692,9
0.2,3530,90,297623,84.2885868026055,11
0.2,3531,89,297712,84.28992072480182,12
0.2,3532,96,297808,84.29323521086894,6
0.2,3533,93,297901,84.29569892473118,8
0.2,3534,95,297996,84.2987270155587,6
0.2,3535,89,298085,84.30005656108597,13
0.2,3536,90,298175,84.30166808029404,12
0.2,3537,91,298266,84.30356133408705,10
0.2,3538,93,298359,84.30601864933597,8
0.2,3539,91,298450,84.30790960451978,10
0.2,3540,91,298541,84.30979949166903,11
0.2,3541,93,298634,84.31225296442688,8
0.2,3542,94,298728,84.31498729889924,7
0.2,3543,92,298820,84.31715575620767,9
0.2,3544,94,298914,84.31988716502116,7
0.2,3545,94,299008,84.32261703327693,8
0.2,3546,88,299096,84.32365379193685,13
0.2,3547,88,299184,84.32468996617813,14
0.2,3548,93,299277,84.32713440405747,8
0.2,3549,92,299369,84.32929577464789,10
0.2,3550,84,299453,84.3292030413968,18
0.2,3551,93,299546,84.33164414414415,8
0.2,3552,95,299641,84.33464677737123,6
0.2,3553,89,299730,84.3359594822735,12
0.2,3554,94,299824,84.33867791842475,7
0.2,3555,89,299913,84.33998875140607,13
0.2,3556,96,300009,84.34326679786336,6
0.2,3557,92,300101,84.34541877459247,10
0.2,3558,93,300194,84.34785051980893,8
0.2,3559,91,300285,84.3497191011236,10
0.2,3560,93,300378,84.35214827295704,9
0.2,3561,88,300466,84.35317237507019,13
0.2,3562,84,300550,84.35307325287678,18
0.2,3563,91,300641,84.35493827160494,11
0.2,3564,93,300734,84.35736325385695,8
0.2,3565,93,300827,84.3597868760516,8
0.2,3566,90,300917,84.36136809643959,11
0.2,3567,93,301010,84.36378923766816,8
0.2,3568,88,301098,84.36480806948725,13
0.2,3569,95,301193,84.36778711484594,7
0.2,3570,20,301213,84.34976197143658,13
0.2,3571,91,301304,84.35162374020157,13
0.2,3572,89,301393,84.35292471312623,13
0.2,3573,91,301484,84.35478455512032,10
0.2,3574,94,301578,84.35748251748252,7
0.2,3575,91,301669,84.35934004474272,10
0.2,3576,88,301757,84.36035784176684,13
0.2,3577,88,301845,84.36137506987144,13
0.2,3578,92,301937,84.36350936015647,9
0.2,3579,94,302031,84.36620111731844,7
0.2,3580,96,302127,84.36944987433678,7
0.2,3581,90,302217,84.37102177554439,11
0.2,3582,93,302310,84.37343008651968,8
0.2,3583,91,302401,84.37527901785714,10
0.2,3584,89,302490,84.3765690376569,12
0.2,3585,90,302580,84.3781372002231,11
0.2,3586,94,302674,84.38081962642877,7
0.2,3587,94,302768,84.3835005574136,7
0.2,3588,94,302862,84.38617999442742,7
0.2,3589,91,302953,84.38802228412256,10
0.2,3590,94,303047,84.39069896964634,7
0.2,3591,90,303137,84.39226057906458,11
0.2,3592,93,303230,84.3946562760924,8
0.2,3593,93,303323,84.39705063995548,8
0.2,3594,90,303413,84.39860917941586,11
0.2,3595,95,303508,84.4015572858732,6
0.2,3596,95,303603,84.4045037531276,6
0.2,3597,92,303695,84.40661478599222,10
0.2,3598,95,303790,84.40955821061407,6
0.2,3599,22,303812,84.39222222222222,10
0.2,3600,91,303903,84.39405720633158,10
0.2,3601,88,303991,84.39505830094392,14
0.2,3602,94,304085,84.3977241187899,8
0.2,3603,93,304178,84.40011098779134,8
0.2,3604,93,304271,84.40249653259362,8
0.2,3605,92,304363,84.40460343871325,9
0.2,3606,96,304459,84.40781813141115,6
0.2,3607,92,304551,84.40992239467849,10
0.2,3608,94,304645,84.41257966195622,7
0.2,3609,96,304741,84.41578947368421,6
0.2,3610,90,304831,84.41733591802824,13
0.2,3611,93,304924,84.41971207087487,8
0.2,3612,89,305013,84.42097979518405,12
0.2,3613,90,305103,84.42252351964582,11
0.2,3614,94,305197,84.42517289073305,7
0.2,3615,94,305291,84.42782079646018,8
0.2,3616,90,305381,84.4293613491844,11
0.2,3617,94,305475,84.43200663349917,7
0.2,3618,88,305563,84.43299253937552,13
0.2,3619,90,305653,84.43453038674033,11
0.2,3620,91,305744,84.4363435515051,10
0.2,3621,93,305837,84.43870789618995,8
0.2,3622,92,305929,84.44079492133591,9
0.2,3623,95,306024,84.44370860927152,7
0.2,3624,92,306116,84.44579310344828,10
0.2,3625,91,306207,84.44760066188637,10
0.2,3626,93,306300,84.44995864350703,8
0.2,3627,95,306395,84.45286659316427,6
0.2,3628,27,306422,84.43703499586663,6
0.2,3629,95,306517,84.43994490358126,7
0.2,3630,93,306610,84.44230239603415,8
0.2,3631,94,306704,84.44493392070484,7
0.2,3632,94,306798,84.44756399669694,9
0.2,3633,90,306888,84.44909190974133,13
0.2,3634,91,306979,84.45089408528199,10
0.2,3635,91,307070,84.45269526952696,11
0.2,3636,23,307093,84.43579873522134,9
0.2,3637,94,307187,84.43842770753162,7
0.2,3638,87,307274,84.43913162956856,14
0.2,3639,94,307368,84.44175824175824,8
0.2,3640,94,307462,84.44438341115078,7
0.2,3641,93,307555,84.44673256452499,9
0.2,3642,27,307582,84.43096349162778,6
0.2,3643,88,307670,84.43194291986828,14
0.2,3644,26,307696,84.4159122085048,6
0.2,3645,92,307788,84.41799232035108,9
0.2,3646,88,307876,84.4189744995887,13
0.2,3647,96,307972,84.42214912280701,6
0.2,3648,93,308065,84.42449986297616,8
0.2,3649,89,308154,84.42575342465753,12
0.2,3650,96,308250,84.42892358258011,6
0.2,3651,87,308337,84.42962760131435,14
0.2,3652,90,308427,84.43115247741582,11
0.2,3653,91,308518,84.43295019157088,10
0.2,3654,94,308612,84.43556771545828,7
0.2,3655,94,308706,84.43818380743983,7
0.2,3656,94,308800,84.44079846869019,7
0.2,3657,88,308888,84.4417714598141,13
0.2,3658,94,308982,84.44438371139655,7
0.2,3659,94,309076,84.44699453551912,8
0.2,3660,92,309168,84.44905763452608,9
0.2,3661,95,309263,84.45193883123976,6
0.2,3662,91,309354,84.45372645372646,10
0.2,3663,93,309447,84.45605895196506,9
0.2,3664,94,309541,84.45866302864938,7
0.2,3665,94,309635,84.46126568466994,7
0.2,3666,95,309730,84.46413962367058,7
0.2,3667,96,309826,84.46728462377317,6
0.2,3668,95,309921,84.47015535568275,7
0.2,3669,96,310017,84.47329700272479,6
0.2,3670,93,310110,84.47561972214655,8
0.2,3671,90,310200,84.47712418300654,11
0.2,3672,87,310287,84.47781105363462,14
0.2,3673,94,310381,84.48040283070223,8
0.2,3674,92,310473,84.48244897959184,9
0.2,3675,93,310566,84.4847660500544,9
0.2,3676,92,310658,84.48680989937449,9
0.2,3677,93,310751,84.48912452419793,9
0.2,3678,91,310842,84.49089426474586,12
0.2,3679,91,310933,84.49266304347826,10
0.2,3680,91,311024,84.49443086117903,10
0.2,3681,23,311047,84.47772949483976,10
0.2,3682,95,311142,84.48058647841434,7
0.2,3683,91,311233,84.48235613463626,11
0.2,3684,96,311329,84.48548168249661,6
0.2,3685,89,311418,84.48670645686381,12
0.2,3686,92,311510,84.48874423650665,11
0.2,3687,27,311537,84.47315618221258,6
0.2,3688,92,311629,84.47519653022499,9
0.2,3689,24,311653,84.45880758807589,9
0.2,3690,90,311743,84.4603088593877,11
0.2,3691,91,311834,84.46208017334777,11
0.2,3692,90,311924,84.46357974546439,11
0.2,3693,91,312015,84.46534921494315,11
0.2,3694,26,312041,84.44952638700947,7
0.2,3695,96,312137,84.45265151515152,6
0.2,3696,94,312231,84.45523397349201,7
0.2,3697,90,312321,84.45673336938886,11
0.2,3698,91,312412,84.45850229791836,10
0.2,3699,95,312507,84.46135135135135,6
0.2,3700,94,312601,84.46392866792759,7
0.2,3701,94,312695,84.46650459211237,9
0.2,3702,90,312785,84.46799891979477,11
0.2,3703,91,312876,84.46976241900649,11
0.2,3704,94,312970,84.472334682861,8
0.2,3705,95,313065,84.47517539125742,6
0.2,3706,91,313156,84.47693552738063,10
0.2,3707,94,313250,84.47950377562029,8
0.2,3708,91,313341,84.48126179563225,10
0.2,3709,92,313433,84.4832884097035,9
0.2,3710,92,313525,84.48531393155484,9
0.2,3711,-44,313481,84.45070043103448,8
0.2,3712,24,313505,84.43441960678696,9
0.2,3713,88,313593,84.43537964458804,13
0.2,3714,88,313681,84.43633916554509,13
0.2,3715,91,313772,84.43810548977395,10
0.2,3716,90,313862,84.43960182943233,11
0.2,3717,96,313958,84.44271113501883,6
0.2,3718,26,313984,84.42699650443667,8
0.2,3719,93,314077,84.42930107526881,8
0.2,3720,90,314167,84.43079817253427,11
0.2,3721,92,314259,84.43283181085438,9
0.2,3722,88,314347,84.4337899543379,14
0.2,3723,95,314442,84.43662728249194,6
0.2,3724,-53,314389,84.39973154362416,17
0.2,3725,90,314479,84.40123456790124,11
0.2,3726,91,314570,84.403005097934,10
0.2,3727,92,314662,84.40504291845494,11
0.2,3728,89,314751,84.40627514078841,13
0.2,3729,94,314845,84.4088471849866,7
0.2,3730,92,314937,84.4108818011257,9
0.2,3731,93,315030,84.41318327974277,8
0.2,3732,96,315126,84.41628716849719,6
0.2,3733,91,315217,84.41805034815212,11
0.2,3734,94,315311,84.42061579651941,7
0.2,3735,91,315402,84.42237687366168,10
0.2,3736,94,315496,84.42493979127643,7
0.2,3737,94,315590,84.42750133761369,7
0.2,3738,94,315684,84.43006151377374,8
0.2,3739,94,315778,84.43262032085562,7
0.2,3740,92,315870,84.4346431435445,9
0.2,3741,92,315962,84.43666488508819,10
0.2,3742,95,316057,84.4394870424793,6
0.2,3743,94,316151,84.4420405982906,7
0.2,3744,91,316242,84.4437917222964,10
0.2,3745,92,316334,84.44580886278698,9
0.2,3746,87,316421,84.44649052575393,14
0.2,3747,90,316511,84.44797225186767,11
0.2,3748,90,316601,84.44945318751667,11
0.2,3749,95,316696,84.45226666666667,6
0.2,3750,92,316788,84.45427885897094,9
0.2,3751,92,316880,84.45628997867804,10
0.2,3752,27,316907,84.44098054889422,6
0.2,3753,88,316995,84.44192860948321,13
0.2,3754,18,317013,84.42423435419441,16
0.2,3755,91,317104,84.42598509052183,10
0.2,3756,96,317200,84.42906574394463,6
0.2,3757,96,317296,84.43214475784993,6
0.2,3758,92,317388,84.4341580207502,10
0.2,3759,92,317480,84.43617021276596,9
0.2,3760,86,317566,84.43658601435789,15
0.2,3761,94,317660,84.43912812333865,8
0.2,3762,89,317749,84.44034015413234,12
0.2,3763,94,317843,84.44287991498406,7
0.2,3764,94,317937,84.44541832669323,8
0.2,3765,92,318029,84.447424322889,9
0.2,3766,92,318121,84.44942925404831,9
0.2,3767,92,318213,84.45143312101911,9
0.2,3768,94,318307,84.4539665693818,7
0.2,3769,93,318400,84.45623342175067,8
0.2,3770,93,318493,84.45849907186422,8
0.2,3771,94,318587,84.46102863202545,7
0.2,3772,27,318614,84.44579909886032,6
0.2,3773,86,318700,84.44621091679915,15
0.2,3774,94,318794,84.4487417218543,7
0.2,3775,85,318879,84.4488877118644,16
0.2,3776,92,318971,84.45088694731268,12
0.2,3777,92,319063,84.45288512440445,9
0.2,3778,93,319156,84.4551468642498,8
0.2,3779,91,319247,84.45687830687831,10
0.2,3780,91,319338,84.45860883364189,10
0.2,3781,94,319432,84.46113167636172,8
0.2,3782,92,319524,84.46312450436162,10
0.2,3783,94,319618,84.46564482029598,7
0.2,3784,96,319714,84.46869220607662,6
0.2,3785,90,319804,84.4701531959852,11
0.2,3786,95,319899,84.47293372062319,6
0.2,3787,93,319992,84.47518479408659,8
0.2,3788,91,320083,84.47690683557667,10
0.2,3789,95,320178,84.4796833773087,6
0.2,3790,95,320273,84.48245845423371,6
0.2,3791,24,320297,84.46650843881856,8
0.2,3792,92,320389,84.46849459530715,11
0.2,3793,24,320413,84.45255666842382,9
0.2,3794,94,320507,84.45507246376812,7
0.2,3795,23,320530,84.43888303477344,10
0.2,3796,94,320624,84.44140110613642,8
0.2,3797,93,320717,84.44365455502896,8
0.2,3798,87,320804,84.44432745459332,14
0.2,3799,93,320897,84.44657894736842,9
0.2,3800,90,320987,84.44803998947646,11
0.2,3801,94,321081,84.45055234087323,7
0.2,3802,90,321171,84.45201156981331,11
0.2,3803,94,321265,84.45452155625657,7
0.2,3804,90,321355,84.45597897503285,11
0.2,3805,96,321451,84.45901208617971,6
0.2,3806,90,321541,84.46046755975834,11
0.2,3807,93,321634,84.46271008403362,9
0.2,3808,18,321652,84.44526122341821,14
0.2,3809,89,321741,84.44645669291339,12
0.2,3810,88,321829,84.44738913670953,14
0.2,3811,92,321921,84.44937040923399,9
0.2,3812,92,322013,84.45135064253869,9
0.2,3813,91,322104,84.45306764551651,10
0.2,3814,95,322199,84.45583224115335,6
0.2,3815,95,322294,84.45859538784067,6
0.2,3816,95,322389,84.46135708671731,6
0.2,3817,94,322483,84.46385542168674,7
0.2,3818,82,322565,84.46321026446714,19
0.2,3819,89,322654,84.46439790575916,12
0.2,3820,94,322748,84.46689348338131,7
0.2,3821,85,322833,84.46703296703296,16
0.2,3822,91,322924,84.46874182579127,10
0.2,3823,94,323018,84.47123430962343,7
0.2,3824,91,323109,84.47294117647058,11
0.2,3825,93,323202,84.47516989022478,9
0.2,3826,91,323293,84.4768748366867,10
0.2,3827,94,323387,84.47936259143155,7
0.2,3828,94,323481,84.4818490467485,7
0.2,3829,94,323575,84.48433420365535,7
0.2,3830,92,323667,84.48629600626468,9
0.2,3831,86,323753,84.48669102296451,15
0.2,3832,91,323844,84.48839029480824,10
0.2,3833,95,323939,84.49113197704747,8
0.2,3834,93,324032,84.49335071707954,8
0.2,3835,95,324127,84.4960896767466,8
0.2,3836,92,324219,84.49804534792807,10
0.2,3837,95,324314,84.50078165711308,6
0.2,3838,92,324406,84.50273508726231,10
0.2,3839,92,324498,84.5046875,9
0.2,3840,89,324587,84.50585784951835,12
0.2,3841,88,324675,84.50676730869338,14
0.2,3842,91,324766,84.50845693468645,10
0.2,3843,93,324859,84.51066597294485,8
0.2,3844,94,324953,84.51313394018206,8
0.2,3845,96,325049,84.51612064482579,6
0.2,3846,86,325135,84.51650636859891,15
0.2,3847,85,325220,84.51663201663202,16
0.2,3848,23,325243,84.50064951935568,10
0.2,3849,92,325335,84.5025974025974,10
0.2,3850,93,325428,84.50480394702674,9
0.2,3851,89,325517,84.50597092419522,12
0.2,3852,94,325611,84.50843498572542,8
0.2,3853,84,325695,84.50830306175402,17
0.2,3854,93,325788,84.51050583657587,8
0.2,3855,89,325877,84.51167012448133,12
0.2,3856,96,325973,84.51464869069225,6
0.2,3857,96,326069,84.51762571280456,6
0.2,3858,93,326162,84.51982378854626,8
0.2,3859,89,326251,84.52098445595855,12
0.2,3860,-53,326198,84.48536648536648,17
0.2,3861,94,326292,84.48783013982393,8
0.2,3862,94,326386,84.4902925187678,9
0.2,3863,92,326478,84.49223602484471,9
0.2,3864,93,326571,84.49443725743855,8
0.2,3865,92,326663,84.49637868598035,9
0.2,3866,96,326759,84.49935350400827,6
0.2,3867,89,326848,84.5005170630817,12
0.2,3868,94,326942,84.50297234427501,7
0.2,3869,92,327034,84.50490956072352,9
0.2,3870,95,327129,84.50762076982691,7
0.2,3871,89,327218,84.50878099173553,12
0.2,3872,92,327310,84.51071520784922,9
0.2,3873,27,327337,84.49586990191017,6
0.2,3874,90,327427,84.49729032258064,11
0.2,3875,91,327518,84.49896800825593,10
0.2,3876,95,327613,84.50167655403662,6
0.2,3877,86,327699,84.50206291903042,16
0.2,3878,94,327793,84.50451147202887,8
0.2,3879,91,327884,84.5061855670103,12
0.2,3880,90,327974,84.50760113372841,12
0.2,3881,94,328068,84.51004636785163,7
0.2,3882,94,328162,84.51249034251867,7
0.2,3883,94,328256,84.51493305870237,8
0.2,3884,91,328347,84.51660231660232,11
0.2,3885,93,328440,84.51878538342768,10
0.2,3886,94,328534,84.52122459480319,7
0.2,3887,96,328630,84.52417695473251,6
0.2,3888,94,328724,84.52661352532785,7
0.2,3889,18,328742,84.50951156812339,14
0.2,3890,94,328836,84.51195065535852,7
0.2,3891,92,328928,84.51387461459404,9
0.2,3892,96,329024,84.51682507063961,6
0.2,3893,13,329037,84.4984591679507,19
0.2,3894,86,329123,84.49884467265726,15
0.2,3895,94,329217,84.50128336755647,7
0.2,3896,96,329313,84.50423402617398,6
0.2,3897,95,329408,84.50692662904054,6
0.2,3898,96,329504,84.50987432675045,6
0.2,3899,89,329593,84.51102564102564,13
0.2,3900,89,329682,84.5121763650346,14
0.2,3901,91,329773,84.5138390568939,10
0.2,3902,87,329860,84.51447604406866,14
0.2,3903,93,329953,84.51664959016394,8
0.2,3904,92,330045,84.51856594110116,9
0.2,3905,94,330139,84.52099334357399,7
0.2,3906,92,330231,84.52290760174047,9
0.2,3907,24,330255,84.50742067553736,9
0.2,3908,90,330345,84.5088257866462,11
0.2,3909,95,330440,84.51150895140665,7
0.2,3910,89,330529,84.51265660956277,12
0.2,3911,94,330623,84.515081799591,8
0.2,3912,89,330712,84.51622795808842,12
0.2,3913,21,330733,84.5,11
0.2,3914,93,330826,84.5021711366539,8
0.2,3915,89,330915,84.50331971399387,12
0.2,3916,93,331008,84.50548889456216,9
0.2,3917,89,331097,84.5066360387953,12
0.2,3918,96,331193,84.50956876754275,6
0.2,3919,89,331282,84.51071428571429,12
0.2,3920,92,331374,84.51262433052793,9
0.2,3921,88,331462,84.51351351351352,13
0.2,3922,94,331556,84.515931684935,7
0.2,3923,90,331646,84.51732925586137,11
0.2,3924,92,331738,84.5192356687898,9
0.2,3925,95,331833,84.5219052470708,6
0.2,3926,91,331924,84.52355487649605,10
0.2,3927,95,332019,84.52622199592668,7
0.2,3928,25,332044,84.5110715194706,8
0.2,3929,94,332138,84.51348600508906,7
0.2,3930,95,332233,84.51615365047061,7
0.2,3931,93,332326,84.51831129196337,8
0.2,3932,95,332421,84.5209763539283,6
0.2,3933,96,332517,84.52389425521098,6
0.2,3934,94,332611,84.52630241423125,7
0.2,3935,94,332705,84.5287093495935,8
0.2,3936,92,332797,84.53060706121413,9
0.2,3937,19,332816,84.51396648044692,13
0.2,3938,91,332907,84.51561309977151,10
0.2,3939,96,333003,84.51852791878173,6
0.2,3940,95,333098,84.52118751585891,6
0.2,3941,25,333123,84.50608828006088,8
0.2,3942,94,333217,84.508496068983,7
0.2,3943,26,333243,84.49366125760649,6
0.2,3944,93,333336,84.4958174904943,8
0.2,3945,23,333359,84.48023314749113,10
0.2,3946,96,333455,84.483151760831,6
0.2,3947,94,333549,84.48556231003039,7
0.2,3948,94,333643,84.48797163838947,8
0.2,3949,94,333737,84.49037974683544,7
0.2,3950,95,333832,84.4930397367755,6
0.2,3951,94,333926,84.49544534412955,7
0.2,3952,94,334020,84.49784973437895,7
0.2,3953,96,334116,84.50075872534143,6
0.2,3954,93,334209,84.50290771175727,8
0.2,3955,91,334300,84.50455005055612,10
0.2,3956,94,334394,84.50694970937579,7
0.2,3957,90,334484,84.50833754421424,11
0.2,3958,18,334502,84.4915382672392,16
0.2,3959,94,334596,84.4939393939394,7
0.2,3960,95,334691,84.49659176975511,6
0.2,3961,93,334784,84.4987380111055,8
0.2,3962,91,334875,84.5003785011355,11
0.2,3963,93,334968,84.50252270433906,8
0.2,3964,91,335059,84.50416141235813,11
0.2,3965,91,335150,84.50579929399899,10
0.2,3966,88,335238,84.50668011091506,13
0.2,3967,95,335333,84.50932459677419,6
0.2,3968,96,335429,84.51221970269589,6
0.2,3969,94,335523,84.51460957178841,7
0.2,3970,95,335618,84.51725006295644,6
0.2,3971,94,335712,84.51963746223565,7
0.2,3972,94,335806,84.522023659703,8
0.2,3973,91,335897,84.52365374937091,11
0.2,3974,89,335986,84.52477987421383,12
0.2,3975,92,336078,84.52665995975855,9
0.2,3976,94,336172,84.52904199145084,7
0.2,3977,93,336265,84.53117144293616,8
0.2,3978,91,336356,84.53279718522242,10
0.2,3979,94,336450,84.53517587939699,7
0.2,3980,26,336476,84.52047224315498,8
0.2,3981,27,336503,84.50602712204922,6
0.2,3982,91,336594,84.5076575445644,10
0.2,3983,93,336687,84.50978915662651,8
0.2,3984,93,336780,84.51191969887077,8
0.2,3985,92,336872,84.5137982940291,9
0.2,3986,92,336964,84.51567594682719,9
0.2,3987,90,337054,84.51705115346039,11
0.2,3988,96,337150,84.51992980696916,6
0.2,3989,94,337244,84.52230576441103,8
0.2,3990,96,337340,84.52518165873215,6
0.2,3991,89,337429,84.52630260521042,12
0.2,3992,88,337517,84.52717255196595,14
0.2,3993,94,337611,84.52954431647471,8
0.2,3994,25,337636,84.51464330413016,8
0.2,3995,96,337732,84.51751751751752,6
0.2,3996,90,337822,84.51888916687516,11
0.2,3997,95,337917,84.52151075537769,7
0.2,3998,94,338011,84.52388097024256,8
0.2,3999,93,338104,84.526,9
0.2,4000,23,338127,84.5106223444139,10
0.2,4001,90,338217,84.5119940029985,11
0.2,4002,91,338308,84.51361478890831,10
0.2,4003,91,338399,84.51523476523477,12
0.2,4004,96,338495,84.51810237203496,6
0.2,4005,26,338521,84.50349475786321,7
0.2,4006,93,338614,84.50561517344647,8
0.2,4007,95,338709,84.50823353293413,6
0.2,4008,94,338803,84.51060114741831,7
0.2,4009,92,338895,84.51246882793018,9
0.2,4010,95,338990,84.51508352031912,7
0.2,4011,93,339083,84.51719840478565,8
0.2,4012,94,339177,84.51956142536756,7
0.2,4013,94,339271,84.52192326856004,7
0.2,4014,91,339362,84.52353673723536,11
0.2,4015,96,339458,84.52639442231076,6
0.2,4016,94,339552,84.52875280059746,8
0.2,4017,94,339646,84.5311100049776,7
0.2,4018,91,339737,84.53271958198557,11
0.2,4019,95,339832,84.53532338308457,6
0.2,4020,25,339857,84.52051728425765,7
0.2,4021,92,339949,84.52237692690204,9
0.2,4022,94,340043,84.52473278647776,8
0.2,4023,94,340137,84.5270874751491,7
0.2,4024,90,340227,84.52844720496894,11
0.2,4025,22,340249,84.51291604570294,10
0.2,4026,92,340341,84.5147752669481,10
0.2,4027,15,340356,84.49751737835155,17
0.2,4028,93,340449,84.49962769918093,8
0.2,4029,86,340535,84.5,15
0.2,4030,89,340624,84.50111634830067,12
0.2,4031,25,340649,84.48635912698413,7
0.2,4032,94,340743,84.48871807587403,7
0.2,4033,95,340838,84.4913237481408,6
0.2,4034,92,340930,84.49318463444858,9
0.2,4035,91,341021,84.49479682854312,11
0.2,4036,93,341114,84.49690364131781,8
0.2,4037,96,341210,84.49975235264982,6
0.2,4038,95,341305,84.5023520673434,7
0.2,4039,89,341394,84.50346534653465,12
0.2,4040,92,341486,84.50532046523138,9
0.2,4041,88,341574,84.50618505690252,15
0.2,4042,88,341662,84.50704922087559,13
0.2,4043,92,341754,84.50890207715133,9
0.2,4044,81,341835,84.5080346106304,20
0.2,4045,91,341926,84.50963914977756,10
0.2,4046,91,342017,84.51124289597233,10
0.2,4047,91,342108,84.51284584980237,11
0.2,4048,91,342199,84.51444801185478,10
0.2,4049,92,342291,84.51629629629629,9
0.2,4050,92,342383,84.51814366823007,9
0.2,4051,95,342478,84.52073050345508,7
0.2,4052,95,342573,84.52331606217616,7
0.2,4053,93,342666,84.52540700542674,9
0.2,4054,90,342756,84.52675709001232,11
0.2,4055,24,342780,84.51183431952663,8
0.2,4056,86,342866,84.51220113384274,15
0.2,4057,90,342956,84.51355347461804,11
0.2,4058,91,343047,84.51515151515152,10
0.2,4059,94,343141,84.51748768472906,7
0.2,4060,95,343236,84.52006894853484,6
0.2,4061,92,343328,84.52191038897095,9
0.2,4062,90,343418,84.52325867585527,11
0.2,4063,92,343510,84.52509842519684,9
0.2,4064,91,343601,84.52669126691266,10
0.2,4065,91,343692,84.52828332513526,11
0.2,4066,93,343785,84.53036636341284,8
0.2,4067,95,343880,84.53294001966569,8
0.2,4068,90,343970,84.53428360776604,11
0.2,4069,96,344066,84.53710073710074,6
0.2,4070,94,344160,84.53942520265291,7
0.2,4071,88,344248,84.54027504911592,14
0.2,4072,94,344342,84.54259759391113,7
0.2,4073,87,344429,84.54320078546883,14
0.2,4074,93,344522,84.54527607361963,8
0.2,4075,86,344608,84.54563297350343,17
0.2,4076,95,344703,84.54819720382635,6
0.2,4077,94,344797,84.5505149583129,7
0.2,4078,93,344890,84.55258641823977,8
0.2,4079,92,344982,84.55441176470588,9
0.2,4080,94,345076,84.55672629257535,8
0.2,4081,94,345170,84.55903968642822,7
0.2,4082,24,345194,84.5442076904237,10
0.2,4083,90,345284,84.54554358472086,11
0.2,4084,93,345377,84.54761321909425,8
0.2,4085,93,345470,84.54968184043074,8
0.2,4086,92,345562,84.55150477122584,9
0.2,4087,92,345654,84.55332681017613,10
0.2,4088,89,345743,84.55441428222059,12
0.2,4089,88,345831,84.55525672371638,13
0.2,4090,90,345921,84.55658763138597,11
0.2,4091,96,346017,84.55938416422288,6
0.2,4092,-52,345965,84.52602003420473,16
0.2,4093,95,346060,84.5285784074255,6
0.2,4094,90,346150,84.52991452991454,12
0.2,4095,90,346240,84.53125,12
0.2,4096,94,346334,84.53356114229925,7
0.2,4097,91,346425,84.53513909224012,10
0.2,4098,89,346514,84.53622834837765,12
0.2,4099,93,346607,84.53829268292682,8
0.2,4100,93,346700,84.54035601072908,9
0.2,4101,95,346795,84.54290589956119,7
0.2,4102,91,346886,84.54447964903729,10
0.2,4103,93,346979,84.54653996101365,8
0.2,4104,95,347074,84.54908647990256,8
0.2,4105,94,347168,84.55138821237213,7
0.2,4106,94,347262,84.55368882395909,8
0.2,4107,93,347355,84.55574488802337,8
0.2,4108,96,347451,84.55853005597469,6
0.2,4109,96,347547,84.56131386861314,6
0.2,4110,94,347641,84.56360982729262,8
0.2,4111,90,347731,84.56493190661479,11
0.2,4112,92,347823,84.56673960612692,9
0.2,4113,94,347917,84.56903257170637,8
0.2,4114,92,348009,84.57083839611178,9
0.2,4115,93,348102,84.57288629737609,8
0.2,4116,91,348193,84.57444741316493,10
0.2,4117,96,348289,84.57722195240407,6
0.2,4118,94,348383,84.57950958970623,7
0.2,4119,89,348472,84.58058252427185,12
0.2,4120,92,348564,84.58238291676777,9
0.2,4121,94,348658,84.58466763706939,7
0.2,4122,94,348752,84.58695124909046,8
0.2,4123,89,348841,84.58802133850631,12
0.2,4124,25,348866,84.57357575757575,8
0.2,4125,27,348893,84.55962190984003,6
0.2,4126,93,348986,84.56166707051126,8
0.2,4127,96,349082,84.56443798449612,6
0.2,4128,91,349173,84.56599660934852,10
0.2,4129,87,349260,84.56658595641646,15
0.2,4130,86,349346,84.56693294601791,16
0.2,4131,88,349434,84.5677637947725,13
0.2,4132,88,349522,84.56859424147109,13
0.2,4133,90,349612,84.56990807934204,12
0.2,4134,91,349703,84.57146311970979,10
0.2,4135,94,349797,84.57374274661508,7
0.2,4136,94,349891,84.57602127145275,7
0.2,4137,88,349979,84.576848719188,13
0.2,4138,90,350069,84.57815897559797,11
0.2,4139,96,350165,84.58091787439614,6
0.2,4140,92,350257,84.58270949046124,9
0.2,4141,91,350348,84.58425881216803,11
0.2,4142,93,350441,84.58629012792662,8
0.2,4143,93,350534,84.58832046332046,10
0.2,4144,91,350625,84.58986731001207,11
0.2,4145,91,350716,84.59141341051615,10
0.2,4146,94,350810,84.59368217988907,7
0.2,4147,95,350905,84.59619093539055,8
0.2,4148,90,350995,84.59749337189685,11
0.2,4149,93,351088,84.59951807228916,9
0.2,4150,24,351112,84.58491929655504,8
0.2,4151,94,351206,84.58718689788054,7
0.2,4152,91,351297,84.588731037804,10
0.2,4153,90,351387,84.59003370245547,11
0.2,4154,91,351478,84.59157641395909,10
0.2,4155,93,351571,84.59359961501444,8
0.2,4156,91,351662,84.59514072648544,10
0.2,4157,88,351750,84.5959595959596,13
0.2,4158,92,351842,84.59773984130801,9
0.2,4159,96,351938,84.60048076923077,6
0.2,4160,91,352029,84.60201874549387,10
0.2,4161,92,352121,84.60379625180202,9
0.2,4162,94,352215,84.6060533269277,7
0.2,4163,94,352309,84.6083093179635,7
0.2,4164,90,352399,84.60960384153661,11
0.2,4165,90,352489,84.61089774363899,11
0.2,4166,94,352583,84.61315094792417,7
0.2,4167,88,352671,84.61396353166987,13
0.2,4168,84,352755,84.61381626289278,17
0.2,4169,92,352847,84.61558752997603,9
0.2,4170,88,352935,84.6163989450971,13
0.2,4171,-47,352888,84.58485139022052,11
0.2,4172,94,352982,84.5871075964534,7
0.2,4173,94,353076,84.58936272160997,7
0.2,4174,92,353168,84.5911377245509,9
0.2,4175,94,353262,84.5933908045977,8
0.2,4176,92,353354,84.59516399329662,9
0.2,4177,92,353446,84.59693633317377,9
0.2,4178,93,353539,84.59894711653506,8
0.2,4179,94,353633,84.6011961722488,7
0.2,4180,83,353716,84.60081320258311,18
0.2,4181,93,353809,84.60282161645146,8
0.2,4182,-119,353690,84.55414774085584,13
0.2,4183,95,353785,84.55664435946463,6
0.2,4184,95,353880,84.55913978494624,7
0.2,4185,95,353975,84.56163401815576,6
0.2,4186,92,354067,84.56341055648436,9
0.2,4187,90,354157,84.56470869149952,12
0.2,4188,89,354246,84.56576748627357,12
0.2,4189,92,354338,84.56754176610978,9
0.2,4190,92,354430,84.56931519923646,9
0.2,4191,20,354450,84.55391221374046,12
0.2,4192,92,354542,84.55568805151442,9
0.2,4193,94,354636,84.55793991416309,7
0.2,4194,90,354726,84.55923718712754,11
0.2,4195,88,354814,84.56005719733079,13
0.2,4196,91,354905,84.56159161305695,11
0.2,4197,89,354994,84.56264888041925,15
0.2,4198,94,355088,84.56489640390569,7
0.2,4199,87,355175,84.56547619047619,18
0.2,4200,93,355268,84.56748393239705,8
0.2,4201,94,355362,84.56972870061875,8
0.2,4202,93,355455,84.57173447537473,9
0.2,4203,92,355547,84.57350142721218,9
0.2,4204,88,355635,84.5743162901308,13
0.2,4205,94,355729,84.57655729909654,8
0.2,4206,86,355815,84.57689565010696,16
0.2,4207,94,355909,84.5791349809886,7
0.2,4208,95,356004,84.5816108339273,6
0.2,4209,94,356098,84.58384798099762,7
0.2,4210,90,356188,84.5851341724056,11
0.2,4211,95,356283,84.58760683760684,6
0.2,4212,92,356375,84.58936624732969,9
0.2,4213,88,356463,84.59017560512576,13
0.2,4214,90,356553,84.5914590747331,12
0.2,4215,95,356648,84.59392789373814,6
0.2,4216,85,356733,84.59402418781124,16
0.2,4217,81,356814,84.5931721194879,21
0.2,4218,91,356905,84.59469068499645,10
0.2,4219,94,356999,84.59691943127962,10
0.2,4220,93,357092,84.5989102108505,8
0.2,4221,96,357188,84.6016106110848,7
0.2,4222,89,357277,84.60265214302629,12
0.2,4223,96,357373,84.60535037878788,7
0.2,4224,94,357467,84.60757396449704,7
0.2,4225,92,357559,84.60932323710364,9
0.2,4226,86,357645,84.6096522356281,15
0.2,4227,89,357734,84.61069063386944,12
0.2,4228,92,357826,84.61243792858832,9
0.2,4229,22,357848,84.59763593380615,10
0.2,4230,91,357939,84.59914913731978,10
0.2,4231,89,358028,84.60018903591683,14
0.2,4232,92,358120,84.60193716040634,9
0.2,4233,94,358214,84.60415682569673,8
0.2,4234,89,358303,84.6051948051948,13
0.2,4235,96,358399,84.60788479697828,6
0.2,4236,90,358489,84.60915742270474,11
0.2,4237,92,358581,84.61090136857008,9
0.2,4238,92,358673,84.61264449162539,9
0.2,4239,21,358694,84.59764150943396,12
0.2,4240,27,358721,84.5840603631219,6
0.2,4241,93,358814,84.58604431871758,8
0.2,4242,94,358908,84.58826302144709,7
0.2,4243,96,359004,84.59095193213949,6
0.2,4244,93,359097,84.5929328621908,9
0.2,4245,88,359185,84.59373528026377,13
0.2,4246,94,359279,84.59595008241111,7
0.2,4247,94,359373,84.5981638418079,7
0.2,4248,95,359468,84.6006119086844,6
0.2,4249,90,359558,84.60188235294117,11
0.2,4250,96,359654,84.60456363208657,6
0.2,4251,93,359747,84.60653809971778,8
0.2,4252,95,359842,84.60898189513284,8
0.2,4253,27,359869,84.59543958627174,6
0.2,4254,19,359888,84.58002350176264,13
0.2,4255,94,359982,84.58223684210526,7
0.2,4256,-44,359938,84.55203194738078,8
0.2,4257,93,360031,84.55401596993894,8
0.2,4258,96,360127,84.55670345151444,6
0.2,4259,96,360223,84.5593896713615,6
0.2,4260,22,360245,84.54470781506689,10
0.2,4261,92,360337,84.54645706241202,9
0.2,4262,93,360430,84.54844006568145,8
0.2,4263,91,360521,84.5499530956848,10
0.2,4264,93,360614,84.55193434935522,8
0.2,4265,91,360705,84.5534458509142,10
0.2,4266,95,360800,84.55589407077572,6
0.2,4267,91,360891,84.55740393626992,10
0.2,4268,94,360985,84.55961583509018,7
0.2,4269,95,361080,84.56206088992974,7
0.2,4270,90,361170,84.56333411379069,11
0.2,4271,26,361196,84.54962546816479,7
0.2,4272,92,361288,84.55136906154927,9
0.2,4273,88,361376,84.55217594759009,13
0.2,4274,93,361469,84.55415204678363,8
0.2,4275,27,361496,84.54069223573433,6
0.2,4276,94,361590,84.54290390460604,7
0.2,4277,92,361682,84.54464703132305,9
0.2,4278,95,361777,84.54709044169198,6
0.2,4279,94,361871,84.54929906542056,7
0.2,4280,94,361965,84.55150665732306,7
0.2,4281,-49,361916,84.52031760859411,12
0.2,4282,90,362006,84.52159701144058,11
0.2,4283,84,362090,84.52147525676938,18
0.2,4284,93,362183,84.52345390898483,8
0.2,4285,87,362270,84.52403173121792,15
0.2,4286,91,362361,84.52554233729882,10
0.2,4287,91,362452,84.52705223880596,12
0.2,4288,93,362545,84.5290277453952,8
0.2,4289,89,362634,84.53006993006993,12
0.2,4290,96,362730,84.53274295036123,6
0.2,4291,94,362824,84.5349487418453,7
0.2,4292,92,362916,84.53668763102725,9
0.2,4293,-49,362867,84.5055891942245,13
0.2,4294,27,362894,84.49220023282886,6
0.2,4295,90,362984,84.49348230912477,11
0.2,4296,27,363011,84.48010239702118,7
0.2,4297,92,363103,84.4818520241973,10
0.2,4298,96,363199,84.48453128634566,7
0.2,4299,91,363290,84.4860465116279,10
0.2,4300,94,363384,84.48825854452453,7
0.2,4301,94,363478,84.49046954904695,9
0.2,4302,91,363569,84.49198233790379,10
0.2,4303,94,363663,84.49419144981412,7
0.2,4304,96,363759,84.49686411149825,6
0.2,4305,95,363854,84.49930329772411,8
0.2,4306,95,363949,84.5017413512886,6
0.2,4307,94,364043,84.50394614670381,7
0.2,4308,95,364138,84.50638199118124,7
0.2,4309,92,364230,84.50812064965197,9
0.2,4310,91,364321,84.5096265367664,10
0.2,4311,89,364410,84.51066790352505,13
0.2,4312,19,364429,84.4954787850684,13
0.2,4313,90,364519,84.49675475197033,11
0.2,4314,94,364613,84.4989571263036,7
0.2,4315,93,364706,84.50092678405932,8
0.2,4316,95,364801,84.5033588139912,6
0.2,4317,85,364886,84.50347383047708,16
0.2,4318,27,364913,84.49015975920352,6
0.2,4319,92,365005,84.49189814814815,10
0.2,4320,87,365092,84.4924785929183,14
0.2,4321,92,365184,84.49421564090699,10
0.2,4322,95,365279,84.49664584779089,6
0.2,4323,95,365374,84.4990749306198,6
0.2,4324,93,365467,84.50104046242775,8
0.2,4325,96,365563,84.50369856680537,6
0.2,4326,93,365656,84.50566212156228,8
0.2,4327,96,365752,84.5083179297597,6
0.2,4328,94,365846,84.51051051051051,7
0.2,4329,96,365942,84.51316397228638,6
0.2,4330,94,366036,84.51535442161163,8
0.2,4331,89,366125,84.51638965835642,12
0.2,4332,24,366149,84.50242326332796,9
0.2,4333,92,366241,84.5041532071989,9
0.2,4334,90,366331,84.50542099192619,11
0.2,4335,91,366422,84.50691881918819,10
0.2,4336,94,366516,84.50910767811851,7
0.2,4337,90,366606,84.5103734439834,11
0.2,4338,92,366698,84.51209956211109,9
0.2,4339,89,366787,84.513133640553,12
0.2,4340,90,366877,84.51439760423865,12
0.2,4341,93,366970,84.51635191156149,8
0.2,4342,92,367062,84.51807506332028,9
0.2,4343,92,367154,84.51979742173113,9
0.2,4344,25,367179,84.50609896432681,8
0.2,4345,92,367271,84.50782328578003,9
0.2,4346,93,367364,84.50977685760294,8
0.2,4347,96,367460,84.51241950321987,6
0.2,4348,91,367551,84.51391124396413,10
0.2,4349,94,367645,84.51609195402298,7
0.2,4350,93,367738,84.5180418294645,8
0.2,4351,93,367831,84.51999080882354,8
0.2,4352,96,367927,84.52262807259362,6
0.2,4353,93,368020,84.52457510335324,10
0.2,4354,92,368112,84.52629161882894,9
0.2,4355,92,368204,84.52800734618917,9
0.2,4356,95,368299,84.53041083314207,6
0.2,4357,95,368394,84.53281321707205,8
0.2,4358,94,368488,84.53498508832301,7
0.2,4359,89,368577,84.53600917431193,12
0.2,4360,19,368596,84.52098142627838,15
0.2,4361,94,368690,84.52315451627693,8
0.2,4362,91,368781,84.5246390098556,10
0.2,4363,91,368872,84.52612282309808,10
0.2,4364,89,368961,84.52714776632303,12
0.2,4365,19,368980,84.51213925790196,13
0.2,4366,95,369075,84.51454087474238,7
0.2,4367,91,369166,84.51602564102564,11
0.2,4368,93,369259,84.51796749828335,9
0.2,4369,95,369354,84.52036613272311,6
0.2,4370,85,369439,84.52047586364677,16
0.2,4371,94,369533,84.52264409881062,7
0.2,4372,25,369558,84.50903270066316,8
0.2,4373,26,369584,84.49565614997714,7
0.2,4374,88,369672,84.49645714285714,13
0.2,4375,81,369753,84.49565813528336,20
0.2,4376,89,369842,84.49668722869545,12
0.2,4377,94,369936,84.4988579259936,7
0.2,4378,87,370023,84.49942909340032,15
0.2,4379,95,370118,84.50182648401827,6
0.2,4380,91,370209,84.50330974663319,10
0.2,4381,92,370301,84.50502053856687,9
0.2,4382,90,370391,84.50627424138717,11
0.2,4383,93,370484,84.50821167883211,8
0.2,4384,95,370579,84.51060433295325,6
0.2,4385,94,370673,84.51276789785682,7
0.2,4386,92,370765,84.51447458399818,10
0.2,4387,19,370784,84.49954421148587,14
0.2,4388,92,370876,84.50125313283208,9
0.2,4389,93,370969,84.50318906605922,8
0.2,4390,85,371054,84.50330220906399,17
0.2,4391,26,371080,84.48998178506375,7
0.2,4392,92,371172,84.49169132711131,9
0.2,4393,92,371264,84.49340009103322,10
0.2,4394,95,371359,84.49579067121729,7
0.2,4395,94,371453,84.49795268425842,8
0.2,4396,92,371545,84.49965885831249,10
0.2,4397,94,371639,84.5018190086403,7
0.2,4398,95,371734,84.50420550125028,6
0.2,4399,89,371823,84.50522727272727,13
0.2,4400,88,371911,84.50602135878209,13
0.2,4401,95,372006,84.50840527033166,6
0.2,4402,18,372024,84.4933000227118,15
0.2,4403,92,372116,84.49500454132607,9
0.2,4404,94,372210,84.49716231555051,7
0.2,4405,96,372306,84.49977303676805,6
0.2,4406,91,372397,84.50124801452235,11
0.2,4407,94,372491,84.50340290381125,7
0.2,4408,22,372513,84.48922658199137,10
0.2,4409,26,372539,84.47596371882086,7
0.2,4410,95,372634,84.47834958059397,6
0.2,4411,94,372728,84.48050770625566,8
0.2,4412,93,372821,84.48243825062316,8
0.2,4413,96,372917,84.48504757589488,6
0.2,4414,96,373013,84.4876557191393,6
0.2,4415,91,373104,84.48913043478261,10
0.2,4416,22,373126,84.47498302014942,10
0.2,4417,94,373220,84.47713897691263,7
0.2,4418,96,373316,84.47974654899298,6
0.2,4419,91,373407,84.48122171945701,10
0.2,4420,90,373497,84.4824700294051,12
0.2,4421,95,373592,84.48484848484848,6
0.2,4422,94,373686,84.4869997739091,7
0.2,4423,89,373775,84.4880198915009,12
0.2,4424,93,373868,84.48994350282486,10
0.2,4425,93,373961,84.49186624491641,9
0.2,4426,94,374055,84.4940140049695,7
0.2,4427,93,374148,84.4959349593496,9
0.2,4428,95,374243,84.49830661548883,6
0.2,4429,85,374328,84.49841986455982,18
0.2,4430,90,374418,84.4996614759648,11
0.2,4431,88,374506,84.50045126353791,14
0.2,4432,93,374599,84.5023685991428,8
0.2,4433,95,374694,84.50473612990528,6
0.2,4434,92,374786,84.50642615558061,9
0.2,4435,92,374878,84.50811541929666,9
0.2,4436,95,374973,84.5104800540906,6
0.2,4437,93,375066,84.51239296980621,10
0.2,4438,92,375158,84.51407974769093,9
0.2,4439,94,375252,84.51621621621622,8
0.2,4440,95,375347,84.51857689709524,6
0.2,4441,92,375439,84.520261143629,10
0.2,4442,94,375533,84.52239477830295,7
0.2,4443,91,375624,84.52385238523853,10
0.2,4444,89,375713,84.52485939257593,13
0.2,4445,92,375805,84.52654071075123,9
0.2,4446,93,375898,84.5284461434675,10
0.2,4447,94,375992,84.53057553956835,8
0.2,4448,95,376087,84.53292874803327,6
0.2,4449,94,376181,84.53505617977528,7
0.2,4450,90,376271,84.53628398112784,12
0.2,4451,94,376365,84.53840970350404,7
0.2,4452,93,376458,84.54030990343588,9
0.2,4453,94,376552,84.54243376740008,7
0.2,4454,95,376647,84.54478114478114,6
0.2,4455,93,376740,84.54667863554758,8
0.2,4456,92,376832,84.54835090868298,9
0.2,4457,95,376927,84.55069537909377,6
0.2,4458,87,377014,84.55124467369366,15
0.2,4459,94,377108,84.55336322869955,7
0.2,4460,95,377203,84.55570499887918,6
0.2,4461,92,377295,84.55737337516808,9
0.2,4462,93,377388,84.55926506833968,8
0.2,4463,95,377483,84.56160394265233,6
0.2,4464,95,377578,84.56394176931691,6
0.2,4465,91,377669,84.5653828929691,10
0.2,4466,94,377763,84.56749496306246,8
0.2,4467,92,377855,84.56915846016115,9
0.2,4468,94,377949,84.57126874021034,9
0.2,4469,94,378043,84.57337807606264,7
0.2,4470,91,378134,84.57481547752181,13
0.2,4471,95,378229,84.57714669051879,7
0.2,4472,91,378320,84.57858260675162,11
0.2,4473,94,378414,84.58068842199374,7
0.2,4474,95,378509,84.58301675977654,6
0.2,4475,94,378603,84.58512064343164,7
0.2,4476,86,378689,84.58543667634576,15
0.2,4477,95,378784,84.58776239392586,6
0.2,4478,78,378862,84.58629158294262,24
0.2,4479,90,378952,84.5875,11
0.2,4480,91,379043,84.58893104217809,10
0.2,4481,93,379136,84.59080767514503,8
0.2,4482,93,379229,84.59268347089002,8
0.2,4483,27,379256,84.57983942908118,6
0.2,4484,27,379283,84.5670011148272,6
0.2,4485,94,379377,84.56910387873384,7
0.2,4486,90,379467,84.57031424114108,11
0.2,4487,95,379562,84.57263814616756,7
0.2,4488,96,379658,84.57518378257964,6
0.2,4489,95,379753,84.57750556792872,6
0.2,4490,92,379845,84.57915831663327,9
0.2,4491,93,379938,84.58103294746215,8
0.2,4492,95,380033,84.58335188070332,7
0.2,4493,96,380129,84.58589230084557,7
0.2,4494,93,380222,84.58776418242492,8
0.2,4495,92,380314,84.5894128113879,9
0.2,4496,93,380407,84.5912830776073,9
0.2,4497,84,380491,84.59115162294353,17
0.2,4498,95,380586,84.59346521449211,8
0.2,4499,91,380677,84.59488888888889,12
0.2,4500,87,380764,84.59542323928017,14
0.2,4501,91,380855,84.59684584629053,10
0.2,4502,93,380948,84.59871196979792,8
0.2,4503,93,381041,84.60057726465364,8
0.2,4504,94,381135,84.60266370699223,7
0.2,4505,93,381228,84.60452729693742,8
0.2,4506,94,381322,84.60661193698691,7
0.2,4507,25,381347,84.59338952972493,8
0.2,4508,94,381441,84.59547571523619,7
0.2,4509,94,381535,84.59756097560975,7
0.2,4510,92,381627,84.59920195078696,9
0.2,4511,95,381722,84.60150709219859,6
0.2,4512,91,381813,84.6029248836694,11
0.2,4513,96,381909,84.60544971200709,6
0.2,4514,94,382003,84.60753045404208,7
0.2,4515,94,382097,84.60961027457927,7
0.2,4516,85,382182,84.60969670135046,17
0.2,4517,96,382278,84.61221779548472,6
0.2,4518,93,382371,84.61407391015712,8
0.2,4519,95,382466,84.61637168141593,7
0.2,4520,-44,382422,84.58792302587923,8
0.2,4521,93,382515,84.58978328173374,9
0.2,4522,90,382605,84.59097943842582,12
0.2,4523,82,382687,84.59040671971707,20
0.2,4524,93,382780,84.59226519337017,8
0.2,4525,95,382875,84.59456473707468,6
0.2,4526,90,382965,84.59575878064943,11
0.2,4527,92,383057,84.59739399293287,9
0.2,4528,87,383144,84.59792448664165,15
0.2,4529,93,383237,84.59977924944812,8
0.2,4530,94,383331,84.60185389538734,7
0.2,4531,96,383427,84.60436893203884,6
0.2,4532,91,383518,84.6057798367527,11
0.2,4533,87,383605,84.60630789589766,15
0.2,4534,94,383699,84.60837927232635,7
0.2,4535,94,383793,84.61044973544973,7
0.2,4536,95,383888,84.61273969583425,6
0.2,4537,94,383982,84.61480828558837,7
0.2,4538,88,384070,84.61555408680326,13
0.2,4539,95,384165,84.61784140969164,6
0.2,4540,93,384258,84.61968729354767,8
0.2,4541,90,384348,84.62087186261559,11
0.2,4542,95,384443,84.62315650451244,6
0.2,4543,93,384536,84.625,8
0.2,4544,88,384624,84.62574257425743,14
0.2,4545,96,384720,84.62824461064672,6
0.2,4546,89,384809,84.62920606993622,12
0.2,4547,96,384905,84.63170624450308,6
0.2,4548,95,385000,84.63398549131678,6
0.2,4549,94,385094,84.63604395604396,7
0.2,4550,95,385189,84.63832124807735,6
0.2,4551,92,385281,84.63993848857645,9
0.2,4552,-51,385230,84.6101471557215,17
0.2,4553,93,385323,84.61198945981555,8
0.2,4554,94,385417,84.61405049396268,8
0.2,4555,93,385510,84.61589113257243,8
0.2,4556,91,385601,84.61729207812157,11
0.2,4557,87,385688,84.61781483106626,14
0.2,4558,96,385784,84.62031147181399,6
0.2,4559,85,385869,84.6203947368421,16
0.2,4560,95,385964,84.62267046700285,6
0.2,4561,88,386052,84.62341078474353,13
0.2,4562,93,386145,84.62524654832347,8
0.2,4563,21,386166,84.61130587204207,14
0.2,4564,93,386259,84.613143483023,8
0.2,4565,92,386351,84.61476127901884,9
0.2,4566,92,386443,84.61637836654259,9
0.2,4567,94,386537,84.61843257443083,7
0.2,4568,94,386631,84.62048588312541,7
0.2,4569,89,386720,84.62144420131291,12
0.2,4570,94,386814,84.62349595274557,7
0.2,4571,92,386906,84.62510936132983,9
0.2,4572,19,386925,84.61075880166193,13
0.2,4573,91,387016,84.61215566243987,10
0.2,4574,92,387108,84.61377049180328,9
0.2,4575,95,387203,84.61604020979021,7
0.2,4576,86,387289,84.6163425824776,15
0.2,4577,90,387379,84.61751856705985,12
0.2,4578,93,387472,84.61934920288273,8
0.2,4579,90,387562,84.62052401746725,11
0.2,4580,93,387655,84.6223531979917,8
0.2,4581,94,387749,84.62439982540376,7
0.2,4582,95,387844,84.62666375736417,9
0.2,4583,95,387939,84.62892670157068,6
0.2,4584,95,388034,84.63118865866957,6
0.2,4585,95,388129,84.63344962930658,6
0.2,4586,91,388220,84.63483758447788,12
0.2,4587,92,388312,84.63644289450741,9
0.2,4588,96,388408,84.63891915449989,6
0.2,4589,94,388502,84.6409586056645,7
0.2,4590,92,388594,84.64256153343499,9
0.2,4591,94,388688,84.64459930313589,8
0.2,4592,95,388783,84.64685390812106,7
0.2,4593,96,388879,84.64932520679147,6
0.2,4594,27,388906,84.63677910772579,6
0.2,4595,94,389000,84.63881636205396,7
0.2,4596,94,389094,84.64085273004133,7
0.2,4597,24,389118,84.62766420182687,8
0.2,4598,94,389212,84.62970210915417,8
0.2,4599,27,389239,84.61717391304347,7
0.2,4600,93,389332,84.61899587046294,8
0.2,4601,96,389428,84.62146892655367,6
0.2,4602,92,389520,84.62307190962416,10
0.2,4603,90,389610,84.62423979148566,11
0.2,4604,91,389701,84.6256243213898,10
0.2,4605,92,389793,84.6272253582284,9
0.2,4606,93,389886,84.62904276101584,8
0.2,4607,93,389979,84.630859375,10
0.2,4608,90,390069,84.63202430028205,11
0.2,4609,92,390161,84.63362255965293,10
0.2,4610,95,390256,84.63587074387334,6
0.2,4611,85,390341,84.63594969644406,16
0.2,4612,91,390432,84.63732928679818,10
0.2,4613,94,390526,84.63935847420893,7
0.2,4614,27,390553,84.62686890574214,7
0.2,4615,94,390647,84.62889948006932,8
0.2,4616,95,390742,84.6311457656487,6
0.2,4617,91,390833,84.63252490255522,10
0.2,4618,96,390929,84.63498592768998,6
0.2,4619,92,391021,84.63658008658008,9
0.2,4620,91,391112,84.63795715213158,10
0.2,4621,91,391203,84.63933362180875,10
0.2,4622,91,391294,84.64070949599827,10
0.2,4623,94,391388,84.64273356401384,8
0.2,4624,92,391480,84.64432432432433,9
0.2,4625,96,391576,84.64677907479464,6
0.2,4626,89,391665,84.64771990490598,12
0.2,4627,88,391753,84.64844425237683,13
0.2,4628,88,391841,84.64916828688702,14
0.2,4629,93,391934,84.65097192224621,8
0.2,4630,95,392029,84.65320665083135,6
0.2,4631,91,392120,84.6545768566494,10
0.2,4632,95,392215,84.65680984243471,6
0.2,4633,94,392309,84.65882606819163,7
0.2,4634,89,392398,84.65976267529666,13
0.2,4635,93,392491,84.66156169111302,8
0.2,4636,96,392587,84.6640069010136,6
0.2,4637,89,392676,84.66494178525227,12
0.2,4638,95,392771,84.66716964863117,6
0.2,4639,93,392864,84.66896551724138,8
0.2,4640,93,392957,84.67076061193708,8
0.2,4641,93,393050,84.67255493321844,8
0.2,4642,94,393144,84.67456385957355,8
0.2,4643,96,393240,84.67700258397933,6
0.2,4644,95,393335,84.67922497308935,7
0.2,4645,95,393430,84.68144640551012,6
0.2,4646,89,393519,84.68237572627501,12
0.2,4647,95,393614,84.68459552495698,6
0.2,4648,95,393709,84.68681436868144,6
0.2,4649,87,393796,84.68731182795699,14
0.2,4650,88,393884,84.68802408084282,14
0.2,4651,95,393979,84.6902407566638,6
0.2,4652,16,393995,84.67547818611648,16
0.2,4653,96,394091,84.67791147400087,6
0.2,4654,96,394187,84.68034371643394,6
0.2,4655,89,394276,84.68127147766323,12
0.2,4656,96,394372,84.68370195404766,6
0.2,4657,94,394466,84.6857020180335,7
0.2,4658,92,394558,84.6872719467697,9
0.2,4659,85,394643,84.687339055794,16
0.2,4660,94,394737,84.68933705213473,7
0.2,4661,20,394757,84.67546117546118,15
0.2,4662,93,394850,84.67724640789191,8
0.2,4663,96,394946,84.67967409948542,6
0.2,4664,94,395040,84.68167202572347,8
0.2,4665,94,395134,84.68366909558509,10
0.2,4666,91,395225,84.68502249839297,11
0.2,4667,94,395319,84.6870179948586,7
0.2,4668,27,395346,84.67466266866566,6
0.2,4669,94,395440,84.67665952890792,7
0.2,4670,91,395531,84.678013273389,10
0.2,4671,92,395623,84.67958047945206,9
0.2,4672,91,395714,84.68093301947357,11
0.2,4673,91,395805,84.68228498074454,10
0.2,4674,92,395897,84.68385026737968,9
0.2,4675,94,395991,84.68584260051325,7
0.2,4676,89,396080,84.68676502031217,12
0.2,4677,85,396165,84.68683197947841,17
0.2,4678,96,396261,84.68924983970933,6
0.2,4679,95,396356,84.69145299145299,6
0.2,4680,93,396449,84.69322794274727,8
0.2,4681,94,396543,84.69521571977788,7
0.2,4682,96,396639,84.69762972453556,6
0.2,4683,91,396730,84.69897523484201,10
0.2,4684,94,396824,84.70096051227321,7
0.2,4685,85,396909,84.70102432778489,16
0.2,4686,92,397001,84.70258160870493,9
0.2,4687,93,397094,84.70435153583618,8
0.2,4688,87,397181,84.70484111750906,14
0.2,4689,91,397272,84.70618336886993,11
0.2,4690,96,397368,84.70859091878064,6
0.2,4691,90,397458,84.70971867007673,11
0.2,4692,96,397554,84.7121244406563,6
0.2,4693,82,397636,84.71154665530464,19
0.2,4694,95,397731,84.71373801916933,6
0.2,4695,94,397825,84.71571550255537,9
0.2,4696,90,397915,84.71684053651266,11
0.2,4697,24,397939,84.7039165602384,9
0.2,4698,92,398031,84.70546924877634,9
0.2,4699,92,398123,84.70702127659574,9
0.2,4700,96,398219,84.70942352690916,6
0.2,4701,94,398313,84.71139940450873,9
0.2,4702,11,398324,84.69572613225601,21
0.2,4703,94,398418,84.69770408163265,7
0.2,4704,94,398512,84.69968119022316,7
0.2,4705,94,398606,84.70165745856353,8
0.2,4706,94,398700,84.70363288718929,8
0.2,4707,-48,398652,84.67544604927782,12
0.2,4708,93,398745,84.67721384582714,9
0.2,4709,95,398840,84.67940552016985,8
0.2,4710,92,398932,84.68095945659095,9
0.2,4711,91,399023,84.68230050933786,10
0.2,4712,91,399114,84.6836409929981,10
0.2,4713,94,399208,84.68561731014,7
0.2,4714,-51,399157,84.65683987274656,16
0.2,4715,86,399243,84.65712468193384,15
0.2,4716,95,399338,84.65931736273055,6
0.2,4717,94,399432,84.66129715981349,8
0.2,4718,16,399448,84.64674719220174,16
0.2,4719,96,399544,84.64915254237287,6
0.2,4720,86,399630,84.64943867824613,15
0.2,4721,95,399725,84.65163066497247,6
0.2,4722,95,399820,84.65382172348083,6
0.2,4723,92,399912,84.65537679932261,9
0.2,4724,92,400004,84.65693121693121,9
0.2,4725,94,400098,84.65890816758358,7
0.2,4726,94,400192,84.66088428178548,7
0.2,4727,23,400215,84.6478426395939,9
0.2,4728,95,400310,84.65003171917954,6
0.2,4729,92,400402,84.65158562367864,9
0.2,4730,92,400494,84.65313887127458,9
0.2,4731,89,400583,84.65405748098055,12
0.2,4732,94,400677,84.65603211493767,8
0.2,4733,93,400770,84.65779467680608,8
0.2,4734,89,400859,84.65871172122492,12
0.2,4735,89,400948,84.65962837837837,12
0.2,4736,94,401042,84.66160016888325,8
0.2,4737,18,401060,84.64753060363023,15
0.2,4738,27,401087,84.63536611099389,6
0.2,4739,96,401183,84.63776371308018,6
0.2,4740,95,401278,84.6399493777684,6
0.2,4741,93,401371,84.641712357655,8
0.2,4742,90,401461,84.64284208306978,11
0.2,4743,88,401549,84.64354974704891,13
0.2,4744,94,401643,84.64552160168599,7
0.2,4745,90,401733,84.64664981036663,11
0.2,4746,95,401828,84.64883084053086,7
0.2,4747,87,401915,84.64932603201348,14
0.2,4748,95,402010,84.65150558012213,6
0.2,4749,92,402102,84.65305263157894,10
0.2,4750,95,402197,84.65523047779415,7
0.2,4751,92,402289,84.6567760942761,9
0.2,4752,94,402383,84.65874184725436,7
0.2,4753,94,402477,84.66070677324359,7
0.2,4754,95,402572,84.66288117770767,6
0.2,4755,93,402665,84.66463414634147,8
0.2,4756,89,402754,84.66554551187723,13
0.2,4757,92,402846,84.66708701134931,10
0.2,4758,90,402936,84.66820760664005,11
0.2,4759,95,403031,84.67037815126051,6
0.2,4760,86,403117,84.67065742491073,15
0.2,4761,90,403207,84.67177656446871,12
0.2,4762,94,403301,84.67373504094058,7
0.2,4763,27,403328,84.66162888329136,6
0.2,4764,94,403422,84.66358866736621,8
0.2,4765,91,403513,84.66491817037348,10
0.2,4766,94,403607,84.66687644220684,7
0.2,4767,91,403698,84.66820469798658,10
0.2,4768,93,403791,84.66995177185993,10
0.2,4769,85,403876,84.67002096436059,18
0.2,4770,94,403970,84.67197652483756,8
0.2,4771,91,404061,84.6733025984912,10
0.2,4772,89,404150,84.67420909281374,12
0.2,4773,86,404236,84.67448680351906,16
0.2,4774,96,404332,84.67685863874345,6
0.2,4775,94,404426,84.678810720268,7
0.2,4776,93,404519,84.6805526481055,8
0.2,4777,89,404608,84.68145667643365,12
0.2,4778,95,404703,84.68361581920904,6
0.2,4779,93,404796,84.68535564853556,9
0.2,4780,94,404890,84.68730391131562,7
0.2,4781,92,404982,84.6888331242158,10
0.2,4782,94,405076,84.69077984528539,7
0.2,4783,91,405167,84.69209866220736,10
0.2,4784,94,405261,84.69404388714733,7
0.2,4785,94,405355,84.69598829920602,8
0.2,4786,93,405448,84.6977229997911,8
0.2,4787,96,405544,84.7000835421888,6
0.2,4788,27,405571,84.68803508039257,6
0.2,4789,25,405596,84.67557411273486,8
0.2,4790,92,405688,84.67710290127322,9
0.2,4791,95,405783,84.6792570951586,7
0.2,4792,93,405876,84.68099311495932,8
0.2,4793,91,405967,84.68231122236128,10
0.2,4794,88,406055,84.6830031282586,13
0.2,4795,93,406148,84.68473728106756,8
0.2,4796,90,406238,84.68584531999166,12
0.2,4797,83,406321,84.68549395581492,19
0.2,4798,96,406417,84.68785163575745,6
0.2,4799,90,406507,84.68895833333333,13
0.2,4800,93,406600,84.69068943970007,8
0.2,4801,93,406693,84.69241982507289,8
0.2,4802,94,406787,84.69435769310847,8
0.2,4803,87,406874,84.69483763530391,14
0.2,4804,88,406962,84.6955254942768,13
0.2,4805,89,407051,84.69642114024137,13
0.2,4806,93,407144,84.6981485333888,8
0.2,4807,94,407238,84.70008319467554,7
0.2,4808,94,407332,84.70201705136203,7
0.2,4809,95,407427,84.704158004158,6
0.2,4810,24,407451,84.69154022032842,9
0.2,4811,87,407538,84.69201995012469,14
0.2,4812,95,407633,84.69416164554332,6
0.2,4813,95,407728,84.69630245118405,7
0.2,4814,94,407822,84.69823468328141,8
0.2,4815,94,407916,84.70016611295681,7
0.2,4816,93,408009,84.70188914261989,8
0.2,4817,90,408099,84.70298879202988,12
0.2,4818,92,408191,84.70450300892301,9
0.2,4819,90,408281,84.70560165975104,13
0.2,4820,91,408372,84.70690728064717,11
0.2,4821,92,408464,84.7084197428453,9
0.2,4822,94,408558,84.71034625751606,7
0.2,4823,94,408652,84.712271973466,7
0.2,4824,93,408745,84.7139896373057,8
0.2,4825,92,408837,84.71549937836718,9
0.2,4826,90,408927,84.71659415786202,11
0.2,4827,93,409020,84.71830985915493,9
0.2,4828,88,409108,84.71898943880721,14
0.2,4829,95,409203,84.72111801242237,6
0.2,4830,92,409295,84.72262471537984,9
0.2,4831,94,409389,84.72454470198676,7
0.2,4832,93,409482,84.72625698324022,8
0.2,4833,96,409578,84.72858916011585,6
0.2,4834,93,409671,84.73029989658738,8
0.2,4835,93,409764,84.73200992555832,8
0.2,4836,95,409859,84.73413272689683,8
0.2,4837,92,409951,84.73563455973543,9
0.2,4838,92,410043,84.73713577185369,10
0.2,4839,93,410136,84.73884297520661,8
0.2,4840,88,410224,84.7395166287957,13
0.2,4841,91,410315,84.74080958281702,10
0.2,4842,85,410400,84.74086310138344,17
0.2,4843,91,410491,84.74215524360034,10
0.2,4844,88,410579,84.74282765737874,13
0.2,4845,90,410669,84.74391250515889,11
0.2,4846,96,410765,84.74623478440272,6
0.2,4847,93,410858,84.74793729372938,10
0.2,4848,91,410949,84.74922664466901,11
0.2,4849,93,411042,84.75092783505154,8
0.2,4850,93,411135,84.7526283240569,8
0.2,4851,92,411227,84.75412201154164,9
0.2,4852,93,411320,84.75582114156192,8
0.2,4853,95,411415,84.75793160280182,6
0.2,4854,20,411435,84.74459320288362,12
0.2,4855,92,411527,84.74608731466228,9
0.2,4856,91,411618,84.74737492279185,12
0.2,4857,93,411711,84.74907369287773,8
0.2,4858,90,411801,84.75015435274747,11
0.2,4859,93,411894,84.75185185185185,9
0.2,4860,23,411917,84.73914832339025,9
0.2,4861,95,412012,84.74125874125875,6
0.2,4862,90,412102,84.74234011926794,11
0.2,4863,95,412197,84.74444901315789,7
0.2,4864,91,412288,84.74573484069887,10
0.2,4865,88,412376,84.74640361693383,13
0.2,4866,89,412465,84.74727758372714,12
0.2,4867,27,412492,84.7354149548069,6
0.2,4868,89,412581,84.73629081947011,13
0.2,4869,-46,412535,84.7094455852156,10
0.2,4870,86,412621,84.70971053171833,16
0.2,4871,95,412716,84.71182266009852,6
0.2,4872,91,412807,84.71311307202956,10
0.2,4873,26,412833,84.70106688551498,7
0.2,4874,93,412926,84.70276923076923,8
0.2,4875,93,413019,84.70447087776866,9
0.2,4876,93,413112,84.70617182694279,8
0.2,4877,91,413203,84.70746207462075,10
0.2,4878,27,413230,84.69563435130149,6
0.2,4879,87,413317,84.69610655737705,15
0.2,4880,91,413408,84.69739807416514,10
0.2,4881,96,413504,84.69971323228185,6
0.2,4882,92,413596,84.70120827360229,9
0.2,4883,95,413691,84.70331695331696,6
0.2,4884,21,413712,84.69027635619243,12
0.2,4885,88,413800,84.690953745395,13
0.2,4886,89,413889,84.69183548189073,12
0.2,4887,96,413985,84.69414893617021,6
0.2,4888,95,414080,84.6962569032522,6
0.2,4889,92,414172,84.69775051124745,9
0.2,4890,94,414266,84.69965242281742,7
0.2,4891,95,414361,84.70175797219952,7
0.2,4892,21,414382,84.68873901491928,11
0.2,4893,89,414471,84.68961994278709,12
0.2,4894,21,414492,84.67660878447396,11
0.2,4895,96,414588,84.67892156862744,6
0.2,4896,94,414682,84.68082499489483,7
0.2,4897,92,414774,84.68231931400571,9
0.2,4898,93,414867,84.6840171463564,9
0.2,4899,93,414960,84.68571428571428,8
0.2,4900,91,415051,84.6870026525199,11
0.2,4901,96,415147,84.68931048551612,6
0.2,4902,90,415237,84.69039363654905,11
0.2,4903,88,415325,84.69106851549755,14
0.2,4904,92,415417,84.69255861365953,9
0.2,4905,91,415508,84.69384427231961,11
0.2,4906,93,415601,84.69553698797635,9
0.2,4907,88,415689,84.69621026894866,13
0.2,4908,85,415774,84.69627215318802,16
0.2,4909,95,415869,84.69837067209777,7
0.2,4910,90,415959,84.69945021380575,11
0.2,4911,95,416054,84.70154723127035,6
0.2,4912,93,416147,84.70323631182576,8
0.2,4913,92,416239,84.70472120472121,9
0.2,4914,89,416328,84.7055951169888,12
0.2,4915,96,416424,84.70789259560618,6
0.2,4916,88,416512,84.70856213138093,13
0.2,4917,94,416606,84.71045140300936,7
0.2,4918,93,416699,84.71213661313276,8
0.2,4919,94,416793,84.7140243902439,8
0.2,4920,95,416888,84.71611461085145,7
0.2,4921,95,416983,84.71820398212108,6
0.2,4922,95,417078,84.72029250457038,6
0.2,4923,94,417172,84.72217709179529,7
0.2,4924,88,417260,84.7228426395939,13
0.2,4925,86,417346,84.72310190824199,15
0.2,4926,89,417435,84.72396996143698,13
0.2,4927,94,417529,84.72585227272727,7
0.2,4928,95,417624,84.72793670115642,6
0.2,4929,94,417718,84.72981744421907,7
0.2,4930,93,417811,84.73149462583655,8
0.2,4931,94,417905,84.73337388483374,7
0.2,4932,94,417999,84.7352523819177,8
0.2,4933,85,418084,84.73530603972436,16
0.2,4934,91,418175,84.73657548125634,10
0.2,4935,91,418266,84.73784440842788,10
0.2,4936,91,418357,84.73911282155154,10
0.2,4937,90,418447,84.74017820980154,11
0.2,4938,93,418540,84.74185057703988,9
0.2,4939,94,418634,84.74372469635628,8
0.2,4940,89,418723,84.74458611617082,13
0.2,4941,95,418818,84.74666127074059,6
0.2,4942,90,418908,84.74772405421808,11
0.2,4943,92,419000,84.74919093851133,9
0.2,4944,91,419091,84.75045500505561,10
0.2,4945,94,419185,84.75232511120097,7
0.2,4946,90,419275,84.75338589043865,11
0.2,4947,90,419365,84.75444624090542,11
0.2,4948,24,419389,84.74217013538089,8
0.2,4949,91,419480,84.74343434343434,10
0.2,4950,93,419573,84.74510199959605,8
0.2,4951,92,419665,84.74656704361874,9
0.2,4952,93,419758,84.74823339390268,8
0.2,4953,91,419849,84.74949535728705,10
0.2,4954,94,419943,84.75136226034309,7
0.2,4955,94,420037,84.75322841000808,7
0.2,4956,92,420129,84.75469033689731,9
0.2,4957,23,420152,84.74223477208552,10
0.2,4958,93,420245,84.74389997983464,9
0.2,4959,89,420334,84.74475806451613,12
0.2,4960,95,420429,84.74682523684741,6
0.2,4961,95,420524,84.74889157597742,6
0.2,4962,94,420618,84.75075559137619,7
0.2,4963,87,420705,84.75120870265914,14
0.2,4964,94,420799,84.75307150050352,7
0.2,4965,96,420895,84.7553362867499,6
0.2,4966,93,420988,84.75699617475337,8
0.2,4967,93,421081,84.75865539452496,8
0.2,4968,86,421167,84.75890521231636,15
0.2,4969,95,421262,84.76096579476861,7
0.2,4970,90,421352,84.7620197143432,11
0.2,4971,85,421437,84.76206757843926,16
0.2,4972,93,421530,84.76372411019506,8
0.2,4973,95,421625,84.76578206674708,6
0.2,4974,92,421717,84.76723618090452,9
0.2,4975,86,421803,84.76748392282958,15
0.2,4976,95,421898,84.76953988346393,7
0.2,4977,89,421987,84.77038971474488,12
0.2,4978,92,422079,84.7718417352882,10
0.2,4979,94,422173,84.77369477911647,7
0.2,4980,94,422267,84.77554707889982,8
0.2,4981,87,422354,84.77599357687676,14
0.2,4982,91,422445,84.77724262492474,10
0.2,4983,94,422539,84.77909309791332,7
0.2,4984,89,422628,84.77993981945838,12
0.2,4985,93,422721,84.78158844765343,10
0.2,4986,27,422748,84.77000200521356,6
0.2,4987,95,422843,84.77205292702486,8
0.2,4988,96,422939,84.77430346762878,6
0.2,4989,94,423033,84.77615230460921,7
0.2,4990,92,423125,84.77759967942296,9
0.2,4991,95,423220,84.77964743589743,6
0.2,4992,94,423314,84.78149409172842,9
0.2,4993,95,423409,84.78354024829795,6
0.2,4994,94,423503,84.78538538538538,7
0.2,4995,94,423597,84.78722978382706,7
0.2,4996,94,423691,84.78907344406645,7
0.2,4997,91,423782,84.79031612645058,10
0.2,4998,93,423875,84.79195839167834,8
0.2,4999,93,423968,84.7936,8
0.2,5000,91,424059,84.79484103179364,11
0.2,5001,90,424149,84.79588164734106,11
0.2,5002,94,424243,84.79772136717969,7
0.2,5003,95,424338,84.79976019184652,7
0.2,5004,96,424434,84.801998001998,6
0.2,5005,91,424525,84.80323611666,10
0.2,5006,93,424618,84.80487317755143,8
0.2,5007,92,424710,84.80630990415335,10
0.2,5008,96,424806,84.80854461968457,6
0.2,5009,94,424900,84.81037924151697,7
0.2,5010,91,424991,84.81161444821393,10
0.2,5011,95,425086,84.81364724660814,6
0.2,5012,95,425181,84.81567923399162,6
0.2,5013,93,425274,84.81731152772238,8
0.2,5014,95,425369,84.81934197407777,7
0.2,5015,90,425459,84.82037480063796,11
0.2,5016,91,425550,84.82160653777157,10
0.2,5017,90,425640,84.82263850139498,11
0.2,5018,94,425734,84.82446702530385,7
0.2,5019,93,425827,84.82609561752989,8
0.2,5020,90,425917,84.82712607050388,11
0.2,5021,94,426011,84.8289526085225,7
0.2,5022,91,426102,84.83018116663348,10
0.2,5023,91,426193,84.83140923566879,10
0.2,5024,91,426284,84.8326368159204,10
0.2,5025,89,426373,84.83346597692001,12
0.2,5026,94,426467,84.83528943703999,8
0.2,5027,95,426562,84.83731105807477,9
0.2,5028,90,426652,84.83833764167827,11
0.2,5029,91,426743,84.83956262425447,11
0.2,5030,92,426835,84.84098588749751,9
0.2,5031,90,426925,84.84201112877584,11
0.2,5032,89,427014,84.84283727399165,13
0.2,5033,96,427110,84.8450536352801,6
0.2,5034,92,427202,84.84647467725918,9
0.2,5035,94,427296,84.8482922954726,7
0.2,5036,89,427385,84.8491165376216,12
0.2,5037,94,427479,84.85093290988488,8
0.2,5038,96,427575,84.85314546537012,6
0.2,5039,94,427669,84.85496031746031,7
0.2,5040,23,427692,84.84268994247174,12
0.2,5041,92,427784,84.84410948036493,9
0.2,5042,25,427809,84.83224271267103,8
0.2,5043,93,427902,84.83386201427439,8
0.2,5044,94,427996,84.83567888999009,7
0.2,5045,94,428090,84.83749504558065,7
0.2,5046,92,428182,84.83891420645928,10
0.2,5047,94,428276,84.84072900158479,7
0.2,5048,23,428299,84.82848088730442,11
0.2,5049,89,428388,84.82930693069306,12
0.2,5050,93,428481,84.8309245693922,8
0.2,5051,94,428575,84.83273950910531,7
0.2,5052,95,428670,84.83475163269345,6
0.2,5053,94,428764,84.83656509695291,7
0.2,5054,93,428857,84.8381800197824,10
0.2,5055,95,428952,84.84018987341773,6
0.2,5056,94,429046,84.84200118647419,7
0.2,5057,93,429139,84.84361407671017,8
0.2,5058,92,429231,84.84502866179086,9
0.2,5059,96,429327,84.84723320158103,6
0.2,5060,93,429420,84.84884410195613,8
0.2,5061,94,429514,84.85065191623865,7
0.2,5062,94,429608,84.85245901639344,7
0.2,5063,96,429704,84.85466034755135,6
0.2,5064,95,429799,84.85666337611056,8
0.2,5065,89,429888,84.85748124753258,12
0.2,5066,96,429984,84.85968028419182,6
0.2,5067,94,430078,84.86148382004735,7
0.2,5068,81,430159,84.86072203590452,20
0.2,5069,93,430252,84.86232741617357,8
0.2,5070,92,430344,84.86373496351804,11
0.2,5071,90,430434,84.8647476340694,11
0.2,5072,91,430525,84.86595702739996,10
0.2,5073,96,430621,84.86815135987386,6
0.2,5074,92,430713,84.86955665024631,9
0.2,5075,93,430806,84.87115839243499,10
0.2,5076,91,430897,84.87236557021863,10
0.2,5077,94,430991,84.8741630563214,7
0.2,5078,89,431080,84.87497538885607,12
0.2,5079,91,431171,84.87618110236221,10
0.2,5080,94,431265,84.87797677622515,7
0.2,5081,88,431353,84.87859110586383,13
0.2,5082,92,431445,84.87999213063152,9
0.2,5083,92,431537,84.88139260424862,10
0.2,5084,90,431627,84.88239921337266,12
0.2,5085,95,431722,84.88438851749902,7
0.2,5086,94,431816,84.88618045999607,7
0.2,5087,90,431906,84.8871855345912,11
0.2,5088,94,432000,84.88897622322656,8
0.2,5089,94,432094,84.89076620825148,7
0.2,5090,95,432189,84.89275191514437,6
0.2,5091,93,432282,84.89434406912804,8
0.2,5092,96,432378,84.89652464166502,6
0.2,5093,89,432467,84.8973301923832,13
0.2,5094,89,432556,84.89813542688911,12
0.2,5095,94,432650,84.89992150706436,7
0.2,5096,94,432744,84.90170688640377,7
0.2,5097,87,432831,84.90211847783445,15
0.2,5098,94,432925,84.90390272602471,7
0.2,5099,93,433018,84.90549019607843,10
0.2,5100,94,433112,84.90727308370907,7
0.2,5101,91,433203,84.90846726773815,10
0.2,5102,95,433298,84.91044483637076,7
0.2,5103,93,433391,84.91202978056427,9
0.2,5104,27,433418,84.90068560235063,6
0.2,5105,92,433510,84.90207598903251,9
0.2,5106,86,433596,84.90229097317408,15
0.2,5107,90,433686,84.90328895849647,11
0.2,5108,91,433777,84.90448228616168,10
0.2,5109,91,433868,84.90567514677103,10
0.2,5110,92,433960,84.90706319702602,9
0.2,5111,92,434052,84.90845070422536,10
0.2,5112,94,434146,84.91022882847643,7
0.2,5113,86,434232,84.91044192412984,15
0.2,5114,81,434313,84.90967741935484,20
0.2,5115,95,434408,84.91164972634871,7
0.2,5116,95,434503,84.91362126245848,6
0.2,5117,22,434525,84.90132864400157,11
0.2,5118,91,434616,84.90252002344208,12
0.2,5119,-47,434569,84.8767578125,10
0.2,5120,91,434660,84.8779535247022,10
0.2,5121,13,434673,84.86392034361577,20
0.2,5122,90,434763,84.8649228967402,12
0.2,5123,25,434788,84.85323965651834,8
0.2,5124,93,434881,84.85482926829269,8
0.2,5125,92,434973,84.85622317596567,9
0.2,5126,95,435068,84.85820167739419,6
0.2,5127,93,435161,84.85978939157566,8
0.2,5128,95,435256,84.86176642620394,6
0.2,5129,94,435350,84.8635477582846,7
0.2,5130,18,435368,84.85051646852466,15
0.2,5131,94,435462,84.8522992985191,7
0.2,5132,94,435556,84.85408143385933,7
0.2,5133,90,435646,84.85508375535645,11
0.2,5134,87,435733,84.85550146056475,15
0.2,5135,24,435757,84.84365264797508,9
0.2,5136,91,435848,84.84485108039712,10
0.2,5137,96,435944,84.84702218762165,6
0.2,5138,96,436040,84.84919244989298,6
0.2,5139,94,436134,84.85097276264591,8
0.2,5140,96,436230,84.85314141217663,6
0.2,5141,94,436324,84.85492026448853,7
0.2,5142,93,436417,84.85650398600039,8
0.2,5143,95,436512,84.85847589424573,7
0.2,5144,92,436604,84.85986394557823,13
0.2,5145,94,436698,84.86164010882239,7
0.2,5146,94,436792,84.86341558189237,9
0.2,5147,89,436881,84.86421911421911,13
0.2,5148,90,436971,84.86521654690232,11
0.2,5149,85,437056,84.8652427184466,16
0.2,5150,92,437148,84.86662783925452,9
0.2,5151,95,437243,84.8685947204969,8
0.2,5152,91,437334,84.86978459150009,11
0.2,5153,95,437429,84.87175009701203,6
0.2,5154,95,437524,84.87371483996121,6
0.2,5155,92,437616,84.87509697439876,9
0.2,5156,96,437712,84.87725421756835,6
0.2,5157,94,437806,84.87902287708414,7
0.2,5158,93,437899,84.88059701492537,10
0.2,5159,84,437983,84.88042635658914,17
0.2,5160,96,438079,84.88258089517535,6
0.2,5161,94,438173,84.88434715226656,7
0.2,5162,96,438269,84.88650009684292,6
0.2,5163,88,438357,84.88710302091403,13
0.2,5164,94,438451,84.88886737657309,7
0.2,5165,93,438544,84.89043747580332,8
0.2,5166,91,438635,84.8916198954906,10
0.2,5167,93,438728,84.89318885448917,9
0.2,5168,91,438819,84.89437028438769,10
0.2,5169,93,438912,84.89593810444875,8
0.2,5170,93,439005,84.89750531812028,8
0.2,5171,93,439098,84.89907192575406,8
0.2,5172,25,439123,84.88749275082158,8
0.2,5173,95,439218,84.8894472361809,6
0.2,5174,89,439307,84.89024154589372,12
0.2,5175,92,439399,84.89161514683153,9
0.2,5176,83,439482,84.89124975854742,18
0.2,5177,93,439575,84.8928157589803,8
0.2,5178,94,439669,84.89457424213168,7
0.2,5179,92,439761,84.89594594594594,9
0.2,5180,95,439856,84.89789615904266,7
0.2,5181,95,439951,84.89984561945195,7
0.2,5182,93,440044,84.90140845070422,8
0.2,5183,90,440134,84.90239197530865,12
0.2,5184,94,440228,84.90414657666345,7
0.2,5185,87,440315,84.90455071345932,15
0.2,5186,94,440409,84.9063042220937,8
0.2,5187,89,440498,84.90709329221279,13
0.2,5188,93,440591,84.90865291963769,8
0.2,5189,94,440685,84.91040462427746,7
0.2,5190,89,440774,84.9111924484685,12
0.2,5191,92,440866,84.91255778120185,9
0.2,5192,92,440958,84.91392258809937,10
0.2,5193,93,441051,84.91547939930689,8
0.2,5194,93,441144,84.91703561116458,8
0.2,5195,95,441239,84.91897613548883,6
0.2,5196,93,441332,84.92053107562054,8
0.2,5197,92,441424,84.921893035783,10
0.2,5198,88,441512,84.92248509328716,13
0.2,5199,16,441528,84.90923076923077,16
0.2,5200,90,441618,84.91020957508171,11
0.2,5201,92,441710,84.91157247212611,10
0.2,5202,89,441799,84.91235825485298,12
0.2,5203,-52,441747,84.88604919292851,15
0.2,5204,94,441841,84.88780019212295,7
0.2,5205,89,441930,84.88859008835958,12
0.2,5206,95,442025,84.8905319761859,6
0.2,5207,24,442049,84.87884024577573,11
0.2,5208,91,442140,84.88001535803417,10
0.2,5209,26,442166,84.86871401151632,7
0.2,5210,92,442258,84.87008251775092,10
0.2,5211,89,442347,84.87087490406753,13
0.2,5212,88,442435,84.8714751582582,13
0.2,5213,95,442530,84.87341772151899,6
0.2,5214,90,442620,84.87440076701822,11
0.2,5215,84,442704,84.87423312883436,17
0.2,5216,96,442800,84.87636572742956,6
0.2,5217,88,442888,84.87696435415869,13
0.2,5218,94,442982,84.87871239701091,7
0.2,5219,88,443070,84.87931034482759,14
0.2,5220,94,443164,84.88105726872247,7
0.2,5221,92,443256,84.88242052853313,9
0.2,5222,25,443281,84.87095538962282,7
0.2,5223,23,443304,84.85911179173047,12
0.2,5224,95,443399,84.86105263157894,6
0.2,5225,96,443495,84.863184079602,7
0.2,5226,90,443585,84.86416682609527,11
0.2,5227,90,443675,84.86514919663351,11
0.2,5228,89,443764,84.8659399502773,12
0.2,5229,96,443860,84.868068833652,6
0.2,5230,93,443953,84.86962339896769,8
0.2,5231,94,444047,84.87136850152905,7
0.2,5232,88,444135,84.87196636728454,13
0.2,5233,82,444217,84.87141765380207,19
0.2,5234,88,444305,84.8720152817574,13
0.2,5235,85,444390,84.87203972498091,16
0.2,5236,93,444483,84.87359175100248,9
0.2,5237,91,444574,84.87476135929744,10
0.2,5238,92,444666,84.87612139721321,9
0.2,5239,92,444758,84.87748091603054,9
0.2,5240,89,444847,84.87826750620111,12
0.2,5241,92,444939,84.87962609690958,9
0.2,5242,95,445034,84.8815563608621,6
0.2,5243,94,445128,84.88329519450801,8
0.2,5244,94,445222,84.88503336510963,8
0.2,5245,95,445317,84.88696149447198,6
0.2,5246,93,445410,84.8885077186964,8
0.2,5247,94,445504,84.89024390243902,7
0.2,5248,92,445596,84.89159839969518,9
0.2,5249,90,445686,84.89257142857143,11
0.2,5250,88,445774,84.89316320700819,13
0.2,5251,96,445870,84.8952779893374,6
0.2,5252,93,445963,84.89682086426804,8
0.2,5253,91,446054,84.89798248953178,11
0.2,5254,90,446144,84.8989533777355,11
0.2,5255,93,446237,84.90049467275495,11
0.2,5256,21,446258,84.88833935704774,12
0.2,5257,94,446352,84.89007227082541,8
0.2,5258,96,446448,84.89218482601255,6
0.2,5259,95,446543,84.89410646387833,8
0.2,5260,91,446634,84.89526705949439,10
0.2,5261,92,446726,84.89661725579627,10
0.2,5262,93,446819,84.89815694470835,8
0.2,5263,89,446908,84.89893617021276,12
0.2,5264,94,447002,84.90066476733143,8
0.2,5265,91,447093,84.9018230155716,10
0.2,5266,92,447185,84.90317068539966,9
0.2,5267,92,447277,84.9045178435839,10
0.2,5268,92,447369,84.90586449041564,9
0.2,5269,93,447462,84.90740037950664,8
0.2,5270,91,447553,84.90855625118573,10
0.2,5271,89,447642,84.90933232169955,13
0.2,5272,91,447733,84.91048738858335,10
0.2,5273,94,447827,84.91221084565794,7
0.2,5274,93,447920,84.91374407582938,8
0.2,5275,94,448014,84.91546626231994,7
0.2,5276,92,448106,84.91680879287473,9
0.2,5277,94,448200,84.91852974611595,8
0.2,5278,94,448294,84.92025004735746,7
0.2,5279,94,448388,84.9219696969697,7
0.2,5280,93,448481,84.92349933724674,8
0.2,5281,95,448576,84.92540704278683,6
0.2,5282,89,448665,84.92617830777967,12
0.2,5283,96,448761,84.92827403482211,6
0.2,5284,93,448854,84.92980132450332,8
0.2,5285,23,448877,84.91808550889141,9
0.2,5286,91,448968,84.9192358615472,10
0.2,5287,95,449063,84.92114220877458,7
0.2,5288,94,449157,84.92285876347135,7
0.2,5289,94,449251,84.92457466918715,7
0.2,5290,93,449344,84.92610092610093,8
0.2,5291,94,449438,84.92781557067272,8
0.2,5292,92,449530,84.92915170980541,9
0.2,5293,91,449621,84.9302984510767,10
0.2,5294,86,449707,84.93050047214354,15
0.2,5295,85,449792,84.93051359516616,16
0.2,5296,95,449887,84.93241457428734,6
0.2,5297,92,449979,84.93374858437146,9
0.2,5298,93,450072,84.93527080581242,8
0.2,5299,96,450168,84.93735849056604,6
0.2,5300,92,450260,84.93869081305414,10
0.2,5301,92,450352,84.94002263296869,10
0.2,5302,93,450445,84.94154252310013,8
0.2,5303,88,450533,84.94211915535445,13
0.2,5304,94,450627,84.94382657869934,7
0.2,5305,93,450720,84.94534489257444,9
0.2,5306,95,450815,84.9472394950066,8
0.2,5307,24,450839,84.93575734740016,10
0.2,5308,27,450866,84.92484460350349,6
0.2,5309,93,450959,84.92636534839924,8
0.2,5310,93,451052,84.92788552061758,8
0.2,5311,94,451146,84.92959337349397,8
0.2,5312,94,451240,84.9313005834745,8
0.2,5313,94,451334,84.9330071509221,7
0.2,5314,91,451425,84.93414863593603,10
0.2,5315,94,451519,84.93585402558314,7
0.2,5316,89,451608,84.93661839383111,12
0.2,5317,95,451703,84.93851071831516,6
0.2,5318,90,451793,84.93946230494454,11
0.2,5319,92,451885,84.9407894736842,9
0.2,5320,96,451981,84.94286788197707,6
0.2,5321,92,452073,84.94419391206313,9
0.2,5322,92,452165,84.9455194439226,10
0.2,5323,94,452259,84.94722013523666,7
0.2,5324,93,452352,84.9487323943662,8
0.2,5325,95,452447,84.95061960195268,8
0.2,5326,86,452533,84.95081659470621,15
0.2,5327,88,452621,84.95138888888889,13
0.2,5328,94,452715,84.95308688309251,7
0.2,5329,90,452805,84.95403377110694,13
0.2,5330,93,452898,84.95554305008442,8
0.2,5331,94,452992,84.95723930982746,9
0.2,5332,94,453086,84.95893493343334,7
0.2,5333,93,453179,84.96044244469441,8
0.2,5334,91,453270,84.96157450796626,11
0.2,5335,92,453362,84.9628935532234,9
0.2,5336,84,453446,84.96271313471988,18
0.2,5337,22,453468,84.95091794679655,11
0.2,5338,92,453560,84.9522382468627,9
0.2,5339,95,453655,84.95411985018727,6
0.2,5340,89,453744,84.95487736378955,13
0.2,5341,91,453835,84.95600898539873,10
0.2,5342,90,453925,84.95695302264646,11
0.2,5343,94,454019,84.95864520958084,7
0.2,5344,93,454112,84.9601496725912,8
0.2,5345,23,454135,84.94855967078189,9
0.2,5346,93,454228,84.95006545726575,8
0.2,5347,90,454318,84.95100972326104,12
0.2,5348,93,454411,84.95251448868947,8
0.2,5349,94,454505,84.95420560747664,7
0.2,5350,94,454599,84.955896094188,7
0.2,5351,91,454690,84.95702541106128,10
0.2,5352,87,454777,84.95740706146087,14
0.2,5353,27,454804,84.94658199477027,6
0.2,5354,87,454891,84.9469654528478,15
0.2,5355,96,454987,84.94902912621359,6
0.2,5356,94,455081,84.95071868583162,7
0.2,5357,93,455174,84.95222097797685,8
0.2,5358,90,455264,84.95316290352677,11
0.2,5359,93,455357,84.95466417910448,8
0.2,5360,95,455452,84.95653795933595,6
0.2,5361,92,455544,84.95785154792988,9
0.2,5362,94,455638,84.95953757225433,7
0.2,5363,95,455733,84.96140939597315,6
0.2,5364,96,455829,84.96346691519105,6
0.2,5365,94,455923,84.96515095042862,7
0.2,5366,96,456019,84.96720700577603,6
0.2,5367,89,456108,84.96795827123697,12
0.2,5368,91,456199,84.96908176569194,11
0.2,5369,86,456285,84.96927374301676,15
0.2,5370,92,456377,84.97058275926271,9
0.2,5371,92,456469,84.97189128816083,9
0.2,5372,94,456563,84.97357156151126,7
0.2,5373,21,456584,84.9616672869371,12
0.2,5374,92,456676,84.96297674418605,9
0.2,5375,92,456768,84.96428571428571,9
0.2,5376,90,456858,84.96522224288637,11
0.2,5377,95,456953,84.96708813685385,7
0.2,5378,92,457045,84.96839561256739,9
0.2,5379,93,457138,84.96988847583643,8
0.2,5380,92,457230,84.97119494517747,9
0.2,5381,92,457322,84.97250092902267,9
0.2,5382,92,457414,84.97380642764257,9
0.2,5383,78,457492,84.97251114413076,23
0.2,5384,91,457583,84.9736304549675,10
0.2,5385,91,457674,84.9747493501671,10
0.2,5386,93,457767,84.97623909411546,8
0.2,5387,90,457857,84.9771714922049,11
0.2,5388,93,457950,84.9786602338096,8
0.2,5389,85,458035,84.9786641929499,17
0.2,5390,77,458112,84.97718419588203,25
0.2,5391,26,458138,84.96624629080118,7
0.2,5392,92,458230,84.96755052846282,9
0.2,5393,79,458309,84.96644419725621,22
0.2,5394,94,458403,84.96811862835959,7
0.2,5395,93,458496,84.9696071163825,8
0.2,5396,94,458590,84.97128034093015,8
0.2,5397,94,458684,84.97295294553538,8
0.2,5398,93,458777,84.9744397110576,8
0.2,5399,93,458870,84.97592592592592,8
0.2,5400,92,458962,84.97722643954823,9
0.2,5401,95,459057,84.97908182154758,6
0.2,5402,90,459147,84.9800111049417,11
0.2,5403,94,459241,84.98168023686158,7
0.2,5404,27,459268,84.97095282146161,6
0.2,5405,91,459359,84.97206807251203,10
0.2,5406,94,459453,84.97373774736452,7
0.2,5407,24,459477,84.96246301775147,8
0.2,5408,93,459570,84.96394897393233,8
0.2,5409,95,459665,84.96580406654344,6
0.2,5410,94,459759,84.96747366475698,7
0.2,5411,90,459849,84.96840354767184,11
0.2,5412,96,459945,84.97044152965084,6
0.2,5413,92,460037,84.97173993350573,9
0.2,5414,95,460132,84.9735918744229,6
0.2,5415,87,460219,84.97396602658789,14
0.2,5416,94,460313,84.97563226878346,7
0.2,5417,92,460405,84.97692875599853,10
0.2,5418,21,460426,84.96512271636833,11
0.2,5419,95,460521,84.9669741697417,7
0.2,5420,19,460540,84.95480538646007,13
0.2,5421,26,460566,84.94393212836592,6
0.2,5422,92,460658,84.94523326572008,9
0.2,5423,90,460748,84.94616519174042,11
0.2,5424,93,460841,84.94764976958525,9
0.2,5425,94,460935,84.94931809804645,7
0.2,5426,94,461029,84.95098581168233,8
0.2,5427,91,461120,84.95210022107591,10
0.2,5428,96,461216,84.95413519985264,6
0.2,5429,94,461310,84.95580110497238,7
0.2,5430,93,461403,84.95728226845885,8
0.2,5431,92,461495,84.95857879234168,9
0.2,5432,95,461590,84.96042702006258,6
0.2,5433,93,461683,84.9619065145381,8
0.2,5434,86,461769,84.96209751609936,15
0.2,5435,93,461862,84.9635761589404,10
0.2,5436,22,461884,84.95199558580099,10
0.2,5437,94,461978,84.9536594336153,7
0.2,5438,91,462069,84.95477109762824,11
0.2,5439,95,462164,84.95661764705882,6
0.2,5440,94,462258,84.95827972799118,7
0.2,5441,94,462352,84.95994119808894,8
0.2,5442,94,462446,84.96160205768878,7
0.2,5443,21,462467,84.94985304922851,11
0.2,5444,96,462563,84.95188246097337,6
0.2,5445,95,462658,84.95372750642673,7
0.2,5446,84,462742,84.95355241417293,18
0.2,5447,92,462834,84.95484581497797,9
0.2,5448,92,462926,84.95613874105341,9
0.2,5449,92,463018,84.95743119266055,9
0.2,5450,88,463106,84.9579893597505,13
0.2,5451,92,463198,84.95928099779897,9
0.2,5452,21,463219,84.94755180634513,11
0.2,5453,96,463315,84.94957829116245,6
0.2,5454,87,463402,84.9499541704858,14
0.2,5455,94,463496,84.95161290322581,7
0.2,5456,91,463587,84.95272127542606,10
0.2,5457,94,463681,84.95437889336753,7
0.2,5458,93,463774,84.95585272027844,10
0.2,5459,89,463863,84.95659340659341,12
0.2,5460,94,463957,84.9582494048709,7
0.2,5461,89,464046,84.95898938117905,12
0.2,5462,93,464139,84.96046128500824,8
0.2,5463,94,464233,84.96211566617862,7
0.2,5464,94,464327,84.96376944190303,7
0.2,5465,94,464421,84.96542261251372,8
0.2,5466,90,464511,84.9663435156393,11
0.2,5467,90,464601,84.96726408193123,11
0.2,5468,24,464625,84.95611629182666,8
0.2,5469,94,464719,84.95776965265082,7
0.2,5470,93,464812,84.95923962712484,8
0.2,5471,95,464907,84.9610745614035,8
0.2,5472,93,465000,84.96254339484743,8
0.2,5473,25,465025,84.95158933138472,8
0.2,5474,93,465118,84.95305936073059,9
0.2,5475,91,465209,84.95416362308254,10
0.2,5476,85,465294,84.9541719919664,17
0.2,5477,94,465388,84.95582329317268,8
0.2,5478,89,465477,84.95656141631684,12
0.2,5479,96,465573,84.95857664233577,7
0.2,5480,92,465665,84.95986133917168,10
0.2,5481,90,465755,84.96078073695732,11
0.2,5482,93,465848,84.96224694510305,9
0.2,5483,92,465940,84.963530269876,9
0.2,5484,86,466026,84.9637192342753,15
0.2,5485,93,466119,84.96518410499453,8
0.2,5486,92,466211,84.9664661928194,9
0.2,5487,90,466301,84.9673833819242,11
0.2,5488,92,466393,84.96866460193114,10
0.2,5489,92,466485,84.96994535519126,9
0.2,5490,95,466580,84.97177199052996,6
0.2,5491,92,466672,84.97305171158048,10
0.2,5492,93,466765,84.97451301656653,8
0.2,5493,95,466860,84.97633782307972,7
0.2,5494,91,466951,84.97743403093722,10
0.2,5495,96,467047,84.97943959243086,6
0.2,5496,94,467141,84.9810805894124,8
0.2,5497,93,467234,84.98253910512913,8
0.2,5498,93,467327,84.98399709038007,8
0.2,5499,96,467423,84.986,6
0.2,5500,89,467512,84.98672968551172,13
0.2,5501,95,467607,84.9885496183206,8
0.2,5502,92,467699,84.98982373250954,10
0.2,5503,95,467794,84.99164244186046,8
0.2,5504,79,467873,84.9905540417802,22
0.2,5505,94,467967,84.9921903378133,7
0.2,5506,92,468059,84.99346286544397,10
0.2,5507,92,468151,84.99473493100945,9
0.2,5508,88,468239,84.99528045017244,13
0.2,5509,94,468333,84.99691470054447,7
0.2,5510,95,468428,84.99872981310106,6
0.2,5511,89,468517,84.9994557329463,12
0.2,5512,94,468611,85.00108833665881,8
0.2,5513,94,468705,85.00272034820458,8
0.2,5514,91,468796,85.0038077969175,10
0.2,5515,91,468887,85.00489485134155,10
0.2,5516,92,468979,85.00616276962117,9
0.2,5517,96,469075,85.00815512866981,7
0.2,5518,90,469165,85.00905961224859,11
0.2,5519,27,469192,84.99855072463768,6
0.2,5520,27,469219,84.9880456439051,6
0.2,5521,91,469310,84.9891343716045,10
0.2,5522,87,469397,84.98949846098135,14
0.2,5523,94,469491,84.99112961622014,7
0.2,5524,95,469586,84.9929411764706,6
0.2,5525,88,469674,84.99348534201954,13
0.2,5526,95,469769,84.99529582051746,6
0.2,5527,90,469859,84.9962011577424,12
0.2,5528,91,469950,84.99728703201302,10
0.2,5529,93,470043,84.99873417721518,8
0.2,5530,94,470137,85.00036159826433,9
0.2,5531,91,470228,85.00144613159797,10
0.2,5532,93,470321,85.0028917404663,8
0.2,5533,94,470415,85.00451752800868,8
0.2,5534,93,470508,85.0059620596206,8
0.2,5535,94,470602,85.00758670520231,7
0.2,5536,93,470695,85.00903016073686,9
0.2,5537,92,470787,85.01029252437704,9
0.2,5538,93,470880,85.01173497021124,8
0.2,5539,21,470901,85.00018050541516,11
0.2,5540,94,470995,85.00180472838838,7
0.2,5541,94,471089,85.00342836521112,7
0.2,5542,92,471181,85.00469060075771,10
0.2,5543,95,471276,85.00649350649351,6
0.2,5544,93,471369,85.00793507664562,8
0.2,5545,92,471461,85.0091958168049,9
0.2,5546,20,471481,84.99747611321435,12
0.2,5547,86,471567,84.99765681326605,15
0.2,5548,95,471662,84.99945936204722,6
0.2,5549,95,471757,85.00126126126126,6
0.2,5550,95,471852,85.00306251125923,6
0.2,5551,93,471945,85.00450288184437,8
0.2,5552,93,472038,85.00594273365748,8
0.2,5553,24,472062,84.99495858840476,8
0.2,5554,95,472157,84.9967596759676,7
0.2,5555,92,472249,84.99802015838733,10
0.2,5556,94,472343,84.99964009357566,8
0.2,5557,92,472435,85.00089960417417,9
0.2,5558,94,472529,85.00251843856809,8
0.2,5559,95,472624,85.0043165467626,6
0.2,5560,95,472719,85.0061140082719,6
0.2,5561,93,472812,85.00755124056094,8
0.2,5562,91,472903,85.00862843789322,10
0.2,5563,86,472989,85.0088066139468,15
0.2,5564,94,473083,85.0104222821204,7
0.2,5565,16,473099,84.99802371541502,17
0.2,5566,94,473193,84.99964074007545,8
0.2,5567,94,473287,85.00125718390805,7
0.2,5568,91,473378,85.0023343508709,10
0.2,5569,90,473468,85.0032315978456,12
0.2,5570,79,473547,85.00215401184707,22
0.2,5571,91,473638,85.00323043790381,10
0.2,5572,92,473730,85.00448591422932,9
0.2,5573,95,473825,85.00627915321134,6
0.2,5574,93,473918,85.0077130044843,8
0.2,5575,95,474013,85.00950502152081,6
0.2,5576,90,474103,85.0103998565537,11
0.2,5577,94,474197,85.01201147364647,8
0.2,5578,91,474288,85.01308478221904,10
0.2,5579,91,474379,85.01415770609319,11
0.2,5580,94,474473,85.01576778355134,8
0.2,5581,93,474566,85.0171981368685,8
0.2,5582,96,474662,85.01916532330289,6
0.2,5583,94,474756,85.02077363896848,7
0.2,5584,94,474850,85.02238137869293,8
0.2,5585,94,474944,85.02398854278553,7
0.2,5586,94,475038,85.02559513155539,7
0.2,5587,92,475130,85.02684323550466,9
0.2,5588,96,475226,85.02880658436214,6
0.2,5589,90,475316,85.02969588550984,11
0.2,5590,93,475409,85.03112144517975,8
0.2,5591,94,475503,85.0327253218884,7
0.2,5592,25,475528,85.02199177543358,8
0.2,5593,96,475624,85.02395423668216,6
0.2,5594,94,475718,85.02555853440572,7
0.2,5595,91,475809,85.02662616154396,10
0.2,5596,96,475905,85.02858674289799,6
0.2,5597,94,475999,85.03018935334048,7
0.2,5598,93,476092,85.03161278799786,9
0.2,5599,90,476182,85.0325,12
0.2,5600,91,476273,85.03356543474379,10
0.2,5601,91,476364,85.03463048911104,10
0.2,5602,90,476454,85.03551668748885,11
0.2,5603,95,476549,85.03729478943612,6
0.2,5604,22,476571,85.02604817127565,10
0.2,5605,23,476594,85.01498394577239,9
0.2,5606,88,476682,85.01551631888711,13
0.2,5607,93,476775,85.01694008559201,8
0.2,5608,94,476869,85.01854162952398,7
0.2,5609,96,476965,85.0204991087344,6
0.2,5610,92,477057,85.02174300481198,9
0.2,5611,95,477152,85.02352102637207,6
0.2,5612,94,477246,85.0251202565473,8
0.2,5613,93,477339,85.02654079087995,8
0.2,5614,90,477429,85.02742653606411,11
0.2,5615,94,477523,85.02902421652422,7
0.2,5616,95,477618,85.03079935908848,6
0.2,5617,89,477707,85.0315058739765,12
0.2,5618,93,477800,85.03292400783057,8
0.2,5619,93,477893,85.03434163701067,8
0.2,5620,17,477910,85.02223803593667,16
0.2,5621,96,478006,85.02419067947349,7
0.2,5622,95,478101,85.02596478747999,7
0.2,5623,93,478194,85.0273826458037,8
0.2,5624,25,478219,85.0167111111111,8
0.2,5625,91,478310,85.01777461784572,10
0.2,5626,93,478403,85.01919317575972,8
0.2,5627,93,478496,85.02061122956646,8
0.2,5628,92,478588,85.0218511280867,9
0.2,5629,91,478679,85.02291296625222,10
0.2,5630,93,478772,85.02432960397798,8
0.2,5631,96,478868,85.0262784090909,6
0.2,5632,91,478959,85.02733889579265,10
0.2,5633,-53,478906,85.00283990060348,17
0.2,5634,91,478997,85.0039041703638,10
0.2,5635,94,479091,85.00550035486161,7
0.2,5636,93,479184,85.00691857370941,8
0.2,5637,96,479280,85.00886839304718,6
0.2,5638,89,479369,85.00957616598687,12
0.2,5639,15,479384,84.99716312056738,17
0.2,5640,92,479476,84.99840453820245,9
0.2,5641,91,479567,84.99946827366182,10
0.2,5642,95,479662,85.00124047492469,6
0.2,5643,16,479678,84.98901488306166,18
0.2,5644,96,479774,84.99096545615589,6
0.2,5645,90,479864,84.99185263903648,11
0.2,5646,93,479957,84.99327076323712,8
0.2,5647,93,480050,84.99468838526913,9
0.2,5648,87,480137,84.99504337050806,15
0.2,5649,90,480227,84.99592920353982,11
0.2,5650,94,480321,84.99752256237834,8
0.2,5651,94,480415,84.99911535739561,7
0.2,5652,94,480509,85.00070758889085,7
0.2,5653,88,480597,85.00123806154934,14
0.2,5654,94,480691,85.0028293545535,7
0.2,5655,83,480774,85.00247524752476,18
0.2,5656,96,480870,85.00441930351776,6
0.2,5657,95,480965,85.00618593142453,6
0.2,5658,95,481060,85.00795193497085,9
0.2,5659,19,481079,84.99628975265017,14
0.2,5660,94,481173,84.99788023317436,8
0.2,5661,92,481265,84.99911691981632,9
0.2,5662,92,481357,85.00035316969804,9
0.2,5663,94,481451,85.00194209039547,8
0.2,5664,94,481545,85.00353045013239,7
0.2,5665,93,481638,85.00494175785387,8
0.2,5666,94,481732,85.00652902770425,8
0.2,5667,95,481827,85.00829216654904,7
0.2,5668,95,481922,85.01005468336567,6
0.2,5669,96,482018,85.01199294532628,6
0.2,5670,95,482113,85.0137541879739,6
0.2,5671,93,482206,85.01516220028209,9
0.2,5672,92,482298,85.01639344262296,9
0.2,5673,92,482390,85.01762425096933,9
0.2,5674,93,482483,85.01903083700441,9
0.2,5675,89,482572,85.01973220577872,12
0.2,5676,92,482664,85.02096177558569,9
0.2,5677,18,482682,85.00915815427967,16
0.2,5678,91,482773,85.01021306568057,11
0.2,5679,94,482867,85.0117957746479,8
0.2,5680,88,482955,85.0123217743355,15
0.2,5681,92,483047,85.01355156634988,9
0.2,5682,96,483143,85.01548477916593,6
0.2,5683,92,483235,85.01671358198452,9
0.2,5684,95,483330,85.01846965699208,6
0.2,5685,92,483422,85.01969750263805,10
0.2,5686,95,483517,85.02145243537893,6
0.2,5687,93,483610,85.02285513361463,8
0.2,5688,91,483701,85.02390578309017,10
0.2,5689,95,483796,85.02565905096661,6
0.2,5690,93,483889,85.0270602706027,8
0.2,5691,94,483983,85.02863668306395,8
0.2,5692,96,484079,85.03056385034253,6
0.2,5693,93,484172,85.03196347031964,8
0.2,5694,94,484266,85.03353819139596,7
0.2,5695,91,484357,85.0345856741573,10
0.2,5696,85,484442,85.03457960329999,16
0.2,5697,95,484537,85.03632853632854,7
0.2,5698,95,484632,85.0380768555887,6
0.2,5699,94,484726,85.03964912280702,9
0.2,5700,92,484818,85.04087002280302,10
0.2,5701,92,484910,85.04209049456331,9
0.2,5702,92,485002,85.04331053831316,10
0.2,5703,91,485093,85.04435483870968,10
0.2,5704,92,485185,85.045574057844,9
0.2,5705,93,485278,85.04696810375044,8
0.2,5706,90,485368,85.04783599088839,11
0.2,5707,92,485460,85.04905395935529,9
0.2,5708,94,485554,85.0506218251883,8
0.2,5709,93,485647,85.05201401050788,9
0.2,5710,88,485735,85.0525302048678,13
0.2,5711,19,485754,85.04096638655462,13
0.2,5712,92,485846,85.0421844915106,9
0.2,5713,90,485936,85.04305215260763,11
0.2,5714,91,486027,85.04409448818897,10
0.2,5715,96,486123,85.046011196641,6
0.2,5716,95,486218,85.04775231764911,9
0.2,5717,89,486307,85.04844351171738,12
0.2,5718,92,486399,85.04965903129917,9
0.2,5719,90,486489,85.05052447552447,11
0.2,5720,94,486583,85.0520887956651,7
0.2,5721,91,486674,85.05312827682629,10
0.2,5722,96,486770,85.05504106237987,6
0.2,5723,92,486862,85.05625436757512,9
0.2,5724,93,486955,85.05764192139738,8
0.2,5725,95,487050,85.0593782745372,6
0.2,5726,21,487071,85.04819277108433,11
0.2,5727,94,487165,85.04975558659218,7
0.2,5728,91,487256,85.05079420492233,12
0.2,5729,91,487347,85.05183246073298,10
0.2,5730,94,487441,85.05339382306752,7
0.2,5731,91,487532,85.05443126308444,10
0.2,5732,91,487623,85.05546834118263,10
0.2,5733,95,487718,85.05720265085455,9
0.2,5734,81,487799,85.0564952048823,20
0.2,5735,93,487892,85.057880055788,9
0.2,5736,25,487917,85.04741153913196,8
0.2,5737,91,488008,85.04844893691181,10
0.2,5738,91,488099,85.04948597316606,11
0.2,5739,93,488192,85.05087108013937,8
0.2,5740,92,488284,85.05208151889914,9
0.2,5741,94,488378,85.0536398467433,8
0.2,5742,95,488473,85.05537175692147,8
0.2,5743,81,488554,85.05466573816156,21
0.2,5744,92,488646,85.05587467362925,9
0.2,5745,93,488739,85.0572572224156,8
0.2,5746,95,488834,85.05898729772055,7
0.2,5747,79,488913,85.05793319415449,22
0.2,5748,94,489007,85.05948860671421,7
0.2,5749,96,489103,85.06139130434782,6
0.2,5750,93,489196,85.06277169187968,8
0.2,5751,94,489290,85.06432545201669,7
0.2,5752,96,489386,85.06622631670433,6
0.2,5753,91,489477,85.06725755995829,10
0.2,5754,95,489572,85.06898349261512,7
0.2,5755,92,489664,85.07018763029882,10
0.2,5756,95,489759,85.07191245440333,6
0.2,5757,17,489776,85.06009030913512,15
0.2,5758,96,489872,85.06198992880708,6
0.2,5759,94,489966,85.06354166666667,8
0.2,5760,94,490060,85.06509286582191,7
0.2,5761,94,490154,85.06664352655328,7
0.2,5762,84,490238,85.0664584417838,17
0.2,5763,94,490332,85.06800832755032,7
0.2,5764,92,490424,85.06921075455334,9
0.2,5765,93,490517,85.07058619493583,8
0.2,5766,93,490610,85.07196115831455,8
0.2,5767,90,490700,85.07281553398059,12
0.2,5768,89,490789,85.07349627318426,12
0.2,5769,93,490882,85.07487001733102,9
0.2,5770,95,490977,85.07658984578063,6
0.2,5771,95,491072,85.07830907830908,6
0.2,5772,93,491165,85.0796812749004,8
0.2,5773,94,491259,85.08122618635261,7
0.2,5774,96,491355,85.08311688311689,6
0.2,5775,94,491449,85.08466066481995,8
0.2,5776,93,491542,85.08603081184006,8
0.2,5777,94,491636,85.08757355486327,8
0.2,5778,94,491730,85.08911576397301,7
0.2,5779,95,491825,85.090830449827,7
0.2,5780,96,491921,85.09271752291991,6
0.2,5781,90,492011,85.09356624005534,11
0.2,5782,93,492104,85.09493342555767,8
0.2,5783,94,492198,85.09647302904564,7
0.2,5784,90,492288,85.09732065687122,12
0.2,5785,84,492372,85.09713100587625,17
0.2,5786,91,492463,85.09815102816658,10
0.2,5787,94,492557,85.09968901174844,8
0.2,5788,93,492650,85.1010537225773,9
0.2,5789,95,492745,85.1027633851468,7
0.2,5790,94,492839,85.10429977551372,8
0.2,5791,96,492935,85.10618093922652,6
0.2,5792,91,493026,85.10719834282754,10
0.2,5793,91,493117,85.10821539523646,10
0.2,5794,91,493208,85.10923209663503,10
0.2,5795,95,493303,85.11093857832988,6
0.2,5796,26,493329,85.10074176298085,6
0.2,5797,89,493418,85.10141428078647,12
0.2,5798,88,493506,85.10191412312467,13
0.2,5799,89,493595,85.10258620689655,13
0.2,5800,89,493684,85.10325805895535,12
0.2,5801,90,493774,85.10410203378146,11
0.2,5802,88,493862,85.10460106841289,13
0.2,5803,93,493955,85.10596140592695,8
0.2,5804,89,494044,85.10663221360896,13
0.2,5805,90,494134,85.10747502583534,11
0.2,5806,94,494228,85.10900637162045,7
0.2,5807,96,494324,85.11088154269973,6
0.2,5808,90,494414,85.1117231881563,11
0.2,5809,95,494509,85.11342512908777,6
0.2,5810,94,494603,85.1149543968336,7
0.2,5811,88,494691,85.11545079146593,14
0.2,5812,92,494783,85.11663512816102,10
0.2,5813,92,494875,85.11781905744753,9
0.2,5814,96,494971,85.11969045571797,6
0.2,5815,91,495062,85.1207015130674,10
0.2,5816,95,495157,85.12239986247207,6
0.2,5817,86,495243,85.12255070470952,15
0.2,5818,-45,495198,85.10018903591683,9
0.2,5819,96,495294,85.1020618556701,6
0.2,5820,90,495384,85.10290328122316,13
0.2,5821,87,495471,85.10322913088285,15
0.2,5822,88,495559,85.10372660140821,13
0.2,5823,93,495652,85.10508241758242,8
0.2,5824,91,495743,85.10609442060085,10
0.2,5825,95,495838,85.1077926536217,6
0.2,5826,88,495926,85.10828899948515,13
0.2,5827,95,496021,85.10998627316404,6
0.2,5828,96,496117,85.11185452050094,6
0.2,5829,88,496205,85.1123499142367,13
0.2,5830,95,496300,85.1140456182473,6
0.2,5831,94,496394,85.11556927297669,7
0.2,5832,94,496488,85.1170924052803,7
0.2,5833,89,496577,85.11775797051766,12
0.2,5834,94,496671,85.11928020565553,7
0.2,5835,93,496764,85.1206305688828,8
0.2,5836,93,496857,85.12198046941923,9
0.2,5837,92,496949,85.12315861596437,9
0.2,5838,94,497043,85.12467888337044,7
0.2,5839,94,497137,85.12619863013698,7
0.2,5840,94,497231,85.12771785653142,7
0.2,5841,90,497321,85.12855186579938,11
0.2,5842,92,497413,85.12972787951395,9
0.2,5843,92,497505,85.13090349075975,11
0.2,5844,94,497599,85.13242087254064,7
0.2,5845,95,497694,85.13410879233665,6
0.2,5846,93,497787,85.13545407901488,8
0.2,5847,95,497882,85.13714090287277,6
0.2,5848,94,497976,85.13865618054368,7
0.2,5849,95,498071,85.14034188034188,7
0.2,5850,92,498163,85.14151427106478,9
0.2,5851,11,498174,85.12884483937115,21
0.2,5852,90,498264,85.12967708867248,11
0.2,5853,92,498356,85.13085070037582,9
0.2,5854,89,498445,85.13151152860803,12
0.2,5855,92,498537,85.1326844262295,9
0.2,5856,87,498624,85.13300324398156,14
0.2,5857,93,498717,85.13434619324002,8
0.2,5858,90,498807,85.13517665130568,12
0.2,5859,94,498901,85.13668941979522,7
0.2,5860,82,498983,85.1361542398908,21
0.2,5861,93,499076,85.13749573524395,9
0.2,5862,88,499164,85.13798396725225,13
0.2,5863,95,499259,85.13966575716235,6
0.2,5864,95,499354,85.14134697357204,6
0.2,5865,91,499445,85.14234572110468,12
0.2,5866,94,499539,85.1438554627578,7
0.2,5867,94,499633,85.14536468984322,8
0.2,5868,22,499655,85.13460555460897,10
0.2,5869,17,499672,85.12299829642248,15
0.2,5870,93,499765,85.12433997615398,8
0.2,5871,93,499858,85.12568119891009,9
0.2,5872,86,499944,85.125830069811,15
0.2,5873,94,500038,85.12734082397004,8
0.2,5874,93,500131,85.12868085106383,8
0.2,5875,87,500218,85.1289993192648,15
0.2,5876,94,500312,85.1305087629743,7
0.2,5877,88,500400,85.13099693773393,15
0.2,5878,94,500494,85.13250552815104,7
0.2,5879,92,500586,85.13367346938776,9
0.2,5880,91,500677,85.1346709743241,10
0.2,5881,90,500767,85.1354981298878,11
0.2,5882,95,500862,85.13717491075981,7
0.2,5883,88,500950,85.13766145479266,13
0.2,5884,91,501041,85.13865760407816,11
0.2,5885,94,501135,85.1401630988787,7
0.2,5886,91,501226,85.141158484797,10
0.2,5887,93,501319,85.14249320652173,8
0.2,5888,93,501412,85.1438274749533,9
0.2,5889,86,501498,85.14397283531409,15
0.2,5890,96,501594,85.14581565099304,6
0.2,5891,93,501687,85.14714867617108,8
0.2,5892,94,501781,85.14865094179535,7
0.2,5893,91,501872,85.14964370546318,10
0.2,5894,25,501897,85.13944020356234,7
0.2,5895,95,501992,85.14111261872456,6
0.2,5896,92,502084,85.14227573342377,9
0.2,5897,92,502176,85.14343845371312,10
0.2,5898,94,502270,85.14493982030852,8
0.2,5899,90,502360,85.1457627118644,11
0.2,5900,93,502453,85.14709371293002,8
0.2,5901,91,502544,85.14808539478143,10
0.2,5902,95,502639,85.14975436218872,6
0.2,5903,88,502727,85.15023712737127,13
0.2,5904,89,502816,85.15088907705335,12
0.2,5905,92,502908,85.15204876396885,9
0.2,5906,93,503001,85.15337734890808,8
0.2,5907,88,503089,85.15385917400135,13
0.2,5908,96,503185,85.15569470299543,6
0.2,5909,91,503276,85.15668358714044,11
0.2,5910,94,503370,85.1581796650313,7
0.2,5911,13,503383,85.14597428958051,19
0.2,5912,25,503408,85.1358024691358,8
0.2,5913,94,503502,85.13730131890429,8
0.2,5914,86,503588,85.1374471682164,16
0.2,5915,85,503673,85.13742393509128,16
0.2,5916,88,503761,85.13790772350853,14
0.2,5917,94,503855,85.13940520446097,7
0.2,5918,96,503951,85.14124007433688,6
0.2,5919,84,504035,85.14104729729729,17
0.2,5920,93,504128,85.14237459888533,8
0.2,5921,93,504221,85.14370145221208,9
0.2,5922,22,504243,85.13304068884011,10
0.2,5923,18,504261,85.12170830519919,14
0.2,5924,91,504352,85.12270042194093,11
0.2,5925,94,504446,85.1241984475194,8
0.2,5926,94,504540,85.12569596760588,8
0.2,5927,-48,504492,85.10323886639677,12
0.2,5928,95,504587,85.10490807893406,7
0.2,5929,91,504678,85.10590219224284,10
0.2,5930,22,504700,85.09526218175687,10
0.2,5931,92,504792,85.09642616318274,9
0.2,5932,92,504884,85.09758975223328,9
0.2,5933,93,504977,85.09892146949781,9
0.2,5934,94,505071,85.10042122999158,7
0.2,5935,94,505165,85.1019204851752,7
0.2,5936,95,505260,85.10358767054068,6
0.2,5937,94,505354,85.10508588750422,7
0.2,5938,94,505448,85.10658359993265,9
0.2,5939,96,505544,85.1084175084175,6
0.2,5940,94,505638,85.10991415586602,7
0.2,5941,93,505731,85.11124200605856,11
0.2,5942,-51,505680,85.08833922261483,15
0.2,5943,93,505773,85.08967025572005,8
0.2,5944,91,505864,85.09066442388561,10
0.2,5945,94,505958,85.09216279852001,7
0.2,5946,88,506046,85.09265175718849,13
0.2,5947,92,506138,85.09381304640215,9
0.2,5948,91,506229,85.09480584972265,10
0.2,5949,90,506319,85.09563025210085,12
0.2,5950,95,506414,85.09729457234079,6
0.2,5951,96,506510,85.09912634408602,6
0.2,5952,86,506596,85.09927767512178,16
0.2,5953,94,506690,85.10077258985557,7
0.2,5954,90,506780,85.10159529806884,11
0.2,5955,94,506874,85.10308932169241,8
0.2,5956,94,506968,85.10458284371327,7
0.2,5957,87,507055,85.10490097348104,15
0.2,5958,96,507151,85.10672931699949,6
0.2,5959,95,507246,85.10838926174496,6
0.2,5960,27,507273,85.09864116758934,7
0.2,5961,95,507368,85.10030191211003,6
0.2,5962,92,507460,85.10145899714908,9
0.2,5963,95,507555,85.10311871227364,6
0.2,5964,94,507649,85.1046102263202,7
0.2,5965,94,507743,85.10610124036205,7
0.2,5966,96,507839,85.10792693145635,6
0.2,5967,92,507931,85.109081769437,9
0.2,5968,93,508024,85.1104037527224,8
0.2,5969,92,508116,85.11155778894472,10
0.2,5970,94,508210,85.1130463908893,7
0.2,5971,96,508306,85.11486939048895,6
0.2,5972,92,508398,85.11602209944752,9
0.2,5973,92,508490,85.11717442249748,9
0.2,5974,94,508584,85.11866108786612,7
0.2,5975,27,508611,85.1089357429719,6
0.2,5976,12,508623,85.09670403212314,20
0.2,5977,17,508640,85.08531281365005,15
0.2,5978,96,508736,85.08713831744438,6
0.2,5979,95,508831,85.08879598662207,6
0.2,5980,90,508921,85.08961712088279,14
0.2,5981,90,509011,85.0904379806085,11
0.2,5982,85,509096,85.09042286478355,16
0.2,5983,94,509190,85.09191176470588,8
0.2,5984,87,509277,85.0922305764411,16
0.2,5985,90,509367,85.09305045105246,12
0.2,5986,94,509461,85.0945381660264,7
0.2,5987,96,509557,85.09635938543754,6
0.2,5988,94,509651,85.09784605109367,7
0.2,5989,93,509744,85.0991652754591,8
0.2,5990,94,509838,85.10065097646469,7
0.2,5991,96,509934,85.10246995994659,6
0.2,5992,92,510026,85.10362089103954,9
0.2,5993,89,510115,85.10427093760427,12
0.2,5994,91,510206,85.10525437864888,11
0.2,5995,93,510299,85.10657104736491,8
0.2,5996,95,510394,85.1082207770552,7
0.2,5997,90,510484,85.10903634544849,13
0.2,5998,92,510576,85.11018503083848,9
0.2,5999,93,510669,85.1115,8
0.2,6000,94,510763,85.11298116980504,8
0.2,6001,94,510857,85.11446184605131,8
0.2,6002,94,510951,85.1159420289855,7
0.2,6003,96,511047,85.11775483011326,6
0.2,6004,94,511141,85.11923397169026,8
0.2,6005,95,511236,85.12087912087912,6
0.2,6006,82,511318,85.12035958048943,19
0.2,6007,88,511406,85.12083888149135,13
0.2,6008,92,511498,85.12198369112997,10
0.2,6009,94,511592,85.1234608985025,8
0.2,6010,92,511684,85.1246048910331,9
0.2,6011,90,511774,85.12541583499667,11
0.2,6012,94,511868,85.12689173457508,7
0.2,6013,92,511960,85.12803458596608,9
0.2,6014,93,512053,85.12934330839568,8
0.2,6015,93,512146,85.13065159574468,8
0.2,6016,91,512237,85.13162705667276,10
0.2,6017,96,512333,85.13343303423063,6
0.2,6018,-50,512283,85.11098189067951,13
0.2,6019,24,512307,85.10083056478405,9
0.2,6020,94,512401,85.10230858661352,7
0.2,6021,92,512493,85.10345400199269,11
0.2,6022,93,512586,85.10476506724224,9
0.2,6023,94,512680,85.1062416998672,7
0.2,6024,87,512767,85.10655601659751,14
0.2,6025,93,512860,85.10786591437106,8
0.2,6026,92,512952,85.10900945744152,9
0.2,6027,23,512975,85.09870603848707,10
0.2,6028,92,513067,85.0998507215127,9
0.2,6029,26,513093,85.09004975124378,7
0.2,6030,96,513189,85.09185872989553,6
0.2,6031,94,513283,85.09333554376659,7
0.2,6032,94,513377,85.09481186805901,7
0.2,6033,92,513469,85.0959562479284,10
0.2,6034,96,513565,85.09776304888152,6
0.2,6035,89,513654,85.09840954274354,12
0.2,6036,91,513745,85.09938711280438,11
0.2,6037,96,513841,85.10119244783041,6
0.2,6038,91,513932,85.10216923331677,11
0.2,6039,93,514025,85.10347682119205,8
0.2,6040,92,514117,85.10461844065551,9
0.2,6041,93,514210,85.10592519033433,8
0.2,6042,96,514306,85.10772794969387,6
0.2,6043,92,514398,85.10886829913964,9
0.2,6044,95,514493,85.11050454921423,6
0.2,6045,23,514516,85.10023155805492,10
0.2,6046,89,514605,85.10087646766992,12
0.2,6047,95,514700,85.10251322751323,6
0.2,6048,91,514791,85.10348817986444,11
0.2,6049,27,514818,85.09388429752066,6
0.2,6050,93,514911,85.0951908775409,8
0.2,6051,91,515002,85.09616655651024,10
0.2,6052,96,515098,85.09796794977697,6
0.2,6053,95,515193,85.099603567889,6
0.2,6054,96,515289,85.10140379851363,6
0.2,6055,94,515383,85.10287318361955,7
0.2,6056,95,515478,85.10450718177316,6
0.2,6057,96,515574,85.10630571145593,6
0.2,6058,92,515666,85.10744347252022,9
0.2,6059,90,515756,85.10825082508251,11
0.2,6060,23,515779,85.09800362976407,10
0.2,6061,96,515875,85.09980204552953,6
0.2,6062,96,515971,85.10159986805212,6
0.2,6063,96,516067,85.10339709762533,6
0.2,6064,94,516161,85.10486397361913,8
0.2,6065,24,516185,85.09479063633367,8
0.2,6066,96,516281,85.09658809955496,6
0.2,6067,25,516306,85.08668424522084,8
0.2,6068,94,516400,85.08815290822211,7
0.2,6069,24,516424,85.07808896210874,9
0.2,6070,89,516513,85.07873496952726,12
0.2,6071,92,516605,85.07987483530962,9
0.2,6072,94,516699,85.08134365223118,8
0.2,6073,90,516789,85.08215344089562,11
0.2,6074,18,516807,85.07111111111111,14
0.2,6075,94,516901,85.0725806451613,7
0.2,6076,94,516995,85.07404969557348,7
0.2,6077,91,517086,85.07502467917078,11
0.2,6078,92,517178,85.07616384273729,9
0.2,6079,93,517271,85.07746710526315,8
0.2,6080,91,517362,85.07844104588061,10
0.2,6081,89,517451,85.07908582703058,12
0.2,6082,95,517546,85.08071675160282,7
0.2,6083,94,517640,85.08218277449046,7
0.2,6084,93,517733,85.08348397699261,9
0.2,6085,93,517826,85.08478475188959,8
0.2,6086,93,517919,85.08608509939215,8
0.2,6087,95,518014,85.0877135348226,6
0.2,6088,94,518108,85.08917720479553,8
0.2,6089,88,518196,85.0896551724138,13
0.2,6090,94,518290,85.09111804301428,7
0.2,6091,92,518382,85.09225213394616,10
0.2,6092,95,518477,85.09387822090925,6
0.2,6093,94,518571,85.09533967837217,7
0.2,6094,90,518661,85.09614438063987,11
0.2,6095,92,518753,85.09727690288715,9
0.2,6096,89,518842,85.09791700836477,13
0.2,6097,95,518937,85.09954083306002,6
0.2,6098,90,519027,85.10034431874078,11
0.2,6099,96,519123,85.10213114754099,6
0.2,6100,93,519216,85.10342566792329,10
0.2,6101,90,519306,85.10422812192724,11
0.2,6102,92,519398,85.10535802064558,10
0.2,6103,93,519491,85.10665137614679,11
0.2,6104,92,519583,85.1077805077805,9
0.2,6105,90,519673,85.10858172289551,11
0.2,6106,21,519694,85.09808416571148,11
0.2,6107,88,519782,85.09855926653569,13
0.2,6108,92,519874,85.09968898346702,9
0.2,6109,93,519967,85.10098199672667,9
0.2,6110,24,519991,85.09098347242677,8
0.2,6111,92,520083,85.09211387434554,11
0.2,6112,94,520177,85.09357107803042,7
0.2,6113,95,520272,85.09519136408244,6
0.2,6114,94,520366,85.09664758789862,7
0.2,6115,87,520453,85.09695879659908,14
0.2,6116,94,520547,85.09841425535393,8
0.2,6117,86,520633,85.09856162144492,15
0.2,6118,91,520724,85.0995260663507,11
0.2,6119,92,520816,85.10065359477125,9
0.2,6120,94,520910,85.10210749877471,7
0.2,6121,20,520930,85.09147337471414,12
0.2,6122,94,521024,85.09292830311938,7
0.2,6123,95,521119,85.09454604833442,6
0.2,6124,91,521210,85.09551020408163,10
0.2,6125,94,521304,85.09696376101861,10
0.2,6126,94,521398,85.09841684347968,7
0.2,6127,95,521493,85.10003263707571,6
0.2,6128,95,521588,85.10164790341001,9
0.2,6129,85,521673,85.1016313213703,17
0.2,6130,90,521763,85.10243027238623,11
0.2,6131,94,521857,85.10388127853881,8
0.2,6132,94,521951,85.10533181151149,8
0.2,6133,93,522044,85.10661884577763,8
0.2,6134,92,522136,85.1077424612877,9
0.2,6135,89,522225,85.10837679269882,12
0.2,6136,93,522318,85.10966270164576,8
0.2,6137,92,522410,85.11078527207559,10
0.2,6138,95,522505,85.11239615572569,6
0.2,6139,95,522600,85.11400651465799,6
0.2,6140,96,522696,85.11577918905715,6
0.2,6141,93,522789,85.11706284597851,8
0.2,6142,93,522882,85.11834608497477,8
0.2,6143,94,522976,85.11979166666667,8
0.2,6144,89,523065,85.12042310821806,14
0.2,6145,93,523158,85.12170517409697,8
0.2,6146,92,523250,85.12282414185782,11
0.2,6147,90,523340,85.12361743656474,12
0.2,6148,93,523433,85.1248983574565,8
0.2,6149,93,523526,85.12617886178862,8
0.2,6150,92,523618,85.12729637457323,9
0.2,6151,90,523708,85.12808842652795,11
0.2,6152,92,523800,85.12920526572404,9
0.2,6153,92,523892,85.13032174195645,9
0.2,6154,94,523986,85.13176279447603,7
0.2,6155,24,524010,85.12183235867447,8
0.2,6156,91,524101,85.1227870716258,10
0.2,6157,88,524189,85.12325430334525,13
0.2,6158,90,524279,85.12404611138172,11
0.2,6159,95,524374,85.12564935064935,7
0.2,6160,95,524469,85.12725206946924,6
0.2,6161,89,524558,85.1278805582603,12
0.2,6162,94,524652,85.12932013629725,7
0.2,6163,96,524748,85.1310837118754,6
0.2,6164,89,524837,85.13171127331711,12
0.2,6165,92,524929,85.13282517028868,9
0.2,6166,94,525023,85.13426301281012,8
0.2,6167,96,525119,85.13602464332037,6
0.2,6168,93,525212,85.13729940022694,8
0.2,6169,23,525235,85.12722852512155,9
0.2,6170,90,525325,85.12801814940852,11
0.2,6171,95,525420,85.1296176279974,7
0.2,6172,90,525510,85.13040660942815,11
0.2,6173,95,525605,85.1320051830256,7
0.2,6174,94,525699,85.13344129554656,7
0.2,6175,95,525794,85.13503886010362,6
0.2,6176,96,525890,85.13679779828395,6
0.2,6177,93,525983,85.13807057300097,8
0.2,6178,93,526076,85.13934293575012,8
0.2,6179,95,526171,85.14093851132687,8
0.2,6180,95,526266,85.14253357061965,6
0.2,6181,92,526358,85.1436428340343,9
0.2,6182,95,526453,85.14523693999676,6
0.2,6183,95,526548,85.14683053040103,6
0.2,6184,94,526642,85.1482619240097,7
0.2,6185,93,526735,85.14953119948271,8
0.2,6186,92,526827,85.15063843542913,9
0.2,6187,90,526917,85.15142210730446,11
0.2,6188,26,526943,85.14186459848118,9
0.2,6189,91,527034,85.14281098546041,11
0.2,6190,95,527129,85.14440316588596,7
0.2,6191,90,527219,85.14518733850129,11
0.2,6192,92,527311,85.14629420313257,9
0.2,6193,93,527404,85.14756215692606,8
0.2,6194,91,527495,85.14850686037127,10
0.2,6195,96,527591,85.15025823111685,6
0.2,6196,94,527685,85.1516862998225,7
0.2,6197,91,527776,85.15262988060665,12
0.2,6198,95,527871,85.15421842232618,6
0.2,6199,96,527967,85.15596774193548,6
0.2,6200,24,527991,85.14610546686018,8
0.2,6201,94,528085,85.14753305385359,8
0.2,6202,94,528179,85.1489601805578,8
0.2,6203,94,528273,85.15038684719536,7
0.2,6204,91,528364,85.15132957292506,10
0.2,6205,91,528455,85.1522719948437,10
0.2,6206,88,528543,85.1527307878202,14
0.2,6207,95,528638,85.15431701030928,6
0.2,6208,95,528733,85.15590272185537,6
0.2,6209,91,528824,85.15684380032206,10
0.2,6210,93,528917,85.15810658509096,9
0.2,6211,93,529010,85.15936896329684,8
0.2,6212,19,529029,85.1487204249155,14
0.2,6213,94,529123,85.15014483424525,7
0.2,6214,17,529140,85.13917940466614,15
0.2,6215,88,529228,85.13963963963964,15
0.2,6216,90,529318,85.14042142512466,11
0.2,6217,94,529412,85.1418462528144,7
0.2,6218,21,529433,85.13153240070751,11
0.2,6219,93,529526,85.13279742765273,8
0.2,6220,95,529621,85.13438353962385,8
0.2,6221,95,529716,85.13596914175507,6
0.2,6222,92,529808,85.13707215169532,9
0.2,6223,93,529901,85.1383354755784,8
0.2,6224,95,529996,85.13991967871486,7
0.2,6225,93,530089,85.14118213941535,8
0.2,6226,94,530183,85.14260478561106,8
0.2,6227,92,530275,85.14370584457289,9
0.2,6228,92,530367,85.14480655000803,9
0.2,6229,96,530463,85.14654895666132,6
0.2,6230,91,530554,85.14748836462847,10
0.2,6231,95,530649,85.14906931964056,6
0.2,6232,93,530742,85.1503288945933,8
0.2,6233,23,530765,85.14035931985885,10
0.2,6234,94,530859,85.14178027265437,8
0.2,6235,91,530950,85.14271969211033,10
0.2,6236,91,531041,85.14365881032548,10
0.2,6237,91,531132,85.1445976274447,11
0.2,6238,94,531226,85.14601698990222,7
0.2,6239,27,531253,85.13669871794872,6
0.2,6240,89,531342,85.13731773754206,12
0.2,6241,91,531433,85.13825696892022,10
0.2,6242,75,531508,85.13663302899248,27
0.2,6243,92,531600,85.13773222293402,9
0.2,6244,94,531694,85.13915132105684,7
0.2,6245,94,531788,85.14056996477746,8
0.2,6246,93,531881,85.14182807747719,8
0.2,6247,93,531974,85.14308578745198,8
0.2,6248,94,532068,85.14450312049928,7
0.2,6249,92,532160,85.1456,9
0.2,6250,91,532251,85.14653655415134,10
0.2,6251,92,532343,85.1476327575176,10
0.2,6252,87,532430,85.14792899408285,14
0.2,6253,84,532514,85.14774544291653,17
0.2,6254,87,532601,85.1480415667466,15
0.2,6255,18,532619,85.13730818414322,14
0.2,6256,90,532709,85.13808534441425,11
0.2,6257,94,532803,85.13950143815916,7
0.2,6258,94,532897,85.14091707940565,7
0.2,6259,92,532989,85.14201277955272,9
0.2,6260,91,533080,85.142948410797,10
0.2,6261,96,533176,85.1446822101565,6
0.2,6262,92,533268,85.14577678428869,9
0.2,6263,94,533362,85.14719029374201,7
0.2,6264,93,533455,85.14844373503591,8
0.2,6265,86,533541,85.1485796361315,15
0.2,6266,90,533631,85.14935375777884,11
0.2,6267,92,533723,85.15044671346521,9
0.2,6268,94,533817,85.15185835061413,7
0.2,6269,93,533910,85.1531100478469,8
0.2,6270,94,534004,85.15452081007814,7
0.2,6271,92,534096,85.15561224489795,10
0.2,6272,89,534185,85.15622509166268,12
0.2,6273,93,534278,85.15747529486771,8
0.2,6274,92,534370,85.15856573705179,10
0.2,6275,94,534464,85.15997450605481,7
0.2,6276,27,534491,85.15070893739048,6
0.2,6277,24,534515,85.14096846129341,9
0.2,6278,94,534609,85.14237935977066,7
0.2,6279,89,534698,85.14299363057324,12
0.2,6280,94,534792,85.14440375736348,8
0.2,6281,95,534887,85.14597262018465,6
0.2,6282,90,534977,85.14674518542098,13
0.2,6283,93,535070,85.1479949077021,8
0.2,6284,93,535163,85.14924423229913,8
0.2,6285,96,535259,85.15097041043589,6
0.2,6286,94,535353,85.15237792269762,7
0.2,6287,92,535445,85.15346692111959,9
0.2,6288,94,535539,85.15487358880586,7
0.2,6289,94,535633,85.15627980922099,7
0.2,6290,91,535724,85.15720871085678,11
0.2,6291,95,535819,85.15877304513668,7
0.2,6292,96,535915,85.16049578897187,7
0.2,6293,96,536011,85.16221798538291,6
0.2,6294,94,536105,85.16362192216044,8
0.2,6295,94,536199,85.16502541296062,7
0.2,6296,96,536295,85.16674606955694,6
0.2,6297,25,536320,85.15719275960622,8
0.2,6298,95,536415,85.15875535799333,8
0.2,6299,93,536508,85.16,11
0.2,6300,96,536604,85.16172036184733,6
0.2,6301,93,536697,85.16296413836878,8
0.2,6302,86,536783,85.16309693796605,15
0.2,6303,96,536879,85.16481598984771,6
0.2,6304,89,536968,85.16542426645519,12
0.2,6305,96,537064,85.16714240405963,6
0.2,6306,96,537160,85.16885999682891,6
0.2,6307,87,537247,85.16915028535193,14
0.2,6308,91,537338,85.17007449675067,11
0.2,6309,92,537430,85.17115689381933,9
0.2,6310,84,537514,85.1709713199176,17
0.2,6311,84,537598,85.17078580481622,17
0.2,6312,26,537624,85.16141295738952,7
0.2,6313,95,537719,85.16297117516629,6
0.2,6314,94,537813,85.1643705463183,7
0.2,6315,82,537895,85.16386953768207,20
0.2,6316,95,537990,85.16542662656325,6
0.2,6317,93,538083,85.16666666666667,8
0.2,6318,93,538176,85.16790631429024,8
0.2,6319,96,538272,85.16962025316455,7
0.2,6320,85,538357,85.16959341876286,17
0.2,6321,94,538451,85.1709901929769,8
0.2,6322,24,538475,85.16131583109284,9
0.2,6323,24,538499,85.15164452877926,8
0.2,6324,94,538593,85.15304347826087,8
0.2,6325,94,538687,85.15444198545684,7
0.2,6326,94,538781,85.1558400505769,8
0.2,6327,93,538874,85.15707964601769,8
0.2,6328,90,538964,85.15784484120714,11
0.2,6329,87,539051,85.15813586097946,14
0.2,6330,92,539143,85.15921655346706,9
0.2,6331,87,539230,85.1595072646873,14
0.2,6332,92,539322,85.1605873993368,9
0.2,6333,93,539415,85.16182507104516,8
0.2,6334,92,539507,85.1629044988161,9
0.2,6335,96,539603,85.1646148989899,6
0.2,6336,92,539695,85.16569354584188,9
0.2,6337,92,539787,85.16677185231934,9
0.2,6338,95,539882,85.16832307935006,6
0.2,6339,96,539978,85.17003154574132,6
0.2,6340,94,540072,85.1714240656048,7
0.2,6341,93,540165,85.17265846736045,8
0.2,6342,89,540254,85.17326186347154,12
0.2,6343,92,540346,85.17433795712485,9
0.2,6344,89,540435,85.17494089834516,12
0.2,6345,92,540527,85.17601638827608,9
0.2,6346,87,540614,85.17630376555853,14
0.2,6347,89,540703,85.1769061121613,12
0.2,6348,92,540795,85.17798078437549,9
0.2,6349,96,540891,85.17968503937009,6
0.2,6350,89,540980,85.18028656904424,12
0.2,6351,93,541073,85.1815176322418,8
0.2,6352,95,541168,85.18306311978593,6
0.2,6353,94,541262,85.18445073969153,7
0.2,6354,96,541358,85.1861526357199,6
0.2,6355,92,541450,85.18722466960352,9
0.2,6356,93,541543,85.18845367311624,8
0.2,6357,92,541635,85.1895250078641,9
0.2,6358,94,541729,85.1909105205221,7
0.2,6359,95,541824,85.19245283018869,7
0.2,6360,95,541919,85.19399465492847,6
0.2,6361,94,542013,85.19537881169444,7
0.2,6362,94,542107,85.1967625333962,7
0.2,6363,92,542199,85.19783155248271,9
0.2,6364,92,542291,85.19890023566379,9
0.2,6365,25,542316,85.1894439208294,8
0.2,6366,92,542408,85.19051358567614,11
0.2,6367,95,542503,85.1920540201005,7
0.2,6368,93,542596,85.19327994975663,8
0.2,6369,94,542690,85.19466248037676,7
0.2,6370,93,542783,85.1958876157589,8
0.2,6371,95,542878,85.19742623979913,6
0.2,6372,96,542974,85.19912129295466,6
0.2,6373,93,543067,85.20034515218073,8
0.2,6374,91,543158,85.20125490196078,10
0.2,6375,92,543250,85.20232120451693,9
0.2,6376,94,543344,85.2037007997491,7
0.2,6377,95,543439,85.2052367513327,6
0.2,6378,92,543531,85.20630192820191,9
0.2,6379,93,543624,85.20752351097178,10
0.2,6380,91,543715,85.20843128036358,10
0.2,6381,95,543810,85.20996552804763,8
0.2,6382,95,543905,85.21149929500235,6
0.2,6383,94,543999,85.21287593984962,7
0.2,6384,92,544091,85.21393891934221,9
0.2,6385,93,544184,85.21515815847165,8
0.2,6386,92,544276,85.21622044778456,9
0.2,6387,92,544368,85.21728240450845,9
0.2,6388,90,544458,85.21803099076539,11
0.2,6389,94,544552,85.21940532081378,7
0.2,6390,94,544646,85.22077922077922,7
0.2,6391,86,544732,85.22090112640801,15
0.2,6392,95,544827,85.22243078366964,6
0.2,6393,90,544917,85.22317797935564,11
0.2,6394,96,545013,85.22486317435497,6
0.2,6395,91,545104,85.22576610381489,10
0.2,6396,92,545196,85.22682507425355,9
0.2,6397,91,545287,85.22772741481712,10
0.2,6398,95,545382,85.22925457102673,6
0.2,6399,94,545476,85.230625,7
0.2,6400,93,545569,85.23183877519138,10
0.2,6401,90,545659,85.23258356763512,11
0.2,6402,90,545749,85.23332812744026,11
0.2,6403,93,545842,85.23454091193004,9
0.2,6404,90,545932,85.23528493364559,11
0.2,6405,94,546026,85.23665313768342,7
0.2,6406,92,546118,85.23770875604808,9
0.2,6407,92,546210,85.23876404494382,9
0.2,6408,94,546304,85.24013106568887,7
0.2,6409,95,546399,85.24165366614665,6
0.2,6410,94,546493,85.24301980970208,7
0.2,6411,94,546587,85.24438552713661,7
0.2,6412,11,546598,85.23280835802277,21
0.2,6413,26,546624,85.22357343311506,8
0.2,6414,91,546715,85.2244738893219,11
0.2,6415,91,546806,85.22537406483791,10
0.2,6416,90,546896,85.22611812373383,11
0.2,6417,92,546988,85.22717357432222,9
0.2,6418,92,547080,85.22822869605858,9
0.2,6419,94,547174,85.22959501557632,7
0.2,6420,94,547268,85.23096090951566,7
0.2,6421,23,547291,85.22127063220181,10
0.2,6422,93,547384,85.22248170636774,8
0.2,6423,93,547477,85.22369240348692,8
0.2,6424,15,547492,85.2127626459144,18
0.2,6425,92,547584,85.21381886087768,9
0.2,6426,95,547679,85.21534152792906,6
0.2,6427,94,547773,85.21670815183572,7
0.2,6428,91,547864,85.21760771504123,11
0.2,6429,89,547953,85.21819595645412,12
0.2,6430,96,548049,85.2198724926139,6
0.2,6431,91,548140,85.2207711442786,10
0.2,6432,87,548227,85.22104772267993,15
0.2,6433,96,548323,85.2227230338825,6
0.2,6434,86,548409,85.22284382284383,15
0.2,6435,92,548501,85.2238968303294,9
0.2,6436,23,548524,85.21423023147429,10
0.2,6437,87,548611,85.21450761105933,16
0.2,6438,90,548701,85.21525081534399,12
0.2,6439,88,548789,85.21568322981366,13
0.2,6440,92,548881,85.21673653159448,9
0.2,6441,94,548975,85.21809996895374,7
0.2,6442,91,549066,85.21899736147758,10
0.2,6443,89,549155,85.21958410924891,12
0.2,6444,91,549246,85.22048099301784,11
0.2,6445,87,549333,85.22075705864101,14
0.2,6446,93,549426,85.22196370404839,8
0.2,6447,95,549521,85.22348014888337,6
0.2,6448,91,549612,85.22437587222825,10
0.2,6449,93,549705,85.22558139534884,8
0.2,6450,91,549796,85.22647651526896,10
0.2,6451,93,549889,85.22768133911966,8
0.2,6452,87,549976,85.22795598946226,15
0.2,6453,93,550069,85.22916021072203,8
0.2,6454,93,550162,85.2303640588691,8
0.2,6455,92,550254,85.2314126394052,10
0.2,6456,94,550348,85.23277063651851,7
0.2,6457,94,550442,85.23412821306906,7
0.2,6458,94,550536,85.2354853692522,7
0.2,6459,92,550628,85.23653250773994,9
0.2,6460,92,550720,85.23757932208636,9
0.2,6461,96,550816,85.23924481584649,6
0.2,6462,21,550837,85.22930527618753,13
0.2,6463,94,550931,85.23066212871286,7
0.2,6464,94,551025,85.23201856148492,7
0.2,6465,89,551114,85.232601299103,12
0.2,6466,96,551210,85.23426627493428,6
0.2,6467,93,551303,85.23546691403834,8
0.2,6468,91,551394,85.23635801514918,10
0.2,6469,92,551486,85.23740340030912,10
0.2,6470,93,551579,85.23860299799104,8
0.2,6471,89,551668,85.23918417799753,12
0.2,6472,27,551695,85.23018693032597,6
0.2,6473,96,551791,85.23185047883842,6
0.2,6474,95,551886,85.23335907335907,6
0.2,6475,96,551982,85.23502161828289,6
0.2,6476,91,552073,85.23591168750966,10
0.2,6477,88,552161,85.23633837604199,13
0.2,6478,90,552251,85.23707362247261,11
0.2,6479,91,552342,85.23796296296297,10
0.2,6480,94,552436,85.23931492053696,7
0.2,6481,94,552530,85.24066646096884,8
0.2,6482,85,552615,85.24062933826931,17
0.2,6483,94,552709,85.24198025909932,7
0.2,6484,96,552805,85.24363916730917,6
0.2,6485,92,552897,85.24468085106383,10
0.2,6486,93,552990,85.24587636812086,8
0.2,6487,94,553084,85.24722564734896,7
0.2,6488,94,553178,85.24857451071043,8
0.2,6489,95,553273,85.25007704160247,7
0.2,6490,95,553368,85.25157910953628,6
0.2,6491,91,553459,85.25246457178065,11
0.2,6492,92,553551,85.25350377329431,9
0.2,6493,94,553645,85.25485063135201,8
0.2,6494,94,553739,85.25619707467283,8
0.2,6495,94,553833,85.25754310344827,9
0.2,6496,92,553925,85.25858088348468,10
0.2,6497,94,554019,85.25992613111727,8
0.2,6498,93,554112,85.26111709493769,8
0.2,6499,96,554208,85.26276923076924,6
0.2,6500,95,554303,85.26426703584065,6
0.2,6501,94,554397,85.26561058135958,7
0.2,6502,94,554491,85.26695371367062,7
0.2,6503,86,554577,85.26706642066421,15
0.2,6504,96,554673,85.26871637202152,6
0.2,6505,95,554768,85.27021211189671,6
0.2,6506,92,554860,85.27124635008452,9
0.2,6507,91,554951,85.2721266133989,10
0.2,6508,92,555043,85.27316023966816,9
0.2,6509,88,555131,85.27357910906298,13
0.2,6510,92,555223,85.27461219474735,9
0.2,6511,95,555318,85.27610565110565,6
0.2,6512,94,555412,85.27744510978044,8
0.2,6513,89,555501,85.27801657967454,12
0.2,6514,95,555596,85.27950882578665,7
0.2,6515,96,555692,85.28115408225905,6
0.2,6516,93,555785,85.2823384993095,8
0.2,6517,92,555877,85.28336913163547,9
0.2,6518,94,555971,85.28470624328885,8
0.2,6519,95,556066,85.2861963190184,6
0.2,6520,25,556091,85.27695138782396,8
0.2,6521,85,556176,85.27690892364305,17
0.2,6522,91,556267,85.2777862946497,10
0.2,6523,19,556286,85.26762722256285,13
0.2,6524,96,556382,85.26927203065134,6
0.2,6525,94,556476,85.27060986821942,7
0.2,6526,94,556570,85.27194729584802,7
0.2,6527,94,556664,85.27328431372548,7
0.2,6528,95,556759,85.2747740848522,6
0.2,6529,94,556853,85.2761102603369,7
0.2,6530,94,556947,85.27744602664217,8
0.2,6531,93,557040,85.27862829148806,8
0.2,6532,87,557127,85.27889178019286,15
0.2,6533,95,557222,85.28037955310683,7
0.2,6534,90,557312,85.28110175975516,11
0.2,6535,92,557404,85.28212974296206,9
0.2,6536,92,557496,85.28315741165672,9
0.2,6537,25,557521,85.2739369837871,7
0.2,6538,17,557538,85.26349594739257,15
0.2,6539,96,557634,85.2651376146789,6
0.2,6540,88,557722,85.26555572542425,13
0.2,6541,95,557817,85.26704371751758,6
0.2,6542,92,557909,85.26807274950329,9
0.2,6543,94,558003,85.26940709046455,8
0.2,6544,90,558093,85.27012987012986,11
0.2,6545,93,558186,85.27131072410633,8
0.2,6546,86,558272,85.27142202535512,16
0.2,6547,94,558366,85.27275503970678,9
0.2,6548,87,558453,85.27301878149336,14
0.2,6549,89,558542,85.27358778625954,12
0.2,6550,95,558637,85.27507250801405,6
0.2,6551,93,558730,85.27625152625153,8
0.2,6552,23,558753,85.26674805432626,9
0.2,6553,90,558843,85.2674702471773,11
0.2,6554,95,558938,85.26895499618611,7
0.2,6555,90,559028,85.26967663209274,11
0.2,6556,94,559122,85.27100808296477,8
0.2,6557,93,559215,85.27218664226899,8
0.2,6558,94,559309,85.27351730446715,7
0.2,6559,17,559326,85.26310975609756,16
0.2,6560,94,559420,85.26444139612863,8
0.2,6561,94,559514,85.26577263029564,7
0.2,6562,90,559604,85.26649398141095,11
0.2,6563,92,559696,85.26751980499695,9
0.2,6564,90,559786,85.26824067022086,11
0.2,6565,14,559800,85.25738653670423,18
0.2,6566,94,559894,85.25871783158215,7
0.2,6567,92,559986,85.25974421437272,9
0.2,6568,93,560079,85.26092251484245,8
0.2,6569,-44,560035,85.24124809741248,8
0.2,6570,96,560131,85.24288540556992,6
0.2,6571,95,560226,85.24437005477785,6
0.2,6572,96,560322,85.24600638977635,6
0.2,6573,90,560412,85.24672954061454,11
0.2,6574,88,560500,85.24714828897338,13
0.2,6575,91,560591,85.24802311435523,10
0.2,6576,89,560680,85.24859358370078,12
0.2,6577,91,560771,85.24946792338096,10
0.2,6578,96,560867,85.25110199118407,6
0.2,6579,93,560960,85.25227963525836,9
0.2,6580,93,561053,85.25345692144052,8
0.2,6581,15,561068,85.24278334852629,17
0.2,6582,1,561069,85.22998632842169,31
0.2,6583,96,561165,85.23162211421628,6
0.2,6584,96,561261,85.23325740318907,6
0.2,6585,95,561356,85.23474035833587,6
0.2,6586,91,561447,85.23561560649765,11
0.2,6587,90,561537,85.23633879781421,12
0.2,6588,92,561629,85.23736530581272,10
0.2,6589,90,561719,85.2380880121396,11
0.2,6590,94,561813,85.23941738734638,7
0.2,6591,92,561905,85.24044296116504,9
0.2,6592,96,562001,85.2420749279539,6
0.2,6593,94,562095,85.24340309372157,8
0.2,6594,88,562183,85.24382107657316,14
0.2,6595,93,562276,85.24499696785931,8
0.2,6596,92,562368,85.24602091859936,9
0.2,6597,95,562463,85.2474992421946,7
0.2,6598,94,562557,85.24882557963328,7
0.2,6599,96,562653,85.25045454545455,6
0.2,6600,93,562746,85.25162854113013,8
0.2,6601,92,562838,85.25265071190549,10
0.2,6602,93,562931,85.25382401938512,9
0.2,6603,89,563020,85.25439127801333,12
0.2,6604,94,563114,85.2557153671461,7
0.2,6605,95,563209,85.25719043293975,7
0.2,6606,92,563301,85.2582109883457,10
0.2,6607,95,563396,85.25968523002422,7
0.2,6608,94,563490,85.26100771674989,7
0.2,6609,94,563584,85.26232980332829,8
0.2,6610,91,563675,85.2631977008017,10
0.2,6611,-48,563627,85.2430429522081,11
0.2,6612,89,563716,85.24361106910631,12
0.2,6613,93,563809,85.24478379195645,8
0.2,6614,95,563904,85.24625850340136,6
0.2,6615,94,563998,85.24758162031439,8
0.2,6616,93,564091,85.24875321142511,8
0.2,6617,96,564187,85.2503777576307,6
0.2,6618,96,564283,85.25200181296269,6
0.2,6619,93,564376,85.25317220543806,8
0.2,6620,92,564468,85.25419120978704,9
0.2,6621,93,564561,85.25536091815161,9
0.2,6622,93,564654,85.25653027329005,8
0.2,6623,94,564748,85.2578502415459,7
0.2,6624,26,564774,85.24890566037736,8
0.2,6625,93,564867,85.25007546030788,8
0.2,6626,92,564959,85.25109400935567,9
0.2,6627,92,565051,85.25211225105612,9
0.2,6628,92,565143,85.25313018554834,9
0.2,6629,86,565229,85.25324283559577,15
0.2,6630,91,565320,85.25410948574876,11
0.2,6631,94,565414,85.25542822677926,7
0.2,6632,21,565435,85.24574099200964,12
0.2,6633,89,565524,85.24630690382877,12
0.2,6634,84,565608,85.24611906556142,17
0.2,6635,96,565704,85.24773960216999,6
0.2,6636,94,565798,85.24905830947718,7
0.2,6637,91,565889,85.24992467610726,11
0.2,6638,90,565979,85.25064015665009,11
0.2,6639,94,566073,85.2519578313253,9
0.2,6640,11,566084,85.24077699141695,21
0.2,6641,94,566178,85.24209575429087,7
0.2,6642,96,566274,85.24371518892067,6
0.2,6643,88,566362,85.24413004214328,13
0.2,6644,93,566455,85.24529721595184,8
0.2,6645,21,566476,85.23563045440866,11
0.2,6646,24,566500,85.22641793290207,9
0.2,6647,94,566594,85.2277376654633,8
0.2,6648,25,566619,85.2186795006768,8
0.2,6649,96,566715,85.2203007518797,6
0.2,6650,87,566802,85.22056833558864,15
0.2,6651,96,566898,85.22218881539386,6
0.2,6652,85,566983,85.22215541860815,16
0.2,6653,94,567077,85.2234746017433,7
0.2,6654,96,567173,85.22509391435011,6
0.2,6655,93,567266,85.22626201923077,9
0.2,6656,27,567293,85.21751539732612,6
0.2,6657,96,567389,85.21913487533794,6
0.2,6658,89,567478,85.21970265805676,15
0.2,6659,96,567574,85.22132132132133,6
0.2,6660,93,567667,85.22248911574839,8
0.2,6661,27,567694,85.21374962473732,6
0.2,6662,95,567789,85.21521837010356,7
0.2,6663,95,567884,85.21668667466987,6
0.2,6664,93,567977,85.21785446361591,8
0.2,6665,25,568002,85.2088208820882,8
0.2,6666,92,568094,85.2098395080246,10
0.2,6667,93,568187,85.2110077984403,9
0.2,6668,91,568278,85.21187584345479,10
0.2,6669,96,568374,85.21349325337331,6
0.2,6670,93,568467,85.21466047069404,8
0.2,6671,96,568563,85.21627697841727,7
0.2,6672,94,568657,85.21759328637795,7
0.2,6673,90,568747,85.21830985915493,11
0.2,6674,93,568840,85.21947565543071,8
0.2,6675,88,568928,85.21989215098861,13
0.2,6676,95,569023,85.22135689680995,6
0.2,6677,94,569117,85.22267145852051,7
0.2,6678,92,569209,85.22368618056595,9
0.2,6679,95,569304,85.2251497005988,6
0.2,6680,87,569391,85.22541535698248,16
0.2,6681,19,569410,85.21550434001796,13
0.2,6682,92,569502,85.21651952715847,9
0.2,6683,93,569595,85.21768402154399,9
0.2,6684,94,569689,85.21899775617054,7
0.2,6685,92,569781,85.22001196530063,10
0.2,6686,96,569877,85.2216240466577,6
0.2,6687,95,569972,85.22308612440192,7
0.2,6688,25,569997,85.21408282254447,8
0.2,6689,91,570088,85.21494768310912,10
0.2,6690,94,570182,85.21626064863248,7
0.2,6691,90,570272,85.21697549312611,11
0.2,6692,96,570368,85.21858658299716,6
0.2,6693,95,570463,85.22004780400358,7
0.2,6694,95,570558,85.22150858849888,7
0.2,6695,89,570647,85.22207287933094,12
0.2,6696,92,570739,85.22308496341645,9
0.2,6697,96,570835,85.2246939384891,6
0.2,6698,93,570928,85.22585460516495,8
0.2,6699,13,570941,85.21507462686567,20
0.2,6700,92,571033,85.21608715117146,10
0.2,6701,21,571054,85.20650552074008,12
0.2,6702,94,571148,85.20781739519619,7
0.2,6703,96,571244,85.20942720763723,6
0.2,6704,95,571339,85.21088739746457,6
0.2,6705,89,571428,85.21145243065911,12
0.2,6706,89,571517,85.21201729536305,12
0.2,6707,90,571607,85.21273106738224,11
0.2,6708,24,571631,85.20360709494709,9
0.2,6709,92,571723,85.20461997019375,9
0.2,6710,94,571817,85.20593056176426,7
0.2,6711,93,571910,85.20709177592371,8
0.2,6712,92,572002,85.20810367942798,9
0.2,6713,93,572095,85.20926422400953,8
0.2,6714,93,572188,85.21042442293373,8
0.2,6715,91,572279,85.21128648004765,11
0.2,6716,26,572305,85.20247134137264,7
0.2,6717,89,572394,85.20303661804108,13
0.2,6718,96,572490,85.20464354814705,6
0.2,6719,86,572576,85.20476190476191,15
0.2,6720,93,572669,85.20592173783663,9
0.2,6721,94,572763,85.20722999107409,9
0.2,6722,96,572859,85.20883534136546,6
0.2,6723,91,572950,85.20969660916121,10
0.2,6724,94,573044,85.21100371747212,7
0.2,6725,96,573140,85.2126077906631,6
0.2,6726,91,573231,85.21346811357218,10
0.2,6727,95,573326,85.21492271105826,7
0.2,6728,90,573416,85.21563382374795,11
0.2,6729,96,573512,85.21723625557206,6
0.2,6730,80,573592,85.21646114990344,21
0.2,6731,95,573687,85.21791443850267,6
0.2,6732,88,573775,85.21832763998218,13
0.2,6733,93,573868,85.21948321948322,10
0.2,6734,22,573890,85.21009651076466,12
0.2,6735,94,573984,85.21140142517815,8
0.2,6736,87,574071,85.2116669140567,15
0.2,6737,92,574163,85.21267438409023,11
0.2,6738,96,574259,85.21427511500222,6
0.2,6739,95,574354,85.21572700296736,6
0.2,6740,88,574442,85.21614003856995,14
0.2,6741,92,574534,85.21714624740433,9
0.2,6742,83,574617,85.21681744030847,18
0.2,6743,89,574706,85.21737841043891,12
0.2,6744,95,574801,85.21882876204596,7
0.2,6745,91,574892,85.2196857396976,11
0.2,6746,93,574985,85.22083889135912,8
0.2,6747,94,575079,85.22213989330172,7
0.2,6748,21,575100,85.21262409245814,11
0.2,6749,96,575196,85.21422222222222,6
0.2,6750,90,575286,85.21493112131536,11
0.2,6751,94,575380,85.21623222748815,7
0.2,6752,95,575475,85.21768103065304,9
0.2,6753,15,575490,85.20728457210542,17
0.2,6754,94,575584,85.20858623242043,7
0.2,6755,95,575679,85.21003552397869,6
0.2,6756,91,575770,85.21089240787332,10
0.2,6757,93,575863,85.21204498372299,10
0.2,6758,92,575955,85.21304926764314,10
0.2,6759,95,576050,85.21449704142012,6
0.2,6760,94,576144,85.21579647981068,7
0.2,6761,90,576234,85.21650399290151,11
0.2,6762,95,576329,85.21795061363301,6
0.2,6763,21,576350,85.20845653459492,11
0.2,6764,94,576444,85.20975609756097,7
0.2,6765,91,576535,85.21061188294414,11
0.2,6766,94,576629,85.21191074331314,8
0.2,6767,-49,576580,85.1920803782506,12
0.2,6768,85,576665,85.1920520017728,16
0.2,6769,86,576751,85.19217134416543,16
0.2,6770,92,576843,85.19317678334072,9
0.2,6771,90,576933,85.1938865918488,11
0.2,6772,96,577029,85.19548206112505,6
0.2,6773,87,577116,85.19574844995572,15
0.2,6774,93,577209,85.19690036900369,8
0.2,6775,18,577227,85.18698347107438,16
0.2,6776,91,577318,85.18784122768187,10
0.2,6777,91,577409,85.18869873118913,10
0.2,6778,96,577505,85.19029355362147,6
0.2,6779,95,577600,85.19174041297936,6
0.2,6780,21,577621,85.18227400088483,12
0.2,6781,92,577713,85.18327926865231,9
0.2,6782,90,577803,85.18398938522778,12
0.2,6783,96,577899,85.18558372641509,6
0.2,6784,26,577925,85.17686072218129,7
0.2,6785,92,578017,85.17786619510757,9
0.2,6786,92,578109,85.17887137174009,9
0.2,6787,94,578203,85.18017088980554,7
0.2,6788,93,578296,85.18132272794226,8
0.2,6789,94,578390,85.18262150220913,7
0.2,6790,22,578412,85.17331762627006,10
0.2,6791,94,578506,85.174617196702,7
0.2,6792,88,578594,85.17503312233181,13
0.2,6793,96,578690,85.17662643508979,6
0.2,6794,95,578785,85.17807211184694,6
0.2,6795,94,578879,85.17937021777516,7
0.2,6796,95,578974,85.18081506547006,6
0.2,6797,94,579068,85.18211238599588,7
0.2,6798,89,579157,85.18267392263569,14
0.2,6799,90,579247,85.18338235294118,11
0.2,6800,91,579338,85.18423761211587,10
0.2,6801,92,579430,85.18523963540136,9
0.2,6802,93,579523,85.18638835807732,8
0.2,6803,92,579615,85.1873897707231,10
0.2,6804,85,579700,85.18736223365173,17
0.2,6805,92,579792,85.1883632089333,9
0.2,6806,94,579886,85.18965770530336,7
0.2,6807,24,579910,85.18066980023502,9
0.2,6808,27,579937,85.1721251285064,6
0.2,6809,87,580024,85.17239353891337,14
0.2,6810,24,580048,85.1634121274409,8
0.2,6811,90,580138,85.16412213740458,11
0.2,6812,96,580234,85.16571260824894,6
0.2,6813,94,580328,85.167009098914,7
0.2,6814,90,580418,85.1677182685253,12
0.2,6815,92,580510,85.16872065727699,9
0.2,6816,95,580605,85.17016282822355,6
0.2,6817,90,580695,85.17087122323262,11
0.2,6818,93,580788,85.17201935767707,8
0.2,6819,91,580879,85.17287390029325,10
0.2,6820,25,580904,85.16405219176075,8
0.2,6821,94,580998,85.16534740545295,7
0.2,6822,90,581088,85.16605598710245,11
0.2,6823,94,581182,85.16735052754983,7
0.2,6824,86,581268,85.16747252747253,15
0.2,6825,92,581360,85.16847348373865,9
0.2,6826,91,581451,85.16932766954739,10
0.2,6827,96,581547,85.17091388400704,6
0.2,6828,-15,581532,85.15624542392737,49
0.2,6829,94,581626,85.1575402635432,7
0.2,6830,88,581714,85.15795637534768,13
0.2,6831,95,581809,85.15939695550351,7
0.2,6832,93,581902,85.16054441680082,8
0.2,6833,92,581994,85.16154521510097,9
0.2,6834,93,582087,85.16269202633504,8
0.2,6835,90,582177,85.16339964891749,12
0.2,6836,90,582267,85.16410706450198,11
0.2,6837,94,582361,85.16539923954373,7
0.2,6838,93,582454,85.16654481649364,10
0.2,6839,92,582546,85.16754385964913,10
0.2,6840,93,582639,85.16868878818886,8
0.2,6841,88,582727,85.16910260157849,13
0.2,6842,92,582819,85.17010083296799,9
0.2,6843,94,582913,85.17139099941555,7
0.2,6844,92,583005,85.17238860482104,9
0.2,6845,94,583099,85.17367806018113,8
0.2,6846,92,583191,85.17467504016358,9
0.2,6847,93,583284,85.17581775700934,8
0.2,6848,95,583379,85.17725215359907,6
0.2,6849,93,583472,85.17839416058393,9
0.2,6850,90,583562,85.17909794190629,12
0.2,6851,94,583656,85.18038528896672,7
0.2,6852,87,583743,85.18065080986429,14
0.2,6853,95,583838,85.18208345491684,6
0.2,6854,96,583934,85.18366156090445,6
0.2,6855,88,584022,85.1840723453909,13
0.2,6856,95,584117,85.18550386466384,6
0.2,6857,95,584212,85.18693496646253,6
0.2,6858,94,584306,85.18821985712204,8
0.2,6859,93,584399,85.18935860058309,8
0.2,6860,94,584493,85.19064276344557,7
0.2,6861,94,584587,85.19192655202565,8
0.2,6862,95,584682,85.19335567536064,7
0.2,6863,91,584773,85.19420163170163,10
0.2,6864,95,584868,85.19563000728333,6
0.2,6865,95,584963,85.1970579667929,8
0.2,6866,94,585057,85.19833988641328,7
0.2,6867,94,585151,85.1996214327315,7
0.2,6868,94,585245,85.20090260591061,7
0.2,6869,94,585339,85.20218340611353,7
0.2,6870,93,585432,85.20331829428031,8
0.2,6871,91,585523,85.2041618160652,10
0.2,6872,93,585616,85.20529608613415,9
0.2,6873,92,585708,85.20628455048006,9
0.2,6874,91,585799,85.20712727272728,10
0.2,6875,96,585895,85.2086969168121,6
0.2,6876,92,585987,85.20968445543114,9
0.2,6877,95,586082,85.21110788019773,7
0.2,6878,96,586178,85.21267626108445,6
0.2,6879,91,586269,85.21351744186046,10
0.2,6880,89,586358,85.21406772271472,12
0.2,6881,94,586452,85.2153443766347,7
0.2,6882,89,586541,85.2158942321662,12
0.2,6883,90,586631,85.21658919233003,11
0.2,6884,94,586725,85.21786492374727,8
0.2,6885,91,586816,85.21870461806564,11
0.2,6886,92,586908,85.21968926963845,9
0.2,6887,94,587002,85.22096399535424,7
0.2,6888,91,587093,85.22180287414719,10
0.2,6889,91,587184,85.22264150943396,10
0.2,6890,93,587277,85.22377013495864,8
0.2,6891,87,587364,85.22402785838653,14
0.2,6892,91,587455,85.22486580589003,10
0.2,6893,86,587541,85.22497824194951,16
0.2,6894,93,587634,85.22610587382161,9
0.2,6895,94,587728,85.22737819025522,7
0.2,6896,94,587822,85.22865013774104,7
0.2,6897,93,587915,85.22977674688316,8
0.2,6898,23,587938,85.22075663139586,10
0.2,6899,90,588028,85.22144927536232,11
0.2,6900,93,588121,85.22257643819736,8
0.2,6901,92,588213,85.22355838887279,9
0.2,6902,95,588308,85.22497464870347,8
0.2,6903,93,588401,85.22610081112398,8
0.2,6904,91,588492,85.22693700217233,11
0.2,6905,92,588584,85.22791775267883,9
0.2,6906,94,588678,85.22918778051252,7
0.2,6907,96,588774,85.23074696004632,6
0.2,6908,86,588860,85.23085830076711,15
0.2,6909,90,588950,85.2315484804631,11
0.2,6910,93,589043,85.23267255100565,9
0.2,6911,94,589137,85.23394097222223,8
0.2,6912,90,589227,85.23463040648055,11
0.2,6913,96,589323,85.23618744576223,6
0.2,6914,94,589417,85.23745480838757,8
0.2,6915,93,589510,85.23857721226142,8
0.2,6916,95,589605,85.23998843429233,6
0.2,6917,91,589696,85.24082104654525,10
0.2,6918,89,589785,85.24136435901141,12
0.2,6919,95,589880,85.24277456647398,6
0.2,6920,96,589976,85.24432885421182,6
0.2,6921,94,590070,85.24559375902918,7
0.2,6922,87,590157,85.24584717607974,14
0.2,6923,94,590251,85.24711149624494,7
0.2,6924,24,590275,85.23826714801444,8
0.2,6925,90,590365,85.23895466358648,11
0.2,6926,26,590391,85.23040277176267,8
0.2,6927,80,590471,85.22964780600462,21
0.2,6928,94,590565,85.23091355173906,7
0.2,6929,92,590657,85.23189033189033,9
0.2,6930,89,590746,85.23243399220891,12
0.2,6931,96,590842,85.233987305251,6
0.2,6932,94,590936,85.23525169479302,7
0.2,6933,94,591030,85.23651571964234,7
0.2,6934,24,591054,85.22768565248738,11
0.2,6935,82,591136,85.22722029988466,19
0.2,6936,96,591232,85.22877324491856,6
0.2,6937,87,591319,85.22902853848372,15
0.2,6938,95,591414,85.23043666234328,6
0.2,6939,91,591505,85.23126801152738,10
0.2,6940,96,591601,85.23281947846132,6
0.2,6941,94,591695,85.23408239700375,8
0.2,6942,96,591791,85.23563301166642,6
0.2,6943,94,591885,85.23689516129032,8
0.2,6944,91,591976,85.23772498200144,10
0.2,6945,89,592065,85.23826662827527,12
0.2,6946,93,592158,85.23938390672232,9
0.2,6947,93,592251,85.24050086355786,8
0.2,6948,90,592341,85.24118578212692,11
0.2,6949,91,592432,85.24201438848921,10
0.2,6950,87,592519,85.24226729966911,14
0.2,6951,93,592612,85.2433831990794,9
0.2,6952,93,592705,85.24449877750611,8
0.2,6953,91,592796,85.24532643083117,10
0.2,6954,95,592891,85.24672897196261,7
0.2,6955,93,592984,85.24784358826912,8
0.2,6956,95,593079,85.2492453643812,7
0.2,6957,93,593172,85.25035929864903,8
0.2,6958,93,593265,85.25147291277483,8
0.2,6959,95,593360,85.25287356321839,6
0.2,6960,89,593449,85.2534118661112,12
0.2,6961,89,593538,85.2539500143637,12
0.2,6962,92,593630,85.2549188568146,11
0.2,6963,95,593725,85.25631820792648,6
0.2,6964,91,593816,85.25714285714285,10
0.2,6965,91,593907,85.25796726959517,10
0.2,6966,86,593993,85.25807377637433,16
0.2,6967,89,594082,85.25861079219288,12
0.2,6968,91,594173,85.25943463911608,11
0.2,6969,95,594268,85.26083213773315,7
0.2,6970,89,594357,85.2613685267537,12
0.2,6971,93,594450,85.26247848537005,9
0.2,6972,90,594540,85.26315789473684,12
0.2,6973,95,594635,85.26455405792946,6
0.2,6974,90,594725,85.26523297491039,11
0.2,6975,90,594815,85.2659116972477,11
0.2,6976,92,594907,85.26687688118102,9
0.2,6977,94,595001,85.26812840355403,7
0.2,6978,94,595095,85.26937956727325,8
0.2,6979,93,595188,85.27048710601719,8
0.2,6980,94,595282,85.27173757341355,8
0.2,6981,87,595369,85.27198510455457,14
0.2,6982,92,595461,85.27294858943148,10
0.2,6983,94,595555,85.2741981672394,7
0.2,6984,89,595644,85.27473156764495,12
0.2,6985,94,595738,85.27598053249356,7
0.2,6986,94,595832,85.27722913983112,7
0.2,6987,96,595928,85.27876359473383,6
0.2,6988,93,596021,85.2798683645729,8
0.2,6989,94,596115,85.28111587982832,7
0.2,6990,89,596204,85.28164783292804,12
0.2,6991,93,596297,85.28275171624713,9
0.2,6992,90,596387,85.28342628342628,11
0.2,6993,94,596481,85.28467257649413,8
0.2,6994,93,596574,85.28577555396711,10
0.2,6995,94,596668,85.28702115494568,7
0.2,6996,95,596763,85.28840931827926,6
0.2,6997,89,596852,85.2889396970563,13
0.2,6998,24,596876,85.28018288326903,9
0.2,6999,89,596965,85.28071428571428,12
0.2,7000,94,597059,85.28195972003999,9
0.2,7001,93,597152,85.28306198229077,8
0.2,7002,92,597244,85.2840211337998,10
0.2,7003,87,597331,85.28426613363793,14
0.2,7004,86,597417,85.28436830835118,15
0.2,7005,94,597511,85.28561233228662,7
0.2,7006,96,597607,85.28714142999857,6
0.2,7007,96,597703,85.2886700913242,6
0.2,7008,93,597796,85.28977029533456,9
0.2,7009,89,597885,85.29029957203994,12
0.2,7010,89,597974,85.29082869776066,12
0.2,7011,94,598068,85.29207073588135,7
0.2,7012,94,598162,85.29331241979182,7
0.2,7013,-46,598116,85.27459366980325,10
0.2,7014,96,598212,85.27612259444048,6
0.2,7015,96,598308,85.27765108323831,6
0.2,7016,91,598399,85.27846658116005,11
0.2,7017,91,598490,85.27928184667996,10
0.2,7018,93,598583,85.28038182077219,8
0.2,7019,94,598677,85.28162393162393,7
0.2,7020,92,598769,85.28258082894175,9
0.2,7021,93,598862,85.2836798632868,8
0.2,7022,94,598956,85.28492097394276,7
0.2,7023,93,599049,85.28601936218679,8
0.2,7024,94,599143,85.28725978647687,8
0.2,7025,89,599232,85.28778821520068,13
0.2,7026,94,599326,85.28902803472322,8
0.2,7027,94,599420,85.29026750142287,9
0.2,7028,94,599514,85.29150661545027,7
0.2,7029,86,599600,85.29160739687056,15
0.2,7030,92,599692,85.29256151329825,9
0.2,7031,94,599786,85.29379977246872,7
0.2,7032,95,599881,85.29517986634437,6
0.2,7033,87,599968,85.29542223485926,16
0.2,7034,95,600063,85.29680170575693,6
0.2,7035,93,600156,85.29789653212052,9
0.2,7036,95,600251,85.29927525934347,6
0.2,7037,92,600343,85.30022733731174,10
0.2,7038,93,600436,85.30132121039921,8
0.2,7039,92,600528,85.30227272727272,9
0.2,7040,90,600618,85.30293992330635,11
0.2,7041,85,600703,85.30289690428856,16
0.2,7042,21,600724,85.29376686071276,11
0.2,7043,92,600816,85.2947189097104,9
0.2,7044,93,600909,85.2958126330731,8
0.2,7045,91,601000,85.2966221969912,13
0.2,7046,94,601094,85.2978572442174,7
0.2,7047,94,601188,85.29909194097617,8
0.2,7048,92,601280,85.30004255922826,9
0.2,7049,88,601368,85.3004255319149,13
0.2,7050,95,601463,85.30180116295561,6
0.2,7051,92,601555,85.3027509926262,9
0.2,7052,94,601649,85.30398412023253,9
0.2,7053,90,601739,85.30464984406011,11
0.2,7054,92,601831,85.30559886605245,9
0.2,7055,88,601919,85.30598072562358,13
0.2,7056,94,602013,85.30721269661329,8
0.2,7057,93,602106,85.30830263530746,8
0.2,7058,96,602202,85.30981725456864,6
0.2,7059,25,602227,85.3012747875354,8
0.2,7060,90,602317,85.30194023509418,11
0.2,7061,-60,602257,85.28136505239308,23
0.2,7062,92,602349,85.28231629619142,9
0.2,7063,86,602435,85.28241789354473,15
0.2,7064,83,602518,85.2820948336872,18
0.2,7065,94,602612,85.28332861590717,7
0.2,7066,93,602705,85.28442054620065,8
0.2,7067,93,602798,85.28551216751556,8
0.2,7068,96,602894,85.28702786815674,6
0.2,7069,85,602979,85.28698727015559,16
0.2,7070,95,603074,85.28836091076226,6
0.2,7071,91,603165,85.2891685520362,10
0.2,7072,95,603260,85.2905414958292,6
0.2,7073,93,603353,85.29163132598246,8
0.2,7074,87,603440,85.29187279151944,15
0.2,7075,95,603535,85.29324477105709,6
0.2,7076,94,603629,85.2944750600537,7
0.2,7077,95,603724,85.29584628426109,6
0.2,7078,14,603738,85.28577482695296,18
0.2,7079,96,603834,85.28728813559322,6
0.2,7080,93,603927,85.28837734783222,8
0.2,7081,95,604022,85.28974865857103,6
0.2,7082,77,604099,85.288578286037,24
0.2,7083,93,604192,85.28966685488425,8
0.2,7084,93,604285,85.2907551164432,8
0.2,7085,95,604380,85.29212531752752,7
0.2,7086,94,604474,85.29335402850289,7
0.2,7087,91,604565,85.2941591422122,10
0.2,7088,95,604660,85.29552828325575,6
0.2,7089,96,604756,85.29703808180535,7
0.2,7090,85,604841,85.2969961923565,16
0.2,7091,91,604932,85.29780033840947,12
0.2,7092,95,605027,85.29916819399408,7
0.2,7093,96,605123,85.30067662813646,6
0.2,7094,96,605219,85.30218463706836,6
0.2,7095,88,605307,85.30256482525367,13
0.2,7096,89,605396,85.30308581090601,14
0.2,7097,90,605486,85.30374753451676,12
0.2,7098,96,605582,85.30525426116354,6
0.2,7099,94,605676,85.30647887323944,7
0.2,7100,19,605695,85.2971412477116,14
0.2,7101,88,605783,85.29752182483807,13
0.2,7102,93,605876,85.2986062227228,8
0.2,7103,92,605968,85.29954954954955,9
0.2,7104,91,606059,85.30035186488388,10
0.2,7105,94,606153,85.30157613284548,7
0.2,7106,94,606247,85.30280005628254,7
0.2,7107,90,606337,85.303460889139,11
0.2,7108,92,606429,85.30440286960192,9
0.2,7109,93,606522,85.30548523206751,8
0.2,7110,95,606617,85.30684854450851,6
0.2,7111,93,606710,85.30793025871766,8
0.2,7112,95,606805,85.30929284408829,8
0.2,7113,91,606896,85.31009277481023,10
0.2,7114,90,606986,85.31075193253689,11
0.2,7115,91,607077,85.31155143338954,11
0.2,7116,91,607168,85.31235070956863,12
0.2,7117,95,607263,85.31371171677438,6
0.2,7118,92,607355,85.31465093411997,9
0.2,7119,82,607437,85.31418539325843,19
0.2,7120,95,607532,85.31554556944249,7
0.2,7121,86,607618,85.31564167368717,15
0.2,7122,92,607710,85.31658009265759,10
0.2,7123,89,607799,85.3170971364402,12
0.2,7124,19,607818,85.30778947368421,13
0.2,7125,94,607912,85.30900926185798,7
0.2,7126,94,608006,85.31022870773117,7
0.2,7127,91,608097,85.31102693602693,10
0.2,7128,82,608179,85.31056249123299,19
0.2,7129,83,608262,85.31023842917251,19
0.2,7130,93,608355,85.31131678586453,8
0.2,7131,92,608447,85.31225462703308,10
0.2,7132,92,608539,85.31319220524324,9
0.2,7133,92,608631,85.31412952060555,11
0.2,7134,92,608723,85.31506657323055,9
0.2,7135,90,608813,85.31572309417041,11
0.2,7136,21,608834,85.30671150343281,12
0.2,7137,90,608924,85.30736901092743,11
0.2,7138,94,609018,85.30858663678386,7
0.2,7139,91,609109,85.30938375350141,10
0.2,7140,94,609203,85.3106007561966,7
0.2,7141,86,609289,85.31069728367405,15
0.2,7142,93,609382,85.31177376452472,8
0.2,7143,19,609401,85.30249160134379,14
0.2,7144,95,609496,85.3038488453464,6
0.2,7145,91,609587,85.30464595577946,10
0.2,7146,91,609678,85.30544284315097,10
0.2,7147,93,609771,85.3065193060996,8
0.2,7148,23,609794,85.29780388865575,10
0.2,7149,90,609884,85.29846153846154,12
0.2,7150,93,609977,85.29953852608027,8
0.2,7151,92,610069,85.30047539149888,9
0.2,7152,92,610161,85.30141199496714,9
0.2,7153,92,610253,85.30234833659492,10
0.2,7154,96,610349,85.30384346610762,6
0.2,7155,95,610444,85.30519843487983,8
0.2,7156,91,610535,85.3059941316194,10
0.2,7157,91,610626,85.30678960603521,11
0.2,7158,93,610719,85.30786422684733,8
0.2,7159,94,610813,85.3090782122905,8
0.2,7160,91,610904,85.30987292277615,11
0.2,7161,88,610992,85.31024853392907,13
0.2,7162,94,611086,85.31146167806784,7
0.2,7163,95,611181,85.31281407035176,7
0.2,7164,95,611276,85.31416608513608,6
0.2,7165,94,611370,85.31537817471393,7
0.2,7166,87,611457,85.31561322729175,15
0.2,7167,95,611552,85.31696428571429,6
0.2,7168,93,611645,85.31803598828289,8
0.2,7169,94,611739,85.31924686192468,7
0.2,7170,94,611833,85.32045739785246,7
0.2,7171,86,611919,85.32055214723927,15
0.2,7172,26,611945,85.31228216924578,7
0.2,7173,93,612038,85.31335377752997,8
0.2,7174,95,612133,85.31470383275261,6
0.2,7175,94,612227,85.31591415830546,7
0.2,7176,23,612250,85.3072314337467,9
0.2,7177,94,612344,85.30844246308163,7
0.2,7178,96,612440,85.30993174536843,6
0.2,7179,92,612532,85.31086350974931,10
0.2,7180,92,612624,85.31179501462192,9
0.2,7181,24,612648,85.30325814536342,9
0.2,7182,94,612742,85.30446888486705,8
0.2,7183,27,612769,85.29635300668151,6
0.2,7184,94,612863,85.29756437021572,8
0.2,7185,96,612959,85.29905371555803,6
0.2,7186,93,613052,85.30012522610268,8
0.2,7187,91,613143,85.30091819699499,10
0.2,7188,94,613237,85.30212825149535,7
0.2,7189,93,613330,85.30319888734353,9
0.2,7190,91,613421,85.30399109998609,10
0.2,7191,95,613516,85.30533926585095,6
0.2,7192,90,613606,85.30599193660504,11
0.2,7193,93,613699,85.30706144008896,9
0.2,7194,21,613720,85.29812369701182,12
0.2,7195,92,613812,85.29905503057255,9
0.2,7196,92,613904,85.29998610532166,9
0.2,7197,27,613931,85.29188663517644,7
0.2,7198,93,614024,85.29295735518822,10
0.2,7199,92,614116,85.29388888888889,9
0.2,7200,94,614210,85.29509790306902,8
0.2,7201,96,614306,85.29658428214385,6
0.2,7202,94,614400,85.29779258642232,7
0.2,7203,27,614427,85.28970016657412,6
0.2,7204,91,614518,85.29049271339348,11
0.2,7205,95,614613,85.29184013322231,7
0.2,7206,92,614705,85.29277091716386,11
0.2,7207,93,614798,85.29384017758046,8
0.2,7208,92,614890,85.29477042585657,9
0.2,7209,90,614980,85.29542302357837,11
0.2,7210,89,615069,85.29593676327832,13
0.2,7211,94,615163,85.2971436494731,7
0.2,7212,89,615252,85.29765700817967,12
0.2,7213,91,615343,85.29844746326587,11
0.2,7214,91,615434,85.2992376992377,10
0.2,7215,93,615527,85.30030487804878,11
0.2,7216,93,615620,85.30137176111958,8
0.2,7217,95,615715,85.30271543363813,6
0.2,7218,94,615809,85.30392021055548,7
0.2,7219,92,615901,85.30484764542936,10
0.2,7220,88,615989,85.30522088353413,13
0.2,7221,93,616082,85.30628634727222,10
0.2,7222,92,616174,85.30721306936177,9
0.2,7223,95,616269,85.30855481727575,6
0.2,7224,81,616350,85.30795847750865,20
0.2,7225,94,616444,85.30916136174923,7
0.2,7226,93,616537,85.31022554310225,8
0.2,7227,95,616632,85.31156613171002,6
0.2,7228,95,616727,85.31290634942593,7
0.2,7229,94,616821,85.31410788381743,7
0.2,7230,12,616833,85.30396902226525,20
0.2,7231,91,616924,85.30475663716814,10
0.2,7232,94,617018,85.3059587999447,8
0.2,7233,26,617044,85.29776057506221,7
0.2,7234,91,617135,85.29854872149275,10
0.2,7235,23,617158,85.28993919292427,9
0.2,7236,92,617250,85.29086638109715,9
0.2,7237,88,617338,85.2912406742194,13
0.2,7238,90,617428,85.2918911451858,11
0.2,7239,93,617521,85.29295580110497,8
0.2,7240,87,617608,85.29319154812872,14
0.2,7241,94,617702,85.29439381386358,8
0.2,7242,94,617796,85.29559574761839,7
0.2,7243,96,617892,85.29707344008835,6
0.2,7244,90,617982,85.29772256728778,11
0.2,7245,20,618002,85.28871101297267,12
0.2,7246,96,618098,85.29018904374225,6
0.2,7247,96,618194,85.29166666666667,6
0.2,7248,96,618290,85.29314388191474,6
0.2,7249,25,618315,85.2848275862069,8
0.2,7250,94,618409,85.2860295131706,7
0.2,7251,91,618500,85.28681742967457,10
0.2,7252,94,618594,85.28801875086171,7
0.2,7253,94,618688,85.28921974083265,7
0.2,7254,94,618782,85.29042039972433,8
0.2,7255,87,618869,85.29065600882029,16
0.2,7256,90,618959,85.29130494694778,13
0.2,7257,89,619048,85.29181592725269,13
0.2,7258,92,619140,85.2927400468384,10
0.2,7259,95,619235,85.29407713498622,6
0.2,7260,90,619325,85.29472524445669,11
0.2,7261,93,619418,85.29578628477003,9
0.2,7262,90,619508,85.29643398044885,11
0.2,7263,92,619600,85.29735682819383,9
0.2,7264,95,619695,85.29869236063317,7
0.2,7265,96,619791,85.30016515276631,6
0.2,7266,92,619883,85.30108710609605,10
0.2,7267,94,619977,85.30228398458998,7
0.2,7268,92,620069,85.30320539276379,10
0.2,7269,94,620163,85.30440165061898,8
0.2,7270,92,620255,85.3053225140971,10
0.2,7271,94,620349,85.30651815181518,7
0.2,7272,89,620438,85.3070259865255,12
0.2,7273,94,620532,85.30822106131427,8
0.2,7274,84,620616,85.3080412371134,17
0.2,7275,96,620712,85.30951072017592,6
0.2,7276,88,620800,85.30988044523842,13
0.2,7277,87,620887,85.31011266831547,14
0.2,7278,96,620983,85.31158126116225,6
0.2,7279,96,621079,85.31304945054946,6
0.2,7280,88,621167,85.31341848647163,13
0.2,7281,23,621190,85.30486130184015,10
0.2,7282,84,621274,85.30468213648221,17
0.2,7283,93,621367,85.305738605162,9
0.2,7284,89,621456,85.30624571036375,12
0.2,7285,91,621547,85.30702717540488,10
0.2,7286,94,621641,85.30822011801838,7
0.2,7287,96,621737,85.30968715697036,6
0.2,7288,93,621830,85.31074221429552,8
0.2,7289,89,621919,85.31124828532236,13
0.2,7290,94,622013,85.31243999451378,7
0.2,7291,-54,621959,85.29333516182118,17
0.2,7292,83,622042,85.2930207047854,18
0.2,7293,93,622135,85.2940773238278,8
0.2,7294,92,622227,85.2949965729952,9
0.2,7295,96,622323,85.29646381578948,6
0.2,7296,93,622416,85.29751952857339,9
0.2,7297,89,622505,85.29802685667306,12
0.2,7298,92,622597,85.29894506096726,9
0.2,7299,88,622685,85.29931506849314,13
0.2,7300,94,622779,85.30050677989317,7
0.2,7301,89,622868,85.30101342098055,13
0.2,7302,91,622959,85.3017937833767,11
0.2,7303,84,623043,85.30161555312158,17
0.2,7304,27,623070,85.29363449691992,6
0.2,7305,94,623164,85.29482617027101,7
0.2,7306,95,623259,85.2961543725195,6
0.2,7307,95,623354,85.29748221127531,7
0.2,7308,89,623443,85.29798878095498,12
0.2,7309,87,623530,85.29822161422709,15
0.2,7310,93,623623,85.29927506497059,8
0.2,7311,94,623717,85.30046498905908,7
0.2,7312,94,623811,85.30165458772049,7
0.2,7313,89,623900,85.3021602406344,12
0.2,7314,95,623995,85.30348598769652,7
0.2,7315,92,624087,85.30440131219245,9
0.2,7316,96,624183,85.30586305863059,6
0.2,7317,91,624274,85.30664115878655,10
0.2,7318,88,624362,85.30700915425605,13
0.2,7319,90,624452,85.30765027322404,11
0.2,7320,93,624545,85.30870099713154,8
0.2,7321,89,624634,85.30920513520896,13
0.2,7322,86,624720,85.30929946743139,15
0.2,7323,94,624814,85.31048607318405,8
0.2,7324,96,624910,85.31194539249147,6
0.2,7325,87,624997,85.31217581217581,15
0.2,7326,89,625086,85.31267913197762,12
0.2,7327,90,625176,85.31331877729258,12
0.2,7328,94,625270,85.31450402510575,7
0.2,7329,89,625359,85.3150068212824,12
0.2,7330,92,625451,85.315918701405,9
0.2,7331,95,625546,85.31723949809056,7
0.2,7332,91,625637,85.31801445520252,10
0.2,7333,90,625727,85.31865284974093,11
0.2,7334,83,625810,85.31833674164963,20
0.2,7335,89,625899,85.31883860414395,13
0.2,7336,91,625990,85.31961292081232,11
0.2,7337,95,626085,85.32093213409648,6
0.2,7338,91,626176,85.32170595448972,10
0.2,7339,91,626267,85.3224795640327,10
0.2,7340,93,626360,85.32352540525814,8
0.2,7341,91,626451,85.3242985562517,10
0.2,7342,95,626546,85.32561623314722,6
0.2,7343,91,626637,85.32638888888889,10
0.2,7344,87,626724,85.32661674608578,14
0.2,7345,93,626817,85.32766131227879,8
0.2,7346,92,626909,85.32856948414319,9
0.2,7347,92,627001,85.32947740881873,9
0.2,7348,96,627097,85.33092937814669,6
0.2,7349,25,627122,85.32272108843537,8
0.2,7350,96,627218,85.3241735818256,6
0.2,7351,27,627245,85.31624047878128,6
0.2,7352,92,627337,85.3171494628043,9
0.2,7353,95,627432,85.31846614087571,6
0.2,7354,92,627524,85.31937457511897,9
0.2,7355,90,627614,85.3200108754758,12
0.2,7356,93,627707,85.32105477776267,8
0.2,7357,90,627797,85.32169067681436,12
0.2,7358,95,627892,85.32300584318521,6
0.2,7359,92,627984,85.32391304347826,10
0.2,7360,91,628075,85.3246841461758,10
0.2,7361,94,628169,85.32586253735398,7
0.2,7362,27,628196,85.31794105663452,6
0.2,7363,94,628290,85.31912004345465,9
0.2,7364,91,628381,85.31989137813986,10
0.2,7365,92,628473,85.32079826228617,9
0.2,7366,85,628558,85.32075471698113,16
0.2,7367,96,628654,85.32220412595005,7
0.2,7368,91,628745,85.32297462342244,10
0.2,7369,92,628837,85.32388059701492,9
0.2,7370,93,628930,85.32492199158865,9
0.2,7371,96,629026,85.32637004883343,6
0.2,7372,91,629117,85.3271395632714,10
0.2,7373,85,629202,85.32709519934906,16
0.2,7374,93,629295,85.32813559322034,8
0.2,7375,94,629389,85.32931127982647,7
0.2,7376,92,629481,85.33021553477023,9
0.2,7377,93,629574,85.33125508267823,8
0.2,7378,87,629661,85.33148123051905,14
0.2,7379,93,629754,85.33252032520325,8
0.2,7380,93,629847,85.33355913832814,8
0.2,7381,91,629938,85.33432674072067,11
0.2,7382,94,630032,85.33550047406203,9
0.2,7383,92,630124,85.33640303358614,9
0.2,7384,94,630218,85.33757616790793,8
0.2,7385,88,630306,85.33793663688058,14
0.2,7386,-50,630256,85.31961554081495,14
0.2,7387,87,630343,85.31984298863021,15
0.2,7388,95,630438,85.32115306536744,6
0.2,7389,92,630530,85.32205683355886,10
0.2,7390,92,630622,85.32296035719118,11
0.2,7391,87,630709,85.32318722943722,14
0.2,7392,89,630798,85.3236845664818,12
0.2,7393,87,630885,85.32391127941574,14
0.2,7394,86,630971,85.32400270453009,15
0.2,7395,94,631065,85.32517577068685,7
0.2,7396,95,631160,85.326483709612,7
0.2,7397,94,631254,85.32765612327655,7
0.2,7398,91,631345,85.3284227598324,10
0.2,7399,90,631435,85.32905405405405,11
0.2,7400,85,631520,85.32900959329821,16
0.2,7401,94,631614,85.33018103215348,7
0.2,7402,93,631707,85.33121707415913,8
0.2,7403,94,631801,85.33238789843328,7
0.2,7404,91,631892,85.33315327481431,10
0.2,7405,88,631980,85.33351336753984,13
0.2,7406,92,632072,85.33441339273661,10
0.2,7407,27,632099,85.32653887688984,6
0.2,7408,94,632193,85.32770954244837,9
0.2,7409,94,632287,85.32887989203779,7
0.2,7410,93,632380,85.32991499122926,8
0.2,7411,92,632472,85.33081489476524,10
0.2,7412,96,632568,85.33225414811817,6
0.2,7413,89,632657,85.33274885352037,12
0.2,7414,91,632748,85.33351314902225,10
0.2,7415,16,632764,85.32416396979504,16
0.2,7416,87,632851,85.32438991506,14
0.2,7417,19,632870,85.31544890806147,13
0.2,7418,92,632962,85.31634991238711,9
0.2,7419,91,633053,85.31711590296496,10
0.2,7420,94,633147,85.3182859452904,7
0.2,7421,25,633172,85.31015898679601,8
0.2,7422,96,633268,85.31159908392833,6
0.2,7423,95,633363,85.31290409482759,6
0.2,7424,95,633458,85.31420875420875,6
0.2,7425,90,633548,85.31483975222193,11
0.2,7426,90,633638,85.31547058031506,12
0.2,7427,96,633734,85.31690899299946,6
0.2,7428,82,633816,85.31646251177817,19
0.2,7429,91,633907,85.31722745625841,10
0.2,7430,90,633997,85.31785762346925,11
0.2,7431,95,634092,85.31916038751345,8
0.2,7432,25,634117,85.31104533835598,8
0.2,7433,86,634203,85.31113801452784,15
0.2,7434,92,634295,85.31203765971755,9
0.2,7435,91,634386,85.31280258203336,10
0.2,7436,89,634475,85.31329837299987,12
0.2,7437,94,634569,85.31446625436945,7
0.2,7438,27,634596,85.30662723484339,6
0.2,7439,96,634692,85.30806451612904,7
0.2,7440,95,634787,85.30936702056175,6
0.2,7441,91,634878,85.31013168503091,11
0.2,7442,95,634973,85.31143356173585,7
0.2,7443,96,635069,85.3128694250403,7
0.2,7444,93,635162,85.31390194761585,8
0.2,7445,95,635257,85.31520279344615,7
0.2,7446,93,635350,85.31623472539277,9
0.2,7447,95,635445,85.31753490870032,6
0.2,7448,91,635536,85.31829775808833,10
0.2,7449,92,635628,85.31919463087249,12
0.2,7450,93,635721,85.32022547309086,10
0.2,7451,94,635815,85.32139023081052,7
0.2,7452,95,635910,85.32268885012746,6
0.2,7453,94,636004,85.32385296485108,8
0.2,7454,91,636095,85.32461435278337,10
0.2,7455,92,636187,85.32550965665236,9
0.2,7456,92,636279,85.32640472039694,10
0.2,7457,93,636372,85.32743362831859,8
0.2,7458,89,636461,85.32792599544175,12
0.2,7459,94,636555,85.32908847184987,7
0.2,7460,93,636648,85.33011660635303,8
0.2,7461,94,636742,85.33127847761995,7
0.2,7462,95,636837,85.33257403189066,7
0.2,7463,92,636929,85.33346730975349,9
0.2,7464,89,637018,85.3339584728734,12
0.2,7465,92,637110,85.33485132601125,10
0.2,7466,90,637200,85.3354760948172,11
0.2,7467,94,637294,85.33663631494376,7
0.2,7468,86,637380,85.33672513053956,15
0.2,7469,90,637470,85.33734939759036,13
0.2,7470,95,637565,85.3386427519743,7
0.2,7471,88,637653,85.33899892933619,14
0.2,7472,92,637745,85.33989027164459,9
0.2,7473,92,637837,85.34078137543484,10
0.2,7474,88,637925,85.34113712374582,13
0.2,7475,95,638020,85.34242910647406,7
0.2,7476,94,638114,85.34358700013374,7
0.2,7477,92,638206,85.34447713292325,9
0.2,7478,93,638299,85.34550073539243,9
0.2,7479,89,638388,85.34598930481283,13
0.2,7480,92,638480,85.34687875952413,10
0.2,7481,91,638571,85.3476343223737,10
0.2,7482,94,638665,85.34879059200856,8
0.2,7483,94,638759,85.34994655264565,7
0.2,7484,94,638853,85.35110220440882,7
0.2,7485,94,638947,85.35225754742186,7
0.2,7486,91,639038,85.35301188727126,10
0.2,7487,94,639132,85.35416666666667,9
0.2,7488,95,639227,85.35545466684471,6
0.2,7489,88,639315,85.3558077436582,13
0.2,7490,92,639407,85.35669470030703,10
0.2,7491,92,639499,85.35758142018153,9
0.2,7492,85,639584,85.35753369811825,17
0.2,7493,93,639677,85.35855350947425,8
0.2,7494,95,639772,85.35983989326218,7
0.2,7495,92,639864,85.36072572038421,9
0.2,7496,93,639957,85.36174469787915,9
0.2,7497,25,639982,85.35369431848493,7
0.2,7498,87,640069,85.35391385518069,14
0.2,7499,91,640160,85.35466666666666,10
0.2,7500,88,640248,85.3550193307559,13
0.2,7501,94,640342,85.35617168754999,7
0.2,7502,94,640436,85.3573237371718,8
0.2,7503,94,640530,85.35847547974414,7
0.2,7504,90,640620,85.35909393737508,11
0.2,7505,91,640711,85.35984545696776,10
0.2,7506,81,640792,85.35926468629279,20
0.2,7507,94,640886,85.36041555673948,7
0.2,7508,92,640978,85.36129977360501,10
0.2,7509,-47,640931,85.34367509986684,11
0.2,7510,96,641027,85.34509386233525,6
0.2,7511,96,641123,85.34651224707136,6
0.2,7512,94,641217,85.34766404898177,9
0.2,7513,94,641311,85.34881554431728,7
0.2,7514,92,641403,85.3497005988024,9
0.2,7515,94,641497,85.35085151676424,7
0.2,7516,94,641591,85.35200212850872,7
0.2,7517,94,641685,85.35315243415802,7
0.2,7518,92,641777,85.35403644101609,9
0.2,7519,95,641872,85.35531914893618,7
0.2,7520,93,641965,85.35633559367105,8
0.2,7521,19,641984,85.34751395905344,14
0.2,7522,95,642079,85.34879702246444,6
0.2,7523,94,642173,85.34994683678894,7
0.2,7524,91,642264,85.3506976744186,10
0.2,7525,93,642357,85.3517140579325,8
0.2,7526,94,642451,85.35286302643816,8
0.2,7527,89,642540,85.35334750265675,12
0.2,7528,95,642635,85.35462876876079,6
0.2,7529,89,642724,85.35511288180611,13
0.2,7530,96,642820,85.35652635772142,6
0.2,7531,95,642915,85.35780669144981,7
0.2,7532,90,643005,85.3584229390681,13
0.2,7533,91,643096,85.35917175471197,10
0.2,7534,87,643183,85.35938951559389,14
0.2,7535,86,643269,85.359474522293,15
0.2,7536,93,643362,85.36048825792756,8
0.2,7537,94,643456,85.36163438577871,7
0.2,7538,95,643551,85.36291285316355,6
0.2,7539,89,643640,85.36339522546419,12
0.2,7540,95,643735,85.36467312027582,6
0.2,7541,92,643827,85.36555290373906,9
0.2,7542,84,643911,85.36537186795705,17
0.2,7543,95,644006,85.36664899257688,6
0.2,7544,87,644093,85.36686547382372,14
0.2,7545,89,644182,85.36734693877551,13
0.2,7546,94,644276,85.3684907910428,7
0.2,7547,23,644299,85.36022787493376,10
0.2,7548,94,644393,85.36137236720096,7
0.2,7549,95,644488,85.36264900662252,6
0.2,7550,94,644582,85.36379287511588,7
0.2,7551,92,644674,85.3646716101695,10
0.2,7552,89,644763,85.36515291936979,13
0.2,7553,94,644857,85.36629600211808,7
0.2,7554,87,644944,85.36651224354732,14
0.2,7555,92,645036,85.36739015352038,9
0.2,7556,91,645127,85.36813550350668,10
0.2,7557,94,645221,85.36927758666315,8
0.2,7558,92,645313,85.37015478237862,9
0.2,7559,95,645408,85.37142857142857,6
0.2,7560,90,645498,85.37204073535247,11
0.2,7561,93,645591,85.3730494578154,8
0.2,7562,92,645683,85.37392569086342,9
0.2,7563,88,645771,85.37427287149656,13
0.2,7564,93,645864,85.37528089887641,8
0.2,7565,90,645954,85.37589214908803,11
0.2,7566,95,646049,85.37716400158584,7
0.2,7567,94,646143,85.37830338266384,7
0.2,7568,94,646237,85.3794424626767,7
0.2,7569,94,646331,85.38058124174373,7
0.2,7570,89,646420,85.3810593052437,12
0.2,7571,84,646504,85.38087691494981,17
0.2,7572,95,646599,85.38214710154496,7
0.2,7573,91,646690,85.38288883020861,10
0.2,7574,94,646784,85.38402640264026,8
0.2,7575,27,646811,85.37631995776135,6
0.2,7576,92,646903,85.37719414016101,9
0.2,7577,92,646995,85.37806809184481,10
0.2,7578,27,647022,85.37036548357302,6
0.2,7579,92,647114,85.37124010554089,9
0.2,7580,91,647205,85.37198258804906,10
0.2,7581,88,647293,85.37232920073859,13
0.2,7582,93,647386,85.37333509165238,8
0.2,7583,93,647479,85.37434071729957,8
0.2,7584,93,647572,85.3753460777851,8
0.2,7585,89,647661,85.37582388610599,12
0.2,7586,96,647757,85.37722419928825,6
0.2,7587,93,647850,85.37822878228782,8
0.2,7588,90,647940,85.37883779154039,11
0.2,7589,94,648034,85.37997364953887,8
0.2,7590,96,648130,85.38137267817152,6
0.2,7591,91,648221,85.38211275026343,10
0.2,7592,92,648313,85.38298432767023,9
0.2,7593,94,648407,85.38411904134843,8
0.2,7594,92,648499,85.3849901250823,10
0.2,7595,93,648592,85.38599262769878,8
0.2,7596,93,648685,85.38699486639463,8
0.2,7597,93,648778,85.38799684127402,9
0.2,7598,94,648872,85.38913014870377,7
0.2,7599,93,648965,85.39013157894736,8
0.2,7600,92,649057,85.39100118405473,9
0.2,7601,92,649149,85.39187056037885,9
0.2,7602,89,649238,85.39234512692359,13
0.2,7603,94,649332,85.39347711730669,7
0.2,7604,90,649422,85.39408284023669,11
0.2,7605,89,649511,85.39455692874047,12
0.2,7606,93,649604,85.39555672406993,8
0.2,7607,96,649700,85.39695057833859,6
0.2,7608,93,649793,85.39794979629386,8
0.2,7609,90,649883,85.39855453350854,11
0.2,7610,95,649978,85.39981605570884,6
0.2,7611,86,650064,85.39989490278508,15
0.2,7612,92,650156,85.40076185472219,9
0.2,7613,94,650250,85.40189125295508,8
0.2,7614,96,650346,85.40328299409062,6
0.2,7615,94,650440,85.40441176470588,7
0.2,7616,86,650526,85.40448995667586,15
0.2,7617,26,650552,85.39669204515621,8
0.2,7618,89,650641,85.39716498228114,12
0.2,7619,83,650724,85.39685039370079,18
0.2,7620,94,650818,85.39797926781262,7
0.2,7621,93,650911,85.39897664654946,8
0.2,7622,96,651007,85.40036730945822,6
0.2,7623,95,651102,85.40162644281217,7
0.2,7624,86,651188,85.40170491803279,15
0.2,7625,90,651278,85.40230789404669,11
0.2,7626,26,651304,85.39451947030287,8
0.2,7627,89,651393,85.39499213424226,12
0.2,7628,93,651486,85.39598898938262,8
0.2,7629,96,651582,85.39737876802097,6
0.2,7630,92,651674,85.3982440047176,9
0.2,7631,21,651695,85.38980607966457,11
0.2,7632,15,651710,85.38058430499149,17
0.2,7633,93,651803,85.38158239455069,8
0.2,7634,93,651896,85.3825802226588,9
0.2,7635,90,651986,85.38318491356732,11
0.2,7636,91,652077,85.38392038758676,10
0.2,7637,90,652167,85.38452474469756,11
0.2,7638,27,652194,85.37688179081032,6
0.2,7639,95,652289,85.37814136125654,6
0.2,7640,93,652382,85.37913885617066,8
0.2,7641,94,652476,85.3802669458257,8
0.2,7642,93,652569,85.38126390160932,8
0.2,7643,95,652664,85.3825222396651,8
0.2,7644,90,652754,85.3831262262917,12
0.2,7645,90,652844,85.38373005493068,11
0.2,7646,94,652938,85.38485680659082,7
0.2,7647,92,653030,85.38572175732217,9
0.2,7648,92,653122,85.38658648189306,9
0.2,7649,91,653213,85.3873202614379,10
0.2,7650,95,653308,85.3885766566462,7
0.2,7651,88,653396,85.38891792995295,13
0.2,7652,91,653487,85.38965111720894,10
0.2,7653,95,653582,85.39090671544291,6
0.2,7654,80,653662,85.39020248203788,22
0.2,7655,94,653756,85.39132706374086,8
0.2,7656,95,653851,85.3925819511558,6
0.2,7657,-53,653798,85.3745103160094,17
0.2,7658,93,653891,85.37550594072333,8
0.2,7659,89,653980,85.37597911227154,12
0.2,7660,91,654071,85.37671322281686,10
0.2,7661,95,654166,85.37796919864265,6
0.2,7662,84,654250,85.37778937752839,17
0.2,7663,89,654339,85.37826200417537,13
0.2,7664,92,654431,85.37912589693411,9
0.2,7665,96,654527,85.38051134881295,6
0.2,7666,92,654619,85.38137472283813,10
0.2,7667,89,654708,85.38184663536776,12
0.2,7668,86,654794,85.3819272395358,16
0.2,7669,93,654887,85.38292046936115,8
0.2,7670,94,654981,85.38404380132968,7
0.2,7671,84,655065,85.38386339937435,17
0.2,7672,90,655155,85.38446500716799,11
0.2,7673,23,655178,85.37633567891582,10
0.2,7674,94,655272,85.37745928338762,7
0.2,7675,94,655366,85.37858259510162,7
0.2,7676,94,655460,85.37970561417221,7
0.2,7677,24,655484,85.3717113831727,8
0.2,7678,93,655577,85.37270477926813,9
0.2,7679,89,655666,85.37317708333333,12
0.2,7680,88,655754,85.37351907303737,15
0.2,7681,27,655781,85.36592033324655,7
0.2,7682,27,655808,85.35832357152154,6
0.2,7683,94,655902,85.35944820406039,8
0.2,7684,91,655993,85.36018217306442,10
0.2,7685,93,656086,85.36117616445485,8
0.2,7686,94,656180,85.36229998699102,7
0.2,7687,18,656198,85.35353798126951,15
0.2,7688,95,656293,85.35479256080114,7
0.2,7689,85,656378,85.35474642392718,16
0.2,7690,91,656469,85.35548043167339,10
0.2,7691,93,656562,85.35647425897037,8
0.2,7692,91,656653,85.35720785129338,10
0.2,7693,94,656747,85.35833116714323,7
0.2,7694,92,656839,85.3591942820013,9
0.2,7695,94,656933,85.36031704781705,7
0.2,7696,92,657025,85.36117968039495,9
0.2,7697,93,657118,85.36217199272538,8
0.2,7698,92,657210,85.36303416028056,9
0.2,7699,92,657302,85.36389610389611,10
0.2,7700,95,657397,85.36514738345669,8
0.2,7701,83,657480,85.36484030122047,18
0.2,7702,89,657569,85.36531221601973,12
0.2,7703,27,657596,85.35773624091381,6
0.2,7704,94,657690,85.35885788449059,8
0.2,7705,89,657779,85.35933039190242,13
0.2,7706,93,657872,85.3603217853899,8
0.2,7707,92,657964,85.36118318629995,10
0.2,7708,94,658058,85.36230380075237,8
0.2,7709,93,658151,85.3632944228275,8
0.2,7710,95,658246,85.3645441576968,7
0.2,7711,95,658341,85.36579356846472,6
0.2,7712,94,658435,85.36691300401918,7
0.2,7713,90,658525,85.36751361161525,11
0.2,7714,94,658619,85.36863253402463,7
0.2,7715,93,658712,85.36962156557802,8
0.2,7716,94,658806,85.37073992484126,8
0.2,7717,89,658895,85.37121015807205,12
0.2,7718,18,658913,85.36248218681176,14
0.2,7719,94,659007,85.36360103626943,7
0.2,7720,89,659096,85.36407201139748,12
0.2,7721,92,659188,85.36493136493137,9
0.2,7722,94,659282,85.36604946264406,8
0.2,7723,90,659372,85.36664940445365,11
0.2,7724,27,659399,85.35909385113268,6
0.2,7725,16,659415,85.35011648977479,17
0.2,7726,94,659509,85.35123592597385,8
0.2,7727,90,659599,85.35183747412009,11
0.2,7728,95,659694,85.35308578082547,6
0.2,7729,93,659787,85.35407503234153,8
0.2,7730,13,659800,85.34471607812702,19
0.2,7731,93,659893,85.34570615623383,8
0.2,7732,24,659917,85.33777317987844,8
0.2,7733,95,660012,85.33902249806052,6
0.2,7734,95,660107,85.34027149321267,7
0.2,7735,94,660201,85.34139089968976,7
0.2,7736,83,660284,85.34108827710999,18
0.2,7737,90,660374,85.34169035926595,11
0.2,7738,90,660464,85.34229228582504,11
0.2,7739,93,660557,85.34328165374677,8
0.2,7740,93,660650,85.3442707660509,8
0.2,7741,92,660742,85.34513045724619,10
0.2,7742,27,660769,85.33759524732017,6
0.2,7743,25,660794,85.32980371900827,8
0.2,7744,90,660884,85.33040671400904,11
0.2,7745,94,660978,85.33152594887684,8
0.2,7746,95,661073,85.33277397702336,6
0.2,7747,93,661166,85.33376355188436,8
0.2,7748,94,661260,85.33488192024777,8
0.2,7749,92,661352,85.33574193548387,9
0.2,7750,94,661446,85.33685976003096,7
0.2,7751,96,661542,85.33823529411765,6
0.2,7752,93,661635,85.33922352637688,9
0.2,7753,89,661724,85.3396956409595,12
0.2,7754,85,661809,85.33965183752417,16
0.2,7755,90,661899,85.34025270758123,12
0.2,7756,93,661992,85.34124017016887,8
0.2,7757,22,662014,85.33307553493168,10
0.2,7758,89,662103,85.3335481376466,13
0.2,7759,94,662197,85.33466494845361,7
0.2,7760,90,662287,85.33526607395954,11
0.2,7761,95,662382,85.33651120845143,6
0.2,7762,94,662476,85.33762720597707,7
0.2,7763,95,662571,85.33887171561051,6
0.2,7764,94,662665,85.33998712169993,7
0.2,7765,95,662760,85.3412310069534,6
0.2,7766,93,662853,85.34221707222866,8
0.2,7767,93,662946,85.34320288362512,8
0.2,7768,94,663040,85.34431715793538,7
0.2,7769,90,663130,85.34491634491634,11
0.2,7770,91,663221,85.34564406125338,11
0.2,7771,95,663316,85.34688625836336,6
0.2,7772,93,663409,85.34787083494146,8
0.2,7773,88,663497,85.34821198868022,13
0.2,7774,95,663592,85.34945337620579,7
0.2,7775,92,663684,85.3503086419753,10
0.2,7776,87,663771,85.35052076636235,14
0.2,7777,92,663863,85.35137567498072,10
0.2,7778,92,663955,85.35223036379998,9
0.2,7779,96,664051,85.35359897172236,6
0.2,7780,96,664147,85.35496722786274,6
0.2,7781,94,664241,85.35607812901567,9
0.2,7782,94,664335,85.35718874469998,7
0.2,7783,96,664431,85.358556012333,6
0.2,7784,25,664456,85.35080282594734,8
0.2,7785,95,664551,85.35204212689443,6
0.2,7786,83,664634,85.35174007961987,19
0.2,7787,94,664728,85.35285053929121,7
0.2,7788,93,664821,85.35383232764154,9
0.2,7789,95,664916,85.35507060333761,6
0.2,7790,89,665005,85.35553844179181,12
0.2,7791,85,665090,85.35549281314168,16
0.2,7792,94,665184,85.35660207878865,7
0.2,7793,94,665278,85.35771105978958,7
0.2,7794,93,665371,85.35869146889031,8
0.2,7795,93,665464,85.35967162647512,9
0.2,7796,93,665557,85.36065153264076,8
0.2,7797,93,665650,85.36163118748397,8
0.2,7798,93,665743,85.36261059110143,8
0.2,7799,92,665835,85.36346153846154,9
0.2,7800,94,665929,85.36456864504551,7
0.2,7801,95,666024,85.36580364009228,6
0.2,7802,-52,665972,85.34819941048315,15
0.2,7803,90,666062,85.34879548949257,11
0.2,7804,91,666153,85.3495195387572,10
0.2,7805,92,666245,85.35037150909557,11
0.2,7806,94,666339,85.35147944152683,7
0.2,7807,89,666428,85.35194672131148,12
0.2,7808,93,666521,85.35292611089768,8
0.2,7809,89,666610,85.35339308578745,12
0.2,7810,93,666703,85.35437203943157,8
0.2,7811,94,666797,85.35547875064005,7
0.2,7812,93,666890,85.35645718674004,8
0.2,7813,92,666982,85.35730739697978,9
0.2,7814,95,667077,85.35854126679463,6
0.2,7815,89,667166,85.35900716479017,12
0.2,7816,94,667260,85.3601125751567,7
0.2,7817,93,667353,85.36108979278588,8
0.2,7818,23,667376,85.35311420897813,10
0.2,7819,94,667470,85.3542199488491,7
0.2,7820,94,667564,85.35532540595831,7
0.2,7821,95,667659,85.35655842495525,7
0.2,7822,94,667753,85.3576633005241,7
0.2,7823,19,667772,85.34918200408998,13
0.2,7824,93,667865,85.35015974440894,8
0.2,7825,92,667957,85.35100945566062,9
0.2,7826,89,668046,85.35147566117287,12
0.2,7827,89,668135,85.35194174757281,12
0.2,7828,95,668230,85.35317409630859,7
0.2,7829,95,668325,85.3544061302682,7
0.2,7830,93,668418,85.3553824543481,9
0.2,7831,93,668511,85.35635852911133,8
0.2,7832,92,668603,85.35720668964636,9
0.2,7833,93,668696,85.35818228235895,8
0.2,7834,87,668783,85.35839183152521,14
0.2,7835,93,668876,85.35936702399184,8
0.2,7836,85,668961,85.3593211688146,16
0.2,7837,93,669054,85.360295993876,8
0.2,7838,94,669148,85.36139813751754,7
0.2,7839,92,669240,85.36224489795919,9
0.2,7840,25,669265,85.35454661395231,8
0.2,7841,93,669358,85.35552155062484,9
0.2,7842,91,669449,85.3562412342216,11
0.2,7843,91,669540,85.35696073431923,11
0.2,7844,91,669631,85.3576800509879,10
0.2,7845,91,669722,85.35839918429774,11
0.2,7846,93,669815,85.35937300879317,8
0.2,7847,21,669836,85.35117227319063,11
0.2,7848,94,669930,85.35227417505415,7
0.2,7849,94,670024,85.35337579617834,7
0.2,7850,93,670117,85.35434976436123,8
0.2,7851,95,670212,85.3555781966378,6
0.2,7852,23,670235,85.3476378454094,9
0.2,7853,95,670330,85.34886681945505,6
0.2,7854,92,670422,85.34971355824315,9
0.2,7855,88,670510,85.35005091649694,14
0.2,7856,91,670601,85.35077001400026,10
0.2,7857,93,670694,85.35174344616951,8
0.2,7858,93,670787,85.35271663061458,8
0.2,7859,93,670880,85.35368956743002,8
0.2,7860,92,670972,85.35453504643175,9
0.2,7861,92,671064,85.3553803103536,9
0.2,7862,92,671156,85.35622535927763,9
0.2,7863,90,671246,85.35681586978637,11
0.2,7864,-50,671196,85.33960584869676,14
0.2,7865,22,671218,85.33155352148488,10
0.2,7866,91,671309,85.33227405618406,10
0.2,7867,86,671395,85.33235892221657,18
0.2,7868,94,671489,85.3334604142839,7
0.2,7869,94,671583,85.33456162642948,7
0.2,7870,26,671609,85.32702324990471,6
0.2,7871,94,671703,85.328125,7
0.2,7872,96,671799,85.32948050298488,6
0.2,7873,27,671826,85.3220726441453,6
0.2,7874,87,671913,85.32228571428571,14
0.2,7875,90,672003,85.32287963433215,13
0.2,7876,95,672098,85.32410816300622,6
0.2,7877,95,672193,85.32533637979182,7
0.2,7878,93,672286,85.326310445488,8
0.2,7879,90,672376,85.32690355329949,11
0.2,7880,90,672466,85.3274965105951,11
0.2,7881,92,672558,85.32834306013702,9
0.2,7882,88,672646,85.32868197386782,13
0.2,7883,96,672742,85.33003551496702,6
0.2,7884,93,672835,85.33100824350032,8
0.2,7885,92,672927,85.3318539183363,9
0.2,7886,25,672952,85.32420438696589,9
0.2,7887,91,673043,85.32492393509128,10
0.2,7888,92,673135,85.32577005957663,9
0.2,7889,95,673230,85.32699619771863,7
0.2,7890,93,673323,85.32796857179065,8
0.2,7891,89,673412,85.32843385707045,12
0.2,7892,95,673507,85.32965919168883,6
0.2,7893,85,673592,85.32961743096023,16
0.2,7894,95,673687,85.3308423052565,6
0.2,7895,91,673778,85.33156028368795,10
0.2,7896,93,673871,85.33253134101558,8
0.2,7897,90,673961,85.33312230944543,11
0.2,7898,95,674056,85.33434611976199,6
0.2,7899,94,674150,85.33544303797468,7
0.2,7900,94,674244,85.3365396785217,7
0.2,7901,92,674336,85.33738294102758,9
0.2,7902,83,674419,85.33708718208275,18
0.2,7903,89,674508,85.33755060728745,12
0.2,7904,92,674600,85.33839342188489,9
0.2,7905,90,674690,85.33898305084746,11
0.2,7906,90,674780,85.33957253066903,11
0.2,7907,84,674864,85.33940313606475,17
0.2,7908,90,674954,85.3399924137059,12
0.2,7909,93,675047,85.3409608091024,8
0.2,7910,90,675137,85.34154974086715,11
0.2,7911,92,675229,85.34239130434783,9
0.2,7912,96,675325,85.34373815240743,6
0.2,7913,94,675419,85.34483194339145,7
0.2,7914,22,675441,85.33682880606443,10
0.2,7915,96,675537,85.33817584638706,6
0.2,7916,95,675632,85.33939623594796,6
0.2,7917,25,675657,85.33177570093459,7
0.2,7918,93,675750,85.33274403333755,8
0.2,7919,94,675844,85.33383838383838,7
0.2,7920,96,675940,85.33518495139502,6
0.2,7921,91,676031,85.33590002524615,13
0.2,7922,96,676127,85.33724599267954,6
0.2,7923,88,676215,85.33758202927814,13
0.2,7924,94,676309,85.33867507886436,7
0.2,7925,96,676405,85.34002018672723,6
0.2,7926,94,676499,85.34111265295824,7
0.2,7927,91,676590,85.34182643794148,10
0.2,7928,-44,676546,85.32551393618363,8
0.2,7929,96,676642,85.32686002522068,6
0.2,7930,87,676729,85.32707098726516,14
0.2,7931,92,676821,85.32791225416037,10
0.2,7932,96,676917,85.32925753182907,6
0.2,7933,14,676931,85.3202672044366,19
0.2,7934,92,677023,85.32110901071204,10
0.2,7935,93,677116,85.32207661290323,9
0.2,7936,27,677143,85.31472848683381,6
0.2,7937,88,677231,85.31506676744772,13
0.2,7938,93,677324,85.31603476508377,8
0.2,7939,91,677415,85.31675062972292,10
0.2,7940,93,677508,85.31771817151493,9
0.2,7941,96,677604,85.31906320825989,6
0.2,7942,92,677696,85.31990431826766,9
0.2,7943,92,677788,85.3207452165156,11
0.2,7944,89,677877,85.32120830711139,14
0.2,7945,93,677970,85.32217467908382,8
0.2,7946,87,678057,85.32238580596452,14
0.2,7947,90,678147,85.32297433316558,11
0.2,7948,96,678243,85.32431752421688,6
0.2,7949,92,678335,85.3251572327044,9
0.2,7950,84,678419,85.32499056722425,17
0.2,7951,94,678513,85.3260814889336,7
0.2,7952,93,678606,85.32704639758582,10
0.2,7953,95,678701,85.32826250942922,6
0.2,7954,89,678790,85.32872407291012,13
0.2,7955,89,678879,85.32918552036199,12
0.2,7956,94,678973,85.3302752293578,7
0.2,7957,94,679067,85.33136466448856,8
0.2,7958,25,679092,85.3237843950245,9
0.2,7959,94,679186,85.3248743718593,7
0.2,7960,90,679276,85.32546162542394,11
0.2,7961,92,679368,85.32629992464204,9
0.2,7962,94,679462,85.32738917493407,7
0.2,7963,95,679557,85.32860371672527,6
0.2,7964,94,679651,85.32969240426867,7
0.2,7965,92,679743,85.33052975144363,9
0.2,7966,94,679837,85.33161792393624,7
0.2,7967,87,679924,85.33182730923694,16
0.2,7968,95,680019,85.33304053206174,6
0.2,7969,88,680107,85.33337515683814,14
0.2,7970,95,680202,85.33458788106887,6
0.2,7971,94,680296,85.33567486201706,8
0.2,7972,95,680391,85.33688699360341,6
0.2,7973,87,680478,85.33709556057185,14
0.2,7974,89,680567,85.33755485893417,12
0.2,7975,95,680662,85.33876629889669,6
0.2,7976,93,680755,85.33972671430362,8
0.2,7977,88,680843,85.340060165455,15
0.2,7978,95,680938,85.34127083594436,6
0.2,7979,25,680963,85.33370927318296,7
0.2,7980,95,681058,85.33492043603559,8
0.2,7981,92,681150,85.33575544976196,9
0.2,7982,94,681244,85.33684078667167,7
0.2,7983,27,681271,85.32953406813627,6
0.2,7984,91,681362,85.33024420788979,10
0.2,7985,89,681451,85.33070373153018,12
0.2,7986,88,681539,85.33103793664705,13
0.2,7987,92,681631,85.33187280921382,9
0.2,7988,91,681722,85.33258230066342,11
0.2,7989,93,681815,85.33354192740926,8
0.2,7990,96,681911,85.33487673632837,6
0.2,7991,96,682007,85.33621121121121,7
0.2,7992,95,682102,85.33742024271237,7
0.2,7993,25,682127,85.32987240430323,7
0.2,7994,93,682220,85.33083176985616,8
0.2,7995,89,682309,85.33129064532267,12
0.2,7996,95,682404,85.33249968738276,6
0.2,7997,94,682498,85.33358339584896,7
0.2,7998,89,682587,85.3340417552194,12
0.2,7999,91,682678,85.33475,10
0.2,8000,92,682770,85.33558305211848,10
0.2,8001,93,682863,85.3365408647838,10
0.2,8002,20,682883,85.328376858678,13
0.2,8003,95,682978,85.3295852073963,6
0.2,8004,22,683000,85.32167395377888,11
0.2,8005,92,683092,85.32250811891082,9
0.2,8006,94,683186,85.32359185712501,7
0.2,8007,92,683278,85.32442557442558,9
0.2,8008,92,683370,85.32525908353102,9
0.2,8009,22,683392,85.31735330836455,11
0.2,8010,91,683483,85.31806266383722,10
0.2,8011,96,683579,85.31939590614078,6
0.2,8012,21,683600,85.31136902533383,11
0.2,8013,85,683685,85.31133017219865,16
0.2,8014,93,683778,85.31228945726762,8
0.2,8015,88,683866,85.312624750499,13
0.2,8016,96,683962,85.31395783959087,6
0.2,8017,96,684058,85.31529059615865,6
0.2,8018,90,684148,85.31587479735627,11
0.2,8019,96,684244,85.31720698254364,6
0.2,8020,93,684337,85.31816481735444,8
0.2,8021,92,684429,85.31899775617053,9
0.2,8022,94,684523,85.32007977065935,8
0.2,8023,94,684617,85.32116151545364,7
0.2,8024,91,684708,85.3218691588785,10
0.2,8025,93,684801,85.32282581609768,8
0.2,8026,91,684892,85.32353307586894,10
0.2,8027,92,684984,85.32436472346787,9
0.2,8028,90,685074,85.32494706688254,11
0.2,8029,91,685165,85.32565379825654,11
0.2,8030,88,685253,85.32598680114556,13
0.2,8031,94,685347,85.32706673306772,7
0.2,8032,92,685439,85.32789742312958,10
0.2,8033,90,685529,85.3284789644013,12
0.2,8034,95,685624,85.32968263845675,8
0.2,8035,90,685714,85.3302638128422,11
0.2,8036,94,685808,85.33134254074903,7
0.2,8037,95,685903,85.3325454093058,6
0.2,8038,93,685996,85.33349919144172,8
0.2,8039,94,686090,85.33457711442786,8
0.2,8040,94,686184,85.3356547693073,8
0.2,8041,89,686273,85.33611042029347,12
0.2,8042,96,686369,85.33743627999503,6
0.2,8043,94,686463,85.33851317752362,8
0.2,8044,95,686558,85.3397141081417,6
0.2,8045,92,686650,85.34054188416604,9
0.2,8046,95,686745,85.34174226419783,7
0.2,8047,94,686839,85.34281809145129,7
0.2,8048,94,686933,85.34389365138526,7
0.2,8049,95,687028,85.34509316770186,6
0.2,8050,93,687121,85.34604396969321,8
0.2,8051,87,687208,85.34624937903627,14
0.2,8052,94,687302,85.3473239786415,7
0.2,8053,96,687398,85.34864663521232,6
0.2,8054,90,687488,85.34922408441962,11
0.2,8055,93,687581,85.35017378351539,8
0.2,8056,96,687677,85.3514955938935,6
0.2,8057,96,687773,85.35281707619757,6
0.2,8058,95,687868,85.35401414567565,6
0.2,8059,93,687961,85.35496277915632,8
0.2,8060,90,688051,85.35553901501055,12
0.2,8061,92,688143,85.35636318531382,9
0.2,8062,90,688233,85.35693910455166,11
0.2,8063,94,688327,85.35801091269842,7
0.2,8064,94,688421,85.3590824550527,7
0.2,8065,90,688511,85.35965782296057,12
0.2,8066,94,688605,85.36072889550019,7
0.2,8067,91,688696,85.36142786316312,10
0.2,8068,92,688788,85.3622505886727,9
0.2,8069,88,688876,85.36257744733581,13
0.2,8070,94,688970,85.36364762730764,7
0.2,8071,94,689064,85.36471754212091,8
0.2,8072,92,689156,85.36553945249598,9
0.2,8073,96,689252,85.36685657666584,6
0.2,8074,96,689348,85.36817337461301,6
0.2,8075,88,689436,85.36849925705795,13
0.2,8076,89,689525,85.36894886715365,14
0.2,8077,88,689613,85.3692745729141,13
0.2,8078,91,689704,85.36997153113009,10
0.2,8079,96,689800,85.37128712871286,6
0.2,8080,85,689885,85.37124118302191,16
0.2,8081,95,689980,85.37243256619648,7
0.2,8082,90,690070,85.37300507237411,11
0.2,8083,91,690161,85.37370113805046,10
0.2,8084,95,690256,85.37489177489178,6
0.2,8085,91,690347,85.37558743507297,11
0.2,8086,25,690372,85.36812167676518,8
0.2,8087,89,690461,85.36857072205737,12
0.2,8088,94,690555,85.36963777970082,7
0.2,8089,95,690650,85.3708281829419,6
0.2,8090,93,690743,85.37177110369547,8
0.2,8091,26,690769,85.36443400889767,7
0.2,8092,94,690863,85.36550105029038,7
0.2,8093,95,690958,85.36669137632815,6
0.2,8094,95,691053,85.36788140827672,6
0.2,8095,92,691145,85.36870059288538,9
0.2,8096,93,691238,85.3696430776831,8
0.2,8097,94,691332,85.37070881699185,7
0.2,8098,95,691427,85.37189776515619,7
0.2,8099,96,691523,85.37320987654321,6
0.2,8100,89,691612,85.37365757313911,12
0.2,8101,94,691706,85.37472229079239,7
0.2,8102,94,691800,85.37578674564976,7
0.2,8103,18,691818,85.36747285291214,14
0.2,8104,92,691910,85.368291178285,9
0.2,8105,91,692001,85.36898593634345,10
0.2,8106,93,692094,85.3699272233872,8
0.2,8107,96,692190,85.3712382831771,6
0.2,8108,90,692280,85.37180910099889,12
0.2,8109,96,692376,85.3731196054254,6
0.2,8110,23,692399,85.36542966342004,10
0.2,8111,90,692489,85.3660009861933,11
0.2,8112,93,692582,85.3669419450265,8
0.2,8113,27,692609,85.35974858269657,6
0.2,8114,94,692703,85.36081330868761,7
0.2,8115,90,692793,85.36138491867915,11
0.2,8116,22,692815,85.35357890846372,10
0.2,8117,92,692907,85.35439763488544,10
0.2,8118,92,692999,85.35521615962557,9
0.2,8119,89,693088,85.35566502463054,13
0.2,8120,85,693173,85.3556212289127,16
0.2,8121,93,693266,85.35656242304852,8
0.2,8122,91,693357,85.35725717099594,10
0.2,8123,90,693447,85.35782865583457,11
0.2,8124,95,693542,85.35901538461539,7
0.2,8125,92,693634,85.35983263598327,9
0.2,8126,94,693728,85.36089577950042,7
0.2,8127,82,693810,85.36048228346456,19
0.2,8128,96,693906,85.36179111821872,6
0.2,8129,92,693998,85.36260762607625,9
0.2,8130,96,694094,85.36391587750585,6
0.2,8131,92,694186,85.3647319232661,9
0.2,8132,95,694281,85.3659166359277,6
0.2,8133,93,694374,85.36685517580526,11
0.2,8134,-44,694330,85.35095267363245,8
0.2,8135,94,694424,85.3520157325467,7
0.2,8136,95,694519,85.35320142558683,6
0.2,8137,94,694613,85.35426394691571,7
0.2,8138,25,694638,85.34684850718762,8
0.2,8139,93,694731,85.3477886977887,8
0.2,8140,89,694820,85.3482373172829,12
0.2,8141,88,694908,85.34856300663228,13
0.2,8142,91,694999,85.34925703057841,10
0.2,8143,95,695094,85.350442043222,6
0.2,8144,94,695188,85.35150399017802,8
0.2,8145,93,695281,85.35244291676896,9
0.2,8146,95,695376,85.35362710200074,7
0.2,8147,95,695471,85.35481099656357,8
0.2,8148,89,695560,85.35525831390355,12
0.2,8149,94,695654,85.3563190184049,7
0.2,8150,96,695750,85.35762483130904,6
0.2,8151,91,695841,85.35831697742886,11
0.2,8152,95,695936,85.35949957071017,7
0.2,8153,84,696020,85.35933284277655,18
0.2,8154,94,696114,85.36039239730226,7
0.2,8155,91,696205,85.36108386463953,12
0.2,8156,92,696297,85.36189775652814,9
0.2,8157,92,696389,85.36271144888453,9
0.2,8158,95,696484,85.36389263390122,6
0.2,8159,92,696576,85.36470588235294,10
0.2,8160,87,696663,85.36490626148756,14
0.2,8161,92,696755,85.36571918647391,9
0.2,8162,87,696842,85.36591939238025,15
0.2,8163,95,696937,85.36709946104851,6
0.2,8164,91,697028,85.36778934476423,11
0.2,8165,95,697123,85.36896889542004,7
0.2,8166,96,697219,85.37027060119995,6
0.2,8167,93,697312,85.37120470127326,8
0.2,8168,96,697408,85.3725058146652,6
0.2,8169,93,697501,85.3734394124847,8
0.2,8170,89,697590,85.37388324562477,12
0.2,8171,91,697681,85.37457170827214,10
0.2,8172,92,697773,85.37538235653983,9
0.2,8173,27,697800,85.36824076339613,6
0.2,8174,95,697895,85.36941896024464,6
0.2,8175,93,697988,85.37035225048923,8
0.2,8176,96,698084,85.37165219518161,6
0.2,8177,94,698178,85.37270726338959,10
0.2,8178,83,698261,85.37241716591271,18
0.2,8179,92,698353,85.37322738386308,9
0.2,8180,25,698378,85.3658476958807,8
0.2,8181,95,698473,85.36702517721828,6
0.2,8182,92,698565,85.3678357570573,9
0.2,8183,94,698659,85.36889051808407,8
0.2,8184,96,698755,85.37018937080025,6
0.2,8185,92,698847,85.37099926704128,9
0.2,8186,94,698941,85.37205325516062,7
0.2,8187,96,699037,85.37335124572544,6
0.2,8188,96,699133,85.37464891928197,6
0.2,8189,95,699228,85.37582417582418,6
0.2,8190,92,699320,85.37663288975705,10
0.2,8191,91,699411,85.3773193359375,10
0.2,8192,92,699503,85.37812766996217,9
0.2,8193,92,699595,85.37893580668782,10
0.2,8194,95,699690,85.38010982306284,7
0.2,8195,94,699784,85.38116154221572,7
0.2,8196,94,699878,85.38221300475784,8
0.2,8197,75,699953,85.38094657233472,26
0.2,8198,95,700048,85.38211977070374,6
0.2,8199,86,700134,85.38219512195121,15
0.2,8200,96,700230,85.38348981831484,6
0.2,8201,91,700321,85.38417459156304,11
0.2,8202,94,700415,85.38522491771303,7
0.2,8203,94,700509,85.38627498781082,7
0.2,8204,92,700601,85.38708104814138,10
0.2,8205,88,700689,85.38739946380697,14
0.2,8206,96,700785,85.3886925795053,6
0.2,8207,96,700881,85.38998538011695,6
0.2,8208,96,700977,85.39127786575709,6
0.2,8209,92,701069,85.39208282582217,9
0.2,8210,25,701094,85.38472780416514,8
0.2,8211,90,701184,85.38528981977593,12
0.2,8212,93,701277,85.38621697309144,8
0.2,8213,93,701370,85.38714390065742,8
0.2,8214,94,701464,85.38819233110165,7
0.2,8215,23,701487,85.3805988315482,10
0.2,8216,92,701579,85.38140440550079,9
0.2,8217,95,701674,85.38257483572646,7
0.2,8218,93,701767,85.38350164253559,8
0.2,8219,95,701862,85.38467153284671,7
0.2,8220,93,701955,85.38559785914123,8
0.2,8221,94,702049,85.38664558501581,8
0.2,8222,93,702142,85.3875714459443,8
0.2,8223,94,702236,85.3886186770428,9
0.2,8224,18,702254,85.3804255319149,14
0.2,8225,94,702348,85.38147337709701,8
0.2,8226,89,702437,85.38191321259268,14
0.2,8227,93,702530,85.38283908604764,8
0.2,8228,94,702624,85.38388625592417,8
0.2,8229,96,702720,85.38517618469015,6
0.2,8230,91,702811,85.38585834042036,10
0.2,8231,86,702897,85.38593294460641,15
0.2,8232,93,702990,85.38685776752095,8
0.2,8233,91,703081,85.38753947048822,10
0.2,8234,96,703177,85.38882817243473,6
0.2,8235,92,703269,85.38963088878096,9
0.2,8236,94,703363,85.39067621706933,7
0.2,8237,95,703458,85.3918426802622,6
0.2,8238,94,703552,85.39288748634543,8
0.2,8239,91,703643,85.39356796116505,10
0.2,8240,92,703735,85.39436961533795,9
0.2,8241,96,703831,85.39565639407911,6
0.2,8242,89,703920,85.39609365522261,12
0.2,8243,94,704014,85.39713731198448,8
0.2,8244,93,704107,85.39805942995756,8
0.2,8245,94,704201,85.39910259519768,7
0.2,8246,94,704295,85.40014550745725,8
0.2,8247,26,704321,85.39294374393792,7
0.2,8248,91,704412,85.39362346951145,10
0.2,8249,84,704496,85.39345454545455,18
0.2,8250,20,704516,85.38552902678464,13
0.2,8251,93,704609,85.38645176926805,8
0.2,8252,89,704698,85.38688961589725,12
0.2,8253,93,704791,85.38781196995396,9
0.2,8254,93,704884,85.38873410054512,8
0.2,8255,18,704902,85.38057170542636,15
0.2,8256,94,704996,85.38161559888579,7
0.2,8257,91,705087,85.38229595543716,13
0.2,8258,89,705176,85.38273398716552,12
0.2,8259,88,705264,85.38305084745762,13
0.2,8260,90,705354,85.38360973247791,11
0.2,8261,93,705447,85.38453159041394,9
0.2,8262,24,705471,85.37710274718626,9
0.2,8263,90,705561,85.37766214908035,12
0.2,8264,94,705655,85.37870538415002,8
0.2,8265,91,705746,85.37938543430921,11
0.2,8266,95,705841,85.38054917140438,7
0.2,8267,88,705929,85.38086598935655,13
0.2,8268,95,706024,85.382029265933,7
0.2,8269,93,706117,85.38295042321644,8
0.2,8270,94,706211,85.38399226212066,7
0.2,8271,94,706305,85.3850338491296,7
0.2,8272,95,706400,85.38619605947056,6
0.2,8273,89,706489,85.38663282571912,14
0.2,8274,96,706585,85.38791540785499,6
0.2,8275,24,706609,85.38049782503624,9
0.2,8276,95,706704,85.38166002174701,6
0.2,8277,92,706796,85.38245953128775,9
0.2,8278,83,706879,85.38217175987438,18
0.2,8279,89,706968,85.38260869565218,12
0.2,8280,95,707063,85.38377007607777,6
0.2,8281,96,707159,85.38505191982613,6
0.2,8282,86,707245,85.3851261620186,16
0.2,8283,92,707337,85.3859246740705,9
0.2,8284,92,707429,85.3867229933615,9
0.2,8285,26,707455,85.37955587738354,6
0.2,8286,91,707546,85.38023410160493,10
0.2,8287,94,707640,85.38127413127413,7
0.2,8288,94,707734,85.3823139100012,8
0.2,8289,90,707824,85.38287092882992,14
0.2,8290,94,707918,85.38391026414185,7
0.2,8291,93,708011,85.38482875060299,9
0.2,8292,95,708106,85.38598818280478,6
0.2,8293,93,708199,85.38690619725102,8
0.2,8294,94,708293,85.38794454490657,7
0.2,8295,95,708388,85.3891031822565,6
0.2,8296,94,708482,85.39014101482464,7
0.2,8297,25,708507,85.38286334056399,8
0.2,8298,93,708600,85.38378117845524,8
0.2,8299,92,708692,85.38457831325302,9
0.2,8300,93,708785,85.38549572340682,8
0.2,8301,23,708808,85.37798120934714,9
0.2,8302,91,708899,85.37865831627123,10
0.2,8303,87,708986,85.3788535645472,14
0.2,8304,94,709080,85.37989163154727,7
0.2,8305,94,709174,85.38092944859137,7
0.2,8306,94,709268,85.38196701576983,9
0.2,8307,94,709362,85.38300433317285,7
0.2,8308,90,709452,85.38355999518595,11
0.2,8309,94,709546,85.38459687123947,7
0.2,8310,90,709636,85.38515220791722,12
0.2,8311,91,709727,85.38582771896054,10
0.2,8312,93,709820,85.38674365451702,8
0.2,8313,91,709911,85.38741881164302,12
0.2,8314,90,710001,85.38797354179194,11
0.2,8315,92,710093,85.38876863876864,9
0.2,8316,94,710187,85.3898040158711,8
0.2,8317,88,710275,85.39011781678288,15
0.2,8318,93,710368,85.39103257603077,8
0.2,8319,89,710457,85.39146634615385,12
0.2,8320,93,710550,85.39238072347074,8
0.2,8321,25,710575,85.38512376832492,8
0.2,8322,94,710669,85.38615883695783,7
0.2,8323,93,710762,85.38707352234502,8
0.2,8324,92,710854,85.38786786786787,9
0.2,8325,86,710940,85.38794138842181,15
0.2,8326,86,711026,85.3880148913174,15
0.2,8327,96,711122,85.38928914505283,6
0.2,8328,95,711217,85.39044303037579,6
0.2,8329,95,711312,85.39159663865546,6
0.2,8330,91,711403,85.39226983555396,10
0.2,8331,96,711499,85.3935429668747,6
0.2,8332,94,711593,85.39457578303133,7
0.2,8333,94,711687,85.39560835133189,7
0.2,8334,85,711772,85.39556088782244,16
0.2,8335,94,711866,85.39659309021113,7
0.2,8336,95,711961,85.39774499220343,7
0.2,8337,89,712050,85.39817702086832,12
0.2,8338,93,712143,85.39908861973858,8
0.2,8339,24,712167,85.39172661870504,8
0.2,8340,92,712259,85.39251888262798,9
0.2,8341,85,712344,85.39247182929753,16
0.2,8342,85,712429,85.3924247872468,16
0.2,8343,93,712522,85.39333652924257,8
0.2,8344,91,712613,85.39400838825644,10
0.2,8345,94,712707,85.39503953989936,7
0.2,8346,88,712795,85.39535162333773,13
0.2,8347,93,712888,85.39626257786296,8
0.2,8348,27,712915,85.38926817582944,6
0.2,8349,83,712998,85.38898203592814,18
0.2,8350,93,713091,85.38989342593702,8
0.2,8351,93,713184,85.39080459770115,8
0.2,8352,93,713277,85.39171555129893,9
0.2,8353,91,713368,85.39238688053626,10
0.2,8354,79,713447,85.39162178336325,22
0.2,8355,92,713539,85.39241263762565,10
0.2,8356,92,713631,85.39320330262056,9
0.2,8357,92,713723,85.39399377841589,9
0.2,8358,91,713814,85.39466443354468,10
0.2,8359,92,713906,85.39545454545454,9
0.2,8360,94,714000,85.39648367420165,7
0.2,8361,94,714094,85.39751255680459,7
0.2,8362,94,714188,85.39854119335166,7
0.2,8363,89,714277,85.39897178383549,12
0.2,8364,91,714368,85.39964136282128,10
0.2,8365,17,714385,85.39146545541477,17
0.2,8366,87,714472,85.39165770288037,14
0.2,8367,94,714566,85.39268642447419,7
0.2,8368,91,714657,85.39335643446051,10
0.2,8369,95,714752,85.39450418160095,6
0.2,8370,94,714846,85.39553219448095,7
0.2,8371,95,714941,85.39667940754897,6
0.2,8372,85,715026,85.39663203152992,17
0.2,8373,92,715118,85.39742058753284,9
0.2,8374,89,715207,85.39785074626866,12
0.2,8375,94,715301,85.39887774594078,8
0.2,8376,91,715392,85.3995463769846,10
0.2,8377,19,715411,85.39162091191216,13
0.2,8378,94,715505,85.39264828738513,8
0.2,8379,96,715601,85.39391408114558,6
0.2,8380,96,715697,85.39517957284333,6
0.2,8381,91,715788,85.39584824624195,10
0.2,8382,92,715880,85.39663604914708,10
0.2,8383,87,715967,85.39682729007633,14
0.2,8384,93,716060,85.39773404889684,8
0.2,8385,-46,716014,85.38206534700691,10
0.2,8386,17,716031,85.373912006677,16
0.2,8387,8,716039,85.36468764902241,24
0.2,8388,94,716133,85.36571701037073,8
0.2,8389,92,716225,85.36650774731824,9
0.2,8390,91,716316,85.36717912048624,10
0.2,8391,91,716407,85.36785033365109,10
0.2,8392,93,716500,85.36875968068628,9
0.2,8393,90,716590,85.36931141291399,11
0.2,8394,94,716684,85.37033948779035,7
0.2,8395,27,716711,85.36338732729871,6
0.2,8396,92,716803,85.36417768250566,9
0.2,8397,94,716897,85.36520600142892,7
0.2,8398,15,716912,85.3568281938326,17
0.2,8399,94,717006,85.35785714285714,7
0.2,8400,95,717101,85.35900488037139,6
0.2,8401,94,717195,85.36003332539872,7
0.2,8402,89,717284,85.3604665000595,12
0.2,8403,94,717378,85.361494526416,7
0.2,8404,92,717470,85.36228435455087,9
0.2,8405,88,717558,85.36259814418273,13
0.2,8406,94,717652,85.36362555013679,7
0.2,8407,86,717738,85.36370123691722,16
0.2,8408,94,717832,85.36472826733262,7
0.2,8409,88,717920,85.36504161712247,13
0.2,8410,94,718014,85.36606824396624,7
0.2,8411,93,718107,85.3669757489301,8
0.2,8412,19,718126,85.35908712706525,14
0.2,8413,93,718219,85.35999524601854,9
0.2,8414,93,718312,85.36090314913844,8
0.2,8415,84,718396,85.36074144486692,17
0.2,8416,91,718487,85.36141142925032,10
0.2,8417,93,718580,85.3623188405797,8
0.2,8418,95,718675,85.3634635942511,6
0.2,8419,17,718692,85.35534441805225,16
0.2,8420,87,718779,85.35553972212327,16
0.2,8421,90,718869,85.35609118974115,11
0.2,8422,86,718955,85.35616763623412,15
0.2,8423,94,719049,85.35719373219374,7
0.2,8424,95,719144,85.35833827893175,7
0.2,8425,94,719238,85.35936387372419,7
0.2,8426,90,719328,85.35991456034176,11
0.2,8427,95,719423,85.36105837683911,7
0.2,8428,91,719514,85.36172736979475,10
0.2,8429,93,719607,85.3626334519573,10
0.2,8430,95,719702,85.36377653896335,8
0.2,8431,93,719795,85.36468216318785,10
0.2,8432,95,719890,85.36582473615557,6
0.2,8433,94,719984,85.36684847047664,8
0.2,8434,94,720078,85.36787196206284,7
0.2,8435,94,720172,85.36889521100048,7
0.2,8436,86,720258,85.36897001303781,15
0.2,8437,96,720354,85.3702299123015,6
0.2,8438,93,720447,85.37113402061856,8
0.2,8439,27,720474,85.36421800947868,6
0.2,8440,92,720566,85.36500414642815,10
0.2,8441,94,720660,85.36602700781805,7
0.2,8442,93,720753,85.36693118559754,8
0.2,8443,94,720847,85.36795357650402,7
0.2,8444,93,720940,85.36885731201895,8
0.2,8445,93,721033,85.36976083353066,8
0.2,8446,90,721123,85.37030898543861,11
0.2,8447,92,721215,85.37109375,9
0.2,8448,91,721306,85.37175997159427,10
0.2,8449,93,721399,85.37266272189349,9
0.2,8450,23,721422,85.36528221512248,9
0.2,8451,90,721512,85.36583057264552,11
0.2,8452,94,721606,85.36685200520525,7
0.2,8453,93,721699,85.36775490891885,8
0.2,8454,95,721794,85.36889414547605,9
0.2,8455,94,721888,85.36991485335857,7
0.2,8456,94,721982,85.37093531985337,8
0.2,8457,82,722064,85.37053676992197,19
0.2,8458,87,722151,85.37072940063837,15
0.2,8459,93,722244,85.37163120567376,9
0.2,8460,95,722339,85.3727691762203,6
0.2,8461,89,722428,85.37319782557316,12
0.2,8462,93,722521,85.37409901926031,8
0.2,8463,96,722617,85.37535444234405,6
0.2,8464,84,722701,85.37519196692263,17
0.2,8465,94,722795,85.37621072525396,7
0.2,8466,96,722891,85.37746545411598,6
0.2,8467,95,722986,85.37860179499292,6
0.2,8468,89,723075,85.37902940134609,12
0.2,8469,92,723167,85.37981109799291,10
0.2,8470,93,723260,85.38071065989848,8
0.2,8471,95,723355,85.38184608120869,6
0.2,8472,79,723434,85.3810928832763,24
0.2,8473,95,723529,85.38222799150343,8
0.2,8474,94,723623,85.38324483775811,8
0.2,8475,94,723717,85.3842614440774,7
0.2,8476,92,723809,85.38504187802289,9
0.2,8477,92,723901,85.38582212786035,10
0.2,8478,94,723995,85.38683807052719,7
0.2,8479,85,724080,85.38679245283019,16
0.2,8480,21,724101,85.37920056597099,12
0.2,8481,93,724194,85.38009903324688,8
0.2,8482,93,724287,85.38099728869504,8
0.2,8483,92,724379,85.38177746346064,9
0.2,8484,91,724470,85.38243959929287,10
0.2,8485,94,724564,85.38345510252181,7
0.2,8486,87,724651,85.38364557558619,16
0.2,8487,93,724744,85.38454288407164,8
0.2,8488,25,724769,85.37742961479562,8
0.2,8489,94,724863,85.37844522968197,7
0.2,8490,-58,724805,85.36155929808032,21
0.2,8491,93,724898,85.36245878473858,10
0.2,8492,92,724990,85.36324031555398,9
0.2,8493,92,725082,85.3640216623499,9
0.2,8494,94,725176,85.3650382577987,7
0.2,8495,91,725267,85.36570150659134,10
0.2,8496,-51,725216,85.34965281864187,18
0.2,8497,89,725305,85.3500823723229,12
0.2,8498,92,725397,85.35086480762443,9
0.2,8499,96,725493,85.35211764705882,6
0.2,8500,93,725586,85.35301729208328,8
0.2,8501,94,725680,85.35403434486004,8
0.2,8502,95,725775,85.35516876396566,8
0.2,8503,94,725869,85.35618532455315,8
0.2,8504,90,725959,85.3567313345091,11
0.2,8505,95,726054,85.35786503644486,7
0.2,8506,92,726146,85.35864582108852,10
0.2,8507,93,726239,85.35954395862717,8
0.2,8508,94,726333,85.36055940768598,8
0.2,8509,87,726420,85.36075205640422,14
0.2,8510,94,726514,85.3617671248972,7
0.2,8511,92,726606,85.3625469924812,9
0.2,8512,84,726690,85.3623869376248,17
0.2,8513,85,726775,85.36234437397228,16
0.2,8514,89,726864,85.36277157956548,12
0.2,8515,94,726958,85.36378581493659,7
0.2,8516,95,727053,85.36491722437478,6
0.2,8517,24,727077,85.35771307818737,9
0.2,8518,96,727173,85.35896231952107,6
0.2,8519,87,727260,85.35915492957747,15
0.2,8520,93,727353,85.36005163713179,9
0.2,8521,92,727445,85.36083079089416,9
0.2,8522,94,727539,85.36184442097853,7
0.2,8523,95,727634,85.3629751290474,6
0.2,8524,94,727728,85.36398826979472,7
0.2,8525,92,727820,85.36476659629369,9
0.2,8526,94,727914,85.3657792893163,7
0.2,8527,19,727933,85.35799718574108,15
0.2,8528,94,728027,85.35901043498652,7
0.2,8529,23,728050,85.35169988276671,10
0.2,8530,94,728144,85.35271363263392,7
0.2,8531,92,728236,85.35349273323956,9
0.2,8532,24,728260,85.34630258994493,10
0.2,8533,92,728352,85.3470822591985,9
0.2,8534,91,728443,85.3477445811365,10
0.2,8535,91,728534,85.34840674789129,10
0.2,8536,-59,728475,85.3314981843739,22
0.2,8537,94,728569,85.33251346919653,7
0.2,8538,93,728662,85.33341140648788,8
0.2,8539,88,728750,85.33372365339578,13
0.2,8540,93,728843,85.33462123873083,8
0.2,8541,96,728939,85.33586981971435,6
0.2,8542,93,729032,85.33676694369659,8
0.2,8543,88,729120,85.33707865168539,13
0.2,8544,90,729210,85.3376243417203,12
0.2,8545,92,729302,85.33840393166393,9
0.2,8546,92,729394,85.33918333918334,9
0.2,8547,81,729475,85.33867571361722,20
0.2,8548,93,729568,85.33957187975201,8
0.2,8549,92,729660,85.34035087719299,9
0.2,8550,87,729747,85.34054496550111,14
0.2,8551,93,729840,85.34144059869037,9
0.2,8552,95,729935,85.34256985852917,7
0.2,8553,94,730029,85.34358194996493,7
0.2,8554,95,730124,85.34471069549971,6
0.2,8555,94,730218,85.34572230014025,7
0.2,8556,94,730312,85.34673366834171,7
0.2,8557,88,730400,85.34704370179949,13
0.2,8558,94,730494,85.34805467928496,7
0.2,8559,91,730585,85.34871495327103,10
0.2,8560,88,730673,85.34902464665343,13
0.2,8561,89,730762,85.34945106283578,12
0.2,8562,92,730854,85.35022772392853,9
0.2,8563,87,730941,85.35042036431574,14
0.2,8564,93,731034,85.35131348511383,8
0.2,8565,92,731126,85.35208965678262,9
0.2,8566,87,731213,85.35228201237305,14
0.2,8567,20,731233,85.34465452847806,12
0.2,8568,95,731328,85.345781304703,7
0.2,8569,94,731422,85.34679113185531,8
0.2,8570,94,731516,85.3478007233695,7
0.2,8571,94,731610,85.34881007932805,7
0.2,8572,90,731700,85.34935261868658,11
0.2,8573,93,731793,85.35024492652204,8
0.2,8574,94,731887,85.35125364431487,7
0.2,8575,84,731971,85.35109608208955,18
0.2,8576,89,732060,85.35152151101784,14
0.2,8577,91,732151,85.35217999533691,14
0.2,8578,90,732241,85.35272176244318,11
0.2,8579,92,732333,85.3534965034965,9
0.2,8580,94,732427,85.35450413704696,7
0.2,8581,94,732521,85.35551153577255,7
0.2,8582,91,732612,85.35616917161832,11
0.2,8583,16,732628,85.34808946877912,17
0.2,8584,94,732722,85.34909726266744,7
0.2,8585,92,732814,85.34987188446308,9
0.2,8586,94,732908,85.3508792360545,7
0.2,8587,94,733002,85.35188635305077,8
0.2,8588,94,733096,85.35289323553383,8
0.2,8589,93,733189,85.35378346915017,8
0.2,8590,93,733282,85.35467349551857,8
0.2,8591,91,733373,85.35533054003724,11
0.2,8592,89,733462,85.35575468404515,12
0.2,8593,86,733548,85.35582964859204,15
0.2,8594,85,733633,85.35578824898197,16
0.2,8595,90,733723,85.3563285248953,11
0.2,8596,90,733813,85.35686867511923,11
0.2,8597,91,733904,85.3575250058153,10
0.2,8598,21,733925,85.35004070240726,11
0.2,8599,89,734014,85.35046511627907,13
0.2,8600,91,734105,85.35112196256249,10
0.2,8601,86,734191,85.35119739595443,15
0.2,8602,85,734276,85.35115657328839,16
0.2,8603,91,734367,85.35181311018131,10
0.2,8604,90,734457,85.35235328297502,11
0.2,8605,94,734551,85.3533581222403,7
0.2,8606,91,734642,85.35401417450912,10
0.2,8607,24,734666,85.34688661710037,11
0.2,8608,89,734755,85.34731095365315,12
0.2,8609,94,734849,85.34831591173055,7
0.2,8610,95,734944,85.34943676692602,6
0.2,8611,27,734971,85.34266140269392,6
0.2,8612,96,735067,85.34389875769186,6
0.2,8613,94,735161,85.3449036452287,7
0.2,8614,94,735255,85.34590829947766,8
0.2,8615,93,735348,85.34679665738162,8
0.2,8616,93,735441,85.3476848090983,9
0.2,8617,92,735533,85.34845671849617,9
0.2,8618,93,735626,85.34934447151642,8
0.2,8619,96,735722,85.3505800464037,6
0.2,8620,95,735817,85.3516993388238,6
0.2,8621,91,735908,85.35235444212479,10
0.2,8622,92,736000,85.35312536240288,11
0.2,8623,94,736094,85.3541280148423,7
0.2,8624,88,736182,85.35443478260869,13
0.2,8625,93,736275,85.35532112218873,8
0.2,8626,88,736363,85.35562768053785,13
0.2,8627,92,736455,85.35639777468707,9
0.2,8628,91,736546,85.35705180206281,10
0.2,8629,92,736638,85.35782155272305,9
0.2,8630,91,736729,85.35847526358475,10
0.2,8631,92,736821,85.35924467099166,9
0.2,8632,87,736908,85.35943472720955,14
0.2,8633,91,736999,85.3600880240908,10
0.2,8634,92,737091,85.36085697741748,9
0.2,8635,27,737118,85.35409911996294,6
0.2,8636,20,737138,85.34653236077342,14
0.2,8637,93,737231,85.34741838388516,9
0.2,8638,96,737327,85.34865146428984,6
0.2,8639,95,737422,85.34976851851852,6
0.2,8640,91,737513,85.35042240481425,10
0.2,8641,93,737606,85.35130756769266,8
0.2,8642,95,737701,85.35242392687724,6
0.2,8643,22,737723,85.34509486348912,10
0.2,8644,95,737818,85.3462116830538,7
0.2,8645,94,737912,85.3472125838538,7
0.2,8646,90,738002,85.3477506649705,11
0.2,8647,87,738089,85.34794172062905,14
0.2,8648,92,738181,85.34871083362239,9
0.2,8649,93,738274,85.34959537572254,8
0.2,8650,87,738361,85.34978615188996,15
0.2,8651,96,738457,85.35101710587148,6
0.2,8652,94,738551,85.35201664162719,7
0.2,8653,94,738645,85.35301594638318,7
0.2,8654,93,738738,85.35389948006933,8
0.2,8655,23,738761,85.34669593345656,10
0.2,8656,92,738853,85.34746447961187,9
0.2,8657,93,738946,85.34834834834835,8
0.2,8658,18,738964,85.34057050467722,14
0.2,8659,93,739057,85.34145496535797,8
0.2,8660,91,739148,85.3421083015818,10
0.2,8661,92,739240,85.34287693373355,11
0.2,8662,91,739331,85.34352995498095,11
0.2,8663,94,739425,85.34452908587258,7
0.2,8664,92,739517,85.34529717253318,9
0.2,8665,90,739607,85.34583429494576,11
0.2,8666,92,739699,85.34660205376716,10
0.2,8667,91,739790,85.34725426857406,10
0.2,8668,90,739880,85.34779097935171,11
0.2,8669,90,739970,85.34832756632065,11
0.2,8670,90,740060,85.3488640295237,11
0.2,8671,96,740156,85.35009225092251,6
0.2,8672,92,740248,85.35085898766286,9
0.2,8673,24,740272,85.34378602720774,9
0.2,8674,93,740365,85.34466858789625,8
0.2,8675,92,740457,85.3454356846473,10
0.2,8676,88,740545,85.34574161576582,14
0.2,8677,93,740638,85.34662364600138,10
0.2,8678,96,740734,85.34785113492337,6
0.2,8679,93,740827,85.34873271889401,8
0.2,8680,91,740918,85.34938371155397,10
0.2,8681,92,741010,85.35014973508409,9
0.2,8682,94,741104,85.35114591730968,7
0.2,8683,92,741196,85.3519115614924,9
0.2,8684,92,741288,85.35267702936096,9
0.2,8685,95,741383,85.35378770435183,7
0.2,8686,92,741475,85.35455278001612,9
0.2,8687,89,741564,85.35497237569061,12
0.2,8688,93,741657,85.35585222695362,8
0.2,8689,92,741749,85.3566168009206,9
0.2,8690,86,741835,85.35669082959383,15
0.2,8691,-51,741784,85.34100322135296,18
0.2,8692,94,741878,85.34199930978949,7
0.2,8693,95,741973,85.34311019093627,8
0.2,8694,94,742067,85.34410580793559,8
0.2,8695,93,742160,85.34498620055197,8
0.2,8696,94,742254,85.34598137288721,8
0.2,8697,26,742280,85.33915842722465,7
0.2,8698,94,742374,85.34015404069433,8
0.2,8699,95,742469,85.3412643678161,6
0.2,8700,90,742559,85.34179979312722,11
0.2,8701,96,742655,85.34302459204781,6
0.2,8702,94,742749,85.34401930368838,7
0.2,8703,88,742837,85.3443244485294,13
0.2,8704,94,742931,85.34531878230902,7
0.2,8705,96,743027,85.34654261428899,6
0.2,8706,92,743119,85.3473067646721,9
0.2,8707,93,743212,85.3481855764814,8
0.2,8708,90,743302,85.34871971523711,11
0.2,8709,93,743395,85.349598163031,8
0.2,8710,88,743483,85.34990242222477,13
0.2,8711,92,743575,85.35066574839303,10
0.2,8712,86,743661,85.35074027315505,15
0.2,8713,94,743755,85.35173284369979,7
0.2,8714,96,743851,85.35295467584625,6
0.2,8715,92,743943,85.35371730151445,9
0.2,8716,94,744037,85.35470918894114,8
0.2,8717,94,744131,85.35570084881854,7
0.2,8718,92,744223,85.35646289712123,9
0.2,8719,90,744313,85.35699541284404,12
0.2,8720,94,744407,85.35798646944158,8
0.2,8721,90,744497,85.35851868837423,12
0.2,8722,94,744591,85.3595093431159,7
0.2,8723,91,744682,85.36015589179276,12
0.2,8724,94,744776,85.36114613180516,7
0.2,8725,88,744864,85.36144854457942,14
0.2,8726,89,744953,85.36186547496276,12
0.2,8727,88,745041,85.362167736022,13
0.2,8728,88,745129,85.36246992782678,13
0.2,8729,90,745219,85.36300114547537,11
0.2,8730,89,745308,85.36341770702096,12
0.2,8731,86,745394,85.36349060925332,15
0.2,8732,94,745488,85.36447956028856,7
0.2,8733,95,745583,85.36558277994047,6
0.2,8734,93,745676,85.36645678305666,9
0.2,8735,94,745770,85.36744505494505,7
0.2,8736,96,745866,85.3686620121323,6
0.2,8737,92,745958,85.36942092011903,10
0.2,8738,93,746051,85.3702940839913,8
0.2,8739,93,746144,85.37116704805491,8
0.2,8740,93,746237,85.37203981237845,10
0.2,8741,-55,746182,85.35598261267444,18
0.2,8742,91,746273,85.35662815967059,10
0.2,8743,96,746369,85.35784537968892,6
0.2,8744,92,746461,85.35860491709548,9
0.2,8745,92,746553,85.35936428081409,9
0.2,8746,95,746648,85.36046644563851,6
0.2,8747,96,746744,85.36168267032464,6
0.2,8748,91,746835,85.36232712309979,10
0.2,8749,92,746927,85.36308571428572,10
0.2,8750,94,747021,85.3640726774083,7
0.2,8751,93,747114,85.36494515539306,8
0.2,8752,86,747200,85.36501770821432,16
0.2,8753,92,747292,85.36577564541923,9
0.2,8754,91,747383,85.36641918903484,10
0.2,8755,83,747466,85.36614892645044,20
0.2,8756,91,747557,85.36679228046134,10
0.2,8757,92,747649,85.36754966887418,10
0.2,8758,92,747741,85.36830688434753,9
0.2,8759,95,747836,85.36940639269406,7
0.2,8760,96,747932,85.37061979226115,6
0.2,8761,95,748027,85.37171878566538,6
0.2,8762,94,748121,85.37270341207349,7
0.2,8763,93,748214,85.37357371063442,8
0.2,8764,94,748308,85.37455790074159,8
0.2,8765,90,748398,85.3750855578371,11
0.2,8766,21,748419,85.36774267138132,12
0.2,8767,92,748511,85.36849908759125,9
0.2,8768,95,748606,85.36959744554682,7
0.2,8769,93,748699,85.37046750285063,9
0.2,8770,95,748794,85.37156538593091,8
0.2,8771,91,748885,85.37220702234382,10
0.2,8772,88,748973,85.37250655420038,13
0.2,8773,92,749065,85.3732619101892,10
0.2,8774,94,749159,85.37424501424502,7
0.2,8775,95,749254,85.37534184138559,7
0.2,8776,19,749273,85.36777942349322,13
0.2,8777,95,749368,85.3688767372978,7
0.2,8778,90,749458,85.3694042601663,11
0.2,8779,93,749551,85.37027334851936,8
0.2,8780,96,749647,85.37148388566223,6
0.2,8781,90,749737,85.37201093145069,12
0.2,8782,94,749831,85.37299328247751,8
0.2,8783,94,749925,85.37397540983606,7
0.2,8784,93,750018,85.37484348321001,9
0.2,8785,93,750111,85.3757113589802,9
0.2,8786,95,750206,85.37680664618186,6
0.2,8787,93,750299,85.37767410104688,8
0.2,8788,90,750389,85.37820002275572,12
0.2,8789,90,750479,85.37872582480091,11
0.2,8790,93,750572,85.37959276532818,11
0.2,8791,96,750668,85.38080072793448,6
0.2,8792,93,750761,85.38166723530081,9
0.2,8793,95,750856,85.38276097339094,6
0.2,8794,93,750949,85.38362706083002,8
0.2,8795,90,751039,85.38415188722146,11
0.2,8796,94,751133,85.38513129475957,8
0.2,8797,87,751220,85.38531484428279,14
0.2,8798,90,751310,85.38583929992045,11
0.2,8799,92,751402,85.38659090909091,10
0.2,8800,92,751494,85.38734234746052,9
0.2,8801,92,751586,85.38809361508748,9
0.2,8802,93,751679,85.38895830966716,8
0.2,8803,15,751694,85.38096319854611,17
0.2,8804,94,751788,85.38194207836456,7
0.2,8805,96,751884,85.38314785373609,6
0.2,8806,94,751978,85.38412626319973,8
0.2,8807,96,752074,85.3853315168029,6
0.2,8808,94,752168,85.38630945623794,7
0.2,8809,94,752262,85.3872871736663,8
0.2,8810,95,752357,85.38837816365906,8
0.2,8811,95,752452,85.38946890603722,7
0.2,8812,87,752539,85.38965165097015,14
0.2,8813,92,752631,85.39040163376447,9
0.2,8814,96,752727,85.39160521837776,6
0.2,8815,92,752819,85.39235480943739,9
0.2,8816,93,752912,85.39321764772599,9
0.2,8817,94,753006,85.39419369471536,7
0.2,8818,88,753094,85.39448917110784,14
0.2,8819,92,753186,85.3952380952381,9
0.2,8820,95,753281,85.39632694705816,6
0.2,8821,83,753364,85.39605531625482,18
0.2,8822,93,753457,85.39691714836223,9
0.2,8823,88,753545,85.3972121486854,13
0.2,8824,95,753640,85.39830028328612,6
0.2,8825,91,753731,85.3989349648765,10
0.2,8826,94,753825,85.39990936898154,7
0.2,8827,91,753916,85.40054372451291,10
0.2,8828,91,754007,85.40117793634613,11
0.2,8829,89,754096,85.40158550396376,12
0.2,8830,85,754181,85.40154002944173,18
0.2,8831,95,754276,85.4026268115942,6
0.2,8832,92,754368,85.40337371221555,9
0.2,8833,93,754461,85.40423364274395,8
0.2,8834,93,754554,85.40509337860782,9
0.2,8835,15,754569,85.39712539610683,17
0.2,8836,93,754662,85.39798574176757,8
0.2,8837,93,754755,85.3988458927359,8
0.2,8838,95,754850,85.39993211901799,6
0.2,8839,94,754944,85.40090497737556,7
0.2,8840,96,755040,85.40210383440787,6
0.2,8841,96,755136,85.40330242026691,6
0.2,8842,92,755228,85.4040483998643,10
0.2,8843,92,755320,85.40479421076436,9
0.2,8844,90,755410,85.40531373657434,11
0.2,8845,94,755504,85.40628532670134,8
0.2,8846,92,755596,85.4070306318526,10
0.2,8847,96,755692,85.40822784810126,6
0.2,8848,25,755717,85.40140128828116,7
0.2,8849,94,755811,85.40237288135593,7
0.2,8850,91,755902,85.40300531013445,10
0.2,8851,94,755996,85.40397650248532,7
0.2,8852,95,756091,85.40506043149215,10
0.2,8853,95,756186,85.40614411565394,6
0.2,8854,95,756281,85.40722755505364,6
0.2,8855,95,756376,85.40831074977416,7
0.2,8856,88,756464,85.4086033645704,13
0.2,8857,95,756559,85.40968615940393,7
0.2,8858,94,756653,85.41065583022915,8
0.2,8859,26,756679,85.40395033860045,7
0.2,8860,20,756699,85.39656923597788,13
0.2,8861,90,756789,85.39708869329722,11
0.2,8862,94,756883,85.39805934785062,8
0.2,8863,90,756973,85.39857851985559,11
0.2,8864,92,757065,85.39932318104907,9
0.2,8865,91,757156,85.39995488382586,11
0.2,8866,92,757248,85.40069922183376,9
0.2,8867,90,757338,85.40121786197564,11
0.2,8868,90,757428,85.4017363851618,11
0.2,8869,93,757521,85.40259301014656,9
0.2,8870,94,757615,85.40356216886484,8
0.2,8871,89,757704,85.40396753832282,12
0.2,8872,89,757793,85.40437281640934,12
0.2,8873,96,757889,85.40556682443092,6
0.2,8874,92,757981,85.40630985915493,9
0.2,8875,95,758076,85.40739071653898,6
0.2,8876,94,758170,85.40835867973415,8
0.2,8877,95,758265,85.40943906285199,6
0.2,8878,93,758358,85.41029395202162,8
0.2,8879,89,758447,85.4106981981982,12
0.2,8880,21,758468,85.40344555793267,12
0.2,8881,96,758564,85.40463859491106,6
0.2,8882,93,758657,85.40549363953619,8
0.2,8883,96,758753,85.40668617739757,6
0.2,8884,92,758845,85.40742824985931,11
0.2,8885,93,758938,85.40828269187486,8
0.2,8886,88,759026,85.40857432204344,13
0.2,8887,92,759118,85.40931593159316,11
0.2,8888,94,759212,85.41028237147036,9
0.2,8889,91,759303,85.41091113610798,11
0.2,8890,91,759394,85.41153975930716,10
0.2,8891,88,759482,85.41183085919928,13
0.2,8892,95,759577,85.41290902957383,7
0.2,8893,91,759668,85.41353721610074,10
0.2,8894,93,759761,85.41439010680158,9
0.2,8895,95,759856,85.41546762589928,6
0.2,8896,92,759948,85.4162077104642,9
0.2,8897,93,760041,85.41706001348618,10
0.2,8898,94,760135,85.41802449713451,7
0.2,8899,84,760219,85.41786516853932,19
0.2,8900,90,760309,85.41837995730816,12
0.2,8901,24,760333,85.41148056616491,8
0.2,8902,92,760425,85.41222059979782,9
0.2,8903,95,760520,85.41329739442946,6
0.2,8904,94,760614,85.41426165075801,9
0.2,8905,92,760706,85.41500112283853,9
0.2,8906,94,760800,85.41596497137083,7
0.2,8907,92,760892,85.41670408621464,10
0.2,8908,93,760985,85.41755528117633,9
0.2,8909,94,761079,85.41851851851852,7
0.2,8910,27,761106,85.41196274267759,6
0.2,8911,96,761202,85.41315080789946,6
0.2,8912,94,761296,85.41411421519129,7
0.2,8913,94,761390,85.41507740632713,7
0.2,8914,91,761481,85.41570386988222,10
0.2,8915,94,761575,85.41666666666667,7
0.2,8916,96,761671,85.41785353818548,6
0.2,8917,91,761762,85.41847947970398,10
0.2,8918,90,761852,85.41899316066824,11
0.2,8919,86,761938,85.41905829596412,15
0.2,8920,92,762030,85.41979598699697,9
0.2,8921,92,762122,85.42053351266532,9
0.2,8922,95,762217,85.42160708281968,6
0.2,8923,96,762313,85.42279246974451,6
0.2,8924,93,762406,85.42364145658263,8
0.2,8925,88,762494,85.42393009186645,13
0.2,8926,90,762584,85.42444270191554,11
0.2,8927,93,762677,85.425291218638,10
0.2,8928,95,762772,85.42636353455035,6
0.2,8929,94,762866,85.42732362821948,8
0.2,8930,94,762960,85.42828350688613,8
0.2,8931,96,763056,85.4294670846395,6
0.2,8932,91,763147,85.43009067502518,10
0.2,8933,95,763242,85.43116185359301,6
0.2,8934,94,763336,85.43212087297147,7
0.2,8935,-44,763292,85.41763652641002,8
0.2,8936,91,763383,85.41826116146358,10
0.2,8937,92,763475,85.41899753859924,10
0.2,8938,21,763496,85.41179102807921,12
0.2,8939,93,763589,85.41263982102909,9
0.2,8940,96,763685,85.41382395705179,6
0.2,8941,96,763781,85.41500782822635,6
0.2,8942,95,763876,85.4160796153416,6
0.2,8943,90,763966,85.41659212880143,11
0.2,8944,96,764062,85.41777529346004,6
0.2,8945,89,764151,85.41817572099262,12
0.2,8946,92,764243,85.41891136693864,9
0.2,8947,91,764334,85.4195350916406,10
0.2,8948,93,764427,85.42038216560509,9
0.2,8949,91,764518,85.42100558659217,10
0.2,8950,90,764608,85.42151714892191,11
0.2,8951,90,764698,85.42202859696157,11
0.2,8952,95,764793,85.42309840277002,6
0.2,8953,93,764886,85.42394460576278,8
0.2,8954,95,764981,85.4250139586823,6
0.2,8955,95,765076,85.42608307280035,6
0.2,8956,94,765170,85.42704030367311,7
0.2,8957,93,765263,85.42788568876982,9
0.2,8958,94,765357,85.42884250474383,7
0.2,8959,90,765447,85.42935267857143,12
0.2,8960,19,765466,85.42193951567906,13
0.2,8961,93,765559,85.42278509261325,9
0.2,8962,92,765651,85.42351891107889,10
0.2,8963,94,765745,85.42447568049978,8
0.2,8964,85,765830,85.42442833240379,17
0.2,8965,96,765926,85.4256078518849,7
0.2,8966,94,766020,85.42656406825026,8
0.2,8967,93,766113,85.42740856378234,8
0.2,8968,87,766200,85.42758390010034,15
0.2,8969,89,766289,85.42798216276478,13
0.2,8970,95,766384,85.42904915839928,6
0.2,8971,27,766411,85.42253678109674,6
0.2,8972,89,766500,85.42293547308593,14
0.2,8973,93,766593,85.4237798083352,9
0.2,8974,95,766688,85.42484679665738,7
0.2,8975,87,766775,85.42502228163993,14
0.2,8976,95,766870,85.42608889383982,7
0.2,8977,94,766964,85.42704388505236,8
0.2,8978,93,767057,85.42788729257155,8
0.2,8979,94,767151,85.42884187082406,7
0.2,8980,91,767242,85.42946219797349,11
0.2,8981,94,767336,85.43041638833222,7
0.2,8982,91,767427,85.43103640209284,10
0.2,8983,27,767454,85.42453250222619,7
0.2,8984,93,767547,85.4253756260434,8
0.2,8985,88,767635,85.42566214110839,13
0.2,8986,96,767731,85.42683876710805,6
0.2,8987,21,767752,85.41967067200711,13
0.2,8988,90,767842,85.42018022026922,11
0.2,8989,95,767937,85.42124582869856,7
0.2,8990,86,768023,85.42131019908798,15
0.2,8991,94,768117,85.42226423487544,7
0.2,8992,96,768213,85.4234404536862,6
0.2,8993,87,768300,85.42361574382922,14
0.2,8994,88,768388,85.42390216787103,14
0.2,8995,94,768482,85.42485549132948,7
0.2,8996,89,768571,85.42525286206514,12
0.2,8997,93,768664,85.42609468770839,8
0.2,8998,96,768760,85.42726969663296,6
0.2,8999,95,768855,85.42833333333333,6
0.2,9000,91,768946,85.42895233862905,11
0.2,9001,94,769040,85.4299044656743,7
0.2,9002,92,769132,85.43063423303343,9
0.2,9003,87,769219,85.43080852954243,14
0.2,9004,95,769314,85.43187118267629,6
0.2,9005,88,769402,85.43215634021763,13
0.2,9006,92,769494,85.43288553347396,9
0.2,9007,96,769590,85.43405861456483,6
0.2,9008,95,769685,85.43512043512044,7
0.2,9009,93,769778,85.43596004439512,9
0.2,9010,92,769870,85.4366884918433,9
0.2,9011,93,769963,85.43752774079006,8
0.2,9012,94,770057,85.43847775435482,7
0.2,9013,96,770153,85.43964943421345,6
0.2,9014,94,770247,85.4405990016639,7
0.2,9015,86,770333,85.4406610470275,16
0.2,9016,94,770427,85.44161029167128,7
0.2,9017,93,770520,85.44244843646041,9
0.2,9018,84,770604,85.44228850205123,18
0.2,9019,92,770696,85.4430155210643,9
0.2,9020,92,770788,85.44374237889369,11
0.2,9021,95,770883,85.44480159609843,6
0.2,9022,94,770977,85.44574975063726,7
0.2,9023,95,771072,85.44680851063829,6
0.2,9024,95,771167,85.44786703601108,8
0.2,9025,94,771261,85.4488145357855,7
0.2,9026,92,771353,85.44954026808463,9
0.2,9027,95,771448,85.45059813912273,6
0.2,9028,96,771544,85.45176653006978,6
0.2,9029,93,771637,85.45260243632336,9
0.2,9030,91,771728,85.45321669804008,10
0.2,9031,90,771818,85.45372010628876,11
0.2,9032,92,771910,85.45444481346175,10
0.2,9033,85,771995,85.45439450963029,16
0.2,9034,92,772087,85.45511898173768,10
0.2,9035,95,772182,85.45617529880478,7
0.2,9036,93,772275,85.4570100697134,8
0.2,9037,88,772363,85.45729143615844,13
0.2,9038,96,772459,85.45845779400376,6
0.2,9039,90,772549,85.45896017699116,11
0.2,9040,95,772644,85.46001548501272,6
0.2,9041,93,772737,85.4608493696085,9
0.2,9042,85,772822,85.4607984076081,16
0.2,9043,94,772916,85.46174259177356,7
0.2,9044,92,773008,85.46246545052516,9
0.2,9045,91,773099,85.4630776033606,11
0.2,9046,96,773195,85.46424229026196,6
0.2,9047,88,773283,85.4645225464191,13
0.2,9048,94,773377,85.46546579732568,8
0.2,9049,94,773471,85.466408839779,7
0.2,9050,92,773563,85.46713070378964,10
0.2,9051,93,773656,85.46796288113124,8
0.2,9052,96,773752,85.46912625648956,7
0.2,9053,96,773848,85.47028937486193,6
0.2,9054,95,773943,85.47134180011044,6
0.2,9055,90,774033,85.47184187279152,11
0.2,9056,92,774125,85.47256265871701,9
0.2,9057,96,774221,85.47372488408037,6
0.2,9058,92,774313,85.47444530301358,9
0.2,9059,91,774404,85.47505518763796,10
0.2,9060,92,774496,85.47577530073943,10
0.2,9061,94,774590,85.47671595674244,7
0.2,9062,92,774682,85.477435727684,9
0.2,9063,27,774709,85.4709841129744,6
0.2,9064,95,774804,85.47203530060673,6
0.2,9065,91,774895,85.47264504742996,10
0.2,9066,90,774985,85.47314436969229,13
0.2,9067,91,775076,85.47375385972651,10
0.2,9068,25,775101,85.46708567648032,9
0.2,9069,95,775196,85.46813671444322,7
0.2,9070,95,775291,85.46918752067027,6
0.2,9071,27,775318,85.46274250440918,6
0.2,9072,23,775341,85.45585804033946,10
0.2,9073,94,775435,85.45679964734406,7
0.2,9074,94,775529,85.45774104683196,7
0.2,9075,93,775622,85.4585720581754,8
0.2,9076,96,775718,85.4597333920899,6
0.2,9077,88,775806,85.46001321877065,13
0.2,9078,92,775898,85.46073356096487,9
0.2,9079,91,775989,85.4613436123348,10
0.2,9080,95,776084,85.46239400947032,6
0.2,9081,96,776180,85.46355428319754,6
0.2,9082,90,776270,85.46405372674226,12
0.2,9083,93,776363,85.4648833113166,9
0.2,9084,95,776458,85.46593285635663,6
0.2,9085,92,776550,85.46665199207573,9
0.2,9086,94,776644,85.46759106415759,7
0.2,9087,92,776736,85.46830985915493,9
0.2,9088,92,776828,85.46902849598416,9
0.2,9089,23,776851,85.46215621562156,10
0.2,9090,90,776941,85.46265537344627,12
0.2,9091,90,777031,85.46315442146943,11
0.2,9092,93,777124,85.46398328384471,8
0.2,9093,26,777150,85.45744446888058,7
0.2,9094,91,777241,85.45805387575591,11
0.2,9095,96,777337,85.45921284080914,6
0.2,9096,90,777427,85.45971199296471,11
0.2,9097,93,777520,85.460540778193,8
0.2,9098,93,777613,85.46136938125069,10
0.2,9099,95,777708,85.46241758241759,6
0.2,9100,95,777803,85.4634655532359,7
0.2,9101,94,777897,85.46440342781806,7
0.2,9102,88,777985,85.46468197297594,13
0.2,9103,94,778079,85.46561950790861,7
0.2,9104,94,778173,85.4665568369028,7
0.2,9105,86,778259,85.46661541840545,15
0.2,9106,91,778350,85.46722301526299,10
0.2,9107,96,778446,85.46837944664031,6
0.2,9108,91,778537,85.4689867164343,11
0.2,9109,93,778630,85.46981339187705,8
0.2,9110,95,778725,85.4708594007244,6
0.2,9111,18,778743,85.46345478489903,14
0.2,9112,94,778837,85.46439152858554,8
0.2,9113,85,778922,85.46434057493965,16
0.2,9114,95,779017,85.46538672517828,6
0.2,9115,96,779113,85.46654234313296,6
0.2,9116,89,779202,85.46692991115499,12
0.2,9117,92,779294,85.4676464136872,10
0.2,9118,88,779382,85.46792411448624,13
0.2,9119,91,779473,85.46853070175439,10
0.2,9120,93,779566,85.46935643021598,8
0.2,9121,90,779656,85.46985310238982,11
0.2,9122,91,779747,85.47045927874602,10
0.2,9123,92,779839,85.47117492327926,10
0.2,9124,96,779935,85.47232876712329,6
0.2,9125,94,780029,85.47326320403243,8
0.2,9126,94,780123,85.47419743617837,7
0.2,9127,96,780219,85.47535056967573,6
0.2,9128,92,780311,85.47606528644978,9
0.2,9129,92,780403,85.47677984665937,9
0.2,9130,93,780496,85.47760376738583,8
0.2,9131,88,780584,85.4778799824792,13
0.2,9132,94,780678,85.47881309536844,7
0.2,9133,94,780772,85.47974600394132,7
0.2,9134,93,780865,85.48056923918993,8
0.2,9135,90,780955,85.48106392294221,11
0.2,9136,91,781046,85.48166794352632,10
0.2,9137,88,781134,85.48194353250165,13
0.2,9138,87,781221,85.48210964000438,16
0.2,9139,93,781314,85.48293216630196,8
0.2,9140,94,781408,85.4838639098567,8
0.2,9141,91,781499,85.48446729380879,11
0.2,9142,87,781586,85.48463305260856,14
0.2,9143,90,781676,85.48512685914261,11
0.2,9144,87,781763,85.48529250956807,16
0.2,9145,94,781857,85.4862234856768,8
0.2,9146,91,781948,85.48682628184105,11
0.2,9147,93,782041,85.48764757324005,8
0.2,9148,24,782065,85.48092687725435,8
0.2,9149,94,782159,85.48185792349727,7
0.2,9150,89,782248,85.4822423778822,12
0.2,9151,95,782343,85.48328234265735,8
0.2,9152,90,782433,85.48377581120944,11
0.2,9153,91,782524,85.48437841380817,10
0.2,9154,90,782614,85.48487165483343,11
0.2,9155,95,782709,85.48591087811272,6
0.2,9156,93,782802,85.4867314622693,8
0.2,9157,94,782896,85.4876610613671,7
0.2,9158,85,782981,85.48760781744733,18
0.2,9159,27,783008,85.48122270742358,6
0.2,9160,95,783103,85.48226176181639,6
0.2,9161,92,783195,85.48297314996725,9
0.2,9162,93,783288,85.48379351740697,10
0.2,9163,94,783382,85.48472282845918,8
0.2,9164,94,783476,85.48565193671577,7
0.2,9165,96,783572,85.48679903993018,6
0.2,9166,90,783662,85.48729137122287,11
0.2,9167,15,783677,85.47960296684118,17
0.2,9168,94,783771,85.4805322281601,7
0.2,9169,93,783864,85.4813522355507,10
0.2,9170,96,783960,85.48249918220478,6
0.2,9171,93,784053,85.48331879633668,9
0.2,9172,91,784144,85.48392020058868,10
0.2,9173,89,784233,85.48430346631785,14
0.2,9174,95,784328,85.48534059945504,6
0.2,9175,93,784421,85.48615954664342,8
0.2,9176,92,784513,85.48686934728124,10
0.2,9177,92,784605,85.48757899324471,9
0.2,9178,94,784699,85.48850637324327,7
0.2,9179,91,784790,85.48910675381264,10
0.2,9180,94,784884,85.49003376538504,8
0.2,9181,94,784978,85.49096057503812,8
0.2,9182,96,785074,85.49210497658717,6
0.2,9183,92,785166,85.49281358885017,9
0.2,9184,90,785256,85.49330430048992,11
0.2,9185,94,785350,85.49423035053341,8
0.2,9186,95,785445,85.49526504843801,6
0.2,9187,96,785541,85.49640835872877,6
0.2,9188,94,785635,85.49733376863641,7
0.2,9189,94,785729,85.49825897714908,7
0.2,9190,92,785821,85.4989663801545,9
0.2,9191,90,785911,85.49945604873804,12
0.2,9192,87,785998,85.49961927553574,14
0.2,9193,96,786094,85.50076136610834,6
0.2,9194,95,786189,85.50179445350734,6
0.2,9195,94,786283,85.50271857329274,7
0.2,9196,94,786377,85.503642492117,7
0.2,9197,95,786472,85.50467492933247,7
0.2,9198,89,786561,85.50505489727145,12
0.2,9199,93,786654,85.5058695652174,8
0.2,9200,95,786749,85.5069014237583,6
0.2,9201,94,786843,85.50782438600304,7
0.2,9202,92,786935,85.50852982723025,9
0.2,9203,93,787028,85.50934376358106,10
0.2,9204,91,787119,85.5099402498642,10
0.2,9205,91,787210,85.51053660656093,10
0.2,9206,91,787301,85.51113283371348,12
0.2,9207,92,787393,85.51183753258036,9
0.2,9208,95,787488,85.51286784667174,6
0.2,9209,89,787577,85.51324647122692,13
0.2,9210,93,787670,85.51405927695147,9
0.2,9211,89,787759,85.51443768996961,12
0.2,9212,91,787850,85.51503310539455,12
0.2,9213,83,787933,85.51476014760148,18
0.2,9214,89,788022,85.51513836136733,12
0.2,9215,92,788114,85.51584201388889,9
0.2,9216,26,788140,85.50938483237496,7
0.2,9217,96,788236,85.51052288999783,6
0.2,9218,92,788328,85.51122681418809,9
0.2,9219,19,788347,85.50401301518438,14
0.2,9220,90,788437,85.5045005964646,12
0.2,9221,92,788529,85.50520494469747,9
0.2,9222,94,788623,85.5061259893744,8
0.2,9223,88,788711,85.50639635732871,14
0.2,9224,88,788799,85.50666666666666,13
0.2,9225,96,788895,85.50780403208324,6
0.2,9226,92,788987,85.50850764061992,9
0.2,9227,93,789080,85.50931946250542,9
0.2,9228,94,789174,85.51023946256366,7
0.2,9229,-115,789059,85.48851570964247,11
0.2,9230,27,789086,85.48217961217637,6
0.2,9231,90,789176,85.48266897746967,11
0.2,9232,94,789270,85.48359146539586,7
0.2,9233,93,789363,85.48440545808967,8
0.2,9234,95,789458,85.4854358419058,6
0.2,9235,94,789552,85.48635773061932,7
0.2,9236,90,789642,85.48684637869438,11
0.2,9237,96,789738,85.48798441221044,6
0.2,9238,92,789830,85.48868925208356,9
0.2,9239,91,789921,85.48928571428571,11
0.2,9240,25,789946,85.48273996320745,8
0.2,9241,94,790040,85.4836615451201,7
0.2,9242,89,790129,85.48404197771286,12
0.2,9243,92,790221,85.48474686282994,9
0.2,9244,27,790248,85.4784207679827,6
0.2,9245,95,790343,85.47945057322086,7
0.2,9246,91,790434,85.48004758299989,10
0.2,9247,93,790527,85.4808607266436,8
0.2,9248,90,790617,85.48134933506326,11
0.2,9249,95,790712,85.48237837837839,7
0.2,9250,94,790806,85.48329910279969,7
0.2,9251,89,790895,85.48367920449633,13
0.2,9252,94,790989,85.48459958932239,7
0.2,9253,94,791083,85.48551977523233,7
0.2,9254,89,791172,85.48589951377633,13
0.2,9255,91,791263,85.48649524632671,10
0.2,9256,91,791354,85.48709085016745,10
0.2,9257,90,791444,85.48757831065025,11
0.2,9258,93,791537,85.48838967491089,8
0.2,9259,93,791630,85.48920086393089,8
0.2,9260,92,791722,85.48990389806717,9
0.2,9261,91,791813,85.49049881235155,11
0.2,9262,94,791907,85.4914174673432,8
0.2,9263,93,792000,85.49222797927462,9
0.2,9264,95,792095,85.49325418240691,6
0.2,9265,94,792189,85.49417224260738,8
0.2,9266,93,792282,85.49498219488508,8
0.2,9267,93,792375,85.49579197237807,8
0.2,9268,93,792468,85.49660157514295,8
0.2,9269,91,792559,85.49719525350594,10
0.2,9270,25,792584,85.49066983065472,7
0.2,9271,94,792678,85.49158757549611,7
0.2,9272,94,792772,85.49250512239836,7
0.2,9273,94,792866,85.49342247142549,7
0.2,9274,93,792959,85.49423180592991,8
0.2,9275,88,793047,85.49450194049159,14
0.2,9276,96,793143,85.4956343645575,6
0.2,9277,86,793229,85.49568872601854,16
0.2,9278,91,793320,85.49628192693179,11
0.2,9279,95,793415,85.49730603448276,6
0.2,9280,24,793439,85.49067988363323,8
0.2,9281,91,793530,85.4912734324499,10
0.2,9282,84,793614,85.49111278681461,17
0.2,9283,92,793706,85.49181387333046,9
0.2,9284,92,793798,85.49251480883144,9
0.2,9285,94,793892,85.49343097135473,7
0.2,9286,94,793986,85.49434693657801,7
0.2,9287,95,794081,85.49537037037037,6
0.2,9288,95,794176,85.49639358380881,6
0.2,9289,94,794270,85.497308934338,7
0.2,9290,94,794364,85.49822408782693,7
0.2,9291,93,794457,85.49903142488162,8
0.2,9292,90,794547,85.49951576455396,11
0.2,9293,93,794640,85.50032278889606,8
0.2,9294,92,794732,85.50102205486822,9
0.2,9295,93,794825,85.50182874354562,9
0.2,9296,93,794918,85.5026352586856,8
0.2,9297,93,795011,85.50344160034416,10
0.2,9298,92,795103,85.50414023013228,9
0.2,9299,93,795196,85.50494623655914,8
0.2,9300,85,795281,85.50489194710246,16
0.2,9301,25,795306,85.49838744356053,9
0.2,9302,92,795398,85.49908631624207,9
0.2,9303,89,795487,85.49946259673258,12
0.2,9304,94,795581,85.50037614185922,7
0.2,9305,92,795673,85.50107457554266,9
0.2,9306,90,795763,85.50155796712153,12
0.2,9307,92,795855,85.50225612376451,9
0.2,9308,95,795950,85.50327639918359,6
0.2,9309,93,796043,85.50408163265305,8
0.2,9310,94,796137,85.50499409300826,7
0.2,9311,95,796232,85.50601374570446,7
0.2,9312,94,796326,85.50692580264148,7
0.2,9313,88,796414,85.5071934721924,14
0.2,9314,91,796505,85.5077831454643,10
0.2,9315,94,796599,85.50869471876342,7
0.2,9316,91,796690,85.50928410432543,10
0.2,9317,88,796778,85.50955140588108,13
0.2,9318,95,796873,85.51056980362699,6
0.2,9319,91,796964,85.51115879828326,10
0.2,9320,21,796985,85.50423774273146,11
0.2,9321,92,797077,85.50493456339841,12
0.2,9322,94,797171,85.50584575780329,8
0.2,9323,92,797263,85.50654225654226,9
0.2,9324,88,797351,85.50680965147453,13
0.2,9325,88,797439,85.50707698906284,13
0.2,9326,92,797531,85.50777313176799,9
0.2,9327,93,797624,85.50857632933105,11
0.2,9328,93,797717,85.5093793547004,8
0.2,9329,93,797810,85.51018220793141,8
0.2,9330,94,797904,85.51109205872896,8
0.2,9331,81,797985,85.51060865837977,20
0.2,9332,95,798080,85.5116254151934,6
0.2,9333,93,798173,85.51242768373687,9
0.2,9334,86,798259,85.51247991430101,15
0.2,9335,88,798347,85.51274635818338,13
0.2,9336,93,798440,85.51354824890221,8
0.2,9337,94,798534,85.5144570571857,7
0.2,9338,27,798561,85.50819145518793,6
0.2,9339,92,798653,85.50888650963597,9
0.2,9340,96,798749,85.51000963494272,6
0.2,9341,25,798774,85.50353243416828,7
0.2,9342,89,798863,85.50390666809376,13
0.2,9343,93,798956,85.50470890410959,8
0.2,9344,90,799046,85.50518994114499,11
0.2,9345,91,799137,85.5057778728868,10
0.2,9346,93,799230,85.506579651225,9
0.2,9347,92,799322,85.50727428326915,9
0.2,9348,87,799409,85.5074339501551,14
0.2,9349,91,799500,85.50802139037434,10
0.2,9350,92,799592,85.50871564538552,9
0.2,9351,88,799680,85.50898203592814,13
0.2,9352,92,799772,85.50967603977334,10
0.2,9353,93,799865,85.5104768013684,8
0.2,9354,15,799880,85.50293960448958,19
0.2,9355,27,799907,85.4966866182129,6
0.2,9356,94,800001,85.49759538313562,7
0.2,9357,96,800097,85.49871767471681,6
0.2,9358,93,800190,85.49951917939951,8
0.2,9359,93,800283,85.50032051282051,9
0.2,9360,92,800375,85.50101484884094,9
0.2,9361,94,800469,85.50192266609699,8
0.2,9362,93,800562,85.50272348606217,8
0.2,9363,91,800653,85.50331055104657,12
0.2,9364,20,800673,85.49631607047517,13
0.2,9365,94,800767,85.4972240017083,7
0.2,9366,91,800858,85.49781146578414,10
0.2,9367,93,800951,85.4986122971819,10
0.2,9368,92,801043,85.49930622264917,9
0.2,9369,90,801133,85.49978655282817,11
0.2,9370,95,801228,85.50080034147904,7
0.2,9371,92,801320,85.50149381135297,9
0.2,9372,96,801416,85.5026138909634,6
0.2,9373,90,801506,85.5030936633241,11
0.2,9374,92,801598,85.50378666666667,9
0.2,9375,91,801689,85.5043728668942,10
0.2,9376,92,801781,85.50506558600831,9
0.2,9377,91,801872,85.50565152484538,10
0.2,9378,91,801963,85.50623733873547,10
0.2,9379,19,801982,85.49914712153519,14
0.2,9380,94,802076,85.50005329922183,7
0.2,9381,89,802165,85.50042634832658,12
0.2,9382,94,802259,85.50133219652564,8
0.2,9383,94,802353,85.5022378516624,7
0.2,9384,91,802444,85.50282365476825,10
0.2,9385,95,802539,85.50383549968038,7
0.2,9386,87,802626,85.50399488654523,14
0.2,9387,94,802720,85.50489987217725,8
0.2,9388,91,802811,85.50548514218767,10
0.2,9389,95,802906,85.50649627263046,6
0.2,9390,92,802998,85.50718773293579,9
0.2,9391,89,803087,85.50755962521295,12
0.2,9392,91,803178,85.50814436282337,11
0.2,9393,95,803273,85.50915477964658,6
0.2,9394,94,803367,85.51005854177754,8
0.2,9395,90,803457,85.51053639846744,11
0.2,9396,96,803553,85.5116526551027,6
0.2,9397,93,803646,85.51244945733134,8
0.2,9398,89,803735,85.51282051282051,12
0.2,9399,90,803825,85.51329787234043,11
0.2,9400,95,803920,85.51430698861823,6
0.2,9401,14,803934,85.5067007019783,19
0.2,9402,81,804015,85.50622141869616,20
0.2,9403,92,804107,85.5069119523607,9
0.2,9404,91,804198,85.50749601275918,10
0.2,9405,91,804289,85.50807994896874,10
0.2,9406,90,804379,85.50855745721272,11
0.2,9407,91,804470,85.50914115646259,10
0.2,9408,95,804565,85.51014985652036,6
0.2,9409,88,804653,85.51041445270988,13
0.2,9410,93,804746,85.51121028583573,8
0.2,9411,92,804838,85.51189970250743,11
0.2,9412,95,804933,85.51290768086689,6
0.2,9413,82,805015,85.51253452305077,19
0.2,9414,91,805106,85.51311736590547,10
0.2,9415,93,805199,85.51391248937978,8
0.2,9416,94,805293,85.51481363491558,7
0.2,9417,94,805387,85.51571458908474,7
0.2,9418,93,805480,85.51650918356513,8
0.2,9419,91,805571,85.51709129511677,13
0.2,9420,88,805659,85.51735484555779,13
0.2,9421,25,805684,85.51093186160051,8
0.2,9422,27,805711,85.50472248753051,6
0.2,9423,85,805796,85.5046689303905,17
0.2,9424,20,805816,85.49771883289125,13
0.2,9425,84,805900,85.49755994058985,17
0.2,9426,80,805980,85.49697676885542,22
0.2,9427,22,806002,85.49024183283835,10
0.2,9428,90,806092,85.49072011878248,11
0.2,9429,92,806184,85.4914103923648,9
0.2,9430,92,806276,85.49210051956314,9
0.2,9431,90,806366,85.49257845631891,11
0.2,9432,95,806461,85.49358634580727,7
0.2,9433,93,806554,85.49438202247191,8
0.2,9434,93,806647,85.49517753047165,8
0.2,9435,96,806743,85.49629080118694,6
0.2,9436,95,806838,85.49729787008583,7
0.2,9437,88,806926,85.49756304301759,13
0.2,9438,92,807018,85.49825193346753,9
0.2,9439,89,807107,85.49862288135593,13
0.2,9440,94,807201,85.49952335557674,7
0.2,9441,95,807296,85.5005295488244,7
0.2,9442,86,807382,85.50058244202054,15
0.2,9443,88,807470,85.500847098687,13
0.2,9444,90,807560,85.50132345156167,11
0.2,9445,95,807655,85.50232902816006,7
0.2,9446,96,807751,85.5034402455806,6
0.2,9447,96,807847,85.50455122777308,6
0.2,9448,94,807941,85.50545031220236,7
0.2,9449,96,808037,85.50656084656084,6
0.2,9450,91,808128,85.50714210136493,10
0.2,9451,27,808155,85.50095217943293,6
0.2,9452,92,808247,85.50163969110335,9
0.2,9453,92,808339,85.50232705733023,9
0.2,9454,90,808429,85.5028027498678,12
0.2,9455,95,808524,85.50380710659898,6
0.2,9456,94,808618,85.50470550914666,7
0.2,9457,92,808710,85.5053922605202,10
0.2,9458,95,808805,85.50639602494978,6
0.2,9459,94,808899,85.50729386892178,7
0.2,9460,91,808990,85.50787443187824,10
0.2,9461,91,809081,85.50845487212005,10
0.2,9462,92,809173,85.50914086441932,10
0.2,9463,96,809269,85.5102493660186,6
0.2,9464,87,809356,85.51040676175383,14
0.2,9465,92,809448,85.5110923304458,9
0.2,9466,91,809539,85.51167212422098,10
0.2,9467,84,809623,85.51151246303337,17
0.2,9468,94,809717,85.51240891329601,7
0.2,9469,95,809812,85.51341077085533,6
0.2,9470,91,809903,85.51399007496569,10
0.2,9471,26,809929,85.50770692567568,7
0.2,9472,94,810023,85.50860339913439,8
0.2,9473,94,810117,85.50949968334389,7
0.2,9474,94,810211,85.51039577836411,7
0.2,9475,16,810227,85.50306036302237,17
0.2,9476,93,810320,85.50385142977736,9
0.2,9477,96,810416,85.5049588520785,6
0.2,9478,93,810509,85.50574955164046,8
0.2,9479,95,810604,85.50675105485232,6
0.2,9480,91,810695,85.50733045037444,10
0.2,9481,95,810790,85.50833157561696,6
0.2,9482,89,810879,85.50869977855109,12
0.2,9483,91,810970,85.50927878532265,10
0.2,9484,93,811063,85.51006852925673,8
0.2,9485,90,811153,85.51054185114906,12
0.2,9486,91,811244,85.51112048065774,10
0.2,9487,94,811338,85.51201517706576,7
0.2,9488,87,811425,85.5121719886184,15
0.2,9489,94,811519,85.51306638566912,7
0.2,9490,88,811607,85.51332841639447,13
0.2,9491,92,811699,85.51401179941003,9
0.2,9492,94,811793,85.51490572000421,7
0.2,9493,92,811885,85.51558879292185,9
0.2,9494,95,811980,85.51658767772511,6
0.2,9495,95,812075,85.51758635214827,6
0.2,9496,94,812169,85.51847951984837,7
0.2,9497,91,812260,85.5190566435039,10
0.2,9498,89,812349,85.51942309716813,12
0.2,9499,91,812440,85.52,10
0.2,9500,93,812533,85.52078728554889,8
0.2,9501,81,812614,85.52031151336561,20
0.2,9502,94,812708,85.52120383036936,8
0.2,9503,93,812801,85.52199074074075,8
0.2,9504,90,812891,85.5224618621778,11
0.2,9505,15,812906,85.51504313065432,17
0.2,9506,89,812995,85.51540969811718,13
0.2,9507,94,813089,85.51630206142197,7
0.2,9508,95,813184,85.51729940056788,8
0.2,9509,89,813273,85.51766561514195,12
0.2,9510,93,813366,85.5184523183682,8
0.2,9511,93,813459,85.51923885618166,9
0.2,9512,89,813548,85.51960475139283,12
0.2,9513,93,813641,85.52039100273281,9
0.2,9514,94,813735,85.52128218602208,7
0.2,9515,96,813831,85.52238335435057,6
0.2,9516,93,813924,85.5231690658821,8
0.2,9517,95,814019,85.5241647404917,6
0.2,9518,96,814115,85.52526525895577,6
0.2,9519,95,814210,85.52626050420169,6
0.2,9520,91,814301,85.52683541644785,10
0.2,9521,87,814388,85.52699012812434,15
0.2,9522,94,814482,85.52787986978893,7
0.2,9523,95,814577,85.52887442251155,6
0.2,9524,87,814664,85.52902887139108,14
0.2,9525,94,814758,85.52991811883267,7
0.2,9526,92,814850,85.53059724992127,9
0.2,9527,76,814926,85.52959697732997,25
0.2,9528,96,815022,85.53069577080491,6
0.2,9529,95,815117,85.53168940188877,6
0.2,9530,91,815208,85.5322631413283,11
0.2,9531,27,815235,85.52612253462023,6
0.2,9532,88,815323,85.52638204133012,13
0.2,9533,91,815414,85.5269561569121,11
0.2,9534,95,815509,85.5279496591505,6
0.2,9535,94,815603,85.52883808724832,7
0.2,9536,92,815695,85.52951661948202,10
0.2,9537,92,815787,85.53019500943594,10
0.2,9538,92,815879,85.53087325715484,9
0.2,9539,94,815973,85.53176100628932,7
0.2,9540,96,816069,85.53285819096531,6
0.2,9541,88,816157,85.53311674701321,13
0.2,9542,94,816251,85.53400398197631,7
0.2,9543,94,816345,85.53489103101425,7
0.2,9544,86,816431,85.53493975903615,15
0.2,9545,94,816525,85.53582652419861,7
0.2,9546,89,816614,85.53618937886247,12
0.2,9547,94,816708,85.53707582739841,8
0.2,9548,94,816802,85.53796209027124,7
0.2,9549,93,816895,85.53874345549738,8
0.2,9550,93,816988,85.53952465710397,8
0.2,9551,25,817013,85.53318676716918,7
0.2,9552,91,817104,85.5337590285774,10
0.2,9553,94,817198,85.5346451747959,8
0.2,9554,96,817294,85.53574045002617,6
0.2,9555,93,817387,85.53652155713688,8
0.2,9556,92,817479,85.53719786543894,9
0.2,9557,94,817573,85.53808328102113,7
0.2,9558,94,817667,85.53896851135056,7
0.2,9559,95,817762,85.53995815899582,6
0.2,9560,91,817853,85.54052923334379,10
0.2,9561,92,817945,85.54120476887681,9
0.2,9562,93,818038,85.54198473282443,8
0.2,9563,94,818132,85.54286909242994,7
0.2,9564,90,818222,85.54333507579717,11
0.2,9565,27,818249,85.53721513694335,6
0.2,9566,93,818342,85.53799519180517,8
0.2,9567,90,818432,85.53846153846153,12
0.2,9568,95,818527,85.53945030828717,7
0.2,9569,88,818615,85.53970741901776,13
0.2,9570,92,818707,85.54038240518233,9
0.2,9571,94,818801,85.5412661930631,8
0.2,9572,95,818896,85.54225425676381,8
0.2,9573,95,818991,85.54324211405891,6
0.2,9574,93,819084,85.54402088772846,9
0.2,9575,90,819174,85.54448621553885,11
0.2,9576,94,819268,85.5453691135011,7
0.2,9577,94,819362,85.54625182710377,7
0.2,9578,95,819457,85.54723875143543,6
0.2,9579,91,819548,85.54780793319415,10
0.2,9580,93,819641,85.5485857426156,8
0.2,9581,91,819732,85.54915466499686,10
0.2,9582,94,819826,85.5500365230095,7
0.2,9583,-46,819780,85.53631051752922,10
0.2,9584,95,819875,85.53729786124153,6
0.2,9585,95,819970,85.53828499895681,7
0.2,9586,93,820063,85.5390633149056,8
0.2,9587,27,820090,85.53295786399666,6
0.2,9588,94,820184,85.53384085931796,7
0.2,9589,89,820273,85.53420229405631,13
0.2,9590,94,820367,85.53508497549787,7
0.2,9591,95,820462,85.53607172643869,6
0.2,9592,93,820555,85.53684978630251,8
0.2,9593,93,820648,85.53762768396915,8
0.2,9594,27,820675,85.53152683689422,6
0.2,9595,94,820769,85.53240933722384,7
0.2,9596,85,820854,85.53235386058144,16
0.2,9597,88,820942,85.5326109606168,13
0.2,9598,85,821027,85.53255547452859,16
0.2,9599,90,821117,85.53302083333334,11
0.2,9600,96,821213,85.53411103010103,6
0.2,9601,23,821236,85.52759841699645,9
0.2,9602,91,821327,85.5281682807456,10
0.2,9603,90,821417,85.5286339025406,11
0.2,9604,24,821441,85.52222800624675,9
0.2,9605,94,821535,85.52311055590256,7
0.2,9606,92,821627,85.52378474029354,11
0.2,9607,92,821719,85.52445878434638,9
0.2,9608,93,821812,85.52523675720678,8
0.2,9609,94,821906,85.5261186264308,8
0.2,9610,92,821998,85.52679221725107,9
0.2,9611,85,822083,85.52673741156887,16
0.2,9612,91,822174,85.52730677207947,11
0.2,9613,92,822266,85.5279800291242,9
0.2,9614,23,822289,85.52147685907437,10
0.2,9615,90,822379,85.52194259567388,11
0.2,9616,96,822475,85.52303213060206,6
0.2,9617,94,822569,85.52391349552921,8
0.2,9618,92,822661,85.52458675537997,10
0.2,9619,93,822754,85.52536382536383,8
0.2,9620,81,822835,85.52489346221806,22
0.2,9621,93,822928,85.5256703388069,8
0.2,9622,88,823016,85.52592746544737,13
0.2,9623,92,823108,85.52660016625104,9
0.2,9624,92,823200,85.52727272727273,9
0.2,9625,94,823294,85.52815291917723,7
0.2,9626,92,823386,85.52882517918354,9
0.2,9627,96,823482,85.52991275446614,6
0.2,9628,92,823574,85.53058469207602,9
0.2,9629,91,823665,85.53115264797508,11
0.2,9630,15,823680,85.52382930121483,17
0.2,9631,89,823769,85.52419019933555,12
0.2,9632,93,823862,85.52496626180837,8
0.2,9633,96,823958,85.52605356030725,6
0.2,9634,92,824050,85.52672548002076,9
0.2,9635,89,824139,85.52708592777086,12
0.2,9636,92,824231,85.52775760091315,9
0.2,9637,96,824327,85.52884415853912,6
0.2,9638,25,824352,85.52256458138811,8
0.2,9639,-45,824307,85.50902489626556,9
0.2,9640,94,824401,85.50990561145109,7
0.2,9641,89,824490,85.51026757934038,12
0.2,9642,91,824581,85.51083687649071,12
0.2,9643,17,824598,85.50373289091664,17
0.2,9644,93,824691,85.5045101088647,8
0.2,9645,92,824783,85.50518349574953,9
0.2,9646,94,824877,85.50606406136623,8
0.2,9647,95,824972,85.50704809286898,6
0.2,9648,-44,824928,85.49362628251632,8
0.2,9649,95,825023,85.49461139896373,7
0.2,9650,92,825115,85.49528546264636,9
0.2,9651,94,825209,85.49616659759636,9
0.2,9652,93,825302,85.49694395524708,9
0.2,9653,94,825396,85.49782473586079,7
0.2,9654,93,825489,85.49860176074573,8
0.2,9655,96,825585,85.49968931234466,6
0.2,9656,24,825609,85.49332090711401,10
0.2,9657,93,825702,85.49409815696832,8
0.2,9658,94,825796,85.49497877627084,7
0.2,9659,93,825889,85.49575569358178,8
0.2,9660,91,825980,85.49632543214989,10
0.2,9661,94,826074,85.49720554750569,7
0.2,9662,93,826167,85.49798199316982,8
0.2,9663,95,826262,85.49896523178808,6
0.2,9664,87,826349,85.4991205380238,14
0.2,9665,93,826442,85.49989654458928,10
0.2,9666,95,826537,85.50087928002483,6
0.2,9667,95,826632,85.50186181216384,6
0.2,9668,92,826724,85.50253387113456,9
0.2,9669,93,826817,85.50330920372285,8
0.2,9670,94,826911,85.50418777789267,7
0.2,9671,92,827003,85.5048593879239,9
0.2,9672,95,827098,85.50584100072366,7
0.2,9673,94,827192,85.50671904072773,8
0.2,9674,90,827282,85.5071834625323,11
0.2,9675,93,827375,85.50795783381562,8
0.2,9676,88,827463,85.50821535599876,13
0.2,9677,96,827559,85.50929944203348,6
0.2,9678,25,827584,85.50304783552019,8
0.2,9679,92,827676,85.50371900826447,9
0.2,9680,90,827766,85.50418345212272,11
0.2,9681,91,827857,85.50475108448667,10
0.2,9682,25,827882,85.49850253020757,8
0.2,9683,24,827906,85.49215200330443,9
0.2,9684,92,827998,85.49282395456892,9
0.2,9685,96,828094,85.49390873425563,6
0.2,9686,92,828186,85.49458036543821,9
0.2,9687,96,828282,85.49566473988439,6
0.2,9688,90,828372,85.49612963154092,11
0.2,9689,92,828464,85.4968008255934,9
0.2,9690,93,828557,85.49757506965226,8
0.2,9691,93,828650,85.49834915394139,9
0.2,9692,94,828744,85.49922624574435,8
0.2,9693,91,828835,85.49979368681659,10
0.2,9694,94,828929,85.50067044868489,8
0.2,9695,94,829023,85.50154702970298,7
0.2,9696,92,829115,85.50221718057131,9
0.2,9697,-49,829066,85.48834811301299,12
0.2,9698,94,829160,85.48922569337046,7
0.2,9699,22,829182,85.48268041237114,10
0.2,9700,96,829278,85.4837645603546,6
0.2,9701,94,829372,85.4846423417852,7
0.2,9702,84,829456,85.48448933319592,17
0.2,9703,88,829544,85.48474855729596,13
0.2,9704,90,829634,85.48521380731582,11
0.2,9705,88,829722,85.48547290335874,13
0.2,9706,24,829746,85.47913876583908,10
0.2,9707,93,829839,85.47991347342398,8
0.2,9708,89,829928,85.48027603254712,12
0.2,9709,91,830019,85.48084449021627,10
0.2,9710,96,830115,85.48192771084338,6
0.2,9711,94,830209,85.48280477759472,7
0.2,9712,94,830303,85.4836816637496,7
0.2,9713,95,830398,85.48466131356804,7
0.2,9714,90,830488,85.48512609366958,11
0.2,9715,87,830575,85.48528200905723,14
0.2,9716,94,830669,85.4861582793043,7
0.2,9717,96,830765,85.48724017287508,6
0.2,9718,91,830856,85.48780738759132,11
0.2,9719,93,830949,85.48858024691359,8
0.2,9720,96,831045,85.48966155745293,6
0.2,9721,96,831141,85.49074264554618,6
0.2,9722,94,831235,85.49161781343207,8
0.2,9723,86,831321,85.49167009461127,15
0.2,9724,95,831416,85.49264781491003,7
0.2,9725,91,831507,85.49321406539174,11
0.2,9726,88,831595,85.4934717795826,13
0.2,9727,92,831687,85.494140625,9
0.2,9728,87,831774,85.49429540548874,14
0.2,9729,94,831868,85.49516957862282,7
0.2,9730,92,831960,85.49583804336656,9
0.2,9731,92,832052,85.49650637073572,9
0.2,9732,87,832139,85.49666084454947,14
0.2,9733,86,832225,85.49671255393466,15
0.2,9734,96,832321,85.49779147406267,6
0.2,9735,86,832407,85.4978430566968,15
0.2,9736,94,832501,85.49871623703399,7
0.2,9737,89,832590,85.49907578558225,14
0.2,9738,94,832684,85.4999486600267,7
0.2,9739,86,832770,85.5,15
0.2,9740,91,832861,85.50056462375527,10
0.2,9741,94,832955,85.50143707657566,7
0.2,9742,92,833047,85.50210407472031,10
0.2,9743,93,833140,85.50287356321839,8
0.2,9744,91,833231,85.50343766033863,10
0.2,9745,93,833324,85.504206854094,8
0.2,9746,92,833416,85.50487329434698,9
0.2,9747,94,833510,85.50574476815757,7
0.2,9748,92,833602,85.50641091393989,10
0.2,9749,95,833697,85.50738461538461,6
0.2,9750,93,833790,85.50815300994769,8
0.2,9751,94,833884,85.5090237899918,7
0.2,9752,95,833979,85.50999692402338,6
0.2,9753,91,834070,85.51055977035062,10
0.2,9754,95,834165,85.51153254741159,8
0.2,9755,84,834249,85.51137761377613,17
0.2,9756,95,834344,85.51235010761505,6
0.2,9757,87,834431,85.5125025620004,14
0.2,9758,92,834523,85.51316733271851,9
0.2,9759,25,834548,85.50696721311475,8
0.2,9760,89,834637,85.50732506915276,13
0.2,9761,96,834733,85.50839991804958,6
0.2,9762,92,834825,85.50906483662808,9
0.2,9763,94,834919,85.509934453093,7
0.2,9764,25,834944,85.50373783922171,8
0.2,9765,26,834970,85.4976448904362,7
0.2,9766,94,835064,85.4985154090304,7
0.2,9767,94,835158,85.49938574938575,7
0.2,9768,91,835249,85.4999488176886,10
0.2,9769,87,835336,85.50010235414534,14
0.2,9770,94,835430,85.50097226486542,7
0.2,9771,94,835524,85.501841997544,8
0.2,9772,90,835614,85.50230226133225,11
0.2,9773,89,835703,85.50266011868221,12
0.2,9774,82,835785,85.50230179028134,19
0.2,9775,87,835872,85.50245499181669,14
0.2,9776,93,835965,85.50322184719239,8
0.2,9777,94,836059,85.50409081611781,7
0.2,9778,91,836150,85.50465282748748,10
0.2,9779,93,836243,85.50541922290388,8
0.2,9780,90,836333,85.50587874450466,12
0.2,9781,94,836427,85.50674708648538,8
0.2,9782,86,836513,85.50679750587754,15
0.2,9783,90,836603,85.50725674570728,11
0.2,9784,22,836625,85.50076647930506,11
0.2,9785,90,836715,85.50122624156958,12
0.2,9786,92,836807,85.50189026259324,9
0.2,9787,94,836901,85.50275847977115,7
0.2,9788,88,836989,85.50301358667893,13
0.2,9789,93,837082,85.50377936670071,8
0.2,9790,95,837177,85.50474925952405,6
0.2,9791,24,837201,85.4984681372549,9
0.2,9792,90,837291,85.4989278055754,11
0.2,9793,93,837384,85.4996936900143,8
0.2,9794,81,837465,85.49923430321593,20
0.2,9795,89,837554,85.49959167006942,14
0.2,9796,92,837646,85.5002551801572,9
0.2,9797,94,837740,85.50112267809757,9
0.2,9798,82,837822,85.50076538422287,19
0.2,9799,90,837912,85.50122448979592,11
0.2,9800,96,838008,85.50229568411386,6
0.2,9801,96,838104,85.50336665986534,6
0.2,9802,94,838198,85.5042333979394,7
0.2,9803,95,838293,85.50520195838433,7
0.2,9804,94,838387,85.50606833248342,7
0.2,9805,93,838480,85.50683255149909,8
0.2,9806,90,838570,85.50729071071683,11
0.2,9807,94,838664,85.50815660685154,8
0.2,9808,94,838758,85.5090223264349,8
0.2,9809,25,838783,85.50285423037717,8
0.2,9810,95,838878,85.50382224034247,6
0.2,9811,94,838972,85.50468813697513,8
0.2,9812,19,838991,85.49791093447467,13
0.2,9813,95,839086,85.49887915223151,6
0.2,9814,93,839179,85.49964340295466,8
0.2,9815,95,839274,85.50061124694376,6
0.2,9816,84,839358,85.50045838850973,17
0.2,9817,94,839452,85.50132409859442,7
0.2,9818,94,839546,85.50218963234545,7
0.2,9819,93,839639,85.50295315682281,8
0.2,9820,95,839734,85.503920171062,6
0.2,9821,93,839827,85.504683363877,8
0.2,9822,84,839911,85.50453018426143,17
0.2,9823,96,840007,85.50559853420195,6
0.2,9824,90,840097,85.50605597964376,12
0.2,9825,87,840184,85.50620801954,14
0.2,9826,96,840280,85.50727587259591,6
0.2,9827,93,840373,85.50803825803825,8
0.2,9828,92,840465,85.50869874860108,10
0.2,9829,90,840555,85.50915564598169,11
0.2,9830,95,840650,85.51012104567185,7
0.2,9831,93,840743,85.51088283157038,9
0.2,9832,96,840839,85.51194955761213,6
0.2,9833,96,840935,85.51301606670734,6
0.2,9834,91,841026,85.51357397051348,10
0.2,9835,93,841119,85.5143350955673,8
0.2,9836,88,841207,85.51458778082748,13
0.2,9837,95,841302,85.51555194145152,6
0.2,9838,93,841395,85.5163126333977,8
0.2,9839,89,841484,85.51666666666667,12
0.2,9840,87,841571,85.51681739660603,14
0.2,9841,96,841667,85.51788254419833,6
0.2,9842,88,841755,85.51813471502591,13
0.2,9843,16,841771,85.5110727346607,16
0.2,9844,95,841866,85.51203656678517,6
0.2,9845,94,841960,85.51289863904124,7
0.2,9846,90,842050,85.51335432111303,11
0.2,9847,84,842134,85.51320064987814,18
0.2,9848,27,842161,85.50725962026601,6
0.2,9849,92,842253,85.50791878172589,9
0.2,9850,18,842271,85.50106588163638,14
0.2,9851,94,842365,85.50192854242793,7
0.2,9852,94,842459,85.50279102811326,7
0.2,9853,96,842555,85.50385630200934,6
0.2,9854,22,842577,85.49741248097412,10
0.2,9855,82,842659,85.49705762987013,19
0.2,9856,92,842751,85.49771735822259,9
0.2,9857,90,842841,85.49817407181985,12
0.2,9858,90,842931,85.49863069276803,11
0.2,9859,90,843021,85.49908722109534,12
0.2,9860,91,843112,85.49964506642328,10
0.2,9861,89,843201,85.5,12
0.2,9862,94,843295,85.50086180675251,7
0.2,9863,91,843386,85.5014193025142,11
0.2,9864,94,843480,85.5022807906741,8
0.2,9865,94,843574,85.50314210419623,7
0.2,9866,96,843670,85.50420593898855,6
0.2,9867,94,843764,85.50506688285367,9
0.2,9868,87,843851,85.50521836052285,14
0.2,9869,92,843943,85.50587639311044,9
0.2,9870,96,844039,85.50693951980548,6
0.2,9871,96,844135,85.50800243111831,7
0.2,9872,94,844229,85.50886255444141,7
0.2,9873,89,844318,85.50921612315172,12
0.2,9874,96,844414,85.51027848101266,6
0.2,9875,27,844441,85.50435398946942,6
0.2,9876,88,844529,85.50460666194188,13
0.2,9877,93,844622,85.50536545859485,8
0.2,9878,88,844710,85.50561797752809,13
0.2,9879,94,844804,85.50647773279353,8
0.2,9880,93,844897,85.5072361097055,8
0.2,9881,95,844992,85.50819672131148,6
0.2,9882,89,845081,85.50855003541434,12
0.2,9883,85,845166,85.5084985835694,16
0.2,9884,95,845261,85.50945877592312,7
0.2,9885,92,845353,85.51011531458629,9
0.2,9886,86,845439,85.51016486295136,15
0.2,9887,94,845533,85.51102346278317,7
0.2,9888,94,845627,85.51188188896754,7
0.2,9889,92,845719,85.51253791708797,10
0.2,9890,92,845811,85.51319381255686,9
0.2,9891,92,845903,85.51384957541448,9
0.2,9892,93,845996,85.51460628727384,8
0.2,9893,87,846083,85.51475641803113,14
0.2,9894,93,846176,85.5155128852956,8
0.2,9895,95,846271,85.51647130153597,6
0.2,9896,94,846365,85.5173284833788,8
0.2,9897,94,846459,85.51818549201859,7
0.2,9898,19,846478,85.51146580462672,15
0.2,9899,90,846568,85.51191919191919,11
0.2,9900,94,846662,85.51277648722352,9
0.2,9901,91,846753,85.51333064027469,11
0.2,9902,87,846840,85.51348076340503,14
0.2,9903,90,846930,85.5139337641357,11
0.2,9904,93,847023,85.51468955073196,8
0.2,9905,94,847117,85.51554613365637,7
0.2,9906,92,847209,85.51620066619562,9
0.2,9907,96,847305,85.51725878078321,6
0.2,9908,95,847400,85.51821576344737,6
0.2,9909,92,847492,85.5188698284561,9
0.2,9910,90,847582,85.51932196549289,11
0.2,9911,93,847675,85.5200766747377,8
0.2,9912,83,847758,85.51982245536165,18
0.2,9913,94,847852,85.52067782933226,8
0.2,9914,13,847865,85.51336359051942,19
0.2,9915,95,847960,85.5143202904397,6
0.2,9916,88,848048,85.51457093879198,13
0.2,9917,-44,848004,85.50151240169389,8
0.2,9918,26,848030,85.49551366065127,7
0.2,9919,94,848124,85.49637096774194,7
0.2,9920,25,848149,85.49027315794778,7
0.2,9921,91,848240,85.49082846200363,10
0.2,9922,91,848331,85.49138365413685,10
0.2,9923,96,848427,85.49244256348247,6
0.2,9924,93,848520,85.49319899244333,8
0.2,9925,95,848615,85.49415676002418,6
0.2,9926,92,848707,85.49481212853833,11
0.2,9927,92,848799,85.4954673650282,9
0.2,9928,20,848819,85.4888709839863,13
0.2,9929,25,848844,85.48277945619336,8
0.2,9930,91,848935,85.4833350115799,10
0.2,9931,27,848962,85.4774466371325,6
0.2,9932,94,849056,85.47830464109533,7
0.2,9933,92,849148,85.47896114354741,9
0.2,9934,93,849241,85.4797181680926,9
0.2,9935,91,849332,85.48027375201288,10
0.2,9936,95,849427,85.48123176008856,6
0.2,9937,94,849521,85.48208895149929,8
0.2,9938,93,849614,85.48284535667572,8
0.2,9939,92,849706,85.48350100603622,9
0.2,9940,93,849799,85.48425711699024,8
0.2,9941,95,849894,85.48521424260713,6
0.2,9942,94,849988,85.48607060243387,7
0.2,9943,91,850079,85.48662510056316,11
0.2,9944,93,850172,85.48738059326294,8
0.2,9945,22,850194,85.48099738588377,11
0.2,9946,83,850277,85.48074796421031,18
0.2,9947,94,850371,85.48160434258142,7
0.2,9948,95,850466,85.48256106141321,6
0.2,9949,96,850562,85.48361809045227,6
0.2,9950,88,850650,85.48387096774194,13
0.2,9951,94,850744,85.4847266881029,8
0.2,9952,90,850834,85.48518034763389,11
0.2,9953,93,850927,85.485935302391,8
0.2,9954,95,851022,85.48689100954294,8
0.2,9955,92,851114,85.48754519887505,10
0.2,9956,94,851208,85.48840012051822,7
0.2,9957,91,851299,85.48895360514159,10
0.2,9958,94,851393,85.48980821367607,8
0.2,9959,95,851488,85.49076305220883,6
0.2,9960,93,851581,85.4915169159723,8
0.2,9961,24,851605,85.48534430837181,9
0.2,9962,90,851695,85.4857974505671,11
0.2,9963,95,851790,85.48675230830992,6
0.2,9964,91,851881,85.48730556949323,10
0.2,9965,19,851900,85.48063415613085,14
0.2,9966,95,851995,85.48158924450688,6
0.2,9967,90,852085,85.48204253611557,11
0.2,9968,85,852170,85.48199418196408,16
0.2,9969,90,852260,85.48244734202608,11
0.2,9970,89,852349,85.48280012034901,12
0.2,9971,22,852371,85.47643401524267,10
0.2,9972,14,852385,85.46926702095658,19
0.2,9973,94,852479,85.47012231802687,7
0.2,9974,93,852572,85.47087719298246,8
0.2,9975,23,852595,85.46461507618284,10
0.2,9976,19,852614,85.45795329257292,15
0.2,9977,94,852708,85.4588093806374,7
0.2,9978,92,852800,85.4594648762401,11
0.2,9979,88,852888,85.45971943887776,14
0.2,9980,89,852977,85.46007414086765,12
0.2,9981,-52,852925,85.44630334602284,16
0.2,9982,92,853017,85.44695983171391,9
0.2,9983,96,853113,85.44801682692308,6
0.2,9984,93,853206,85.44877315973962,8
0.2,9985,94,853300,85.44962948127379,7
0.2,9986,95,853395,85.45058576148993,8
0.2,9987,94,853489,85.4514417300761,8
0.2,9988,95,853584,85.45239763740115,6
0.2,9989,81,853665,85.45195195195195,20
0.2,9990,94,853759,85.4528075267741,7
0.2,9991,83,853842,85.45256204963971,18
0.2,9992,91,853933,85.45311718202741,10
0.2,9993,94,854027,85.45397238343006,7
0.2,9994,93,854120,85.45472736368184,8
0.2,9995,87,854207,85.45488195278111,14
0.2,9996,92,854299,85.4555366609983,9
0.2,9997,93,854392,85.45629125825165,8
0.2,9998,23,854415,85.45004500450045,10
0.2,9999,92,854507,85.4507,9
