0.05,0,87,87,87.0,14
0.05,1,-133,-46,-23.0,534
0.05,2,-138,-184,-61.333333333333336,107
0.05,3,91,-93,-23.25,10
0.05,4,74,-19,-3.8,203
0.05,5,15,-4,-0.6666666666666666,78
0.05,6,14,10,1.4285714285714286,59
0.05,7,0,10,1.25,160
0.05,8,-19,-9,-1.0,304
0.05,9,96,87,8.7,7
0.05,10,91,178,16.181818181818183,41
0.05,11,92,270,22.5,9
0.05,12,95,365,28.076923076923077,7
0.05,13,95,460,32.857142857142854,6
0.05,14,23,483,32.2,10
0.05,15,91,574,35.875,44
0.05,16,-72,502,29.529411764705884,136
0.05,17,79,581,32.27777777777778,95
0.05,18,87,668,35.1578947368421,14
0.05,19,93,761,38.05,8
0.05,20,94,855,40.714285714285715,7
0.05,21,92,947,43.04545454545455,18
0.05,22,20,967,42.04347826086956,12
0.05,23,92,1059,44.125,9
0.05,24,19,1078,43.12,18
0.05,25,24,1102,42.38461538461539,8
0.05,26,94,1196,44.2962962962963,7
0.05,27,95,1291,46.107142857142854,6
0.05,28,22,1313,45.275862068965516,10
0.05,29,91,1404,46.8,10
0.05,30,93,1497,48.29032258064516,8
0.05,31,92,1589,49.65625,26
0.05,32,92,1681,50.93939393939394,9
0.05,33,89,1770,52.05882352941177,42
0.05,34,87,1857,53.05714285714286,14
0.05,35,91,1948,54.111111111111114,10
0.05,36,88,2036,55.027027027027025,59
0.05,37,89,2125,55.921052631578945,12
0.05,38,87,2212,56.717948717948715,14
0.05,39,92,2304,57.6,9
0.05,40,95,2399,58.51219512195122,6
0.05,41,89,2488,59.23809523809524,12
0.05,42,93,2581,60.02325581395349,8
0.05,43,90,2671,60.70454545454545,11
0.05,44,94,2765,61.44444444444444,7
0.05,45,93,2858,62.130434782608695,8
0.05,46,92,2950,62.765957446808514,9
0.05,47,23,2973,61.9375,9
0.05,48,94,3067,62.59183673469388,7
0.05,49,94,3161,63.22,7
0.05,50,23,3184,62.431372549019606,9
0.05,51,92,3276,63.0,9
0.05,52,95,3371,63.60377358490566,6
0.05,53,95,3466,64.18518518518519,6
0.05,54,94,3560,64.72727272727273,7
0.05,55,91,3651,65.19642857142857,10
0.05,56,92,3743,65.66666666666667,9
0.05,57,93,3836,66.13793103448276,8
0.05,58,91,3927,66.55932203389831,10
0.05,59,93,4020,67.0,10
0.05,60,94,4114,67.44262295081967,7
0.05,61,24,4138,66.74193548387096,23
0.05,62,94,4232,67.17460317460318,7
0.05,63,94,4326,67.59375,7
0.05,64,94,4420,68.0,7
0.05,65,90,4510,68.33333333333333,15
0.05,66,93,4603,68.70149253731343,8
0.05,67,22,4625,68.01470588235294,10
0.05,68,90,4715,68.33333333333333,11
0.05,69,93,4808,68.68571428571428,8
0.05,70,22,4830,68.02816901408451,17
0.05,71,85,4915,68.26388888888889,74
0.05,72,94,5009,68.61643835616438,7
0.05,73,94,5103,68.95945945945945,7
0.05,74,95,5198,69.30666666666667,6
0.05,75,91,5289,69.59210526315789,21
0.05,76,91,5380,69.87012987012987,11
0.05,77,95,5475,70.1923076923077,6
0.05,78,95,5570,70.50632911392405,6
0.05,79,26,5596,69.95,6
0.05,80,95,5691,70.25925925925925,8
0.05,81,95,5786,70.5609756097561,6
0.05,82,95,5881,70.855421686747,6
0.05,83,92,5973,71.10714285714286,9
0.05,84,93,6066,71.36470588235294,8
0.05,85,95,6161,71.63953488372093,6
0.05,86,92,6253,71.8735632183908,10
0.05,87,95,6348,72.13636363636364,6
0.05,88,91,6439,72.34831460674157,11
0.05,89,94,6533,72.58888888888889,7
0.05,90,94,6627,72.82417582417582,7
0.05,91,95,6722,73.06521739130434,6
0.05,92,92,6814,73.26881720430107,9
0.05,93,96,6910,73.51063829787235,6
0.05,94,93,7003,73.71578947368421,9
0.05,95,92,7095,73.90625,9
0.05,96,94,7189,74.11340206185567,7
0.05,97,21,7210,73.57142857142857,12
0.05,98,92,7302,73.75757575757575,9
0.05,99,24,7326,73.26,8
0.05,100,94,7420,73.46534653465346,7
0.05,101,95,7515,73.67647058823529,6
0.05,102,22,7537,73.1747572815534,11
0.05,103,86,7623,73.29807692307692,15
0.05,104,88,7711,73.43809523809524,14
0.05,105,88,7799,73.5754716981132,13
0.05,106,94,7893,73.76635514018692,8
0.05,107,95,7988,73.96296296296296,7
0.05,108,94,8082,74.14678899082568,7
0.05,109,95,8177,74.33636363636364,6
0.05,110,94,8271,74.51351351351352,7
0.05,111,95,8366,74.69642857142857,6
0.05,112,96,8462,74.88495575221239,6
0.05,113,92,8554,75.03508771929825,9
0.05,114,96,8650,75.21739130434783,6
0.05,115,94,8744,75.37931034482759,7
0.05,116,94,8838,75.53846153846153,7
0.05,117,94,8932,75.69491525423729,7
0.05,118,94,9026,75.84873949579831,7
0.05,119,96,9122,76.01666666666667,6
0.05,120,96,9218,76.18181818181819,6
0.05,121,22,9240,75.73770491803279,10
0.05,122,94,9334,75.88617886178862,7
0.05,123,96,9430,76.04838709677419,6
0.05,124,94,9524,76.192,7
0.05,125,94,9618,76.33333333333333,8
0.05,126,95,9713,76.48031496062993,6
0.05,127,93,9806,76.609375,8
0.05,128,25,9831,76.20930232558139,8
0.05,129,94,9925,76.34615384615384,7
0.05,130,94,10019,76.48091603053435,7
0.05,131,90,10109,76.58333333333333,12
0.05,132,91,10200,76.69172932330827,11
0.05,133,93,10293,76.81343283582089,10
0.05,134,95,10388,76.94814814814815,6
0.05,135,94,10482,77.07352941176471,8
0.05,136,94,10576,77.1970802919708,7
0.05,137,95,10671,77.32608695652173,7
0.05,138,94,10765,77.44604316546763,7
0.05,139,80,10845,77.46428571428571,21
0.05,140,91,10936,77.56028368794327,10
0.05,141,95,11031,77.6830985915493,7
0.05,142,93,11124,77.79020979020979,8
0.05,143,24,11148,77.41666666666667,10
0.05,144,94,11242,77.53103448275863,7
0.05,145,94,11336,77.64383561643835,7
0.05,146,87,11423,77.70748299319727,14
0.05,147,95,11518,77.82432432432432,6
0.05,148,92,11610,77.91946308724832,9
0.05,149,91,11701,78.00666666666666,10
0.05,150,94,11795,78.11258278145695,7
0.05,151,93,11888,78.21052631578948,8
0.05,152,95,11983,78.3202614379085,6
0.05,153,95,12078,78.42857142857143,6
0.05,154,94,12172,78.52903225806452,7
0.05,155,93,12265,78.62179487179488,8
0.05,156,95,12360,78.72611464968153,6
0.05,157,25,12385,78.38607594936708,7
0.05,158,21,12406,78.0251572327044,11
0.05,159,88,12494,78.0875,14
0.05,160,95,12589,78.19254658385093,6
0.05,161,94,12683,78.29012345679013,7
0.05,162,96,12779,78.39877300613497,6
0.05,163,92,12871,78.48170731707317,9
0.05,164,94,12965,78.57575757575758,7
0.05,165,91,13056,78.65060240963855,10
0.05,166,92,13148,78.73053892215569,9
0.05,167,93,13241,78.81547619047619,9
0.05,168,93,13334,78.89940828402366,8
0.05,169,94,13428,78.98823529411764,8
0.05,170,96,13524,79.08771929824562,6
0.05,171,91,13615,79.15697674418605,10
0.05,172,93,13708,79.23699421965318,8
0.05,173,94,13802,79.32183908045977,7
0.05,174,96,13898,79.41714285714286,6
0.05,175,95,13993,79.50568181818181,7
0.05,176,90,14083,79.56497175141243,11
0.05,177,95,14178,79.65168539325843,6
0.05,178,90,14268,79.70949720670392,11
0.05,179,95,14363,79.79444444444445,6
0.05,180,93,14456,79.86740331491713,8
0.05,181,96,14552,79.95604395604396,6
0.05,182,96,14648,80.04371584699453,6
0.05,183,94,14742,80.1195652173913,7
0.05,184,95,14837,80.2,7
0.05,185,96,14933,80.28494623655914,6
0.05,186,93,15026,80.3529411764706,9
0.05,187,95,15121,80.43085106382979,6
0.05,188,94,15215,80.5026455026455,7
0.05,189,94,15309,80.57368421052631,8
0.05,190,93,15402,80.63874345549738,8
0.05,191,27,15429,80.359375,6
0.05,192,96,15525,80.44041450777202,6
0.05,193,92,15617,80.5,9
0.05,194,94,15711,80.56923076923077,7
0.05,195,94,15805,80.63775510204081,7
0.05,196,95,15900,80.71065989847716,7
0.05,197,90,15990,80.75757575757575,11
0.05,198,96,16086,80.83417085427136,6
0.05,199,95,16181,80.905,6
0.05,200,93,16274,80.96517412935323,8
0.05,201,95,16369,81.03465346534654,6
0.05,202,96,16465,81.10837438423646,6
0.05,203,95,16560,81.17647058823529,6
0.05,204,91,16651,81.22439024390243,10
0.05,205,91,16742,81.27184466019418,10
0.05,206,27,16769,81.00966183574879,6
0.05,207,96,16865,81.08173076923077,6
0.05,208,95,16960,81.14832535885168,7
0.05,209,95,17055,81.21428571428571,6
0.05,210,25,17080,80.9478672985782,7
0.05,211,94,17174,81.00943396226415,7
0.05,212,96,17270,81.07981220657277,6
0.05,213,93,17363,81.1355140186916,8
0.05,214,94,17457,81.19534883720931,7
0.05,215,94,17551,81.25462962962963,7
0.05,216,26,17577,81.0,6
0.05,217,94,17671,81.05963302752293,7
0.05,218,25,17696,80.80365296803653,8
0.05,219,94,17790,80.86363636363636,7
0.05,220,93,17883,80.91855203619909,9
0.05,221,96,17979,80.98648648648648,6
0.05,222,96,18075,81.05381165919283,6
0.05,223,94,18169,81.11160714285714,7
0.05,224,94,18263,81.16888888888889,7
0.05,225,94,18357,81.22566371681415,7
0.05,226,94,18451,81.28193832599119,7
0.05,227,94,18545,81.33771929824562,7
0.05,228,94,18639,81.39301310043668,7
0.05,229,96,18735,81.45652173913044,6
0.05,230,96,18831,81.51948051948052,6
0.05,231,96,18927,81.58189655172414,6
0.05,232,93,19020,81.63090128755364,8
0.05,233,96,19116,81.6923076923077,6
0.05,234,93,19209,81.7404255319149,8
0.05,235,26,19235,81.5042372881356,6
0.05,236,21,19256,81.24894514767932,11
0.05,237,95,19351,81.30672268907563,6
0.05,238,96,19447,81.36820083682008,6
0.05,239,92,19539,81.4125,9
0.05,240,93,19632,81.46058091286307,8
0.05,241,96,19728,81.52066115702479,6
0.05,242,92,19820,81.56378600823045,9
0.05,243,95,19915,81.6188524590164,6
0.05,244,26,19941,81.39183673469388,6
0.05,245,92,20033,81.4349593495935,9
0.05,246,96,20129,81.49392712550608,6
0.05,247,92,20221,81.53629032258064,10
0.05,248,93,20314,81.58232931726907,8
0.05,249,94,20408,81.632,8
0.05,250,95,20503,81.68525896414343,6
0.05,251,93,20596,81.73015873015873,8
0.05,252,92,20688,81.7707509881423,10
0.05,253,94,20782,81.81889763779527,7
0.05,254,93,20875,81.86274509803921,8
0.05,255,93,20968,81.90625,8
0.05,256,94,21062,81.95330739299611,7
0.05,257,95,21157,82.00387596899225,6
0.05,258,26,21183,81.7876447876448,6
0.05,259,94,21277,81.83461538461539,7
0.05,260,94,21371,81.88122605363985,7
0.05,261,95,21466,81.93129770992367,7
0.05,262,96,21562,81.98479087452472,7
0.05,263,92,21654,82.02272727272727,9
0.05,264,94,21748,82.06792452830189,8
0.05,265,94,21842,82.11278195488721,7
0.05,266,92,21934,82.1498127340824,9
0.05,267,95,22029,82.19776119402985,6
0.05,268,94,22123,82.24163568773234,8
0.05,269,94,22217,82.28518518518518,7
0.05,270,93,22310,82.32472324723247,8
0.05,271,94,22404,82.36764705882354,7
0.05,272,93,22497,82.4065934065934,8
0.05,273,94,22591,82.44890510948905,7
0.05,274,94,22685,82.49090909090908,8
0.05,275,94,22779,82.53260869565217,8
0.05,276,88,22867,82.5523465703971,16
0.05,277,96,22963,82.60071942446044,6
0.05,278,93,23056,82.63799283154121,8
0.05,279,94,23150,82.67857142857143,7
0.05,280,92,23242,82.71174377224199,9
0.05,281,94,23336,82.7517730496454,7
0.05,282,92,23428,82.7844522968198,9
0.05,283,93,23521,82.82042253521126,8
0.05,284,94,23615,82.85964912280701,7
0.05,285,94,23709,82.8986013986014,7
0.05,286,95,23804,82.94076655052265,6
0.05,287,95,23899,82.98263888888889,6
0.05,288,94,23993,83.02076124567473,7
0.05,289,94,24087,83.05862068965517,8
0.05,290,94,24181,83.09621993127148,7
0.05,291,94,24275,83.13356164383562,7
0.05,292,94,24369,83.17064846416382,7
0.05,293,95,24464,83.21088435374149,6
0.05,294,95,24559,83.25084745762712,6
0.05,295,94,24653,83.28716216216216,7
0.05,296,94,24747,83.32323232323232,7
0.05,297,93,24840,83.35570469798658,8
0.05,298,94,24934,83.3913043478261,7
0.05,299,94,25028,83.42666666666666,7
0.05,300,96,25124,83.46843853820597,6
0.05,301,88,25212,83.48344370860927,13
0.05,302,95,25307,83.52145214521452,6
0.05,303,94,25401,83.55592105263158,7
0.05,304,95,25496,83.59344262295082,7
0.05,305,92,25588,83.62091503267973,9
0.05,306,93,25681,83.6514657980456,8
0.05,307,93,25774,83.68181818181819,8
0.05,308,94,25868,83.71521035598705,8
0.05,309,92,25960,83.74193548387096,9
0.05,310,95,26055,83.7781350482315,6
0.05,311,26,26081,83.59294871794872,7
0.05,312,94,26175,83.6261980830671,7
0.05,313,95,26270,83.6624203821656,8
0.05,314,94,26364,83.6952380952381,7
0.05,315,93,26457,83.7246835443038,8
0.05,316,96,26553,83.76340694006309,6
0.05,317,95,26648,83.79874213836477,6
0.05,318,95,26743,83.83385579937304,7
0.05,319,91,26834,83.85625,11
0.05,320,95,26929,83.89096573208722,6
0.05,321,94,27023,83.9223602484472,7
0.05,322,94,27117,83.95356037151703,8
0.05,323,91,27208,83.9753086419753,10
0.05,324,95,27303,84.00923076923077,6
0.05,325,94,27397,84.0398773006135,7
0.05,326,94,27491,84.07033639143731,7
0.05,327,96,27587,84.10670731707317,6
0.05,328,96,27683,84.14285714285714,6
0.05,329,92,27775,84.16666666666667,10
0.05,330,93,27868,84.19335347432025,8
0.05,331,94,27962,84.22289156626506,7
0.05,332,95,28057,84.25525525525525,6
0.05,333,91,28148,84.27544910179641,10
0.05,334,92,28240,84.29850746268657,9
0.05,335,93,28333,84.32440476190476,8
0.05,336,88,28421,84.33531157270029,14
0.05,337,94,28515,84.36390532544378,7
0.05,338,94,28609,84.39233038348083,7
0.05,339,92,28701,84.41470588235295,9
0.05,340,94,28795,84.44281524926686,7
0.05,341,94,28889,84.47076023391813,7
0.05,342,95,28984,84.50145772594752,6
0.05,343,90,29074,84.51744186046511,11
0.05,344,88,29162,84.52753623188406,14
0.05,345,92,29254,84.54913294797687,9
0.05,346,-46,29208,84.17291066282421,9
0.05,347,96,29304,84.20689655172414,6
0.05,348,92,29396,84.22922636103152,9
0.05,349,94,29490,84.25714285714285,7
0.05,350,94,29584,84.28490028490029,7
0.05,351,94,29678,84.3125,7
0.05,352,94,29772,84.33994334277621,7
0.05,353,88,29860,84.35028248587571,13
0.05,354,90,29950,84.36619718309859,11
0.05,355,96,30046,84.39887640449439,6
0.05,356,95,30141,84.42857142857143,6
0.05,357,95,30236,84.45810055865921,6
0.05,358,95,30331,84.4874651810585,6
0.05,359,94,30425,84.51388888888889,7
0.05,360,95,30520,84.54293628808864,6
0.05,361,94,30614,84.56906077348066,8
0.05,362,92,30706,84.58953168044077,9
0.05,363,94,30800,84.61538461538461,7
0.05,364,92,30892,84.63561643835617,9
0.05,365,94,30986,84.66120218579235,7
0.05,366,95,31081,84.68937329700273,6
0.05,367,96,31177,84.72010869565217,6
0.05,368,96,31273,84.75067750677506,6
0.05,369,93,31366,84.77297297297298,8
0.05,370,93,31459,84.79514824797843,8
0.05,371,95,31554,84.8225806451613,6
0.05,372,92,31646,84.84182305630027,9
0.05,373,93,31739,84.86363636363636,8
0.05,374,94,31833,84.888,7
0.05,375,94,31927,84.9122340425532,7
0.05,376,94,32021,84.93633952254642,8
0.05,377,95,32116,84.96296296296296,6
0.05,378,95,32211,84.98944591029024,6
0.05,379,92,32303,85.0078947368421,9
0.05,380,19,32322,84.83464566929133,13
0.05,381,26,32348,84.68062827225131,6
0.05,382,92,32440,84.69973890339426,9
0.05,383,26,32466,84.546875,7
0.05,384,92,32558,84.56623376623376,9
0.05,385,94,32652,84.59067357512953,8
0.05,386,95,32747,84.61757105943153,8
0.05,387,94,32841,84.6417525773196,7
0.05,388,95,32936,84.66838046272494,6
0.05,389,92,33028,84.68717948717949,9
0.05,390,94,33122,84.71099744245524,7
0.05,391,92,33214,84.7295918367347,9
0.05,392,95,33309,84.7557251908397,6
0.05,393,92,33401,84.7741116751269,9
0.05,394,92,33493,84.79240506329114,9
0.05,395,92,33585,84.81060606060606,9
0.05,396,95,33680,84.83627204030226,6
0.05,397,23,33703,84.68090452261306,10
0.05,398,94,33797,84.70426065162907,7
0.05,399,90,33887,84.7175,11
0.05,400,93,33980,84.73815461346634,9
0.05,401,96,34076,84.76616915422886,6
0.05,402,94,34170,84.78908188585608,7
0.05,403,94,34264,84.81188118811882,7
0.05,404,91,34355,84.82716049382717,10
0.05,405,94,34449,84.84975369458128,7
0.05,406,94,34543,84.87223587223588,7
0.05,407,94,34637,84.89460784313725,7
0.05,408,93,34730,84.91442542787286,8
0.05,409,92,34822,84.93170731707318,9
0.05,410,93,34915,84.95133819951339,9
0.05,411,93,35008,84.97087378640776,8
0.05,412,94,35102,84.99273607748184,8
0.05,413,94,35196,85.01449275362319,7
0.05,414,96,35292,85.04096385542168,6
0.05,415,96,35388,85.0673076923077,6
0.05,416,95,35483,85.09112709832134,6
0.05,417,94,35577,85.11244019138756,7
0.05,418,91,35668,85.12649164677805,10
0.05,419,94,35762,85.14761904761905,7
0.05,420,95,35857,85.1710213776722,6
0.05,421,94,35951,85.19194312796209,7
0.05,422,95,36046,85.21513002364067,6
0.05,423,94,36140,85.23584905660377,7
0.05,424,96,36236,85.26117647058824,6
0.05,425,94,36330,85.28169014084507,7
0.05,426,93,36423,85.29976580796253,8
0.05,427,96,36519,85.32476635514018,6
0.05,428,24,36543,85.18181818181819,8
0.05,429,94,36637,85.20232558139534,7
0.05,430,22,36659,85.05568445475637,10
0.05,431,95,36754,85.07870370370371,6
0.05,432,94,36848,85.09930715935334,7
0.05,433,95,36943,85.1221198156682,6
0.05,434,94,37037,85.14252873563218,8
0.05,435,95,37132,85.1651376146789,6
0.05,436,92,37224,85.18077803203661,9
0.05,437,95,37319,85.20319634703196,6
0.05,438,94,37413,85.22323462414579,7
0.05,439,94,37507,85.24318181818182,8
0.05,440,91,37598,85.2562358276644,10
0.05,441,95,37693,85.27828054298642,6
0.05,442,94,37787,85.2979683972912,8
0.05,443,94,37881,85.31756756756756,8
0.05,444,93,37974,85.33483146067415,8
0.05,445,95,38069,85.35650224215247,6
0.05,446,94,38163,85.3758389261745,7
0.05,447,96,38259,85.39955357142857,6
0.05,448,94,38353,85.41870824053453,8
0.05,449,94,38447,85.43777777777778,7
0.05,450,94,38541,85.45676274944567,7
0.05,451,94,38635,85.47566371681415,7
0.05,452,19,38654,85.3289183222958,13
0.05,453,95,38749,85.35022026431719,6
0.05,454,92,38841,85.36483516483517,9
0.05,455,90,38931,85.375,11
0.05,456,95,39026,85.39606126914661,6
0.05,457,23,39049,85.25982532751091,9
0.05,458,93,39142,85.27668845315904,8
0.05,459,93,39235,85.29347826086956,8
0.05,460,92,39327,85.30802603036877,11
0.05,461,92,39419,85.32251082251082,9
0.05,462,94,39513,85.34125269978402,7
0.05,463,94,39607,85.35991379310344,7
0.05,464,95,39702,85.38064516129032,7
0.05,465,94,39796,85.39914163090128,7
0.05,466,94,39890,85.41755888650964,8
0.05,467,95,39985,85.4380341880342,6
0.05,468,95,40080,85.45842217484008,6
0.05,469,94,40174,85.47659574468085,7
0.05,470,94,40268,85.49469214437367,7
0.05,471,95,40363,85.51483050847457,6
0.05,472,90,40453,85.52431289640592,11
0.05,473,92,40545,85.5379746835443,9
0.05,474,91,40636,85.54947368421053,12
0.05,475,94,40730,85.5672268907563,7
0.05,476,94,40824,85.58490566037736,8
0.05,477,27,40851,85.4623430962343,6
0.05,478,95,40946,85.48225469728601,7
0.05,479,93,41039,85.49791666666667,9
0.05,480,92,41131,85.51143451143452,10
0.05,481,95,41226,85.5311203319502,6
0.05,482,-45,41181,85.26086956521739,8
0.05,483,89,41270,85.26859504132231,12
0.05,484,93,41363,85.28453608247423,9
0.05,485,96,41459,85.30658436213992,6
0.05,486,94,41553,85.32443531827515,7
0.05,487,94,41647,85.3422131147541,9
0.05,488,94,41741,85.359918200409,7
0.05,489,95,41836,85.37959183673469,6
0.05,490,92,41928,85.39307535641548,9
0.05,491,93,42021,85.40853658536585,8
0.05,492,93,42114,85.4239350912779,8
0.05,493,95,42209,85.44331983805668,6
0.05,494,90,42299,85.45252525252525,11
0.05,495,92,42391,85.46572580645162,9
0.05,496,95,42486,85.48490945674044,6
0.05,497,90,42576,85.49397590361446,11
0.05,498,94,42670,85.51102204408818,8
0.05,499,96,42766,85.532,6
0.05,500,95,42861,85.55089820359281,6
0.05,501,96,42957,85.57171314741036,7
0.05,502,92,43049,85.5844930417495,9
0.05,503,94,43143,85.60119047619048,7
0.05,504,95,43238,85.61980198019802,6
0.05,505,92,43330,85.63241106719367,9
0.05,506,95,43425,85.6508875739645,6
0.05,507,95,43520,85.66929133858268,6
0.05,508,95,43615,85.68762278978389,6
0.05,509,94,43709,85.70392156862745,8
0.05,510,93,43802,85.71819960861056,8
0.05,511,24,43826,85.59765625,8
0.05,512,92,43918,85.61013645224172,9
0.05,513,92,44010,85.62256809338521,9
0.05,514,96,44106,85.64271844660195,6
0.05,515,91,44197,85.65310077519379,10
0.05,516,94,44291,85.66924564796905,7
0.05,517,94,44385,85.68532818532819,7
0.05,518,93,44478,85.69942196531792,8
0.05,519,94,44572,85.71538461538462,7
0.05,520,94,44666,85.73128598848369,7
0.05,521,94,44760,85.74712643678161,7
0.05,522,96,44856,85.76673040152964,6
0.05,523,96,44952,85.78625954198473,6
0.05,524,96,45048,85.80571428571429,6
0.05,525,91,45139,85.81558935361217,10
0.05,526,94,45233,85.83111954459203,7
0.05,527,93,45326,85.84469696969697,9
0.05,528,94,45420,85.8601134215501,8
0.05,529,93,45513,85.87358490566038,8
0.05,530,94,45607,85.88888888888889,8
0.05,531,95,45702,85.90601503759399,6
0.05,532,93,45795,85.91932457786116,8
0.05,533,96,45891,85.93820224719101,6
0.05,534,93,45984,85.95140186915887,8
0.05,535,94,46078,85.96641791044776,7
0.05,536,94,46172,85.98137802607076,8
0.05,537,91,46263,85.9907063197026,10
0.05,538,95,46358,86.00742115027829,6
0.05,539,91,46449,86.01666666666667,10
0.05,540,89,46538,86.02218114602587,12
0.05,541,89,46627,86.02767527675277,12
0.05,542,91,46718,86.03683241252303,10
0.05,543,93,46811,86.04963235294117,8
0.05,544,95,46906,86.06605504587156,6
0.05,545,25,46931,85.95421245421245,7
0.05,546,96,47027,85.97257769652651,6
0.05,547,94,47121,85.98722627737226,8
0.05,548,94,47215,86.00182149362477,7
0.05,549,96,47311,86.02,6
0.05,550,95,47406,86.03629764065336,6
0.05,551,95,47501,86.05253623188406,6
0.05,552,93,47594,86.06509945750452,9
0.05,553,96,47690,86.08303249097473,6
0.05,554,96,47786,86.1009009009009,6
0.05,555,96,47882,86.11870503597122,6
0.05,556,90,47972,86.12567324955117,11
0.05,557,93,48065,86.13799283154121,8
0.05,558,91,48156,86.14669051878354,10
0.05,559,89,48245,86.15178571428571,13
0.05,560,91,48336,86.16042780748663,10
0.05,561,92,48428,86.17081850533808,9
0.05,562,94,48522,86.1847246891652,7
0.05,563,96,48618,86.20212765957447,6
0.05,564,91,48709,86.21061946902655,11
0.05,565,93,48802,86.2226148409894,9
0.05,566,95,48897,86.23809523809524,6
0.05,567,96,48993,86.25528169014085,6
0.05,568,94,49087,86.2688927943761,7
0.05,569,94,49181,86.28245614035087,7
0.05,570,92,49273,86.29246935201401,9
0.05,571,91,49364,86.3006993006993,10
0.05,572,94,49458,86.31413612565446,7
0.05,573,91,49549,86.32229965156795,12
0.05,574,92,49641,86.33217391304348,9
0.05,575,93,49734,86.34375,8
0.05,576,95,49829,86.35875216637781,6
0.05,577,95,49924,86.37370242214533,6
0.05,578,92,50016,86.38341968911917,9
0.05,579,93,50109,86.3948275862069,8
0.05,580,93,50202,86.40619621342513,8
0.05,581,93,50295,86.41752577319588,10
0.05,582,95,50390,86.43224699828474,6
0.05,583,22,50412,86.32191780821918,10
0.05,584,95,50507,86.33675213675214,6
0.05,585,94,50601,86.34982935153583,7
0.05,586,95,50696,86.36456558773425,7
0.05,587,93,50789,86.37585034013605,9
0.05,588,94,50883,86.38879456706282,7
0.05,589,94,50977,86.40169491525424,7
0.05,590,94,51071,86.414551607445,7
0.05,591,93,51164,86.42567567567568,8
0.05,592,24,51188,86.32040472175379,8
0.05,593,93,51281,86.33164983164983,10
0.05,594,90,51371,86.33781512605042,11
0.05,595,94,51465,86.3506711409396,7
0.05,596,92,51557,86.36013400335008,9
0.05,597,93,51650,86.37123745819397,8
0.05,598,90,51740,86.37729549248748,11
0.05,599,95,51835,86.39166666666667,6
0.05,600,93,51928,86.4026622296173,8
0.05,601,96,52024,86.4186046511628,6
0.05,602,94,52118,86.43117744610282,7
0.05,603,94,52212,86.44370860927152,7
0.05,604,94,52306,86.45619834710743,7
0.05,605,92,52398,86.46534653465346,10
0.05,606,93,52491,86.47611202635915,9
0.05,607,96,52587,86.49177631578948,6
0.05,608,96,52683,86.50738916256158,6
0.05,609,96,52779,86.52295081967213,6
0.05,610,96,52875,86.53846153846153,6
0.05,611,96,52971,86.55392156862744,6
0.05,612,94,53065,86.56606851549755,8
0.05,613,94,53159,86.57817589576547,10
0.05,614,94,53253,86.59024390243903,7
0.05,615,92,53345,86.59902597402598,10
0.05,616,93,53438,86.6094003241491,8
0.05,617,96,53534,86.62459546925567,6
0.05,618,94,53628,86.63651050080776,7
0.05,619,94,53722,86.64838709677419,7
0.05,620,94,53816,86.66022544283413,7
0.05,621,95,53911,86.67363344051446,6
0.05,622,92,54003,86.68218298555377,9
0.05,623,92,54095,86.69070512820512,10
0.05,624,95,54190,86.704,6
0.05,625,94,54284,86.71565495207668,8
0.05,626,91,54375,86.72248803827752,10
0.05,627,95,54470,86.73566878980891,6
0.05,628,95,54565,86.74880763116057,6
0.05,629,96,54661,86.76349206349207,6
0.05,630,94,54755,86.77496038034866,7
0.05,631,94,54849,86.7863924050633,7
0.05,632,25,54874,86.68878357030016,7
0.05,633,94,54968,86.70031545741325,7
0.05,634,94,55062,86.71181102362205,7
0.05,635,96,55158,86.72641509433963,6
0.05,636,95,55253,86.73940345368916,6
0.05,637,94,55347,86.75078369905957,7
0.05,638,93,55440,86.7605633802817,9
0.05,639,96,55536,86.775,6
0.05,640,90,55626,86.78003120124805,11
0.05,641,92,55718,86.78816199376946,9
0.05,642,96,55814,86.80248833592535,6
0.05,643,93,55907,86.81211180124224,10
0.05,644,93,56000,86.82170542635659,8
0.05,645,94,56094,86.83281733746131,7
0.05,646,25,56119,86.73724884080372,7
0.05,647,91,56210,86.74382716049382,10
0.05,648,94,56304,86.75500770416025,7
0.05,649,94,56398,86.76615384615384,7
0.05,650,94,56492,86.77726574500768,7
0.05,651,96,56588,86.79141104294479,6
0.05,652,95,56683,86.80398162327718,6
0.05,653,93,56776,86.81345565749236,8
0.05,654,93,56869,86.82290076335877,8
0.05,655,93,56962,86.83231707317073,8
0.05,656,95,57057,86.84474885844749,6
0.05,657,94,57151,86.85562310030394,7
0.05,658,92,57243,86.86342943854325,9
0.05,659,96,57339,86.87727272727273,6
0.05,660,95,57434,86.88956127080182,6
0.05,661,93,57527,86.8987915407855,8
0.05,662,92,57619,86.90648567119155,9
0.05,663,95,57714,86.91867469879519,6
0.05,664,95,57809,86.93082706766917,6
0.05,665,24,57833,86.83633633633633,8
0.05,666,95,57928,86.84857571214393,6
0.05,667,95,58023,86.86077844311377,7
0.05,668,91,58114,86.86696562032886,10
0.05,669,23,58137,86.77164179104477,9
0.05,670,27,58164,86.68256333830104,6
0.05,671,96,58260,86.69642857142857,6
0.05,672,95,58355,86.70876671619614,6
0.05,673,94,58449,86.71958456973294,7
0.05,674,94,58543,86.73037037037037,8
0.05,675,93,58636,86.7396449704142,8
0.05,676,96,58732,86.7533234859675,6
0.05,677,96,58828,86.7669616519174,6
0.05,678,25,58853,86.6759941089838,7
0.05,679,93,58946,86.68529411764706,8
0.05,680,25,58971,86.59471365638767,7
0.05,681,94,59065,86.60557184750733,7
0.05,682,95,59160,86.61786237188872,6
0.05,683,96,59256,86.63157894736842,6
0.05,684,94,59350,86.64233576642336,7
0.05,685,96,59446,86.65597667638484,6
0.05,686,95,59541,86.66812227074236,6
0.05,687,92,59633,86.67587209302326,9
0.05,688,95,59728,86.68795355587808,8
0.05,689,93,59821,86.69710144927537,9
0.05,690,24,59845,86.60636758321273,8
0.05,691,92,59937,86.61416184971098,9
0.05,692,94,60031,86.62481962481962,7
0.05,693,94,60125,86.63544668587896,7
0.05,694,25,60150,86.54676258992805,7
0.05,695,91,60241,86.55316091954023,11
0.05,696,88,60329,86.55523672883788,14
0.05,697,95,60424,86.567335243553,6
0.05,698,94,60518,86.57796852646638,7
0.05,699,90,60608,86.58285714285714,11
0.05,700,94,60702,86.59343794579172,8
0.05,701,93,60795,86.6025641025641,9
0.05,702,93,60888,86.61166429587482,8
0.05,703,92,60980,86.61931818181819,12
0.05,704,93,61073,86.62836879432624,8
0.05,705,94,61167,86.63881019830028,7
0.05,706,96,61263,86.65205091937766,6
0.05,707,91,61354,86.65819209039547,10
0.05,708,94,61448,86.66854724964739,7
0.05,709,94,61542,86.67887323943663,7
0.05,710,94,61636,86.68917018284107,7
0.05,711,96,61732,86.70224719101124,6
0.05,712,94,61826,86.7124824684432,7
0.05,713,94,61920,86.72268907563026,7
0.05,714,94,62014,86.73286713286713,7
0.05,715,95,62109,86.74441340782123,6
0.05,716,96,62205,86.75732217573221,6
0.05,717,96,62301,86.77019498607243,6
0.05,718,91,62392,86.77607788595272,10
0.05,719,27,62419,86.69305555555556,7
0.05,720,94,62513,86.70319001386963,7
0.05,721,93,62606,86.71191135734072,8
0.05,722,89,62695,86.71507607192254,12
0.05,723,92,62787,86.72237569060773,10
0.05,724,93,62880,86.73103448275862,8
0.05,725,93,62973,86.7396694214876,9
0.05,726,93,63066,86.74828060522697,8
0.05,727,93,63159,86.75686813186813,8
0.05,728,94,63253,86.76680384087791,8
0.05,729,24,63277,86.68082191780822,8
0.05,730,94,63371,86.69083447332422,7
0.05,731,93,63464,86.69945355191257,8
0.05,732,96,63560,86.71214188267395,6
0.05,733,92,63652,86.71934604904632,9
0.05,734,91,63743,86.72517006802721,11
0.05,735,95,63838,86.73641304347827,6
0.05,736,94,63932,86.74626865671642,7
0.05,737,94,64026,86.7560975609756,8
0.05,738,90,64116,86.76048714479026,11
0.05,739,96,64212,86.77297297297298,6
0.05,740,92,64304,86.78002699055331,9
0.05,741,27,64331,86.69946091644205,6
0.05,742,95,64426,86.71063257065948,8
0.05,743,96,64522,86.72311827956989,6
0.05,744,94,64616,86.73288590604027,7
0.05,745,96,64712,86.74530831099196,6
0.05,746,94,64806,86.75502008032129,7
0.05,747,95,64901,86.76604278074866,6
0.05,748,90,64991,86.77036048064086,11
0.05,749,91,65082,86.776,10
0.05,750,93,65175,86.78428761651132,8
0.05,751,94,65269,86.7938829787234,7
0.05,752,93,65362,86.80212483399734,9
0.05,753,26,65388,86.72148541114058,6
0.05,754,92,65480,86.72847682119205,9
0.05,755,94,65574,86.73809523809524,7
0.05,756,94,65668,86.74768824306473,7
0.05,757,94,65762,86.75725593667546,7
0.05,758,26,65788,86.67720685111989,6
0.05,759,92,65880,86.6842105263158,9
0.05,760,95,65975,86.69513797634691,7
0.05,761,95,66070,86.70603674540682,6
0.05,762,95,66165,86.71690694626474,6
0.05,763,94,66259,86.72643979057591,7
0.05,764,92,66351,86.73333333333333,9
0.05,765,25,66376,86.65274151436032,8
0.05,766,26,66402,86.57366362451108,6
0.05,767,95,66497,86.58463541666667,6
0.05,768,96,66593,86.59687906371911,6
0.05,769,94,66687,86.6064935064935,7
0.05,770,93,66780,86.6147859922179,10
0.05,771,95,66875,86.62564766839378,6
0.05,772,93,66968,86.63389391979301,10
0.05,773,25,66993,86.55426356589147,7
0.05,774,91,67084,86.56,10
0.05,775,95,67179,86.57087628865979,6
0.05,776,94,67273,86.58043758043758,7
0.05,777,92,67365,86.58740359897172,9
0.05,778,96,67461,86.599486521181,6
0.05,779,94,67555,86.60897435897436,7
0.05,780,92,67647,86.61587708066581,9
0.05,781,92,67739,86.6227621483376,9
0.05,782,93,67832,86.6309067688378,8
0.05,783,94,67926,86.64030612244898,7
0.05,784,96,68022,86.65222929936306,6
0.05,785,95,68117,86.66284987277353,6
0.05,786,96,68213,86.67471410419314,6
0.05,787,93,68306,86.68274111675127,8
0.05,788,95,68401,86.69328263624841,6
0.05,789,91,68492,86.69873417721519,10
0.05,790,93,68585,86.70670037926675,8
0.05,791,94,68679,86.7159090909091,7
0.05,792,27,68706,86.640605296343,7
0.05,793,96,68802,86.65239294710328,6
0.05,794,26,68828,86.57610062893082,6
0.05,795,26,68854,86.5,6
0.05,796,92,68946,86.5069008782936,9
0.05,797,96,69042,86.5187969924812,6
0.05,798,92,69134,86.52565707133917,9
0.05,799,91,69225,86.53125,10
0.05,800,94,69319,86.54057428214732,7
0.05,801,94,69413,86.5498753117207,7
0.05,802,95,69508,86.56039850560398,6
0.05,803,93,69601,86.56840796019901,8
0.05,804,26,69627,86.49316770186336,6
0.05,805,95,69722,86.50372208436724,6
0.05,806,93,69815,86.51177199504338,8
0.05,807,96,69911,86.52351485148515,6
0.05,808,94,70005,86.5327564894932,7
0.05,809,94,70099,86.54197530864198,7
0.05,810,24,70123,86.4648581997534,8
0.05,811,90,70213,86.4692118226601,11
0.05,812,94,70307,86.47847478474785,7
0.05,813,96,70403,86.49017199017199,6
0.05,814,94,70497,86.49938650306748,7
0.05,815,96,70593,86.51102941176471,6
0.05,816,94,70687,86.5201958384333,8
0.05,817,95,70782,86.53056234718827,6
0.05,818,96,70878,86.54212454212454,6
0.05,819,95,70973,86.55243902439024,6
0.05,820,95,71068,86.56272838002437,6
0.05,821,92,71160,86.56934306569343,9
0.05,822,89,71249,86.57229647630619,12
0.05,823,23,71272,86.49514563106796,9
0.05,824,93,71365,86.5030303030303,8
0.05,825,94,71459,86.51210653753027,7
0.05,826,95,71554,86.5223700120919,6
0.05,827,94,71648,86.53140096618357,7
0.05,828,94,71742,86.54041013268998,7
0.05,829,96,71838,86.55180722891566,6
0.05,830,95,71933,86.56197352587245,7
0.05,831,93,72026,86.56971153846153,8
0.05,832,92,72118,86.57623049219688,9
0.05,833,94,72212,86.58513189448442,7
0.05,834,95,72307,86.59520958083833,6
0.05,835,93,72400,86.60287081339713,8
0.05,836,96,72496,86.61409796893668,6
0.05,837,96,72592,86.62529832935562,6
0.05,838,92,72684,86.63170441001192,9
0.05,839,93,72777,86.63928571428572,9
0.05,840,96,72873,86.65041617122473,6
0.05,841,94,72967,86.65914489311164,8
0.05,842,91,73058,86.66429418742587,10
0.05,843,94,73152,86.67298578199052,8
0.05,844,92,73244,86.6792899408284,9
0.05,845,90,73334,86.68321513002364,11
0.05,846,93,73427,86.69067296340023,8
0.05,847,96,73523,86.70165094339623,6
0.05,848,90,73613,86.7055359246172,12
0.05,849,94,73707,86.71411764705883,7
0.05,850,95,73802,86.72385428907168,6
0.05,851,94,73896,86.73239436619718,7
0.05,852,94,73990,86.74091441969519,8
0.05,853,94,74084,86.74941451990632,7
0.05,854,90,74174,86.753216374269,11
0.05,855,94,74268,86.76168224299066,8
0.05,856,96,74364,86.77246207701283,6
0.05,857,24,74388,86.6993006993007,8
0.05,858,93,74481,86.70663562281723,8
0.05,859,95,74576,86.71627906976744,6
0.05,860,95,74671,86.72590011614402,6
0.05,861,92,74763,86.73201856148492,9
0.05,862,96,74859,86.74275782155273,6
0.05,863,90,74949,86.74652777777777,12
0.05,864,25,74974,86.67514450867051,7
0.05,865,89,75063,86.67782909930716,14
0.05,866,94,75157,86.68627450980392,7
0.05,867,93,75250,86.69354838709677,8
0.05,868,94,75344,86.70195627157652,8
0.05,869,96,75440,86.71264367816092,6
0.05,870,92,75532,86.7187141216992,9
0.05,871,93,75625,86.72591743119266,8
0.05,872,92,75717,86.73195876288659,9
0.05,873,94,75811,86.74027459954233,7
0.05,874,95,75906,86.74971428571429,6
0.05,875,96,76002,86.76027397260275,6
0.05,876,94,76096,86.7685290763968,7
0.05,877,25,76121,86.69817767653758,7
0.05,878,92,76213,86.70420932878271,9
0.05,879,95,76308,86.71363636363637,8
0.05,880,95,76403,86.72304199772985,6
0.05,881,94,76497,86.7312925170068,7
0.05,882,87,76584,86.73159682899207,14
0.05,883,94,76678,86.73981900452489,7
0.05,884,94,76772,86.74802259887005,7
0.05,885,92,76864,86.75395033860045,9
0.05,886,93,76957,86.76099210822998,8
0.05,887,96,77053,86.7713963963964,6
0.05,888,95,77148,86.78065241844769,6
0.05,889,96,77244,86.79101123595505,6
0.05,890,93,77337,86.79797979797979,8
0.05,891,93,77430,86.80493273542601,9
0.05,892,94,77524,86.81298992161254,8
0.05,893,94,77618,86.82102908277405,7
0.05,894,95,77713,86.83016759776537,6
0.05,895,94,77807,86.83816964285714,8
0.05,896,94,77901,86.84615384615384,7
0.05,897,27,77928,86.77951002227171,6
0.05,898,94,78022,86.78754171301446,7
0.05,899,92,78114,86.79333333333334,9
0.05,900,94,78208,86.80133185349611,8
0.05,901,96,78304,86.81152993348115,6
0.05,902,94,78398,86.81949058693245,7
0.05,903,24,78422,86.75,8
0.05,904,94,78516,86.75801104972376,7
0.05,905,94,78610,86.76600441501104,7
0.05,906,92,78702,86.77177508269018,9
0.05,907,96,78798,86.78193832599119,6
0.05,908,95,78893,86.7909790979098,8
0.05,909,92,78985,86.7967032967033,9
0.05,910,93,79078,86.80351262349068,9
0.05,911,27,79105,86.73793859649123,6
0.05,912,94,79199,86.74589266155532,8
0.05,913,95,79294,86.75492341356674,7
0.05,914,92,79386,86.76065573770492,9
0.05,915,92,79478,86.76637554585153,10
0.05,916,90,79568,86.76990185387132,11
0.05,917,96,79664,86.77995642701525,6
0.05,918,89,79753,86.78237214363439,13
0.05,919,96,79849,86.79239130434783,6
0.05,920,92,79941,86.79804560260587,9
0.05,921,95,80036,86.80694143167028,7
0.05,922,27,80063,86.7421451787649,6
0.05,923,94,80157,86.75,7
0.05,924,91,80248,86.7545945945946,10
0.05,925,94,80342,86.76241900647948,7
0.05,926,93,80435,86.76914778856526,9
0.05,927,24,80459,86.70150862068965,9
0.05,928,94,80553,86.70936490850377,7
0.05,929,96,80649,86.71935483870968,6
0.05,930,94,80743,86.72717508055854,7
0.05,931,90,80833,86.73068669527898,11
0.05,932,96,80929,86.7406216505895,6
0.05,933,24,80953,86.67344753747324,9
0.05,934,94,81047,86.6812834224599,7
0.05,935,94,81141,86.68910256410257,7
0.05,936,92,81233,86.6947705442903,10
0.05,937,91,81324,86.69936034115139,10
0.05,938,92,81416,86.70500532481363,10
0.05,939,90,81506,86.70851063829787,11
0.05,940,95,81601,86.7173219978746,6
0.05,941,95,81696,86.72611464968153,6
0.05,942,95,81791,86.73488865323436,6
0.05,943,94,81885,86.74258474576271,7
0.05,944,27,81912,86.67936507936508,6
0.05,945,94,82006,86.68710359408034,7
0.05,946,24,82030,86.62090813093981,8
0.05,947,94,82124,86.62869198312237,8
0.05,948,95,82219,86.63751317175975,6
0.05,949,91,82310,86.6421052631579,11
0.05,950,96,82406,86.65194532071504,6
0.05,951,92,82498,86.65756302521008,9
0.05,952,95,82593,86.66631689401889,7
0.05,953,93,82686,86.67295597484276,8
0.05,954,96,82782,86.682722513089,6
0.05,955,94,82876,86.69037656903765,8
0.05,956,95,82971,86.69905956112852,6
0.05,957,94,83065,86.70668058455115,8
0.05,958,93,83158,86.71324296141815,8
0.05,959,94,83252,86.72083333333333,8
0.05,960,95,83347,86.72944849115504,7
0.05,961,94,83441,86.73700623700624,7
0.05,962,94,83535,86.74454828660436,7
0.05,963,92,83627,86.75,9
0.05,964,95,83722,86.75854922279792,6
0.05,965,92,83814,86.7639751552795,9
0.05,966,91,83905,86.7683557394002,10
0.05,967,96,84001,86.77789256198348,6
0.05,968,26,84027,86.71517027863777,6
0.05,969,94,84121,86.72268041237113,7
0.05,970,94,84215,86.73017507723996,8
0.05,971,94,84309,86.73765432098766,7
0.05,972,95,84404,86.74614594039055,6
0.05,973,94,84498,86.75359342915812,8
0.05,974,94,84592,86.76102564102564,7
0.05,975,94,84686,86.76844262295081,7
0.05,976,95,84781,86.77686796315251,6
0.05,977,94,84875,86.7842535787321,7
0.05,978,94,84969,86.79162410623084,7
0.05,979,92,85061,86.7969387755102,9
0.05,980,94,85155,86.80428134556576,7
0.05,981,94,85249,86.81160896130346,7
0.05,982,92,85341,86.81688708036623,9
0.05,983,95,85436,86.82520325203252,6
0.05,984,95,85531,86.83350253807106,6
0.05,985,91,85622,86.83772819472617,11
0.05,986,92,85714,86.84295845997974,10
0.05,987,90,85804,86.84615384615384,11
0.05,988,95,85899,86.85439838220425,7
0.05,989,95,85994,86.86262626262626,7
0.05,990,94,86088,86.86982845610494,7
0.05,991,90,86178,86.87298387096774,11
0.05,992,95,86273,86.88116817724068,6
0.05,993,96,86369,86.89034205231388,6
0.05,994,93,86462,86.89648241206031,8
0.05,995,95,86557,86.90461847389558,6
0.05,996,95,86652,86.91273821464394,6
0.05,997,93,86745,86.9188376753507,8
0.05,998,94,86839,86.92592592592592,7
0.05,999,95,86934,86.934,6
0.05,1000,93,87027,86.94005994005994,8
0.05,1001,25,87052,86.87824351297405,8
0.05,1002,91,87143,86.88235294117646,11
0.05,1003,91,87234,86.88645418326693,11
0.05,1004,90,87324,86.88955223880598,12
0.05,1005,92,87416,86.89463220675944,9
0.05,1006,96,87512,86.90367428003972,6
0.05,1007,95,87607,86.91170634920636,6
0.05,1008,96,87703,86.9207135777998,6
0.05,1009,94,87797,86.92772277227722,7
0.05,1010,94,87891,86.93471810089021,8
0.05,1011,94,87985,86.94169960474308,8
0.05,1012,26,88011,86.88153998025666,6
0.05,1013,94,88105,86.88856015779093,7
0.05,1014,93,88198,86.89458128078817,10
0.05,1015,94,88292,86.9015748031496,8
0.05,1016,94,88386,86.90855457227138,7
0.05,1017,95,88481,86.91650294695481,6
0.05,1018,92,88573,86.92149165848872,9
0.05,1019,92,88665,86.92647058823529,9
0.05,1020,92,88757,86.93143976493634,9
0.05,1021,92,88849,86.93639921722114,9
0.05,1022,94,88943,86.94330400782013,7
0.05,1023,25,88968,86.8828125,7
0.05,1024,95,89063,86.89073170731707,7
0.05,1025,94,89157,86.89766081871345,7
0.05,1026,94,89251,86.904576436222,7
0.05,1027,94,89345,86.9114785992218,8
0.05,1028,94,89439,86.91836734693878,10
0.05,1029,95,89534,86.92621359223301,7
0.05,1030,95,89629,86.93404461687682,6
0.05,1031,95,89724,86.94186046511628,6
0.05,1032,27,89751,86.8838334946757,6
0.05,1033,93,89844,86.88974854932302,8
0.05,1034,94,89938,86.89661835748792,7
0.05,1035,94,90032,86.9034749034749,7
0.05,1036,95,90127,86.91128254580521,6
0.05,1037,92,90219,86.91618497109826,9
0.05,1038,95,90314,86.92396535129933,6
0.05,1039,93,90407,86.92980769230769,10
0.05,1040,94,90501,86.93659942363112,7
0.05,1041,94,90595,86.94337811900192,7
0.05,1042,95,90690,86.95110258868648,6
0.05,1043,96,90786,86.95977011494253,6
0.05,1044,94,90880,86.96650717703349,7
0.05,1045,95,90975,86.97418738049713,6
0.05,1046,96,91071,86.98280802292264,6
0.05,1047,94,91165,86.9895038167939,7
0.05,1048,94,91259,86.99618684461392,7
0.05,1049,94,91353,87.00285714285714,8
0.05,1050,94,91447,87.00951474785919,7
0.05,1051,93,91540,87.01520912547528,9
0.05,1052,93,91633,87.02089268755935,8
0.05,1053,94,91727,87.02751423149905,7
0.05,1054,91,91818,87.03127962085308,10
0.05,1055,94,91912,87.03787878787878,8
0.05,1056,92,92004,87.04257332071901,9
0.05,1057,91,92095,87.04631379962193,11
0.05,1058,96,92191,87.0547686496695,6
0.05,1059,95,92286,87.06226415094339,6
0.05,1060,96,92382,87.07068803016023,6
0.05,1061,96,92478,87.07909604519774,6
0.05,1062,92,92570,87.08372530573848,9
0.05,1063,95,92665,87.09116541353383,6
0.05,1064,94,92759,87.09765258215963,7
0.05,1065,90,92849,87.10037523452158,11
0.05,1066,95,92944,87.10777881911902,6
0.05,1067,96,93040,87.11610486891385,6
0.05,1068,94,93134,87.12254443405051,7
0.05,1069,89,93223,87.12429906542056,12
0.05,1070,94,93317,87.13071895424837,7
0.05,1071,96,93413,87.13899253731343,6
0.05,1072,93,93506,87.14445479962721,8
0.05,1073,94,93600,87.15083798882682,7
0.05,1074,94,93694,87.15720930232558,8
0.05,1075,96,93790,87.16542750929368,6
0.05,1076,95,93885,87.17270194986072,6
0.05,1077,94,93979,87.17903525046383,7
0.05,1078,92,94071,87.18350324374421,9
0.05,1079,92,94163,87.18796296296296,10
0.05,1080,94,94257,87.19426456984274,8
0.05,1081,95,94352,87.20147874306839,6
0.05,1082,96,94448,87.20960295475531,6
0.05,1083,95,94543,87.21678966789668,7
0.05,1084,95,94638,87.22396313364055,6
0.05,1085,95,94733,87.23112338858195,6
0.05,1086,94,94827,87.23735050597976,7
0.05,1087,92,94919,87.24172794117646,9
0.05,1088,95,95014,87.24885215794306,6
0.05,1089,89,95103,87.25045871559632,12
0.05,1090,96,95199,87.25847846012832,6
0.05,1091,94,95293,87.26465201465201,8
0.05,1092,27,95320,87.20951509606587,6
0.05,1093,96,95416,87.21755027422303,6
0.05,1094,96,95512,87.22557077625571,6
0.05,1095,95,95607,87.23266423357664,6
0.05,1096,95,95702,87.23974475843208,6
0.05,1097,96,95798,87.24772313296903,6
0.05,1098,91,95889,87.25113739763421,10
0.05,1099,95,95984,87.25818181818182,6
0.05,1100,93,96077,87.26339691189827,8
0.05,1101,95,96172,87.27041742286751,6
0.05,1102,95,96267,87.27742520398913,6
0.05,1103,94,96361,87.28351449275362,7
0.05,1104,94,96455,87.289592760181,7
0.05,1105,92,96547,87.29385171790236,9
0.05,1106,27,96574,87.23938572719061,6
0.05,1107,92,96666,87.24368231046931,9
0.05,1108,93,96759,87.24887285843101,8
0.05,1109,92,96851,87.25315315315315,9
0.05,1110,94,96945,87.25922592259226,7
0.05,1111,92,97037,87.26348920863309,9
0.05,1112,94,97131,87.26954177897574,8
0.05,1113,94,97225,87.27558348294434,7
0.05,1114,94,97319,87.28161434977578,7
0.05,1115,94,97413,87.28763440860214,7
0.05,1116,93,97506,87.29274843330349,8
0.05,1117,96,97602,87.30053667262969,6
0.05,1118,94,97696,87.3065236818588,8
0.05,1119,94,97790,87.3125,7
0.05,1120,92,97882,87.31668153434434,9
0.05,1121,90,97972,87.31907308377896,11
0.05,1122,95,98067,87.3259127337489,6
0.05,1123,93,98160,87.33096085409252,8
0.05,1124,94,98254,87.3368888888889,7
0.05,1125,27,98281,87.28330373001776,6
0.05,1126,93,98374,87.28837622005324,8
0.05,1127,93,98467,87.29343971631205,8
0.05,1128,96,98563,87.30115146147033,7
0.05,1129,94,98657,87.3070796460177,7
0.05,1130,95,98752,87.31388152077807,6
0.05,1131,93,98845,87.31890459363957,8
0.05,1132,96,98941,87.32656663724624,6
0.05,1133,94,99035,87.33245149911816,7
0.05,1134,95,99130,87.33920704845815,6
0.05,1135,94,99224,87.34507042253522,7
0.05,1136,82,99306,87.34036939313984,19
0.05,1137,95,99401,87.34710017574693,6
0.05,1138,96,99497,87.35469710272169,6
0.05,1139,96,99593,87.36228070175439,6
0.05,1140,94,99687,87.3680981595092,7
0.05,1141,95,99782,87.37478108581436,6
0.05,1142,91,99873,87.37795275590551,10
0.05,1143,94,99967,87.38374125874125,7
0.05,1144,96,100063,87.39126637554585,6
0.05,1145,89,100152,87.39267015706807,12
0.05,1146,93,100245,87.39755884917176,9
0.05,1147,94,100339,87.40331010452962,7
0.05,1148,95,100434,87.40992167101828,6
0.05,1149,92,100526,87.41391304347826,9
0.05,1150,94,100620,87.41963509991312,7
0.05,1151,95,100715,87.42621527777777,6
0.05,1152,96,100811,87.43365134431917,6
0.05,1153,94,100905,87.43934142114385,7
0.05,1154,93,100998,87.44415584415584,8
0.05,1155,96,101094,87.4515570934256,6
0.05,1156,92,101186,87.45548833189282,9
0.05,1157,94,101280,87.46113989637306,7
0.05,1158,93,101373,87.46591889559966,8
0.05,1159,94,101467,87.47155172413792,8
0.05,1160,94,101561,87.47717484926787,7
0.05,1161,89,101650,87.47848537005163,12
0.05,1162,93,101743,87.48323301805675,8
0.05,1163,92,101835,87.48711340206185,10
0.05,1164,94,101929,87.49270386266095,7
0.05,1165,94,102023,87.49828473413379,7
0.05,1166,94,102117,87.5038560411311,7
0.05,1167,95,102212,87.51027397260275,6
0.05,1168,94,102306,87.5158254918734,7
0.05,1169,93,102399,87.52051282051282,8
0.05,1170,94,102493,87.5260461144321,7
0.05,1171,94,102587,87.5315699658703,7
0.05,1172,95,102682,87.53793691389599,8
0.05,1173,95,102777,87.5442930153322,6
0.05,1174,96,102873,87.55148936170212,6
0.05,1175,96,102969,87.55867346938776,6
0.05,1176,94,103063,87.56414613423959,7
0.05,1177,95,103158,87.5704584040747,6
0.05,1178,94,103252,87.57591178965225,7
0.05,1179,94,103346,87.5813559322034,7
0.05,1180,92,103438,87.58509737510585,9
0.05,1181,94,103532,87.59052453468698,7
0.05,1182,93,103625,87.59509721048182,8
0.05,1183,91,103716,87.59797297297297,10
0.05,1184,92,103808,87.60168776371307,9
0.05,1185,87,103895,87.60118043844857,14
0.05,1186,94,103989,87.60657118786858,8
0.05,1187,94,104083,87.61195286195286,7
0.05,1188,96,104179,87.61900756938604,6
0.05,1189,95,104274,87.62521008403361,6
0.05,1190,96,104370,87.63224181360202,6
0.05,1191,94,104464,87.63758389261746,7
0.05,1192,95,104559,87.64375523889355,8
0.05,1193,93,104652,87.64824120603015,8
0.05,1194,95,104747,87.65439330543933,6
0.05,1195,94,104841,87.65969899665552,8
0.05,1196,92,104933,87.66332497911445,9
0.05,1197,94,105027,87.6686143572621,7
0.05,1198,16,105043,87.60884070058383,16
0.05,1199,94,105137,87.61416666666666,7
0.05,1200,94,105231,87.6194837635304,7
0.05,1201,95,105326,87.62562396006656,6
0.05,1202,96,105422,87.63258520365753,6
0.05,1203,94,105516,87.63787375415282,7
0.05,1204,95,105611,87.64398340248962,7
0.05,1205,92,105703,87.64759535655058,9
0.05,1206,95,105798,87.65368682684341,6
0.05,1207,96,105894,87.66059602649007,6
0.05,1208,93,105987,87.6650124069479,8
0.05,1209,95,106082,87.6710743801653,6
0.05,1210,90,106172,87.6729975227085,11
0.05,1211,94,106266,87.67821782178218,7
0.05,1212,96,106362,87.6850783182193,6
0.05,1213,92,106454,87.68863261943987,9
0.05,1214,93,106547,87.69300411522634,8
0.05,1215,95,106642,87.69901315789474,6
0.05,1216,94,106736,87.70419063270337,7
0.05,1217,94,106830,87.70935960591133,7
0.05,1218,94,106924,87.71452009844134,9
0.05,1219,94,107018,87.71967213114755,7
0.05,1220,95,107113,87.72563472563472,6
0.05,1221,93,107206,87.72995090016367,8
0.05,1222,94,107300,87.73507767784137,8
0.05,1223,93,107393,87.73937908496733,8
0.05,1224,93,107486,87.74367346938776,8
0.05,1225,93,107579,87.74796084828711,8
0.05,1226,96,107675,87.75468622656886,6
0.05,1227,96,107771,87.76140065146579,6
0.05,1228,93,107864,87.76566314076484,8
0.05,1229,95,107959,87.77154471544715,6
0.05,1230,27,107986,87.72217709179529,6
0.05,1231,92,108078,87.72564935064935,9
0.05,1232,94,108172,87.73073803730738,8
0.05,1233,94,108266,87.73581847649919,7
0.05,1234,83,108349,87.73198380566802,19
0.05,1235,95,108444,87.7378640776699,7
0.05,1236,96,108540,87.7445432497979,6
0.05,1237,93,108633,87.74878836833602,8
0.05,1238,95,108728,87.7546408393866,7
0.05,1239,95,108823,87.76048387096775,6
0.05,1240,91,108914,87.76309427880742,11
0.05,1241,92,109006,87.76650563607086,9
0.05,1242,94,109100,87.77152051488335,7
0.05,1243,95,109195,87.77733118971061,7
0.05,1244,88,109283,87.77751004016065,13
0.05,1245,96,109379,87.78410914927768,6
0.05,1246,96,109475,87.79069767441861,6
0.05,1247,95,109570,87.79647435897436,6
0.05,1248,94,109664,87.80144115292234,7
0.05,1249,94,109758,87.8064,7
0.05,1250,94,109852,87.81135091926458,8
0.05,1251,93,109945,87.81549520766774,8
0.05,1252,94,110039,87.82043096568236,7
0.05,1253,94,110133,87.82535885167464,8
0.05,1254,93,110226,87.82948207171314,8
0.05,1255,95,110321,87.83519108280255,7
0.05,1256,94,110415,87.8400954653938,7
0.05,1257,95,110510,87.84578696343402,6
0.05,1258,95,110605,87.85146942017474,6
0.05,1259,95,110700,87.85714285714286,6
0.05,1260,94,110794,87.8620142743854,7
0.05,1261,92,110886,87.86529318541997,9
0.05,1262,94,110980,87.8701504354711,7
0.05,1263,96,111076,87.87658227848101,6
0.05,1264,94,111170,87.88142292490119,7
0.05,1265,94,111264,87.88625592417061,7
0.05,1266,95,111359,87.89187056037885,6
0.05,1267,90,111449,87.89353312302839,11
0.05,1268,95,111544,87.89913317572892,7
0.05,1269,94,111638,87.90393700787402,7
0.05,1270,94,111732,87.9087332808812,7
0.05,1271,94,111826,87.91352201257861,7
0.05,1272,94,111920,87.91830322073841,7
0.05,1273,95,112015,87.92386185243328,6
0.05,1274,96,112111,87.93019607843138,6
0.05,1275,94,112205,87.93495297805643,7
0.05,1276,94,112299,87.9397024275646,7
0.05,1277,95,112394,87.94522691705791,6
0.05,1278,95,112489,87.95074276778733,6
0.05,1279,93,112582,87.9546875,8
0.05,1280,96,112678,87.96096799375488,6
0.05,1281,90,112768,87.96255850234009,11
0.05,1282,96,112864,87.96882307092751,6
0.05,1283,96,112960,87.97507788161994,6
0.05,1284,96,113056,87.98132295719844,6
0.05,1285,93,113149,87.98522550544324,8
0.05,1286,93,113242,87.98912198912198,8
0.05,1287,90,113332,87.99068322981367,12
0.05,1288,92,113424,87.99379363847945,9
0.05,1289,94,113518,87.9984496124031,7
0.05,1290,95,113613,88.00387296669248,6
0.05,1291,96,113709,88.01006191950465,6
0.05,1292,95,113804,88.015467904099,7
0.05,1293,95,113899,88.02086553323029,7
0.05,1294,95,113994,88.02625482625483,6
0.05,1295,94,114088,88.03086419753086,7
0.05,1296,90,114178,88.03238242097147,11
0.05,1297,91,114269,88.0346687211094,10
0.05,1298,95,114364,88.04003079291763,6
0.05,1299,27,114391,87.99307692307693,6
0.05,1300,95,114486,87.99846272098385,6
0.05,1301,91,114577,88.00076804915514,10
0.05,1302,94,114671,88.00537221795855,7
0.05,1303,88,114759,88.00536809815951,13
0.05,1304,95,114854,88.01072796934866,6
0.05,1305,96,114950,88.01684532924962,6
0.05,1306,93,115043,88.02065799540934,8
0.05,1307,95,115138,88.02599388379205,6
0.05,1308,24,115162,87.97708174178763,10
0.05,1309,94,115256,87.98167938931297,7
0.05,1310,96,115352,87.98779557589626,6
0.05,1311,92,115444,87.99085365853658,9
0.05,1312,92,115536,87.993907083016,9
0.05,1313,94,115630,87.99847792998477,7
0.05,1314,95,115725,88.00380228136882,6
0.05,1315,93,115818,88.00759878419453,8
0.05,1316,93,115911,88.0113895216401,8
0.05,1317,85,115996,88.00910470409711,16
0.05,1318,95,116091,88.01440485216072,6
0.05,1319,95,116186,88.01969696969697,6
0.05,1320,91,116277,88.0219530658592,10
0.05,1321,93,116370,88.02571860816944,8
0.05,1322,94,116464,88.0302343159486,8
0.05,1323,95,116559,88.03549848942598,6
0.05,1324,94,116653,88.04,7
0.05,1325,94,116747,88.0444947209653,8
0.05,1326,95,116842,88.04973624717408,6
0.05,1327,89,116931,88.05045180722891,12
0.05,1328,94,117025,88.05492851768247,7
0.05,1329,95,117120,88.06015037593986,6
0.05,1330,94,117214,88.06461307287753,7
0.05,1331,94,117308,88.06906906906907,7
0.05,1332,25,117333,88.02175543885971,8
0.05,1333,93,117426,88.02548725637182,8
0.05,1334,95,117521,88.03071161048689,7
0.05,1335,92,117613,88.03368263473054,9
0.05,1336,94,117707,88.03814510097233,7
0.05,1337,96,117803,88.0440956651719,6
0.05,1338,92,117895,88.0470500373413,9
0.05,1339,94,117989,88.05149253731344,7
0.05,1340,94,118083,88.0559284116331,7
0.05,1341,94,118177,88.06035767511177,7
0.05,1342,96,118273,88.066269545793,6
0.05,1343,88,118361,88.06622023809524,14
0.05,1344,95,118456,88.07137546468401,6
0.05,1345,95,118551,88.07652303120356,7
0.05,1346,94,118645,88.08092056421678,7
0.05,1347,95,118740,88.0860534124629,6
0.05,1348,96,118836,88.09191994069681,6
0.05,1349,96,118932,88.09777777777778,6
0.05,1350,96,119028,88.10362694300518,6
0.05,1351,95,119123,88.10872781065089,7
0.05,1352,96,119219,88.11456023651145,6
0.05,1353,94,119313,88.11890694239291,7
0.05,1354,96,119409,88.12472324723247,6
0.05,1355,93,119502,88.1283185840708,8
0.05,1356,96,119598,88.13411938098747,6
0.05,1357,91,119689,88.13622974963181,10
0.05,1358,95,119784,88.14128035320088,6
0.05,1359,94,119878,88.14558823529411,7
0.05,1360,94,119972,88.14988978692138,7
0.05,1361,92,120064,88.15271659324523,9
0.05,1362,94,120158,88.15700660308144,7
0.05,1363,93,120251,88.16055718475073,8
0.05,1364,96,120347,88.16630036630036,6
0.05,1365,95,120442,88.17130307467058,8
0.05,1366,93,120535,88.17483540599854,8
0.05,1367,96,120631,88.18055555555556,6
0.05,1368,95,120726,88.1855368882396,6
0.05,1369,95,120821,88.19051094890511,7
0.05,1370,89,120910,88.19110138584975,12
0.05,1371,95,121005,88.1960641399417,7
0.05,1372,23,121028,88.14857975236708,12
0.05,1373,26,121054,88.10334788937409,7
0.05,1374,94,121148,88.10763636363636,7
0.05,1375,94,121242,88.11191860465117,7
0.05,1376,94,121336,88.11619462599855,7
0.05,1377,96,121432,88.12191582002903,6
0.05,1378,95,121527,88.1269035532995,6
0.05,1379,94,121621,88.13115942028986,7
0.05,1380,95,121716,88.13613323678494,7
0.05,1381,95,121811,88.1410998552822,6
0.05,1382,94,121905,88.14533622559652,7
0.05,1383,96,122001,88.15101156069365,6
0.05,1384,91,122092,88.15306859205776,10
0.05,1385,95,122187,88.15800865800865,6
0.05,1386,93,122280,88.16149963950973,8
0.05,1387,95,122375,88.1664265129683,6
0.05,1388,94,122469,88.170626349892,7
0.05,1389,94,122563,88.17482014388489,7
0.05,1390,96,122659,88.1804457225018,6
0.05,1391,95,122754,88.1853448275862,6
0.05,1392,94,122848,88.18951902368988,7
0.05,1393,94,122942,88.19368723098995,8
0.05,1394,95,123037,88.19856630824373,7
0.05,1395,95,123132,88.20343839541547,6
0.05,1396,92,123224,88.20615604867574,9
0.05,1397,95,123319,88.21101573676681,6
0.05,1398,26,123345,88.16654753395282,7
0.05,1399,96,123441,88.17214285714286,6
0.05,1400,94,123535,88.17630264097073,7
0.05,1401,94,123629,88.18045649072754,7
0.05,1402,95,123724,88.18531717747683,7
0.05,1403,95,123819,88.19017094017094,6
0.05,1404,96,123915,88.19572953736655,6
0.05,1405,94,124009,88.19985775248934,7
0.05,1406,94,124103,88.20398009950249,7
0.05,1407,89,124192,88.20454545454545,12
0.05,1408,96,124288,88.21007806955288,6
0.05,1409,95,124383,88.21489361702127,7
0.05,1410,94,124477,88.21899362154501,7
0.05,1411,95,124572,88.22379603399433,6
0.05,1412,93,124665,88.2271762208068,8
0.05,1413,94,124759,88.23125884016973,8
0.05,1414,92,124851,88.2339222614841,9
0.05,1415,88,124939,88.23375706214689,15
0.05,1416,96,125035,88.23923782639379,6
0.05,1417,96,125131,88.24471086036671,6
0.05,1418,91,125222,88.24665257223397,10
0.05,1419,94,125316,88.25070422535211,7
0.05,1420,96,125412,88.25615763546799,6
0.05,1421,93,125505,88.25949367088607,8
0.05,1422,93,125598,88.26282501756852,8
0.05,1423,91,125689,88.26474719101124,10
0.05,1424,94,125783,88.26877192982457,7
0.05,1425,95,125878,88.273492286115,6
0.05,1426,90,125968,88.27470217238962,11
0.05,1427,94,126062,88.27871148459384,8
0.05,1428,94,126156,88.28271518544436,7
0.05,1429,92,126248,88.28531468531469,11
0.05,1430,94,126342,88.28930817610063,7
0.05,1431,89,126431,88.28980446927375,12
0.05,1432,89,126520,88.29030006978367,12
0.05,1433,94,126614,88.29428172942818,7
0.05,1434,94,126708,88.29825783972126,8
0.05,1435,93,126801,88.30153203342618,8
0.05,1436,95,126896,88.3061934585943,6
0.05,1437,95,126991,88.31084840055632,6
0.05,1438,95,127086,88.31549687282835,6
0.05,1439,93,127179,88.31875,8
0.05,1440,96,127275,88.32408049965302,6
0.05,1441,95,127370,88.32871012482663,6
0.05,1442,94,127464,88.33264033264034,7
0.05,1443,96,127560,88.33795013850416,6
0.05,1444,88,127648,88.33771626297577,13
0.05,1445,94,127742,88.34163208852006,7
0.05,1446,90,127832,88.3427781617139,11
0.05,1447,92,127924,88.34530386740332,9
0.05,1448,94,128018,88.34920634920636,7
0.05,1449,94,128112,88.35310344827586,7
0.05,1450,96,128208,88.35837353549276,6
0.05,1451,94,128302,88.36225895316804,7
0.05,1452,94,128396,88.36613902271164,7
0.05,1453,94,128490,88.37001375515818,7
0.05,1454,94,128584,88.37388316151203,7
0.05,1455,96,128680,88.37912087912088,6
0.05,1456,94,128774,88.38297872340425,8
0.05,1457,94,128868,88.38683127572017,7
0.05,1458,94,128962,88.39067854694997,7
0.05,1459,92,129054,88.39315068493151,9
0.05,1460,92,129146,88.39561943874058,9
0.05,1461,96,129242,88.40082079343365,6
0.05,1462,95,129337,88.40533151059466,8
0.05,1463,96,129433,88.41051912568307,6
0.05,1464,92,129525,88.41296928327645,9
0.05,1465,93,129618,88.41609822646657,9
0.05,1466,95,129713,88.42058623040218,7
0.05,1467,94,129807,88.42438692098092,7
0.05,1468,95,129902,88.428863172226,6
0.05,1469,94,129996,88.43265306122449,7
0.05,1470,94,130090,88.43643779741673,8
0.05,1471,96,130186,88.44157608695652,6
0.05,1472,94,130280,88.44534962661236,7
0.05,1473,19,130299,88.39823609226595,13
0.05,1474,96,130395,88.40338983050847,6
0.05,1475,94,130489,88.40718157181571,7
0.05,1476,93,130582,88.41029113067027,8
0.05,1477,26,130608,88.3680649526387,7
0.05,1478,92,130700,88.37052062204192,9
0.05,1479,92,130792,88.37297297297297,10
0.05,1480,91,130883,88.37474679270763,10
0.05,1481,93,130976,88.3778677462888,8
0.05,1482,94,131070,88.38165879973027,7
0.05,1483,94,131164,88.38544474393531,8
0.05,1484,94,131258,88.38922558922559,7
0.05,1485,93,131351,88.39232839838493,8
0.05,1486,93,131444,88.39542703429724,8
0.05,1487,91,131535,88.39717741935483,10
0.05,1488,95,131630,88.40161182001343,6
0.05,1489,96,131726,88.40671140939597,6
0.05,1490,27,131753,88.36552649228706,6
0.05,1491,94,131847,88.36930294906166,7
0.05,1492,94,131941,88.37307434695245,7
0.05,1493,93,132034,88.37617135207496,8
0.05,1494,90,132124,88.3772575250836,11
0.05,1495,92,132216,88.37967914438502,9
0.05,1496,94,132310,88.38343353373413,7
0.05,1497,96,132406,88.38851802403204,6
0.05,1498,94,132500,88.39226150767178,7
0.05,1499,93,132593,88.39533333333334,8
0.05,1500,94,132687,88.39906728847436,9
0.05,1501,94,132781,88.40279627163781,7
0.05,1502,94,132875,88.40652029274784,8
0.05,1503,96,132971,88.41156914893617,6
0.05,1504,94,133065,88.41528239202658,7
0.05,1505,94,133159,88.41899070385126,8
0.05,1506,94,133253,88.42269409422694,7
0.05,1507,94,133347,88.4263925729443,7
0.05,1508,94,133441,88.43008614976806,7
0.05,1509,95,133536,88.43443708609271,8
0.05,1510,94,133630,88.4381204500331,7
0.05,1511,93,133723,88.44113756613757,8
0.05,1512,93,133816,88.44415069398546,9
0.05,1513,92,133908,88.44649933949802,9
0.05,1514,95,134003,88.45082508250825,6
0.05,1515,96,134099,88.45580474934037,6
0.05,1516,96,134195,88.46077785102176,7
0.05,1517,94,134289,88.46442687747036,7
0.05,1518,93,134382,88.46741277156023,8
0.05,1519,95,134477,88.47171052631579,6
0.05,1520,93,134570,88.47468770545693,8
0.05,1521,94,134664,88.47831800262811,7
0.05,1522,93,134757,88.48128693368352,8
0.05,1523,94,134851,88.48490813648294,7
0.05,1524,94,134945,88.48852459016393,7
0.05,1525,96,135041,88.49344692005242,6
0.05,1526,89,135130,88.49377865094958,12
0.05,1527,95,135225,88.49803664921465,8
0.05,1528,95,135320,88.50228907782865,7
0.05,1529,93,135413,88.50522875816993,8
0.05,1530,94,135507,88.5088177661659,7
0.05,1531,93,135600,88.51174934725849,8
0.05,1532,95,135695,88.51598173515981,6
0.05,1533,93,135788,88.51890482398957,8
0.05,1534,94,135882,88.52247557003257,7
0.05,1535,93,135975,88.525390625,8
0.05,1536,94,136069,88.52895250487964,9
0.05,1537,94,136163,88.53250975292588,7
0.05,1538,93,136256,88.53541260558805,9
0.05,1539,93,136349,88.5383116883117,8
0.05,1540,94,136443,88.54185593770279,8
0.05,1541,94,136537,88.54539559014268,7
0.05,1542,94,136631,88.54893065456902,7
0.05,1543,94,136725,88.55246113989638,7
0.05,1544,91,136816,88.55404530744336,11
0.05,1545,95,136911,88.55821474773609,8
0.05,1546,92,137003,88.56043956043956,9
0.05,1547,95,137098,88.56459948320413,7
0.05,1548,96,137194,88.56939961265333,6
0.05,1549,95,137289,88.57354838709678,6
0.05,1550,95,137384,88.57769181173437,6
0.05,1551,92,137476,88.5798969072165,9
0.05,1552,95,137571,88.58403090792015,6
0.05,1553,96,137667,88.58880308880309,6
0.05,1554,94,137761,88.59228295819936,7
0.05,1555,20,137781,88.54820051413881,12
0.05,1556,92,137873,88.55041746949261,9
0.05,1557,93,137966,88.55327342747111,8
0.05,1558,93,138059,88.55612572161643,8
0.05,1559,96,138155,88.56089743589743,6
0.05,1560,94,138249,88.56438180653427,7
0.05,1561,93,138342,88.56722151088348,9
0.05,1562,90,138432,88.56813819577735,11
0.05,1563,94,138526,88.57161125319693,7
0.05,1564,92,138618,88.57380191693291,9
0.05,1565,96,138714,88.57854406130268,6
0.05,1566,94,138808,88.58200382897256,7
0.05,1567,94,138902,88.58545918367346,7
0.05,1568,96,138998,88.59018483110262,6
0.05,1569,94,139092,88.5936305732484,7
0.05,1570,90,139182,88.59452577975811,11
0.05,1571,94,139276,88.59796437659033,7
0.05,1572,89,139365,88.59821996185633,12
0.05,1573,93,139458,88.6010165184244,8
0.05,1574,95,139553,88.60507936507936,6
0.05,1575,27,139580,88.56598984771574,6
0.05,1576,95,139675,88.57006975269499,6
0.05,1577,94,139769,88.57351077313055,7
0.05,1578,92,139861,88.57568081063964,9
0.05,1579,94,139955,88.57911392405063,7
0.05,1580,93,140048,88.5819101834282,10
0.05,1581,92,140140,88.58407079646018,9
0.05,1582,94,140234,88.58749210360075,7
0.05,1583,92,140326,88.58964646464646,9
0.05,1584,96,140422,88.59432176656152,6
0.05,1585,94,140516,88.59773013871374,7
0.05,1586,94,140610,88.60113421550095,7
0.05,1587,93,140703,88.60390428211586,8
0.05,1588,95,140798,88.6079295154185,6
0.05,1589,94,140892,88.61132075471698,8
0.05,1590,93,140985,88.61407919547455,8
0.05,1591,91,141076,88.61557788944724,10
0.05,1592,93,141169,88.61833019460138,10
0.05,1593,93,141262,88.62107904642409,8
0.05,1594,96,141358,88.6257053291536,6
0.05,1595,96,141454,88.63032581453633,6
0.05,1596,93,141547,88.63306199123356,8
0.05,1597,96,141643,88.63767209011264,6
0.05,1598,96,141739,88.64227642276423,6
0.05,1599,93,141832,88.645,8
0.05,1600,94,141926,88.64834478450967,7
0.05,1601,93,142019,88.65106117353308,8
0.05,1602,94,142113,88.65439800374298,7
0.05,1603,93,142206,88.6571072319202,8
0.05,1604,93,142299,88.65981308411214,8
0.05,1605,95,142394,88.66376089663761,6
0.05,1606,88,142482,88.6633478531425,13
0.05,1607,92,142574,88.66542288557214,9
0.05,1608,92,142666,88.6674953387197,9
0.05,1609,96,142762,88.672049689441,6
0.05,1610,95,142857,88.67597765363128,7
0.05,1611,93,142950,88.6786600496278,8
0.05,1612,94,143044,88.68195908245505,7
0.05,1613,91,143135,88.68339529120199,10
0.05,1614,96,143231,88.68792569659443,6
0.05,1615,93,143324,88.69059405940594,8
0.05,1616,92,143416,88.6926406926407,9
0.05,1617,94,143510,88.69592088998763,7
0.05,1618,95,143605,88.69981470043237,7
0.05,1619,91,143696,88.70123456790124,10
0.05,1620,93,143789,88.7038864898211,8
0.05,1621,94,143883,88.70715166461159,7
0.05,1622,92,143975,88.70918052988293,9
0.05,1623,94,144069,88.71243842364532,7
0.05,1624,94,144163,88.71569230769231,7
0.05,1625,93,144256,88.71832718327184,8
0.05,1626,94,144350,88.72157344806392,7
0.05,1627,93,144443,88.72420147420148,8
0.05,1628,93,144536,88.7268262737876,8
0.05,1629,92,144628,88.72883435582823,9
0.05,1630,95,144723,88.73267933782955,6
0.05,1631,96,144819,88.73713235294117,6
0.05,1632,95,144914,88.74096754439681,6
0.05,1633,94,145008,88.74418604651163,7
0.05,1634,95,145103,88.7480122324159,7
0.05,1635,94,145197,88.75122249388752,7
0.05,1636,96,145293,88.75565058032987,6
0.05,1637,90,145383,88.75641025641026,11
0.05,1638,95,145478,88.76021964612569,6
0.05,1639,96,145574,88.76463414634146,6
0.05,1640,94,145668,88.76782449725776,7
0.05,1641,94,145762,88.77101096224116,7
0.05,1642,92,145854,88.77297626293365,9
0.05,1643,93,145947,88.77554744525547,8
0.05,1644,95,146042,88.77933130699088,6
0.05,1645,94,146136,88.78250303766707,8
0.05,1646,93,146229,88.78506375227687,8
0.05,1647,95,146324,88.78883495145631,8
0.05,1648,94,146418,88.7919951485749,7
0.05,1649,92,146510,88.7939393939394,9
0.05,1650,95,146605,88.7976983646275,6
0.05,1651,94,146699,88.80084745762711,8
0.05,1652,87,146786,88.79975801572898,14
0.05,1653,96,146882,88.80411124546553,6
0.05,1654,94,146976,88.80725075528701,7
0.05,1655,92,147068,88.80917874396135,9
0.05,1656,94,147162,88.8123114061557,7
0.05,1657,94,147256,88.81544028950543,8
0.05,1658,92,147348,88.81735985533454,9
0.05,1659,95,147443,88.8210843373494,6
0.05,1660,94,147537,88.82420228777845,7
0.05,1661,94,147631,88.82731648616125,7
0.05,1662,94,147725,88.83042693926639,7
0.05,1663,94,147819,88.83353365384616,8
0.05,1664,94,147913,88.83663663663664,7
0.05,1665,94,148007,88.83973589435774,7
0.05,1666,96,148103,88.84403119376125,6
0.05,1667,96,148199,88.84832134292566,6
0.05,1668,94,148293,88.85140802875974,7
0.05,1669,94,148387,88.85449101796407,7
0.05,1670,94,148481,88.85757031717534,8
0.05,1671,19,148500,88.8157894736842,13
0.05,1672,95,148595,88.81948595337717,6
0.05,1673,95,148690,88.8231780167264,6
0.05,1674,94,148784,88.82626865671642,7
0.05,1675,94,148878,88.82935560859188,7
0.05,1676,94,148972,88.83243887895051,7
0.05,1677,27,148999,88.79558998808105,6
0.05,1678,94,149093,88.79868969624776,7
0.05,1679,82,149175,88.79464285714286,19
0.05,1680,95,149270,88.79833432480666,6
0.05,1681,94,149364,88.8014268727705,7
0.05,1682,94,149458,88.80451574569221,8
0.05,1683,93,149551,88.80700712589073,10
0.05,1684,95,149646,88.8106824925816,6
0.05,1685,95,149741,88.81435349940688,6
0.05,1686,92,149833,88.81624184943686,10
0.05,1687,94,149927,88.81931279620854,7
0.05,1688,93,150020,88.82178804026051,8
0.05,1689,95,150115,88.82544378698225,6
0.05,1690,93,150208,88.82791247782377,8
0.05,1691,95,150303,88.83156028368795,6
0.05,1692,93,150396,88.83402244536326,9
0.05,1693,92,150488,88.83589138134593,9
0.05,1694,91,150579,88.83716814159293,12
0.05,1695,92,150671,88.83903301886792,9
0.05,1696,89,150760,88.83912787271656,12
0.05,1697,95,150855,88.84275618374558,6
0.05,1698,92,150947,88.84461447910536,9
0.05,1699,92,151039,88.84647058823529,9
0.05,1700,95,151134,88.85008818342152,6
0.05,1701,92,151226,88.85193889541716,9
0.05,1702,93,151319,88.85437463300059,8
0.05,1703,95,151414,88.85798122065728,6
0.05,1704,90,151504,88.85865102639296,11
0.05,1705,92,151596,88.86049237983588,9
0.05,1706,26,151622,88.82366725248974,7
0.05,1707,96,151718,88.82786885245902,6
0.05,1708,95,151813,88.8314803978935,6
0.05,1709,94,151907,88.83450292397661,7
0.05,1710,94,152001,88.83752191700759,8
0.05,1711,94,152095,88.84053738317758,7
0.05,1712,93,152188,88.84296555750146,8
0.05,1713,96,152284,88.84714119019837,6
0.05,1714,27,152311,88.81107871720117,6
0.05,1715,94,152405,88.81410256410257,8
0.05,1716,96,152501,88.81828771112406,6
0.05,1717,91,152592,88.81955762514552,10
0.05,1718,92,152684,88.82140779522979,9
0.05,1719,96,152780,88.82558139534883,6
0.05,1720,94,152874,88.82858803021499,7
0.05,1721,94,152968,88.83159117305459,8
0.05,1722,94,153062,88.83459082994777,7
0.05,1723,94,153156,88.83758700696056,7
0.05,1724,94,153250,88.84057971014492,7
0.05,1725,91,153341,88.84183082271147,10
0.05,1726,92,153433,88.84365952518819,9
0.05,1727,92,153525,88.84548611111111,9
0.05,1728,95,153620,88.84904569115095,7
0.05,1729,95,153715,88.85260115606937,6
0.05,1730,93,153808,88.85499711149625,8
0.05,1731,95,153903,88.85854503464203,6
0.05,1732,89,153992,88.85862665897288,12
0.05,1733,94,154086,88.86159169550173,7
0.05,1734,96,154182,88.8657060518732,6
0.05,1735,96,154278,88.86981566820276,6
0.05,1736,95,154373,88.8733448474381,6
0.05,1737,95,154468,88.87686996547757,6
0.05,1738,95,154563,88.8803910293272,6
0.05,1739,94,154657,88.88333333333334,7
0.05,1740,93,154750,88.88569787478461,8
0.05,1741,93,154843,88.88805970149254,8
0.05,1742,95,154938,88.89156626506023,6
0.05,1743,94,155032,88.89449541284404,7
0.05,1744,91,155123,88.89570200573066,10
0.05,1745,96,155219,88.89977090492555,6
0.05,1746,94,155313,88.90269032627361,7
0.05,1747,92,155405,88.90446224256293,9
0.05,1748,93,155498,88.90680388793596,9
0.05,1749,96,155594,88.91085714285714,6
0.05,1750,94,155688,88.9137635636779,7
0.05,1751,94,155782,88.91666666666667,7
0.05,1752,94,155876,88.91956645750143,7
0.05,1753,94,155970,88.9224629418472,7
0.05,1754,95,156065,88.92592592592592,6
0.05,1755,93,156158,88.92824601366742,9
0.05,1756,96,156254,88.93227091633466,6
0.05,1757,87,156341,88.93117178612059,14
0.05,1758,95,156436,88.93462194428653,7
0.05,1759,89,156525,88.9346590909091,12
0.05,1760,93,156618,88.93696763202726,8
0.05,1761,95,156713,88.94040862656072,7
0.05,1762,93,156806,88.94271128757799,9
0.05,1763,92,156898,88.94444444444444,9
0.05,1764,95,156993,88.94787535410765,6
0.05,1765,94,157087,88.95073612684031,7
0.05,1766,95,157182,88.9541595925297,8
0.05,1767,94,157276,88.95701357466064,7
0.05,1768,92,157368,88.95873374788016,9
0.05,1769,94,157462,88.96158192090395,7
0.05,1770,95,157557,88.96499153020892,6
0.05,1771,92,157649,88.96670428893906,9
0.05,1772,95,157744,88.97010716300056,8
0.05,1773,92,157836,88.9718151071026,9
0.05,1774,89,157925,88.97183098591549,12
0.05,1775,93,158018,88.97409909909909,8
0.05,1776,96,158114,88.97805289814293,6
0.05,1777,95,158209,88.9814398200225,6
0.05,1778,94,158303,88.98426082068578,7
0.05,1779,93,158396,88.98651685393259,8
0.05,1780,94,158490,88.98933183604717,7
0.05,1781,95,158585,88.99270482603816,6
0.05,1782,95,158680,88.99607403252945,6
0.05,1783,95,158775,88.99943946188341,6
0.05,1784,94,158869,89.00224089635854,7
0.05,1785,94,158963,89.005039193729,7
0.05,1786,94,159057,89.00783435926134,7
0.05,1787,95,159152,89.01118568232663,6
0.05,1788,94,159246,89.01397428731134,7
0.05,1789,94,159340,89.01675977653632,7
0.05,1790,93,159433,89.01898380792854,8
0.05,1791,94,159527,89.02176339285714,7
0.05,1792,95,159622,89.02509760178472,6
0.05,1793,26,159648,88.98996655518394,6
0.05,1794,94,159742,88.99275766016713,7
0.05,1795,92,159834,88.99443207126949,10
0.05,1796,94,159928,88.99721758486366,7
0.05,1797,92,160020,88.99888765294772,9
0.05,1798,96,160116,89.00277932184547,6
0.05,1799,92,160208,89.00444444444445,10
0.05,1800,91,160299,89.00555247084952,11
0.05,1801,94,160393,89.00832408435072,8
0.05,1802,93,160486,89.01053799223516,8
0.05,1803,94,160580,89.01330376940133,7
0.05,1804,95,160675,89.01662049861496,6
0.05,1805,93,160768,89.0188261351052,8
0.05,1806,92,160860,89.02047592695075,9
0.05,1807,95,160955,89.02378318584071,6
0.05,1808,94,161049,89.02653399668326,7
0.05,1809,93,161142,89.02872928176795,8
0.05,1810,95,161237,89.03202650469353,6
0.05,1811,94,161331,89.03476821192054,7
0.05,1812,94,161425,89.03750689464975,7
0.05,1813,95,161520,89.04079382579934,7
0.05,1814,94,161614,89.0435261707989,7
0.05,1815,94,161708,89.04625550660793,7
0.05,1816,93,161801,89.0484314804623,8
0.05,1817,92,161893,89.05005500550055,9
0.05,1818,92,161985,89.05167674546455,9
0.05,1819,94,162079,89.05439560439561,8
0.05,1820,93,162172,89.056562328391,8
0.05,1821,94,162266,89.05927552140506,7
0.05,1822,94,162360,89.06198573779484,7
0.05,1823,94,162454,89.06469298245614,8
0.05,1824,95,162549,89.06794520547945,7
0.05,1825,94,162643,89.07064622124864,8
0.05,1826,94,162737,89.07334428024083,7
0.05,1827,93,162830,89.07549234135668,8
0.05,1828,94,162924,89.0781848004374,8
0.05,1829,94,163018,89.08087431693988,7
0.05,1830,96,163114,89.08465319497542,6
0.05,1831,91,163205,89.08569868995633,10
0.05,1832,96,163301,89.08947081287506,6
0.05,1833,95,163396,89.092693565976,6
0.05,1834,96,163492,89.09645776566758,6
0.05,1835,90,163582,89.09694989106754,11
0.05,1836,93,163675,89.0990745781165,8
0.05,1837,94,163769,89.10174102285093,7
0.05,1838,94,163863,89.10440456769983,7
0.05,1839,96,163959,89.10815217391304,6
0.05,1840,94,164053,89.11080934274851,7
0.05,1841,92,164145,89.11237785016287,9
0.05,1842,93,164238,89.11448724905046,8
0.05,1843,92,164330,89.11605206073753,9
0.05,1844,95,164425,89.11924119241192,6
0.05,1845,94,164519,89.12188515709643,7
0.05,1846,94,164613,89.12452625879806,7
0.05,1847,95,164708,89.12770562770562,6
0.05,1848,94,164802,89.13034072471606,7
0.05,1849,94,164896,89.13297297297298,7
0.05,1850,94,164990,89.13560237709346,7
0.05,1851,27,165017,89.10205183585313,6
0.05,1852,92,165109,89.10361575822989,9
0.05,1853,94,165203,89.10625674217907,7
0.05,1854,93,165296,89.10835579514824,8
0.05,1855,95,165391,89.1115301724138,6
0.05,1856,92,165483,89.11308562197092,9
0.05,1857,96,165579,89.11679224973089,6
0.05,1858,92,165671,89.11834319526628,9
0.05,1859,95,165766,89.12150537634409,6
0.05,1860,95,165861,89.12466415905428,6
0.05,1861,95,165956,89.12781954887218,7
0.05,1862,95,166051,89.13097155126141,6
0.05,1863,92,166143,89.13251072961373,9
0.05,1864,94,166237,89.13512064343163,8
0.05,1865,95,166332,89.13826366559485,6
0.05,1866,93,166425,89.1403320835565,8
0.05,1867,93,166518,89.1423982869379,8
0.05,1868,94,166612,89.1449973247726,7
0.05,1869,92,166704,89.14652406417112,9
0.05,1870,92,166796,89.148049171566,10
0.05,1871,94,166890,89.15064102564102,8
0.05,1872,94,166984,89.15323011211959,7
0.05,1873,95,167079,89.15635005336179,7
0.05,1874,94,167173,89.15893333333334,7
0.05,1875,92,167265,89.16044776119404,10
0.05,1876,92,167357,89.16196057538626,9
0.05,1877,94,167451,89.16453674121406,8
0.05,1878,94,167545,89.16711016498137,7
0.05,1879,92,167637,89.16861702127659,9
0.05,1880,96,167733,89.17224880382776,6
0.05,1881,95,167828,89.17534537725824,7
0.05,1882,92,167920,89.17684545937334,9
0.05,1883,90,168010,89.17728237791933,12
0.05,1884,94,168104,89.17984084880636,7
0.05,1885,95,168199,89.1829268292683,6
0.05,1886,88,168287,89.18229994700583,13
0.05,1887,94,168381,89.18485169491525,7
0.05,1888,94,168475,89.18740074113288,7
0.05,1889,92,168567,89.18888888888888,10
0.05,1890,93,168660,89.1909042834479,8
0.05,1891,92,168752,89.1923890063425,9
0.05,1892,95,168847,89.19545694664554,6
0.05,1893,94,168941,89.19799366420274,8
0.05,1894,94,169035,89.2005277044855,7
0.05,1895,95,169130,89.2035864978903,6
0.05,1896,93,169223,89.20558777016342,8
0.05,1897,93,169316,89.20758693361434,9
0.05,1898,93,169409,89.20958399157452,8
0.05,1899,94,169503,89.2121052631579,7
0.05,1900,92,169595,89.21357180431352,9
0.05,1901,92,169687,89.21503680336488,10
0.05,1902,93,169780,89.21702574881766,8
0.05,1903,95,169875,89.22006302521008,6
0.05,1904,94,169969,89.22257217847769,7
0.05,1905,91,170060,89.22350472193075,10
0.05,1906,92,170152,89.22496067121132,10
0.05,1907,93,170245,89.22693920335429,8
0.05,1908,94,170339,89.2294394971189,7
0.05,1909,96,170435,89.23298429319372,6
0.05,1910,92,170527,89.23443223443223,9
0.05,1911,95,170622,89.23744769874477,7
0.05,1912,96,170718,89.24098274960795,6
0.05,1913,94,170812,89.24346917450366,8
0.05,1914,93,170905,89.24543080939948,8
0.05,1915,93,170998,89.24739039665971,8
0.05,1916,93,171091,89.24934793948879,8
0.05,1917,95,171186,89.25234619395204,6
0.05,1918,94,171280,89.254820218864,7
0.05,1919,96,171376,89.25833333333334,6
0.05,1920,93,171469,89.26028110359188,8
0.05,1921,96,171565,89.26378772112383,6
0.05,1922,95,171660,89.26677067082683,6
0.05,1923,94,171754,89.26923076923077,7
0.05,1924,94,171848,89.27168831168831,7
0.05,1925,91,171939,89.27258566978193,10
0.05,1926,95,172034,89.2755578619616,6
0.05,1927,91,172125,89.27645228215768,10
0.05,1928,94,172219,89.2789009849663,7
0.05,1929,92,172311,89.28031088082902,9
0.05,1930,93,172404,89.28223718280684,9
0.05,1931,94,172498,89.28467908902691,8
0.05,1932,94,172592,89.2871184687015,7
0.05,1933,96,172688,89.29058945191314,6
0.05,1934,94,172782,89.29302325581395,7
0.05,1935,95,172877,89.29597107438016,6
0.05,1936,92,172969,89.29736706246773,9
0.05,1937,94,173063,89.29979360165119,7
0.05,1938,94,173157,89.30221763795771,7
0.05,1939,94,173251,89.30463917525773,7
0.05,1940,95,173346,89.30757341576506,6
0.05,1941,-48,173298,89.2368692070031,11
0.05,1942,95,173393,89.23983530622748,6
0.05,1943,94,173487,89.24228395061728,7
0.05,1944,92,173579,89.24370179948586,9
0.05,1945,95,173674,89.24665981500515,6
0.05,1946,94,173768,89.24910118130457,7
0.05,1947,95,173863,89.25205338809035,6
0.05,1948,95,173958,89.25500256541817,6
0.05,1949,95,174053,89.25794871794872,6
0.05,1950,92,174145,89.25935417734495,9
0.05,1951,96,174241,89.26280737704919,6
0.05,1952,94,174335,89.26523297491039,7
0.05,1953,23,174358,89.23132036847493,9
0.05,1954,96,174454,89.23478260869565,6
0.05,1955,92,174546,89.2361963190184,9
0.05,1956,94,174640,89.23863055697497,7
0.05,1957,94,174734,89.24106230847804,7
0.05,1958,94,174828,89.24349157733538,8
0.05,1959,93,174921,89.24540816326531,8
0.05,1960,94,175015,89.24783273839877,7
0.05,1961,94,175109,89.25025484199796,7
0.05,1962,96,175205,89.25369332654101,6
0.05,1963,93,175298,89.25560081466395,8
0.05,1964,94,175392,89.25801526717557,7
0.05,1965,93,175485,89.25991861648016,8
0.05,1966,94,175579,89.26232841891205,7
0.05,1967,95,175674,89.26524390243902,7
0.05,1968,92,175766,89.26663280853225,9
0.05,1969,88,175854,89.26598984771573,13
0.05,1970,95,175949,89.26889903602232,6
0.05,1971,94,176043,89.2712981744422,7
0.05,1972,96,176139,89.27470856563609,6
0.05,1973,27,176166,89.24316109422493,6
0.05,1974,96,176262,89.24658227848101,6
0.05,1975,94,176356,89.24898785425101,7
0.05,1976,93,176449,89.250885179565,8
0.05,1977,94,176543,89.25328614762387,7
0.05,1978,95,176638,89.25618999494694,6
0.05,1979,90,176728,89.25656565656566,13
0.05,1980,92,176820,89.25795053003533,9
0.05,1981,96,176916,89.26135216952574,6
0.05,1982,95,177011,89.26424609178014,6
0.05,1983,90,177101,89.26461693548387,11
0.05,1984,96,177197,89.26801007556675,6
0.05,1985,94,177291,89.2703927492447,7
0.05,1986,94,177385,89.2727730246603,7
0.05,1987,93,177478,89.27464788732394,8
0.05,1988,91,177569,89.27551533433886,10
0.05,1989,94,177663,89.27788944723618,7
0.05,1990,95,177758,89.28076343545956,6
0.05,1991,94,177852,89.28313253012048,7
0.05,1992,90,177942,89.28349222277973,11
0.05,1993,94,178036,89.28585757271816,8
0.05,1994,94,178130,89.28822055137844,7
0.05,1995,94,178224,89.29058116232466,7
0.05,1996,94,178318,89.29293940911367,7
0.05,1997,96,178414,89.29629629629629,6
0.05,1998,93,178507,89.29814907453726,8
0.05,1999,94,178601,89.3005,7
0.05,2000,94,178695,89.30284857571215,8
0.05,2001,95,178790,89.3056943056943,6
0.05,2002,94,178884,89.30803794308537,7
0.05,2003,93,178977,89.30988023952096,8
0.05,2004,92,179069,89.31122194513716,9
0.05,2005,96,179165,89.31455633100698,6
0.05,2006,93,179258,89.31639262580967,9
0.05,2007,96,179354,89.31972111553785,6
0.05,2008,86,179440,89.318068690891,15
0.05,2009,93,179533,89.31990049751244,8
0.05,2010,92,179625,89.32123321730482,9
0.05,2011,93,179718,89.32306163021869,8
0.05,2012,95,179813,89.32588176850471,6
0.05,2013,96,179909,89.3291956305859,6
0.05,2014,94,180003,89.33151364764268,7
0.05,2015,92,180095,89.3328373015873,9
0.05,2016,93,180188,89.33465542885473,8
0.05,2017,95,180283,89.3374628344896,6
0.05,2018,95,180378,89.34026745913819,6
0.05,2019,94,180472,89.34257425742574,7
0.05,2020,94,180566,89.34487877288471,7
0.05,2021,94,180660,89.34718100890208,7
0.05,2022,94,180754,89.34948096885813,7
0.05,2023,93,180847,89.35128458498023,8
0.05,2024,95,180942,89.35407407407408,6
0.05,2025,94,181036,89.35636722606121,8
0.05,2026,95,181131,89.35915145535274,6
0.05,2027,92,181223,89.36045364891518,9
0.05,2028,93,181316,89.36224741251849,9
0.05,2029,94,181410,89.36453201970443,7
0.05,2030,95,181505,89.36730674544559,6
0.05,2031,94,181599,89.36958661417323,8
0.05,2032,96,181695,89.37284800787015,6
0.05,2033,94,181789,89.37512291052114,7
0.05,2034,96,181885,89.37837837837837,6
0.05,2035,94,181979,89.38064833005893,7
0.05,2036,94,182073,89.38291605301914,7
0.05,2037,92,182165,89.38420019627085,10
0.05,2038,96,182261,89.38744482589505,6
0.05,2039,94,182355,89.38970588235294,7
0.05,2040,95,182450,89.39245467907888,6
0.05,2041,25,182475,89.36092066601371,7
0.05,2042,94,182569,89.36319138521782,7
0.05,2043,94,182663,89.36545988258317,7
0.05,2044,94,182757,89.36772616136919,8
0.05,2045,94,182851,89.36999022482894,8
0.05,2046,94,182945,89.37225207620908,7
0.05,2047,96,183041,89.37548828125,6
0.05,2048,94,183135,89.37774524158127,7
0.05,2049,93,183228,89.37951219512195,8
0.05,2050,95,183323,89.38225255972696,6
0.05,2051,94,183417,89.38450292397661,7
0.05,2052,94,183511,89.38675109595714,7
0.05,2053,93,183604,89.38851022395326,8
0.05,2054,94,183698,89.39075425790755,7
0.05,2055,94,183792,89.39299610894942,7
0.05,2056,94,183886,89.39523578026252,8
0.05,2057,91,183977,89.39601554907678,10
0.05,2058,96,184073,89.39922292374939,6
0.05,2059,96,184169,89.40242718446602,6
0.05,2060,94,184263,89.40465793304222,7
0.05,2061,93,184356,89.40640155189136,8
0.05,2062,96,184452,89.40959767329133,6
0.05,2063,95,184547,89.4123062015504,6
0.05,2064,94,184641,89.41452784503632,7
0.05,2065,91,184732,89.41529525653436,10
0.05,2066,94,184826,89.41751330430576,7
0.05,2067,94,184920,89.41972920696325,7
0.05,2068,94,185014,89.42194296761721,7
0.05,2069,93,185107,89.42367149758454,8
0.05,2070,91,185198,89.42443264123612,11
0.05,2071,96,185294,89.42760617760618,6
0.05,2072,87,185381,89.4264351181862,14
0.05,2073,93,185474,89.4281581485053,8
0.05,2074,93,185567,89.42987951807228,8
0.05,2075,94,185661,89.4320809248555,7
0.05,2076,94,185755,89.43428021184401,7
0.05,2077,94,185849,89.43647738209818,7
0.05,2078,96,185945,89.43963443963445,6
0.05,2079,23,185968,89.4076923076923,9
0.05,2080,95,186063,89.4103796251802,6
0.05,2081,94,186157,89.41258405379443,7
0.05,2082,92,186249,89.41382621219395,9
0.05,2083,92,186341,89.41506717850288,9
0.05,2084,94,186435,89.41726618705036,7
0.05,2085,93,186528,89.4189837008629,8
0.05,2086,95,186623,89.42165788212746,6
0.05,2087,96,186719,89.42480842911877,6
0.05,2088,92,186811,89.42604116802298,9
0.05,2089,94,186905,89.42822966507177,7
0.05,2090,94,186999,89.43041606886658,7
0.05,2091,92,187091,89.43164435946463,9
0.05,2092,90,187181,89.43191591017678,11
0.05,2093,91,187272,89.432664756447,10
0.05,2094,91,187363,89.43341288782817,10
0.05,2095,90,187453,89.43368320610686,11
0.05,2096,93,187546,89.43538388173582,8
0.05,2097,93,187639,89.43708293612964,8
0.05,2098,94,187733,89.43925678894712,7
0.05,2099,95,187828,89.44190476190477,7
0.05,2100,95,187923,89.44455021418372,6
0.05,2101,94,188017,89.44671741198859,8
0.05,2102,96,188113,89.44983357108892,6
0.05,2103,90,188203,89.45009505703422,11
0.05,2104,91,188294,89.45083135391924,10
0.05,2105,94,188388,89.45299145299145,7
0.05,2106,94,188482,89.45514950166113,7
0.05,2107,94,188576,89.4573055028463,7
0.05,2108,94,188670,89.45945945945945,8
0.05,2109,93,188763,89.46113744075829,8
0.05,2110,92,188855,89.46234012316438,9
0.05,2111,93,188948,89.46401515151516,8
0.05,2112,94,189042,89.46616185518221,7
0.05,2113,95,189137,89.46877956480606,8
0.05,2114,94,189231,89.47092198581561,7
0.05,2115,94,189325,89.47306238185256,7
0.05,2116,94,189419,89.47520075578649,7
0.05,2117,96,189515,89.47828139754485,6
0.05,2118,95,189610,89.48088721094857,6
0.05,2119,93,189703,89.48254716981133,8
0.05,2120,94,189797,89.48467703913248,7
0.05,2121,94,189891,89.48680490103676,7
0.05,2122,94,189985,89.48893075836081,7
0.05,2123,94,190079,89.49105461393597,7
0.05,2124,94,190173,89.49317647058824,7
0.05,2125,96,190269,89.49623706491063,6
0.05,2126,92,190361,89.4974141984015,9
0.05,2127,95,190456,89.5,6
0.05,2128,96,190552,89.50305307656177,6
0.05,2129,94,190646,89.50516431924882,7
0.05,2130,94,190740,89.50727358047865,7
0.05,2131,93,190833,89.50891181988743,8
0.05,2132,92,190925,89.51007969995312,11
0.05,2133,92,191017,89.5112464854733,9
0.05,2134,94,191111,89.51334894613584,7
0.05,2135,96,191207,89.51638576779027,6
0.05,2136,95,191302,89.51895180159102,6
0.05,2137,96,191398,89.52198316183349,6
0.05,2138,93,191491,89.52360916316036,8
0.05,2139,94,191585,89.52570093457943,8
0.05,2140,95,191680,89.52825782344699,6
0.05,2141,93,191773,89.52987861811391,8
0.05,2142,27,191800,89.50069995333645,6
0.05,2143,96,191896,89.50373134328358,6
0.05,2144,94,191990,89.50582750582751,7
0.05,2145,96,192086,89.50885368126747,6
0.05,2146,90,192176,89.5090824406148,11
0.05,2147,94,192270,89.51117318435755,7
0.05,2148,94,192364,89.51326198231736,7
0.05,2149,94,192458,89.5153488372093,7
0.05,2150,94,192552,89.51743375174337,7
0.05,2151,91,192643,89.51812267657992,10
0.05,2152,92,192735,89.51927542963307,9
0.05,2153,92,192827,89.52042711234911,9
0.05,2154,92,192919,89.5215777262181,10
0.05,2155,96,193015,89.52458256029685,6
0.05,2156,91,193106,89.52526657394529,10
0.05,2157,96,193202,89.52826691380908,6
0.05,2158,94,193296,89.53033811949977,7
0.05,2159,96,193392,89.53333333333333,6
0.05,2160,94,193486,89.53540027764923,7
0.05,2161,93,193579,89.53700277520814,9
0.05,2162,95,193674,89.53952843273231,7
0.05,2163,95,193769,89.5420517560074,6
0.05,2164,93,193862,89.54364896073903,8
0.05,2165,94,193956,89.54570637119113,7
0.05,2166,86,194042,89.54407014305491,15
0.05,2167,96,194138,89.54704797047971,6
0.05,2168,95,194233,89.54956201014292,6
0.05,2169,96,194329,89.55253456221199,6
0.05,2170,94,194423,89.5545831414095,7
0.05,2171,94,194517,89.55662983425414,7
0.05,2172,93,194610,89.55821445006903,9
0.05,2173,94,194704,89.5602575896964,7
0.05,2174,94,194798,89.5622988505747,7
0.05,2175,94,194892,89.56433823529412,7
0.05,2176,94,194986,89.56637574644006,7
0.05,2177,94,195080,89.5684113865932,8
0.05,2178,94,195174,89.5704451583295,8
0.05,2179,94,195268,89.57247706422018,7
0.05,2180,95,195363,89.57496561210453,7
0.05,2181,94,195457,89.57699358386802,7
0.05,2182,93,195550,89.57856161245992,8
0.05,2183,93,195643,89.5801282051282,8
0.05,2184,93,195736,89.5816933638444,8
0.05,2185,84,195820,89.57913998170174,17
0.05,2186,95,195915,89.58161865569274,6
0.05,2187,93,196008,89.58318098720292,8
0.05,2188,92,196100,89.58428506167199,9
0.05,2189,93,196193,89.58584474885845,9
0.05,2190,94,196287,89.58785942492013,7
0.05,2191,94,196381,89.58987226277372,7
0.05,2192,94,196475,89.59188326493388,7
0.05,2193,96,196571,89.59480401093893,6
0.05,2194,95,196666,89.59726651480638,6
0.05,2195,92,196758,89.59836065573771,9
0.05,2196,93,196851,89.59990896677287,8
0.05,2197,95,196946,89.60236578707917,6
0.05,2198,93,197039,89.60391086857662,8
0.05,2199,96,197135,89.60681818181818,6
0.05,2200,94,197229,89.60881417537483,8
0.05,2201,95,197324,89.61126248864669,6
0.05,2202,94,197418,89.61325465274625,7
0.05,2203,93,197511,89.61479128856624,8
0.05,2204,96,197607,89.61768707482993,6
0.05,2205,95,197702,89.62012692656391,6
0.05,2206,94,197796,89.62211146352514,7
0.05,2207,93,197889,89.62364130434783,8
0.05,2208,91,197980,89.62426437301947,10
0.05,2209,92,198072,89.62533936651583,9
0.05,2210,94,198166,89.62731795567616,8
0.05,2211,93,198259,89.62884267631102,8
0.05,2212,95,198354,89.63126976954361,6
0.05,2213,96,198450,89.63414634146342,6
0.05,2214,93,198543,89.63566591422122,8
0.05,2215,96,198639,89.63853790613719,6
0.05,2216,91,198730,89.63915200721696,10
0.05,2217,95,198825,89.64156898106403,6
0.05,2218,95,198920,89.64398377647589,7
0.05,2219,96,199016,89.64684684684684,6
0.05,2220,90,199106,89.64700585321927,11
0.05,2221,95,199201,89.64941494149414,7
0.05,2222,96,199297,89.65227170490328,6
0.05,2223,93,199390,89.65377697841727,8
0.05,2224,95,199485,89.6561797752809,7
0.05,2225,94,199579,89.6581311769991,7
0.05,2226,94,199673,89.66008082622362,7
0.05,2227,96,199769,89.6629263913824,6
0.05,2228,94,199863,89.66487213997308,7
0.05,2229,96,199959,89.6677130044843,6
0.05,2230,93,200052,89.6692066337965,8
0.05,2231,93,200145,89.67069892473118,8
0.05,2232,96,200241,89.67353336318854,6
0.05,2233,93,200334,89.6750223813787,10
0.05,2234,92,200426,89.67606263982103,10
0.05,2235,95,200521,89.67844364937388,6
0.05,2236,92,200613,89.67948144836835,9
0.05,2237,94,200707,89.68141197497766,7
0.05,2238,93,200800,89.68289414917373,8
0.05,2239,95,200895,89.68526785714286,7
0.05,2240,89,200984,89.68496207050424,12
0.05,2241,91,201075,89.68554861730598,10
0.05,2242,92,201167,89.68658047258137,9
0.05,2243,95,201262,89.68894830659536,6
0.05,2244,91,201353,89.68953229398663,10
0.05,2245,93,201446,89.69100623330365,8
0.05,2246,93,201539,89.69247886070316,8
0.05,2247,96,201635,89.6952846975089,6
0.05,2248,93,201728,89.69675411293909,8
0.05,2249,92,201820,89.69777777777777,9
0.05,2250,94,201914,89.69968902709907,9
0.05,2251,94,202008,89.70159857904085,7
0.05,2252,92,202100,89.70261873058145,9
0.05,2253,93,202193,89.70408163265306,8
0.05,2254,92,202285,89.70509977827051,9
0.05,2255,94,202379,89.70700354609929,7
0.05,2256,94,202473,89.70890562693842,7
0.05,2257,93,202566,89.71036315323295,8
0.05,2258,96,202662,89.71314741035856,6
0.05,2259,94,202756,89.71504424778762,8
0.05,2260,94,202850,89.71693940734188,7
0.05,2261,92,202942,89.71794871794872,9
0.05,2262,93,203035,89.71939902783915,8
0.05,2263,92,203127,89.72040636042402,9
0.05,2264,96,203223,89.72317880794702,6
0.05,2265,96,203319,89.72594880847308,6
0.05,2266,95,203414,89.72827525363917,6
0.05,2267,94,203508,89.73015873015873,7
0.05,2268,25,203533,89.70163067430586,7
0.05,2269,92,203625,89.70264317180617,9
0.05,2270,94,203719,89.70453544693967,7
0.05,2271,94,203813,89.70642605633803,7
0.05,2272,96,203909,89.7091948966124,6
0.05,2273,94,204003,89.71108179419525,7
0.05,2274,96,204099,89.71384615384615,6
0.05,2275,94,204193,89.71572934973638,8
0.05,2276,95,204288,89.71805006587616,6
0.05,2277,94,204382,89.71992976294996,7
0.05,2278,95,204477,89.7222465993857,6
0.05,2279,96,204573,89.725,6
0.05,2280,93,204666,89.72643577378342,8
0.05,2281,94,204760,89.72830850131464,7
0.05,2282,94,204854,89.73017958826107,7
0.05,2283,93,204947,89.7316112084063,8
0.05,2284,94,205041,89.73347921225383,7
0.05,2285,93,205134,89.73490813648294,8
0.05,2286,91,205225,89.73546130301705,10
0.05,2287,94,205319,89.73732517482517,8
0.05,2288,87,205406,89.73612931411097,14
0.05,2289,91,205497,89.73668122270742,10
0.05,2290,94,205591,89.7385421213444,7
0.05,2291,93,205684,89.73996509598604,8
0.05,2292,91,205775,89.74051460968164,10
0.05,2293,93,205868,89.74193548387096,8
0.05,2294,95,205963,89.7442265795207,6
0.05,2295,93,206056,89.74564459930313,8
0.05,2296,93,206149,89.74706138441445,8
0.05,2297,95,206244,89.74934725848564,6
0.05,2298,92,206336,89.75032622879513,9
0.05,2299,93,206429,89.75173913043479,8
0.05,2300,94,206523,89.7535853976532,7
0.05,2301,93,206616,89.75499565595135,8
0.05,2302,94,206710,89.75683890577507,8
0.05,2303,96,206806,89.75954861111111,6
0.05,2304,94,206900,89.76138828633405,8
0.05,2305,95,206995,89.76366001734606,6
0.05,2306,93,207088,89.76506285218899,8
0.05,2307,95,207183,89.76733102253033,6
0.05,2308,94,207277,89.76916414032048,7
0.05,2309,94,207371,89.77099567099567,7
0.05,2310,95,207466,89.7732583297274,6
0.05,2311,95,207561,89.77551903114187,6
0.05,2312,94,207655,89.77734543882404,7
0.05,2313,94,207749,89.77917026793432,7
0.05,2314,91,207840,89.77969762419006,10
0.05,2315,89,207929,89.7793609671848,12
0.05,2316,95,208024,89.78161415623651,6
0.05,2317,93,208117,89.78300258843831,8
0.05,2318,94,208211,89.78482104355325,7
0.05,2319,95,208306,89.78706896551724,7
0.05,2320,95,208401,89.7893149504524,6
0.05,2321,95,208496,89.79155900086133,6
0.05,2322,94,208590,89.79337064141197,7
0.05,2323,96,208686,89.7960413080895,6
0.05,2324,95,208781,89.79827956989247,6
0.05,2325,93,208874,89.79965606190886,8
0.05,2326,95,208969,89.80189084658359,7
0.05,2327,93,209062,89.80326460481099,9
0.05,2328,93,209155,89.80463718334049,9
0.05,2329,94,209249,89.80643776824034,7
0.05,2330,94,209343,89.80823680823681,8
0.05,2331,94,209437,89.81003430531733,7
0.05,2332,94,209531,89.81183026146593,7
0.05,2333,96,209627,89.81448157669237,6
0.05,2334,96,209723,89.81713062098501,6
0.05,2335,96,209819,89.81977739726027,6
0.05,2336,91,209910,89.82028241335045,10
0.05,2337,95,210005,89.82249786142002,8
0.05,2338,94,210099,89.82428388200086,7
0.05,2339,94,210193,89.82606837606838,7
0.05,2340,93,210286,89.82742417770184,8
0.05,2341,94,210380,89.82920580700257,7
0.05,2342,92,210472,89.83013230900555,9
0.05,2343,91,210563,89.83063139931741,10
0.05,2344,96,210659,89.83326226012794,6
0.05,2345,94,210753,89.83503836317135,7
0.05,2346,95,210848,89.83723902854707,7
0.05,2347,94,210942,89.83901192504258,7
0.05,2348,95,211037,89.84120902511707,6
0.05,2349,90,211127,89.84127659574469,11
0.05,2350,92,211219,89.84219481071884,9
0.05,2351,95,211314,89.84438775510205,7
0.05,2352,94,211408,89.84615384615384,7
0.05,2353,92,211500,89.84706881903143,9
0.05,2354,94,211594,89.8488322717622,7
0.05,2355,95,211689,89.85101867572156,6
0.05,2356,95,211784,89.85320322443785,6
0.05,2357,91,211875,89.85368956743002,10
0.05,2358,93,211968,89.85502331496397,8
0.05,2359,92,212060,89.85593220338983,10
0.05,2360,89,212149,89.85556967386701,12
0.05,2361,96,212245,89.85817104149027,6
0.05,2362,95,212340,89.86034701650445,6
0.05,2363,88,212428,89.8595600676819,15
0.05,2364,94,212522,89.86131078224102,7
0.05,2365,95,212617,89.86348267117498,6
0.05,2366,91,212708,89.86396282213772,10
0.05,2367,92,212800,89.86486486486487,9
0.05,2368,95,212895,89.86703250316589,6
0.05,2369,92,212987,89.86793248945148,9
0.05,2370,95,213082,89.87009700548292,6
0.05,2371,95,213177,89.87225969645868,8
0.05,2372,92,213269,89.8731563421829,9
0.05,2373,94,213363,89.87489469250211,7
0.05,2374,95,213458,89.87705263157895,6
0.05,2375,94,213552,89.87878787878788,7
0.05,2376,92,213644,89.87968026924695,9
0.05,2377,93,213737,89.88099243061396,8
0.05,2378,94,213831,89.88272383354351,8
0.05,2379,93,213924,89.88403361344538,9
0.05,2380,27,213951,89.85762284754306,6
0.05,2381,96,214047,89.860201511335,6
0.05,2382,93,214140,89.86151909357952,8
0.05,2383,95,214235,89.8636744966443,6
0.05,2384,27,214262,89.83731656184486,6
0.05,2385,94,214356,89.83906119027661,7
0.05,2386,96,214452,89.841642228739,6
0.05,2387,95,214547,89.84380234505862,6
0.05,2388,91,214638,89.84428631226454,10
0.05,2389,94,214732,89.8460251046025,7
0.05,2390,94,214826,89.84776244249268,7
0.05,2391,93,214919,89.84908026755853,8
0.05,2392,96,215015,89.85165064772252,6
0.05,2393,95,215110,89.85380116959064,6
0.05,2394,95,215205,89.85594989561586,6
0.05,2395,94,215299,89.8576794657763,7
0.05,2396,93,215392,89.85899040467251,8
0.05,2397,95,215487,89.86113427856547,6
0.05,2398,94,215581,89.862859524802,7
0.05,2399,94,215675,89.86458333333333,7
0.05,2400,94,215769,89.86630570595585,7
0.05,2401,94,215863,89.86802664446294,7
0.05,2402,91,215954,89.86849771119434,10
0.05,2403,94,216048,89.87021630615641,7
0.05,2404,95,216143,89.87234927234927,6
0.05,2405,94,216237,89.87406483790524,7
0.05,2406,94,216331,89.87577897798089,7
0.05,2407,92,216423,89.8766611295681,9
0.05,2408,93,216516,89.87795765877958,8
0.05,2409,92,216608,89.87883817427385,9
0.05,2410,95,216703,89.88096225632518,8
0.05,2411,90,216793,89.88101160862355,11
0.05,2412,94,216887,89.88271860754247,7
0.05,2413,93,216980,89.88400994200497,8
0.05,2414,94,217074,89.88571428571429,7
0.05,2415,94,217168,89.88741721854305,7
0.05,2416,94,217262,89.88911874224245,8
0.05,2417,96,217358,89.89164598842018,6
0.05,2418,96,217454,89.89417114510128,6
0.05,2419,94,217548,89.89586776859504,7
0.05,2420,94,217642,89.8975629904998,7
0.05,2421,94,217736,89.89925681255161,7
0.05,2422,95,217831,89.90136194799835,6
0.05,2423,95,217926,89.90346534653466,6
0.05,2424,93,218019,89.90474226804123,8
0.05,2425,93,218112,89.90601813685079,8
0.05,2426,93,218205,89.90729295426452,8
0.05,2427,27,218232,89.88138385502471,6
0.05,2428,94,218326,89.88307945656649,7
0.05,2429,95,218421,89.88518518518518,8
0.05,2430,95,218516,89.88728918140683,7
0.05,2431,95,218611,89.88939144736842,6
0.05,2432,95,218706,89.89149198520346,6
0.05,2433,94,218800,89.89317995069844,7
0.05,2434,94,218894,89.89486652977413,7
0.05,2435,90,218984,89.89490968801313,11
0.05,2436,95,219079,89.89700451374641,7
0.05,2437,89,219168,89.8966365873667,12
0.05,2438,92,219260,89.89749897498974,9
0.05,2439,96,219356,89.9,6
0.05,2440,95,219451,89.90208930766079,6
0.05,2441,94,219545,89.9037674037674,7
0.05,2442,26,219571,89.87760949652068,7
0.05,2443,94,219665,89.87929623567922,7
0.05,2444,94,219759,89.88098159509202,7
0.05,2445,96,219855,89.88348323793949,6
0.05,2446,93,219948,89.88475684511647,8
0.05,2447,91,220039,89.88521241830065,11
0.05,2448,89,220128,89.88485095957533,12
0.05,2449,94,220222,89.8865306122449,7
0.05,2450,94,220316,89.88820889432884,8
0.05,2451,95,220411,89.89029363784665,6
0.05,2452,94,220505,89.89196901752956,8
0.05,2453,96,220601,89.89445802770986,6
0.05,2454,91,220692,89.8949083503055,12
0.05,2455,94,220786,89.89657980456026,8
0.05,2456,95,220881,89.8986568986569,6
0.05,2457,95,220976,89.90073230268511,6
0.05,2458,94,221070,89.902399349329,7
0.05,2459,94,221164,89.90406504065041,7
0.05,2460,93,221257,89.90532303941487,8
0.05,2461,94,221351,89.90698619008936,7
0.05,2462,95,221446,89.90905399918798,6
0.05,2463,94,221540,89.91071428571429,8
0.05,2464,94,221634,89.91237322515212,7
0.05,2465,94,221728,89.91403081914031,8
0.05,2466,95,221823,89.91609241994325,6
0.05,2467,96,221919,89.91855753646678,6
0.05,2468,91,222010,89.91899554475496,10
0.05,2469,96,222106,89.92145748987855,6
0.05,2470,95,222201,89.92351274787535,7
0.05,2471,92,222293,89.92435275080906,9
0.05,2472,91,222384,89.92478770723817,10
0.05,2473,94,222478,89.9264349232013,7
0.05,2474,90,222568,89.92646464646465,11
0.05,2475,90,222658,89.92649434571891,12
0.05,2476,91,222749,89.9269277351635,10
0.05,2477,92,222841,89.92776432606941,9
0.05,2478,92,222933,89.92860024203308,9
0.05,2479,94,223027,89.93024193548388,7
0.05,2480,94,223121,89.93188230552197,7
0.05,2481,91,223212,89.93231265108783,13
0.05,2482,94,223306,89.93395086588804,7
0.05,2483,92,223398,89.93478260869566,9
0.05,2484,89,223487,89.9344064386318,13
0.05,2485,94,223581,89.93604183427192,8
0.05,2486,94,223675,89.93767591475674,7
0.05,2487,95,223770,89.93971061093248,6
0.05,2488,95,223865,89.94174367215749,6
0.05,2489,95,223960,89.94377510040161,6
0.05,2490,95,224055,89.94580489763148,6
0.05,2491,92,224147,89.94662921348315,9
0.05,2492,93,224240,89.9478539911753,8
0.05,2493,96,224336,89.95028067361667,6
0.05,2494,94,224430,89.95190380761522,7
0.05,2495,93,224523,89.953125,8
0.05,2496,91,224614,89.95354425310373,10
0.05,2497,96,224710,89.95596477181745,6
0.05,2498,96,224806,89.95838335334133,6
0.05,2499,91,224897,89.9588,10
0.05,2500,94,224991,89.96041583366653,7
0.05,2501,93,225084,89.96163069544365,8
0.05,2502,96,225180,89.96404314822213,6
0.05,2503,93,225273,89.96525559105432,8
0.05,2504,91,225364,89.96566866267464,10
0.05,2505,92,225456,89.96648044692738,10
0.05,2506,26,225482,89.94096529716793,6
0.05,2507,26,225508,89.91547049441786,7
0.05,2508,94,225602,89.91709844559585,7
0.05,2509,94,225696,89.91872509960159,9
0.05,2510,95,225791,89.92074870569495,6
0.05,2511,94,225885,89.92237261146497,9
0.05,2512,95,225980,89.92439315559093,6
0.05,2513,96,226076,89.92680986475736,6
0.05,2514,92,226168,89.92763419483101,9
0.05,2515,94,226262,89.92925278219396,7
0.05,2516,88,226350,89.92848629320619,13
0.05,2517,93,226443,89.92970611596505,8
0.05,2518,95,226538,89.93171893608574,6
0.05,2519,25,226563,89.90595238095239,7
0.05,2520,91,226654,89.90638635462118,10
0.05,2521,93,226747,89.90761300555116,8
0.05,2522,93,226840,89.90883868410623,8
0.05,2523,96,226936,89.91125198098257,6
0.05,2524,95,227031,89.91326732673268,6
0.05,2525,95,227126,89.91528107680126,6
0.05,2526,95,227221,89.9172932330827,6
0.05,2527,93,227314,89.91851265822785,8
0.05,2528,94,227408,89.92012653222618,7
0.05,2529,94,227502,89.92173913043479,7
0.05,2530,92,227594,89.92256025286449,9
0.05,2531,95,227689,89.92456556082149,7
0.05,2532,92,227781,89.92538491906829,9
0.05,2533,94,227875,89.92699289660615,7
0.05,2534,96,227971,89.92938856015779,6
0.05,2535,93,228064,89.93059936908517,8
0.05,2536,92,228156,89.93141505715411,9
0.05,2537,94,228250,89.93301812450748,7
0.05,2538,96,228346,89.93540764080346,6
0.05,2539,91,228437,89.93582677165354,10
0.05,2540,96,228533,89.93821330184967,6
0.05,2541,95,228628,89.94020456333595,6
0.05,2542,90,228718,89.94022807707432,11
0.05,2543,94,228812,89.94182389937107,7
0.05,2544,95,228907,89.94381139489194,6
0.05,2545,94,229001,89.94540455616654,7
0.05,2546,94,229095,89.9469964664311,7
0.05,2547,93,229188,89.94819466248038,10
0.05,2548,94,229282,89.94978422910945,7
0.05,2549,95,229377,89.95176470588235,8
0.05,2550,95,229472,89.95374362994905,6
0.05,2551,95,229567,89.9557210031348,6
0.05,2552,94,229661,89.95730513121818,7
0.05,2553,27,229688,89.93265465935787,6
0.05,2554,95,229783,89.93463796477495,6
0.05,2555,94,229877,89.93622848200313,8
0.05,2556,96,229973,89.93859992178334,6
0.05,2557,92,230065,89.93940578577013,9
0.05,2558,94,230159,89.9409925752247,7
0.05,2559,96,230255,89.943359375,6
0.05,2560,94,230349,89.94494338149161,7
0.05,2561,94,230443,89.94652615144419,8
0.05,2562,95,230538,89.94849785407726,6
0.05,2563,94,230632,89.95007800312013,8
0.05,2564,94,230726,89.95165692007797,7
0.05,2565,96,230822,89.95401402961808,6
0.05,2566,92,230914,89.95481106349824,9
0.05,2567,93,231007,89.9559968847352,8
0.05,2568,90,231097,89.95601401323472,11
0.05,2569,94,231191,89.95758754863813,7
0.05,2570,94,231285,89.95915985997667,8
0.05,2571,95,231380,89.96111975116641,8
0.05,2572,96,231476,89.96346677030704,6
0.05,2573,94,231570,89.96503496503496,7
0.05,2574,94,231664,89.96660194174757,7
0.05,2575,95,231759,89.96855590062111,6
0.05,2576,94,231853,89.97012029491657,7
0.05,2577,92,231945,89.97090768037238,9
0.05,2578,90,232035,89.97091896083754,11
0.05,2579,96,232131,89.97325581395349,6
0.05,2580,95,232226,89.97520340953119,6
0.05,2581,93,232319,89.97637490317584,10
0.05,2582,92,232411,89.97715834301201,9
0.05,2583,88,232499,89.97639318885449,13
0.05,2584,94,232593,89.9779497098646,7
0.05,2585,93,232686,89.97911832946636,8
0.05,2586,94,232780,89.98067259373792,7
0.05,2587,95,232875,89.98261205564143,6
0.05,2588,90,232965,89.98261877172654,11
0.05,2589,95,233060,89.98455598455598,6
0.05,2590,90,233150,89.98456194519491,11
0.05,2591,95,233245,89.98649691358025,6
0.05,2592,94,233339,89.98804473582723,7
0.05,2593,92,233431,89.98882035466461,9
0.05,2594,93,233524,89.98998073217726,8
0.05,2595,91,233615,89.99036979969183,10
0.05,2596,94,233709,89.99191374663073,7
0.05,2597,92,233801,89.99268668206312,10
0.05,2598,96,233897,89.99499807618315,6
0.05,2599,96,233993,89.99730769230769,6
0.05,2600,95,234088,89.999231064975,6
0.05,2601,96,234184,90.00153727901615,6
0.05,2602,92,234276,90.00230503265463,9
0.05,2603,93,234369,90.00345622119816,8
0.05,2604,89,234458,90.00307101727448,12
0.05,2605,90,234548,90.00306983883345,11
0.05,2606,95,234643,90.00498657460683,6
0.05,2607,94,234737,90.00651840490798,7
0.05,2608,96,234833,90.00881563817555,6
0.05,2609,94,234927,90.01034482758621,8
0.05,2610,95,235022,90.01225584067407,6
0.05,2611,94,235116,90.01378254211332,7
0.05,2612,92,235208,90.0145426712591,9
0.05,2613,92,235300,90.01530221882173,9
0.05,2614,96,235396,90.01759082217973,6
0.05,2615,94,235490,90.0191131498471,8
0.05,2616,93,235583,90.02025219717234,8
0.05,2617,95,235678,90.02215431627197,6
0.05,2618,94,235772,90.02367315769378,7
0.05,2619,95,235867,90.02557251908397,6
0.05,2620,94,235961,90.02708889736742,7
0.05,2621,94,236055,90.02860411899313,7
0.05,2622,92,236147,90.02935569958063,10
0.05,2623,93,236240,90.03048780487805,8
0.05,2624,93,236333,90.03161904761905,8
0.05,2625,87,236420,90.03046458492003,14
0.05,2626,94,236514,90.03197563760943,7
0.05,2627,96,236610,90.03424657534246,6
0.05,2628,95,236705,90.03613541270445,6
0.05,2629,96,236801,90.03840304182509,6
0.05,2630,93,236894,90.03952869631318,8
0.05,2631,94,236988,90.04103343465046,7
0.05,2632,92,237080,90.0417774401823,9
0.05,2633,94,237174,90.04328018223235,7
0.05,2634,95,237269,90.04516129032258,6
0.05,2635,93,237362,90.04628224582702,8
0.05,2636,93,237455,90.04740235115662,8
0.05,2637,94,237549,90.0489006823351,7
0.05,2638,95,237644,90.0507768093975,6
0.05,2639,94,237738,90.05227272727272,7
0.05,2640,94,237832,90.05376751230594,7
0.05,2641,94,237926,90.05526116578349,7
0.05,2642,91,238017,90.05561861521,10
0.05,2643,88,238105,90.05484114977307,15
0.05,2644,93,238198,90.05595463137996,8
0.05,2645,18,238216,90.02872260015117,14
0.05,2646,94,238310,90.03022289384208,8
0.05,2647,94,238404,90.03172205438067,9
0.05,2648,96,238500,90.03397508493771,6
0.05,2649,96,238596,90.03622641509433,6
0.05,2650,93,238689,90.03734439834025,8
0.05,2651,96,238785,90.039592760181,6
0.05,2652,93,238878,90.04070863173766,8
0.05,2653,91,238969,90.04107008289374,11
0.05,2654,93,239062,90.0421845574388,8
0.05,2655,94,239156,90.04367469879519,7
0.05,2656,94,239250,90.04516371847949,7
0.05,2657,92,239342,90.04589917231,9
0.05,2658,92,239434,90.04663407295976,9
0.05,2659,94,239528,90.04812030075188,7
0.05,2660,93,239621,90.04922961292748,8
0.05,2661,85,239706,90.0473328324568,16
0.05,2662,94,239800,90.04881712354488,8
0.05,2663,94,239894,90.05030030030031,8
0.05,2664,94,239988,90.05178236397748,7
0.05,2665,93,240081,90.05288822205551,8
0.05,2666,95,240176,90.05474315710536,7
0.05,2667,94,240270,90.05622188905548,7
0.05,2668,94,240364,90.05769951292619,7
0.05,2669,94,240458,90.05917602996254,7
0.05,2670,94,240552,90.06065144140771,7
0.05,2671,94,240646,90.062125748503,7
0.05,2672,95,240741,90.06397306397307,6
0.05,2673,94,240835,90.06544502617801,7
0.05,2674,96,240931,90.06766355140186,6
0.05,2675,95,241026,90.0695067264574,6
0.05,2676,92,241118,90.07022786701532,9
0.05,2677,93,241211,90.0713218820015,8
0.05,2678,94,241305,90.07278835386339,7
0.05,2679,92,241397,90.07350746268656,9
0.05,2680,93,241490,90.07459903021261,8
0.05,2681,93,241583,90.07568978374347,8
0.05,2682,93,241676,90.07677972418934,8
0.05,2683,94,241770,90.07824143070044,7
0.05,2684,91,241861,90.07858472998137,10
0.05,2685,93,241954,90.07967237527923,8
0.05,2686,93,242047,90.080759211016,8
0.05,2687,91,242138,90.08110119047619,10
0.05,2688,92,242230,90.08181480104128,9
0.05,2689,94,242324,90.08327137546469,7
0.05,2690,94,242418,90.08472686733556,7
0.05,2691,90,242508,90.08469539375929,12
0.05,2692,96,242604,90.08689194207204,6
0.05,2693,96,242700,90.0890868596882,6
0.05,2694,27,242727,90.06567717996289,6
0.05,2695,96,242823,90.06787833827893,6
0.05,2696,94,242917,90.06933629959214,7
0.05,2697,94,243011,90.07079318013344,7
0.05,2698,95,243106,90.07261948869952,7
0.05,2699,95,243201,90.07444444444444,6
0.05,2700,95,243296,90.07626804887079,6
0.05,2701,92,243388,90.07698001480385,9
0.05,2702,96,243484,90.07917129115798,6
0.05,2703,93,243577,90.08025147928994,8
0.05,2704,92,243669,90.08096118299446,9
0.05,2705,95,243764,90.08277900960827,6
0.05,2706,94,243858,90.08422608053195,7
0.05,2707,94,243952,90.08567208271788,8
0.05,2708,91,244043,90.0860095976375,10
0.05,2709,93,244136,90.08708487084871,8
0.05,2710,26,244162,90.06344522316489,7
0.05,2711,93,244255,90.06452802359883,8
0.05,2712,94,244349,90.06597862145227,7
0.05,2713,96,244445,90.06816507000737,6
0.05,2714,95,244540,90.06998158379373,6
0.05,2715,94,244634,90.07142857142857,7
0.05,2716,94,244728,90.07287449392713,7
0.05,2717,92,244820,90.07358351729212,10
0.05,2718,90,244910,90.07355645457889,11
0.05,2719,92,245002,90.07426470588236,9
0.05,2720,94,245096,90.07570746049247,7
0.05,2721,92,245188,90.07641440117561,9
0.05,2722,95,245283,90.07822254865957,6
0.05,2723,94,245377,90.07966226138032,7
0.05,2724,94,245471,90.08110091743119,7
0.05,2725,95,245566,90.08290535583272,7
0.05,2726,96,245662,90.08507517418408,6
0.05,2727,95,245757,90.08687683284458,7
0.05,2728,96,245853,90.08904360571638,6
0.05,2729,96,245949,90.09120879120879,6
0.05,2730,94,246043,90.0926400585866,8
0.05,2731,95,246138,90.09443631039531,6
0.05,2732,93,246231,90.09549945115258,8
0.05,2733,95,246326,90.09729334308705,8
0.05,2734,94,246420,90.09872029250457,7
0.05,2735,94,246514,90.10014619883042,7
0.05,2736,92,246606,90.10084033613445,9
0.05,2737,94,246700,90.10226442658875,7
0.05,2738,93,246793,90.10332238043081,8
0.05,2739,95,246888,90.10510948905109,8
0.05,2740,95,246983,90.10689529368844,6
0.05,2741,93,247076,90.10795040116703,8
0.05,2742,95,247171,90.1097338680277,6
0.05,2743,92,247263,90.11042274052478,9
0.05,2744,95,247358,90.11220400728597,8
0.05,2745,94,247452,90.11361981063365,8
0.05,2746,94,247546,90.11503458318165,7
0.05,2747,92,247638,90.11572052401746,9
0.05,2748,93,247731,90.1167697344489,10
0.05,2749,94,247825,90.11818181818182,7
0.05,2750,94,247919,90.11959287531806,8
0.05,2751,90,248009,90.11954941860465,11
0.05,2752,95,248104,90.12132219397022,6
0.05,2753,95,248199,90.12309368191721,6
0.05,2754,92,248291,90.12377495462795,9
0.05,2755,96,248387,90.12590711175616,6
0.05,2756,93,248480,90.12694958287994,8
0.05,2757,93,248573,90.12799129804206,8
0.05,2758,93,248666,90.12903225806451,8
0.05,2759,96,248762,90.13115942028986,6
0.05,2760,92,248854,90.13183629119884,9
0.05,2761,20,248874,90.10644460535843,12
0.05,2762,93,248967,90.10749185667753,8
0.05,2763,90,249057,90.1074529667149,11
0.05,2764,94,249151,90.10886075949367,7
0.05,2765,96,249247,90.11099060014462,6
0.05,2766,95,249342,90.11275749909649,6
0.05,2767,94,249436,90.11416184971098,7
0.05,2768,96,249532,90.11628746840015,6
0.05,2769,91,249623,90.11660649819494,10
0.05,2770,95,249718,90.1183688199206,6
0.05,2771,24,249742,90.09451659451659,9
0.05,2772,94,249836,90.0959249909845,7
0.05,2773,94,249930,90.09733237202596,7
0.05,2774,94,250024,90.09873873873875,8
0.05,2775,93,250117,90.09978386167147,8
0.05,2776,92,250209,90.1004681310767,9
0.05,2777,92,250301,90.10115190784737,9
0.05,2778,96,250397,90.10327455919395,6
0.05,2779,93,250490,90.10431654676259,8
0.05,2780,94,250584,90.10571736785329,7
0.05,2781,94,250678,90.10711718188354,7
0.05,2782,96,250774,90.1092346388789,6
0.05,2783,91,250865,90.10955459770115,10
0.05,2784,96,250961,90.1116696588869,6
0.05,2785,94,251055,90.11306532663316,7
0.05,2786,94,251149,90.11445999282383,7
0.05,2787,96,251245,90.11657101865136,6
0.05,2788,95,251340,90.11832197920401,6
0.05,2789,89,251429,90.1179211469534,12
0.05,2790,94,251523,90.11931207452525,8
0.05,2791,96,251619,90.12141833810888,6
0.05,2792,93,251712,90.12244897959184,8
0.05,2793,94,251806,90.12383679312813,7
0.05,2794,91,251897,90.12415026833631,10
0.05,2795,96,251993,90.12625178826896,6
0.05,2796,94,252087,90.12763675366465,7
0.05,2797,94,252181,90.1290207290922,8
0.05,2798,94,252275,90.13040371561272,7
0.05,2799,92,252367,90.13107142857143,9
0.05,2800,92,252459,90.13173866476258,9
0.05,2801,92,252551,90.13240542469664,9
0.05,2802,94,252645,90.13378523011059,7
0.05,2803,91,252736,90.13409415121255,10
0.05,2804,95,252831,90.13582887700535,6
0.05,2805,93,252924,90.1368496079829,8
0.05,2806,90,253014,90.13680085500535,11
0.05,2807,93,253107,90.13782051282051,8
0.05,2808,91,253198,90.1381274474902,10
0.05,2809,94,253292,90.13950177935943,8
0.05,2810,94,253386,90.14087513340448,7
0.05,2811,94,253480,90.14224751066857,7
0.05,2812,91,253571,90.14255243512264,10
0.05,2813,95,253666,90.14427860696517,6
0.05,2814,92,253758,90.1449378330373,9
0.05,2815,95,253853,90.14666193181819,7
0.05,2816,93,253946,90.1476748313809,10
0.05,2817,95,254041,90.14939673527324,6
0.05,2818,94,254135,90.15076268180206,8
0.05,2819,95,254230,90.15248226950355,6
0.05,2820,96,254326,90.15455512229705,6
0.05,2821,92,254418,90.15520907158044,9
0.05,2822,93,254511,90.15621679064824,8
0.05,2823,95,254606,90.15793201133144,8
0.05,2824,92,254698,90.15858407079646,11
0.05,2825,96,254794,90.16065109695683,6
0.05,2826,94,254888,90.16200919702865,7
0.05,2827,95,254983,90.16371994342292,6
0.05,2828,93,255076,90.16472251679039,8
0.05,2829,91,255167,90.16501766784452,10
0.05,2830,94,255261,90.16637230660544,7
0.05,2831,96,255357,90.16843220338983,6
0.05,2832,95,255452,90.1701376632545,6
0.05,2833,94,255546,90.17148906139732,7
0.05,2834,95,255641,90.1731922398589,8
0.05,2835,93,255734,90.17418899858956,8
0.05,2836,95,255829,90.17589002467395,7
0.05,2837,93,255922,90.1768851303735,10
0.05,2838,27,255949,90.1546319126453,6
0.05,2839,94,256043,90.15598591549296,7
0.05,2840,96,256139,90.15804294262584,6
0.05,2841,94,256233,90.15939479239972,7
0.05,2842,96,256329,90.16144917340837,6
0.05,2843,94,256423,90.16279887482419,7
0.05,2844,93,256516,90.16379613356766,8
0.05,2845,92,256608,90.1644413211525,9
0.05,2846,83,256691,90.16192483315771,19
0.05,2847,95,256786,90.16362359550561,6
0.05,2848,94,256880,90.16497016497017,7
0.05,2849,90,256970,90.16491228070176,11
0.05,2850,92,257062,90.16555594528236,9
0.05,2851,90,257152,90.16549789621318,11
0.05,2852,93,257245,90.1664914125482,8
0.05,2853,93,257338,90.16748423265592,8
0.05,2854,85,257423,90.16567425569177,17
0.05,2855,95,257518,90.16736694677871,6
0.05,2856,96,257614,90.16940847042352,6
0.05,2857,92,257706,90.1700489853044,9
0.05,2858,94,257800,90.17138859741168,7
0.05,2859,95,257895,90.17307692307692,6
0.05,2860,93,257988,90.17406501223348,8
0.05,2861,94,258082,90.17540181691125,7
0.05,2862,95,258177,90.177086971708,6
0.05,2863,94,258271,90.1784217877095,8
0.05,2864,94,258365,90.17975567190227,7
0.05,2865,95,258460,90.18143754361479,6
0.05,2866,92,258552,90.18207185211023,9
0.05,2867,92,258644,90.18270571827057,9
0.05,2868,94,258738,90.18403624956431,7
0.05,2869,92,258830,90.18466898954703,9
0.05,2870,96,258926,90.18669453152212,6
0.05,2871,95,259021,90.1883704735376,6
0.05,2872,94,259115,90.1896971806474,7
0.05,2873,94,259209,90.1910229645094,7
0.05,2874,96,259305,90.19304347826088,6
0.05,2875,94,259399,90.19436717663422,7
0.05,2876,94,259493,90.19568995481404,7
0.05,2877,95,259588,90.19735927727588,7
0.05,2878,96,259684,90.19937478291074,6
0.05,2879,96,259780,90.20138888888889,6
0.05,2880,24,259804,90.17841027421035,9
0.05,2881,95,259899,90.18008327550312,7
0.05,2882,93,259992,90.18106139438085,8
0.05,2883,94,260086,90.18238557558946,7
0.05,2884,92,260178,90.18301559792027,9
0.05,2885,94,260272,90.18433818433819,7
0.05,2886,95,260367,90.18600623484586,7
0.05,2887,92,260459,90.18663434903047,9
0.05,2888,92,260551,90.18726202838353,9
0.05,2889,95,260646,90.18892733564014,7
0.05,2890,23,260669,90.16568661362851,10
0.05,2891,94,260763,90.16701244813278,8
0.05,2892,94,260857,90.168337366056,7
0.05,2893,96,260953,90.17035245335177,6
0.05,2894,96,261049,90.17236614853195,6
0.05,2895,92,261141,90.17299723756906,9
0.05,2896,94,261235,90.17431826026925,7
0.05,2897,96,261331,90.17632850241546,6
0.05,2898,94,261425,90.17764746464297,7
0.05,2899,94,261519,90.17896551724138,7
0.05,2900,93,261612,90.1799379524302,8
0.05,2901,93,261705,90.18090971743625,8
0.05,2902,94,261799,90.18222528418877,7
0.05,2903,94,261893,90.18353994490359,7
0.05,2904,96,261989,90.1855421686747,6
0.05,2905,96,262085,90.18754301445286,6
0.05,2906,96,262181,90.18954248366013,6
0.05,2907,91,262272,90.1898211829436,10
0.05,2908,92,262364,90.19044345135785,9
0.05,2909,93,262457,90.19140893470791,9
0.05,2910,91,262548,90.19168670559945,10
0.05,2911,93,262641,90.1926510989011,8
0.05,2912,93,262734,90.1936148300721,8
0.05,2913,93,262827,90.1945778997941,9
0.05,2914,94,262921,90.19588336192109,7
0.05,2915,93,263014,90.19684499314128,8
0.05,2916,95,263109,90.19849160095988,6
0.05,2917,94,263203,90.19979437971213,7
0.05,2918,94,263297,90.20109626584447,7
0.05,2919,94,263391,90.20239726027397,7
0.05,2920,91,263482,90.20267031838412,10
0.05,2921,96,263578,90.20465434633813,6
0.05,2922,94,263672,90.20595278823127,7
0.05,2923,92,263764,90.20656634746922,9
0.05,2924,94,263858,90.20786324786324,7
0.05,2925,89,263947,90.20745044429255,12
0.05,2926,95,264042,90.20908780321147,7
0.05,2927,94,264136,90.2103825136612,7
0.05,2928,94,264230,90.2116763400478,7
0.05,2929,92,264322,90.2122866894198,9
0.05,2930,95,264417,90.21392016376663,6
0.05,2931,94,264511,90.21521145975443,7
0.05,2932,95,264606,90.21684282304807,6
0.05,2933,96,264702,90.21881390593047,6
0.05,2934,96,264798,90.22078364565587,6
0.05,2935,94,264892,90.22207084468666,8
0.05,2936,96,264988,90.22403813415049,6
0.05,2937,91,265079,90.22430224642613,11
0.05,2938,96,265175,90.22626743790404,6
0.05,2939,93,265268,90.22721088435374,8
0.05,2940,94,265362,90.22849370962258,7
0.05,2941,90,265452,90.22841604350782,11
0.05,2942,96,265548,90.23037716615698,6
0.05,2943,94,265642,90.23165760869566,7
0.05,2944,94,265736,90.23293718166384,8
0.05,2945,94,265830,90.23421588594705,7
0.05,2946,94,265924,90.2354937224296,7
0.05,2947,94,266018,90.23677069199458,7
0.05,2948,94,266112,90.2380467955239,7
0.05,2949,93,266205,90.23898305084745,8
0.05,2950,94,266299,90.24025753981701,7
0.05,2951,93,266392,90.24119241192412,8
0.05,2952,91,266483,90.24144937351845,10
0.05,2953,91,266574,90.24170616113744,10
0.05,2954,92,266666,90.24230118443316,10
0.05,2955,92,266758,90.24289580514208,9
0.05,2956,95,266853,90.24450456543795,6
0.05,2957,94,266947,90.24577417173766,7
0.05,2958,91,267038,90.24602906387292,10
0.05,2959,96,267134,90.24797297297297,6
0.05,2960,91,267225,90.2482269503546,10
0.05,2961,94,267319,90.24949358541527,7
0.05,2962,92,267411,90.25008437394533,10
0.05,2963,96,267507,90.25202429149797,6
0.05,2964,92,267599,90.25261382799326,9
0.05,2965,96,267695,90.25455158462576,6
0.05,2966,94,267789,90.25581395348837,8
0.05,2967,94,267883,90.25707547169812,8
0.05,2968,96,267979,90.25900976759851,6
0.05,2969,92,268071,90.25959595959596,9
0.05,2970,90,268161,90.25950858296869,12
0.05,2971,96,268257,90.2614401076716,6
0.05,2972,96,268353,90.26337033299697,6
0.05,2973,91,268444,90.26361802286483,10
0.05,2974,94,268538,90.26487394957984,7
0.05,2975,92,268630,90.26545698924731,9
0.05,2976,94,268724,90.26671145448438,7
0.05,2977,93,268817,90.2676292813969,8
0.05,2978,95,268912,90.26921785834172,6
0.05,2979,95,269007,90.27080536912752,6
0.05,2980,93,269100,90.27172089902717,8
0.05,2981,94,269194,90.2729711602951,7
0.05,2982,91,269285,90.27321488434463,12
0.05,2983,94,269379,90.27446380697052,7
0.05,2984,93,269472,90.27537688442212,9
0.05,2985,94,269566,90.27662424648359,7
0.05,2986,95,269661,90.27820555741546,6
0.05,2987,94,269755,90.27945113788488,7
0.05,2988,94,269849,90.28069588491134,7
0.05,2989,92,269941,90.28127090301004,9
0.05,2990,94,270035,90.28251420929455,10
0.05,2991,93,270128,90.28342245989305,8
0.05,2992,91,270219,90.28366187771466,10
0.05,2993,93,270312,90.28456913827655,8
0.05,2994,92,270404,90.28514190317195,9
0.05,2995,95,270499,90.28671562082776,7
0.05,2996,96,270595,90.28862195528862,6
0.05,2997,94,270689,90.2898599066044,7
0.05,2998,88,270777,90.28909636545515,14
0.05,2999,96,270873,90.291,6
0.05,3000,95,270968,90.29256914361879,6
0.05,3001,93,271061,90.29347101932045,8
0.05,3002,94,271155,90.2947052947053,7
0.05,3003,95,271250,90.29627163781625,9
0.05,3004,94,271344,90.29750415973378,7
0.05,3005,94,271438,90.29873586161011,7
0.05,3006,95,271533,90.30029930162954,6
0.05,3007,94,271627,90.30152925531915,8
0.05,3008,92,271719,90.30209371884347,9
0.05,3009,96,271815,90.30398671096346,6
0.05,3010,96,271911,90.30587844569911,6
0.05,3011,92,272003,90.30644090305445,9
0.05,3012,95,272098,90.30799867241952,6
0.05,3013,92,272190,90.3085600530856,9
0.05,3014,94,272284,90.30978441127695,7
0.05,3015,92,272376,90.3103448275862,9
0.05,3016,93,272469,90.31123632747763,8
0.05,3017,94,272563,90.31245858184228,7
0.05,3018,95,272658,90.31401126200728,6
0.05,3019,94,272752,90.31523178807947,7
0.05,3020,95,272847,90.3167825223436,6
0.05,3021,94,272941,90.31800132362673,7
0.05,3022,94,273035,90.31921931855773,8
0.05,3023,93,273128,90.32010582010582,8
0.05,3024,96,273224,90.32198347107438,6
0.05,3025,93,273317,90.32286847323199,10
0.05,3026,95,273412,90.3244136108358,6
0.05,3027,92,273504,90.32496697490093,9
0.05,3028,92,273596,90.32551997358864,9
0.05,3029,95,273691,90.32706270627062,6
0.05,3030,92,273783,90.32761464863081,9
0.05,3031,92,273875,90.32816622691293,9
0.05,3032,96,273971,90.33003626772172,6
0.05,3033,22,273993,90.30751483190508,11
0.05,3034,94,274087,90.30873146622734,7
0.05,3035,91,274178,90.30895915678525,10
0.05,3036,94,274272,90.31017451432335,7
0.05,3037,93,274365,90.3110599078341,8
0.05,3038,96,274461,90.31293188548865,6
0.05,3039,96,274557,90.31480263157894,6
0.05,3040,93,274650,90.31568562972706,8
0.05,3041,94,274744,90.31689677843524,7
0.05,3042,94,274838,90.3181071311206,7
0.05,3043,94,274932,90.31931668856767,7
0.05,3044,17,274949,90.29523809523809,16
0.05,3045,92,275041,90.29579776756403,9
0.05,3046,93,275134,90.2966852641943,8
0.05,3047,95,275229,90.2982283464567,7
0.05,3048,95,275324,90.29977041653001,6
0.05,3049,91,275415,90.3,10
0.05,3050,18,275433,90.2763028515241,15
0.05,3051,92,275525,90.27686762778507,9
0.05,3052,94,275619,90.27808712741566,7
0.05,3053,96,275715,90.27996070726915,6
0.05,3054,96,275811,90.28183306055647,6
0.05,3055,92,275903,90.28239528795811,10
0.05,3056,94,275997,90.28361138370951,7
0.05,3057,95,276092,90.28515369522563,6
0.05,3058,94,276186,90.28636809414841,7
0.05,3059,95,276281,90.28790849673203,6
0.05,3060,93,276374,90.28879451159752,8
0.05,3061,95,276469,90.29033311561071,6
0.05,3062,92,276561,90.29089128305583,9
0.05,3063,94,276655,90.29210182767623,7
0.05,3064,90,276745,90.29200652528549,11
0.05,3065,94,276839,90.29321591650358,7
0.05,3066,91,276930,90.2934463645256,10
0.05,3067,95,277025,90.29498044328552,7
0.05,3068,95,277120,90.29651352231997,7
0.05,3069,95,277215,90.29804560260587,6
0.05,3070,94,277309,90.2992510582872,7
0.05,3071,94,277403,90.30045572916667,8
0.05,3072,95,277498,90.30198503091441,6
0.05,3073,94,277592,90.30318802862719,8
0.05,3074,96,277688,90.30504065040651,6
0.05,3075,95,277783,90.30656697009103,6
0.05,3076,96,277879,90.30841728956776,6
0.05,3077,96,277975,90.31026640675763,6
0.05,3078,94,278069,90.31146476128613,7
0.05,3079,93,278162,90.31233766233767,8
0.05,3080,94,278256,90.31353456669912,7
0.05,3081,94,278350,90.31473069435431,7
0.05,3082,94,278444,90.31592604605903,7
0.05,3083,94,278538,90.3171206225681,8
0.05,3084,94,278632,90.31831442463533,8
0.05,3085,94,278726,90.31950745301361,7
0.05,3086,91,278817,90.31972789115646,10
0.05,3087,22,278839,90.297603626943,11
0.05,3088,94,278933,90.29880220135966,7
0.05,3089,94,279027,90.3,7
0.05,3090,92,279119,90.300549983824,9
0.05,3091,94,279213,90.30174644243208,7
0.05,3092,95,279308,90.303265438086,6
0.05,3093,94,279402,90.30446024563672,7
0.05,3094,94,279496,90.30565428109854,7
0.05,3095,95,279591,90.30717054263566,6
0.05,3096,94,279685,90.30836293186955,8
0.05,3097,94,279779,90.30955455132343,8
0.05,3098,94,279873,90.3107454017425,7
0.05,3099,94,279967,90.31193548387097,7
0.05,3100,96,280063,90.313769751693,6
0.05,3101,95,280158,90.31528046421663,6
0.05,3102,96,280254,90.31711247180148,6
0.05,3103,95,280349,90.31862113402062,6
0.05,3104,94,280443,90.31980676328503,7
0.05,3105,94,280537,90.32099162910495,7
0.05,3106,96,280633,90.32281943997425,6
0.05,3107,91,280724,90.32303732303733,10
0.05,3108,96,280820,90.3248633000965,6
0.05,3109,96,280916,90.3266881028939,6
0.05,3110,95,281011,90.32819029251044,6
0.05,3111,96,281107,90.33001285347044,6
0.05,3112,87,281194,90.32894314166398,15
0.05,3113,94,281288,90.330122029544,7
0.05,3114,93,281381,90.33097913322632,8
0.05,3115,94,281475,90.33215661103979,7
0.05,3116,92,281567,90.33269169072827,9
0.05,3117,92,281659,90.33322642719692,9
0.05,3118,95,281754,90.33472266752165,6
0.05,3119,95,281849,90.33621794871794,6
0.05,3120,94,281943,90.33739186158283,7
0.05,3121,88,282031,90.33664317745036,14
0.05,3122,91,282122,90.33685558757605,10
0.05,3123,91,282213,90.33706786171575,10
0.05,3124,94,282307,90.33824,7
0.05,3125,94,282401,90.33941138835573,7
0.05,3126,94,282495,90.34058202750239,7
0.05,3127,92,282587,90.34111253196932,9
0.05,3128,95,282682,90.34260147011825,6
0.05,3129,93,282775,90.34345047923323,8
0.05,3130,94,282869,90.34461833280102,7
0.05,3131,96,282965,90.34642401021712,6
0.05,3132,92,283057,90.34695180338333,9
0.05,3133,94,283151,90.34811742182514,8
0.05,3134,92,283243,90.34864433811802,9
0.05,3135,95,283338,90.3501275510204,6
0.05,3136,96,283434,90.35192859419828,6
0.05,3137,96,283530,90.35372848948374,6
0.05,3138,96,283626,90.35552723797387,6
0.05,3139,93,283719,90.3563694267516,8
0.05,3140,94,283813,90.35752944922,7
0.05,3141,96,283909,90.35932527052833,6
0.05,3142,91,284000,90.35952911231308,10
0.05,3143,94,284094,90.36068702290076,7
0.05,3144,94,284188,90.36184419713831,7
0.05,3145,91,284279,90.36204704386523,10
0.05,3146,96,284375,90.36383857642198,6
0.05,3147,93,284468,90.36467598475222,8
0.05,3148,93,284561,90.36551286122578,8
0.05,3149,95,284656,90.36698412698412,6
0.05,3150,96,284752,90.36877181847032,6
0.05,3151,95,284847,90.37024111675127,6
0.05,3152,20,284867,90.34792261338409,12
0.05,3153,94,284961,90.34908053265694,7
0.05,3154,93,285054,90.3499207606973,8
0.05,3155,26,285080,90.32953105196451,6
0.05,3156,90,285170,90.32942667089009,11
0.05,3157,91,285261,90.32963901203293,10
0.05,3158,94,285355,90.33080088635644,7
0.05,3159,94,285449,90.33196202531646,7
0.05,3160,95,285544,90.33343878519456,6
0.05,3161,95,285639,90.33491461100569,7
0.05,3162,90,285729,90.33480872589314,11
0.05,3163,90,285819,90.33470290771176,11
0.05,3164,94,285913,90.33586097946288,7
0.05,3165,93,286006,90.33670246367656,8
0.05,3166,93,286099,90.33754341648248,8
0.05,3167,94,286193,90.3386994949495,7
0.05,3168,90,286283,90.33859261596719,11
0.05,3169,25,286308,90.3179810725552,8
0.05,3170,96,286404,90.3197729422895,6
0.05,3171,94,286498,90.32093316519546,7
0.05,3172,92,286590,90.32146233848093,10
0.05,3173,95,286685,90.322936357908,6
0.05,3174,94,286779,90.32409448818898,7
0.05,3175,95,286874,90.32556675062972,6
0.05,3176,94,286968,90.32672332389046,7
0.05,3177,93,287061,90.3275645059786,9
0.05,3178,92,287153,90.32809059452659,9
0.05,3179,96,287249,90.32987421383648,6
0.05,3180,95,287344,90.33134234517448,7
0.05,3181,92,287436,90.3318667504714,9
0.05,3182,94,287530,90.3330191643104,7
0.05,3183,93,287623,90.3338567839196,8
0.05,3184,94,287717,90.33500784929356,7
0.05,3185,95,287812,90.33647206528562,6
0.05,3186,94,287906,90.33762158770003,7
0.05,3187,95,288001,90.33908406524466,7
0.05,3188,93,288094,90.33991846973973,8
0.05,3189,94,288188,90.341065830721,8
0.05,3190,94,288282,90.34221247257913,7
0.05,3191,91,288373,90.34241854636592,10
0.05,3192,95,288468,90.34387723144378,6
0.05,3193,94,288562,90.34502191609268,7
0.05,3194,89,288651,90.34460093896713,12
0.05,3195,95,288746,90.34605757196496,6
0.05,3196,94,288840,90.34720050046919,7
0.05,3197,96,288936,90.34896810506567,6
0.05,3198,94,289030,90.35010940919037,7
0.05,3199,92,289122,90.350625,9
0.05,3200,94,289216,90.35176507341455,7
0.05,3201,93,289309,90.3525921299188,8
0.05,3202,90,289399,90.35248204807992,11
0.05,3203,95,289494,90.35393258426966,6
0.05,3204,92,289586,90.35444617784711,9
0.05,3205,93,289679,90.35527136618839,8
0.05,3206,95,289774,90.35671967570939,6
0.05,3207,95,289869,90.35816708229426,6
0.05,3208,91,289960,90.3583670925522,10
0.05,3209,91,290051,90.35856697819315,11
0.05,3210,94,290145,90.35970102771722,7
0.05,3211,92,290237,90.36021170610212,9
0.05,3212,93,290330,90.36103330220978,8
0.05,3213,95,290425,90.3624766645924,6
0.05,3214,93,290518,90.36329704510109,8
0.05,3215,93,290611,90.36411691542288,8
0.05,3216,94,290705,90.3652471246503,7
0.05,3217,94,290799,90.3663766314481,7
0.05,3218,94,290893,90.36750543647095,7
0.05,3219,91,290984,90.36770186335404,10
0.05,3220,94,291078,90.36882955603849,7
0.05,3221,95,291173,90.37026691495966,7
0.05,3222,90,291263,90.37015203226807,11
0.05,3223,94,291357,90.37127791563276,8
0.05,3224,93,291450,90.37209302325581,8
0.05,3225,95,291545,90.3735275883447,6
0.05,3226,95,291640,90.3749612643322,7
0.05,3227,96,291736,90.37670384138785,6
0.05,3228,95,291831,90.37813564571074,6
0.05,3229,94,291925,90.37925696594428,7
0.05,3230,96,292021,90.38099659548128,6
0.05,3231,92,292113,90.38149752475248,9
0.05,3232,93,292206,90.38230745437674,8
0.05,3233,94,292300,90.3834260977118,7
0.05,3234,92,292392,90.38392581143741,9
0.05,3235,91,292483,90.38411619283066,10
0.05,3236,93,292576,90.38492431263515,8
0.05,3237,94,292670,90.38604076590488,9
0.05,3238,96,292766,90.38777400432232,6
0.05,3239,92,292858,90.38827160493827,9
0.05,3240,94,292952,90.38938599197779,7
0.05,3241,94,293046,90.39049969154843,7
0.05,3242,92,293138,90.39099599136603,10
0.05,3243,96,293234,90.39272503082614,6
0.05,3244,95,293329,90.39414483821264,6
0.05,3245,94,293423,90.39525569932225,7
0.05,3246,93,293516,90.39605789959963,8
0.05,3247,93,293609,90.39685960591133,9
0.05,3248,95,293704,90.39827639273622,6
0.05,3249,94,293798,90.39938461538462,8
0.05,3250,96,293894,90.40110735158413,6
0.05,3251,94,293988,90.40221402214023,8
0.05,3252,94,294082,90.40332001229635,7
0.05,3253,94,294176,90.40442532267978,8
0.05,3254,93,294269,90.40522273425499,9
0.05,3255,94,294363,90.40632678132678,7
0.05,3256,22,294385,90.3853239177157,10
0.05,3257,95,294480,90.38674033149171,6
0.05,3258,94,294574,90.38784903344585,8
0.05,3259,91,294665,90.38803680981596,11
0.05,3260,93,294758,90.38883777982214,8
0.05,3261,96,294854,90.39055793991416,6
0.05,3262,88,294942,90.3898253141281,13
0.05,3263,93,295035,90.390625,8
0.05,3264,94,295129,90.391730474732,7
0.05,3265,90,295219,90.39161053276179,11
0.05,3266,94,295313,90.39271502907866,8
0.05,3267,94,295407,90.3938188494492,7
0.05,3268,95,295502,90.39522789843988,7
0.05,3269,94,295596,90.39633027522936,7
0.05,3270,94,295690,90.39743197798838,7
0.05,3271,96,295786,90.39914425427872,6
0.05,3272,94,295880,90.40024442407577,7
0.05,3273,94,295974,90.40134392180819,7
0.05,3274,92,296066,90.4018320610687,9
0.05,3275,94,296160,90.40293040293041,7
0.05,3276,94,296254,90.40402807445835,7
0.05,3277,91,296345,90.40420988407566,10
0.05,3278,95,296440,90.40561146691064,6
0.05,3279,88,296528,90.40487804878049,13
0.05,3280,92,296620,90.40536421822615,9
0.05,3281,92,296712,90.40585009140767,9
0.05,3282,88,296800,90.4051172707889,13
0.05,3283,94,296894,90.4062119366626,7
0.05,3284,96,296990,90.40791476407915,6
0.05,3285,91,297081,90.40809494826537,10
0.05,3286,93,297174,90.40888348037724,10
0.05,3287,95,297269,90.4102798053528,6
0.05,3288,95,297364,90.4116752812405,6
0.05,3289,94,297458,90.41276595744681,7
0.05,3290,94,297552,90.41385597082953,7
0.05,3291,94,297646,90.4149453219927,8
0.05,3292,94,297740,90.41603401153964,9
0.05,3293,94,297834,90.41712204007285,7
0.05,3294,92,297926,90.4176024279211,9
0.05,3295,93,298019,90.4183859223301,8
0.05,3296,95,298114,90.41977555353351,6
0.05,3297,90,298204,90.4196482716798,11
0.05,3298,94,298298,90.42073355562292,7
0.05,3299,95,298393,90.42212121212121,6
0.05,3300,96,298489,90.42381096637382,6
0.05,3301,92,298581,90.42428831011509,9
0.05,3302,92,298673,90.42476536481986,9
0.05,3303,95,298768,90.42615012106538,6
0.05,3304,93,298861,90.4269288956127,8
0.05,3305,96,298957,90.4286146400484,6
0.05,3306,91,299048,90.42878742062292,10
0.05,3307,91,299139,90.42896009673518,10
0.05,3308,85,299224,90.42731943185252,16
0.05,3309,95,299319,90.42870090634442,6
0.05,3310,95,299414,90.43008154636061,6
0.05,3311,96,299510,90.43176328502416,6
0.05,3312,93,299603,90.43253848475702,8
0.05,3313,95,299698,90.43391671695836,6
0.05,3314,93,299791,90.43469079939668,8
0.05,3315,89,299880,90.43425814234017,13
0.05,3316,92,299972,90.43473017787157,9
0.05,3317,93,300065,90.43550331525014,8
0.05,3318,95,300160,90.43687857788491,6
0.05,3319,93,300253,90.43765060240963,8
0.05,3320,93,300346,90.4384221619994,8
0.05,3321,92,300438,90.43889223359422,9
0.05,3322,95,300533,90.44026482094493,7
0.05,3323,94,300627,90.4413357400722,7
0.05,3324,95,300722,90.4427067669173,8
0.05,3325,92,300814,90.44317498496693,9
0.05,3326,94,300908,90.44424406372107,7
0.05,3327,96,301004,90.44591346153847,6
0.05,3328,92,301096,90.44638029438269,9
0.05,3329,94,301190,90.44744744744744,7
0.05,3330,96,301286,90.44911438006605,6
0.05,3331,25,301311,90.42947178871549,8
0.05,3332,92,301403,90.42994299429942,9
0.05,3333,96,301499,90.43161367726455,6
0.05,3334,92,301591,90.432083958021,9
0.05,3335,95,301686,90.43345323741008,6
0.05,3336,92,301778,90.43392268504645,9
0.05,3337,93,301871,90.4346914319952,9
0.05,3338,26,301897,90.41539383048817,7
0.05,3339,93,301990,90.41616766467065,8
0.05,3340,94,302084,90.41724034720144,7
0.05,3341,93,302177,90.418013165769,8
0.05,3342,92,302269,90.41848638947053,10
0.05,3343,25,302294,90.39892344497608,7
0.05,3344,95,302389,90.40029895366219,6
0.05,3345,94,302483,90.40137477585176,9
0.05,3346,96,302579,90.40304750522856,6
0.05,3347,90,302669,90.40292712066906,11
0.05,3348,94,302763,90.40400119438638,7
0.05,3349,93,302856,90.40477611940298,8
0.05,3350,94,302950,90.40584900029842,7
0.05,3351,89,303039,90.40542959427208,12
0.05,3352,94,303133,90.4065016403221,7
0.05,3353,92,303225,90.40697674418605,9
0.05,3354,95,303320,90.40834575260804,7
0.05,3355,92,303412,90.4088200238379,10
0.05,3356,96,303508,90.4104855525767,6
0.05,3357,92,303600,90.41095890410959,12
0.05,3358,94,303694,90.4120273891039,7
0.05,3359,22,303716,90.39166666666667,12
0.05,3360,93,303809,90.39244272537935,8
0.05,3361,95,303904,90.39381320642475,8
0.05,3362,94,303998,90.39488551888195,7
0.05,3363,95,304093,90.39625445897741,6
0.05,3364,94,304187,90.39732540861813,7
0.05,3365,95,304282,90.39869281045752,6
0.05,3366,91,304373,90.39887139887139,10
0.05,3367,94,304467,90.3999406175772,7
0.05,3368,93,304560,90.40071237756011,8
0.05,3369,94,304654,90.40178041543027,7
0.05,3370,93,304747,90.40255117175913,8
0.05,3371,92,304839,90.40302491103203,9
0.05,3372,92,304931,90.40349836940409,9
0.05,3373,92,305023,90.40397154712507,9
0.05,3374,95,305118,90.40533333333333,6
0.05,3375,94,305212,90.4063981042654,7
0.05,3376,93,305305,90.4071661237785,10
0.05,3377,93,305398,90.40793368857312,8
0.05,3378,93,305491,90.40870079905298,9
0.05,3379,96,305587,90.4103550295858,6
0.05,3380,93,305680,90.41112097012719,8
0.05,3381,94,305774,90.41218214074512,7
0.05,3382,93,305867,90.41294708838309,9
0.05,3383,94,305961,90.41400709219859,7
0.05,3384,27,305988,90.39527326440177,6
0.05,3385,91,306079,90.39545186060248,10
0.05,3386,93,306172,90.39622084440508,8
0.05,3387,88,306260,90.39551357733176,13
0.05,3388,93,306353,90.39628208911184,8
0.05,3389,95,306448,90.3976401179941,6
0.05,3390,95,306543,90.39899734591566,6
0.05,3391,94,306637,90.40005896226415,7
0.05,3392,94,306731,90.40111995284408,7
0.05,3393,96,306827,90.40276959340012,6
0.05,3394,94,306921,90.4038291605302,7
0.05,3395,94,307015,90.40488810365136,7
0.05,3396,92,307107,90.40535766853105,9
0.05,3397,91,307198,90.40553266627428,10
0.05,3398,91,307289,90.40570756104736,10
0.05,3399,95,307384,90.40705882352941,7
0.05,3400,93,307477,90.40782122905028,8
0.05,3401,91,307568,90.40799529688418,10
0.05,3402,94,307662,90.40905083749632,7
0.05,3403,92,307754,90.40951821386604,10
0.05,3404,96,307850,90.41116005873715,6
0.05,3405,94,307944,90.41221374045801,7
0.05,3406,27,307971,90.3936014088641,6
0.05,3407,94,308065,90.39465962441315,7
0.05,3408,94,308159,90.39571721912584,7
0.05,3409,95,308254,90.39706744868035,6
0.05,3410,94,308348,90.39812371738493,7
0.05,3411,92,308440,90.39859320046894,9
0.05,3412,95,308535,90.3999414005274,6
0.05,3413,95,308630,90.40128881077915,6
0.05,3414,93,308723,90.40204978038068,8
0.05,3415,93,308816,90.40281030444964,8
0.05,3416,95,308911,90.4041556921276,6
0.05,3417,91,309002,90.40433001755413,10
0.05,3418,96,309098,90.40596665691723,6
0.05,3419,93,309191,90.40672514619882,9
0.05,3420,93,309284,90.40748319204911,8
0.05,3421,94,309378,90.40853302162478,8
0.05,3422,92,309470,90.40899795501022,10
0.05,3423,94,309564,90.41004672897196,7
0.05,3424,94,309658,90.41109489051095,8
0.05,3425,94,309752,90.41214244016345,7
0.05,3426,93,309845,90.41289757805662,8
0.05,3427,95,309940,90.41423570595099,7
0.05,3428,95,310035,90.41557305336833,6
0.05,3429,93,310128,90.41632653061224,8
0.05,3430,94,310222,90.41737102885456,7
0.05,3431,92,310314,90.41783216783217,9
0.05,3432,93,310407,90.41858432857559,8
0.05,3433,94,310501,90.41962725684333,7
0.05,3434,94,310595,90.42066957787482,7
0.05,3435,93,310688,90.42142025611176,8
0.05,3436,94,310782,90.42246144893802,7
0.05,3437,95,310877,90.4237929028505,6
0.05,3438,92,310969,90.42425123582437,9
0.05,3439,96,311065,90.42587209302326,6
0.05,3440,95,311160,90.42720139494332,6
0.05,3441,94,311254,90.42823939570017,7
0.05,3442,94,311348,90.42927679349404,7
0.05,3443,95,311443,90.43060394889663,8
0.05,3444,89,311532,90.43018867924528,12
0.05,3445,96,311628,90.43180499129426,6
0.05,3446,94,311722,90.43284015085581,7
0.05,3447,96,311818,90.4344547563805,6
0.05,3448,91,311909,90.43461873006669,10
0.05,3449,94,312003,90.43565217391304,7
0.05,3450,94,312097,90.43668501883512,7
0.05,3451,93,312190,90.43742757821553,8
0.05,3452,91,312281,90.43759050101362,10
0.05,3453,96,312377,90.43920092646208,7
0.05,3454,96,312473,90.44081041968163,6
0.05,3455,94,312567,90.44184027777777,8
0.05,3456,96,312663,90.44344807636679,6
0.05,3457,86,312749,90.44216310005784,15
0.05,3458,94,312843,90.44319167389419,7
0.05,3459,93,312936,90.44393063583816,8
0.05,3460,94,313030,90.44495810459405,7
0.05,3461,93,313123,90.44569612940496,8
0.05,3462,94,313217,90.44672249494658,7
0.05,3463,96,313313,90.44832563510393,6
0.05,3464,94,313407,90.44935064935065,7
0.05,3465,96,313503,90.45095210617427,6
0.05,3466,96,313599,90.45255263916931,6
0.05,3467,92,313691,90.45299884659747,9
0.05,3468,96,313787,90.45459786682041,6
0.05,3469,87,313874,90.4536023054755,14
0.05,3470,92,313966,90.45404782483435,11
0.05,3471,27,313993,90.43577188940093,6
0.05,3472,93,314086,90.43651022171034,8
0.05,3473,95,314181,90.43782383419689,6
0.05,3474,96,314277,90.43942446043165,6
0.05,3475,94,314371,90.44044879171462,7
0.05,3476,94,314465,90.4414725337935,7
0.05,3477,92,314557,90.44192064404831,9
0.05,3478,92,314649,90.44236849669446,9
0.05,3479,95,314744,90.44367816091955,6
0.05,3480,93,314837,90.44441252513646,8
0.05,3481,23,314860,90.42504307869041,9
0.05,3482,94,314954,90.42606948033304,8
0.05,3483,95,315049,90.42738231917336,6
0.05,3484,26,315075,90.40889526542324,7
0.05,3485,93,315168,90.40963855421687,8
0.05,3486,94,315262,90.41066819615716,8
0.05,3487,92,315354,90.41112385321101,9
0.05,3488,22,315376,90.3915161937518,10
0.05,3489,89,315465,90.39111747851003,12
0.05,3490,92,315557,90.39157834431396,9
0.05,3491,94,315651,90.3926116838488,7
0.05,3492,95,315746,90.39393071858002,7
0.05,3493,96,315842,90.3955352032055,6
0.05,3494,96,315938,90.39713876967096,6
0.05,3495,94,316032,90.39816933638444,7
0.05,3496,95,316127,90.39948527309122,8
0.05,3497,94,316221,90.40051457975986,7
0.05,3498,92,316313,90.40097170620177,9
0.05,3499,94,316407,90.402,7
0.05,3500,94,316501,90.40302770636961,8
0.05,3501,93,316594,90.40376927470017,9
0.05,3502,95,316689,90.40508135883529,7
0.05,3503,96,316785,90.40667808219177,6
0.05,3504,91,316876,90.40684736091298,10
0.05,3505,94,316970,90.40787221905305,7
0.05,3506,95,317065,90.40918163672654,6
0.05,3507,96,317161,90.41077537058153,6
0.05,3508,95,317256,90.41208321459105,8
0.05,3509,94,317350,90.41310541310541,7
0.05,3510,93,317443,90.41384221019652,8
0.05,3511,94,317537,90.41486332574031,7
0.05,3512,94,317631,90.41588385994876,8
0.05,3513,91,317722,90.41605008537279,10
0.05,3514,94,317816,90.41706970128023,7
0.05,3515,92,317908,90.41751990898749,9
0.05,3516,92,318000,90.4179698606767,9
0.05,3517,95,318095,90.41927231381467,6
0.05,3518,96,318191,90.42085819835181,6
0.05,3519,94,318285,90.421875,8
0.05,3520,92,318377,90.42232320363533,9
0.05,3521,88,318465,90.42163543441227,13
0.05,3522,96,318561,90.4232188475731,6
0.05,3523,93,318654,90.42395005675368,9
0.05,3524,93,318747,90.42468085106383,8
0.05,3525,96,318843,90.42626205331821,6
0.05,3526,95,318938,90.42755883186844,6
0.05,3527,94,319032,90.42857142857143,7
0.05,3528,93,319125,90.42930008500991,8
0.05,3529,95,319220,90.43059490084985,6
0.05,3530,94,319314,90.43160577740016,7
0.05,3531,93,319407,90.4323329558324,8
0.05,3532,94,319501,90.43334276818568,7
0.05,3533,94,319595,90.43435200905489,7
0.05,3534,92,319687,90.43479490806223,10
0.05,3535,95,319782,90.43608597285068,7
0.05,3536,95,319877,90.43737630760532,6
0.05,3537,94,319971,90.4383832673827,7
0.05,3538,93,320064,90.43910709239898,10
0.05,3539,95,320159,90.44039548022599,7
0.05,3540,96,320255,90.4419655464558,6
0.05,3541,90,320345,90.44184076792773,13
0.05,3542,93,320438,90.4425627998871,8
0.05,3543,86,320524,90.441309255079,15
0.05,3544,94,320618,90.44231311706629,8
0.05,3545,94,320712,90.44331641285956,7
0.05,3546,95,320807,90.44460107132788,7
0.05,3547,93,320900,90.44532130777903,8
0.05,3548,94,320994,90.44632290786137,7
0.05,3549,94,321088,90.44732394366197,8
0.05,3550,95,321183,90.44860602647141,7
0.05,3551,25,321208,90.43018018018019,8
0.05,3552,94,321302,90.43118491415704,7
0.05,3553,92,321394,90.43162633652223,9
0.05,3554,94,321488,90.43263009845289,7
0.05,3555,96,321584,90.43419572553431,6
0.05,3556,94,321678,90.43519820073095,7
0.05,3557,93,321771,90.43591905564924,8
0.05,3558,95,321866,90.43720146108457,6
0.05,3559,93,321959,90.4379213483146,9
0.05,3560,93,322052,90.43864083122719,8
0.05,3561,25,322077,90.42026951151038,7
0.05,3562,94,322171,90.42127420712882,7
0.05,3563,94,322265,90.422278338945,7
0.05,3564,96,322361,90.42384291725105,6
0.05,3565,90,322451,90.42372406057207,11
0.05,3566,93,322544,90.42444631342865,8
0.05,3567,93,322637,90.42516816143498,8
0.05,3568,90,322727,90.42504903334267,11
0.05,3569,91,322818,90.42521008403361,10
0.05,3570,25,322843,90.4068888266592,7
0.05,3571,90,322933,90.40677491601343,12
0.05,3572,93,323026,90.40750069969214,9
0.05,3573,94,323120,90.40850587576945,7
0.05,3574,95,323215,90.40979020979022,6
0.05,3575,95,323310,90.41107382550335,6
0.05,3576,96,323406,90.41263628739166,6
0.05,3577,93,323499,90.41335941866964,9
0.05,3578,92,323591,90.41380273819503,10
0.05,3579,91,323682,90.41396648044693,10
0.05,3580,93,323775,90.41468863445965,8
0.05,3581,95,323870,90.41596873255165,6
0.05,3582,94,323964,90.41696902037398,7
0.05,3583,96,324060,90.41852678571429,6
0.05,3584,96,324156,90.42008368200837,6
0.05,3585,94,324250,90.42108198549916,7
0.05,3586,90,324340,90.42096459436856,11
0.05,3587,94,324434,90.42196209587514,7
0.05,3588,92,324526,90.42240178322652,9
0.05,3589,96,324622,90.42395543175488,6
0.05,3590,91,324713,90.42411584516847,10
0.05,3591,95,324808,90.42538975501114,7
0.05,3592,94,324902,90.42638463679377,7
0.05,3593,92,324994,90.4268224819143,9
0.05,3594,94,325088,90.4278164116829,7
0.05,3595,95,325183,90.42908787541712,6
0.05,3596,86,325269,90.4278565471226,15
0.05,3597,95,325364,90.42912729294052,6
0.05,3598,95,325459,90.43039733259239,6
0.05,3599,93,325552,90.43111111111111,9
0.05,3600,93,325645,90.43182449319633,8
0.05,3601,94,325739,90.43281510272071,7
0.05,3602,95,325834,90.43408270885374,6
0.05,3603,95,325929,90.43534961154273,6
0.05,3604,94,326023,90.43633841886269,7
0.05,3605,89,326112,90.43594009983362,12
0.05,3606,94,326206,90.43692819517605,8
0.05,3607,93,326299,90.43763858093126,8
0.05,3608,96,326395,90.43917982820726,6
0.05,3609,91,326486,90.43933518005541,10
0.05,3610,91,326577,90.43949044585987,10
0.05,3611,94,326671,90.44047619047619,7
0.05,3612,93,326764,90.44118461112649,8
0.05,3613,96,326860,90.44272274488102,6
0.05,3614,94,326954,90.44370677731673,7
0.05,3615,93,327047,90.44441371681415,9
0.05,3616,95,327142,90.44567320984241,6
0.05,3617,94,327236,90.44665561083471,7
0.05,3618,94,327330,90.44763746891407,7
0.05,3619,92,327422,90.44806629834254,9
0.05,3620,95,327517,90.44932339132836,6
0.05,3621,94,327611,90.45030369961347,7
0.05,3622,94,327705,90.45128346674026,7
0.05,3623,94,327799,90.45226269315673,8
0.05,3624,94,327893,90.45324137931034,7
0.05,3625,96,327989,90.45477109762824,6
0.05,3626,94,328083,90.45574855252275,7
0.05,3627,95,328178,90.45700110253583,6
0.05,3628,93,328271,90.45770184623863,8
0.05,3629,94,328365,90.45867768595042,7
0.05,3630,96,328461,90.4602038006059,6
0.05,3631,95,328556,90.4614537444934,7
0.05,3632,94,328650,90.46242774566474,7
0.05,3633,93,328743,90.46312603192075,8
0.05,3634,93,328836,90.46382393397523,8
0.05,3635,93,328929,90.46452145214522,9
0.05,3636,96,329025,90.46604344239758,6
0.05,3637,95,329120,90.46728971962617,6
0.05,3638,95,329215,90.46853531189888,6
0.05,3639,94,329309,90.4695054945055,7
0.05,3640,89,329398,90.46910189508377,12
0.05,3641,91,329489,90.46924766611752,10
0.05,3642,92,329581,90.4696678561625,9
0.05,3643,96,329677,90.4711855104281,6
0.05,3644,93,329770,90.4718792866941,8
0.05,3645,94,329864,90.47284695556775,7
0.05,3646,93,329957,90.47353989580478,8
0.05,3647,96,330053,90.4750548245614,6
0.05,3648,96,330149,90.4765689229926,6
0.05,3649,94,330243,90.47753424657535,8
0.05,3650,94,330337,90.47849904135853,7
0.05,3651,95,330432,90.47973713033954,6
0.05,3652,95,330527,90.48097454147276,6
0.05,3653,90,330617,90.48084291187739,11
0.05,3654,94,330711,90.48180574555404,7
0.05,3655,95,330806,90.48304157549234,9
0.05,3656,89,330895,90.48263604047033,12
0.05,3657,96,330991,90.48414434117004,6
0.05,3658,96,331087,90.48565181743646,6
0.05,3659,95,331182,90.48688524590163,6
0.05,3660,94,331276,90.48784485113357,7
0.05,3661,91,331367,90.48798470780994,10
0.05,3662,96,331463,90.48948948948949,6
0.05,3663,94,331557,90.49044759825327,7
0.05,3664,94,331651,90.49140518417462,7
0.05,3665,94,331745,90.4923622476814,7
0.05,3666,92,331837,90.4927733842378,9
0.05,3667,96,331933,90.4942748091603,6
0.05,3668,91,332024,90.49441264649768,10
0.05,3669,27,332051,90.47711171662125,6
0.05,3670,93,332144,90.47779896485972,9
0.05,3671,95,332239,90.47903050108933,6
0.05,3672,94,332333,90.47998910971957,7
0.05,3673,95,332428,90.48121937942297,6
0.05,3674,92,332520,90.48163265306123,9
0.05,3675,96,332616,90.48313384113166,6
0.05,3676,90,332706,90.48300244764754,11
0.05,3677,96,332802,90.48450244698205,6
0.05,3678,27,332829,90.46724653438434,6
0.05,3679,94,332923,90.46820652173913,7
0.05,3680,95,333018,90.46943765281173,6
0.05,3681,95,333113,90.47066811515481,6
0.05,3682,94,333207,90.47162639152864,7
0.05,3683,93,333300,90.47231270358306,8
0.05,3684,92,333392,90.47272727272727,9
0.05,3685,93,333485,90.47341291372761,8
0.05,3686,95,333580,90.47464062923787,6
0.05,3687,94,333674,90.47559652928416,7
0.05,3688,91,333765,90.4757386825698,10
0.05,3689,94,333859,90.47669376693767,7
0.05,3690,94,333953,90.47764833378488,7
0.05,3691,94,334047,90.47860238353196,8
0.05,3692,94,334141,90.47955591659897,8
0.05,3693,94,334235,90.48050893340552,7
0.05,3694,91,334326,90.48064952638701,10
0.05,3695,94,334420,90.48160173160173,7
0.05,3696,94,334514,90.48255342169327,7
0.05,3697,94,334608,90.4835045970795,7
0.05,3698,88,334696,90.48283319816167,13
0.05,3699,91,334787,90.48297297297297,10
0.05,3700,94,334881,90.4839232639827,7
0.05,3701,96,334977,90.48541329011346,6
0.05,3702,95,335072,90.48663246016743,6
0.05,3703,92,335164,90.48704103671706,9
0.05,3704,96,335260,90.4885290148448,6
0.05,3705,94,335354,90.48947652455477,7
0.05,3706,93,335447,90.4901537631508,10
0.05,3707,93,335540,90.49083063646171,9
0.05,3708,91,335631,90.49096791588029,10
0.05,3709,93,335724,90.49164420485175,8
0.05,3710,92,335816,90.49205066019941,11
0.05,3711,94,335910,90.49299568965517,7
0.05,3712,88,335998,90.49232426609211,13
0.05,3713,94,336092,90.49326871297792,7
0.05,3714,94,336186,90.49421265141319,7
0.05,3715,94,336280,90.49515608180839,7
0.05,3716,94,336374,90.49609900457358,7
0.05,3717,93,336467,90.49677245831091,9
0.05,3718,94,336561,90.49771443936542,7
0.05,3719,95,336656,90.4989247311828,6
0.05,3720,91,336747,90.49905939263638,10
0.05,3721,96,336843,90.50053734551317,6
0.05,3722,20,336863,90.48160085952189,14
0.05,3723,95,336958,90.4828141783029,8
0.05,3724,93,337051,90.4834899328859,8
0.05,3725,94,337145,90.4844337090714,7
0.05,3726,96,337241,90.4859136034344,6
0.05,3727,95,337336,90.48712446351931,6
0.05,3728,95,337431,90.48833467417538,6
0.05,3729,94,337525,90.4892761394102,7
0.05,3730,95,337620,90.49048512463146,8
0.05,3731,96,337716,90.49196141479099,6
0.05,3732,92,337808,90.49236538976695,9
0.05,3733,92,337900,90.49276914836636,9
0.05,3734,95,337995,90.49397590361446,6
0.05,3735,94,338089,90.49491434689507,7
0.05,3736,93,338182,90.4955846936045,8
0.05,3737,94,338276,90.49652220438738,7
0.05,3738,95,338371,90.49772666488366,7
0.05,3739,95,338466,90.49893048128342,6
0.05,3740,93,338559,90.49959903769046,8
0.05,3741,92,338651,90.5,9
0.05,3742,94,338745,90.50093507881378,7
0.05,3743,94,338839,90.50186965811966,8
0.05,3744,93,338932,90.50253671562083,8
0.05,3745,92,339024,90.50293646556327,9
0.05,3746,92,339116,90.50333600213504,9
0.05,3747,93,339209,90.50400213447172,8
0.05,3748,94,339303,90.5049346492398,7
0.05,3749,92,339395,90.50533333333334,9
0.05,3750,89,339484,90.5049320181285,12
0.05,3751,94,339578,90.50586353944563,7
0.05,3752,95,339673,90.50706101785238,6
0.05,3753,96,339769,90.5085242408098,6
0.05,3754,93,339862,90.5091877496671,8
0.05,3755,87,339949,90.50825346112886,14
0.05,3756,96,340045,90.50971519829652,6
0.05,3757,93,340138,90.51037786056413,8
0.05,3758,95,340233,90.51157222665603,6
0.05,3759,94,340327,90.5125,7
0.05,3760,95,340422,90.51369316671098,6
0.05,3761,95,340517,90.51488569909623,6
0.05,3762,93,340610,90.51554610682966,10
0.05,3763,92,340702,90.51594048884166,9
0.05,3764,94,340796,90.51686586985392,7
0.05,3765,92,340888,90.51725969198088,9
0.05,3766,91,340979,90.51738784178391,10
0.05,3767,94,341073,90.51831210191082,7
0.05,3768,96,341169,90.51976651631733,6
0.05,3769,95,341264,90.52095490716181,6
0.05,3770,95,341359,90.5221426677274,7
0.05,3771,94,341453,90.52306468716861,7
0.05,3772,94,341547,90.52398621786377,7
0.05,3773,96,341643,90.52543720190779,6
0.05,3774,94,341737,90.52635761589404,8
0.05,3775,93,341830,90.5270127118644,8
0.05,3776,92,341922,90.527402700556,10
0.05,3777,93,342015,90.52805717310747,8
0.05,3778,93,342108,90.52871129928552,10
0.05,3779,94,342202,90.52962962962962,7
0.05,3780,91,342293,90.52975403332452,10
0.05,3781,95,342388,90.5309360126917,6
0.05,3782,96,342484,90.53238170763944,6
0.05,3783,92,342576,90.53276955602537,9
0.05,3784,92,342668,90.5331571994716,9
0.05,3785,94,342762,90.53407290015848,7
0.05,3786,92,342854,90.53445999471877,9
0.05,3787,95,342949,90.5356388595565,6
0.05,3788,95,343044,90.53681710213776,7
0.05,3789,96,343140,90.53825857519789,6
0.05,3790,95,343235,90.53943550514376,6
0.05,3791,94,343329,90.54034810126582,7
0.05,3792,96,343425,90.54178750329554,6
0.05,3793,27,343452,90.52503953610965,6
0.05,3794,94,343546,90.52595520421607,7
0.05,3795,92,343638,90.5263435194942,9
0.05,3796,91,343729,90.52646826441928,10
0.05,3797,95,343824,90.52764612954186,6
0.05,3798,94,343918,90.52856014740722,7
0.05,3799,96,344014,90.53,6
0.05,3800,93,344107,90.53064982899237,8
0.05,3801,95,344202,90.53182535507628,6
0.05,3802,92,344294,90.53221141204313,9
0.05,3803,92,344386,90.53259726603575,9
0.05,3804,95,344481,90.53377135348227,6
0.05,3805,96,344577,90.53520756699947,6
0.05,3806,95,344672,90.53638035198318,6
0.05,3807,96,344768,90.53781512605042,6
0.05,3808,95,344863,90.53898661065897,6
0.05,3809,90,344953,90.53884514435696,11
0.05,3810,93,345046,90.53949094725793,8
0.05,3811,94,345140,90.54039874081847,7
0.05,3812,90,345230,90.54025701547339,12
0.05,3813,93,345323,90.54090194022024,8
0.05,3814,95,345418,90.54207077326343,6
0.05,3815,94,345512,90.54297693920336,7
0.05,3816,96,345608,90.5444066020435,6
0.05,3817,95,345703,90.54557359874279,6
0.05,3818,94,345797,90.5464781356376,7
0.05,3819,94,345891,90.54738219895287,7
0.05,3820,94,345985,90.54828578906046,7
0.05,3821,95,346080,90.54945054945055,6
0.05,3822,93,346173,90.55009155113785,8
0.05,3823,91,346264,90.55020920502092,10
0.05,3824,92,346356,90.55058823529411,9
0.05,3825,95,346451,90.5517511761631,6
0.05,3826,94,346545,90.55265220799582,7
0.05,3827,96,346641,90.55407523510972,6
0.05,3828,92,346733,90.5544528597545,9
0.05,3829,94,346827,90.55535248041775,7
0.05,3830,93,346920,90.55599060297573,8
0.05,3831,94,347014,90.55688935281837,8
0.05,3832,94,347108,90.55778763370728,7
0.05,3833,95,347203,90.55894627021388,6
0.05,3834,95,347298,90.56010430247719,6
0.05,3835,92,347390,90.56047966631908,9
0.05,3836,92,347482,90.56085483450613,9
0.05,3837,95,347577,90.56201146430432,6
0.05,3838,95,347672,90.56316749153426,6
0.05,3839,94,347766,90.5640625,7
0.05,3840,89,347855,90.56365529809945,12
0.05,3841,95,347950,90.56480999479437,8
0.05,3842,94,348044,90.56570387717929,7
0.05,3843,96,348140,90.56711758584808,6
0.05,3844,27,348167,90.55058517555267,6
0.05,3845,92,348259,90.55096203848154,9
0.05,3846,91,348350,90.55107876267222,10
0.05,3847,93,348443,90.55171517671518,8
0.05,3848,90,348533,90.55157183684074,11
0.05,3849,95,348628,90.55272727272727,6
0.05,3850,93,348721,90.55336276291872,8
0.05,3851,94,348815,90.55425752855659,8
0.05,3852,96,348911,90.5556709057877,6
0.05,3853,95,349006,90.55682407887909,6
0.05,3854,93,349099,90.557457846952,8
0.05,3855,91,349190,90.55757261410788,10
0.05,3856,96,349286,90.5589836660617,6
0.05,3857,90,349376,90.55883877656817,11
0.05,3858,94,349470,90.55973050012956,7
0.05,3859,94,349564,90.56062176165803,7
0.05,3860,95,349659,90.56177156177156,6
0.05,3861,90,349749,90.56162610046609,11
0.05,3862,94,349843,90.56251617913539,7
0.05,3863,96,349939,90.56392339544513,6
0.05,3864,96,350035,90.5653298835705,6
0.05,3865,92,350127,90.56570098292809,9
0.05,3866,92,350219,90.56607189035428,9
0.05,3867,96,350315,90.56747673216132,6
0.05,3868,92,350407,90.56784698888602,9
0.05,3869,95,350502,90.56899224806202,6
0.05,3870,95,350597,90.57013691552571,6
0.05,3871,90,350687,90.56998966942149,11
0.05,3872,95,350782,90.571133488252,6
0.05,3873,94,350876,90.5720185854414,7
0.05,3874,94,350970,90.57290322580646,7
0.05,3875,94,351064,90.57378740970073,7
0.05,3876,94,351158,90.57467113747744,7
0.05,3877,95,351253,90.57581227436823,7
0.05,3878,95,351348,90.5769528228925,6
0.05,3879,92,351440,90.57731958762886,9
0.05,3880,96,351536,90.57871682556042,6
0.05,3881,27,351563,90.5623390005152,6
0.05,3882,96,351659,90.56373937677054,6
0.05,3883,94,351753,90.56462409886714,8
0.05,3884,94,351847,90.56550836550836,7
0.05,3885,96,351943,90.56690684508492,6
0.05,3886,93,352036,90.56753280164651,8
0.05,3887,96,352132,90.56893004115226,6
0.05,3888,95,352227,90.5700694265878,6
0.05,3889,90,352317,90.56992287917738,11
0.05,3890,92,352409,90.57029041377538,9
0.05,3891,93,352502,90.57091469681397,8
0.05,3892,95,352597,90.57205240174673,6
0.05,3893,92,352689,90.57241910631741,9
0.05,3894,94,352783,90.57329910141206,7
0.05,3895,96,352879,90.57469199178645,6
0.05,3896,95,352974,90.57582755966128,6
0.05,3897,94,353068,90.5767060030785,7
0.05,3898,88,353156,90.57604513977942,13
0.05,3899,26,353182,90.55948717948718,6
0.05,3900,92,353274,90.55985644706486,10
0.05,3901,94,353368,90.56073808303434,7
0.05,3902,93,353461,90.56136305406098,8
0.05,3903,94,353555,90.56224385245902,7
0.05,3904,96,353651,90.56363636363636,6
0.05,3905,27,353678,90.547363031234,6
0.05,3906,96,353774,90.54875863834144,6
0.05,3907,93,353867,90.54938587512794,8
0.05,3908,92,353959,90.54975697109235,9
0.05,3909,96,354055,90.55115089514067,6
0.05,3910,95,354150,90.55228841728459,6
0.05,3911,90,354240,90.5521472392638,11
0.05,3912,91,354331,90.55226169179657,10
0.05,3913,94,354425,90.55314256515074,7
0.05,3914,94,354519,90.55402298850575,9
0.05,3915,94,354613,90.55490296220633,7
0.05,3916,95,354708,90.55603778401839,6
0.05,3917,91,354799,90.55615109749873,10
0.05,3918,94,354893,90.55702985455473,7
0.05,3919,94,354987,90.55790816326531,7
0.05,3920,91,355078,90.5580209130324,10
0.05,3921,96,355174,90.55940846506884,6
0.05,3922,91,355265,90.55952077491716,10
0.05,3923,92,355357,90.55988786952089,9
0.05,3924,95,355452,90.56101910828025,6
0.05,3925,94,355546,90.5618950585838,7
0.05,3926,95,355641,90.56302521008404,6
0.05,3927,91,355732,90.56313645621181,10
0.05,3928,95,355827,90.56426571646729,7
0.05,3929,92,355919,90.564631043257,9
0.05,3930,93,356012,90.56525057237344,8
0.05,3931,91,356103,90.56536113936927,10
0.05,3932,91,356194,90.56547165013984,12
0.05,3933,95,356289,90.5665988815455,7
0.05,3934,94,356383,90.56747141041932,7
0.05,3935,94,356477,90.56834349593495,7
0.05,3936,93,356570,90.56896113792227,8
0.05,3937,92,356662,90.56932453021838,9
0.05,3938,94,356756,90.57019548108657,7
0.05,3939,95,356851,90.57131979695431,6
0.05,3940,94,356945,90.57218979954327,7
0.05,3941,90,357035,90.57204464738712,11
0.05,3942,95,357130,90.57316763885366,6
0.05,3943,96,357226,90.57454361054766,6
0.05,3944,94,357320,90.57541191381496,7
0.05,3945,94,357414,90.57627977698935,7
0.05,3946,92,357506,90.5766404864454,9
0.05,3947,94,357600,90.5775075987842,7
0.05,3948,94,357694,90.57837427196759,7
0.05,3949,95,357789,90.57949367088608,6
0.05,3950,94,357883,90.58035940268286,7
0.05,3951,93,357976,90.58097165991903,9
0.05,3952,89,358065,90.58057171768277,12
0.05,3953,94,358159,90.58143651997976,7
0.05,3954,94,358253,90.58230088495576,7
0.05,3955,95,358348,90.58341759352882,6
0.05,3956,94,358442,90.58428102097548,8
0.05,3957,94,358536,90.58514401212734,7
0.05,3958,92,358628,90.58550138923971,9
0.05,3959,94,358722,90.58636363636364,7
0.05,3960,96,358818,90.58773037111841,6
0.05,3961,92,358910,90.58808682483594,12
0.05,3962,94,359004,90.5889477668433,7
0.05,3963,92,359096,90.58930373360242,9
0.05,3964,95,359191,90.5904161412358,6
0.05,3965,20,359211,90.57261724659607,13
0.05,3966,93,359304,90.57322914040837,8
0.05,3967,93,359397,90.57384072580645,10
0.05,3968,94,359491,90.57470395565633,7
0.05,3969,95,359586,90.57581863979848,6
0.05,3970,93,359679,90.57642911105515,8
0.05,3971,94,359773,90.57729103726082,7
0.05,3972,93,359866,90.5779008306066,8
0.05,3973,94,359960,90.5787619526925,7
0.05,3974,94,360054,90.57962264150943,7
0.05,3975,87,360141,90.57872233400403,14
0.05,3976,91,360232,90.57882826250943,11
0.05,3977,93,360325,90.57943690296632,8
0.05,3978,95,360420,90.58054787635085,7
0.05,3979,92,360512,90.58090452261307,9
0.05,3980,94,360606,90.58176337603618,7
0.05,3981,92,360698,90.58211953792065,9
0.05,3982,96,360794,90.58347978910369,6
0.05,3983,96,360890,90.58483935742971,6
0.05,3984,94,360984,90.58569636135508,7
0.05,3985,94,361078,90.58655293527346,8
0.05,3986,91,361169,90.5866566340607,10
0.05,3987,95,361264,90.58776328986961,6
0.05,3988,92,361356,90.58811732263725,9
0.05,3989,93,361449,90.58872180451128,8
0.05,3990,89,361538,90.58832372838887,12
0.05,3991,96,361634,90.58967935871743,6
0.05,3992,93,361727,90.59028299524168,8
0.05,3993,92,361819,90.5906359539309,9
0.05,3994,96,361915,90.59198998748435,6
0.05,3995,96,362011,90.59334334334335,6
0.05,3996,94,362105,90.59419564673505,7
0.05,3997,92,362197,90.59454727363682,9
0.05,3998,92,362289,90.59489872468117,9
0.05,3999,94,362383,90.59575,7
0.05,4000,95,362478,90.59685078730317,6
0.05,4001,93,362571,90.59745127436283,8
0.05,4002,27,362598,90.58156382712966,6
0.05,4003,92,362690,90.58191808191808,9
0.05,4004,95,362785,90.58302122347067,6
0.05,4005,92,362877,90.5833749375936,9
0.05,4006,94,362971,90.58422760169702,7
0.05,4007,95,363066,90.58532934131736,7
0.05,4008,93,363159,90.585931653779,8
0.05,4009,92,363251,90.5862842892768,9
0.05,4010,95,363346,90.58738469209673,7
0.05,4011,93,363439,90.58798604187437,8
0.05,4012,94,363533,90.58883628208324,7
0.05,4013,93,363626,90.58943697060289,8
0.05,4014,94,363720,90.59028642590286,7
0.05,4015,95,363815,90.5913844621514,6
0.05,4016,27,363842,90.57555389594225,6
0.05,4017,94,363936,90.57640617222499,7
0.05,4018,94,364030,90.57725802438418,7
0.05,4019,94,364124,90.57810945273631,9
0.05,4020,96,364220,90.5794578463069,6
0.05,4021,95,364315,90.58055693684734,6
0.05,4022,94,364409,90.58140691026597,7
0.05,4023,95,364504,90.58250497017893,6
0.05,4024,95,364599,90.58360248447205,7
0.05,4025,94,364693,90.58445106805763,8
0.05,4026,95,364788,90.58554755401043,6
0.05,4027,94,364882,90.58639523336643,8
0.05,4028,96,364978,90.58773889302556,7
0.05,4029,94,365072,90.58858560794044,8
0.05,4030,93,365165,90.58918382535352,8
0.05,4031,94,365259,90.59002976190476,7
0.05,4032,93,365352,90.59062732457228,8
0.05,4033,96,365448,90.5919682697075,6
0.05,4034,92,365540,90.59231722428748,9
0.05,4035,96,365636,90.59365708622398,6
0.05,4036,95,365731,90.59474857567501,8
0.05,4037,94,365825,90.59559187716691,7
0.05,4038,93,365918,90.59618717504333,8
0.05,4039,95,366013,90.59727722772277,6
0.05,4040,94,366107,90.59811927740658,7
0.05,4041,93,366200,90.59871350816428,10
0.05,4042,94,366294,90.59955478604996,7
0.05,4043,96,366390,90.60089020771514,6
0.05,4044,95,366485,90.60197775030902,6
0.05,4045,92,366577,90.60232328225408,9
0.05,4046,92,366669,90.60266864343959,9
0.05,4047,94,366763,90.60350790513834,7
0.05,4048,94,366857,90.60434675228451,8
0.05,4049,94,366951,90.60518518518519,7
0.05,4050,93,367044,90.60577635151814,8
0.05,4051,93,367137,90.60636722606121,8
0.05,4052,92,367229,90.60671107821366,9
0.05,4053,94,367323,90.60754810064134,7
0.05,4054,93,367416,90.60813810110974,9
0.05,4055,94,367510,90.60897435897436,7
0.05,4056,94,367604,90.60981020458466,7
0.05,4057,95,367699,90.61089206505667,6
0.05,4058,94,367793,90.61172702636117,7
0.05,4059,96,367889,90.61305418719212,6
0.05,4060,95,367984,90.61413444964295,6
0.05,4061,93,368077,90.61472181191532,8
0.05,4062,94,368171,90.61555500861432,7
0.05,4063,92,368263,90.61589566929133,11
0.05,4064,91,368354,90.6159901599016,10
0.05,4065,95,368449,90.61706837186424,6
0.05,4066,94,368543,90.61790017211705,7
0.05,4067,94,368637,90.61873156342183,7
0.05,4068,94,368731,90.61956254608012,7
0.05,4069,96,368827,90.62088452088452,6
0.05,4070,94,368921,90.62171456644559,7
0.05,4071,94,369015,90.6225442043222,7
0.05,4072,94,369109,90.62337343481464,7
0.05,4073,93,369202,90.62395679921453,8
0.05,4074,95,369297,90.62503067484663,8
0.05,4075,94,369391,90.62585868498527,8
0.05,4076,94,369485,90.62668628893795,7
0.05,4077,94,369579,90.62751348700343,7
0.05,4078,89,369668,90.62711448884531,12
0.05,4079,92,369760,90.62745098039215,9
0.05,4080,94,369854,90.62827738299437,8
0.05,4081,95,369949,90.62934835864772,8
0.05,4082,96,370045,90.63066372765124,6
0.05,4083,92,370137,90.63099902056807,9
0.05,4084,91,370228,90.63108935128518,10
0.05,4085,95,370323,90.63215859030836,6
0.05,4086,95,370418,90.6332273060925,6
0.05,4087,93,370511,90.63380626223092,8
0.05,4088,96,370607,90.63511861090731,6
0.05,4089,95,370702,90.6361858190709,7
0.05,4090,93,370795,90.63676362747495,8
0.05,4091,94,370889,90.63758553274683,7
0.05,4092,94,370983,90.63840703640362,7
0.05,4093,96,371079,90.63971665852468,6
0.05,4094,95,371174,90.64078144078144,6
0.05,4095,93,371267,90.641357421875,8
0.05,4096,96,371363,90.64266536490115,6
0.05,4097,94,371457,90.64348462664715,7
0.05,4098,94,371551,90.64430348865577,7
0.05,4099,96,371647,90.64560975609756,6
0.05,4100,94,371741,90.64642770056084,7
0.05,4101,96,371837,90.64773281326183,6
0.05,4102,95,371932,90.64879356568365,6
0.05,4103,93,372025,90.6493664717349,8
0.05,4104,94,372119,90.65018270401949,8
0.05,4105,94,372213,90.65099853872381,7
0.05,4106,94,372307,90.6518139761383,7
0.05,4107,94,372401,90.65262901655306,7
0.05,4108,92,372493,90.65295692382576,9
0.05,4109,93,372586,90.65352798053527,9
0.05,4110,96,372682,90.65482850887862,6
0.05,4111,93,372775,90.65539883268482,8
0.05,4112,90,372865,90.65523948456115,11
0.05,4113,20,372885,90.63806514341273,12
0.05,4114,96,372981,90.6393681652491,6
0.05,4115,94,373075,90.64018464528668,7
0.05,4116,93,373168,90.64075783337381,9
0.05,4117,93,373261,90.64133074307917,8
0.05,4118,95,373356,90.64238892935178,8
0.05,4119,94,373450,90.64320388349515,8
0.05,4120,92,373542,90.64353312302839,9
0.05,4121,18,373560,90.6259097525473,15
0.05,4122,91,373651,90.62600048508368,10
0.05,4123,94,373745,90.6268186226964,7
0.05,4124,95,373840,90.62787878787879,6
0.05,4125,94,373934,90.62869607367911,7
0.05,4126,94,374028,90.62951296341168,7
0.05,4127,94,374122,90.63032945736434,7
0.05,4128,95,374217,90.63138774521676,8
0.05,4129,93,374310,90.6319612590799,8
0.05,4130,94,374404,90.6327765674171,8
0.05,4131,96,374500,90.63407550822846,6
0.05,4132,93,374593,90.63464795548028,8
0.05,4133,93,374686,90.63522012578616,8
0.05,4134,95,374781,90.63627569528416,6
0.05,4135,93,374874,90.63684719535783,8
0.05,4136,95,374969,90.63790186125212,6
0.05,4137,90,375059,90.63774770420493,11
0.05,4138,93,375152,90.63831843440444,8
0.05,4139,93,375245,90.63888888888889,8
0.05,4140,95,375340,90.63994204298479,6
0.05,4141,92,375432,90.64027040077258,10
0.05,4142,90,375522,90.64011585807386,11
0.05,4143,94,375616,90.64092664092664,7
0.05,4144,94,375710,90.64173703256937,7
0.05,4145,93,375803,90.64230583695128,8
0.05,4146,92,375895,90.64263322884013,9
0.05,4147,93,375988,90.64320154291225,8
0.05,4148,91,376079,90.64328753916607,10
0.05,4149,96,376175,90.644578313253,6
0.05,4150,91,376266,90.64466393640086,10
0.05,4151,96,376362,90.64595375722543,6
0.05,4152,94,376456,90.6467613773176,7
0.05,4153,94,376550,90.64756860857005,7
0.05,4154,93,376643,90.64813477737665,8
0.05,4155,93,376736,90.64870067372473,9
0.05,4156,94,376830,90.6495068559057,7
0.05,4157,26,376856,90.63395863395863,6
0.05,4158,91,376947,90.63404664582832,10
0.05,4159,93,377040,90.63461538461539,8
0.05,4160,26,377066,90.61908195145398,8
0.05,4161,94,377160,90.61989428159539,8
0.05,4162,92,377252,90.62022579870286,10
0.05,4163,93,377345,90.62079731027858,8
0.05,4164,94,377439,90.62160864345738,7
0.05,4165,93,377532,90.6221795487278,8
0.05,4166,95,377627,90.62323014158868,6
0.05,4167,95,377722,90.62428023032629,7
0.05,4168,95,377817,90.62532981530343,6
0.05,4169,94,377911,90.62613908872902,7
0.05,4170,94,378005,90.62694797410693,7
0.05,4171,94,378099,90.6277564717162,7
0.05,4172,94,378193,90.6285645818356,7
0.05,4173,95,378288,90.62961188308577,6
0.05,4174,94,378382,90.63041916167664,7
0.05,4175,95,378477,90.63146551724138,7
0.05,4176,92,378569,90.6317931529806,9
0.05,4177,95,378664,90.63283867879368,6
0.05,4178,93,378757,90.63340512084231,8
0.05,4179,93,378850,90.63397129186603,8
0.05,4180,95,378945,90.63501554651997,6
0.05,4181,94,379039,90.63582018173123,7
0.05,4182,92,379131,90.63614630647861,9
0.05,4183,94,379225,90.63695028680688,7
0.05,4184,95,379320,90.63799283154121,6
0.05,4185,94,379414,90.63879598662207,7
0.05,4186,95,379509,90.63983759254836,7
0.05,4187,95,379604,90.64087870105062,6
0.05,4188,93,379697,90.64144187156839,8
0.05,4189,94,379791,90.64224343675417,8
0.05,4190,92,379883,90.64256740634693,9
0.05,4191,90,379973,90.64241412213741,11
0.05,4192,95,380068,90.64345337467208,7
0.05,4193,95,380163,90.6444921316166,6
0.05,4194,94,380257,90.64529201430274,7
0.05,4195,94,380351,90.64609151572927,7
0.05,4196,91,380442,90.64617583988563,10
0.05,4197,93,380535,90.6467365412101,8
0.05,4198,93,380628,90.64729697547035,8
0.05,4199,95,380723,90.64833333333333,6
0.05,4200,90,380813,90.64817900499881,11
0.05,4201,93,380906,90.64873869585911,9
0.05,4202,96,381002,90.65001189626457,6
0.05,4203,94,381096,90.65080875356803,8
0.05,4204,96,381192,90.65208085612366,6
0.05,4205,93,381285,90.65263908701854,9
0.05,4206,94,381379,90.65343475160446,7
0.05,4207,93,381472,90.65399239543726,9
0.05,4208,94,381566,90.65478736041815,7
0.05,4209,94,381660,90.65558194774347,7
0.05,4210,93,381753,90.656138684398,8
0.05,4211,96,381849,90.6574074074074,6
0.05,4212,91,381940,90.65748872537384,10
0.05,4213,94,382034,90.65828191741814,7
0.05,4214,94,382128,90.65907473309609,7
0.05,4215,92,382220,90.65939278937381,9
0.05,4216,96,382316,90.660659236424,6
0.05,4217,95,382411,90.66168800379327,7
0.05,4218,92,382503,90.66200521450581,9
0.05,4219,94,382597,90.6627962085308,7
0.05,4220,94,382691,90.66358682776593,7
0.05,4221,93,382784,90.66414021790621,9
0.05,4222,94,382878,90.66493014444707,7
0.05,4223,94,382972,90.6657196969697,7
0.05,4224,95,383067,90.66674556213017,7
0.05,4225,94,383161,90.66753431140559,7
0.05,4226,92,383253,90.66784953867992,9
0.05,4227,91,383344,90.66792809839167,10
0.05,4228,27,383371,90.65287301962638,6
0.05,4229,93,383464,90.65342789598108,9
0.05,4230,91,383555,90.6535098085559,10
0.05,4231,94,383649,90.65430056710775,7
0.05,4232,94,383743,90.65509095204347,7
0.05,4233,94,383837,90.65588096362778,7
0.05,4234,92,383929,90.65619834710743,9
0.05,4235,92,384021,90.65651558073654,9
0.05,4236,89,384110,90.65612461647392,12
0.05,4237,95,384205,90.65714959886739,7
0.05,4238,95,384300,90.65817409766454,6
0.05,4239,93,384393,90.65872641509434,8
0.05,4240,96,384489,90.6599858523933,6
0.05,4241,90,384579,90.65983026874116,11
0.05,4242,94,384673,90.66061748762668,7
0.05,4243,95,384768,90.66163996229972,6
0.05,4244,96,384864,90.66289752650177,6
0.05,4245,95,384959,90.66391898257183,6
0.05,4246,92,385051,90.66423357664233,9
0.05,4247,95,385146,90.66525423728814,6
0.05,4248,95,385241,90.66627441751,6
0.05,4249,95,385336,90.66729411764706,6
0.05,4250,96,385432,90.66854857680546,6
0.05,4251,94,385526,90.66933207902164,7
0.05,4252,90,385616,90.66917470021161,11
0.05,4253,93,385709,90.66972261401034,8
0.05,4254,94,385803,90.67050528789659,7
0.05,4255,94,385897,90.67128759398496,7
0.05,4256,95,385992,90.6723044397463,6
0.05,4257,96,386088,90.67355565993424,6
0.05,4258,92,386180,90.67386710495421,9
0.05,4259,96,386276,90.67511737089202,6
0.05,4260,95,386371,90.676132363295,6
0.05,4261,94,386465,90.676912247771,7
0.05,4262,94,386559,90.67769176636172,7
0.05,4263,94,386653,90.67847091932458,7
0.05,4264,95,386748,90.67948417350527,6
0.05,4265,94,386842,90.68026254102203,7
0.05,4266,92,386934,90.68057183032576,9
0.05,4267,95,387029,90.6815838800375,6
0.05,4268,93,387122,90.68212696181776,8
0.05,4269,93,387215,90.68266978922716,9
0.05,4270,92,387307,90.68297822523999,10
0.05,4271,96,387403,90.68422284644194,6
0.05,4272,96,387499,90.68546688509244,6
0.05,4273,94,387593,90.68624239588208,7
0.05,4274,94,387687,90.68701754385965,7
0.05,4275,95,387782,90.68802619270346,6
0.05,4276,94,387876,90.688800561141,7
0.05,4277,96,387972,90.69004207573633,6
0.05,4278,89,388061,90.68964711381163,12
0.05,4279,95,388156,90.69065420560747,7
0.05,4280,92,388248,90.69096005606167,9
0.05,4281,94,388342,90.69173283512377,7
0.05,4282,96,388438,90.69297221573663,6
0.05,4283,93,388531,90.69351073762839,8
0.05,4284,94,388625,90.69428238039673,7
0.05,4285,94,388719,90.69505366308913,7
0.05,4286,94,388813,90.69582458595755,7
0.05,4287,92,388905,90.69612873134328,9
0.05,4288,95,389000,90.69713219864771,6
0.05,4289,94,389094,90.6979020979021,7
0.05,4290,93,389187,90.69843859240271,8
0.05,4291,94,389281,90.69920782851817,7
0.05,4292,95,389376,90.70020964360587,6
0.05,4293,88,389464,90.69958081043316,13
0.05,4294,25,389489,90.68428405122235,7
0.05,4295,94,389583,90.68505586592178,8
0.05,4296,93,389676,90.68559460088434,8
0.05,4297,93,389769,90.68613308515589,8
0.05,4298,92,389861,90.68643870667597,10
0.05,4299,94,389955,90.68720930232558,7
0.05,4300,93,390048,90.68774703557312,9
0.05,4301,93,390141,90.68828451882845,8
0.05,4302,94,390235,90.68905414826865,7
0.05,4303,96,390331,90.69028810408922,6
0.05,4304,92,390423,90.69059233449477,9
0.05,4305,92,390515,90.69089642359498,9
0.05,4306,96,390611,90.69212909217553,6
0.05,4307,27,390638,90.67734447539462,6
0.05,4308,92,390730,90.6776514272453,9
0.05,4309,95,390825,90.67865429234338,6
0.05,4310,94,390919,90.67942472744143,8
0.05,4311,93,391012,90.6799628942486,8
0.05,4312,94,391106,90.6807326686761,7
0.05,4313,94,391200,90.68150208623088,7
0.05,4314,95,391295,90.68250289687138,6
0.05,4315,94,391389,90.68327154772938,7
0.05,4316,93,391482,90.68380820013898,8
0.05,4317,27,391509,90.66905974988421,6
0.05,4318,90,391599,90.66890483908313,11
0.05,4319,93,391692,90.66944444444445,8
0.05,4320,95,391787,90.6704466558667,6
0.05,4321,93,391880,90.67098565478945,8
0.05,4322,95,391975,90.67198704603285,8
0.05,4323,94,392069,90.672756706753,7
0.05,4324,94,392163,90.6735260115607,7
0.05,4325,96,392259,90.6747572815534,6
0.05,4326,94,392353,90.67552576843079,7
0.05,4327,93,392446,90.67606284658041,8
0.05,4328,94,392540,90.67683067683068,7
0.05,4329,94,392634,90.67759815242495,7
0.05,4330,93,392727,90.67813438005079,8
0.05,4331,92,392819,90.67843951985226,9
0.05,4332,94,392913,90.67920609277637,7
0.05,4333,93,393006,90.67974157821874,8
0.05,4334,94,393100,90.6805074971165,7
0.05,4335,95,393195,90.6815036900369,6
0.05,4336,95,393290,90.68249942356468,6
0.05,4337,93,393383,90.6830336560627,8
0.05,4338,95,393478,90.68402857801337,6
0.05,4339,96,393574,90.6852534562212,6
0.05,4340,95,393669,90.68624740843124,6
0.05,4341,95,393764,90.68724090280976,7
0.05,4342,27,393791,90.67257655998158,6
0.05,4343,95,393886,90.67357274401473,6
0.05,4344,94,393980,90.67433831990795,7
0.05,4345,94,394074,90.67510354348826,8
0.05,4346,95,394169,90.67609845870716,6
0.05,4347,93,394262,90.67663293468262,8
0.05,4348,94,394356,90.67739710278225,7
0.05,4349,95,394451,90.6783908045977,6
0.05,4350,94,394545,90.67915421742129,7
0.05,4351,93,394638,90.6796875,8
0.05,4352,94,394732,90.68045026418562,7
0.05,4353,95,394827,90.68144235186035,7
0.05,4354,92,394919,90.68174512055108,9
0.05,4355,92,395011,90.68204775022957,9
0.05,4356,94,395105,90.68280927243516,7
0.05,4357,95,395200,90.68379990821478,6
0.05,4358,95,395295,90.68479008947006,6
0.05,4359,95,395390,90.68577981651376,6
0.05,4360,95,395485,90.68676908965834,7
0.05,4361,92,395577,90.68707015130674,9
0.05,4362,94,395671,90.68782947513179,9
0.05,4363,94,395765,90.68858845096241,7
0.05,4364,93,395858,90.68911798396334,8
0.05,4365,94,395952,90.68987631699495,7
0.05,4366,24,395976,90.67460499198535,10
0.05,4367,94,396070,90.6753663003663,7
0.05,4368,96,396166,90.67658503089952,6
0.05,4369,93,396259,90.67711670480548,8
0.05,4370,94,396353,90.67787691603752,7
0.05,4371,95,396448,90.67886550777676,7
0.05,4372,93,396541,90.67939629544935,8
0.05,4373,90,396631,90.67924096936443,11
0.05,4374,91,396722,90.67931428571428,10
0.05,4375,94,396816,90.6800731261426,7
0.05,4376,94,396910,90.68083161983094,7
0.05,4377,92,397002,90.68113293741435,9
0.05,4378,94,397096,90.68189084265813,7
0.05,4379,95,397191,90.68287671232876,7
0.05,4380,95,397286,90.68386213193335,6
0.05,4381,93,397379,90.68439068918302,8
0.05,4382,95,397474,90.68537531371207,6
0.05,4383,94,397568,90.68613138686132,7
0.05,4384,96,397664,90.68734321550741,6
0.05,4385,90,397754,90.68718650250798,11
0.05,4386,95,397849,90.68816959197629,6
0.05,4387,91,397940,90.68824065633547,10
0.05,4388,91,398031,90.68831168831169,12
0.05,4389,95,398126,90.68929384965831,7
0.05,4390,94,398220,90.69004782509678,7
0.05,4391,96,398316,90.69125683060109,6
0.05,4392,95,398411,90.69223765080811,6
0.05,4393,95,398506,90.69321802457897,7
0.05,4394,95,398601,90.69419795221843,7
0.05,4395,94,398695,90.6949499545041,7
0.05,4396,92,398787,90.69524675915397,9
0.05,4397,95,398882,90.6962255570714,6
0.05,4398,94,398976,90.69697658558763,7
0.05,4399,94,399070,90.69772727272728,7
0.05,4400,93,399163,90.6982503976369,8
0.05,4401,92,399255,90.6985461154021,9
0.05,4402,93,399348,90.69906881671588,8
0.05,4403,94,399442,90.69981834695731,8
0.05,4404,95,399537,90.70079455164586,6
0.05,4405,92,399629,90.7010894235134,9
0.05,4406,94,399723,90.70183798502383,7
0.05,4407,94,399817,90.70258620689656,7
0.05,4408,94,399911,90.70333408936267,7
0.05,4409,95,400006,90.70430839002267,6
0.05,4410,95,400101,90.70528224892314,6
0.05,4411,88,400189,90.7046690843155,13
0.05,4412,93,400282,90.70518921368684,8
0.05,4413,93,400375,90.70570910738559,8
0.05,4414,93,400468,90.70622876557191,8
0.05,4415,93,400561,90.7067481884058,8
0.05,4416,95,400656,90.70772017206248,6
0.05,4417,94,400750,90.70846536894523,7
0.05,4418,94,400844,90.7092102285585,9
0.05,4419,93,400937,90.70972850678733,8
0.05,4420,94,401031,90.71047274372314,9
0.05,4421,94,401125,90.71121664405247,7
0.05,4422,93,401218,90.71173411711509,9
0.05,4423,93,401311,90.7122513562387,8
0.05,4424,91,401402,90.7123163841808,12
0.05,4425,94,401496,90.713059195662,7
0.05,4426,93,401589,90.71357578495595,9
0.05,4427,92,401681,90.71386630532972,9
0.05,4428,94,401775,90.71460826371641,9
0.05,4429,92,401867,90.71489841986455,9
0.05,4430,96,401963,90.71609117580681,6
0.05,4431,92,402055,90.716380866426,9
0.05,4432,94,402149,90.71712158808933,7
0.05,4433,93,402242,90.71763644564727,8
0.05,4434,94,402336,90.71837655016911,7
0.05,4435,95,402431,90.71934174932372,6
0.05,4436,95,402526,90.72030651340997,7
0.05,4437,93,402619,90.72082018927445,8
0.05,4438,94,402713,90.72155890966434,7
0.05,4439,27,402740,90.7072072072072,6
0.05,4440,96,402836,90.70839900923215,6
0.05,4441,96,402932,90.70959027465106,6
0.05,4442,95,403027,90.71055593067747,7
0.05,4443,94,403121,90.71129612961296,7
0.05,4444,93,403214,90.71181102362205,8
0.05,4445,94,403308,90.71255060728745,7
0.05,4446,91,403399,90.71261524623341,10
0.05,4447,94,403493,90.71335431654676,8
0.05,4448,95,403588,90.71431782423016,6
0.05,4449,95,403683,90.7152808988764,6
0.05,4450,92,403775,90.71556953493597,9
0.05,4451,93,403868,90.71608265947889,9
0.05,4452,88,403956,90.71547271502358,13
0.05,4453,93,404049,90.71598563089358,8
0.05,4454,93,404142,90.71649831649832,8
0.05,4455,94,404236,90.71723518850987,8
0.05,4456,86,404322,90.71617680053848,16
0.05,4457,94,404416,90.71691341408703,7
0.05,4458,95,404511,90.71787396277192,6
0.05,4459,91,404602,90.71793721973094,10
0.05,4460,94,404696,90.71867294328626,7
0.05,4461,96,404792,90.71985656656209,6
0.05,4462,93,404885,90.72036746583017,8
0.05,4463,94,404979,90.72110215053763,7
0.05,4464,96,405075,90.72228443449048,6
0.05,4465,94,405169,90.7230183609494,8
0.05,4466,89,405258,90.72263263935527,12
0.05,4467,90,405348,90.7224709042077,11
0.05,4468,93,405441,90.72298053255761,8
0.05,4469,95,405536,90.72393736017897,6
0.05,4470,94,405630,90.72467009617536,7
0.05,4471,94,405724,90.72540250447227,7
0.05,4472,95,405819,90.72635814889335,6
0.05,4473,96,405915,90.72753687974966,6
0.05,4474,96,406011,90.72871508379889,6
0.05,4475,93,406104,90.72922252010724,8
0.05,4476,94,406198,90.72995309358946,7
0.05,4477,90,406288,90.72979008485932,11
0.05,4478,94,406382,90.730520205403,7
0.05,4479,91,406473,90.73058035714286,10
0.05,4480,93,406566,90.73108681097969,8
0.05,4481,27,406593,90.71686746987952,6
0.05,4482,96,406689,90.71804595137185,6
0.05,4483,96,406785,90.7192239072257,6
0.05,4484,89,406874,90.71884057971015,12
0.05,4485,92,406966,90.71912617030762,9
0.05,4486,94,407060,90.7198573657232,8
0.05,4487,92,407152,90.72014260249554,9
0.05,4488,94,407246,90.72087324571174,7
0.05,4489,94,407340,90.72160356347439,7
0.05,4490,94,407434,90.72233355600089,8
0.05,4491,96,407530,90.72350845948353,6
0.05,4492,94,407624,90.7242377030937,7
0.05,4493,95,407719,90.725189141077,7
0.05,4494,91,407810,90.72525027808676,10
0.05,4495,94,407904,90.72597864768683,7
0.05,4496,95,407999,90.72692906382032,8
0.05,4497,94,408093,90.72765673632726,7
0.05,4498,95,408188,90.72860635696821,6
0.05,4499,94,408282,90.72933333333333,7
0.05,4500,92,408374,90.72961564096867,9
0.05,4501,94,408468,90.73034207019103,8
0.05,4502,94,408562,90.73106817677105,7
0.05,4503,95,408657,90.73201598579041,6
0.05,4504,95,408752,90.73296337402886,6
0.05,4505,96,408848,90.734132268087,6
0.05,4506,94,408942,90.73485688928334,7
0.05,4507,94,409036,90.73558118899734,7
0.05,4508,94,409130,90.7363051674429,7
0.05,4509,94,409224,90.7370288248337,7
0.05,4510,96,409320,90.7381955220572,6
0.05,4511,94,409414,90.73891843971631,7
0.05,4512,93,409507,90.73941945490805,9
0.05,4513,90,409597,90.73925564909172,12
0.05,4514,21,409618,90.72380952380952,11
0.05,4515,94,409712,90.7245349867139,8
0.05,4516,96,409808,90.72570290015497,6
0.05,4517,96,409904,90.72687029659141,6
0.05,4518,95,409999,90.7278158884709,6
0.05,4519,92,410091,90.72809734513274,9
0.05,4520,95,410186,90.72904224729042,6
0.05,4521,95,410281,90.72998673153472,6
0.05,4522,94,410375,90.73070970594738,7
0.05,4523,93,410468,90.73121131741821,8
0.05,4524,96,410564,90.73237569060774,6
0.05,4525,93,410657,90.73287671232876,9
0.05,4526,96,410753,90.73404020322509,6
0.05,4527,96,410849,90.73520318021201,6
0.05,4528,92,410941,90.73548244645617,9
0.05,4529,95,411036,90.7364238410596,7
0.05,4530,95,411131,90.73736482012801,6
0.05,4531,92,411223,90.73764342453663,9
0.05,4532,94,411317,90.73836311493493,7
0.05,4533,94,411411,90.73908248786942,7
0.05,4534,90,411501,90.73891951488423,11
0.05,4535,95,411596,90.73985890652557,6
0.05,4536,94,411690,90.74057747410183,7
0.05,4537,92,411782,90.74085500220362,9
0.05,4538,93,411875,90.74135272086363,9
0.05,4539,94,411969,90.7420704845815,7
0.05,4540,96,412065,90.74322836379652,6
0.05,4541,95,412160,90.74416556583003,6
0.05,4542,93,412253,90.74466211754347,8
0.05,4543,94,412347,90.74537852112677,7
0.05,4544,95,412442,90.74631463146315,6
0.05,4545,93,412535,90.74681038275406,9
0.05,4546,95,412630,90.74774576643941,6
0.05,4547,93,412723,90.74824098504837,8
0.05,4548,96,412819,90.74939547153221,6
0.05,4549,90,412909,90.74923076923076,12
0.05,4550,91,413000,90.74928587123709,10
0.05,4551,93,413093,90.74978031634447,9
0.05,4552,95,413188,90.75071381506699,6
0.05,4553,94,413282,90.75142731664471,7
0.05,4554,91,413373,90.75148188803513,10
0.05,4555,96,413469,90.75263388937664,6
0.05,4556,95,413564,90.75356594250603,6
0.05,4557,92,413656,90.75383940324704,9
0.05,4558,93,413749,90.7543320903707,8
0.05,4559,93,413842,90.75482456140351,8
0.05,4560,90,413932,90.7546590659943,11
0.05,4561,93,414025,90.755151249452,9
0.05,4562,92,414117,90.75542406311637,9
0.05,4563,94,414211,90.75613496932516,7
0.05,4564,94,414305,90.75684556407448,7
0.05,4565,93,414398,90.75733683749452,8
0.05,4566,92,414490,90.75760893365448,9
0.05,4567,90,414580,90.75744308231174,11
0.05,4568,95,414675,90.75837163493105,6
0.05,4569,94,414769,90.75908096280088,7
0.05,4570,96,414865,90.76022752133012,6
0.05,4571,95,414960,90.76115485564304,6
0.05,4572,95,415055,90.76208178438662,6
0.05,4573,95,415150,90.76300830782685,6
0.05,4574,94,415244,90.76371584699453,9
0.05,4575,93,415337,90.76420454545455,8
0.05,4576,93,415430,90.76469303036924,8
0.05,4577,95,415525,90.76561817387505,6
0.05,4578,95,415620,90.76654291329984,8
0.05,4579,94,415714,90.76724890829695,7
0.05,4580,96,415810,90.76839118096485,6
0.05,4581,92,415902,90.76865997381056,9
0.05,4582,96,415998,90.76980144010473,6
0.05,4583,96,416094,90.77094240837697,6
0.05,4584,94,416188,90.77164667393674,8
0.05,4585,94,416282,90.77235063235935,8
0.05,4586,94,416376,90.77305428384565,9
0.05,4587,94,416470,90.77375762859634,7
0.05,4588,94,416564,90.77446066681195,8
0.05,4589,94,416658,90.77516339869281,9
0.05,4590,96,416754,90.77630145937704,6
0.05,4591,87,416841,90.77547909407666,14
0.05,4592,95,416936,90.77639886784237,6
0.05,4593,96,417032,90.77753591641272,6
0.05,4594,96,417128,90.77867247007617,6
0.05,4595,96,417224,90.77980852915579,6
0.05,4596,96,417320,90.78094409397433,6
0.05,4597,92,417412,90.78120922140062,9
0.05,4598,93,417505,90.78169167210262,8
0.05,4599,93,417598,90.78217391304348,8
0.05,4600,95,417693,90.7830906324712,6
0.05,4601,95,417788,90.78400695349848,6
0.05,4602,92,417880,90.78427112752553,9
0.05,4603,96,417976,90.78540399652476,6
0.05,4604,96,418072,90.78653637350706,6
0.05,4605,26,418098,90.77247069040382,7
0.05,4606,93,418191,90.77295420013024,8
0.05,4607,96,418287,90.77408854166667,6
0.05,4608,95,418382,90.7750054241701,6
0.05,4609,92,418474,90.77527114967462,10
0.05,4610,93,418567,90.77575363261765,8
0.05,4611,94,418661,90.77645273200346,7
0.05,4612,89,418750,90.77606763494472,13
0.05,4613,95,418845,90.77698309492848,6
0.05,4614,96,418941,90.77811484290358,6
0.05,4615,94,419035,90.77881282495667,7
0.05,4616,27,419062,90.7649989170457,6
0.05,4617,93,419155,90.76548289302728,8
0.05,4618,95,419250,90.76639965360468,6
0.05,4619,26,419276,90.75238095238095,8
0.05,4620,96,419372,90.75351655485825,6
0.05,4621,94,419466,90.75421895283426,7
0.05,4622,94,419560,90.75492104693922,7
0.05,4623,93,419653,90.75540657439447,8
0.05,4624,95,419748,90.75632432432432,6
0.05,4625,95,419843,90.75724167747514,6
0.05,4626,94,419937,90.75794251134644,7
0.05,4627,94,420031,90.75864304235091,7
0.05,4628,94,420125,90.75934327068481,8
0.05,4629,95,420220,90.76025917926566,6
0.05,4630,96,420316,90.761390628374,6
0.05,4631,94,420410,90.76208981001727,8
0.05,4632,95,420505,90.7630045327002,6
0.05,4633,93,420598,90.76348726801899,8
0.05,4634,94,420692,90.76418554476807,7
0.05,4635,93,420785,90.76466781708369,8
0.05,4636,94,420879,90.7653655380634,7
0.05,4637,94,420973,90.76606295817163,7
0.05,4638,95,421068,90.76697564130201,6
0.05,4639,92,421160,90.76724137931035,9
0.05,4640,94,421254,90.76793794440853,8
0.05,4641,25,421279,90.75376992675571,8
0.05,4642,95,421374,90.75468447124703,6
0.05,4643,93,421467,90.75516795865633,8
0.05,4644,94,421561,90.75586652314317,7
0.05,4645,94,421655,90.75656478691347,7
0.05,4646,91,421746,90.75661717236927,10
0.05,4647,94,421840,90.75731497418245,8
0.05,4648,96,421936,90.75844267584426,6
0.05,4649,94,422030,90.75913978494624,7
0.05,4650,94,422124,90.7598365942808,7
0.05,4651,91,422215,90.75988822012037,10
0.05,4652,96,422311,90.76101439931227,6
0.05,4653,94,422405,90.76171035668243,7
0.05,4654,92,422497,90.76197636949517,9
0.05,4655,26,422523,90.74806701030928,8
0.05,4656,93,422616,90.74855056903586,8
0.05,4657,94,422710,90.74924860455131,7
0.05,4658,93,422803,90.74973170208199,8
0.05,4659,94,422897,90.75042918454936,7
0.05,4660,94,422991,90.75112636773224,7
0.05,4661,94,423085,90.75182325182325,7
0.05,4662,96,423181,90.75294874544285,6
0.05,4663,93,423274,90.75343053173242,8
0.05,4664,94,423368,90.75412647374063,7
0.05,4665,93,423461,90.75460780111445,8
0.05,4666,94,423555,90.7553031926291,7
0.05,4667,92,423647,90.75556983718937,9
0.05,4668,92,423739,90.75583636753052,9
0.05,4669,96,423835,90.75695931477516,6
0.05,4670,92,423927,90.75722543352602,9
0.05,4671,96,424023,90.75834760273973,6
0.05,4672,95,424118,90.75925529638349,6
0.05,4673,94,424212,90.7599486521181,7
0.05,4674,94,424306,90.76064171122995,7
0.05,4675,93,424399,90.76112061591104,8
0.05,4676,94,424493,90.76181312807356,7
0.05,4677,93,424586,90.76229157759727,10
0.05,4678,94,424680,90.7629835434922,7
0.05,4679,93,424773,90.76346153846154,8
0.05,4680,94,424867,90.7641529587695,7
0.05,4681,92,424959,90.76441691584793,10
0.05,4682,92,425051,90.76468076019646,10
0.05,4683,95,425146,90.76558497011102,6
0.05,4684,96,425242,90.7667022411953,6
0.05,4685,93,425335,90.76717883055912,12
0.05,4686,94,425429,90.76786857264774,7
0.05,4687,93,425522,90.7683447098976,8
0.05,4688,92,425614,90.76860737897206,9
0.05,4689,91,425705,90.76865671641791,10
0.05,4690,95,425800,90.76955872948199,6
0.05,4691,90,425890,90.7693947144075,11
0.05,4692,96,425986,90.77050926912423,6
0.05,4693,96,426082,90.77162334895611,6
0.05,4694,88,426170,90.77103301384452,13
0.05,4695,25,426195,90.75702725724021,8
0.05,4696,93,426288,90.75750479029168,8
0.05,4697,94,426382,90.75819497658578,7
0.05,4698,95,426477,90.75909768035753,6
0.05,4699,95,426572,90.76,8
0.05,4700,95,426667,90.76090193575835,6
0.05,4701,24,426691,90.74670353041259,9
0.05,4702,96,426787,90.7478205400808,6
0.05,4703,94,426881,90.7485119047619,7
0.05,4704,92,426973,90.74877789585547,9
0.05,4705,96,427069,90.74989375265618,6
0.05,4706,91,427160,90.74994688761419,10
0.05,4707,92,427252,90.75021240441801,9
0.05,4708,95,427347,90.75111488638777,6
0.05,4709,93,427440,90.7515923566879,8
0.05,4710,95,427535,90.75249416259817,6
0.05,4711,92,427627,90.75275891341256,9
0.05,4712,95,427722,90.75366008911521,6
0.05,4713,95,427817,90.75456088247772,7
0.05,4714,21,427838,90.73976670201485,11
0.05,4715,94,427932,90.74045801526718,8
0.05,4716,95,428027,90.74136103455587,6
0.05,4717,94,428121,90.74205171682917,7
0.05,4718,96,428217,90.74316592498411,6
0.05,4719,87,428304,90.74237288135593,14
0.05,4720,94,428398,90.74306291040034,7
0.05,4721,94,428492,90.7437526471834,8
0.05,4722,94,428586,90.74444209189075,7
0.05,4723,93,428679,90.74491955969518,8
0.05,4724,93,428772,90.74539682539682,9
0.05,4725,94,428866,90.74608548455353,7
0.05,4726,94,428960,90.74677385233764,7
0.05,4727,92,429052,90.74703891708968,9
0.05,4728,90,429142,90.74688094734616,11
0.05,4729,94,429236,90.7475687103594,7
0.05,4730,92,429328,90.74783343901923,9
0.05,4731,90,429418,90.74767540152156,11
0.05,4732,27,429445,90.73420663427002,6
0.05,4733,95,429540,90.73510773130545,6
0.05,4734,27,429567,90.72164730728616,6
0.05,4735,94,429661,90.72233952702703,7
0.05,4736,96,429757,90.72345366265569,6
0.05,4737,94,429851,90.72414520894893,7
0.05,4738,93,429944,90.72462544840684,8
0.05,4739,92,430036,90.72489451476794,9
0.05,4740,96,430132,90.7260071714828,6
0.05,4741,92,430224,90.72627583298187,9
0.05,4742,94,430318,90.7269660552393,7
0.05,4743,94,430412,90.72765598650928,7
0.05,4744,86,430498,90.72665964172813,15
0.05,4745,94,430592,90.72734934681837,8
0.05,4746,94,430686,90.72803876132294,7
0.05,4747,94,430780,90.72872788542544,7
0.05,4748,95,430875,90.72962728995579,7
0.05,4749,90,430965,90.72947368421053,11
0.05,4750,93,431058,90.72995158913913,8
0.05,4751,94,431152,90.73063973063974,7
0.05,4752,94,431246,90.73132758257942,7
0.05,4753,93,431339,90.7318047959613,8
0.05,4754,95,431434,90.73270241850683,6
0.05,4755,92,431526,90.73296888141296,9
0.05,4756,96,431622,90.73407609838134,6
0.05,4757,90,431712,90.73392181588903,11
0.05,4758,95,431807,90.73481823912587,6
0.05,4759,95,431902,90.73571428571428,7
0.05,4760,94,431996,90.73639991598404,7
0.05,4761,94,432090,90.73708525829484,8
0.05,4762,94,432184,90.73777031282805,7
0.05,4763,92,432276,90.73803526448363,9
0.05,4764,95,432371,90.73892969569779,7
0.05,4765,92,432463,90.7391942929081,9
0.05,4766,94,432557,90.7398783301867,8
0.05,4767,95,432652,90.74077181208054,6
0.05,4768,95,432747,90.74166491927029,6
0.05,4769,92,432839,90.741928721174,9
0.05,4770,95,432934,90.74282121148606,6
0.05,4771,94,433028,90.74350377200335,7
0.05,4772,92,433120,90.74376702283679,9
0.05,4773,93,433213,90.7442396313364,8
0.05,4774,94,433307,90.74492146596859,7
0.05,4775,94,433401,90.74560301507537,9
0.05,4776,95,433496,90.74649361523969,8
0.05,4777,95,433591,90.74738384261197,6
0.05,4778,96,433687,90.74848294622306,6
0.05,4779,93,433780,90.7489539748954,10
0.05,4780,92,433872,90.7492156452625,9
0.05,4781,92,433964,90.74947720618988,9
0.05,4782,95,434059,90.75036587915534,7
0.05,4783,88,434147,90.74979096989966,13
0.05,4784,95,434242,90.75067920585163,6
0.05,4785,93,434335,90.75114918512328,8
0.05,4786,92,434427,90.7514100689367,9
0.05,4787,93,434520,90.75187969924812,8
0.05,4788,93,434613,90.75234913343078,8
0.05,4789,95,434708,90.75323590814196,6
0.05,4790,22,434730,90.73888541014402,10
0.05,4791,95,434825,90.73977462437395,6
0.05,4792,96,434921,90.74087210515334,6
0.05,4793,94,435015,90.7415519399249,7
0.05,4794,93,435108,90.74202294056309,8
0.05,4795,92,435200,90.74228523769808,10
0.05,4796,94,435294,90.74296435272045,7
0.05,4797,91,435385,90.74301792413506,10
0.05,4798,94,435479,90.74369660345906,7
0.05,4799,92,435571,90.74395833333334,9
0.05,4800,94,435665,90.7446365340554,7
0.05,4801,96,435761,90.7457309454394,6
0.05,4802,92,435853,90.74599208827816,9
0.05,4803,96,435949,90.74708576186511,6
0.05,4804,93,436042,90.74755463059313,8
0.05,4805,94,436136,90.74823137744487,7
0.05,4806,93,436229,90.74869981277304,8
0.05,4807,95,436324,90.7495840266223,7
0.05,4808,94,436418,90.75025992929923,7
0.05,4809,96,436514,90.75135135135135,6
0.05,4810,90,436604,90.75119517771773,11
0.05,4811,96,436700,90.7522859517872,6
0.05,4812,93,436793,90.75275296073136,8
0.05,4813,89,436882,90.75238886580806,12
0.05,4814,90,436972,90.75223260643821,11
0.05,4815,94,437066,90.75290697674419,7
0.05,4816,94,437160,90.75358106705418,7
0.05,4817,94,437254,90.75425487754255,7
0.05,4818,94,437348,90.75492840838348,7
0.05,4819,94,437442,90.75560165975104,7
0.05,4820,92,437534,90.7558597801286,9
0.05,4821,95,437629,90.7567399419328,6
0.05,4822,94,437723,90.75741239892183,8
0.05,4823,96,437819,90.7584991708126,6
0.05,4824,95,437914,90.75937823834197,6
0.05,4825,92,438006,90.75963530874431,9
0.05,4826,92,438098,90.75989227263311,9
0.05,4827,95,438193,90.76077050538525,6
0.05,4828,94,438287,90.761441292193,7
0.05,4829,96,438383,90.76252587991718,6
0.05,4830,94,438477,90.76319602566757,7
0.05,4831,27,438504,90.75,6
0.05,4832,94,438598,90.75067246016967,7
0.05,4833,94,438692,90.75134464211833,7
0.05,4834,93,438785,90.75180972078594,8
0.05,4835,93,438878,90.75227460711332,8
0.05,4836,96,438974,90.75335952036386,6
0.05,4837,92,439066,90.75361719718892,9
0.05,4838,96,439162,90.7547013845836,6
0.05,4839,93,439255,90.7551652892562,8
0.05,4840,93,439348,90.75562900227226,8
0.05,4841,93,439441,90.75609252375051,9
0.05,4842,96,439537,90.75717530456329,6
0.05,4843,96,439633,90.75825763831544,6
0.05,4844,27,439660,90.74509803921569,8
0.05,4845,95,439755,90.74597606273215,6
0.05,4846,94,439849,90.74664741076955,8
0.05,4847,92,439941,90.74690594059406,9
0.05,4848,94,440035,90.74757681996287,7
0.05,4849,94,440129,90.74824742268041,7
0.05,4850,96,440225,90.74933003504432,6
0.05,4851,95,440320,90.75020610057709,8
0.05,4852,96,440416,90.75128786317741,6
0.05,4853,93,440509,90.75175113308612,8
0.05,4854,95,440604,90.75262615859938,6
0.05,4855,94,440698,90.75329489291597,8
0.05,4856,94,440792,90.75396335186329,7
0.05,4857,95,440887,90.75483738163854,7
0.05,4858,94,440981,90.75550524799341,7
0.05,4859,95,441076,90.75637860082304,6
0.05,4860,95,441171,90.75725159432216,6
0.05,4861,89,441260,90.75689016865488,12
0.05,4862,89,441349,90.75652889163068,12
0.05,4863,93,441442,90.75699013157895,8
0.05,4864,95,441537,90.7578622816033,6
0.05,4865,96,441633,90.75893958076449,6
0.05,4866,94,441727,90.75960550647216,7
0.05,4867,92,441819,90.75986031224322,9
0.05,4868,90,441909,90.75970425138632,11
0.05,4869,92,442001,90.75995893223819,9
0.05,4870,95,442096,90.76082939848081,6
0.05,4871,92,442188,90.76108374384236,9
0.05,4872,93,442281,90.76154319720911,8
0.05,4873,93,442374,90.7620024620435,8
0.05,4874,27,442401,90.74892307692308,6
0.05,4875,90,442491,90.74876948318294,11
0.05,4876,95,442586,90.74964117285217,6
0.05,4877,90,442676,90.74948749487496,11
0.05,4878,26,442702,90.73621643779462,6
0.05,4879,94,442796,90.73688524590163,7
0.05,4880,94,442890,90.73755377996312,7
0.05,4881,92,442982,90.73781237197869,9
0.05,4882,92,443074,90.73807085807906,9
0.05,4883,94,443168,90.73873873873873,7
0.05,4884,94,443262,90.73940634595701,7
0.05,4885,90,443352,90.73925501432664,11
0.05,4886,94,443446,90.73992224268467,7
0.05,4887,94,443540,90.740589198036,7
0.05,4888,92,443632,90.74084679893639,9
0.05,4889,90,443722,90.74069529652351,11
0.05,4890,95,443817,90.74156614189327,6
0.05,4891,91,443908,90.74161896974653,10
0.05,4892,94,444002,90.74228489679133,8
0.05,4893,26,444028,90.72905598692276,7
0.05,4894,94,444122,90.7297242083759,8
0.05,4895,95,444217,90.73059640522875,6
0.05,4896,90,444307,90.73044721257914,11
0.05,4897,92,444399,90.73070641077992,9
0.05,4898,95,444494,90.73157787303532,6
0.05,4899,94,444588,90.73224489795918,7
0.05,4900,92,444680,90.73250357069986,9
0.05,4901,92,444772,90.7327621379029,9
0.05,4902,94,444866,90.73342851315522,7
0.05,4903,92,444958,90.7336867862969,9
0.05,4904,96,445054,90.73476044852191,6
0.05,4905,91,445145,90.73481451284142,10
0.05,4906,87,445232,90.73405339311188,14
0.05,4907,94,445326,90.73471882640587,7
0.05,4908,92,445418,90.73497657364025,9
0.05,4909,24,445442,90.7213849287169,9
0.05,4910,92,445534,90.72164528609244,9
0.05,4911,94,445628,90.72231270358306,7
0.05,4912,93,445721,90.72277630775494,10
0.05,4913,93,445814,90.72323972323973,9
0.05,4914,94,445908,90.72390640895219,7
0.05,4915,95,446003,90.72477624084621,6
0.05,4916,91,446094,90.7248322147651,11
0.05,4917,92,446186,90.72509150061,9
0.05,4918,94,446280,90.72575726773735,7
0.05,4919,94,446374,90.72642276422764,7
0.05,4920,96,446470,90.72749441170494,6
0.05,4921,92,446562,90.72775294595692,9
0.05,4922,94,446656,90.72841763152549,7
0.05,4923,94,446750,90.72908204711617,7
0.05,4924,95,446845,90.72994923857868,6
0.05,4925,96,446941,90.73101908241982,6
0.05,4926,94,447035,90.73168256545566,7
0.05,4927,92,447127,90.73193993506493,9
0.05,4928,95,447222,90.73280584297018,6
0.05,4929,94,447316,90.73346855983773,7
0.05,4930,93,447409,90.73392820928818,9
0.05,4931,94,447503,90.73459042984591,7
0.05,4932,95,447598,90.73545509831746,7
0.05,4933,96,447694,90.73652209160925,6
0.05,4934,93,447787,90.7369807497467,9
0.05,4935,94,447881,90.73764181523501,7
0.05,4936,95,447976,90.73850516508001,8
0.05,4937,94,448070,90.73916565411098,7
0.05,4938,91,448161,90.73921846527637,10
0.05,4939,26,448187,90.7261133603239,8
0.05,4940,94,448281,90.72677595628416,8
0.05,4941,94,448375,90.72743828409551,7
0.05,4942,93,448468,90.72789803762898,8
0.05,4943,94,448562,90.72855987055016,8
0.05,4944,93,448655,90.72901921132457,8
0.05,4945,96,448751,90.73008491710473,6
0.05,4946,94,448845,90.73074590661007,7
0.05,4947,94,448939,90.73140662894099,7
0.05,4948,94,449033,90.73206708425944,7
0.05,4949,94,449127,90.73272727272727,7
0.05,4950,96,449223,90.73379115330236,6
0.05,4951,95,449318,90.73465266558966,6
0.05,4952,93,449411,90.73511003432263,9
0.05,4953,94,449505,90.73576907549455,7
0.05,4954,94,449599,90.7364278506559,7
0.05,4955,95,449694,90.73728813559322,6
0.05,4956,95,449789,90.73814807343152,6
0.05,4957,96,449885,90.73920935861234,6
0.05,4958,93,449978,90.73966525509175,8
0.05,4959,92,450070,90.7399193548387,9
0.05,4960,96,450166,90.74097964120138,6
0.05,4961,94,450260,90.7416364369206,7
0.05,4962,94,450354,90.74229296796292,7
0.05,4963,90,450444,90.74214343271555,11
0.05,4964,96,450540,90.74320241691844,6
0.05,4965,94,450634,90.74385823600483,7
0.05,4966,93,450727,90.74431246225086,8
0.05,4967,95,450822,90.7451690821256,6
0.05,4968,91,450913,90.74522036627089,11
0.05,4969,94,451007,90.74587525150905,7
0.05,4970,94,451101,90.74652987326493,8
0.05,4971,92,451193,90.74678197908287,9
0.05,4972,95,451288,90.74763724110196,6
0.05,4973,90,451378,90.74748693204664,12
0.05,4974,95,451473,90.74834170854271,6
0.05,4975,96,451569,90.74939710610933,8
0.05,4976,91,451660,90.74944745830821,10
0.05,4977,93,451753,90.74989955805545,8
0.05,4978,95,451848,90.7507531632858,6
0.05,4979,93,451941,90.7512048192771,8
0.05,4980,95,452036,90.75205781971492,6
0.05,4981,96,452132,90.75311120032116,6
0.05,4982,94,452226,90.7537627934979,7
0.05,4983,93,452319,90.75421348314607,8
0.05,4984,92,452411,90.75446339017051,9
0.05,4985,95,452506,90.75531488166867,6
0.05,4986,91,452597,90.75536394626027,10
0.05,4987,94,452691,90.75601443464315,7
0.05,4988,93,452784,90.75646422128683,8
0.05,4989,89,452873,90.7561122244489,12
0.05,4990,93,452966,90.75656181126027,8
0.05,4991,93,453059,90.75701121794872,8
0.05,4992,95,453154,90.75786100540758,6
0.05,4993,93,453247,90.75830997196636,8
0.05,4994,-49,453198,90.73033033033033,12
0.05,4995,95,453293,90.73118494795837,7
0.05,4996,95,453388,90.73203922353412,6
0.05,4997,96,453484,90.73309323729492,6
0.05,4998,95,453579,90.73394678935787,7
0.05,4999,95,453674,90.7348,6
0.05,5000,94,453768,90.73545290941811,7
0.05,5001,92,453860,90.73570571771292,9
0.05,5002,94,453954,90.73635818508895,7
0.05,5003,93,454047,90.73681055155875,8
0.05,5004,96,454143,90.73786213786214,6
0.05,5005,95,454238,90.73871354374751,6
0.05,5006,93,454331,90.73916516876373,8
0.05,5007,94,454425,90.7398162939297,7
0.05,5008,95,454520,90.74066679976043,6
0.05,5009,95,454615,90.74151696606786,6
0.05,5010,94,454709,90.7421672320894,7
0.05,5011,93,454802,90.74261771747805,8
0.05,5012,93,454895,90.74306802313984,8
0.05,5013,96,454991,90.74411647387315,6
0.05,5014,96,455087,90.74516450648056,6
0.05,5015,90,455177,90.74501594896331,11
0.05,5016,95,455272,90.74586406218856,6
0.05,5017,93,455365,90.74631327222001,8
0.05,5018,92,455457,90.74656306037059,9
0.05,5019,93,455550,90.74701195219123,8
0.05,5020,26,455576,90.73411670981876,7
0.05,5021,90,455666,90.73397052966945,11
0.05,5022,95,455761,90.73481982878758,6
0.05,5023,94,455855,90.73546974522293,7
0.05,5024,96,455951,90.73651741293533,6
0.05,5025,95,456046,90.73736569836848,7
0.05,5026,94,456140,90.73801472050926,7
0.05,5027,26,456166,90.72513922036595,7
0.05,5028,95,456261,90.72598926227879,6
0.05,5029,93,456354,90.72644135188867,8
0.05,5030,93,456447,90.72689326177698,8
0.05,5031,94,456541,90.72754372019078,8
0.05,5032,94,456635,90.72819392012715,7
0.05,5033,94,456729,90.72884386174017,7
0.05,5034,93,456822,90.72929493545183,8
0.05,5035,95,456917,90.7301429706116,6
0.05,5036,94,457011,90.73079213817749,7
0.05,5037,94,457105,90.73144104803494,8
0.05,5038,94,457199,90.73208970033737,7
0.05,5039,94,457293,90.73273809523809,7
0.05,5040,95,457388,90.73358460622892,6
0.05,5041,91,457479,90.73363744545816,10
0.05,5042,95,457574,90.7344834423954,6
0.05,5043,92,457666,90.73473433782712,9
0.05,5044,92,457758,90.73498513379583,9
0.05,5045,94,457852,90.73563218390805,8
0.05,5046,90,457942,90.73548642758074,13
0.05,5047,90,458032,90.73534072900158,11
0.05,5048,94,458126,90.73598732422262,8
0.05,5049,92,458218,90.73623762376238,9
0.05,5050,91,458309,90.73628984359533,11
0.05,5051,96,458405,90.73733174980205,6
0.05,5052,95,458500,90.73817534138136,6
0.05,5053,92,458592,90.73842500989315,9
0.05,5054,92,458684,90.73867457962413,9
0.05,5055,93,458777,90.73912183544304,8
0.05,5056,91,458868,90.73917342297806,10
0.05,5057,94,458962,90.73981810992487,7
0.05,5058,95,459057,90.74066020952758,6
0.05,5059,95,459152,90.74150197628458,6
0.05,5060,94,459246,90.74214582098399,8
0.05,5061,96,459342,90.74318451205058,6
0.05,5062,25,459367,90.73019948647047,8
0.05,5063,96,459463,90.7312401263823,6
0.05,5064,96,459559,90.73228035538006,6
0.05,5065,95,459654,90.73312277931306,6
0.05,5066,94,459748,90.73376751529504,7
0.05,5067,95,459843,90.7346093133386,6
0.05,5068,93,459936,90.73505622410732,8
0.05,5069,88,460024,90.734516765286,13
0.05,5070,93,460117,90.73496351804378,8
0.05,5071,88,460205,90.73442429022082,13
0.05,5072,93,460298,90.73487088507787,8
0.05,5073,93,460391,90.73531730390225,8
0.05,5074,94,460485,90.73596059113301,7
0.05,5075,91,460576,90.73601260835304,10
0.05,5076,93,460669,90.736458538507,8
0.05,5077,95,460764,90.73729814887751,6
0.05,5078,94,460858,90.73794053947627,7
0.05,5079,96,460954,90.73897637795275,6
0.05,5080,92,461046,90.73922456209408,9
0.05,5081,92,461138,90.73947264856356,9
0.05,5082,94,461232,90.740114105843,7
0.05,5083,96,461328,90.74114870180959,6
0.05,5084,90,461418,90.7410029498525,11
0.05,5085,94,461512,90.74164372788046,8
0.05,5086,94,461606,90.74228425398074,7
0.05,5087,95,461701,90.7431210691824,7
0.05,5088,95,461796,90.74395755551188,6
0.05,5089,94,461890,90.74459724950884,7
0.05,5090,94,461984,90.74523669220193,7
0.05,5091,94,462078,90.7458758837392,7
0.05,5092,91,462169,90.74592578048302,10
0.05,5093,94,462263,90.7465645857872,7
0.05,5094,95,462358,90.74739941118744,6
0.05,5095,96,462454,90.74843014128729,6
0.05,5096,94,462548,90.74906807926232,8
0.05,5097,93,462641,90.7495096116124,8
0.05,5098,93,462734,90.74995097077858,8
0.05,5099,94,462828,90.75058823529412,7
0.05,5100,94,462922,90.75122524995099,8
0.05,5101,96,463018,90.75225401803215,6
0.05,5102,94,463112,90.75289045659416,7
0.05,5103,94,463206,90.75352664576802,7
0.05,5104,90,463296,90.75337904015672,11
0.05,5105,93,463389,90.75381903642773,8
0.05,5106,93,463482,90.75425886038771,8
0.05,5107,93,463575,90.75469851213782,8
0.05,5108,94,463669,90.75533372479937,8
0.05,5109,90,463759,90.75518590998043,11
0.05,5110,90,463849,90.75503815300333,11
0.05,5111,94,463943,90.75567292644757,7
0.05,5112,92,464035,90.7559162918052,9
0.05,5113,93,464128,90.75635510363708,9
0.05,5114,96,464224,90.75738025415444,6
0.05,5115,92,464316,90.75762314308054,9
0.05,5116,96,464412,90.75864764510456,6
0.05,5117,94,464506,90.75928096912857,8
0.05,5118,24,464530,90.74623949990233,9
0.05,5119,93,464623,90.7466796875,8
0.05,5120,94,464717,90.74731497754345,7
0.05,5121,89,464806,90.7469738383444,12
0.05,5122,96,464902,90.7479992192075,6
0.05,5123,95,464997,90.74882903981265,6
0.05,5124,94,465091,90.74946341463415,7
0.05,5125,95,465186,90.7502926258291,6
0.05,5126,93,465279,90.75073142188414,8
0.05,5127,89,465368,90.75039001560063,12
0.05,5128,94,465462,90.75102359134334,7
0.05,5129,94,465556,90.75165692007798,7
0.05,5130,94,465650,90.75229000194894,8
0.05,5131,93,465743,90.75272798129384,8
0.05,5132,94,465837,90.75336060783168,7
0.05,5133,96,465933,90.75438254772108,6
0.05,5134,95,466028,90.75520934761441,6
0.05,5135,93,466121,90.75564641744548,8
0.05,5136,92,466213,90.7558886509636,9
0.05,5137,95,466308,90.75671467497081,7
0.05,5138,94,466402,90.75734578711811,7
0.05,5139,94,466496,90.7579766536965,8
0.05,5140,94,466590,90.75860727484925,7
0.05,5141,92,466682,90.75884869700505,9
0.05,5142,94,466776,90.7594789033638,7
0.05,5143,95,466871,90.7603032659409,6
0.05,5144,93,466964,90.76073858114674,8
0.05,5145,94,467058,90.76136805285658,7
0.05,5146,94,467152,90.76199727996891,7
0.05,5147,92,467244,90.76223776223776,9
0.05,5148,95,467339,90.76306078850263,6
0.05,5149,94,467433,90.76368932038835,8
0.05,5150,96,467529,90.76470588235294,6
0.05,5151,95,467624,90.76552795031056,6
0.05,5152,95,467719,90.76634969920434,7
0.05,5153,92,467811,90.76658905704308,9
0.05,5154,96,467907,90.76760426770126,6
0.05,5155,94,468001,90.76823118696664,7
0.05,5156,96,468097,90.76924568547605,6
0.05,5157,93,468190,90.76967816983327,8
0.05,5158,94,468284,90.77030432254313,8
0.05,5159,13,468297,90.75523255813954,19
0.05,5160,96,468393,90.75624878899438,6
0.05,5161,94,468487,90.75687717938783,7
0.05,5162,90,468577,90.75673058299438,12
0.05,5163,95,468672,90.75755228505035,8
0.05,5164,90,468762,90.75740561471443,11
0.05,5165,93,468855,90.75783972125436,9
0.05,5166,94,468949,90.75846719566479,7
0.05,5167,96,469045,90.7594814241486,7
0.05,5168,94,469139,90.76010833816986,7
0.05,5169,94,469233,90.76073500967118,7
0.05,5170,89,469322,90.76039450783215,12
0.05,5171,94,469416,90.76102088167053,8
0.05,5172,93,469509,90.76145370191378,8
0.05,5173,93,469602,90.76188635485119,8
0.05,5174,92,469694,90.76212560386473,9
0.05,5175,95,469789,90.76294435857805,6
0.05,5176,90,469879,90.76279698667182,11
0.05,5177,94,469973,90.7634221707223,7
0.05,5178,94,470067,90.76404711334234,8
0.05,5179,94,470161,90.76467181467181,7
0.05,5180,96,470257,90.76568230071415,6
0.05,5181,94,470351,90.76630644538788,7
0.05,5182,92,470443,90.76654447231333,9
0.05,5183,96,470539,90.76755401234568,6
0.05,5184,95,470634,90.76837029893925,6
0.05,5185,93,470727,90.7688006170459,8
0.05,5186,92,470819,90.76903797956429,9
0.05,5187,93,470912,90.76946800308404,9
0.05,5188,94,471006,90.77009057621892,8
0.05,5189,94,471100,90.77071290944123,7
0.05,5190,94,471194,90.77133500288961,8
0.05,5191,96,471290,90.77234206471495,6
0.05,5192,93,471383,90.77277103793568,8
0.05,5193,96,471479,90.77377743550251,6
0.05,5194,94,471573,90.77439846005775,7
0.05,5195,92,471665,90.77463433410315,9
0.05,5196,96,471761,90.7756397921878,7
0.05,5197,95,471856,90.77645248172374,6
0.05,5198,94,471950,90.77707251394499,7
0.05,5199,91,472041,90.77711538461539,10
0.05,5200,93,472134,90.77754278023457,8
0.05,5201,95,472229,90.77835447904653,8
0.05,5202,91,472320,90.77839707860849,10
0.05,5203,95,472415,90.77920830130668,6
0.05,5204,96,472511,90.78021133525456,6
0.05,5205,93,472604,90.78063772570111,8
0.05,5206,92,472696,90.78087190320723,9
0.05,5207,94,472790,90.78149001536099,7
0.05,5208,90,472880,90.78133998848148,11
0.05,5209,94,472974,90.78195777351247,7
0.05,5210,95,473069,90.78276722318174,7
0.05,5211,96,473165,90.78376822716807,6
0.05,5212,93,473258,90.78419336274698,8
0.05,5213,86,473344,90.78327579593402,15
0.05,5214,94,473438,90.78389261744967,7
0.05,5215,95,473533,90.7847009202454,6
0.05,5216,96,473629,90.78570059421124,6
0.05,5217,95,473724,90.78650824070525,6
0.05,5218,93,473817,90.78693236252155,9
0.05,5219,94,473911,90.78754789272031,7
0.05,5220,27,473938,90.77533039647577,6
0.05,5221,92,474030,90.77556491765607,9
0.05,5222,92,474122,90.77579934903312,9
0.05,5223,92,474214,90.7760336906585,9
0.05,5224,91,474305,90.77607655502392,10
0.05,5225,95,474400,90.77688480673555,6
0.05,5226,93,474493,90.77731012052803,8
0.05,5227,92,474585,90.7775439938791,10
0.05,5228,92,474677,90.77777777777777,10
0.05,5229,96,474773,90.77877629063097,6
0.05,5230,92,474865,90.77900974956987,9
0.05,5231,94,474959,90.77962538226299,7
0.05,5232,96,475055,90.7806229696159,6
0.05,5233,94,475149,90.781238058846,7
0.05,5234,96,475245,90.78223495702005,6
0.05,5235,94,475339,90.78284950343775,7
0.05,5236,96,475435,90.78384571319458,6
0.05,5237,91,475526,90.78388697976327,10
0.05,5238,95,475621,90.78469173506394,6
0.05,5239,94,475715,90.78530534351145,7
0.05,5240,93,475808,90.78572791452012,8
0.05,5241,94,475902,90.78634109118657,7
0.05,5242,89,475991,90.786000381461,12
0.05,5243,94,476085,90.78661327231121,7
0.05,5244,25,476110,90.77407054337465,7
0.05,5245,95,476205,90.7748760960732,7
0.05,5246,94,476299,90.77549075662283,7
0.05,5247,94,476393,90.77610518292683,7
0.05,5248,94,476487,90.77671937511907,7
0.05,5249,96,476583,90.77771428571428,6
0.05,5250,93,476676,90.7781374976195,8
0.05,5251,96,476772,90.77913175932979,6
0.05,5252,93,476865,90.77955454026271,8
0.05,5253,96,476961,90.78054815378759,6
0.05,5254,94,477055,90.78116079923882,7
0.05,5255,93,477148,90.78158295281582,8
0.05,5256,96,477244,90.78257561346776,6
0.05,5257,94,477338,90.7831875237733,7
0.05,5258,93,477431,90.7836090511504,8
0.05,5259,89,477520,90.78326996197718,12
0.05,5260,91,477611,90.7833111575746,10
0.05,5261,94,477705,90.78392246294185,7
0.05,5262,95,477800,90.78472354170626,7
0.05,5263,91,477891,90.78476443768997,10
0.05,5264,96,477987,90.78575498575499,6
0.05,5265,93,478080,90.78617546524876,8
0.05,5266,95,478175,90.78697550787925,6
0.05,5267,93,478268,90.78739559605164,8
0.05,5268,94,478362,90.78800531410134,7
0.05,5269,90,478452,90.78785578747627,11
0.05,5270,91,478543,90.78789603490799,10
0.05,5271,93,478636,90.78831562974203,8
0.05,5272,93,478729,90.78873506542764,8
0.05,5273,92,478821,90.78896473265074,9
0.05,5274,94,478915,90.78957345971564,8
0.05,5275,94,479009,90.7901819560273,7
0.05,5276,26,479035,90.77790411218496,7
0.05,5277,93,479128,90.77832512315271,8
0.05,5278,94,479222,90.77893540443266,7
0.05,5279,95,479317,90.77973484848485,6
0.05,5280,91,479408,90.77977655747017,10
0.05,5281,93,479501,90.78019689511548,8
0.05,5282,94,479595,90.78080636002271,8
0.05,5283,95,479690,90.78160484481454,6
0.05,5284,94,479784,90.78221381267738,7
0.05,5285,94,479878,90.78282255013242,7
0.05,5286,91,479969,90.78286362776622,10
0.05,5287,94,480063,90.78347201210288,7
0.05,5288,94,480157,90.78408016638306,7
0.05,5289,93,480250,90.78449905482042,9
0.05,5290,96,480346,90.78548478548478,6
0.05,5291,94,480440,90.78609221466364,7
0.05,5292,96,480536,90.78707727186851,6
0.05,5293,94,480630,90.78768417075935,7
0.05,5294,92,480722,90.78791312559018,9
0.05,5295,94,480816,90.78851963746223,7
0.05,5296,94,480910,90.78912592033227,7
0.05,5297,23,480933,90.77633069082673,9
0.05,5298,92,481025,90.77656161539913,9
0.05,5299,94,481119,90.77716981132076,8
0.05,5300,95,481214,90.77796642142992,6
0.05,5301,91,481305,90.77800829875518,10
0.05,5302,94,481399,90.77861587780501,8
0.05,5303,90,481489,90.77846907993967,11
0.05,5304,94,481583,90.77907634307257,7
0.05,5305,95,481678,90.77987184319637,6
0.05,5306,93,481771,90.78029018277746,8
0.05,5307,94,481865,90.78089675960814,7
0.05,5308,92,481957,90.7811263891505,9
0.05,5309,94,482051,90.78173258003767,8
0.05,5310,92,482143,90.7819619657315,9
0.05,5311,92,482235,90.78219126506023,9
0.05,5312,93,482328,90.78260869565217,9
0.05,5313,94,482422,90.78321415129845,7
0.05,5314,94,482516,90.78381937911571,7
0.05,5315,94,482610,90.7844243792325,7
0.05,5316,96,482706,90.7854053037427,6
0.05,5317,90,482796,90.78525761564498,11
0.05,5318,95,482891,90.78605000940027,6
0.05,5319,91,482982,90.78609022556391,10
0.05,5320,96,483078,90.78707009960534,6
0.05,5321,94,483172,90.78767380683954,7
0.05,5322,92,483264,90.78790155927109,9
0.05,5323,94,483358,90.78850488354621,8
0.05,5324,94,483452,90.78910798122065,8
0.05,5325,94,483546,90.78971085242208,7
0.05,5326,95,483641,90.79050122019899,6
0.05,5327,94,483735,90.7911036036036,7
0.05,5328,95,483830,90.79189341339838,6
0.05,5329,95,483925,90.79268292682927,8
0.05,5330,94,484019,90.79328456199588,8
0.05,5331,94,484113,90.79388597149287,7
0.05,5332,95,484208,90.7946746671667,8
0.05,5333,94,484302,90.79527559055119,7
0.05,5334,95,484397,90.79606373008434,6
0.05,5335,96,484493,90.79703898050974,6
0.05,5336,94,484587,90.79763912310287,7
0.05,5337,94,484681,90.79823904083926,7
0.05,5338,94,484775,90.79883873384529,7
0.05,5339,89,484864,90.79850187265917,12
0.05,5340,94,484958,90.79910129189291,7
0.05,5341,96,485054,90.80007487832273,6
0.05,5342,95,485149,90.80086093954706,6
0.05,5343,96,485245,90.80183383233533,6
0.05,5344,96,485341,90.80280636108513,6
0.05,5345,92,485433,90.8030303030303,9
0.05,5346,94,485527,90.80362820273051,7
0.05,5347,94,485621,90.80422587883321,8
0.05,5348,93,485714,90.80463638063189,9
0.05,5349,93,485807,90.80504672897196,8
0.05,5350,93,485900,90.80545692393945,8
0.05,5351,94,485994,90.8060538116592,7
0.05,5352,94,486088,90.80665047636839,7
0.05,5353,23,486111,90.7939858050056,9
0.05,5354,95,486206,90.79477124183006,8
0.05,5355,94,486300,90.79536967886483,7
0.05,5356,94,486394,90.79596789247714,7
0.05,5357,89,486483,90.7956326987682,12
0.05,5358,94,486577,90.79623064004478,7
0.05,5359,94,486671,90.79682835820896,7
0.05,5360,94,486765,90.79742585338556,7
0.05,5361,90,486855,90.79727713539724,11
0.05,5362,95,486950,90.79806078687302,6
0.05,5363,94,487044,90.79865771812081,7
0.05,5364,95,487139,90.79944082013047,6
0.05,5365,95,487234,90.80022363026463,6
0.05,5366,92,487326,90.80044717719396,9
0.05,5367,95,487421,90.80122950819673,6
0.05,5368,96,487517,90.8021978021978,6
0.05,5369,94,487611,90.80279329608939,7
0.05,5370,96,487707,90.80376093837275,6
0.05,5371,92,487799,90.80398361876397,9
0.05,5372,94,487893,90.80457844779453,7
0.05,5373,94,487987,90.80517305545217,7
0.05,5374,94,488081,90.80576744186047,7
0.05,5375,92,488173,90.80598958333333,9
0.05,5376,92,488265,90.80621164217965,9
0.05,5377,94,488359,90.8068055039048,7
0.05,5378,94,488453,90.80739914482245,7
0.05,5379,93,488546,90.80780669144981,8
0.05,5380,95,488641,90.80858576472775,6
0.05,5381,93,488734,90.80899293942772,8
0.05,5382,94,488828,90.80958573286271,7
0.05,5383,94,488922,90.81017830609213,7
0.05,5384,93,489015,90.81058495821728,8
0.05,5385,21,489036,90.79762346825102,11
0.05,5386,90,489126,90.79747540374977,11
0.05,5387,92,489218,90.79769858945805,9
0.05,5388,90,489308,90.79755056596771,12
0.05,5389,94,489402,90.79814471243043,7
0.05,5390,94,489496,90.79873863847153,7
0.05,5391,93,489589,90.799146884273,8
0.05,5392,95,489684,90.79992582977934,7
0.05,5393,95,489779,90.80070448646644,6
0.05,5394,95,489874,90.8014828544949,7
0.05,5395,96,489970,90.80244625648629,6
0.05,5396,93,490063,90.80285343709468,8
0.05,5397,94,490157,90.80344572063727,7
0.05,5398,93,490250,90.80385256528987,8
0.05,5399,94,490344,90.80444444444444,7
0.05,5400,92,490436,90.80466580262915,9
0.05,5401,94,490530,90.80525731210663,7
0.05,5402,94,490624,90.80584860262817,7
0.05,5403,92,490716,90.8060695780903,9
0.05,5404,95,490811,90.8068455134135,7
0.05,5405,90,490901,90.80669626341103,11
0.05,5406,93,490994,90.80710190493804,8
0.05,5407,90,491084,90.8069526627219,11
0.05,5408,92,491176,90.80717322980219,10
0.05,5409,96,491272,90.80813308687615,6
0.05,5410,94,491366,90.80872297172426,7
0.05,5411,91,491457,90.80875831485588,11
0.05,5412,95,491552,90.8095326066876,6
0.05,5413,93,491645,90.80993719985223,8
0.05,5414,96,491741,90.81089566020314,6
0.05,5415,94,491835,90.81148449039881,7
0.05,5416,95,491930,90.81225770721802,6
0.05,5417,95,492025,90.81303063861203,6
0.05,5418,96,492121,90.81398782063111,6
0.05,5419,94,492215,90.81457564575646,7
0.05,5420,94,492309,90.81516325401218,7
0.05,5421,27,492336,90.80339358170417,6
0.05,5422,95,492431,90.80416743499907,6
0.05,5423,93,492524,90.80457227138643,9
0.05,5424,96,492620,90.80552995391704,6
0.05,5425,94,492714,90.80611868779948,7
0.05,5426,21,492735,90.79325594250967,12
0.05,5427,94,492829,90.79384672070745,7
0.05,5428,24,492853,90.78154356235034,9
0.05,5429,90,492943,90.78139963167588,11
0.05,5430,93,493036,90.78180813846437,8
0.05,5431,92,493128,90.7820324005891,9
0.05,5432,92,493220,90.78225658015829,9
0.05,5433,96,493316,90.78321678321679,6
0.05,5434,93,493409,90.7836246550138,8
0.05,5435,93,493502,90.7840323767476,8
0.05,5436,94,493596,90.78462387345962,7
0.05,5437,93,493689,90.7850312614932,8
0.05,5438,94,493783,90.78562235705093,7
0.05,5439,93,493876,90.7860294117647,9
0.05,5440,95,493971,90.78680389634259,7
0.05,5441,92,494063,90.78702682837192,9
0.05,5442,94,494157,90.78761712291016,7
0.05,5443,95,494252,90.78839088905217,6
0.05,5444,93,494345,90.78879706152433,8
0.05,5445,93,494438,90.7892030848329,8
0.05,5446,94,494532,90.7897925463558,8
0.05,5447,94,494626,90.79038179148311,7
0.05,5448,94,494720,90.79097082033401,7
0.05,5449,94,494814,90.79155963302752,7
0.05,5450,94,494908,90.79214822968262,7
0.05,5451,96,495004,90.79310344827586,6
0.05,5452,96,495100,90.79405831652302,6
0.05,5453,94,495194,90.79464613127979,7
0.05,5454,94,495288,90.79523373052245,7
0.05,5455,95,495383,90.79600439882698,6
0.05,5456,96,495479,90.79695803555067,6
0.05,5457,96,495575,90.79791132282888,6
0.05,5458,93,495668,90.79831470965378,8
0.05,5459,95,495763,90.79908424908425,6
0.05,5460,95,495858,90.79985350668376,6
0.05,5461,94,495952,90.80043939948737,7
0.05,5462,94,496046,90.80102507779608,7
0.05,5463,96,496142,90.8019765739385,6
0.05,5464,94,496236,90.80256175663312,7
0.05,5465,95,496331,90.80332967435054,6
0.05,5466,94,496425,90.80391439546369,7
0.05,5467,95,496520,90.80468178493051,6
0.05,5468,-46,496474,90.77966721521302,10
0.05,5469,94,496568,90.78025594149909,7
0.05,5470,94,496662,90.78084445256809,7
0.05,5471,95,496757,90.78161549707602,6
0.05,5472,90,496847,90.78147268408551,11
0.05,5473,94,496941,90.78206065034709,7
0.05,5474,92,497033,90.78228310502283,10
0.05,5475,93,497126,90.7826880934989,8
0.05,5476,93,497219,90.783092934088,8
0.05,5477,92,497311,90.7833150784958,10
0.05,5478,96,497407,90.78426720204416,6
0.05,5479,94,497501,90.78485401459854,8
0.05,5480,93,497594,90.7852581645685,8
0.05,5481,94,497688,90.78584458226925,7
0.05,5482,95,497783,90.78661316797374,6
0.05,5483,94,497877,90.78719912472647,7
0.05,5484,94,497971,90.78778486782133,7
0.05,5485,96,498067,90.78873496172075,6
0.05,5486,94,498161,90.78932021140878,7
0.05,5487,95,498256,90.79008746355684,6
0.05,5488,95,498351,90.79085443614501,6
0.05,5489,94,498445,90.79143897996357,7
0.05,5490,92,498537,90.79165907849207,9
0.05,5491,95,498632,90.79242534595775,6
0.05,5492,92,498724,90.79264518478062,9
0.05,5493,93,498817,90.79304696032035,8
0.05,5494,96,498913,90.79399454049135,6
0.05,5495,96,499009,90.79494177583697,6
0.05,5496,94,499103,90.7955248317264,7
0.05,5497,94,499197,90.79610767551837,7
0.05,5498,94,499291,90.7966903073286,7
0.05,5499,90,499381,90.79654545454545,11
0.05,5500,95,499476,90.79730958007634,6
0.05,5501,90,499566,90.79716466739367,12
0.05,5502,95,499661,90.79792840268944,6
0.05,5503,94,499755,90.79851017441861,7
0.05,5504,96,499851,90.79945504087193,6
0.05,5505,94,499945,90.80003632401016,8
0.05,5506,93,500038,90.8004358089704,8
0.05,5507,95,500133,90.80119825708061,7
0.05,5508,95,500228,90.8019604283899,6
0.05,5509,95,500323,90.802722323049,6
0.05,5510,95,500418,90.8034839412085,6
0.05,5511,89,500507,90.80315674891146,12
0.05,5512,26,500533,90.79140214039543,7
0.05,5513,95,500628,90.79216539717083,6
0.05,5514,25,500653,90.78023572076155,7
0.05,5515,95,500748,90.78100072516317,8
0.05,5516,96,500844,90.78194671016857,6
0.05,5517,92,500936,90.78216745197535,9
0.05,5518,94,501030,90.78275049827867,7
0.05,5519,94,501124,90.78333333333333,7
0.05,5520,94,501218,90.78391595725412,7
0.05,5521,96,501314,90.78486055776892,6
0.05,5522,87,501401,90.784175267065,15
0.05,5523,95,501496,90.78493845039826,6
0.05,5524,94,501590,90.78552036199095,8
0.05,5525,92,501682,90.78574013753168,10
0.05,5526,94,501776,90.78632169350462,9
0.05,5527,96,501872,90.78726483357453,6
0.05,5528,96,501968,90.78820763248326,6
0.05,5529,95,502063,90.78896925858952,6
0.05,5530,92,502155,90.78918821189659,9
0.05,5531,94,502249,90.78976861894432,8
0.05,5532,91,502340,90.78980661485632,10
0.05,5533,96,502436,90.79074810263823,6
0.05,5534,95,502531,90.79150858175248,7
0.05,5535,94,502625,90.79208815028902,7
0.05,5536,96,502721,90.79302871591115,6
0.05,5537,94,502815,90.79360780065005,7
0.05,5538,92,502907,90.79382560028886,9
0.05,5539,94,503001,90.79440433212996,7
0.05,5540,96,503097,90.79534380075799,6
0.05,5541,96,503193,90.79628293035006,6
0.05,5542,94,503287,90.79686090564677,7
0.05,5543,94,503381,90.79743867243867,7
0.05,5544,93,503474,90.79783588818755,8
0.05,5545,95,503569,90.79859358095925,6
0.05,5546,94,503663,90.79917072291329,8
0.05,5547,92,503755,90.79938716654651,9
0.05,5548,92,503847,90.79960353216796,9
0.05,5549,93,503940,90.8,8
0.05,5550,96,504036,90.80093676814988,6
0.05,5551,91,504127,90.80097262247838,10
0.05,5552,95,504222,90.80172879524581,6
0.05,5553,93,504315,90.80212459488656,8
0.05,5554,96,504411,90.8030603060306,6
0.05,5555,95,504506,90.80381569474442,6
0.05,5556,94,504600,90.80439085837682,7
0.05,5557,95,504695,90.80514573587621,6
0.05,5558,95,504790,90.80590034178809,6
0.05,5559,91,504881,90.80593525179856,10
0.05,5560,93,504974,90.80632979679913,8
0.05,5561,93,505067,90.80672419992808,8
0.05,5562,94,505161,90.80729822038468,7
0.05,5563,91,505252,90.80733285406183,10
0.05,5564,96,505348,90.80826594788859,6
0.05,5565,92,505440,90.80848005749192,9
0.05,5566,92,505532,90.80869409017424,9
0.05,5567,93,505625,90.80908764367815,8
0.05,5568,94,505719,90.80966062129646,7
0.05,5569,93,505812,90.8100538599641,8
0.05,5570,95,505907,90.81080595943277,6
0.05,5571,92,505999,90.81101938262742,9
0.05,5572,93,506092,90.8114121657994,8
0.05,5573,95,506187,90.81216361679225,8
0.05,5574,94,506281,90.81273542600897,7
0.05,5575,93,506374,90.81312769010043,8
0.05,5576,94,506468,90.81369912139142,7
0.05,5577,93,506561,90.81409107206885,8
0.05,5578,93,506654,90.81448288223696,10
0.05,5579,92,506746,90.81469534050179,9
0.05,5580,92,506838,90.81490772263035,9
0.05,5581,94,506932,90.81547832318165,7
0.05,5582,94,507026,90.81604871932653,8
0.05,5583,95,507121,90.81679799426934,6
0.05,5584,94,507215,90.81736794986571,7
0.05,5585,96,507311,90.81829573934837,6
0.05,5586,96,507407,90.81922319670664,6
0.05,5587,95,507502,90.81997136721546,6
0.05,5588,95,507597,90.82071926999463,6
0.05,5589,93,507690,90.82110912343471,8
0.05,5590,93,507783,90.82149883741728,10
0.05,5591,92,507875,90.8217095851216,9
0.05,5592,95,507970,90.82245664223136,6
0.05,5593,92,508062,90.8226671433679,9
0.05,5594,95,508157,90.82341376228776,6
0.05,5595,27,508184,90.8120085775554,6
0.05,5596,94,508278,90.81257816687511,7
0.05,5597,91,508369,90.8126116470168,10
0.05,5598,92,508461,90.81282371852116,9
0.05,5599,94,508555,90.81339285714286,7
0.05,5600,96,508651,90.81431887163006,6
0.05,5601,94,508745,90.81488754016422,7
0.05,5602,95,508840,90.81563448152775,8
0.05,5603,95,508935,90.81638115631692,6
0.05,5604,94,509029,90.81694915254238,8
0.05,5605,96,509125,90.81787370674277,6
0.05,5606,94,509219,90.81844123417157,7
0.05,5607,92,509311,90.81865192582026,9
0.05,5608,93,509404,90.81904082724193,8
0.05,5609,24,509428,90.80713012477719,8
0.05,5610,93,509521,90.80752094100873,8
0.05,5611,95,509616,90.80826799714896,6
0.05,5612,96,509712,90.80919294494923,6
0.05,5613,94,509806,90.80976131100819,7
0.05,5614,96,509902,90.8106856634016,6
0.05,5615,92,509994,90.81089743589743,9
0.05,5616,93,510087,90.81128716396653,8
0.05,5617,93,510180,90.81167675329299,8
0.05,5618,95,510275,90.81242213917066,6
0.05,5619,94,510369,90.81298932384341,7
0.05,5620,25,510394,90.80128091086995,8
0.05,5621,94,510488,90.80184987548915,7
0.05,5622,94,510582,90.80241863773786,7
0.05,5623,94,510676,90.80298719772404,7
0.05,5624,95,510771,90.80373333333333,6
0.05,5625,92,510863,90.80394596516174,9
0.05,5626,96,510959,90.80486937977608,6
0.05,5627,94,511053,90.80543710021323,7
0.05,5628,94,511147,90.80600461893765,7
0.05,5629,95,511242,90.80674955595026,6
0.05,5630,94,511336,90.80731664002842,8
0.05,5631,91,511427,90.80735085227273,10
0.05,5632,94,511521,90.80791762826203,7
0.05,5633,95,511616,90.80866169684062,6
0.05,5634,96,511712,90.80958296362023,6
0.05,5635,95,511807,90.81032647267565,6
0.05,5636,96,511903,90.81124711726095,6
0.05,5637,94,511997,90.81181269953885,7
0.05,5638,94,512091,90.81237808122007,7
0.05,5639,-46,512045,90.78812056737588,10
0.05,5640,93,512138,90.78851267505762,8
0.05,5641,94,512232,90.78908188585608,7
0.05,5642,95,512327,90.78982810561757,6
0.05,5643,93,512420,90.79021970233876,8
0.05,5644,94,512514,90.79078830823738,7
0.05,5645,93,512607,90.79117959617429,8
0.05,5646,95,512702,90.79192491588454,6
0.05,5647,94,512796,90.79249291784703,8
0.05,5648,94,512890,90.79306071871127,7
0.05,5649,94,512984,90.79362831858407,7
0.05,5650,21,513005,90.78127764997346,11
0.05,5651,93,513098,90.78167020523708,8
0.05,5652,95,513193,90.78241641606226,6
0.05,5653,90,513283,90.78227803325079,11
0.05,5654,92,513375,90.78249336870026,9
0.05,5655,92,513467,90.78270862800566,9
0.05,5656,93,513560,90.78310058334806,8
0.05,5657,26,513586,90.77165075998586,8
0.05,5658,92,513678,90.77186782116982,9
0.05,5659,95,513773,90.7726148409894,6
0.05,5660,94,513867,90.77318494965554,7
0.05,5661,95,513962,90.77393147297775,6
0.05,5662,91,514053,90.77397139325446,10
0.05,5663,92,514145,90.77418785310735,9
0.05,5664,89,514234,90.7738746690203,13
0.05,5665,96,514330,90.7747970349453,6
0.05,5666,95,514425,90.77554261514028,6
0.05,5667,92,514517,90.7757586450247,9
0.05,5668,91,514608,90.77579820074087,10
0.05,5669,96,514704,90.77671957671957,6
0.05,5670,95,514799,90.77746429201198,7
0.05,5671,94,514893,90.77803244005642,7
0.05,5672,27,514920,90.76679005817029,6
0.05,5673,21,514941,90.75449418399718,11
0.05,5674,93,515034,90.75488986784141,9
0.05,5675,93,515127,90.75528541226215,9
0.05,5676,93,515220,90.7556808173331,8
0.05,5677,94,515314,90.7562522014794,7
0.05,5678,92,515406,90.75647120972002,9
0.05,5679,95,515501,90.75721830985916,6
0.05,5680,95,515596,90.75796514698116,6
0.05,5681,93,515689,90.75835973248856,8
0.05,5682,94,515783,90.75893014253036,7
0.05,5683,93,515876,90.75932441942294,8
0.05,5684,94,515970,90.7598944591029,7
0.05,5685,95,516065,90.76064016883574,6
0.05,5686,90,516155,90.76050641814665,13
0.05,5687,96,516251,90.76142756680731,6
0.05,5688,94,516345,90.7619968359993,7
0.05,5689,27,516372,90.75079086115993,6
0.05,5690,95,516467,90.75153751537515,6
0.05,5691,96,516563,90.7524595924104,6
0.05,5692,94,516657,90.75303003688741,7
0.05,5693,93,516750,90.75342465753425,8
0.05,5694,94,516844,90.75399473222124,7
0.05,5695,96,516940,90.75491573033707,6
0.05,5696,94,517034,90.75548534316307,8
0.05,5697,94,517128,90.75605475605475,7
0.05,5698,94,517222,90.75662396911738,7
0.05,5699,94,517316,90.75719298245615,7
0.05,5700,96,517412,90.75811261182248,6
0.05,5701,23,517435,90.74622939319536,10
0.05,5702,95,517530,90.74697527617043,6
0.05,5703,95,517625,90.74772089761571,6
0.05,5704,94,517719,90.74829097283084,7
0.05,5705,92,517811,90.74851033999299,10
0.05,5706,95,517906,90.74925530050815,7
0.05,5707,95,518001,90.75,6
0.05,5708,94,518095,90.75056927658083,7
0.05,5709,95,518190,90.75131348511384,7
0.05,5710,94,518284,90.7518823323411,7
0.05,5711,90,518374,90.75175070028011,11
0.05,5712,92,518466,90.75196919306845,9
0.05,5713,94,518560,90.75253762688135,7
0.05,5714,94,518654,90.75310586176728,7
0.05,5715,95,518749,90.7538488453464,6
0.05,5716,92,518841,90.75406681826132,9
0.05,5717,94,518935,90.75463448758308,7
0.05,5718,20,518955,90.7422626333275,13
0.05,5719,96,519051,90.74318181818182,6
0.05,5720,95,519146,90.74392588708268,6
0.05,5721,92,519238,90.744145403705,9
0.05,5722,92,519330,90.7443648436135,9
0.05,5723,93,519423,90.74475890985325,8
0.05,5724,95,519518,90.74550218340612,6
0.05,5725,94,519612,90.74607055536151,7
0.05,5726,94,519706,90.74663872882836,7
0.05,5727,92,519798,90.74685754189944,9
0.05,5728,93,519891,90.74725082911503,8
0.05,5729,92,519983,90.74746945898778,9
0.05,5730,94,520077,90.74803699179898,7
0.05,5731,93,520170,90.74842986741102,8
0.05,5732,96,520266,90.74934589220304,6
0.05,5733,95,520361,90.75008719916289,6
0.05,5734,94,520455,90.75065387968614,7
0.05,5735,96,520551,90.7515690376569,7
0.05,5736,95,520646,90.75230956946139,6
0.05,5737,91,520737,90.752352736145,10
0.05,5738,94,520831,90.7529186269385,7
0.05,5739,95,520926,90.75365853658536,7
0.05,5740,94,521020,90.75422400278697,8
0.05,5741,94,521114,90.75478927203065,7
0.05,5742,25,521139,90.74333971791746,7
0.05,5743,96,521235,90.74425487465182,6
0.05,5744,93,521328,90.74464751958224,8
0.05,5745,95,521423,90.74538809606683,6
0.05,5746,93,521516,90.74578040716895,8
0.05,5747,94,521610,90.7463465553236,7
0.05,5748,93,521703,90.74673856322839,8
0.05,5749,93,521796,90.7471304347826,8
0.05,5750,95,521891,90.74786993566336,6
0.05,5751,88,521979,90.74739221140473,13
0.05,5752,93,522072,90.74778376499218,8
0.05,5753,93,522165,90.74817518248175,8
0.05,5754,94,522259,90.74874022589053,7
0.05,5755,92,522351,90.74895760945101,9
0.05,5756,91,522442,90.74900121591106,11
0.05,5757,93,522535,90.7493921500521,8
0.05,5758,95,522630,90.75013023094287,6
0.05,5759,94,522724,90.75069444444445,8
0.05,5760,96,522820,90.75160562402361,6
0.05,5761,94,522914,90.75216938562998,8
0.05,5762,96,523010,90.75307999305917,6
0.05,5763,92,523102,90.75329632199862,9
0.05,5764,96,523198,90.7542064180399,6
0.05,5765,94,523292,90.75476933749566,7
0.05,5766,92,523384,90.75498526096757,9
0.05,5767,90,523474,90.75485436893204,11
0.05,5768,94,523568,90.755416883342,7
0.05,5769,95,523663,90.75615251299827,7
0.05,5770,94,523757,90.75671460752037,7
0.05,5771,95,523852,90.75744975744976,7
0.05,5772,94,523946,90.75801143253075,7
0.05,5773,94,524040,90.75857291305854,7
0.05,5774,93,524133,90.75896103896103,8
0.05,5775,95,524228,90.75969529085873,6
0.05,5776,92,524320,90.75990998788298,9
0.05,5777,91,524411,90.75995154032537,10
0.05,5778,91,524502,90.75999307838727,10
0.05,5779,96,524598,90.76089965397924,6
0.05,5780,94,524692,90.76145995502509,7
0.05,5781,96,524788,90.76236596333449,6
0.05,5782,91,524879,90.76240705516167,10
0.05,5783,93,524972,90.7627939142462,8
0.05,5784,94,525066,90.76335350043215,7
0.05,5785,93,525159,90.76374006221916,8
0.05,5786,94,525253,90.76429929151547,7
0.05,5787,94,525347,90.76485832757429,7
0.05,5788,96,525443,90.765762653308,6
0.05,5789,94,525537,90.76632124352332,7
0.05,5790,91,525628,90.76636159557934,10
0.05,5791,94,525722,90.76691988950276,7
0.05,5792,94,525816,90.7674779906784,8
0.05,5793,91,525907,90.76751812219537,10
0.05,5794,94,526001,90.76807592752372,7
0.05,5795,95,526096,90.7688060731539,6
0.05,5796,95,526191,90.76953596687942,6
0.05,5797,92,526283,90.7697481890307,9
0.05,5798,96,526379,90.77065011208829,6
0.05,5799,96,526475,90.77155172413794,6
0.05,5800,96,526571,90.77245302534045,6
0.05,5801,96,526667,90.7733540158566,6
0.05,5802,94,526761,90.77391004652766,7
0.05,5803,23,526784,90.76223294279806,9
0.05,5804,92,526876,90.76244616709732,9
0.05,5805,91,526967,90.76248708232862,10
0.05,5806,27,526994,90.75150680213535,6
0.05,5807,95,527089,90.75223829201101,6
0.05,5808,94,527183,90.75279738337063,7
0.05,5809,88,527271,90.75232358003443,13
0.05,5810,92,527363,90.75253828945104,9
0.05,5811,94,527457,90.75309704060564,7
0.05,5812,88,527545,90.75262343024256,14
0.05,5813,94,527639,90.7531819745442,8
0.05,5814,93,527732,90.75356835769561,8
0.05,5815,95,527827,90.7542984869326,6
0.05,5816,94,527921,90.75485645521746,7
0.05,5817,91,528012,90.75489859058095,10
0.05,5818,89,528101,90.7545970097955,12
0.05,5819,95,528196,90.7553264604811,7
0.05,5820,92,528288,90.75554028517436,9
0.05,5821,95,528383,90.75626932325662,6
0.05,5822,95,528478,90.75699811093938,6
0.05,5823,90,528568,90.75686813186813,11
0.05,5824,95,528663,90.7575965665236,6
0.05,5825,95,528758,90.7583247511157,6
0.05,5826,23,528781,90.74669641324867,9
0.05,5827,92,528873,90.74691146190803,10
0.05,5828,94,528967,90.74746954880769,7
0.05,5829,93,529060,90.74785591766724,8
0.05,5830,94,529154,90.74841365117476,7
0.05,5831,94,529248,90.74897119341564,7
0.05,5832,94,529342,90.74952854448826,8
0.05,5833,94,529436,90.75008570449091,7
0.05,5834,94,529530,90.75064267352185,7
0.05,5835,96,529626,90.75154215215902,6
0.05,5836,96,529722,90.75244132259722,6
0.05,5837,94,529816,90.75299760191847,7
0.05,5838,93,529909,90.75338242849803,8
0.05,5839,94,530003,90.75393835616438,7
0.05,5840,93,530096,90.75432288991611,8
0.05,5841,95,530191,90.75504964053407,6
0.05,5842,92,530283,90.75526270751327,9
0.05,5843,93,530376,90.75564681724846,9
0.05,5844,91,530467,90.75568862275449,11
0.05,5845,95,530562,90.7564146424906,6
0.05,5846,92,530654,90.75662733025483,10
0.05,5847,90,530744,90.75649794801642,11
0.05,5848,94,530838,90.75705248760472,7
0.05,5849,93,530931,90.7574358974359,8
0.05,5850,94,531025,90.75799008716459,8
0.05,5851,94,531119,90.75854408749146,7
0.05,5852,95,531214,90.75926875106782,6
0.05,5853,94,531308,90.75982234369661,7
0.05,5854,95,531403,90.7605465414176,6
0.05,5855,95,531498,90.76127049180327,6
0.05,5856,92,531590,90.76148198736554,9
0.05,5857,93,531683,90.76186411744622,8
0.05,5858,95,531778,90.7625874722649,7
0.05,5859,92,531870,90.76279863481228,9
0.05,5860,90,531960,90.76266848660639,11
0.05,5861,94,532054,90.76322074377346,7
0.05,5862,94,532148,90.7637728125533,7
0.05,5863,90,532238,90.76364256480218,11
0.05,5864,92,532330,90.76385336743392,9
0.05,5865,90,532420,90.76372315035799,11
0.05,5866,95,532515,90.76444520197715,6
0.05,5867,93,532608,90.76482617586912,8
0.05,5868,94,532702,90.76537740671324,7
0.05,5869,94,532796,90.76592844974446,8
0.05,5870,94,532890,90.76647930505877,7
0.05,5871,93,532983,90.76685967302453,8
0.05,5872,95,533078,90.76758045292014,6
0.05,5873,94,533172,90.76813074565884,7
0.05,5874,94,533266,90.76868085106383,7
0.05,5875,92,533358,90.76889040163377,9
0.05,5876,93,533451,90.76927003573252,8
0.05,5877,96,533547,90.77015991833957,6
0.05,5878,96,533643,90.77104949821398,7
0.05,5879,93,533736,90.77142857142857,8
0.05,5880,92,533828,90.77163747661962,9
0.05,5881,95,533923,90.77235634138049,6
0.05,5882,92,534015,90.77256501784804,9
0.05,5883,94,534109,90.77311352821211,7
0.05,5884,96,534205,90.77400169923534,6
0.05,5885,96,534301,90.77488956846754,6
0.05,5886,94,534395,90.77543740445049,7
0.05,5887,94,534489,90.77598505434783,8
0.05,5888,94,534583,90.77653251825437,7
0.05,5889,93,534676,90.77691001697792,8
0.05,5890,95,534771,90.77762688847395,6
0.05,5891,92,534863,90.77783435166327,9
0.05,5892,93,534956,90.7782114372985,9
0.05,5893,94,535050,90.7787580590431,7
0.05,5894,92,535142,90.77896522476675,9
0.05,5895,95,535237,90.77968113975577,6
0.05,5896,92,535329,90.77988807868408,9
0.05,5897,94,535423,90.78043404543914,7
0.05,5898,96,535519,90.78131886760468,6
0.05,5899,94,535613,90.78186440677966,7
0.05,5900,91,535704,90.7819013726487,10
0.05,5901,94,535798,90.78244662826161,7
0.05,5902,96,535894,90.78333050991021,6
0.05,5903,94,535988,90.78387533875339,7
0.05,5904,93,536081,90.78425063505505,9
0.05,5905,95,536176,90.78496444293938,7
0.05,5906,91,536267,90.78500084645336,10
0.05,5907,94,536361,90.78554502369668,7
0.05,5908,92,536453,90.78575055000846,9
0.05,5909,94,536547,90.78629441624365,7
0.05,5910,92,536639,90.78649974623583,9
0.05,5911,25,536664,90.77537212449256,8
0.05,5912,17,536681,90.76289531540674,16
0.05,5913,94,536775,90.76344267839026,7
0.05,5914,94,536869,90.76398985629754,7
0.05,5915,94,536963,90.76453684922245,8
0.05,5916,92,537055,90.7647456481325,9
0.05,5917,94,537149,90.76529232848935,7
0.05,5918,91,537240,90.76533198175368,10
0.05,5919,23,537263,90.75388513513514,10
0.05,5920,94,537357,90.75443337274109,7
0.05,5921,95,537452,90.75515028706518,6
0.05,5922,95,537547,90.75586695931116,6
0.05,5923,92,537639,90.75607697501688,9
0.05,5924,94,537733,90.75662447257383,7
0.05,5925,92,537825,90.75683428957139,9
0.05,5926,91,537916,90.75687531634891,10
0.05,5927,90,538006,90.75674763832659,15
0.05,5928,27,538033,90.74599426547479,6
0.05,5929,94,538127,90.74654300168633,8
0.05,5930,94,538221,90.74709155285787,7
0.05,5931,90,538311,90.74696561024949,11
0.05,5932,94,538405,90.74751390527558,7
0.05,5933,21,538426,90.73576002696326,11
0.05,5934,93,538519,90.73614153327716,8
0.05,5935,93,538612,90.73652291105121,8
0.05,5936,96,538708,90.7374094660603,6
0.05,5937,94,538802,90.73795890872347,7
0.05,5938,96,538898,90.73884492338777,6
0.05,5939,91,538989,90.7388888888889,10
0.05,5940,94,539083,90.73943780508331,8
0.05,5941,96,539179,90.74032312352743,6
0.05,5942,92,539271,90.74053508329126,9
0.05,5943,95,539366,90.74125168236877,6
0.05,5944,96,539462,90.7421362489487,6
0.05,5945,95,539557,90.74285233770603,6
0.05,5946,96,539653,90.74373633764924,6
0.05,5947,94,539747,90.74428379287156,7
0.05,5948,94,539841,90.74483106404438,8
0.05,5949,91,539932,90.74487394957983,11
0.05,5950,95,540027,90.74558897664258,6
0.05,5951,91,540118,90.74563172043011,10
0.05,5952,94,540212,90.74617839744667,7
0.05,5953,96,540308,90.74706079946255,6
0.05,5954,92,540400,90.7472712006717,10
0.05,5955,92,540492,90.74748153122901,9
0.05,5956,95,540587,90.74819540036931,6
0.05,5957,91,540678,90.74823766364553,10
0.05,5958,94,540772,90.74878335291156,8
0.05,5959,94,540866,90.7493288590604,7
0.05,5960,92,540958,90.74953866800873,9
0.05,5961,96,541054,90.75041932237504,6
0.05,5962,96,541150,90.75129968136844,6
0.05,5963,92,541242,90.75150905432595,9
0.05,5964,92,541334,90.75171835708298,9
0.05,5965,94,541428,90.75226282266175,7
0.05,5966,93,541521,90.7526395173454,8
0.05,5967,93,541614,90.75301608579089,8
0.05,5968,92,541706,90.75322499581169,9
0.05,5969,96,541802,90.75410385259632,6
0.05,5970,96,541898,90.75498241500586,6
0.05,5971,96,541994,90.75586068318822,6
0.05,5972,94,542088,90.7564038171773,7
0.05,5973,93,542181,90.75677937730164,8
0.05,5974,90,542271,90.75665271966527,14
0.05,5975,89,542360,90.75635876840695,12
0.05,5976,93,542453,90.75673414756567,8
0.05,5977,93,542546,90.7571094011375,8
0.05,5978,93,542639,90.75748452918548,8
0.05,5979,92,542731,90.75769230769231,9
0.05,5980,95,542826,90.75840160508277,6
0.05,5981,94,542920,90.75894349715814,7
0.05,5982,92,543012,90.75915092762828,10
0.05,5983,89,543101,90.75885695187166,12
0.05,5984,95,543196,90.75956558061822,6
0.05,5985,95,543291,90.76027397260275,6
0.05,5986,94,543385,90.760815099382,7
0.05,5987,94,543479,90.76135604542418,7
0.05,5988,94,543573,90.76189681081983,7
0.05,5989,95,543668,90.7626043405676,6
0.05,5990,95,543763,90.76331163411784,6
0.05,5991,93,543856,90.76368491321762,9
0.05,5992,93,543949,90.76405806774571,8
0.05,5993,95,544044,90.76476476476476,7
0.05,5994,96,544140,90.76563803169307,6
0.05,5995,94,544234,90.76617745163442,8
0.05,5996,92,544326,90.76638319159579,9
0.05,5997,91,544417,90.76642214071357,10
0.05,5998,96,544513,90.76729454909152,6
0.05,5999,93,544606,90.76766666666667,8
0.05,6000,92,544698,90.76787202132978,9
0.05,6001,96,544794,90.76874375208264,6
0.05,6002,92,544886,90.76894885890388,9
0.05,6003,96,544982,90.76982011992006,6
0.05,6004,87,545069,90.76919233971691,14
0.05,6005,96,545165,90.77006327006328,6
0.05,6006,92,545257,90.77026802064259,9
0.05,6007,95,545352,90.77097203728363,6
0.05,6008,90,545442,90.7708437343984,11
0.05,6009,94,545536,90.77138103161397,7
0.05,6010,94,545630,90.77191815005823,7
0.05,6011,96,545726,90.7727877578177,6
0.05,6012,91,545817,90.77282554465324,10
0.05,6013,93,545910,90.77319587628865,9
0.05,6014,92,546002,90.77339983374897,9
0.05,6015,93,546095,90.77376994680851,8
0.05,6016,93,546188,90.7741399368456,8
0.05,6017,89,546277,90.77384513127285,12
0.05,6018,91,546368,90.77388270476824,10
0.05,6019,95,546463,90.77458471760798,6
0.05,6020,92,546555,90.77478824115596,9
0.05,6021,95,546650,90.77548987047493,6
0.05,6022,93,546743,90.77585920637556,8
0.05,6023,93,546836,90.77622841965471,9
0.05,6024,96,546932,90.77709543568464,6
0.05,6025,92,547024,90.7772983737139,9
0.05,6026,94,547118,90.77783308445329,7
0.05,6027,91,547209,90.7778699402787,10
0.05,6028,94,547303,90.77840437883563,7
0.05,6029,95,547398,90.77910447761194,6
0.05,6030,92,547490,90.77930691427623,9
0.05,6031,95,547585,90.78000663129974,6
0.05,6032,95,547680,90.78070611636002,6
0.05,6033,95,547775,90.78140536957243,6
0.05,6034,90,547865,90.78127589063794,11
0.05,6035,93,547958,90.78164347249835,10
0.05,6036,94,548052,90.78217657777041,7
0.05,6037,94,548146,90.7827095064591,7
0.05,6038,92,548238,90.78291107799305,9
0.05,6039,94,548332,90.78344370860927,8
0.05,6040,93,548425,90.78381062737957,8
0.05,6041,94,548519,90.78434293280371,7
0.05,6042,94,548613,90.78487506205526,7
0.05,6043,96,548709,90.78573792190602,6
0.05,6044,96,548805,90.78660049627791,6
0.05,6045,96,548901,90.7874627853126,6
0.05,6046,95,548996,90.78815941789317,7
0.05,6047,96,549092,90.78902116402116,6
0.05,6048,95,549187,90.78971730864606,7
0.05,6049,95,549282,90.79041322314049,6
0.05,6050,94,549376,90.7909436456784,8
0.05,6051,94,549470,90.79147389292795,7
0.05,6052,94,549564,90.79200396497605,7
0.05,6053,94,549658,90.79253386190948,7
0.05,6054,93,549751,90.79289843104873,8
0.05,6055,94,549845,90.79342800528401,7
0.05,6056,89,549934,90.79313191348852,12
0.05,6057,95,550029,90.7938263453285,6
0.05,6058,95,550124,90.79452054794521,6
0.05,6059,94,550218,90.7950495049505,7
0.05,6060,94,550312,90.79557828741132,7
0.05,6061,91,550403,90.79561200923787,10
0.05,6062,91,550494,90.79564571994062,10
0.05,6063,94,550588,90.79617414248021,8
0.05,6064,94,550682,90.7967023907667,7
0.05,6065,94,550776,90.79723046488625,7
0.05,6066,94,550870,90.797758364925,8
0.05,6067,95,550965,90.7984508899143,6
0.05,6068,93,551058,90.7988136431043,8
0.05,6069,90,551148,90.7986820428336,11
0.05,6070,94,551242,90.79920935595453,7
0.05,6071,93,551335,90.7995718050066,9
0.05,6072,94,551429,90.80009879795817,7
0.05,6073,94,551523,90.80062561738558,7
0.05,6074,95,551618,90.80131687242799,6
0.05,6075,94,551712,90.80184331797236,7
0.05,6076,94,551806,90.80236959025835,7
0.05,6077,92,551898,90.8025666337611,9
0.05,6078,93,551991,90.8029281131765,8
0.05,6079,96,552087,90.80378289473684,6
0.05,6080,93,552180,90.80414405525407,8
0.05,6081,96,552276,90.80499835580402,6
0.05,6082,96,552372,90.80585237547263,6
0.05,6083,95,552467,90.80654174884944,7
0.05,6084,95,552562,90.80723089564503,6
0.05,6085,94,552656,90.80775550443641,7
0.05,6086,93,552749,90.80811565631674,8
0.05,6087,94,552843,90.80863994743758,7
0.05,6088,93,552936,90.80899983576943,8
0.05,6089,95,553031,90.8096880131363,6
0.05,6090,92,553123,90.80988343457561,10
0.05,6091,94,553217,90.81040709126724,7
0.05,6092,94,553311,90.8109305760709,7
0.05,6093,96,553407,90.81178208073516,6
0.05,6094,93,553500,90.8121410992617,8
0.05,6095,95,553595,90.8128280839895,6
0.05,6096,27,553622,90.80236181728719,6
0.05,6097,93,553715,90.80272220400131,8
0.05,6098,95,553810,90.80341039514674,6
0.05,6099,96,553906,90.80426229508197,6
0.05,6100,93,553999,90.8046221930831,8
0.05,6101,95,554094,90.80530973451327,6
0.05,6102,96,554190,90.80616090447322,6
0.05,6103,91,554281,90.80619266055047,10
0.05,6104,93,554374,90.80655200655201,8
0.05,6105,94,554468,90.80707500818866,7
0.05,6106,91,554559,90.80710659898477,11
0.05,6107,96,554655,90.80795677799607,6
0.05,6108,94,554749,90.80847929284661,7
0.05,6109,94,554843,90.80900163666121,7
0.05,6110,95,554938,90.8096874488627,6
0.05,6111,95,555033,90.81037303664921,6
0.05,6112,93,555126,90.81073122852936,8
0.05,6113,94,555220,90.81125286228328,7
0.05,6114,92,555312,90.81144726083402,9
0.05,6115,94,555406,90.81196860693264,7
0.05,6116,92,555498,90.81216282491417,9
0.05,6117,92,555590,90.81235697940504,9
0.05,6118,94,555684,90.81287792122896,8
0.05,6119,94,555778,90.81339869281045,7
0.05,6120,91,555869,90.81342917823885,10
0.05,6121,95,555964,90.8141130349559,6
0.05,6122,94,556058,90.8146333496652,7
0.05,6123,94,556152,90.81515349444807,7
0.05,6124,93,556245,90.81551020408163,8
0.05,6125,94,556339,90.8160300359125,7
0.05,6126,91,556430,90.81606006202057,10
0.05,6127,93,556523,90.81641644908616,8
0.05,6128,95,556618,90.81709903736335,6
0.05,6129,93,556711,90.81745513866231,8
0.05,6130,94,556805,90.81797422932637,7
0.05,6131,96,556901,90.81881930854533,6
0.05,6132,93,556994,90.8191749551606,8
0.05,6133,94,557088,90.81969351157483,7
0.05,6134,94,557182,90.8202118989405,7
0.05,6135,94,557276,90.82073011734029,8
0.05,6136,94,557370,90.82124816685678,7
0.05,6137,92,557462,90.82144020853698,9
0.05,6138,93,557555,90.82179508063203,8
0.05,6139,96,557651,90.82263843648208,6
0.05,6140,95,557746,90.82331867773978,6
0.05,6141,95,557841,90.82399869749267,7
0.05,6142,93,557934,90.82435292202507,8
0.05,6143,93,558027,90.82470703125,9
0.05,6144,95,558122,90.82538649308381,6
0.05,6145,94,558216,90.8259030263586,7
0.05,6146,94,558310,90.82641939157313,7
0.05,6147,96,558406,90.82726089785297,6
0.05,6148,92,558498,90.8274516181493,9
0.05,6149,93,558591,90.82780487804878,9
0.05,6150,96,558687,90.82864574865876,6
0.05,6151,27,558714,90.81827048114434,6
0.05,6152,94,558808,90.8187875832927,7
0.05,6153,92,558900,90.81897952551186,9
0.05,6154,95,558995,90.81965881397238,6
0.05,6155,94,559089,90.8201754385965,7
0.05,6156,93,559182,90.8205294786422,8
0.05,6157,26,559208,90.81000324780773,6
0.05,6158,94,559302,90.81052118850462,8
0.05,6159,95,559397,90.81120129870129,6
0.05,6160,94,559491,90.81171887680571,7
0.05,6161,96,559587,90.81256085686465,6
0.05,6162,94,559681,90.81307804640598,7
0.05,6163,91,559772,90.81310837118754,11
0.05,6164,92,559864,90.81330089213301,9
0.05,6165,95,559959,90.81397988971781,7
0.05,6166,95,560054,90.81465866709908,6
0.05,6167,94,560148,90.81517509727627,7
0.05,6168,27,560175,90.80483060463608,6
0.05,6169,92,560267,90.80502431118315,9
0.05,6170,96,560363,90.80586614811213,6
0.05,6171,96,560459,90.80670771224887,6
0.05,6172,95,560554,90.80738700793779,6
0.05,6173,94,560648,90.80790411402656,7
0.05,6174,92,560740,90.8080971659919,9
0.05,6175,95,560835,90.80877590673575,6
0.05,6176,91,560926,90.80880686417355,10
0.05,6177,91,561017,90.80883781158951,10
0.05,6178,93,561110,90.8091924259589,8
0.05,6179,94,561204,90.80970873786407,7
0.05,6180,94,561298,90.81022488270506,7
0.05,6181,87,561385,90.80960854092527,14
0.05,6182,92,561477,90.80980106744299,9
0.05,6183,95,561572,90.8104786545925,6
0.05,6184,91,561663,90.81050929668552,10
0.05,6185,93,561756,90.81086323957322,8
0.05,6186,94,561850,90.81137869726847,7
0.05,6187,95,561945,90.81205559146736,6
0.05,6188,94,562039,90.81257068993375,7
0.05,6189,93,562132,90.81292407108239,8
0.05,6190,93,562225,90.81327733807139,8
0.05,6191,94,562319,90.81379198966408,7
0.05,6192,94,562413,90.81430647505248,7
0.05,6193,95,562508,90.81498224087827,6
0.05,6194,92,562600,90.81517352703793,9
0.05,6195,90,562690,90.81504196255649,11
0.05,6196,94,562784,90.81555591415201,7
0.05,6197,94,562878,90.8160696999032,8
0.05,6198,90,562968,90.81593805452492,11
0.05,6199,95,563063,90.8166129032258,6
0.05,6200,93,563156,90.81696500564425,8
0.05,6201,94,563250,90.81747823282812,7
0.05,6202,93,563343,90.81783008221828,8
0.05,6203,96,563439,90.81866537717602,6
0.05,6204,94,563533,90.81917808219178,7
0.05,6205,96,563629,90.82001289075089,6
0.05,6206,93,563722,90.8203641050427,8
0.05,6207,92,563814,90.82055412371135,9
0.05,6208,93,563907,90.82090513770333,8
0.05,6209,91,563998,90.82093397745572,10
0.05,6210,94,564092,90.82144582192883,8
0.05,6211,94,564186,90.82195750160979,7
0.05,6212,95,564281,90.82262996941895,6
0.05,6213,96,564377,90.82346314773093,6
0.05,6214,94,564471,90.82397425583267,7
0.05,6215,95,564566,90.82464607464607,6
0.05,6216,94,564660,90.82515682805212,7
0.05,6217,94,564754,90.82566741717594,7
0.05,6218,89,564843,90.82537385431742,13
0.05,6219,93,564936,90.82572347266881,8
0.05,6220,94,565030,90.8262337244816,7
0.05,6221,94,565124,90.826743812279,7
0.05,6222,94,565218,90.82725373614012,7
0.05,6223,93,565311,90.8276028277635,8
0.05,6224,94,565405,90.82811244979919,7
0.05,6225,93,565498,90.82846129135882,8
0.05,6226,94,565592,90.82897061185162,7
0.05,6227,95,565687,90.82964033397559,8
0.05,6228,94,565781,90.83014930165356,7
0.05,6229,27,565808,90.8199036918138,6
0.05,6230,94,565902,90.82041405873856,7
0.05,6231,94,565996,90.8209242618742,7
0.05,6232,94,566090,90.82143430129953,7
0.05,6233,96,566186,90.8222649983959,6
0.05,6234,94,566280,90.82277465918203,7
0.05,6235,93,566373,90.82312379730597,8
0.05,6236,94,566467,90.8236331569665,7
0.05,6237,96,566563,90.82446296890029,6
0.05,6238,94,566657,90.82497195063311,7
0.05,6239,94,566751,90.82548076923077,7
0.05,6240,96,566847,90.82630988623617,6
0.05,6241,93,566940,90.82665812239667,8
0.05,6242,94,567034,90.82716642639757,7
0.05,6243,94,567128,90.82767456758488,7
0.05,6244,92,567220,90.82786228983187,9
0.05,6245,95,567315,90.82853025936599,6
0.05,6246,93,567408,90.82887786137346,8
0.05,6247,94,567502,90.82938540332907,7
0.05,6248,93,567595,90.82973275724116,9
0.05,6249,95,567690,90.8304,6
0.05,6250,94,567784,90.83090705487122,7
0.05,6251,94,567878,90.83141394753679,7
0.05,6252,93,567971,90.83176075483767,10
0.05,6253,91,568062,90.83178765590023,11
0.05,6254,94,568156,90.83229416466827,7
0.05,6255,92,568248,90.83248081841433,9
0.05,6256,93,568341,90.83282723349848,8
0.05,6257,95,568436,90.83349312879514,6
0.05,6258,92,568528,90.83367950151782,10
0.05,6259,96,568624,90.83450479233227,6
0.05,6260,92,568716,90.83469094393867,9
0.05,6261,96,568812,90.83551580964549,6
0.05,6262,89,568901,90.83522273670765,12
0.05,6263,95,568996,90.83588761174968,7
0.05,6264,96,569092,90.8367118914605,6
0.05,6265,94,569186,90.83721672518352,7
0.05,6266,94,569280,90.83772139779799,7
0.05,6267,94,569374,90.83822590938098,7
0.05,6268,95,569469,90.83888977508374,6
0.05,6269,94,569563,90.83939393939394,7
0.05,6270,93,569656,90.83973847871152,8
0.05,6271,92,569748,90.83992346938776,9
0.05,6272,94,569842,90.84042722780168,7
0.05,6273,95,569937,90.84109021357985,6
0.05,6274,94,570031,90.841593625498,7
0.05,6275,95,570126,90.84225621414915,7
0.05,6276,95,570221,90.84291859168393,6
0.05,6277,96,570317,90.8437400446002,6
0.05,6278,95,570412,90.84440197483676,7
0.05,6279,95,570507,90.84506369426751,6
0.05,6280,96,570603,90.84588441330999,6
0.05,6281,94,570697,90.8463865011143,7
0.05,6282,92,570789,90.84657010982015,9
0.05,6283,94,570883,90.84707192870783,7
0.05,6284,95,570978,90.84773269689738,6
0.05,6285,94,571072,90.84823417117404,7
0.05,6286,88,571160,90.8477811356768,13
0.05,6287,96,571256,90.84860050890585,6
0.05,6288,93,571349,90.8489425981873,8
0.05,6289,94,571443,90.84944356120826,7
0.05,6290,94,571537,90.84994436496582,7
0.05,6291,95,571632,90.85060394151303,6
0.05,6292,94,571726,90.8511044017162,7
0.05,6293,96,571822,90.85192246584049,6
0.05,6294,94,571916,90.85242255758538,7
0.05,6295,93,572009,90.85276365946633,8
0.05,6296,94,572103,90.8532634587899,7
0.05,6297,94,572197,90.85376309939663,7
0.05,6298,94,572291,90.85426258136212,7
0.05,6299,95,572386,90.85492063492063,6
0.05,6300,95,572481,90.85557847960641,6
0.05,6301,96,572577,90.85639479530307,6
0.05,6302,94,572671,90.85689354275742,7
0.05,6303,94,572765,90.8573921319797,8
0.05,6304,93,572858,90.85773195876288,9
0.05,6305,96,572954,90.85854741516016,6
0.05,6306,27,572981,90.84842238782305,6
0.05,6307,94,573075,90.84892200380469,7
0.05,6308,90,573165,90.848787446505,11
0.05,6309,94,573259,90.84928684627575,7
0.05,6310,94,573353,90.84978608778323,7
0.05,6311,96,573449,90.8506020278834,6
0.05,6312,93,573542,90.85094249960399,8
0.05,6313,90,573632,90.85080772885651,11
0.05,6314,91,573723,90.85083135391923,10
0.05,6315,93,573816,90.85117162761242,8
0.05,6316,96,573912,90.85198670254867,7
0.05,6317,93,574005,90.85232668566002,8
0.05,6318,95,574100,90.85298306694096,6
0.05,6319,94,574194,90.85348101265822,7
0.05,6320,94,574288,90.85397880082266,7
0.05,6321,96,574384,90.85479278709269,6
0.05,6322,93,574477,90.85513205756762,8
0.05,6323,94,574571,90.8556293485136,7
0.05,6324,95,574666,90.85628458498023,6
0.05,6325,94,574760,90.85678153651597,8
0.05,6326,93,574853,90.85712027817291,8
0.05,6327,95,574948,90.85777496839444,6
0.05,6328,94,575042,90.85827144888609,7
0.05,6329,96,575138,90.85908372827804,6
0.05,6330,95,575233,90.85973779813615,6
0.05,6331,87,575320,90.85912823752369,14
0.05,6332,95,575415,90.85978209379441,6
0.05,6333,92,575507,90.85996210925165,9
0.05,6334,94,575601,90.86045777426993,8
0.05,6335,92,575693,90.86063762626263,10
0.05,6336,91,575784,90.86065961811583,10
0.05,6337,95,575879,90.8613127169454,6
0.05,6338,93,575972,90.86165010253983,8
0.05,6339,91,576063,90.86167192429022,10
0.05,6340,94,576157,90.86216685065448,7
0.05,6341,92,576249,90.86234626300852,9
0.05,6342,94,576343,90.86284092700615,7
0.05,6343,91,576434,90.86286254728877,10
0.05,6344,95,576529,90.8635145784082,6
0.05,6345,92,576621,90.86369366530097,9
0.05,6346,91,576712,90.8637151410115,10
0.05,6347,95,576807,90.86436672967864,6
0.05,6348,22,576829,90.85352023940779,12
0.05,6349,94,576923,90.8540157480315,7
0.05,6350,92,577015,90.85419618957644,9
0.05,6351,94,577109,90.85469143576826,7
0.05,6352,91,577200,90.85471430820085,10
0.05,6353,94,577294,90.85520931696568,7
0.05,6354,96,577390,90.85601888276948,6
0.05,6355,95,577485,90.85667086217747,6
0.05,6356,92,577577,90.85685071574642,9
0.05,6357,96,577673,90.85765964139667,6
0.05,6358,94,577767,90.85815379776695,7
0.05,6359,94,577861,90.85864779874214,7
0.05,6360,94,577955,90.85914164439554,7
0.05,6361,94,578049,90.85963533480037,7
0.05,6362,93,578142,90.85997171145686,8
0.05,6363,88,578230,90.85952231301069,13
0.05,6364,94,578324,90.86001571091909,7
0.05,6365,25,578349,90.84967012252592,8
0.05,6366,95,578444,90.8503219726716,6
0.05,6367,94,578538,90.85081658291458,7
0.05,6368,95,578633,90.85146804835924,7
0.05,6369,94,578727,90.8519623233909,7
0.05,6370,92,578819,90.85214252079736,10
0.05,6371,93,578912,90.85247959824231,8
0.05,6372,94,579006,90.85297348187667,7
0.05,6373,96,579102,90.85378098525258,6
0.05,6374,89,579191,90.85349019607843,12
0.05,6375,94,579285,90.85398368883313,7
0.05,6376,95,579380,90.8546338403638,6
0.05,6377,95,579475,90.85528378802132,6
0.05,6378,95,579570,90.85593353190156,6
0.05,6379,95,579665,90.8565830721003,7
0.05,6380,94,579759,90.85707569346498,7
0.05,6381,95,579854,90.85772485114384,6
0.05,6382,94,579948,90.8582171392762,8
0.05,6383,96,580044,90.85902255639098,6
0.05,6384,93,580137,90.85935787000783,8
0.05,6385,86,580223,90.85859693078609,16
0.05,6386,90,580313,90.8584625019571,11
0.05,6387,94,580407,90.85895428929243,8
0.05,6388,94,580501,90.85944592267961,7
0.05,6389,95,580596,90.86009389671362,9
0.05,6390,95,580691,90.86074166797059,6
0.05,6391,94,580785,90.86123279098874,7
0.05,6392,95,580880,90.86188018144846,6
0.05,6393,95,580975,90.86252736940882,7
0.05,6394,94,581069,90.86301798279906,7
0.05,6395,93,581162,90.86335209505941,8
0.05,6396,94,581256,90.86384242613725,8
0.05,6397,96,581352,90.8646452016255,6
0.05,6398,95,581447,90.86529145178935,8
0.05,6399,95,581542,90.8659375,6
0.05,6400,93,581635,90.86627089517263,8
0.05,6401,92,581727,90.86644798500468,9
0.05,6402,93,581820,90.86678119631422,8
0.05,6403,94,581914,90.86727045596503,7
0.05,6404,94,582008,90.86775956284153,7
0.05,6405,94,582102,90.8682485170153,7
0.05,6406,94,582196,90.86873731855783,7
0.05,6407,96,582292,90.86953807740325,6
0.05,6408,95,582387,90.87018255578093,6
0.05,6409,94,582481,90.87067082683308,7
0.05,6410,96,582577,90.87147090937451,6
0.05,6411,93,582670,90.87180286961946,10
0.05,6412,89,582759,90.87151099329488,13
0.05,6413,92,582851,90.87168693483007,9
0.05,6414,94,582945,90.8721745908028,8
0.05,6415,92,583037,90.87235037406484,9
0.05,6416,95,583132,90.87299361072152,6
0.05,6417,94,583226,90.87348083515114,7
0.05,6418,93,583319,90.87381212026796,8
0.05,6419,91,583410,90.87383177570094,10
0.05,6420,94,583504,90.87431864195608,8
0.05,6421,90,583594,90.87418249766428,11
0.05,6422,94,583688,90.87466915771446,8
0.05,6423,94,583782,90.87515566625156,7
0.05,6424,94,583876,90.8756420233463,7
0.05,6425,94,583970,90.87612822906941,7
0.05,6426,95,584065,90.87676987708106,6
0.05,6427,95,584160,90.87741132545115,6
0.05,6428,92,584252,90.8775859387152,9
0.05,6429,96,584348,90.87838258164852,6
0.05,6430,91,584439,90.8784014927694,10
0.05,6431,94,584533,90.8788868159204,7
0.05,6432,94,584627,90.87937198818592,8
0.05,6433,93,584720,90.87970158532795,8
0.05,6434,95,584815,90.88034188034187,6
0.05,6435,95,584910,90.88098197638284,6
0.05,6436,96,585006,90.88177722541556,6
0.05,6437,95,585101,90.88241689965828,6
0.05,6438,92,585193,90.88259046435782,10
0.05,6439,93,585286,90.88291925465839,8
0.05,6440,93,585379,90.88324794286602,8
0.05,6441,96,585475,90.88404222291214,6
0.05,6442,94,585569,90.88452584199906,7
0.05,6443,93,585662,90.88485412787088,8
0.05,6444,95,585757,90.88549262994569,6
0.05,6445,94,585851,90.88597579894508,10
0.05,6446,95,585946,90.8866139289592,6
0.05,6447,91,586037,90.88663151364764,10
0.05,6448,94,586131,90.88711428128391,7
0.05,6449,92,586223,90.88728682170543,9
0.05,6450,94,586317,90.88776933808712,7
0.05,6451,94,586411,90.88825170489771,7
0.05,6452,94,586505,90.88873392220673,7
0.05,6453,96,586601,90.88952587542609,6
0.05,6454,94,586695,90.89000774593339,8
0.05,6455,94,586789,90.89048946716233,7
0.05,6456,94,586883,90.89097103918229,7
0.05,6457,94,586977,90.89145246206256,7
0.05,6458,95,587072,90.8920885586004,6
0.05,6459,95,587167,90.89272445820434,7
0.05,6460,94,587261,90.89320538616313,7
0.05,6461,95,587356,90.89384091612504,6
0.05,6462,93,587449,90.89416679560576,8
0.05,6463,96,587545,90.89495668316832,6
0.05,6464,94,587639,90.8954369682908,7
0.05,6465,88,587727,90.89498917414167,13
0.05,6466,90,587817,90.89485078088758,11
0.05,6467,94,587911,90.89533085961658,7
0.05,6468,93,588004,90.89565620652341,8
0.05,6469,88,588092,90.8952086553323,13
0.05,6470,94,588186,90.89568845618915,7
0.05,6471,94,588280,90.89616810877627,7
0.05,6472,94,588374,90.89664761316237,7
0.05,6473,96,588470,90.8974358974359,6
0.05,6474,95,588565,90.8980694980695,8
0.05,6475,94,588659,90.8985484867202,8
0.05,6476,89,588748,90.89825536513818,12
0.05,6477,90,588838,90.89811670268601,12
0.05,6478,95,588933,90.898749807069,6
0.05,6479,94,589027,90.89922839506173,7
0.05,6480,95,589122,90.89986113254128,7
0.05,6481,96,589218,90.90064794816415,6
0.05,6482,93,589311,90.90097177232762,8
0.05,6483,93,589404,90.90129549660703,8
0.05,6484,89,589493,90.90100231303006,12
0.05,6485,95,589588,90.90163428923836,6
0.05,6486,95,589683,90.90226607060275,7
0.05,6487,93,589776,90.90258939580764,9
0.05,6488,24,589800,90.8922792417938,8
0.05,6489,94,589894,90.89275808936826,8
0.05,6490,93,589987,90.89308272993375,8
0.05,6491,90,590077,90.89294516327789,11
0.05,6492,95,590172,90.89357769906053,6
0.05,6493,94,590266,90.89405605174007,7
0.05,6494,93,590359,90.89438029253272,8
0.05,6495,92,590451,90.89455049261083,10
0.05,6496,94,590545,90.89502847468061,7
0.05,6497,90,590635,90.89489073561096,11
0.05,6498,92,590727,90.89506077858132,9
0.05,6499,92,590819,90.89523076923076,9
0.05,6500,94,590913,90.89570835256114,7
0.05,6501,94,591007,90.896185788988,7
0.05,6502,94,591101,90.89666307857912,7
0.05,6503,94,591195,90.89714022140221,7
0.05,6504,92,591287,90.89730976172176,9
0.05,6505,94,591381,90.8977866584691,9
0.05,6506,95,591476,90.89841708928846,6
0.05,6507,95,591571,90.89904732636755,6
0.05,6508,93,591664,90.8993701029344,8
0.05,6509,96,591760,90.90015360983102,6
0.05,6510,94,591854,90.90062970357856,7
0.05,6511,93,591947,90.90095208845209,8
0.05,6512,95,592042,90.90158145247966,7
0.05,6513,94,592136,90.90205710776789,8
0.05,6514,94,592230,90.90253261703761,7
0.05,6515,94,592324,90.90300798035605,7
0.05,6516,94,592418,90.9034831977904,7
0.05,6517,94,592512,90.9039582694078,7
0.05,6518,96,592608,90.90473999079613,6
0.05,6519,23,592631,90.89432515337424,9
0.05,6520,92,592723,90.8944947094004,9
0.05,6521,94,592817,90.89497086783196,7
0.05,6522,95,592912,90.89560018396443,6
0.05,6523,94,593006,90.89607602697731,8
0.05,6524,93,593099,90.89639846743295,8
0.05,6525,94,593193,90.89687404229237,7
0.05,6526,95,593288,90.89750268117052,8
0.05,6527,93,593381,90.89782475490196,8
0.05,6528,95,593476,90.8984530555981,7
0.05,6529,96,593572,90.89923430321592,6
0.05,6530,94,593666,90.89970907977339,7
0.05,6531,93,593759,90.90003061849357,8
0.05,6532,96,593855,90.90081126588092,6
0.05,6533,95,593950,90.90143862871136,9
0.05,6534,95,594045,90.90206579954094,6
0.05,6535,96,594141,90.90284577723378,6
0.05,6536,95,594236,90.90347254092092,6
0.05,6537,25,594261,90.89339247476292,7
0.05,6538,94,594355,90.89386756384768,7
0.05,6539,96,594451,90.89464831804281,6
0.05,6540,93,594544,90.89497018804464,9
0.05,6541,93,594637,90.89529195964536,8
0.05,6542,92,594729,90.89546079779917,9
0.05,6543,96,594825,90.89624083129584,6
0.05,6544,27,594852,90.88647822765469,6
0.05,6545,92,594944,90.88664833486098,9
0.05,6546,95,595039,90.88727661524362,6
0.05,6547,94,595133,90.88775198533904,7
0.05,6548,90,595223,90.88761642998931,11
0.05,6549,92,595315,90.88778625954198,9
0.05,6550,95,595410,90.88841398259808,6
0.05,6551,96,595506,90.88919413919415,6
0.05,6552,96,595602,90.8899740576835,6
0.05,6553,95,595697,90.8906011595972,6
0.05,6554,94,595791,90.89107551487415,8
0.05,6555,94,595885,90.89154972544235,7
0.05,6556,92,595977,90.8917187738295,9
0.05,6557,96,596073,90.89249771271729,6
0.05,6558,94,596167,90.89297148955633,7
0.05,6559,94,596261,90.89344512195122,10
0.05,6560,93,596354,90.89376619417772,8
0.05,6561,96,596450,90.8945443462359,6
0.05,6562,95,596545,90.89516989181777,6
0.05,6563,93,596638,90.89549055453992,8
0.05,6564,95,596733,90.89611576542269,6
0.05,6565,93,596826,90.89643618641486,8
0.05,6566,96,596922,90.8972133394244,6
0.05,6567,94,597016,90.89768574908648,7
0.05,6568,95,597111,90.89831024509057,6
0.05,6569,96,597207,90.89908675799087,6
0.05,6570,95,597302,90.89971085070765,6
0.05,6571,96,597398,90.90048691418137,6
0.05,6572,96,597494,90.90126274151834,6
0.05,6573,94,597588,90.90173410404624,8
0.05,6574,94,597682,90.90220532319391,7
0.05,6575,95,597777,90.90282846715328,6
0.05,6576,95,597872,90.9034514216208,6
0.05,6577,93,597965,90.90377014290058,8
0.05,6578,91,598056,90.90378476972184,10
0.05,6579,92,598148,90.90395136778116,9
0.05,6580,95,598243,90.90457377298283,6
0.05,6581,-44,598199,90.8840777879064,8
0.05,6582,94,598293,90.88455111651223,7
0.05,6583,92,598385,90.88472053462941,10
0.05,6584,96,598481,90.88549734244495,6
0.05,6585,25,598506,90.87549347099909,8
0.05,6586,94,598600,90.87596781539396,7
0.05,6587,95,598695,90.87659380692168,8
0.05,6588,88,598783,90.87615723174989,13
0.05,6589,27,598810,90.86646433990896,6
0.05,6590,95,598905,90.86709148839326,7
0.05,6591,96,599001,90.86787014563107,7
0.05,6592,94,599095,90.86834521462157,7
0.05,6593,94,599189,90.86882013952078,7
0.05,6594,93,599282,90.8691432903715,8
0.05,6595,92,599374,90.86931473620376,9
0.05,6596,93,599467,90.86963771411247,8
0.05,6597,94,599561,90.87011215519854,7
0.05,6598,92,599653,90.87028337626913,10
0.05,6599,94,599747,90.87075757575758,7
0.05,6600,94,599841,90.87123163157098,7
0.05,6601,94,599935,90.87170554377461,7
0.05,6602,95,600030,90.87233075874603,6
0.05,6603,94,600124,90.87280436099334,8
0.05,6604,95,600219,90.87342922028766,8
0.05,6605,93,600312,90.87375113533152,8
0.05,6606,93,600405,90.87407295292871,8
0.05,6607,95,600500,90.87469733656174,6
0.05,6608,94,600594,90.87517022242396,7
0.05,6609,95,600689,90.87579425113465,6
0.05,6610,94,600783,90.87626682801391,8
0.05,6611,95,600878,90.87689050211736,7
0.05,6612,94,600972,90.87736277030092,7
0.05,6613,93,601065,90.87768370123979,8
0.05,6614,92,601157,90.87785336356765,9
0.05,6615,94,601251,90.87832527206771,7
0.05,6616,95,601346,90.87894816382047,6
0.05,6617,95,601441,90.87957086733152,6
0.05,6618,85,601526,90.87868258045022,16
0.05,6619,94,601620,90.87915407854985,7
0.05,6620,88,601708,90.87871922670291,13
0.05,6621,95,601803,90.87934158864391,6
0.05,6622,94,601897,90.87981277366752,7
0.05,6623,95,601992,90.8804347826087,7
0.05,6624,96,602088,90.88120754716981,6
0.05,6625,94,602182,90.88167823724721,7
0.05,6626,93,602275,90.88199788743022,8
0.05,6627,92,602367,90.88216656608328,9
0.05,6628,94,602461,90.88263689847639,8
0.05,6629,94,602555,90.88310708898945,8
0.05,6630,95,602650,90.8837279445031,6
0.05,6631,95,602745,90.8843486127865,6
0.05,6632,94,602839,90.88481833257953,7
0.05,6633,95,602934,90.88543864938197,6
0.05,6634,91,603025,90.8854559155991,10
0.05,6635,96,603121,90.88622664255576,6
0.05,6636,95,603216,90.88684646677716,6
0.05,6637,93,603309,90.88716480867731,8
0.05,6638,95,603404,90.88778430486519,6
0.05,6639,90,603494,90.88765060240964,11
0.05,6640,87,603581,90.88706520102394,14
0.05,6641,87,603668,90.88647997591087,14
0.05,6642,93,603761,90.88679813337347,8
0.05,6643,95,603856,90.88741721854305,7
0.05,6644,93,603949,90.8877351392024,8
0.05,6645,94,604043,90.88820343063497,8
0.05,6646,92,604135,90.88837069354597,9
0.05,6647,95,604230,90.88898916967509,6
0.05,6648,94,604324,90.88945706121221,8
0.05,6649,96,604420,90.89022556390978,6
0.05,6650,94,604514,90.8906931288528,7
0.05,6651,94,604608,90.89116055321708,7
0.05,6652,94,604702,90.89162783706598,7
0.05,6653,94,604796,90.89209498046289,7
0.05,6654,94,604890,90.89256198347107,7
0.05,6655,94,604984,90.89302884615384,7
0.05,6656,94,605078,90.89349556857444,8
0.05,6657,93,605171,90.8938119555422,8
0.05,6658,93,605264,90.8941282474846,8
0.05,6659,86,605350,90.8933933933934,15
0.05,6660,94,605444,90.89385978081368,8
0.05,6661,94,605538,90.89432602821975,7
0.05,6662,93,605631,90.89464205312922,8
0.05,6663,95,605726,90.8952581032413,7
0.05,6664,94,605820,90.89572393098274,7
0.05,6665,94,605914,90.8961896189619,7
0.05,6666,95,606009,90.89680515974202,7
0.05,6667,94,606103,90.89727054589082,7
0.05,6668,94,606197,90.89773579247263,7
0.05,6669,94,606291,90.89820089955022,7
0.05,6670,94,606385,90.89866586718632,7
0.05,6671,96,606481,90.8994304556355,6
0.05,6672,92,606573,90.89959538438484,9
0.05,6673,94,606667,90.90005993407252,7
0.05,6674,92,606759,90.90022471910112,9
0.05,6675,94,606853,90.90068903535051,7
0.05,6676,92,606945,90.90085367680096,10
0.05,6677,95,607040,90.90146750524109,6
0.05,6678,94,607134,90.90193142686032,7
0.05,6679,95,607229,90.90254491017964,6
0.05,6680,94,607323,90.90300853165694,7
0.05,6681,94,607417,90.90347201436695,7
0.05,6682,94,607511,90.90393535837198,7
0.05,6683,94,607605,90.90439856373429,7
0.05,6684,96,607701,90.90516080777861,6
0.05,6685,96,607797,90.90592282381095,6
0.05,6686,89,607886,90.90563780469567,12
0.05,6687,93,607979,90.9059509569378,8
0.05,6688,94,608073,90.90641351472567,8
0.05,6689,93,608166,90.9067264573991,9
0.05,6690,94,608260,90.90718876102227,7
0.05,6691,93,608353,90.90750149432158,8
0.05,6692,94,608447,90.90796354400119,7
0.05,6693,95,608542,90.90857484314311,6
0.05,6694,95,608637,90.90918595967139,7
0.05,6695,92,608729,90.90934886499403,9
0.05,6696,26,608755,90.89965656263999,7
0.05,6697,93,608848,90.8999701403404,8
0.05,6698,94,608942,90.9004329004329,7
0.05,6699,91,609033,90.90044776119403,11
0.05,6700,94,609127,90.90091031189375,7
0.05,6701,92,609219,90.90107430617726,9
0.05,6702,96,609315,90.90183499925406,6
0.05,6703,93,609408,90.90214797136038,8
0.05,6704,93,609501,90.90246085011185,8
0.05,6705,94,609595,90.90292275574113,7
0.05,6706,93,609688,90.90323542567467,8
0.05,6707,94,609782,90.90369707811568,7
0.05,6708,91,609873,90.90371143240424,10
0.05,6709,94,609967,90.90417287630402,7
0.05,6710,93,610060,90.90448517359559,8
0.05,6711,92,610152,90.9046483909416,11
0.05,6712,94,610246,90.9051094890511,7
0.05,6713,93,610339,90.90542150729819,8
0.05,6714,89,610428,90.90513775130306,12
0.05,6715,96,610524,90.90589636688505,6
0.05,6716,91,610615,90.90591037665625,10
0.05,6717,94,610709,90.90637094373325,7
0.05,6718,94,610803,90.90683137371633,7
0.05,6719,90,610893,90.90669642857142,12
0.05,6720,93,610986,90.90700788573129,8
0.05,6721,94,611080,90.90746801547158,7
0.05,6722,96,611176,90.90822549457087,6
0.05,6723,95,611271,90.90883402736466,6
0.05,6724,93,611364,90.90914498141264,8
0.05,6725,95,611459,90.9097531965507,6
0.05,6726,96,611555,90.9105098855359,6
0.05,6727,26,611581,90.90086206896552,6
0.05,6728,95,611676,90.90147124386982,6
0.05,6729,95,611771,90.90208023774146,6
0.05,6730,96,611867,90.902837616996,6
0.05,6731,96,611963,90.90359477124183,6
0.05,6732,95,612058,90.90420317837517,6
0.05,6733,89,612147,90.90392040392041,13
0.05,6734,92,612239,90.9040831477357,9
0.05,6735,92,612331,90.9042458432304,9
0.05,6736,95,612426,90.90485379248923,6
0.05,6737,94,612520,90.90531314930246,7
0.05,6738,94,612614,90.9057723697878,7
0.05,6739,94,612708,90.90623145400593,7
0.05,6740,94,612802,90.9066904020175,7
0.05,6741,94,612896,90.90714921388312,7
0.05,6742,94,612990,90.90760788966335,8
0.05,6743,94,613084,90.90806642941874,7
0.05,6744,89,613173,90.90778354336545,15
0.05,6745,88,613261,90.90735250518826,13
0.05,6746,95,613356,90.90795909293018,6
0.05,6747,96,613452,90.90871369294605,6
0.05,6748,93,613545,90.90902355904578,8
0.05,6749,95,613640,90.90962962962963,6
0.05,6750,95,613735,90.9102355206636,6
0.05,6751,93,613828,90.91054502369668,8
0.05,6752,94,613922,90.91100251739968,7
0.05,6753,94,614016,90.91145987562926,8
0.05,6754,94,614110,90.9119170984456,7
0.05,6755,90,614200,90.91178211959739,11
0.05,6756,92,614292,90.91194317004587,9
0.05,6757,94,614386,90.91240011837822,7
0.05,6758,95,614481,90.91300488237906,6
0.05,6759,94,614575,90.91346153846153,8
0.05,6760,91,614666,90.91347433811566,10
0.05,6761,94,614760,90.91393078970718,7
0.05,6762,90,614850,90.9137956528168,11
0.05,6763,94,614944,90.91425192193968,7
0.05,6764,94,615038,90.91470805617148,7
0.05,6765,96,615134,90.91545965119717,6
0.05,6766,95,615229,90.91606324811586,6
0.05,6767,94,615323,90.91651891252955,7
0.05,6768,91,615414,90.91653124538337,10
0.05,6769,96,615510,90.91728212703102,6
0.05,6770,96,615606,90.91803278688525,6
0.05,6771,96,615702,90.9187832250443,6
0.05,6772,95,615797,90.9193857965451,8
0.05,6773,91,615888,90.91939769707706,10
0.05,6774,94,615982,90.91985239852399,7
0.05,6775,96,616078,90.92060212514758,6
0.05,6776,94,616172,90.92105651468201,7
0.05,6777,94,616266,90.92151077013868,7
0.05,6778,93,616359,90.92181737719427,8
0.05,6779,88,616447,90.92138643067847,13
0.05,6780,93,616540,90.92169296563928,8
0.05,6781,94,616634,90.92214685933352,7
0.05,6782,93,616727,90.92245319180304,8
0.05,6783,92,616819,90.92261202830188,9
0.05,6784,94,616913,90.92306558585115,9
0.05,6785,94,617007,90.92351900972591,8
0.05,6786,94,617101,90.92397229998527,7
0.05,6787,88,617189,90.923541543901,13
0.05,6788,94,617283,90.92399469730447,9
0.05,6789,92,617375,90.9241531664212,9
0.05,6790,95,617470,90.92475335002209,6
0.05,6791,90,617560,90.924617196702,11
0.05,6792,96,617656,90.92536434564994,6
0.05,6793,91,617747,90.92537533117456,10
0.05,6794,94,617841,90.92582781456953,7
0.05,6795,94,617935,90.92628016480282,7
0.05,6796,92,618027,90.92643813447108,9
0.05,6797,94,618121,90.92689026184172,7
0.05,6798,89,618210,90.92660685394911,12
0.05,6799,94,618304,90.9270588235294,7
0.05,6800,94,618398,90.92751066019703,7
0.05,6801,94,618492,90.92796236401058,8
0.05,6802,94,618586,90.92841393502866,7
0.05,6803,96,618682,90.9291593180482,6
0.05,6804,92,618774,90.92931667891257,10
0.05,6805,93,618867,90.92962092271524,8
0.05,6806,94,618961,90.93007198472161,7
0.05,6807,94,619055,90.93052291421857,7
0.05,6808,89,619144,90.93023938904392,13
0.05,6809,92,619236,90.93039647577092,9
0.05,6810,91,619327,90.93040669505213,10
0.05,6811,94,619421,90.9308573106283,7
0.05,6812,92,619513,90.93101423748716,9
0.05,6813,94,619607,90.93146463164074,7
0.05,6814,27,619634,90.92208363903154,6
0.05,6815,90,619724,90.9219483568075,11
0.05,6816,92,619816,90.92210649845973,9
0.05,6817,92,619908,90.9222645937225,9
0.05,6818,95,620003,90.92286258982256,7
0.05,6819,95,620098,90.92346041055718,6
0.05,6820,91,620189,90.92347163172555,10
0.05,6821,94,620283,90.92392260334213,8
0.05,6822,96,620379,90.92466656895793,6
0.05,6823,94,620473,90.92511723329426,7
0.05,6824,19,620492,90.91457875457876,14
0.05,6825,93,620585,90.91488426604161,9
0.05,6826,94,620679,90.91533616522631,7
0.05,6827,92,620771,90.91549502050381,9
0.05,6828,94,620865,90.915946697906,7
0.05,6829,92,620957,90.91610541727673,10
0.05,6830,92,621049,90.91626409017714,9
0.05,6831,94,621143,90.91671545667447,8
0.05,6832,91,621234,90.91672764525099,11
0.05,6833,90,621324,90.91659350307287,11
0.05,6834,94,621418,90.91704462326261,7
0.05,6835,94,621512,90.9174956114687,7
0.05,6836,96,621608,90.91823899371069,6
0.05,6837,96,621704,90.91898215852588,6
0.05,6838,95,621799,90.91957888580201,7
0.05,6839,96,621895,90.9203216374269,6
0.05,6840,94,621989,90.92077181698582,7
0.05,6841,92,622081,90.92092955276235,9
0.05,6842,92,622173,90.92108724243752,9
0.05,6843,93,622266,90.92139099941555,8
0.05,6844,94,622360,90.9218407596786,7
0.05,6845,90,622450,90.92170610575519,11
0.05,6846,93,622543,90.92200963925806,8
0.05,6847,88,622631,90.92158294392523,13
0.05,6848,93,622724,90.92188640677472,8
0.05,6849,87,622811,90.92131386861314,14
0.05,6850,94,622905,90.92176324624143,8
0.05,6851,93,622998,90.92206654991243,8
0.05,6852,96,623094,90.9228075295491,6
0.05,6853,94,623188,90.92325649255909,7
0.05,6854,96,623284,90.9239970824216,6
0.05,6855,93,623377,90.92429988331389,8
0.05,6856,94,623471,90.92474843225901,7
0.05,6857,95,623566,90.92534266550014,6
0.05,6858,95,623661,90.92593672547018,6
0.05,6859,92,623753,90.92609329446064,9
0.05,6860,93,623846,90.92639556915901,8
0.05,6861,95,623941,90.92698921597201,6
0.05,6862,95,624036,90.92758268978581,6
0.05,6863,95,624131,90.928175990676,6
0.05,6864,92,624223,90.92833211944647,9
0.05,6865,96,624319,90.92907078357122,6
0.05,6866,94,624413,90.92951798456386,7
0.05,6867,89,624502,90.9292370413512,12
0.05,6868,93,624595,90.9295385063328,8
0.05,6869,94,624689,90.92998544395924,7
0.05,6870,96,624785,90.93072332993742,6
0.05,6871,94,624879,90.93116996507567,8
0.05,6872,94,624973,90.93161647024588,7
0.05,6873,92,625065,90.93177189409369,9
0.05,6874,93,625158,90.93207272727273,9
0.05,6875,94,625252,90.9325189063409,7
0.05,6876,91,625343,90.93252871891814,10
0.05,6877,92,625435,90.93268391974411,9
0.05,6878,27,625462,90.9233900276203,6
0.05,6879,93,625555,90.92369186046511,8
0.05,6880,94,625649,90.92413893329459,7
0.05,6881,94,625743,90.92458587619878,7
0.05,6882,94,625837,90.92503268923434,7
0.05,6883,96,625933,90.92576990122022,6
0.05,6884,92,626025,90.92592592592592,9
0.05,6885,91,626116,90.92593668312519,10
0.05,6886,96,626212,90.92667344271817,6
0.05,6887,96,626308,90.92740998838559,6
0.05,6888,94,626402,90.92785600232254,7
0.05,6889,93,626495,90.92815674891146,8
0.05,6890,94,626589,90.92860252503264,7
0.05,6891,93,626682,90.92890307603018,8
0.05,6892,92,626774,90.92905846510953,9
0.05,6893,93,626867,90.92935886277922,8
0.05,6894,95,626962,90.92994923857869,6
0.05,6895,91,627053,90.92995939675174,10
0.05,6896,93,627146,90.93025953313035,9
0.05,6897,89,627235,90.92997970426211,12
0.05,6898,94,627329,90.93042469923178,7
0.05,6899,94,627423,90.93086956521739,7
0.05,6900,94,627517,90.93131430227503,9
0.05,6901,93,627610,90.93161402492031,9
0.05,6902,94,627704,90.93205852527886,8
0.05,6903,94,627798,90.93250289687138,8
0.05,6904,95,627893,90.93309196234613,6
0.05,6905,94,627987,90.93353605560382,8
0.05,6906,96,628083,90.9342695815839,6
0.05,6907,92,628175,90.93442385639838,9
0.05,6908,95,628270,90.93501230279345,6
0.05,6909,94,628364,90.9354558610709,7
0.05,6910,93,628457,90.93575459412531,8
0.05,6911,94,628551,90.93619791666667,7
0.05,6912,95,628646,90.93678576594822,8
0.05,6913,94,628740,90.9372288111079,7
0.05,6914,25,628765,90.92769342010124,8
0.05,6915,93,628858,90.927993059572,8
0.05,6916,96,628954,90.9287263264421,6
0.05,6917,91,629045,90.92873662908355,10
0.05,6918,92,629137,90.92889145830323,9
0.05,6919,94,629231,90.92933526011561,7
0.05,6920,96,629327,90.93006790926167,6
0.05,6921,92,629419,90.93022247905229,9
0.05,6922,93,629512,90.93052145023833,8
0.05,6923,93,629605,90.93082033506643,8
0.05,6924,94,629699,90.93126353790613,7
0.05,6925,96,629795,90.93199537972856,6
0.05,6926,92,629887,90.93214955969395,10
0.05,6927,94,629981,90.93259237875289,7
0.05,6928,89,630070,90.93231346514649,12
0.05,6929,92,630162,90.93246753246753,9
0.05,6930,94,630256,90.93291011398067,8
0.05,6931,95,630351,90.93349682631275,6
0.05,6932,94,630445,90.93393913168903,8
0.05,6933,94,630539,90.93438130948947,7
0.05,6934,94,630633,90.93482335976928,7
0.05,6935,23,630656,90.92502883506344,10
0.05,6936,91,630747,90.92503964249676,10
0.05,6937,96,630843,90.92577111559527,6
0.05,6938,96,630939,90.92650237786424,6
0.05,6939,92,631031,90.92665706051874,9
0.05,6940,94,631125,90.9270998415214,7
0.05,6941,94,631219,90.92754249495823,7
0.05,6942,95,631314,90.92812905084257,7
0.05,6943,92,631406,90.92828341013825,9
0.05,6944,94,631500,90.92872570194385,7
0.05,6945,94,631594,90.92916786639793,7
0.05,6946,96,631690,90.92989779761048,6
0.05,6947,95,631785,90.93048359240069,6
0.05,6948,96,631881,90.93121312419053,6
0.05,6949,95,631976,90.93179856115108,6
0.05,6950,89,632065,90.93152064451158,12
0.05,6951,94,632159,90.93196202531645,7
0.05,6952,96,632255,90.93269092478067,6
0.05,6953,94,632349,90.93313201035376,7
0.05,6954,94,632443,90.93357296908698,7
0.05,6955,93,632536,90.93387004025301,8
0.05,6956,27,632563,90.92468017823775,6
0.05,6957,-46,632517,90.9050014371946,9
0.05,6958,94,632611,90.90544618479666,7
0.05,6959,93,632704,90.90574712643678,8
0.05,6960,94,632798,90.9061916391323,7
0.05,6961,94,632892,90.906636024131,7
0.05,6962,96,632988,90.90736751400259,6
0.05,6963,92,633080,90.9075244112579,9
0.05,6964,94,633174,90.90796841349605,7
0.05,6965,95,633269,90.90855584266437,6
0.05,6966,93,633362,90.90885603559639,8
0.05,6967,92,633454,90.90901262916188,9
0.05,6968,96,633550,90.90974314822786,6
0.05,6969,96,633646,90.91047345767575,6
0.05,6970,96,633742,90.91120355759575,6
0.05,6971,96,633838,90.91193344807803,6
0.05,6972,92,633930,90.91208948802525,9
0.05,6973,95,634025,90.91267565242329,6
0.05,6974,94,634119,90.91311827956989,7
0.05,6975,96,634215,90.91384747706422,6
0.05,6976,90,634305,90.91371649706177,11
0.05,6977,95,634400,90.91430209229006,7
0.05,6978,94,634494,90.9147442326981,7
0.05,6979,95,634589,90.91532951289398,8
0.05,6980,94,634683,90.91577137945853,7
0.05,6981,93,634776,90.91606989401318,8
0.05,6982,94,634870,90.91651152799656,7
0.05,6983,92,634962,90.91666666666667,9
0.05,6984,96,635058,90.91739441660701,6
0.05,6985,95,635153,90.9179788147724,7
0.05,6986,94,635247,90.91841992271361,7
0.05,6987,95,635342,90.91900400686892,6
0.05,6988,91,635433,90.91901559593647,10
0.05,6989,95,635528,90.91959942775394,7
0.05,6990,88,635616,90.91918180517808,13
0.05,6991,95,635711,90.91976544622426,6
0.05,6992,94,635805,90.92020592020592,8
0.05,6993,94,635899,90.92064626822992,7
0.05,6994,93,635992,90.92094353109364,8
0.05,6995,93,636085,90.92124070897655,8
0.05,6996,93,636178,90.92153780191511,8
0.05,6997,91,636269,90.921549014004,10
0.05,6998,91,636360,90.92156022288898,10
0.05,6999,96,636456,90.92228571428572,6
0.05,7000,94,636550,90.92272532495357,7
0.05,7001,93,636643,90.92302199371608,8
0.05,7002,96,636739,90.92374696558618,6
0.05,7003,96,636835,90.92447173043975,6
0.05,7004,94,636929,90.9249107780157,8
0.05,7005,95,637024,90.92549243505567,6
0.05,7006,94,637118,90.92593121164549,7
0.05,7007,94,637212,90.9263698630137,7
0.05,7008,92,637304,90.92652304180339,9
0.05,7009,96,637400,90.92724679029958,6
0.05,7010,94,637494,90.92768506632434,7
0.05,7011,96,637590,90.9284084426697,6
0.05,7012,96,637686,90.92913161271923,6
0.05,7013,92,637778,90.92928428856573,10
0.05,7014,93,637871,90.9295794725588,8
0.05,7015,94,637965,90.93001710376282,7
0.05,7016,95,638060,90.9305971212769,6
0.05,7017,94,638154,90.93103448275862,7
0.05,7018,93,638247,90.93132924918079,8
0.05,7019,95,638342,90.93190883190883,6
0.05,7020,94,638436,90.9323458196838,7
0.05,7021,91,638527,90.93235545428652,10
0.05,7022,94,638621,90.9327922540225,7
0.05,7023,92,638713,90.93294419134396,9
0.05,7024,95,638808,90.9335231316726,8
0.05,7025,92,638900,90.93367492171933,9
0.05,7026,96,638996,90.93439590152269,6
0.05,7027,96,639092,90.93511667615253,6
0.05,7028,94,639186,90.9355527102006,7
0.05,7029,95,639281,90.93613086770982,6
0.05,7030,94,639375,90.9365666334803,7
0.05,7031,95,639470,90.93714448236632,7
0.05,7032,95,639565,90.93772216692734,6
0.05,7033,92,639657,90.9378731873756,9
0.05,7034,94,639751,90.93830845771144,7
0.05,7035,93,639844,90.93860147811256,8
0.05,7036,94,639938,90.93903652124484,7
0.05,7037,91,640029,90.9390451832907,10
0.05,7038,95,640124,90.9396221054127,7
0.05,7039,91,640215,90.93963068181819,10
0.05,7040,94,640309,90.94006533162903,7
0.05,7041,94,640403,90.9404998579949,7
0.05,7042,93,640496,90.94079227601874,11
0.05,7043,93,640589,90.94108461101646,11
0.05,7044,93,640682,90.94137686302342,8
0.05,7045,85,640767,90.9405336361056,16
0.05,7046,94,640861,90.94096778771109,7
0.05,7047,24,640885,90.93146992054484,10
0.05,7048,95,640980,90.93204709887928,8
0.05,7049,94,641074,90.93248226950355,9
0.05,7050,92,641166,90.93263366898313,9
0.05,7051,94,641260,90.93306863301191,7
0.05,7052,95,641355,90.9336452573373,6
0.05,7053,94,641449,90.93407995463566,7
0.05,7054,94,641543,90.93451452870305,7
0.05,7055,95,641638,90.93509070294785,6
0.05,7056,93,641731,90.9353833073544,8
0.05,7057,92,641823,90.93553414565032,9
0.05,7058,93,641916,90.93582660433489,8
0.05,7059,92,642008,90.93597733711049,9
0.05,7060,92,642100,90.93612802719161,9
0.05,7061,93,642193,90.93642027754177,8
0.05,7062,96,642289,90.93713719382698,6
0.05,7063,94,642383,90.93757078142696,7
0.05,7064,95,642478,90.9381457891012,6
0.05,7065,94,642572,90.9385791112369,7
0.05,7066,96,642668,90.93929531625867,6
0.05,7067,95,642763,90.93986983588002,6
0.05,7068,92,642855,90.94001980478144,10
0.05,7069,96,642951,90.94073550212164,6
0.05,7070,96,643047,90.94145099703012,6
0.05,7071,96,643143,90.94216628959276,6
0.05,7072,90,643233,90.94203308355719,11
0.05,7073,95,643328,90.94260672886627,6
0.05,7074,94,643422,90.94303886925795,7
0.05,7075,90,643512,90.94290559638213,12
0.05,7076,95,643607,90.94347887522962,8
0.05,7077,93,643700,90.94376942639164,9
0.05,7078,94,643794,90.9442011583557,7
0.05,7079,95,643889,90.94477401129943,6
0.05,7080,95,643984,90.94534670244316,6
0.05,7081,94,644078,90.94577802880542,7
0.05,7082,94,644172,90.94620923337568,7
0.05,7083,94,644266,90.94664031620553,7
0.05,7084,96,644362,90.94735356386732,6
0.05,7085,93,644455,90.94764324019192,8
0.05,7086,90,644545,90.94750952448145,11
0.05,7087,96,644641,90.9482223476298,6
0.05,7088,27,644668,90.93920157991253,6
0.05,7089,92,644760,90.93935119887165,9
0.05,7090,96,644856,90.9400648709632,6
0.05,7091,94,644950,90.94049633389734,7
0.05,7092,95,645045,90.94106865924151,6
0.05,7093,91,645136,90.94107696645052,10
0.05,7094,90,645226,90.94094432699085,11
0.05,7095,94,645320,90.94137542277339,7
0.05,7096,96,645416,90.94208820628434,6
0.05,7097,91,645507,90.94209636517328,11
0.05,7098,95,645602,90.94266798140583,6
0.05,7099,96,645698,90.94338028169014,6
0.05,7100,96,645794,90.94409238135474,6
0.05,7101,94,645888,90.94452266967052,7
0.05,7102,95,645983,90.94509362241307,6
0.05,7103,94,646077,90.94552364864865,7
0.05,7104,94,646171,90.94595355383532,7
0.05,7105,91,646262,90.94596115958345,10
0.05,7106,93,646355,90.94625017588294,8
0.05,7107,95,646450,90.94682048396173,7
0.05,7108,95,646545,90.94739063159375,6
0.05,7109,95,646640,90.9479606188467,6
0.05,7110,94,646734,90.94838981859091,7
0.05,7111,94,646828,90.94881889763779,7
0.05,7112,94,646922,90.94924785603824,7
0.05,7113,92,647014,90.94939555805453,9
0.05,7114,94,647108,90.94982431482782,7
0.05,7115,93,647201,90.95011242270938,9
0.05,7116,94,647295,90.95054095826893,7
0.05,7117,94,647389,90.9509693734195,7
0.05,7118,96,647485,90.95167860654587,6
0.05,7119,93,647578,90.95196629213483,8
0.05,7120,94,647672,90.95239432663952,7
0.05,7121,95,647767,90.95296265094075,6
0.05,7122,91,647858,90.95296925452759,10
0.05,7123,94,647952,90.9533969679955,7
0.05,7124,88,648040,90.95298245614035,13
0.05,7125,96,648136,90.95369071007578,6
0.05,7126,93,648229,90.95397783078434,9
0.05,7127,95,648324,90.95454545454545,6
0.05,7128,89,648413,90.95427128629541,13
0.05,7129,94,648507,90.954698457223,7
0.05,7130,94,648601,90.95512550834385,8
0.05,7131,94,648695,90.95555243970836,7
0.05,7132,92,648787,90.95569886443292,9
0.05,7133,95,648882,90.95626576955425,6
0.05,7134,94,648976,90.95669236159776,7
0.05,7135,94,649070,90.95711883408072,7
0.05,7136,94,649164,90.95754518705338,7
0.05,7137,95,649259,90.95811151583077,6
0.05,7138,88,649347,90.95769715646449,13
0.05,7139,94,649441,90.95812324929972,8
0.05,7140,93,649534,90.95840918638847,8
0.05,7141,93,649627,90.95869504340521,9
0.05,7142,92,649719,90.95884082318354,9
0.05,7143,93,649812,90.95912653975364,8
0.05,7144,94,649906,90.9595521343597,7
0.05,7145,96,650002,90.96025748670586,6
0.05,7146,94,650096,90.9606828039737,7
0.05,7147,96,650192,90.96138780078344,6
0.05,7148,89,650281,90.9611134424395,12
0.05,7149,96,650377,90.96181818181819,6
0.05,7150,95,650472,90.9623828835128,6
0.05,7151,93,650565,90.9626677852349,8
0.05,7152,93,650658,90.96295260729764,8
0.05,7153,93,650751,90.96323734973441,8
0.05,7154,96,650847,90.96394129979036,6
0.05,7155,92,650939,90.96408608160984,9
0.05,7156,95,651034,90.96464999301384,6
0.05,7157,95,651129,90.96521374685666,7
0.05,7158,94,651223,90.96563765889091,7
0.05,7159,94,651317,90.96606145251397,7
0.05,7160,94,651411,90.96648512777546,7
0.05,7161,94,651505,90.96690868472494,7
0.05,7162,92,651597,90.96705291079157,9
0.05,7163,94,651691,90.96747627024008,8
0.05,7164,96,651787,90.96817864619679,6
0.05,7165,93,651880,90.96846218252861,9
0.05,7166,94,651974,90.96888516813172,7
0.05,7167,90,652064,90.96875,11
0.05,7168,94,652158,90.96917282745153,7
0.05,7169,91,652249,90.96917712691771,10
0.05,7170,93,652342,90.96946032631432,8
0.05,7171,95,652437,90.97002230897937,7
0.05,7172,96,652533,90.97072354663321,6
0.05,7173,95,652628,90.97128519654308,6
0.05,7174,90,652718,90.97114982578397,11
0.05,7175,92,652810,90.97129319955407,9
0.05,7176,94,652904,90.9717152013376,8
0.05,7177,93,652997,90.97199777096684,8
0.05,7178,94,653091,90.97241955704138,9
0.05,7179,94,653185,90.97284122562674,7
0.05,7180,93,653278,90.97312352040106,8
0.05,7181,96,653374,90.97382344750766,6
0.05,7182,92,653466,90.9739663093415,9
0.05,7183,94,653560,90.97438752783964,7
0.05,7184,92,653652,90.97453027139875,9
0.05,7185,94,653746,90.97495129418313,7
0.05,7186,94,653840,90.97537219980521,7
0.05,7187,94,653934,90.97579298831386,7
0.05,7188,96,654030,90.97649186256781,6
0.05,7189,94,654124,90.9769123783032,8
0.05,7190,96,654220,90.97761090251703,6
0.05,7191,92,654312,90.97775305895439,9
0.05,7192,96,654408,90.97845127207007,6
0.05,7193,91,654499,90.97845426744509,10
0.05,7194,95,654594,90.97901320361362,6
0.05,7195,94,654688,90.97943301834353,8
0.05,7196,92,654780,90.97957482284285,9
0.05,7197,92,654872,90.9797165879411,9
0.05,7198,95,654967,90.98027503819975,6
0.05,7199,95,655062,90.98083333333334,6
0.05,7200,94,655156,90.98125260380503,7
0.05,7201,94,655250,90.98167175784505,7
0.05,7202,94,655344,90.98209079550188,7
0.05,7203,96,655440,90.98278734036646,6
0.05,7204,89,655529,90.9825121443442,12
0.05,7205,94,655623,90.98293089092422,7
0.05,7206,94,655717,90.98334952129873,7
0.05,7207,94,655811,90.98376803551609,8
0.05,7208,95,655906,90.98432514911916,7
0.05,7209,95,656001,90.98488210818307,6
0.05,7210,94,656095,90.98530023575094,8
0.05,7211,90,656185,90.98516361619524,11
0.05,7212,90,656275,90.98502703452101,12
0.05,7213,93,656368,90.98530634876629,8
0.05,7214,92,656460,90.98544698544698,9
0.05,7215,94,656554,90.98586474501109,7
0.05,7216,92,656646,90.98600526534571,9
0.05,7217,94,656740,90.98642283180936,7
0.05,7218,95,656835,90.9869788059288,6
0.05,7219,89,656924,90.98670360110803,12
0.05,7220,94,657018,90.98712089738264,8
0.05,7221,95,657113,90.98767654389366,7
0.05,7222,92,657205,90.98781669666343,9
0.05,7223,96,657301,90.98851052048727,6
0.05,7224,96,657397,90.98920415224913,6
0.05,7225,96,657493,90.98989759202878,6
0.05,7226,94,657587,90.99031409990315,7
0.05,7227,93,657680,90.99059214167127,8
0.05,7228,95,657775,90.99114676995436,6
0.05,7229,94,657869,90.99156293222683,7
0.05,7230,94,657963,90.99197897939428,7
0.05,7231,95,658058,90.99253318584071,7
0.05,7232,94,658152,90.99294898382414,8
0.05,7233,93,658245,90.9932264307437,9
0.05,7234,94,658339,90.99364201796821,8
0.05,7235,93,658432,90.99391929242675,8
0.05,7236,94,658526,90.99433466906177,7
0.05,7237,94,658620,90.99474993092015,7
0.05,7238,92,658712,90.99488879679514,9
0.05,7239,96,658808,90.99558011049724,6
0.05,7240,95,658903,90.99613313078304,6
0.05,7241,95,658998,90.996685998343,7
0.05,7242,94,659092,90.99710064890239,7
0.05,7243,92,659184,90.99723909442297,10
0.05,7244,95,659279,90.99779158040027,6
0.05,7245,93,659372,90.99806789953078,8
0.05,7246,94,659466,90.99848213053677,7
0.05,7247,92,659558,90.99862030905078,9
0.05,7248,94,659652,90.99903434956546,7
0.05,7249,94,659746,90.99944827586206,7
0.05,7250,93,659839,90.99972417597573,8
0.05,7251,94,659933,91.00013789299504,7
0.05,7252,92,660025,91.00027574796636,9
0.05,7253,95,660120,91.00082712985939,6
0.05,7254,94,660214,91.0012405237767,7
0.05,7255,94,660308,91.00165380374862,7
0.05,7256,95,660403,91.00220476781038,6
0.05,7257,96,660499,91.00289335905208,6
0.05,7258,96,660595,91.00358176057308,6
0.05,7259,26,660621,90.99462809917355,7
0.05,7260,93,660714,90.99490428315659,8
0.05,7261,94,660808,90.99531809418893,7
0.05,7262,95,660903,90.99586947542338,6
0.05,7263,94,660997,90.99628303964758,7
0.05,7264,96,661093,90.99697178251893,6
0.05,7265,94,661187,90.99738508120011,8
0.05,7266,96,661283,90.99807348286775,6
0.05,7267,93,661376,90.99834892680242,8
0.05,7268,94,661470,90.99876186545605,7
0.05,7269,93,661563,90.9990371389271,8
0.05,7270,94,661657,90.99944986934396,7
0.05,7271,92,661749,90.99958745874588,9
0.05,7272,92,661841,90.99972501031212,10
0.05,7273,93,661934,91.0,8
0.05,7274,94,662028,91.00041237113402,7
0.05,7275,94,662122,91.00082462891699,7
0.05,7276,94,662216,91.00123677339563,8
0.05,7277,95,662311,91.00178620500138,7
0.05,7278,95,662406,91.00233548564363,7
0.05,7279,96,662502,91.00302197802198,6
0.05,7280,94,662596,91.0034335942865,7
0.05,7281,93,662689,91.00370777258995,8
0.05,7282,92,662781,91.00384456954552,9
0.05,7283,96,662877,91.00453047775947,6
0.05,7284,89,662966,91.00425531914894,13
0.05,7285,92,663058,91.00439198462806,9
0.05,7286,96,663154,91.0050775353369,6
0.05,7287,95,663249,91.00562568605928,6
0.05,7288,93,663342,91.00589930031555,8
0.05,7289,95,663437,91.00644718792867,6
0.05,7290,91,663528,91.00644630366205,10
0.05,7291,94,663622,91.00685682940208,7
0.05,7292,95,663717,91.00740436034553,6
0.05,7293,96,663813,91.00808884014258,6
0.05,7294,94,663907,91.00849897189856,9
0.05,7295,92,663999,91.00863486842105,9
0.05,7296,93,664092,91.00890777031657,8
0.05,7297,96,664188,91.00959166895039,6
0.05,7298,27,664215,91.00082203041512,6
0.05,7299,95,664310,91.0013698630137,6
0.05,7300,94,664404,91.00178057800301,7
0.05,7301,96,664500,91.00246507806081,6
0.05,7302,94,664594,91.00287553060386,8
0.05,7303,96,664690,91.00355969331873,6
0.05,7304,91,664781,91.00355920602327,10
0.05,7305,89,664870,91.0032849712565,13
0.05,7306,94,664964,91.00369508690297,7
0.05,7307,91,665055,91.00369458128078,10
0.05,7308,94,665149,91.00410452866329,7
0.05,7309,91,665240,91.00410396716826,10
0.05,7310,94,665334,91.00451374640951,7
0.05,7311,94,665428,91.00492341356674,7
0.05,7312,92,665520,91.00505948311226,9
0.05,7313,95,665615,91.00560568772218,6
0.05,7314,94,665709,91.00601503759398,7
0.05,7315,94,665803,91.00642427556042,8
0.05,7316,95,665898,91.0069700697007,7
0.05,7317,92,665990,91.00710576660289,9
0.05,7318,94,666084,91.00751468779887,7
0.05,7319,94,666178,91.00792349726775,8
0.05,7320,96,666274,91.00860538177845,6
0.05,7321,94,666368,91.00901393062004,8
0.05,7322,94,666462,91.00942236788201,7
0.05,7323,95,666557,91.0099672310213,6
0.05,7324,91,666648,91.00996587030717,10
0.05,7325,92,666740,91.01010101010101,9
0.05,7326,91,666831,91.01009963149993,10
0.05,7327,94,666925,91.0105076419214,7
0.05,7328,94,667019,91.0109155410015,7
0.05,7329,95,667114,91.01145975443383,6
0.05,7330,93,667207,91.01173100531987,8
0.05,7331,95,667302,91.01227495908347,6
0.05,7332,92,667394,91.01240965498432,9
0.05,7333,96,667490,91.01308971911645,6
0.05,7334,94,667584,91.01349693251534,7
0.05,7335,93,667677,91.0137677208288,8
0.05,7336,93,667770,91.01403843532779,8
0.05,7337,91,667861,91.01403652221313,10
0.05,7338,94,667955,91.01444338465731,7
0.05,7339,92,668047,91.01457765667575,9
0.05,7340,94,668141,91.01498433455933,7
0.05,7341,93,668234,91.0152546989921,8
0.05,7342,94,668328,91.01566117390712,7
0.05,7343,94,668422,91.01606753812636,7
0.05,7344,95,668517,91.01660993873384,6
0.05,7345,91,668608,91.0166076776477,10
0.05,7346,94,668702,91.01701374710767,7
0.05,7347,95,668797,91.01755579749592,6
0.05,7348,92,668889,91.01768948156212,9
0.05,7349,88,668977,91.01727891156463,13
0.05,7350,95,669072,91.01782070466604,7
0.05,7351,95,669167,91.01836235038085,7
0.05,7352,94,669261,91.0187678498572,7
0.05,7353,94,669355,91.01917323905357,8
0.05,7354,93,669448,91.0194425560843,8
0.05,7355,26,669474,91.01060358890702,8
0.05,7356,88,669562,91.01019437270627,13
0.05,7357,93,669655,91.01046480021745,8
0.05,7358,95,669750,91.01100693028944,7
0.05,7359,87,669837,91.01046195652174,14
0.05,7360,93,669930,91.01073223746774,9
0.05,7361,93,670023,91.01100244498778,9
0.05,7362,95,670118,91.01154420752411,6
0.05,7363,95,670213,91.01208582292233,6
0.05,7364,96,670309,91.01276306856755,6
0.05,7365,93,670402,91.01303285365191,8
0.05,7366,90,670492,91.01289534410208,11
0.05,7367,92,670584,91.0130293159609,9
0.05,7368,94,670678,91.01343465870539,8
0.05,7369,94,670772,91.01383989145184,7
0.05,7370,94,670866,91.01424501424502,7
0.05,7371,93,670959,91.01451437873033,8
0.05,7372,94,671053,91.01491930014919,8
0.05,7373,95,671148,91.01545972335232,6
0.05,7374,96,671244,91.01613559322034,6
0.05,7375,25,671269,91.00718546637744,8
0.05,7376,94,671363,91.00759116171885,7
0.05,7377,94,671457,91.00799674708593,7
0.05,7378,95,671552,91.0085377422415,6
0.05,7379,93,671645,91.00880758807588,8
0.05,7380,96,671741,91.00948380978187,6
0.05,7381,96,671837,91.0101598482796,6
0.05,7382,94,671931,91.01056481105242,7
0.05,7383,94,672025,91.01096966413868,7
0.05,7384,93,672118,91.01123899796886,8
0.05,7385,94,672212,91.01164365014893,7
0.05,7386,92,672304,91.01177744686612,9
0.05,7387,96,672400,91.0124526258798,6
0.05,7388,91,672491,91.01245094058736,10
0.05,7389,96,672587,91.01312584573748,6
0.05,7390,94,672681,91.01352996888107,7
0.05,7391,94,672775,91.01393398268398,7
0.05,7392,94,672869,91.01433788719059,7
0.05,7393,95,672964,91.0148769272383,8
0.05,7394,92,673056,91.01501014198783,9
0.05,7395,27,673083,91.006354786371,6
0.05,7396,94,673177,91.00675949709341,7
0.05,7397,91,673268,91.00675858340092,10
0.05,7398,94,673362,91.00716313015272,7
0.05,7399,93,673455,91.00743243243244,8
0.05,7400,95,673550,91.00797189568978,7
0.05,7401,20,673570,90.99837881653607,14
0.05,7402,94,673664,90.9987842766446,7
0.05,7403,95,673759,90.99932468935711,7
0.05,7404,95,673854,90.99986495611074,6
0.05,7405,96,673950,91.0005401026195,6
0.05,7406,94,674044,91.00094505197787,8
0.05,7407,94,674138,91.00134989200863,7
0.05,7408,93,674231,91.00161965177487,8
0.05,7409,93,674324,91.00188933873144,8
0.05,7410,92,674416,91.0020240183511,9
0.05,7411,94,674510,91.00242849433351,7
0.05,7412,94,674604,91.0028328611898,7
0.05,7413,95,674699,91.00337199892095,6
0.05,7414,96,674795,91.00404585300068,6
0.05,7415,94,674889,91.0044498381877,7
0.05,7416,93,674982,91.0047188890387,8
0.05,7417,96,675078,91.00539228902669,6
0.05,7418,95,675173,91.00593071842566,6
0.05,7419,94,675267,91.00633423180594,7
0.05,7420,95,675362,91.00687238916588,7
0.05,7421,93,675455,91.00714093236324,8
0.05,7422,91,675546,91.00713997036239,10
0.05,7423,93,675639,91.00740840517241,8
0.05,7424,91,675730,91.00740740740741,10
0.05,7425,95,675825,91.00794505790466,6
0.05,7426,95,675920,91.00848256361922,7
0.05,7427,93,676013,91.0087506731287,9
0.05,7428,95,676108,91.0092879256966,7
0.05,7429,88,676196,91.00888290713324,13
0.05,7430,94,676290,91.00928542591845,7
0.05,7431,94,676384,91.00968783638321,7
0.05,7432,95,676479,91.01022467375219,8
0.05,7433,90,676569,91.01008878127523,11
0.05,7434,95,676664,91.01062542030935,6
0.05,7435,95,676759,91.01116191500807,6
0.05,7436,92,676851,91.01129487696652,9
0.05,7437,93,676944,91.0115622479161,8
0.05,7438,93,677037,91.01182954698213,8
0.05,7439,94,677131,91.0122311827957,7
0.05,7440,96,677227,91.01290149173498,6
0.05,7441,95,677322,91.0134372480516,7
0.05,7442,93,677415,91.01370415155179,8
0.05,7443,95,677510,91.01423965609887,7
0.05,7444,96,677606,91.01490933512424,6
0.05,7445,92,677698,91.0150416330916,9
0.05,7446,92,677790,91.0151738955284,9
0.05,7447,96,677886,91.01584317937701,6
0.05,7448,96,677982,91.01651228352799,6
0.05,7449,93,678075,91.01677852348993,8
0.05,7450,90,678165,91.01664206146826,11
0.05,7451,95,678260,91.01717659688674,6
0.05,7452,93,678353,91.01744264054743,8
0.05,7453,93,678446,91.01770861282533,8
0.05,7454,95,678541,91.01824279007377,6
0.05,7455,93,678634,91.01850858369099,8
0.05,7456,94,678728,91.01890840820705,7
0.05,7457,96,678824,91.01957629391258,6
0.05,7458,94,678918,91.01997586807883,7
0.05,7459,94,679012,91.02037533512065,7
0.05,7460,94,679106,91.02077469508109,7
0.05,7461,91,679197,91.02077191101581,10
0.05,7462,94,679291,91.02117111081334,8
0.05,7463,96,679387,91.02183815648446,6
0.05,7464,96,679483,91.02250502344273,6
0.05,7465,94,679577,91.02290383069916,7
0.05,7466,94,679671,91.023302531137,7
0.05,7467,91,679762,91.02329941081949,10
0.05,7468,94,679856,91.02369795153301,7
0.05,7469,95,679951,91.02423025435074,6
0.05,7470,94,680045,91.02462856377996,7
0.05,7471,96,680141,91.02529443254818,6
0.05,7472,93,680234,91.02555867790713,9
0.05,7473,93,680327,91.02582285255552,8
0.05,7474,94,680421,91.02622073578596,7
0.05,7475,94,680515,91.02661851257356,7
0.05,7476,94,680609,91.02701618296108,7
0.05,7477,94,680703,91.02741374699117,8
0.05,7478,94,680797,91.02781120470651,7
0.05,7479,94,680891,91.02820855614974,7
0.05,7480,92,680983,91.02833845742548,9
0.05,7481,93,681076,91.02860197808073,8
0.05,7482,94,681170,91.0289990645463,7
0.05,7483,94,681264,91.02939604489578,7
0.05,7484,95,681359,91.02992651970608,6
0.05,7485,92,681451,91.03005610472883,9
0.05,7486,94,681545,91.03045278482703,7
0.05,7487,96,681641,91.03111645299145,6
0.05,7488,95,681736,91.03164641474162,6
0.05,7489,95,681831,91.03217623497997,6
0.05,7490,93,681924,91.03243892671206,8
0.05,7491,91,682015,91.03243459690336,10
0.05,7492,94,682109,91.03283064193246,7
0.05,7493,96,682205,91.03349346143581,6
0.05,7494,94,682299,91.03388925950634,7
0.05,7495,94,682393,91.03428495197439,7
0.05,7496,94,682487,91.03468053888221,7
0.05,7497,95,682582,91.03520938917045,6
0.05,7498,94,682676,91.03560474729964,7
0.05,7499,90,682766,91.03546666666666,12
0.05,7500,92,682858,91.03559525396614,9
0.05,7501,93,682951,91.03585710477206,8
0.05,7502,95,683046,91.03638544582167,7
0.05,7503,96,683142,91.03704690831556,6
0.05,7504,96,683238,91.03770819453698,6
0.05,7505,93,683331,91.03796962430056,8
0.05,7506,95,683426,91.0384974024244,6
0.05,7507,91,683517,91.03849227490677,10
0.05,7508,95,683612,91.03901984285524,6
0.05,7509,94,683706,91.03941411451399,7
0.05,7510,94,683800,91.03980828118759,7
0.05,7511,95,683895,91.04033546325878,6
0.05,7512,95,683990,91.04086250499135,6
0.05,7513,94,684084,91.04125632153314,7
0.05,7514,92,684176,91.04138389886893,9
0.05,7515,91,684267,91.04137839276211,10
0.05,7516,94,684361,91.04177198350406,7
0.05,7517,93,684454,91.04203245544028,8
0.05,7518,92,684546,91.04215986168373,9
0.05,7519,95,684641,91.04268617021276,6
0.05,7520,96,684737,91.04334529982715,6
0.05,7521,96,684833,91.04400425418771,6
0.05,7522,96,684929,91.04466303336434,6
0.05,7523,92,685021,91.04479000531632,9
0.05,7524,92,685113,91.0449169435216,9
0.05,7525,93,685206,91.04517672070156,8
0.05,7526,86,685292,91.04450644347017,15
0.05,7527,96,685388,91.0451647183847,6
0.05,7528,96,685484,91.04582281843538,6
0.05,7529,92,685576,91.04594953519256,9
0.05,7530,95,685671,91.04647457177002,6
0.05,7531,93,685764,91.04673393520977,8
0.05,7532,94,685858,91.04712597902562,8
0.05,7533,92,685950,91.0472524555349,9
0.05,7534,91,686041,91.04724618447246,12
0.05,7535,96,686137,91.0479033970276,6
0.05,7536,96,686233,91.04856043518642,6
0.05,7537,94,686327,91.04895197665164,7
0.05,7538,95,686422,91.0494760578326,6
0.05,7539,94,686516,91.0498673740053,7
0.05,7540,96,686612,91.05052380320912,6
0.05,7541,93,686705,91.05078228586582,8
0.05,7542,94,686799,91.05117327323346,7
0.05,7543,92,686891,91.05129904559915,9
0.05,7544,95,686986,91.05182239893969,6
0.05,7545,26,687012,91.04320169626293,7
0.05,7546,95,687107,91.04372598383463,6
0.05,7547,94,687201,91.04411764705883,7
0.05,7548,88,687289,91.04371439925818,14
0.05,7549,94,687383,91.0441059602649,7
0.05,7550,94,687477,91.04449741756059,7
0.05,7551,93,687570,91.04475635593221,9
0.05,7552,95,687665,91.04528002118363,6
0.05,7553,94,687759,91.04567116759333,7
0.05,7554,94,687853,91.04606221045665,7
0.05,7555,94,687947,91.04645314981472,8
0.05,7556,94,688041,91.04684398570862,7
0.05,7557,94,688135,91.04723471817941,8
0.05,7558,93,688228,91.04749305463686,8
0.05,7559,95,688323,91.04801587301587,6
0.05,7560,95,688418,91.04853855310144,6
0.05,7561,92,688510,91.0486643745041,9
0.05,7562,96,688606,91.04931905328573,6
0.05,7563,94,688700,91.04970914859862,7
0.05,7564,94,688794,91.0500991407799,7
0.05,7565,94,688888,91.05048902987048,7
0.05,7566,94,688982,91.05087881591119,8
0.05,7567,94,689076,91.05126849894292,7
0.05,7568,92,689168,91.05139384330823,9
0.05,7569,95,689263,91.05191545574637,7
0.05,7570,94,689357,91.05230484744419,8
0.05,7571,92,689449,91.05243000528262,9
0.05,7572,94,689543,91.05281922619834,7
0.05,7573,25,689568,91.04409823078954,8
0.05,7574,93,689661,91.04435643564356,8
0.05,7575,96,689757,91.04501055966209,6
0.05,7576,95,689852,91.04553253266464,6
0.05,7577,15,689867,91.03549749274215,17
0.05,7578,91,689958,91.03549280907771,10
0.05,7579,95,690053,91.03601583113456,6
0.05,7580,91,690144,91.03601108033241,11
0.05,7581,92,690236,91.03613822210498,9
0.05,7582,89,690325,91.03586970855862,12
0.05,7583,94,690419,91.0362605485232,7
0.05,7584,96,690515,91.03691496374424,6
0.05,7585,94,690609,91.03730556287898,7
0.05,7586,95,690704,91.03782786345064,8
0.05,7587,95,690799,91.0383500263574,7
0.05,7588,92,690891,91.03847674265384,9
0.05,7589,24,690915,91.0296442687747,9
0.05,7590,94,691009,91.0300355684363,8
0.05,7591,92,691101,91.03016332982087,9
0.05,7592,95,691196,91.0306861583037,6
0.05,7593,95,691291,91.03120884909139,6
0.05,7594,94,691385,91.03159973666887,7
0.05,7595,94,691479,91.03199052132702,7
0.05,7596,93,691572,91.03224957219955,8
0.05,7597,94,691666,91.03264016846539,7
0.05,7598,89,691755,91.03237268061586,12
0.05,7599,96,691851,91.03302631578947,6
0.05,7600,88,691939,91.03262728588344,13
0.05,7601,94,692033,91.03301762694028,7
0.05,7602,90,692123,91.03288175720111,11
0.05,7603,94,692217,91.0332719621252,7
0.05,7604,96,692313,91.03392504930966,6
0.05,7605,93,692406,91.03418353931107,8
0.05,7606,96,692502,91.03483633495465,6
0.05,7607,94,692596,91.03522607781282,7
0.05,7608,92,692688,91.03535287159943,9
0.05,7609,95,692783,91.0358738501971,6
0.05,7610,94,692877,91.03626330311391,7
0.05,7611,92,692969,91.03638991066737,9
0.05,7612,92,693061,91.03651648495993,9
0.05,7613,92,693153,91.03664302600473,9
0.05,7614,92,693245,91.03676953381483,9
0.05,7615,94,693339,91.03715861344538,7
0.05,7616,94,693433,91.03754759091505,8
0.05,7617,94,693527,91.03793646626411,7
0.05,7618,91,693618,91.03793148707179,11
0.05,7619,94,693712,91.03832020997375,7
0.05,7620,95,693807,91.0388400472379,6
0.05,7621,94,693901,91.03922854893729,7
0.05,7622,94,693995,91.03961694870786,7
0.05,7623,94,694089,91.04000524658971,7
0.05,7624,95,694184,91.04052459016394,6
0.05,7625,95,694279,91.04104379753475,6
0.05,7626,94,694373,91.04143175560509,7
0.05,7627,92,694465,91.04155742003147,9
0.05,7628,94,694559,91.04194520907065,7
0.05,7629,94,694653,91.04233289646133,7
0.05,7630,91,694744,91.0423273489713,10
0.05,7631,94,694838,91.04271488469601,7
0.05,7632,93,694931,91.04297130879078,8
0.05,7633,96,695027,91.0436206444852,6
0.05,7634,94,695121,91.04400785854617,7
0.05,7635,95,695216,91.04452592980618,6
0.05,7636,96,695312,91.04517480686134,6
0.05,7637,93,695405,91.04543074103168,8
0.05,7638,94,695499,91.0458175153816,7
0.05,7639,94,695593,91.04620418848168,7
0.05,7640,96,695689,91.04685250621647,6
0.05,7641,94,695783,91.04723894268515,7
0.05,7642,95,695878,91.0477561167081,6
0.05,7643,90,695968,91.04761904761905,11
0.05,7644,94,696062,91.0480052321779,7
0.05,7645,92,696154,91.04812974104107,9
0.05,7646,94,696248,91.04851575781352,8
0.05,7647,94,696342,91.04890167364017,7
0.05,7648,94,696436,91.0492874885606,7
0.05,7649,94,696530,91.04967320261439,7
0.05,7650,95,696625,91.05018951771011,6
0.05,7651,94,696719,91.05057501306848,7
0.05,7652,93,696812,91.05082973997125,9
0.05,7653,89,696901,91.0505617977528,12
0.05,7654,95,696996,91.05107772697583,6
0.05,7655,93,697089,91.05133228840126,8
0.05,7656,95,697184,91.05184798223847,6
0.05,7657,94,697278,91.05223295899712,7
0.05,7658,92,697370,91.05235670453062,9
0.05,7659,93,697463,91.05261096605744,8
0.05,7660,93,697556,91.05286516120611,12
0.05,7661,96,697652,91.05351083268076,6
0.05,7662,94,697746,91.05389534125017,7
0.05,7663,93,697839,91.05414926931107,8
0.05,7664,93,697932,91.05440313111546,8
0.05,7665,94,698026,91.05478737281503,7
0.05,7666,94,698120,91.055171514282,7
0.05,7667,96,698216,91.05581637976005,6
0.05,7668,89,698305,91.05554831138349,13
0.05,7669,94,698399,91.05593220338983,7
0.05,7670,94,698493,91.056315995307,7
0.05,7671,23,698516,91.04744525547446,11
0.05,7672,93,698609,91.04769972631304,8
0.05,7673,92,698701,91.04782382069325,9
0.05,7674,93,698794,91.04807817589577,9
0.05,7675,95,698889,91.04859301719645,7
0.05,7676,92,698981,91.04871694672399,9
0.05,7677,96,699077,91.04936181297212,6
0.05,7678,94,699171,91.04974606068498,7
0.05,7679,92,699263,91.04986979166667,9
0.05,7680,95,699358,91.05038406457493,6
0.05,7681,94,699452,91.05076802915907,7
0.05,7682,93,699545,91.05102173630092,9
0.05,7683,94,699639,91.0514055179594,8
0.05,7684,93,699732,91.05165907612232,8
0.05,7685,94,699826,91.0520426749935,8
0.05,7686,93,699919,91.05229608429816,8
0.05,7687,94,700013,91.0526795005203,7
0.05,7688,95,700108,91.05319287293536,6
0.05,7689,94,700202,91.05357607282184,7
0.05,7690,93,700295,91.05382915095566,8
0.05,7691,93,700388,91.05408216328654,8
0.05,7692,92,700480,91.05420512153906,9
0.05,7693,94,700574,91.05458799064206,7
0.05,7694,94,700668,91.05497076023391,8
0.05,7695,93,700761,91.0552234927235,8
0.05,7696,94,700855,91.05560608029103,7
0.05,7697,93,700948,91.0558586645882,8
0.05,7698,94,701042,91.05624107026887,7
0.05,7699,95,701137,91.05675324675325,6
0.05,7700,88,701225,91.05635631736138,13
0.05,7701,91,701316,91.05634900025967,10
0.05,7702,95,701411,91.05686096326107,6
0.05,7703,92,701503,91.05698338525441,9
0.05,7704,94,701597,91.05736534717715,7
0.05,7705,95,701692,91.05787697897742,6
0.05,7706,92,701784,91.05799922148697,9
0.05,7707,94,701878,91.05838090295796,7
0.05,7708,96,701974,91.05902192242833,6
0.05,7709,96,702070,91.05966277561609,6
0.05,7710,86,702156,91.05900661392815,15
0.05,7711,95,702251,91.05951763485477,6
0.05,7712,92,702343,91.05963956955789,9
0.05,7713,94,702437,91.06002074150895,7
0.05,7714,95,702532,91.06053143227479,6
0.05,7715,96,702628,91.06117159149818,6
0.05,7716,94,702722,91.06155241674226,7
0.05,7717,91,702813,91.06154444156518,10
0.05,7718,95,702908,91.06205467029407,6
0.05,7719,94,703002,91.06243523316063,7
0.05,7720,93,703095,91.06268618054656,8
0.05,7721,96,703191,91.06332556332556,6
0.05,7722,91,703282,91.06331736371877,10
0.05,7723,92,703374,91.06343863283273,9
0.05,7724,96,703470,91.06407766990291,6
0.05,7725,95,703565,91.06458710846492,6
0.05,7726,91,703656,91.06457874983823,10
0.05,7727,96,703752,91.06521739130434,6
0.05,7728,94,703846,91.0655971018243,7
0.05,7729,90,703936,91.06545924967658,11
0.05,7730,95,704031,91.06596818005433,7
0.05,7731,92,704123,91.06608898085877,10
0.05,7732,93,704216,91.06633906633907,8
0.05,7733,94,704310,91.06671838634601,7
0.05,7734,95,704405,91.0672268907563,6
0.05,7735,94,704499,91.06760599793175,7
0.05,7736,96,704595,91.06824350523459,6
0.05,7737,94,704689,91.06862238304471,8
0.05,7738,94,704783,91.06900116294095,7
0.05,7739,94,704877,91.06937984496125,9
0.05,7740,92,704969,91.06950006459114,10
0.05,7741,94,705063,91.06987858434513,7
0.05,7742,93,705156,91.0701278574196,8
0.05,7743,94,705250,91.0705061983471,7
0.05,7744,94,705344,91.07088444157522,7
0.05,7745,95,705439,91.0713916860315,6
0.05,7746,96,705535,91.07202788176068,6
0.05,7747,92,705627,91.07214765100672,9
0.05,7748,95,705722,91.07265453606917,7
0.05,7749,94,705816,91.07303225806452,7
0.05,7750,94,705910,91.0734098825958,7
0.05,7751,94,706004,91.07378740970073,7
0.05,7752,93,706097,91.07403585708758,8
0.05,7753,95,706192,91.07454217178231,6
0.05,7754,92,706284,91.07466150870407,11
0.05,7755,94,706378,91.07503867973182,7
0.05,7756,94,706472,91.07541575351296,7
0.05,7757,91,706563,91.0754060324826,10
0.05,7758,23,706586,91.06663229797654,9
0.05,7759,91,706677,91.06662371134021,10
0.05,7760,90,706767,91.06648627754156,12
0.05,7761,93,706860,91.06673537748003,8
0.05,7762,94,706954,91.06711322942162,9
0.05,7763,94,707048,91.06749098402885,7
0.05,7764,95,707143,91.06799742433999,6
0.05,7765,95,707238,91.06850373422611,6
0.05,7766,91,707329,91.06849491438136,11
0.05,7767,94,707423,91.06887229660144,7
0.05,7768,95,707518,91.0693782983653,6
0.05,7769,92,707610,91.06949806949807,9
0.05,7770,95,707705,91.07000386050701,6
0.05,7771,95,707800,91.07050952135873,6
0.05,7772,90,707890,91.0703717998199,11
0.05,7773,94,707984,91.07074864934397,9
0.05,7774,95,708079,91.07125401929261,6
0.05,7775,92,708171,91.07137345679013,9
0.05,7776,94,708265,91.07175003214607,7
0.05,7777,96,708361,91.07238364618154,6
0.05,7778,94,708455,91.07275999485795,7
0.05,7779,94,708549,91.07313624678663,7
0.05,7780,95,708644,91.0736409201902,6
0.05,7781,96,708740,91.07427396556155,6
0.05,7782,94,708834,91.0746498779391,7
0.05,7783,91,708925,91.07464028776978,11
0.05,7784,95,709020,91.07514450867052,6
0.05,7785,90,709110,91.07500642178269,11
0.05,7786,96,709206,91.0756388853217,6
0.05,7787,96,709302,91.07627118644068,6
0.05,7788,93,709395,91.07651816664527,8
0.05,7789,95,709490,91.0770218228498,6
0.05,7790,94,709584,91.07739699653446,7
0.05,7791,95,709679,91.07790041067761,6
0.05,7792,94,709773,91.07827537533684,7
0.05,7793,94,709867,91.07865024377726,8
0.05,7794,94,709961,91.07902501603591,7
0.05,7795,96,710057,91.07965623396613,6
0.05,7796,96,710153,91.08028728998333,6
0.05,7797,96,710249,91.08091818414978,6
0.05,7798,94,710343,91.08129247339403,8
0.05,7799,96,710439,91.08192307692308,6
0.05,7800,94,710533,91.08229714139213,7
0.05,7801,93,710626,91.08254293770828,8
0.05,7802,96,710722,91.08317313853647,6
0.05,7803,93,710815,91.08341875961045,8
0.05,7804,92,710907,91.08353619474696,9
0.05,7805,94,711001,91.0839098129644,7
0.05,7806,94,711095,91.08428333546817,7
0.05,7807,89,711184,91.08401639344262,12
0.05,7808,94,711278,91.08438980663337,7
0.05,7809,95,711373,91.08489116517285,6
0.05,7810,91,711464,91.08488029701702,10
0.05,7811,92,711556,91.08499743983614,9
0.05,7812,92,711648,91.08511455266863,9
0.05,7813,94,711742,91.08548758638341,7
0.05,7814,94,711836,91.08586052463212,8
0.05,7815,93,711929,91.0861054247697,8
0.05,7816,94,712023,91.08647818856339,7
0.05,7817,96,712119,91.08710667689947,6
0.05,7818,95,712214,91.08760711088374,6
0.05,7819,94,712308,91.08797953964195,7
0.05,7820,94,712402,91.088351873162,7
0.05,7821,95,712497,91.08885195602147,6
0.05,7822,96,712593,91.08947973923047,6
0.05,7823,94,712687,91.08985173824131,7
0.05,7824,96,712783,91.09047923322683,6
0.05,7825,95,712878,91.0909787886532,6
0.05,7826,96,712974,91.09160597930241,7
0.05,7827,94,713068,91.09197751660705,7
0.05,7828,93,713161,91.09222122876484,8
0.05,7829,92,713253,91.09233716475096,10
0.05,7830,94,713347,91.09270846635168,7
0.05,7831,95,713442,91.09320735444331,6
0.05,7832,94,713536,91.09357845014681,7
0.05,7833,95,713631,91.09407709982129,7
0.05,7834,95,713726,91.09457562220804,6
0.05,7835,95,713821,91.0950740173558,6
0.05,7836,25,713846,91.08664029603165,8
0.05,7837,89,713935,91.08637407501914,12
0.05,7838,93,714028,91.08661819109581,8
0.05,7839,96,714124,91.08724489795918,6
0.05,7840,93,714217,91.0874888407091,8
0.05,7841,96,714313,91.08811527671513,6
0.05,7842,89,714402,91.08784903735815,12
0.05,7843,96,714498,91.08847526772055,6
0.05,7844,26,714524,91.08017845761631,9
0.05,7845,94,714618,91.08055059903135,7
0.05,7846,93,714711,91.08079520835989,8
0.05,7847,94,714805,91.08116717635066,8
0.05,7848,94,714899,91.08153904956045,7
0.05,7849,96,714995,91.08216560509554,6
0.05,7850,95,715090,91.08266462870972,7
0.05,7851,94,715184,91.08303616912889,7
0.05,7852,95,715279,91.08353495479435,6
0.05,7853,94,715373,91.08390628978864,7
0.05,7854,94,715467,91.08427753023552,7
0.05,7855,94,715561,91.08464867617108,7
0.05,7856,93,715654,91.08489245259004,8
0.05,7857,92,715746,91.08500890811911,10
0.05,7858,95,715841,91.08550706196718,6
0.05,7859,92,715933,91.08562340966921,9
0.05,7860,94,716027,91.08599414832719,9
0.05,7861,94,716121,91.08636479267362,7
0.05,7862,94,716215,91.0867353427445,7
0.05,7863,90,716305,91.08659715157681,11
0.05,7864,96,716401,91.08722186904005,6
0.05,7865,93,716494,91.08746503941012,8
0.05,7866,94,716588,91.08783526121775,8
0.05,7867,93,716681,91.08807829181495,8
0.05,7868,94,716775,91.08844834159359,7
0.05,7869,91,716866,91.08843710292248,10
0.05,7870,95,716961,91.08893406174565,6
0.05,7871,95,717056,91.08943089430895,6
0.05,7872,92,717148,91.08954655150515,9
0.05,7873,94,717242,91.08991617983236,7
0.05,7874,95,717337,91.09041269841269,7
0.05,7875,94,717431,91.09078212290503,7
0.05,7876,94,717525,91.09115145359908,8
0.05,7877,91,717616,91.09113988321909,10
0.05,7878,93,717709,91.09138215509583,8
0.05,7879,94,717803,91.09175126903553,8
0.05,7880,84,717887,91.09085141479508,17
0.05,7881,94,717981,91.09122050241055,7
0.05,7882,94,718075,91.09158949638463,7
0.05,7883,94,718169,91.09195839675291,7
0.05,7884,95,718264,91.09245402663285,7
0.05,7885,90,718354,91.09231549581537,11
0.05,7886,93,718447,91.0925573728921,8
0.05,7887,94,718541,91.09292596348884,7
0.05,7888,96,718637,91.09354797819749,6
0.05,7889,92,718729,91.0936628643853,9
0.05,7890,94,718823,91.09403117475605,8
0.05,7891,93,718916,91.09427268119614,8
0.05,7892,95,719011,91.09476751552008,6
0.05,7893,93,719104,91.0950088674943,8
0.05,7894,93,719197,91.09525015832806,8
0.05,7895,92,719289,91.09536474164133,9
0.05,7896,95,719384,91.09585918703306,8
0.05,7897,94,719478,91.09622689288427,7
0.05,7898,94,719572,91.09659450563362,7
0.05,7899,94,719666,91.09696202531646,7
0.05,7900,95,719761,91.09745601822554,8
0.05,7901,94,719855,91.09782333586433,7
0.05,7902,92,719947,91.09793749209162,9
0.05,7903,94,720041,91.09830465587045,7
0.05,7904,92,720133,91.09841872232764,9
0.05,7905,95,720228,91.09891221856817,7
0.05,7906,96,720324,91.09953206019982,6
0.05,7907,94,720418,91.09989883662114,8
0.05,7908,90,720508,91.09975976735365,12
0.05,7909,92,720600,91.09987357774969,11
0.05,7910,90,720690,91.09973454683352,11
0.05,7911,94,720784,91.10010111223458,7
0.05,7912,94,720878,91.10046758498673,7
0.05,7913,91,720969,91.10045489006824,11
0.05,7914,96,721065,91.1010739102969,6
0.05,7915,96,721161,91.10169277412835,6
0.05,7916,92,721253,91.10180623973727,9
0.05,7917,93,721346,91.10204597120484,8
0.05,7918,90,721436,91.10190680641495,12
0.05,7919,94,721530,91.10227272727273,7
0.05,7920,89,721619,91.10200732230778,13
0.05,7921,94,721713,91.10237313809644,7
0.05,7922,92,721805,91.10248643190711,9
0.05,7923,94,721899,91.10285209490156,7
0.05,7924,96,721995,91.10347003154574,6
0.05,7925,96,722091,91.10408781226344,6
0.05,7926,95,722186,91.10457928598461,6
0.05,7927,93,722279,91.10481836528758,8
0.05,7928,94,722373,91.1051835035944,8
0.05,7929,93,722466,91.10542244640605,8
0.05,7930,94,722560,91.10578741646702,7
0.05,7931,96,722656,91.10640443772063,6
0.05,7932,93,722749,91.10664313626623,8
0.05,7933,94,722843,91.10700781446937,7
0.05,7934,92,722935,91.10712035286704,10
0.05,7935,94,723029,91.10748487903226,7
0.05,7936,94,723123,91.10784931334257,7
0.05,7937,92,723215,91.1079617031998,9
0.05,7938,96,723311,91.10857790653735,6
0.05,7939,96,723407,91.10919395465994,6
0.05,7940,90,723497,91.10905427528019,12
0.05,7941,95,723592,91.10954419541677,7
0.05,7942,94,723686,91.10990809517814,7
0.05,7943,96,723782,91.11052366565961,6
0.05,7944,95,723877,91.11101321585903,6
0.05,7945,94,723971,91.11137679335515,7
0.05,7946,94,724065,91.1117402793507,7
0.05,7947,90,724155,91.11160040261701,12
0.05,7948,94,724249,91.11196376902755,7
0.05,7949,94,724343,91.11232704402515,7
0.05,7950,96,724439,91.11294176833103,6
0.05,7951,93,724532,91.11317907444668,8
0.05,7952,94,724626,91.11354205960015,8
0.05,7953,94,724720,91.11390495348252,7
0.05,7954,94,724814,91.11426775612821,9
0.05,7955,93,724907,91.11450477626948,8
0.05,7956,94,725001,91.11486741234134,7
0.05,7957,94,725095,91.1152299572757,7
0.05,7958,94,725189,91.11559241110692,7
0.05,7959,94,725283,91.11595477386935,7
0.05,7960,94,725377,91.11631704559728,7
0.05,7961,94,725471,91.11667922632505,7
0.05,7962,96,725567,91.11729247770941,6
0.05,7963,96,725663,91.11790557508789,6
0.05,7964,94,725757,91.11826741996234,7
0.05,7965,95,725852,91.11875470750691,6
0.05,7966,92,725944,91.1188653194427,9
0.05,7967,95,726039,91.11935240963855,7
0.05,7968,92,726131,91.11946291881038,9
0.05,7969,94,726225,91.1198243412798,7
0.05,7970,88,726313,91.11943294442354,14
0.05,7971,95,726408,91.11991971901656,6
0.05,7972,94,726502,91.12028094820018,7
0.05,7973,94,726596,91.12064208678204,7
0.05,7974,93,726689,91.1208777429467,8
0.05,7975,95,726784,91.12136409227683,8
0.05,7976,94,726878,91.12172495925786,7
0.05,7977,94,726972,91.12208573577338,7
0.05,7978,95,727067,91.12257175084596,6
0.05,7979,94,727161,91.12293233082707,7
0.05,7980,92,727253,91.12304222528505,9
0.05,7981,94,727347,91.12340265597595,7
0.05,7982,95,727442,91.12388826255794,6
0.05,7983,96,727538,91.12449899799599,6
0.05,7984,91,727629,91.12448340638697,10
0.05,7985,87,727716,91.12396694214875,14
0.05,7986,94,727810,91.12432703142606,7
0.05,7987,94,727904,91.12468703054581,7
0.05,7988,93,727997,91.12492176743022,9
0.05,7989,95,728092,91.12540675844807,8
0.05,7990,92,728184,91.12551620573144,9
0.05,7991,95,728279,91.126001001001,7
0.05,7992,94,728373,91.1263605654948,7
0.05,7993,95,728468,91.12684513385038,6
0.05,7994,94,728562,91.12720450281427,7
0.05,7995,96,728658,91.12781390695348,6
0.05,7996,94,728752,91.12817306489934,7
0.05,7997,90,728842,91.128032008002,11
0.05,7998,94,728936,91.12839104888111,7
0.05,7999,96,729032,91.129,6
0.05,8000,91,729123,91.12898387701537,10
0.05,8001,95,729218,91.12946763309172,6
0.05,8002,94,729312,91.12982631513182,7
0.05,8003,95,729407,91.13030984507746,7
0.05,8004,94,729501,91.13066833229232,7
0.05,8005,95,729596,91.13115163627279,6
0.05,8006,96,729692,91.13175971025353,6
0.05,8007,95,729787,91.13224275724276,6
0.05,8008,93,729880,91.13247596453989,8
0.05,8009,94,729974,91.13283395755306,7
0.05,8010,90,730064,91.13269254774684,11
0.05,8011,95,730159,91.13317523714429,7
0.05,8012,94,730253,91.1335330088606,7
0.05,8013,95,730348,91.13401547292239,6
0.05,8014,92,730440,91.134123518403,9
0.05,8015,94,730534,91.13448103792415,7
0.05,8016,96,730630,91.13508793813148,6
0.05,8017,96,730726,91.13569468695435,6
0.05,8018,92,730818,91.1358024691358,9
0.05,8019,92,730910,91.1359102244389,9
0.05,8020,23,730933,91.12741553422266,10
0.05,8021,94,731027,91.12777362253802,7
0.05,8022,94,731121,91.12813162158794,7
0.05,8023,96,731217,91.12873878364906,6
0.05,8024,91,731308,91.12872274143302,11
0.05,8025,94,731402,91.12908048841265,7
0.05,8026,96,731498,91.12968730534446,6
0.05,8027,96,731594,91.13029397110114,6
0.05,8028,93,731687,91.13052684020425,8
0.05,8029,95,731782,91.13100871731008,6
0.05,8030,94,731876,91.13136595691695,7
0.05,8031,92,731968,91.13147410358566,9
0.05,8032,93,732061,91.13170670982198,10
0.05,8033,94,732155,91.13206372915111,7
0.05,8034,96,732251,91.1326695706285,6
0.05,8035,94,732345,91.13302638128422,8
0.05,8036,93,732438,91.13325867861143,8
0.05,8037,96,732534,91.13386414530977,6
0.05,8038,96,732630,91.13446946137579,6
0.05,8039,95,732725,91.13495024875621,7
0.05,8040,96,732821,91.13555527919414,6
0.05,8041,89,732910,91.13528972892315,12
0.05,8042,27,732937,91.12731567822952,6
0.05,8043,95,733032,91.12779711586275,6
0.05,8044,95,733127,91.12827843380983,6
0.05,8045,95,733222,91.12875963211533,8
0.05,8046,96,733318,91.12936498073816,6
0.05,8047,92,733410,91.1294731610338,9
0.05,8048,95,733505,91.12995403155672,7
0.05,8049,92,733597,91.13006211180124,9
0.05,8050,92,733689,91.13017016519687,10
0.05,8051,89,733778,91.12990561351216,12
0.05,8052,96,733874,91.13051036880665,6
0.05,8053,91,733965,91.13049416439037,10
0.05,8054,95,734060,91.13097454996897,6
0.05,8055,92,734152,91.13108242303873,10
0.05,8056,91,734243,91.13106615365521,10
0.05,8057,90,734333,91.13092578803673,11
0.05,8058,94,734427,91.13128179674898,7
0.05,8059,95,734522,91.13176178660049,6
0.05,8060,94,734616,91.13211760327503,7
0.05,8061,95,734711,91.13259737037956,6
0.05,8062,91,734802,91.13258092521394,10
0.05,8063,95,734897,91.13306051587301,6
0.05,8064,95,734992,91.13353998760074,7
0.05,8065,94,735086,91.13389536325316,7
0.05,8066,92,735178,91.13400272716004,9
0.05,8067,94,735272,91.13435795736243,7
0.05,8068,96,735368,91.13496096170529,6
0.05,8069,94,735462,91.1353159851301,7
0.05,8070,94,735556,91.13567092057986,8
0.05,8071,94,735650,91.13602576808721,8
0.05,8072,27,735677,91.12808125851605,6
0.05,8073,94,735771,91.12843695813723,7
0.05,8074,88,735859,91.12804953560372,13
0.05,8075,96,735955,91.12865279841506,6
0.05,8076,95,736050,91.12913210350378,6
0.05,8077,89,736139,91.1288685318148,12
0.05,8078,90,736229,91.12872880306969,11
0.05,8079,95,736324,91.12920792079208,6
0.05,8080,94,736418,91.12956317287464,7
0.05,8081,95,736513,91.13004206879485,6
0.05,8082,95,736608,91.13052084622046,6
0.05,8083,91,736699,91.13050470064324,10
0.05,8084,95,736794,91.13098330241188,6
0.05,8085,94,736888,91.13133811526095,7
0.05,8086,94,736982,91.13169284036107,7
0.05,8087,94,737076,91.1320474777448,7
0.05,8088,95,737171,91.13252565212017,6
0.05,8089,93,737264,91.1327564894932,8
0.05,8090,92,737356,91.13286367568904,9
0.05,8091,94,737450,91.13321799307958,7
0.05,8092,92,737542,91.13332509576178,9
0.05,8093,92,737634,91.13343217197924,9
0.05,8094,92,737726,91.13353922174181,10
0.05,8095,96,737822,91.13414031620553,6
0.05,8096,94,737916,91.13449425713227,7
0.05,8097,91,738007,91.13447764880218,13
0.05,8098,96,738103,91.13507840474132,6
0.05,8099,93,738196,91.13530864197531,9
0.05,8100,94,738290,91.13566226391804,7
0.05,8101,96,738386,91.13626265119724,6
0.05,8102,94,738480,91.13661606812292,7
0.05,8103,96,738576,91.13721618953603,6
0.05,8104,94,738670,91.13756940160395,7
0.05,8105,96,738766,91.13816925734024,6
0.05,8106,94,738860,91.13852226470951,7
0.05,8107,92,738952,91.13862851504686,9
0.05,8108,96,739048,91.13922801825133,6
0.05,8109,95,739143,91.13970406905055,6
0.05,8110,96,739239,91.14030329182592,6
0.05,8111,95,739334,91.14077909270218,6
0.05,8112,92,739426,91.1408849993837,9
0.05,8113,94,739520,91.14123736751294,8
0.05,8114,92,739612,91.14134319162045,9
0.05,8115,95,739707,91.14181862986693,6
0.05,8116,94,739801,91.14217075274117,7
0.05,8117,94,739895,91.14252278886426,7
0.05,8118,96,739991,91.1431210740239,6
0.05,8119,96,740087,91.14371921182266,6
0.05,8120,94,740181,91.14407092722571,7
0.05,8121,96,740277,91.14466880078798,6
0.05,8122,94,740371,91.14502031269235,7
0.05,8123,89,740460,91.14475627769572,12
0.05,8124,25,740485,91.13661538461538,8
0.05,8125,93,740578,91.13684469603741,8
0.05,8126,96,740674,91.13744309093147,6
0.05,8127,93,740767,91.13767224409449,8
0.05,8128,91,740858,91.13765530815598,10
0.05,8129,89,740947,91.13739237392375,12
0.05,8130,94,741041,91.13774443487885,7
0.05,8131,92,741133,91.13785046728972,9
0.05,8132,92,741225,91.13795647362596,9
0.05,8133,92,741317,91.13806245389722,9
0.05,8134,94,741411,91.13841425937308,7
0.05,8135,92,741503,91.13852015732547,9
0.05,8136,95,741598,91.1389947154971,7
0.05,8137,93,741691,91.1392233964119,8
0.05,8138,94,741785,91.13957488634968,7
0.05,8139,95,741880,91.14004914004914,6
0.05,8140,93,741973,91.14027760717357,8
0.05,8141,93,742066,91.14050601817735,8
0.05,8142,93,742159,91.14073437308117,8
0.05,8143,94,742253,91.14108546168958,7
0.05,8144,92,742345,91.14119091467158,11
0.05,8145,94,742439,91.14154186103609,7
0.05,8146,94,742533,91.14189272124709,8
0.05,8147,94,742627,91.14224349533627,7
0.05,8148,93,742720,91.14247146889188,8
0.05,8149,93,742813,91.14269938650307,8
0.05,8150,96,742909,91.14329530119004,6
0.05,8151,95,743004,91.14376840039255,6
0.05,8152,94,743098,91.1441187293021,7
0.05,8153,94,743192,91.14446897228355,8
0.05,8154,94,743286,91.14481912936849,7
0.05,8155,93,743379,91.14504659146641,10
0.05,8156,94,743473,91.14539659188426,7
0.05,8157,94,743567,91.14574650649669,8
0.05,8158,96,743663,91.14634146341463,6
0.05,8159,96,743759,91.1469362745098,6
0.05,8160,95,743854,91.14740840583262,7
0.05,8161,23,743877,91.13905905415339,10
0.05,8162,94,743971,91.13940953080976,7
0.05,8163,93,744064,91.13963743263106,8
0.05,8164,92,744156,91.139742804654,9
0.05,8165,92,744248,91.13984815086945,10
0.05,8166,92,744340,91.13995347128689,9
0.05,8167,96,744436,91.14054848188051,6
0.05,8168,94,744530,91.14089851879055,7
0.05,8169,92,744622,91.14100367197062,9
0.05,8170,95,744717,91.14147595153592,7
0.05,8171,94,744811,91.1418257464513,7
0.05,8172,92,744903,91.1419307475835,9
0.05,8173,22,744925,91.13347198434059,13
0.05,8174,93,745018,91.1337003058104,8
0.05,8175,91,745109,91.13368395303327,10
0.05,8176,94,745203,91.13403448697566,7
0.05,8177,93,745296,91.13426265590608,8
0.05,8178,94,745390,91.13461303337816,7
0.05,8179,94,745484,91.13496332518338,9
0.05,8180,94,745578,91.13531353135313,7
0.05,8181,94,745672,91.13566365191885,7
0.05,8182,94,745766,91.1360136869119,8
0.05,8183,95,745861,91.13648582600196,6
0.05,8184,89,745950,91.1362248014661,12
0.05,8185,95,746045,91.13669679941363,6
0.05,8186,92,746137,91.1368022474655,9
0.05,8187,96,746233,91.13739618954568,6
0.05,8188,91,746324,91.13737941140555,10
0.05,8189,92,746416,91.13748473748474,9
0.05,8190,91,746507,91.13746795263094,10
0.05,8191,95,746602,91.137939453125,6
0.05,8192,96,746698,91.13853289393384,6
0.05,8193,92,746790,91.13863802782524,9
0.05,8194,90,746880,91.1384990848078,11
0.05,8195,94,746974,91.13884821864325,7
0.05,8196,84,747058,91.1379773087715,17
0.05,8197,93,747151,91.13820444010734,8
0.05,8198,95,747246,91.1386754482254,7
0.05,8199,94,747340,91.1390243902439,7
0.05,8200,94,747434,91.13937324716498,7
0.05,8201,96,747530,91.13996586198488,6
0.05,8202,94,747624,91.14031451907839,7
0.05,8203,92,747716,91.1404193076548,9
0.05,8204,95,747811,91.14088970140159,6
0.05,8205,93,747904,91.14111625639775,8
0.05,8206,92,747996,91.14122090898015,10
0.05,8207,95,748091,91.1416910331384,6
0.05,8208,95,748186,91.14216104275795,6
0.05,8209,94,748280,91.14250913520098,8
0.05,8210,92,748372,91.142613567166,9
0.05,8211,92,748464,91.14271797369703,9
0.05,8212,96,748560,91.14330938755631,6
0.05,8213,88,748648,91.14292671049428,13
0.05,8214,96,748744,91.14351795496044,6
0.05,8215,19,748763,91.13473709834469,13
0.05,8216,93,748856,91.13496409881952,8
0.05,8217,94,748950,91.1353127281577,7
0.05,8218,94,749044,91.13566127266091,7
0.05,8219,93,749137,91.13588807785888,8
0.05,8220,94,749231,91.13623646758302,7
0.05,8221,94,749325,91.13658477256142,7
0.05,8222,93,749418,91.13681138270704,8
0.05,8223,92,749510,91.13691634241245,9
0.05,8224,95,749605,91.13738601823708,6
0.05,8225,94,749699,91.13773401410162,7
0.05,8226,95,749794,91.13820347635833,6
0.05,8227,94,749888,91.1385512882839,7
0.05,8228,96,749984,91.13914205857334,6
0.05,8229,94,750078,91.13948967193195,7
0.05,8230,96,750174,91.14008018466772,6
0.05,8231,94,750268,91.14042759961127,8
0.05,8232,92,750360,91.14053200534434,9
0.05,8233,91,750451,91.1405149380617,10
0.05,8234,94,750545,91.14086217364905,8
0.05,8235,27,750572,91.13307430791646,6
0.05,8236,96,750668,91.13366516935777,6
0.05,8237,94,750762,91.13401310997816,7
0.05,8238,95,750857,91.13448234008982,6
0.05,8239,94,750951,91.13483009708737,8
0.05,8240,88,751039,91.13444970270598,13
0.05,8241,92,751131,91.13455471972821,11
0.05,8242,94,751225,91.13490234138057,7
0.05,8243,96,751321,91.13549247937894,6
0.05,8244,94,751415,91.1358399029715,7
0.05,8245,96,751511,91.13642978413776,6
0.05,8246,94,751605,91.13677700982176,7
0.05,8247,94,751699,91.13712415130941,8
0.05,8248,94,751793,91.13747120863135,7
0.05,8249,94,751887,91.13781818181818,7
0.05,8250,94,751981,91.1381650709005,7
0.05,8251,93,752074,91.13839069316529,8
0.05,8252,94,752168,91.13873742881377,7
0.05,8253,95,752263,91.13920523382602,6
0.05,8254,94,752357,91.13955178679588,7
0.05,8255,95,752452,91.14001937984496,6
0.05,8256,92,752544,91.140123531549,10
0.05,8257,93,752637,91.14034875272463,8
0.05,8258,93,752730,91.14057391936069,8
0.05,8259,92,752822,91.14067796610169,9
0.05,8260,95,752917,91.14114513981359,6
0.05,8261,93,753010,91.14137012829823,8
0.05,8262,95,753105,91.14183710516761,7
0.05,8263,96,753201,91.14242497579865,6
0.05,8264,96,753297,91.14301270417423,6
0.05,8265,94,753391,91.14335833534963,7
0.05,8266,95,753486,91.14382484577234,7
0.05,8267,92,753578,91.14392839864539,10
0.05,8268,93,753671,91.14415286007981,8
0.05,8269,95,753766,91.14461910519951,8
0.05,8270,94,753860,91.14496433321243,7
0.05,8271,96,753956,91.14555125725339,6
0.05,8272,92,754048,91.14565453886135,9
0.05,8273,94,754142,91.1459995165579,8
0.05,8274,91,754233,91.14598187311178,12
0.05,8275,93,754326,91.14620589656839,8
0.05,8276,93,754419,91.14642986589344,8
0.05,8277,94,754513,91.14677458323267,7
0.05,8278,94,754607,91.14711921729678,7
0.05,8279,96,754703,91.14770531400966,6
0.05,8280,96,754799,91.14829126917039,6
0.05,8281,94,754893,91.14863559526684,7
0.05,8282,94,754987,91.14897983822287,7
0.05,8283,95,755082,91.14944471269918,6
0.05,8284,95,755177,91.14990947495474,6
0.05,8285,96,755273,91.15049481052378,6
0.05,8286,90,755363,91.1503559792446,11
0.05,8287,94,755457,91.1506998069498,7
0.05,8288,92,755549,91.15080226806612,9
0.05,8289,94,755643,91.15114595898673,7
0.05,8290,27,755670,91.1434085152575,6
0.05,8291,96,755766,91.14399421128799,6
0.05,8292,93,755859,91.14421801519353,8
0.05,8293,93,755952,91.14444176513142,8
0.05,8294,95,756047,91.14490657022303,7
0.05,8295,94,756141,91.14525072324011,7
0.05,8296,96,756237,91.14583584428107,6
0.05,8297,94,756331,91.14617980236201,9
0.05,8298,94,756425,91.14652367755151,7
0.05,8299,94,756519,91.14686746987952,7
0.05,8300,94,756613,91.14721117937597,7
0.05,8301,96,756709,91.14779571187665,6
0.05,8302,95,756804,91.14825966518126,6
0.05,8303,94,756898,91.14860308285164,7
0.05,8304,93,756991,91.14882600842866,8
0.05,8305,95,757086,91.14928967011798,6
0.05,8306,92,757178,91.14939207896954,11
0.05,8307,95,757273,91.14985556090515,6
0.05,8308,95,757368,91.15031893127933,6
0.05,8309,93,757461,91.15054151624548,8
0.05,8310,92,757553,91.15064372518349,9
0.05,8311,88,757641,91.1502646775746,13
0.05,8312,91,757732,91.15024660170816,10
0.05,8313,91,757823,91.15022853019003,10
0.05,8314,93,757916,91.1504509921828,8
0.05,8315,94,758010,91.15079365079364,7
0.05,8316,93,758103,91.15101599134303,8
0.05,8317,96,758199,91.15159894205338,6
0.05,8318,92,758291,91.15170092559202,10
0.05,8319,94,758385,91.15204326923077,7
0.05,8320,92,758477,91.15214517485879,9
0.05,8321,91,758568,91.1521268925739,10
0.05,8322,92,758660,91.15222876366694,9
0.05,8323,94,758754,91.15257087938491,7
0.05,8324,96,758850,91.15315315315316,6
0.05,8325,96,758946,91.15373528705261,6
0.05,8326,96,759042,91.15431728113366,6
0.05,8327,96,759138,91.15489913544668,6
0.05,8328,94,759232,91.1552407251771,7
0.05,8329,95,759327,91.15570228091237,6
0.05,8330,87,759414,91.15520345696795,14
0.05,8331,94,759508,91.15554488718195,7
0.05,8332,92,759600,91.15564622584904,10
0.05,8333,94,759694,91.15598752099832,7
0.05,8334,93,759787,91.15620875824835,9
0.05,8335,95,759882,91.156669865643,6
0.05,8336,94,759976,91.15701091519732,7
0.05,8337,96,760072,91.15759174862077,6
0.05,8338,94,760166,91.15793260582804,7
0.05,8339,92,760258,91.15803357314148,9
0.05,8340,91,760349,91.15801462654358,10
0.05,8341,93,760442,91.15823543514745,8
0.05,8342,96,760538,91.1588157737025,6
0.05,8343,93,760631,91.15903643336529,8
0.05,8344,95,760726,91.15949670461355,8
0.05,8345,96,760822,91.16007668344118,6
0.05,8346,94,760916,91.16041691625733,8
0.05,8347,95,761011,91.16087685673214,6
0.05,8348,88,761099,91.16049826326505,13
0.05,8349,94,761193,91.16083832335329,7
0.05,8350,95,761288,91.16129804813795,6
0.05,8351,90,761378,91.16115900383141,11
0.05,8352,91,761469,91.16113971028373,10
0.05,8353,94,761563,91.1614795307637,8
0.05,8354,90,761653,91.16134051466187,11
0.05,8355,93,761746,91.16156055528961,8
0.05,8356,94,761840,91.16190020342228,7
0.05,8357,94,761934,91.16223977027997,7
0.05,8358,96,762030,91.1628185189616,6
0.05,8359,95,762125,91.16327751196172,6
0.05,8360,93,762218,91.16349718933142,8
0.05,8361,93,762311,91.16371681415929,8
0.05,8362,93,762404,91.16393638646419,8
0.05,8363,95,762499,91.16439502630321,6
0.05,8364,94,762593,91.16473401075912,7
0.05,8365,93,762686,91.16495338273965,8
0.05,8366,94,762780,91.16529221943348,7
0.05,8367,96,762876,91.16586998087953,6
0.05,8368,91,762967,91.16585016130959,10
0.05,8369,93,763060,91.16606929510155,8
0.05,8370,91,763151,91.16604945645682,10
0.05,8371,95,763246,91.16650740563784,6
0.05,8372,95,763341,91.16696524543174,6
0.05,8373,94,763435,91.16730355863386,7
0.05,8374,96,763531,91.16788059701493,6
0.05,8375,94,763625,91.16821872015282,7
0.05,8376,95,763720,91.1686761370419,6
0.05,8377,93,763813,91.16889472427788,10
0.05,8378,94,763907,91.16923260532283,8
0.05,8379,93,764000,91.16945107398568,8
0.05,8380,94,764094,91.16978880801814,7
0.05,8381,92,764186,91.16988785492723,9
0.05,8382,94,764280,91.17022545628056,7
0.05,8383,94,764374,91.17056297709924,7
0.05,8384,24,764398,91.16255217650567,9
0.05,8385,94,764492,91.16289053183878,7
0.05,8386,93,764585,91.16310957434125,8
0.05,8387,94,764679,91.1634477825465,7
0.05,8388,92,764771,91.16354750268208,9
0.05,8389,96,764867,91.16412395709177,6
0.05,8390,96,764963,91.16470027410321,6
0.05,8391,92,765055,91.16479980934223,9
0.05,8392,93,765148,91.16501846777076,8
0.05,8393,94,765242,91.1653562068144,7
0.05,8394,95,765337,91.165812983919,6
0.05,8395,96,765433,91.16638875655075,6
0.05,8396,94,765527,91.16672621174229,10
0.05,8397,92,765619,91.1668254346273,9
0.05,8398,25,765644,91.15894749374925,8
0.05,8399,94,765738,91.15928571428572,8
0.05,8400,92,765830,91.15938578740626,9
0.05,8401,96,765926,91.15996191383005,6
0.05,8402,95,766021,91.16041889801261,6
0.05,8403,94,766115,91.16075678248453,8
0.05,8404,95,766210,91.16121356335515,7
0.05,8405,95,766305,91.16167023554604,8
0.05,8406,95,766400,91.16212679909599,6
0.05,8407,93,766493,91.1623453853473,8
0.05,8408,96,766589,91.16292068022356,6
0.05,8409,94,766683,91.16325802615934,7
0.05,8410,94,766777,91.16359529187969,7
0.05,8411,93,766870,91.16381359961959,8
0.05,8412,93,766963,91.16403185546179,8
0.05,8413,93,767056,91.16425005942477,8
0.05,8414,95,767151,91.16470588235295,6
0.05,8415,91,767242,91.16468631178707,10
0.05,8416,94,767336,91.16502316739931,7
0.05,8417,94,767430,91.16535994297934,7
0.05,8418,93,767523,91.16557785960327,8
0.05,8419,94,767617,91.16591448931116,7
0.05,8420,94,767711,91.166251039069,8
0.05,8421,93,767804,91.16646877226312,8
0.05,8422,92,767896,91.16656773121215,9
0.05,8423,95,767991,91.16702279202279,6
0.05,8424,94,768085,91.1673590504451,7
0.05,8425,93,768178,91.16757654877759,8
0.05,8426,96,768274,91.1681499940667,6
0.05,8427,94,768368,91.16848599905079,7
0.05,8428,96,768464,91.16905920037964,6
0.05,8429,93,768557,91.16927639383155,8
0.05,8430,94,768651,91.16961214565295,8
0.05,8431,88,768739,91.16923624288425,13
0.05,8432,93,768832,91.16945333807661,8
0.05,8433,94,768926,91.16978894949015,7
0.05,8434,90,769016,91.1696502667457,11
0.05,8435,92,769108,91.16974869606449,10
0.05,8436,94,769202,91.170084153135,7
0.05,8437,92,769294,91.17018250770325,9
0.05,8438,96,769390,91.17075482877118,6
0.05,8439,94,769484,91.17109004739336,7
0.05,8440,94,769578,91.17142518658926,7
0.05,8441,95,769673,91.17187870172945,7
0.05,8442,95,769768,91.17233210943978,7
0.05,8443,92,769860,91.17243012790146,9
0.05,8444,94,769954,91.17276494967436,7
0.05,8445,95,770049,91.17321809140421,7
0.05,8446,94,770143,91.17355274061796,7
0.05,8447,94,770237,91.17388731060606,7
0.05,8448,94,770331,91.17422180139661,8
0.05,8449,95,770426,91.17467455621302,6
0.05,8450,94,770520,91.17500887468938,7
0.05,8451,95,770615,91.17546142924752,6
0.05,8452,94,770709,91.17579557553532,8
0.05,8453,95,770804,91.17624792997398,6
0.05,8454,84,770888,91.17539917208752,18
0.05,8455,96,770984,91.1759697256386,6
0.05,8456,91,771075,91.17594891805605,10
0.05,8457,92,771167,91.17604634665406,9
0.05,8458,91,771258,91.1760255349332,11
0.05,8459,92,771350,91.17612293144208,11
0.05,8460,94,771444,91.17645668360714,8
0.05,8461,94,771538,91.17679035688963,7
0.05,8462,94,771632,91.1771239513175,8
0.05,8463,95,771727,91.17757561436673,6
0.05,8464,96,771823,91.17814530419373,6
0.05,8465,94,771917,91.1784786203638,7
0.05,8466,91,772008,91.1784575410417,10
0.05,8467,94,772102,91.17879074161549,7
0.05,8468,94,772196,91.17912386350218,8
0.05,8469,94,772290,91.17945690672964,7
0.05,8470,91,772381,91.17943572187463,10
0.05,8471,90,772471,91.17929650613786,11
0.05,8472,94,772565,91.17962941107047,7
0.05,8473,95,772660,91.1800802454567,6
0.05,8474,94,772754,91.18041297935103,7
0.05,8475,94,772848,91.18074563473337,7
0.05,8476,93,772941,91.18096024536982,8
0.05,8477,92,773033,91.18105685303138,10
0.05,8478,23,773056,91.173015685812,10
0.05,8479,94,773150,91.17334905660377,7
0.05,8480,89,773239,91.17309279566089,12
0.05,8481,94,773333,91.17342607875501,7
0.05,8482,91,773424,91.17340563479901,10
0.05,8483,93,773517,91.17362093352192,8
0.05,8484,94,773611,91.17395403653506,7
0.05,8485,94,773705,91.17428706104171,7
0.05,8486,93,773798,91.1745021798044,8
0.05,8487,90,773888,91.17436380772855,11
0.05,8488,24,773912,91.16645070090706,8
0.05,8489,95,774007,91.16690223792698,6
0.05,8490,95,774102,91.16735366859027,6
0.05,8491,95,774197,91.16780499293452,6
0.05,8492,94,774291,91.1681384669728,7
0.05,8493,96,774387,91.1687073228161,6
0.05,8494,92,774479,91.16880517951736,9
0.05,8495,25,774504,91.16101694915254,7
0.05,8496,95,774599,91.16146875367777,6
0.05,8497,96,774695,91.16203812661803,6
0.05,8498,95,774790,91.16248970467113,6
0.05,8499,93,774883,91.16270588235294,8
0.05,8500,93,774976,91.16292200917539,9
0.05,8501,95,775071,91.16337332392378,6
0.05,8502,93,775164,91.16358932141597,8
0.05,8503,95,775259,91.16404045155221,6
0.05,8504,90,775349,91.16390358612581,11
0.05,8505,95,775444,91.16435457324242,6
0.05,8506,93,775537,91.16457035382626,8
0.05,8507,94,775631,91.16490362012223,8
0.05,8508,94,775725,91.16523680808555,7
0.05,8509,92,775817,91.16533490011751,9
0.05,8510,94,775911,91.16566795911174,7
0.05,8511,94,776005,91.16600093984962,7
0.05,8512,93,776098,91.16621637495595,8
0.05,8513,94,776192,91.16654921306085,7
0.05,8514,95,776287,91.16699941280093,6
0.05,8515,91,776378,91.16697980272428,10
0.05,8516,93,776471,91.16719502172127,8
0.05,8517,93,776564,91.16741019018549,8
0.05,8518,94,776658,91.16774269280432,7
0.05,8519,90,776748,91.16760563380282,11
0.05,8520,96,776844,91.16817274967727,6
0.05,8521,95,776939,91.16862238911054,6
0.05,8522,95,777034,91.1690719230318,6
0.05,8523,95,777129,91.16952135147818,6
0.05,8524,94,777223,91.16985337243402,7
0.05,8525,94,777317,91.1701853155055,8
0.05,8526,92,777409,91.17028263164067,9
0.05,8527,96,777505,91.17084896810506,6
0.05,8528,96,777601,91.17141517176691,6
0.05,8529,96,777697,91.17198124267291,6
0.05,8530,95,777792,91.17242996131755,7
0.05,8531,93,777885,91.1726441631505,8
0.05,8532,94,777979,91.17297550685574,7
0.05,8533,94,778073,91.17330677290836,7
0.05,8534,92,778165,91.1734036321031,10
0.05,8535,94,778259,91.17373477038426,7
0.05,8536,94,778353,91.1740658310882,7
0.05,8537,96,778449,91.17463106113844,6
0.05,8538,95,778544,91.17507904906898,7
0.05,8539,95,778639,91.17552693208431,6
0.05,8540,96,778735,91.17609179253014,6
0.05,8541,94,778829,91.17642238351674,7
0.05,8542,96,778925,91.17698700690624,6
0.05,8543,93,779018,91.17720037453184,8
0.05,8544,93,779111,91.17741369221767,9
0.05,8545,95,779206,91.17786098759653,7
0.05,8546,95,779301,91.17830817830817,6
0.05,8547,95,779396,91.17875526438934,6
0.05,8548,94,779490,91.17908527313136,7
0.05,8549,95,779585,91.17953216374269,6
0.05,8550,95,779680,91.17997894983043,7
0.05,8551,96,779776,91.18054256314312,6
0.05,8552,94,779870,91.18087220858179,7
0.05,8553,94,779964,91.18120177694645,7
0.05,8554,93,780057,91.18141437755699,8
0.05,8555,92,780149,91.1815100514259,9
0.05,8556,93,780242,91.18172256631998,8
0.05,8557,90,780332,91.18158448235569,12
0.05,8558,95,780427,91.1820306110527,6
0.05,8559,94,780521,91.18235981308412,7
0.05,8560,93,780614,91.18257212942413,8
0.05,8561,94,780708,91.18290119131044,7
0.05,8562,96,780804,91.1834637393437,6
0.05,8563,94,780898,91.1837926202709,7
0.05,8564,92,780990,91.18388791593695,9
0.05,8565,25,781015,91.17616156899369,7
0.05,8566,90,781105,91.17602427921092,13
0.05,8567,93,781198,91.17623716153128,8
0.05,8568,92,781290,91.17633329443342,10
0.05,8569,94,781384,91.17666277712952,7
0.05,8570,96,781480,91.17722552794307,6
0.05,8571,27,781507,91.16973868408773,6
0.05,8572,89,781596,91.16948559430772,12
0.05,8573,93,781689,91.16969909027291,8
0.05,8574,90,781779,91.16956268221574,11
0.05,8575,96,781875,91.17012593283582,6
0.05,8576,96,781971,91.17068905211613,6
0.05,8577,94,782065,91.17101888552111,7
0.05,8578,27,782092,91.16353887399464,6
0.05,8579,96,782188,91.16410256410256,6
0.05,8580,92,782280,91.1641999766927,9
0.05,8581,96,782376,91.16476345840131,6
0.05,8582,94,782470,91.1650937900501,7
0.05,8583,96,782566,91.16565703634669,6
0.05,8584,96,782662,91.16622015142691,6
0.05,8585,93,782755,91.16643372932681,8
0.05,8586,93,782848,91.16664725748224,8
0.05,8587,90,782938,91.16651141127154,11
0.05,8588,93,783031,91.1667248806613,8
0.05,8589,92,783123,91.16682188591385,10
0.05,8590,93,783216,91.16703526946804,8
0.05,8591,95,783311,91.16748137802607,6
0.05,8592,96,783407,91.16804375654603,6
0.05,8593,90,783497,91.16790784268095,11
0.05,8594,93,783590,91.16812100058173,8
0.05,8595,94,783684,91.16845044206607,7
0.05,8596,92,783776,91.16854716761661,9
0.05,8597,94,783870,91.168876482903,8
0.05,8598,94,783964,91.16920572159553,7
0.05,8599,95,784059,91.1696511627907,7
0.05,8600,94,784153,91.16998023485641,7
0.05,8601,89,784242,91.16972797023948,12
0.05,8602,93,784335,91.16994071835406,9
0.05,8603,94,784429,91.17026964202697,7
0.05,8604,96,784525,91.17083091226031,6
0.05,8605,95,784620,91.17127585405531,7
0.05,8606,94,784714,91.17160450795863,7
0.05,8607,94,784808,91.17193308550186,7
0.05,8608,89,784897,91.17168079916367,12
0.05,8609,94,784991,91.17200929152149,8
0.05,8610,96,785087,91.17256996864475,6
0.05,8611,94,785181,91.17289828146772,7
0.05,8612,96,785277,91.17345872518287,7
0.05,8613,94,785371,91.17378685860227,7
0.05,8614,92,785463,91.17388276262334,9
0.05,8615,93,785556,91.1740947075209,8
0.05,8616,93,785649,91.17430660322619,8
0.05,8617,93,785742,91.17451844975632,8
0.05,8618,96,785838,91.17507831534981,6
0.05,8619,94,785932,91.1754060324826,7
0.05,8620,92,786024,91.17550168193945,10
0.05,8621,95,786119,91.17594525632104,7
0.05,8622,94,786213,91.17627275890061,7
0.05,8623,95,786308,91.17671614100186,6
0.05,8624,96,786404,91.17727536231884,6
0.05,8625,94,786498,91.17760259680037,8
0.05,8626,92,786590,91.1776979251188,10
0.05,8627,94,786684,91.17802503477051,7
0.05,8628,96,786780,91.17858384517325,6
0.05,8629,94,786874,91.17891077636153,7
0.05,8630,95,786969,91.17935349322211,6
0.05,8631,96,787065,91.17991195551437,6
0.05,8632,92,787157,91.1800069500753,9
0.05,8633,93,787250,91.18021774380357,9
0.05,8634,89,787339,91.17996525767227,13
0.05,8635,93,787432,91.18017600741084,8
0.05,8636,94,787526,91.18050248929026,7
0.05,8637,88,787614,91.18013429034498,13
0.05,8638,93,787707,91.18034494733186,8
0.05,8639,92,787799,91.18043981481482,10
0.05,8640,96,787895,91.18099756972573,6
0.05,8641,94,787989,91.18132376764638,7
0.05,8642,89,788078,91.1810713872498,12
0.05,8643,94,788172,91.18139750115687,7
0.05,8644,96,788268,91.18195488721804,6
0.05,8645,89,788357,91.18170252139718,12
0.05,8646,89,788446,91.18145021394703,12
0.05,8647,93,788539,91.18166049953747,8
0.05,8648,92,788631,91.1817551161984,9
0.05,8649,93,788724,91.18196531791908,8
0.05,8650,94,788818,91.1822910646168,8
0.05,8651,93,788911,91.18250115580213,8
0.05,8652,27,788938,91.17508378597019,6
0.05,8653,94,789032,91.17541021492951,7
0.05,8654,96,789128,91.17596764875795,6
0.05,8655,92,789220,91.17606284658041,9
0.05,8656,93,789313,91.17627353586693,8
0.05,8657,93,789406,91.17648417648418,8
0.05,8658,94,789500,91.17681025522577,7
0.05,8659,91,789591,91.17678983833719,11
0.05,8660,94,789685,91.17711580648886,7
0.05,8661,94,789779,91.17744169937659,7
0.05,8662,94,789873,91.17776751702644,7
0.05,8663,90,789963,91.17763157894737,11
0.05,8664,94,790057,91.17795729948067,7
0.05,8665,95,790152,91.17839833833372,6
0.05,8666,95,790247,91.17883927541249,6
0.05,8667,25,790272,91.17120443008768,9
0.05,8668,94,790366,91.17153074172339,7
0.05,8669,93,790459,91.1717416378316,8
0.05,8670,93,790552,91.17195248529582,8
0.05,8671,92,790644,91.17204797047971,9
0.05,8672,96,790740,91.17260463507436,6
0.05,8673,96,790836,91.17316117131658,6
0.05,8674,91,790927,91.17314121037464,11
0.05,8675,96,791023,91.17369755647763,6
0.05,8676,93,791116,91.17390803273021,8
0.05,8677,93,791209,91.17411846047476,8
0.05,8678,94,791303,91.17444406037562,7
0.05,8679,94,791397,91.17476958525346,7
0.05,8680,88,791485,91.17440387052183,13
0.05,8681,92,791577,91.1744989633725,9
0.05,8682,96,791673,91.17505470459518,6
0.05,8683,94,791767,91.17538000921235,7
0.05,8684,93,791860,91.17559009786989,8
0.05,8685,96,791956,91.1761455215289,6
0.05,8686,94,792050,91.17647058823529,7
0.05,8687,93,792143,91.17668047882137,8
0.05,8688,94,792237,91.17700540913799,8
0.05,8689,95,792332,91.17744533947065,6
0.05,8690,93,792425,91.17765504544931,8
0.05,8691,94,792519,91.17797975149563,7
0.05,8692,92,792611,91.17807431266536,9
0.05,8693,96,792707,91.17862893949851,6
0.05,8694,94,792801,91.17895342150662,7
0.05,8695,93,792894,91.17916283348666,8
0.05,8696,95,792989,91.17960216166495,6
0.05,8697,93,793082,91.17981145090826,8
0.05,8698,94,793176,91.1801356477756,7
0.05,8699,92,793268,91.18022988505747,9
0.05,8700,94,793362,91.18055395931502,7
0.05,8701,94,793456,91.18087795908987,7
0.05,8702,95,793551,91.18131678731471,6
0.05,8703,92,793643,91.18141084558823,9
0.05,8704,90,793733,91.18127512923607,11
0.05,8705,94,793827,91.1815988973122,7
0.05,8706,94,793921,91.18192259101872,7
0.05,8707,93,794014,91.1821313734497,8
0.05,8708,93,794107,91.18234010793432,10
0.05,8709,91,794198,91.18231917336395,11
0.05,8710,94,794292,91.18264263574791,7
0.05,8711,93,794385,91.18285123966942,8
0.05,8712,92,794477,91.18294502467577,10
0.05,8713,93,794570,91.1831535460179,8
0.05,8714,96,794666,91.18370625358577,6
0.05,8715,94,794760,91.18402937127122,7
0.05,8716,27,794787,91.17666628427212,6
0.05,8717,95,794882,91.17710484055976,6
0.05,8718,27,794909,91.1697442367244,7
0.05,8719,93,795002,91.16995412844037,8
0.05,8720,93,795095,91.17016397202156,8
0.05,8721,93,795188,91.17037376748452,8
0.05,8722,94,795282,91.17069815430472,7
0.05,8723,94,795376,91.17102246675837,7
0.05,8724,95,795471,91.17146131805157,6
0.05,8725,91,795562,91.17144166857666,10
0.05,8726,91,795653,91.1714220236049,10
0.05,8727,94,795747,91.17174610449129,7
0.05,8728,92,795839,91.1718409898041,9
0.05,8729,94,795933,91.17216494845361,7
0.05,8730,89,796022,91.17191616080632,12
0.05,8731,96,796118,91.17246907924874,6
0.05,8732,93,796211,91.17267834650177,8
0.05,8733,94,796305,91.17300206091139,7
0.05,8734,94,796399,91.17332570120206,7
0.05,8735,94,796493,91.17364926739927,7
0.05,8736,88,796581,91.17328602495135,13
0.05,8737,96,796677,91.17383840695811,6
0.05,8738,93,796770,91.1740473738414,8
0.05,8739,92,796862,91.17414187643021,9
0.05,8740,96,796958,91.17469397094153,6
0.05,8741,94,797052,91.17501715854496,7
0.05,8742,92,797144,91.17511151778565,9
0.05,8743,96,797240,91.17566331198536,6
0.05,8744,94,797334,91.17598627787306,7
0.05,8745,96,797430,91.1765378458724,6
0.05,8746,94,797524,91.176860637933,7
0.05,8747,95,797619,91.1772976680384,6
0.05,8748,94,797713,91.1776202994628,7
0.05,8749,94,797807,91.17794285714285,7
0.05,8750,86,797893,91.17735115986744,17
0.05,8751,89,797982,91.17710237659963,12
0.05,8752,95,798077,91.17753912944133,6
0.05,8753,91,798168,91.17751884852639,10
0.05,8754,93,798261,91.17772701313535,8
0.05,8755,94,798355,91.17804933759707,7
0.05,8756,96,798451,91.17859997716113,6
0.05,8757,96,798547,91.17915049097968,6
0.05,8758,96,798643,91.17970087909579,6
0.05,8759,93,798736,91.17990867579908,8
0.05,8760,96,798832,91.18045885172926,6
0.05,8761,94,798926,91.18078064368865,7
0.05,8762,91,799017,91.18076001369394,10
0.05,8763,94,799111,91.18108169785486,7
0.05,8764,96,799207,91.1816314888762,6
0.05,8765,95,799302,91.18206707734429,7
0.05,8766,96,799398,91.18261663054636,6
0.05,8767,90,799488,91.18248175182482,11
0.05,8768,90,799578,91.18234690386589,11
0.05,8769,92,799670,91.18244013683011,9
0.05,8770,94,799764,91.18276137270551,7
0.05,8771,95,799859,91.18319653442772,8
0.05,8772,89,799948,91.182947680383,12
0.05,8773,84,800032,91.18212901755186,17
0.05,8774,94,800126,91.18245014245014,7
0.05,8775,94,800220,91.18277119416591,7
0.05,8776,94,800314,91.18309217272416,7
0.05,8777,94,800408,91.18341307814993,7
0.05,8778,93,800501,91.18362000227816,8
0.05,8779,94,800595,91.18394077448747,7
0.05,8780,94,800689,91.18426147363625,7
0.05,8781,95,800784,91.18469596902756,6
0.05,8782,93,800877,91.1849026528521,8
0.05,8783,94,800971,91.18522313296903,7
0.05,8784,93,801064,91.1854297097325,8
0.05,8785,96,801160,91.18597769178238,6
0.05,8786,91,801251,91.18595652668715,10
0.05,8787,96,801347,91.18650432407829,6
0.05,8788,94,801441,91.18682443964046,7
0.05,8789,95,801536,91.1872582480091,6
0.05,8790,89,801625,91.18700944147423,12
0.05,8791,93,801718,91.18721565059144,8
0.05,8792,94,801812,91.1875355396338,7
0.05,8793,27,801839,91.18023652490335,6
0.05,8794,93,801932,91.18044343376918,8
0.05,8795,94,802026,91.18076398362892,7
0.05,8796,95,802121,91.1811981357281,6
0.05,8797,96,802217,91.18174585132985,6
0.05,8798,93,802310,91.18195249460166,8
0.05,8799,88,802398,91.18159090909091,13
0.05,8800,94,802492,91.18191114646064,7
0.05,8801,92,802584,91.18200408997956,9
0.05,8802,95,802679,91.18243780529365,6
0.05,8803,92,802771,91.18253066787824,9
0.05,8804,94,802865,91.18285065303805,7
0.05,8805,95,802960,91.1832841244606,6
0.05,8806,94,803054,91.18360395140229,7
0.05,8807,93,803147,91.18381017257039,8
0.05,8808,91,803238,91.18378930639119,10
0.05,8809,95,803333,91.18422247446084,6
0.05,8810,94,803427,91.18454204971059,7
0.05,8811,91,803518,91.18452110758057,10
0.05,8812,95,803613,91.18495404516055,6
0.05,8813,91,803704,91.18493306103926,10
0.05,8814,94,803798,91.18525241066364,7
0.05,8815,94,803892,91.1855716878403,8
0.05,8816,89,803981,91.18532380628332,12
0.05,8817,94,804075,91.18564300294851,7
0.05,8818,89,804164,91.18539516952035,12
0.05,8819,92,804256,91.18548752834467,9
0.05,8820,93,804349,91.18569323205986,8
0.05,8821,94,804443,91.18601224212196,7
0.05,8822,91,804534,91.18599115946957,10
0.05,8823,95,804629,91.1864233907525,6
0.05,8824,88,804717,91.18606232294617,14
0.05,8825,92,804809,91.18615454339452,9
0.05,8826,96,804905,91.1866998980401,6
0.05,8827,94,804999,91.1870185772542,7
0.05,8828,96,805095,91.18756371049949,6
0.05,8829,93,805188,91.18776896942242,8
0.05,8830,94,805282,91.18808741931831,8
0.05,8831,93,805375,91.18829257246377,10
0.05,8832,92,805467,91.1883844673384,9
0.05,8833,95,805562,91.18881593841974,7
0.05,8834,94,805656,91.18913412563667,7
0.05,8835,96,805752,91.18967858759619,6
0.05,8836,95,805847,91.19010976575761,6
0.05,8837,93,805940,91.19031455080335,9
0.05,8838,94,806034,91.1906324244824,7
0.05,8839,94,806128,91.19095022624434,7
0.05,8840,95,806223,91.19138106549033,6
0.05,8841,96,806319,91.1919249038679,6
0.05,8842,94,806413,91.19224245165668,8
0.05,8843,92,806505,91.19233378561736,9
0.05,8844,94,806599,91.19265121537592,7
0.05,8845,94,806693,91.1929685733665,8
0.05,8846,94,806787,91.19328585961343,7
0.05,8847,94,806881,91.19360307414105,7
0.05,8848,96,806977,91.19414623121257,6
0.05,8849,92,807069,91.1942372881356,9
0.05,8850,94,807163,91.19455428765112,7
0.05,8851,26,807189,91.18718933574334,6
0.05,8852,94,807283,91.18750705975376,7
0.05,8853,94,807377,91.18782471199458,7
0.05,8854,94,807471,91.18814229249011,7
0.05,8855,94,807565,91.18845980126468,7
0.05,8856,90,807655,91.18832561815513,11
0.05,8857,90,807745,91.18819146534206,11
0.05,8858,92,807837,91.18828310193024,9
0.05,8859,95,807932,91.18871331828443,6
0.05,8860,94,808026,91.18903058345559,8
0.05,8861,96,808122,91.18957345971565,6
0.05,8862,94,808216,91.18989055624506,7
0.05,8863,95,808311,91.19032039711192,6
0.05,8864,94,808405,91.19063733784546,7
0.05,8865,94,808499,91.19095420708324,8
0.05,8866,94,808593,91.19127100484944,8
0.05,8867,94,808687,91.19158773116824,7
0.05,8868,95,808782,91.19201713834705,6
0.05,8869,96,808878,91.19255918827508,6
0.05,8870,94,808972,91.19287566227032,7
0.05,8871,96,809068,91.19341749323715,6
0.05,8872,93,809161,91.19362109771217,8
0.05,8873,96,809257,91.19416272256029,6
0.05,8874,95,809352,91.19459154929578,6
0.05,8875,96,809448,91.19513294276702,6
0.05,8876,95,809543,91.1955615635913,7
0.05,8877,92,809635,91.19565217391305,9
0.05,8878,95,809730,91.19608063971168,6
0.05,8879,93,809823,91.19628378378378,8
0.05,8880,94,809917,91.19659948204031,7
0.05,8881,94,810011,91.19691510920964,7
0.05,8882,96,810107,91.1974558144771,6
0.05,8883,95,810202,91.19788383610987,6
0.05,8884,91,810293,91.19786156443443,10
0.05,8885,93,810386,91.19806437092055,9
0.05,8886,94,810480,91.19837965567683,7
0.05,8887,94,810574,91.19869486948694,7
0.05,8888,96,810670,91.19923500956239,6
0.05,8889,92,810762,91.19932508436446,10
0.05,8890,93,810855,91.1995276121921,8
0.05,8891,93,810948,91.19973009446694,9
0.05,8892,94,811042,91.20004497919712,7
0.05,8893,94,811136,91.20035979311896,7
0.05,8894,95,811231,91.20078695896571,6
0.05,8895,92,811323,91.20087679856115,9
0.05,8896,91,811414,91.20085422052377,10
0.05,8897,88,811502,91.20049449314453,13
0.05,8898,94,811596,91.20080907967187,7
0.05,8899,94,811690,91.20112359550562,7
0.05,8900,94,811784,91.20143804066959,7
0.05,8901,95,811879,91.20186474949449,6
0.05,8902,94,811973,91.20217904077278,7
0.05,8903,96,812069,91.20271787960468,6
0.05,8904,89,812158,91.20247052217856,12
0.05,8905,95,812253,91.20289692342241,6
0.05,8906,94,812347,91.20321095767373,7
0.05,8907,93,812440,91.20341266277504,8
0.05,8908,95,812535,91.20383881468179,6
0.05,8909,95,812630,91.20426487093154,6
0.05,8910,93,812723,91.20446638985524,8
0.05,8911,91,812814,91.2044434470377,10
0.05,8912,94,812908,91.20475709637608,8
0.05,8913,95,813003,91.20518285842495,6
0.05,8914,94,813097,91.20549635445877,7
0.05,8915,94,813191,91.20580978017048,7
0.05,8916,92,813283,91.20589884490299,9
0.05,8917,95,813378,91.20632428795695,6
0.05,8918,93,813471,91.20652539522368,8
0.05,8919,92,813563,91.20661434977579,9
0.05,8920,95,813658,91.20703956955498,6
0.05,8921,94,813752,91.20735261152208,7
0.05,8922,94,813846,91.207665583324,7
0.05,8923,96,813942,91.20820259973107,6
0.05,8924,91,814033,91.20817927170869,10
0.05,8925,90,814123,91.208043916648,11
0.05,8926,93,814216,91.20824465105859,8
0.05,8927,91,814307,91.20822132616487,10
0.05,8928,93,814400,91.2084219957442,8
0.05,8929,95,814495,91.20884658454648,8
0.05,8930,90,814585,91.20871123054529,11
0.05,8931,93,814678,91.20891177787729,10
0.05,8932,94,814772,91.2092242247845,7
0.05,8933,26,814798,91.20192522946049,7
0.05,8934,94,814892,91.20223838836039,7
0.05,8935,95,814987,91.20266338406446,6
0.05,8936,95,815082,91.20308828465929,6
0.05,8937,92,815174,91.20317744461849,9
0.05,8938,96,815270,91.20371406197562,6
0.05,8939,94,815364,91.20402684563759,7
0.05,8940,94,815458,91.2043395593334,7
0.05,8941,92,815550,91.20442853947662,9
0.05,8942,90,815640,91.20429386112043,11
0.05,8943,94,815734,91.20460644007156,7
0.05,8944,94,815828,91.2049189491336,7
0.05,8945,94,815922,91.20523138832998,7
0.05,8946,94,816016,91.20554375768414,7
0.05,8947,93,816109,91.20574430040233,8
0.05,8948,96,816205,91.20628003128841,6
0.05,8949,96,816301,91.2068156424581,6
0.05,8950,93,816394,91.20701597586861,8
0.05,8951,95,816489,91.20743967828419,6
0.05,8952,92,816581,91.20752820283704,9
0.05,8953,92,816673,91.20761670761671,9
0.05,8954,89,816762,91.2073701842546,12
0.05,8955,95,816857,91.20779365788299,6
0.05,8956,93,816950,91.20799374790667,8
0.05,8957,94,817044,91.20830542531814,7
0.05,8958,94,817138,91.20861703315101,8
0.05,8959,96,817234,91.20915178571428,6
0.05,8960,92,817326,91.2092400401741,9
0.05,8961,96,817422,91.20977460388306,6
0.05,8962,94,817516,91.21008590873592,7
0.05,8963,96,817612,91.21062025881302,6
0.05,8964,95,817707,91.21104294478528,6
0.05,8965,94,817801,91.21135400401516,7
0.05,8966,27,817828,91.20419315267091,6
0.05,8967,93,817921,91.20439339875111,8
0.05,8968,95,818016,91.20481659047832,6
0.05,8969,94,818110,91.2051282051282,7
0.05,8970,96,818206,91.20566269089288,6
0.05,8971,95,818301,91.20608559964333,6
0.05,8972,96,818397,91.20661985957874,6
0.05,8973,92,818489,91.20670826833073,9
0.05,8974,93,818582,91.20690807799443,9
0.05,8975,93,818675,91.20710784313725,8
0.05,8976,95,818770,91.20753035535257,6
0.05,8977,95,818865,91.2079527734462,6
0.05,8978,90,818955,91.20781824256599,11
0.05,8979,96,819051,91.20835189309577,6
0.05,8980,94,819145,91.20866273243514,7
0.05,8981,96,819241,91.20919617011802,6
0.05,8982,94,819335,91.20950684626517,7
0.05,8983,95,819430,91.20992876224399,6
0.05,8984,94,819524,91.21023928770173,8
0.05,8985,93,819617,91.21043845982639,8
0.05,8986,95,819712,91.21086013130076,6
0.05,8987,94,819806,91.21117044948821,7
0.05,8988,94,819900,91.21148069863166,7
0.05,8989,92,819992,91.21156840934371,9
0.05,8990,95,820087,91.21198976754532,8
0.05,8991,94,820181,91.21229982206405,7
0.05,8992,96,820277,91.21283220282442,6
0.05,8993,95,820372,91.21325327996442,6
0.05,8994,92,820464,91.21334074485826,9
0.05,8995,95,820559,91.21376167185416,6
0.05,8996,95,820654,91.21418250527954,6
0.05,8997,92,820746,91.21426983774172,9
0.05,8998,94,820840,91.21457939771085,7
0.05,8999,94,820934,91.2148888888889,7
0.05,9000,94,821028,91.21519831129875,7
0.05,9001,94,821122,91.21550766496334,8
0.05,9002,94,821216,91.21581694990559,7
0.05,9003,92,821308,91.21590404264771,10
0.05,9004,96,821404,91.2164353137146,6
0.05,9005,93,821497,91.21663335554075,8
0.05,9006,94,821591,91.21694237815032,7
0.05,9007,95,821686,91.2173623445826,6
0.05,9008,90,821776,91.21722721722722,12
0.05,9009,93,821869,91.21742508324084,8
0.05,9010,93,821962,91.21762290533792,8
0.05,9011,96,822058,91.21815357301377,6
0.05,9012,95,822153,91.21857317208476,7
0.05,9013,93,822246,91.21877080097626,8
0.05,9014,94,822340,91.21907931225735,8
0.05,9015,27,822367,91.21195652173913,6
0.05,9016,95,822462,91.21237662193634,6
0.05,9017,94,822556,91.21268573963185,7
0.05,9018,94,822650,91.21299478877924,7
0.05,9019,26,822676,91.20576496674057,6
0.05,9020,92,822768,91.20585300964416,9
0.05,9021,95,822863,91.2062735535358,7
0.05,9022,89,822952,91.20602903690569,13
0.05,9023,92,823044,91.2061170212766,9
0.05,9024,92,823136,91.20620498614959,11
0.05,9025,94,823230,91.2065145136273,8
0.05,9026,92,823322,91.2066024149773,9
0.05,9027,23,823345,91.1990474080638,9
0.05,9028,94,823439,91.19935762542917,7
0.05,9029,24,823463,91.19191583610188,9
0.05,9030,93,823556,91.1921160447348,8
0.05,9031,95,823651,91.19253764393268,6
0.05,9032,95,823746,91.19295914978413,6
0.05,9033,95,823841,91.19338056232013,6
0.05,9034,95,823936,91.19380188157166,6
0.05,9035,92,824028,91.19389110225764,9
0.05,9036,95,824123,91.19431227177161,7
0.05,9037,95,824218,91.19473334808586,6
0.05,9038,89,824307,91.19449054098905,12
0.05,9039,95,824402,91.19491150442478,7
0.05,9040,91,824493,91.19488994580246,10
0.05,9041,94,824587,91.195200176952,7
0.05,9042,95,824682,91.19562092226032,6
0.05,9043,94,824776,91.19593100398053,7
0.05,9044,94,824870,91.19624101713654,7
0.05,9045,94,824964,91.19655096175104,8
0.05,9046,95,825059,91.19697137172544,6
0.05,9047,90,825149,91.19683908045977,11
0.05,9048,95,825244,91.19725936567576,6
0.05,9049,94,825338,91.19756906077347,7
0.05,9050,90,825428,91.19743674732074,11
0.05,9051,94,825522,91.19774635439681,7
0.05,9052,92,825614,91.19783497183253,9
0.05,9053,94,825708,91.19814446653413,7
0.05,9054,96,825804,91.19867476532302,6
0.05,9055,96,825900,91.19920494699646,6
0.05,9056,95,825995,91.1996245997571,6
0.05,9057,92,826087,91.19971296091852,9
0.05,9058,95,826182,91.20013246495198,6
0.05,9059,94,826276,91.20044150110375,7
0.05,9060,93,826369,91.20064010594857,10
0.05,9061,94,826463,91.20094901787685,7
0.05,9062,89,826552,91.20070616793556,12
0.05,9063,92,826644,91.20079435127978,9
0.05,9064,93,826737,91.20099282956426,8
0.05,9065,94,826831,91.20130156629163,7
0.05,9066,87,826918,91.20083820447778,14
0.05,9067,96,827014,91.20136744596383,6
0.05,9068,96,827110,91.20189657073547,6
0.05,9069,27,827137,91.19481808158766,6
0.05,9070,91,827228,91.19479660456399,10
0.05,9071,96,827324,91.1953262786596,6
0.05,9072,96,827420,91.19585583599691,6
0.05,9073,96,827516,91.1963852766145,6
0.05,9074,94,827610,91.19669421487603,8
0.05,9075,96,827706,91.19722344645218,6
0.05,9076,96,827802,91.19775256141897,6
0.05,9077,94,827896,91.1980612469707,7
0.05,9078,95,827991,91.19848000881154,6
0.05,9079,93,828084,91.19867841409692,8
0.05,9080,94,828178,91.19898689571633,7
0.05,9081,94,828272,91.19929530940321,7
0.05,9082,93,828365,91.19949355939667,8
0.05,9083,94,828459,91.19980184940555,7
0.05,9084,96,828555,91.20033021463952,6
0.05,9085,92,828647,91.20041822584196,9
0.05,9086,94,828741,91.2007263123143,7
0.05,9087,92,828833,91.20081426056338,9
0.05,9088,94,828927,91.20112223566949,9
0.05,9089,26,828953,91.1939493949395,7
0.05,9090,96,829049,91.19447805521945,6
0.05,9091,92,829141,91.19456665200175,9
0.05,9092,94,829235,91.1948751787089,7
0.05,9093,92,829327,91.19496371233781,9
0.05,9094,94,829421,91.19527212754261,7
0.05,9095,95,829516,91.19569041336851,6
0.05,9096,94,829610,91.1959986808838,7
0.05,9097,94,829704,91.1963068806331,7
0.05,9098,94,829798,91.19661501263874,7
0.05,9099,94,829892,91.19692307692307,8
0.05,9100,95,829987,91.19734095154378,7
0.05,9101,95,830082,91.1977587343441,7
0.05,9102,91,830173,91.197737009777,11
0.05,9103,92,830265,91.19782513181019,9
0.05,9104,93,830358,91.1980230642504,8
0.05,9105,92,830450,91.19811113551505,9
0.05,9106,27,830477,91.19106182057757,6
0.05,9107,96,830573,91.19158981115503,6
0.05,9108,94,830667,91.19189812273575,7
0.05,9109,94,830761,91.19220636663007,7
0.05,9110,91,830852,91.19218527055207,10
0.05,9111,94,830946,91.19249341527656,7
0.05,9112,94,831040,91.19280149237353,7
0.05,9113,92,831132,91.1928900592495,9
0.05,9114,91,831223,91.19286889742183,10
0.05,9115,96,831319,91.19339622641509,6
0.05,9116,95,831414,91.19381375452451,6
0.05,9117,94,831508,91.19412151787672,7
0.05,9118,92,831600,91.19420989143546,9
0.05,9119,93,831693,91.19440789473684,8
0.05,9120,94,831787,91.1947154917224,7
0.05,9121,94,831881,91.19502302126726,7
0.05,9122,95,831976,91.19544009645949,6
0.05,9123,92,832068,91.19552827707146,9
0.05,9124,94,832162,91.19583561643836,8
0.05,9125,95,832257,91.19625246548324,6
0.05,9126,94,832351,91.19655965815711,7
0.05,9127,94,832445,91.19686678352322,7
0.05,9128,94,832539,91.19717384160369,7
0.05,9129,91,832630,91.19715224534502,10
0.05,9130,92,832722,91.19724017084657,9
0.05,9131,94,832816,91.19754708716601,7
0.05,9132,93,832909,91.19774444322786,8
0.05,9133,93,833002,91.1979417560762,8
0.05,9134,95,833097,91.19835796387521,8
0.05,9135,94,833191,91.19866462346761,7
0.05,9136,96,833287,91.19919010616177,6
0.05,9137,96,833383,91.19971547384549,6
0.05,9138,91,833474,91.19969362074625,10
0.05,9139,94,833568,91.2,7
0.05,9140,92,833660,91.20008751777705,10
0.05,9141,95,833755,91.20050317217239,6
0.05,9142,95,833850,91.20091873564476,6
0.05,9143,94,833944,91.20122484689414,7
0.05,9144,94,834038,91.20153089119738,7
0.05,9145,94,834132,91.20183686857642,7
0.05,9146,96,834228,91.20236142997705,6
0.05,9147,90,834318,91.20222999562746,11
0.05,9148,96,834414,91.20275439938791,6
0.05,9149,92,834506,91.20284153005464,9
0.05,9150,96,834602,91.20336575237678,6
0.05,9151,90,834692,91.20323426573427,11
0.05,9152,95,834787,91.20364907680542,6
0.05,9153,94,834881,91.20395455538562,7
0.05,9154,95,834976,91.20436919716002,6
0.05,9155,95,835071,91.20478374836173,8
0.05,9156,93,835164,91.2049797968767,8
0.05,9157,94,835258,91.20528499672417,7
0.05,9158,88,835346,91.20493503657605,13
0.05,9159,95,835441,91.20534934497816,8
0.05,9160,93,835534,91.20554524615217,8
0.05,9161,95,835629,91.20595939751146,6
0.05,9162,95,835724,91.2063734584743,8
0.05,9163,91,835815,91.20635093845482,11
0.05,9164,96,835911,91.20687397708674,6
0.05,9165,95,836006,91.20728780274929,6
0.05,9166,94,836100,91.20759245118359,7
0.05,9167,92,836192,91.20767888307155,9
0.05,9168,93,836285,91.207874359254,8
0.05,9169,92,836377,91.20796074154853,9
0.05,9170,96,836473,91.20848326245775,6
0.05,9171,93,836566,91.20867858700393,8
0.05,9172,88,836654,91.20832879101711,13
0.05,9173,95,836749,91.20874209723131,6
0.05,9174,94,836843,91.20904632152589,7
0.05,9175,26,836869,91.20193984306887,8
0.05,9176,94,836963,91.2022447422905,7
0.05,9177,94,837057,91.20254957507082,8
0.05,9178,93,837150,91.20274539710208,8
0.05,9179,94,837244,91.20305010893246,7
0.05,9180,96,837340,91.20357259557782,6
0.05,9181,93,837433,91.20376824221303,8
0.05,9182,93,837526,91.20396384623761,8
0.05,9183,94,837620,91.20426829268293,7
0.05,9184,95,837715,91.20468154599891,7
0.05,9185,94,837809,91.20498584802961,8
0.05,9186,96,837905,91.20550778273648,6
0.05,9187,93,837998,91.20570309098825,8
0.05,9188,94,838092,91.20600718250081,7
0.05,9189,89,838181,91.20576713819369,12
0.05,9190,94,838275,91.20607115656621,7
0.05,9191,91,838366,91.20604873803308,10
0.05,9192,91,838457,91.20602632437725,10
0.05,9193,91,838548,91.20600391559712,10
0.05,9194,91,838639,91.20598151169114,10
0.05,9195,95,838734,91.20639408438451,6
0.05,9196,95,838829,91.20680656735892,6
0.05,9197,94,838923,91.20711024135682,7
0.05,9198,93,839016,91.20730514186324,8
0.05,9199,96,839112,91.20782608695652,6
0.05,9200,92,839204,91.20791218345832,9
0.05,9201,96,839300,91.20843294935884,6
0.05,9202,92,839392,91.2085189612083,9
0.05,9203,94,839486,91.20882225119513,7
0.05,9204,93,839579,91.20901683867463,8
0.05,9205,95,839674,91.2094286334999,6
0.05,9206,94,839768,91.20973172586076,7
0.05,9207,93,839861,91.2099261511729,8
0.05,9208,92,839953,91.21001194483657,9
0.05,9209,25,839978,91.2028230184582,7
0.05,9210,93,840071,91.20301813049615,8
0.05,9211,96,840167,91.20353886235345,6
0.05,9212,96,840263,91.20405948116792,6
0.05,9213,92,840355,91.20414586498806,9
0.05,9214,93,840448,91.20434074877916,8
0.05,9215,94,840542,91.20464409722223,7
0.05,9216,92,840634,91.20473038949767,9
0.05,9217,96,840730,91.20525059665871,6
0.05,9218,93,840823,91.20544527606032,8
0.05,9219,90,840913,91.20531453362256,11
0.05,9220,20,840933,91.19759245201172,14
0.05,9221,95,841028,91.19800477119931,6
0.05,9222,89,841117,91.19776645343164,12
0.05,9223,91,841208,91.19774501300954,11
0.05,9224,88,841296,91.19739837398375,13
0.05,9225,92,841388,91.19748536743984,11
0.05,9226,94,841482,91.1977890972147,7
0.05,9227,96,841578,91.19830949284786,6
0.05,9228,90,841668,91.19817965109979,11
0.05,9229,93,841761,91.19837486457205,8
0.05,9230,94,841855,91.19867836637417,8
0.05,9231,94,841949,91.19898180242635,7
0.05,9232,92,842041,91.19906855843172,9
0.05,9233,95,842136,91.19948018193632,6
0.05,9234,94,842230,91.19978343259339,7
0.05,9235,96,842326,91.2003031615418,6
0.05,9236,92,842418,91.20038973692758,9
0.05,9237,90,842508,91.20025979649274,11
0.05,9238,95,842603,91.20067106829744,6
0.05,9239,91,842694,91.20064935064936,10
0.05,9240,94,842788,91.200952277892,7
0.05,9241,93,842881,91.20114693789223,8
0.05,9242,94,842975,91.20144974575355,7
0.05,9243,26,843001,91.19439636520987,7
0.05,9244,93,843094,91.19459167117361,8
0.05,9245,94,843188,91.19489508976855,7
0.05,9246,89,843277,91.19465772683033,12
0.05,9247,89,843366,91.19442041522491,12
0.05,9248,94,843460,91.19472375391935,7
0.05,9249,94,843554,91.19502702702702,8
0.05,9250,94,843648,91.19533023456924,7
0.05,9251,94,843742,91.19563337656723,7
0.05,9252,95,843837,91.19604452609964,8
0.05,9253,92,843929,91.1961314026367,9
0.05,9254,91,844020,91.19611021069692,10
0.05,9255,94,844114,91.19641313742437,9
0.05,9256,93,844207,91.19660797234525,8
0.05,9257,93,844300,91.19680276517606,8
0.05,9258,96,844396,91.1973215250027,6
0.05,9259,95,844491,91.19773218142548,6
0.05,9260,95,844586,91.19814274916315,6
0.05,9261,95,844681,91.19855322824444,6
0.05,9262,92,844773,91.19863974954119,9
0.05,9263,94,844867,91.19894214162349,7
0.05,9264,93,844960,91.19913653534809,9
0.05,9265,90,845050,91.19900712281459,11
0.05,9266,94,845144,91.19930937736052,7
0.05,9267,94,845238,91.19961156668106,7
0.05,9268,93,845331,91.19980580429389,9
0.05,9269,93,845424,91.2,8
0.05,9270,94,845518,91.20030201704239,7
0.05,9271,92,845610,91.20038826574633,10
0.05,9272,94,845704,91.20069017577914,7
0.05,9273,95,845799,91.20109984904033,6
0.05,9274,93,845892,91.20129380053908,8
0.05,9275,95,845987,91.20170332039672,7
0.05,9276,94,846081,91.20200495849951,7
0.05,9277,94,846175,91.20230653158008,7
0.05,9278,94,846269,91.20260803965945,7
0.05,9279,94,846363,91.20290948275863,8
0.05,9280,92,846455,91.20299536687857,9
0.05,9281,94,846549,91.2032967032967,7
0.05,9282,93,846642,91.20349025099644,8
0.05,9283,95,846737,91.20389918138733,6
0.05,9284,94,846831,91.20420032310177,7
0.05,9285,93,846924,91.20439371096273,8
0.05,9286,93,847017,91.2045870571767,8
0.05,9287,95,847112,91.20499569336779,6
0.05,9288,92,847204,91.20508127893207,9
0.05,9289,94,847298,91.205382131324,7
0.05,9290,95,847393,91.20579054999462,6
0.05,9291,95,847488,91.20619888075764,7
0.05,9292,96,847584,91.20671473151835,6
0.05,9293,95,847679,91.2071228749731,6
0.05,9294,95,847774,91.20753093060786,6
0.05,9295,95,847869,91.20793889845095,6
0.05,9296,90,847959,91.20780897063568,11
0.05,9297,96,848055,91.20832437083244,6
0.05,9298,94,848149,91.20862458328853,7
0.05,9299,95,848244,91.20903225806451,7
0.05,9300,95,848339,91.20943984517794,6
0.05,9301,94,848433,91.20973984089443,7
0.05,9302,94,848527,91.21003977211652,7
0.05,9303,94,848621,91.21033963886501,7
0.05,9304,94,848715,91.21063944116067,7
0.05,9305,94,848809,91.21093917902428,7
0.05,9306,93,848902,91.21113140646825,8
0.05,9307,95,848997,91.21153846153847,6
0.05,9308,94,849091,91.21183800623054,7
0.05,9309,90,849181,91.21170784103116,11
0.05,9310,92,849273,91.2117925034905,9
0.05,9311,93,849366,91.21198453608247,8
0.05,9312,93,849459,91.21217652743476,8
0.05,9313,92,849551,91.21226111230406,9
0.05,9314,92,849643,91.21234567901234,9
0.05,9315,96,849739,91.2128595963933,6
0.05,9316,92,849831,91.21294408071267,9
0.05,9317,95,849926,91.21335050440008,6
0.05,9318,92,850018,91.21343491790965,9
0.05,9319,90,850108,91.21330472103004,11
0.05,9320,95,850203,91.21371097521725,6
0.05,9321,96,850299,91.21422441536151,6
0.05,9322,96,850395,91.21473774536094,6
0.05,9323,87,850482,91.21428571428571,14
0.05,9324,94,850576,91.21458445040214,7
0.05,9325,94,850670,91.21488312245336,7
0.05,9326,94,850764,91.21518173045996,7
0.05,9327,96,850860,91.21569468267582,6
0.05,9328,94,850954,91.215993139672,7
0.05,9329,90,851044,91.21586280814577,11
0.05,9330,93,851137,91.21605401350338,8
0.05,9331,96,851233,91.21656665237892,6
0.05,9332,94,851327,91.21686488803172,8
0.05,9333,96,851423,91.2173773301907,6
0.05,9334,92,851515,91.21746116764864,9
0.05,9335,93,851608,91.21765209940017,8
0.05,9336,93,851701,91.21784299025383,8
0.05,9337,94,851795,91.21814092953524,7
0.05,9338,94,851889,91.21843880501125,7
0.05,9339,95,851984,91.2188436830835,6
0.05,9340,89,852073,91.21860614495236,13
0.05,9341,94,852167,91.21890387497324,7
0.05,9342,93,852260,91.21909450925827,8
0.05,9343,94,852354,91.21939212328768,7
0.05,9344,95,852449,91.21979668271803,6
0.05,9345,95,852544,91.22020115557457,7
0.05,9346,94,852638,91.22049855568632,7
0.05,9347,91,852729,91.22047496790758,10
0.05,9348,96,852825,91.2209862017328,6
0.05,9349,92,852917,91.22106951871658,9
0.05,9350,94,853011,91.2213666987488,7
0.05,9351,92,853103,91.2214499572284,9
0.05,9352,94,853197,91.22174703303753,7
0.05,9353,93,853290,91.2219371391918,8
0.05,9354,92,853382,91.22202030999466,9
0.05,9355,93,853475,91.22221034630184,8
0.05,9356,95,853570,91.22261408571123,6
0.05,9357,25,853595,91.21553750801453,8
0.05,9358,94,853689,91.21583502510953,7
0.05,9359,94,853783,91.21613247863247,7
0.05,9360,94,853877,91.21642986860378,7
0.05,9361,95,853972,91.21683400982695,6
0.05,9362,93,854065,91.21702445797287,8
0.05,9363,93,854158,91.21721486544212,8
0.05,9364,93,854251,91.21740523224773,8
0.05,9365,95,854346,91.21780909673286,7
0.05,9366,96,854442,91.21831963275328,6
0.05,9367,93,854535,91.2185098206661,8
0.05,9368,92,854627,91.21859323300245,10
0.05,9369,94,854721,91.21889007470651,7
0.05,9370,93,854814,91.2190801408601,8
0.05,9371,92,854906,91.21916346564234,9
0.05,9372,93,854999,91.21935346207191,9
0.05,9373,95,855094,91.2197567740559,6
0.05,9374,92,855186,91.21984,9
0.05,9375,95,855281,91.22024317406144,6
0.05,9376,90,855371,91.22011304255092,11
0.05,9377,95,855466,91.22051610151418,6
0.05,9378,94,855560,91.22081245335323,7
0.05,9379,96,855656,91.22132196162048,6
0.05,9380,92,855748,91.22140496748747,9
0.05,9381,92,855840,91.22148795565977,9
0.05,9382,94,855934,91.22178407758713,7
0.05,9383,93,856027,91.22197357203751,8
0.05,9384,95,856122,91.22237613212573,7
0.05,9385,94,856216,91.22267206477733,7
0.05,9386,90,856306,91.22254181314584,11
0.05,9387,94,856400,91.2228376651044,7
0.05,9388,94,856494,91.22313345404197,7
0.05,9389,96,856590,91.22364217252397,6
0.05,9390,96,856686,91.22415078266425,6
0.05,9391,93,856779,91.2243398637138,8
0.05,9392,93,856872,91.22452890450336,8
0.05,9393,95,856967,91.22493080689802,6
0.05,9394,93,857060,91.22511974454497,8
0.05,9395,94,857154,91.22541507024266,7
0.05,9396,95,857249,91.22581675002661,6
0.05,9397,95,857344,91.22621834432859,6
0.05,9398,94,857438,91.2265134588786,7
0.05,9399,93,857531,91.22670212765958,8
0.05,9400,94,857625,91.2269971279651,8
0.05,9401,96,857721,91.2275047862157,6
0.05,9402,96,857817,91.22801233648835,6
0.05,9403,94,857911,91.22830710336027,8
0.05,9404,94,858005,91.22860180754918,7
0.05,9405,95,858100,91.22900276419307,6
0.05,9406,96,858196,91.22950993940682,6
0.05,9407,94,858290,91.2298044217687,9
0.05,9408,90,858380,91.22967371665426,11
0.05,9409,94,858474,91.22996811902232,8
0.05,9410,92,858566,91.23004994155775,9
0.05,9411,93,858659,91.23023799405014,8
0.05,9412,93,858752,91.23042600658664,8
0.05,9413,94,858846,91.23072020395156,7
0.05,9414,90,858936,91.23058948486458,12
0.05,9415,93,859029,91.23077740016993,8
0.05,9416,96,859125,91.23128384835935,6
0.05,9417,94,859219,91.23157782968784,7
0.05,9418,94,859313,91.23187174859326,7
0.05,9419,94,859407,91.23216560509555,7
0.05,9420,93,859500,91.23235325337014,8
0.05,9421,96,859596,91.23285926554871,6
0.05,9422,89,859685,91.23262230712088,12
0.05,9423,94,859779,91.23291595925298,7
0.05,9424,96,859875,91.23342175066313,6
0.05,9425,95,859970,91.23382134521536,9
0.05,9426,94,860064,91.23411477670521,7
0.05,9427,93,860157,91.23430207891387,8
0.05,9428,94,860251,91.23459539717892,7
0.05,9429,94,860345,91.23488865323436,7
0.05,9430,94,860439,91.2351818471,7
0.05,9431,96,860535,91.23568702290076,6
0.05,9432,94,860629,91.23598006996714,8
0.05,9433,93,860722,91.23616705533178,8
0.05,9434,92,860814,91.2362480127186,9
0.05,9435,94,860908,91.23654090716406,7
0.05,9436,95,861003,91.23693970541485,8
0.05,9437,94,861097,91.2372324645052,7
0.05,9438,94,861191,91.23752516156372,7
0.05,9439,92,861283,91.2376059322034,9
0.05,9440,94,861377,91.23789852769833,7
0.05,9441,94,861471,91.23819106121584,7
0.05,9442,96,861567,91.23869532987398,6
0.05,9443,94,861661,91.23898771706904,7
0.05,9444,94,861755,91.23928004235044,7
0.05,9445,94,861849,91.23957230573788,7
0.05,9446,94,861943,91.23986450725099,7
0.05,9447,91,862034,91.23983911939035,10
0.05,9448,94,862128,91.24013123081808,7
0.05,9449,95,862223,91.2405291005291,6
0.05,9450,94,862317,91.2408210771347,7
0.05,9451,95,862412,91.24121878967415,6
0.05,9452,94,862506,91.24151063154554,7
0.05,9453,94,862600,91.2418024116776,7
0.05,9454,96,862696,91.24230565838181,6
0.05,9455,94,862790,91.2425972927242,7
0.05,9456,94,862884,91.24288886539071,7
0.05,9457,92,862976,91.24296891520406,9
0.05,9458,94,863070,91.24326038693307,7
0.05,9459,93,863163,91.24344608879493,8
0.05,9460,96,863259,91.24394884261706,6
0.05,9461,94,863353,91.24424011836821,7
0.05,9462,91,863444,91.24421430835888,10
0.05,9463,93,863537,91.24439983093829,8
0.05,9464,96,863633,91.24490227152668,6
0.05,9465,94,863727,91.24519332347349,7
0.05,9466,96,863823,91.2456955740995,6
0.05,9467,96,863919,91.24619771863118,6
0.05,9468,94,864013,91.24648854155666,7
0.05,9469,96,864109,91.24699049630412,6
0.05,9470,94,864203,91.24728117411044,7
0.05,9471,94,864297,91.24757179054055,7
0.05,9472,94,864391,91.24786234561385,7
0.05,9473,94,864485,91.2481528393498,8
0.05,9474,92,864577,91.24823218997362,9
0.05,9475,-45,864532,91.233853946813,10
0.05,9476,94,864626,91.23414582673841,7
0.05,9477,93,864719,91.23433213758177,8
0.05,9478,90,864809,91.23420192003375,11
0.05,9479,96,864905,91.2347046413502,6
0.05,9480,92,864997,91.23478536019407,9
0.05,9481,94,865091,91.23507698797722,7
0.05,9482,92,865183,91.23515765053253,9
0.05,9483,94,865277,91.23544917756222,7
0.05,9484,96,865373,91.23595150237216,6
0.05,9485,91,865464,91.235926628716,10
0.05,9486,95,865559,91.23632338990197,6
0.05,9487,95,865654,91.23672006745363,7
0.05,9488,96,865750,91.23722204658026,6
0.05,9489,94,865844,91.23751317175974,7
0.05,9490,96,865940,91.23801496154252,6
0.05,9491,96,866036,91.23851664559629,6
0.05,9492,95,866131,91.23891288317708,6
0.05,9493,94,866225,91.2392037076048,7
0.05,9494,95,866320,91.23959978936283,6
0.05,9495,96,866416,91.24010109519797,6
0.05,9496,96,866512,91.24060229546173,6
0.05,9497,96,866608,91.2411033901874,6
0.05,9498,95,866703,91.24149910516897,6
0.05,9499,95,866798,91.2418947368421,7
0.05,9500,94,866892,91.2421850331544,7
0.05,9501,94,866986,91.24247526836456,7
0.05,9502,95,867081,91.24287067241923,8
0.05,9503,91,867172,91.24284511784512,10
0.05,9504,95,867267,91.24324039978958,6
0.05,9505,95,867362,91.24363559856933,7
0.05,9506,96,867458,91.24413589986325,6
0.05,9507,94,867552,91.2444257467396,7
0.05,9508,27,867579,91.23766957619098,6
0.05,9509,92,867671,91.23774973711882,9
0.05,9510,93,867764,91.2379350226054,9
0.05,9511,88,867852,91.23759461732548,13
0.05,9512,96,867948,91.23809523809524,6
0.05,9513,94,868042,91.23838553710321,7
0.05,9514,95,868137,91.23878087230689,6
0.05,9515,94,868231,91.23907103825137,7
0.05,9516,94,868325,91.2393611432174,8
0.05,9517,92,868417,91.23944105904602,9
0.05,9518,94,868511,91.23973106418741,8
0.05,9519,94,868605,91.24002100840336,7
0.05,9520,94,868699,91.24031089171305,7
0.05,9521,94,868793,91.24060071413568,7
0.05,9522,89,868882,91.24036543106163,12
0.05,9523,92,868974,91.24044519109617,9
0.05,9524,93,869067,91.24062992125984,8
0.05,9525,93,869160,91.2408146126391,9
0.05,9526,94,869254,91.24110423008293,7
0.05,9527,94,869348,91.24139378673384,8
0.05,9528,23,869371,91.23423234337287,10
0.05,9529,95,869466,91.23462749213012,6
0.05,9530,89,869555,91.23439303325989,12
0.05,9531,96,869651,91.23489299202686,6
0.05,9532,95,869746,91.23528794713101,6
0.05,9533,93,869839,91.23547304384309,8
0.05,9534,93,869932,91.23565810173046,8
0.05,9535,94,870026,91.23594798657719,7
0.05,9536,95,870121,91.23634266540842,6
0.05,9537,94,870215,91.23663241769763,7
0.05,9538,93,870308,91.23681727644407,8
0.05,9539,92,870400,91.23689727463312,9
0.05,9540,93,870493,91.2370820668693,8
0.05,9541,94,870587,91.23737162020541,7
0.05,9542,93,870680,91.23755632400713,8
0.05,9543,95,870775,91.23795054484494,6
0.05,9544,95,870870,91.23834468308014,8
0.05,9545,96,870966,91.23884349465744,6
0.05,9546,95,871061,91.23923745679271,6
0.05,9547,96,871157,91.23973607038123,6
0.05,9548,96,871253,91.24023457953713,6
0.05,9549,94,871347,91.24052356020943,7
0.05,9550,94,871441,91.24081248036855,7
0.05,9551,94,871535,91.2411013400335,7
0.05,9552,95,871630,91.24149481838165,6
0.05,9553,91,871721,91.24146954155327,10
0.05,9554,96,871817,91.24196755625327,6
0.05,9555,94,871911,91.24225617413144,7
0.05,9556,93,872004,91.24244009626452,8
0.05,9557,94,872098,91.24272860431053,7
0.05,9558,94,872192,91.24301705199288,7
0.05,9559,27,872219,91.23629707112971,6
0.05,9560,91,872310,91.23627235644807,10
0.05,9561,94,872404,91.2365613888308,8
0.05,9562,95,872499,91.23695493046115,6
0.05,9563,94,872593,91.23724383103304,8
0.05,9564,94,872687,91.23753267119707,7
0.05,9565,90,872777,91.2374033033661,11
0.05,9566,95,872872,91.23779659245322,6
0.05,9567,93,872965,91.23798076923077,8
0.05,9568,94,873059,91.23826941164177,7
0.05,9569,94,873153,91.23855799373041,8
0.05,9570,94,873247,91.23884651551562,8
0.05,9571,95,873342,91.23923944839115,6
0.05,9572,95,873437,91.23963229917476,6
0.05,9573,95,873532,91.2400250678922,7
0.05,9574,94,873626,91.2403133159269,7
0.05,9575,93,873719,91.24049707602339,8
0.05,9576,94,873813,91.24078521457659,7
0.05,9577,94,873907,91.24107329296304,7
0.05,9578,27,873934,91.23436684413822,6
0.05,9579,94,874028,91.23465553235908,7
0.05,9580,92,874120,91.23473541383989,9
0.05,9581,94,874214,91.23502400333959,7
0.05,9582,96,874310,91.23552123552123,6
0.05,9583,91,874401,91.23549666110183,10
0.05,9584,94,874495,91.2357850808555,7
0.05,9585,93,874588,91.23596912163572,8
0.05,9586,96,874684,91.23646604777302,6
0.05,9587,96,874780,91.23696287025449,6
0.05,9588,94,874874,91.23725101679007,7
0.05,9589,94,874968,91.23753910323254,7
0.05,9590,88,875056,91.23720154311333,13
0.05,9591,96,875152,91.23769808173478,6
0.05,9592,95,875247,91.23809027415824,6
0.05,9593,94,875341,91.2383781530123,7
0.05,9594,94,875435,91.23866597186034,7
0.05,9595,91,875526,91.23864110045852,11
0.05,9596,94,875620,91.23892883192664,7
0.05,9597,94,875714,91.23921650343821,7
0.05,9598,90,875804,91.23908740493802,11
0.05,9599,95,875899,91.23947916666667,8
0.05,9600,94,875993,91.23976669096969,7
0.05,9601,96,876089,91.24026244532389,6
0.05,9602,27,876116,91.23357284182026,6
0.05,9603,96,876212,91.23406913785922,6
0.05,9604,95,876307,91.23446121811557,6
0.05,9605,95,876402,91.23485321673954,6
0.05,9606,94,876496,91.23514104298948,7
0.05,9607,92,876588,91.23522064945878,9
0.05,9608,94,876682,91.2355083775627,8
0.05,9609,92,876774,91.23558792924038,9
0.05,9610,93,876867,91.23577151180939,8
0.05,9611,94,876961,91.23605909280066,7
0.05,9612,95,877056,91.23645063975866,6
0.05,9613,94,877150,91.236738090285,7
0.05,9614,94,877244,91.23702548101924,7
0.05,9615,95,877339,91.23741680532446,7
0.05,9616,94,877433,91.23770406571695,8
0.05,9617,94,877527,91.23799126637554,7
0.05,9618,94,877621,91.23827840731884,8
0.05,9619,95,877716,91.23866943866943,6
0.05,9620,91,877807,91.23864463153518,10
0.05,9621,90,877897,91.23851590106007,11
0.05,9622,94,877991,91.23880286812845,7
0.05,9623,94,878085,91.2390897755611,7
0.05,9624,94,878179,91.23937662337663,8
0.05,9625,95,878274,91.23976729690422,7
0.05,9626,26,878300,91.23299054741872,6
0.05,9627,27,878327,91.22631906938098,6
0.05,9628,93,878420,91.22650327136775,8
0.05,9629,95,878515,91.22689511941849,6
0.05,9630,88,878603,91.22656006645208,13
0.05,9631,94,878697,91.22684800664452,7
0.05,9632,92,878789,91.2269282674141,9
0.05,9633,94,878883,91.22721610961179,7
0.05,9634,93,878976,91.22740010378827,8
0.05,9635,96,879072,91.22789539227895,6
0.05,9636,96,879168,91.2283905779807,6
0.05,9637,94,879262,91.22867814899357,7
0.05,9638,94,879356,91.2289656603382,7
0.05,9639,94,879450,91.22925311203319,7
0.05,9640,92,879542,91.22933305673685,9
0.05,9641,96,879638,91.22982783654844,6
0.05,9642,25,879663,91.2229596598569,8
0.05,9643,93,879756,91.22314392368312,8
0.05,9644,89,879845,91.22291342664593,12
0.05,9645,92,879937,91.22299398714493,9
0.05,9646,93,880030,91.22317819011091,8
0.05,9647,91,880121,91.22315505804312,10
0.05,9648,96,880217,91.22365011918333,6
0.05,9649,96,880313,91.22414507772021,6
0.05,9650,96,880409,91.22463993368562,6
0.05,9651,94,880503,91.22492747617075,8
0.05,9652,95,880598,91.22531855381746,6
0.05,9653,94,880692,91.22560596643878,7
0.05,9654,95,880787,91.22599689280166,7
0.05,9655,95,880882,91.22638773819386,7
0.05,9656,92,880974,91.22646784715751,10
0.05,9657,95,881069,91.22685856284946,6
0.05,9658,94,881163,91.22714566725334,8
0.05,9659,94,881257,91.22743271221532,7
0.05,9660,95,881352,91.22782320670738,7
0.05,9661,89,881441,91.22759263092527,12
0.05,9662,93,881534,91.22777605298562,8
0.05,9663,93,881627,91.2279594370861,8
0.05,9664,94,881721,91.22824624935333,8
0.05,9665,91,881812,91.22822263604387,10
0.05,9666,94,881906,91.22850936174615,7
0.05,9667,94,882000,91.22879602813406,7
0.05,9668,92,882092,91.22887578860275,9
0.05,9669,93,882185,91.22905894519131,8
0.05,9670,93,882278,91.22924206390239,8
0.05,9671,95,882373,91.22963192721257,9
0.05,9672,94,882467,91.2299183293704,7
0.05,9673,92,882559,91.22999793260286,9
0.05,9674,96,882655,91.23049095607234,6
0.05,9675,96,882751,91.23098387763538,6
0.05,9676,95,882846,91.23137335951225,6
0.05,9677,94,882940,91.2316594337673,7
0.05,9678,94,883034,91.23194544891001,7
0.05,9679,92,883126,91.23202479338843,9
0.05,9680,94,883220,91.23231071170333,8
0.05,9681,92,883312,91.23239000206569,9
0.05,9682,96,883408,91.23288237116596,6
0.05,9683,95,883503,91.23327137546468,7
0.05,9684,92,883595,91.23335054207537,9
0.05,9685,88,883683,91.23301672517034,13
0.05,9686,93,883776,91.23319913285847,8
0.05,9687,27,883803,91.22656895127993,6
0.05,9688,95,883898,91.22695840644029,6
0.05,9689,90,883988,91.22683178534572,11
0.05,9690,96,884084,91.22732432153545,6
0.05,9691,91,884175,91.22730086669418,11
0.05,9692,94,884269,91.22758691839472,7
0.05,9693,93,884362,91.22776975448731,9
0.05,9694,94,884456,91.22805569881382,7
0.05,9695,92,884548,91.22813531353135,9
0.05,9696,91,884639,91.22811178715067,10
0.05,9697,92,884731,91.22819137966592,10
0.05,9698,94,884825,91.22847716259407,7
0.05,9699,93,884918,91.22865979381443,8
0.05,9700,95,885013,91.2290485516957,7
0.05,9701,94,885107,91.22933415790558,7
0.05,9702,96,885203,91.22982582706379,6
0.05,9703,94,885297,91.23011129431163,7
0.05,9704,93,885390,91.23029366306028,8
0.05,9705,95,885485,91.23068205233876,6
0.05,9706,96,885581,91.23117338003503,6
0.05,9707,94,885675,91.23145859085291,7
0.05,9708,94,885769,91.23174374291894,7
0.05,9709,96,885865,91.23223480947478,6
0.05,9710,92,885957,91.23231387086808,9
0.05,9711,94,886051,91.23259884678748,7
0.05,9712,92,886143,91.23267785442191,9
0.05,9713,91,886234,91.23265390158534,10
0.05,9714,94,886328,91.23293875450335,7
0.05,9715,94,886422,91.2332235487855,7
0.05,9716,94,886516,91.23350828444994,7
0.05,9717,94,886610,91.23379296151471,7
0.05,9718,96,886706,91.23428336248585,6
0.05,9719,94,886800,91.23456790123457,7
0.05,9720,92,886892,91.23464664129204,9
0.05,9721,92,886984,91.2347253651512,9
0.05,9722,91,887075,91.23470122390209,10
0.05,9723,95,887170,91.2350884409708,6
0.05,9724,94,887264,91.23537275064267,7
0.05,9725,95,887359,91.23575981904175,7
0.05,9726,91,887450,91.23573558137144,11
0.05,9727,88,887538,91.23540296052632,13
0.05,9728,95,887633,91.2357899064652,6
0.05,9729,92,887725,91.23586844809867,9
0.05,9730,92,887817,91.23594697358956,9
0.05,9731,94,887911,91.23623099054664,7
0.05,9732,92,888003,91.23630946265283,9
0.05,9733,94,888097,91.2365933840148,7
0.05,9734,94,888191,91.23687724704673,7
0.05,9735,93,888284,91.23705834018077,8
0.05,9736,96,888380,91.23754749922975,6
0.05,9737,93,888473,91.23772848634216,10
0.05,9738,95,888568,91.23811479618031,9
0.05,9739,95,888663,91.23850102669404,6
0.05,9740,95,888758,91.23888717790781,6
0.05,9741,92,888850,91.23896530486553,9
0.05,9742,94,888944,91.23924869136816,7
0.05,9743,92,889036,91.23932676518884,9
0.05,9744,96,889132,91.23981528989225,6
0.05,9745,93,889225,91.2399958957521,8
0.05,9746,93,889318,91.2401764645532,8
0.05,9747,94,889412,91.24045958145261,7
0.05,9748,91,889503,91.24043491640168,10
0.05,9749,96,889599,91.24092307692308,6
0.05,9750,92,889691,91.24100092298225,9
0.05,9751,94,889785,91.24128383921247,8
0.05,9752,95,889880,91.24166922998052,6
0.05,9753,94,889974,91.24195201968423,8
0.05,9754,94,890068,91.24223475140954,7
0.05,9755,91,890159,91.24220992209922,10
0.05,9756,85,890244,91.24157015476068,16
0.05,9757,94,890338,91.24185283869646,7
0.05,9758,95,890433,91.24223793421457,6
0.05,9759,96,890529,91.24272540983607,6
0.05,9760,94,890623,91.24300788853601,7
0.05,9761,92,890715,91.24308543331284,9
0.05,9762,91,890806,91.24306053467171,10
0.05,9763,91,890897,91.24303564113069,10
0.05,9764,96,890993,91.24352278545827,6
0.05,9765,94,891087,91.24380503788655,7
0.05,9766,95,891182,91.24418961810177,6
0.05,9767,96,891278,91.2446764946765,6
0.05,9768,94,891372,91.24495854232777,7
0.05,9769,94,891466,91.24524053224155,7
0.05,9770,94,891560,91.24552246443558,7
0.05,9771,96,891656,91.24600900532133,6
0.05,9772,94,891750,91.24629080118694,7
0.05,9773,94,891844,91.24657253939021,7
0.05,9774,93,891937,91.24675191815857,8
0.05,9775,95,892032,91.24713584288052,6
0.05,9776,92,892124,91.24721284647643,9
0.05,9777,95,892219,91.24759664553078,6
0.05,9778,95,892314,91.2479803660906,6
0.05,9779,92,892406,91.2480572597137,10
0.05,9780,96,892502,91.2485430937532,6
0.05,9781,94,892596,91.24882437129422,7
0.05,9782,92,892688,91.24890115506491,9
0.05,9783,95,892783,91.24928454619787,6
0.05,9784,96,892879,91.24977005620848,6
0.05,9785,95,892974,91.2501532801962,7
0.05,9786,95,893069,91.25053642587105,6
0.05,9787,93,893162,91.25071516142215,8
0.05,9788,94,893256,91.25099601593625,7
0.05,9789,93,893349,91.2511746680286,8
0.05,9790,94,893443,91.25145541824124,7
0.05,9791,94,893537,91.25173611111111,7
0.05,9792,96,893633,91.25222097416523,6
0.05,9793,94,893727,91.25250153154992,7
0.05,9794,96,893823,91.25298621745789,6
0.05,9795,94,893917,91.25326663944467,7
0.05,9796,95,894012,91.25364907624783,6
0.05,9797,95,894107,91.25403143498673,8
0.05,9798,96,894203,91.25451576691499,6
0.05,9799,95,894298,91.25489795918368,6
0.05,9800,94,894392,91.25517804305683,7
0.05,9801,94,894486,91.25545806978168,7
0.05,9802,96,894582,91.2559420585535,6
0.05,9803,95,894677,91.25632394940841,6
0.05,9804,94,894771,91.2566037735849,7
0.05,9805,94,894865,91.25688354068937,7
0.05,9806,95,894960,91.25726521872132,6
0.05,9807,95,895055,91.25764681892333,6
0.05,9808,93,895148,91.25782444693648,8
0.05,9809,94,895242,91.25810397553516,7
0.05,9810,95,895337,91.25848537356029,6
0.05,9811,94,895431,91.25876477782307,8
0.05,9812,93,895524,91.25894221950473,9
0.05,9813,92,895616,91.25901772977379,9
0.05,9814,95,895711,91.25939887926643,6
0.05,9815,94,895805,91.25967807660962,8
0.05,9816,92,895897,91.25975348884587,9
0.05,9817,93,895990,91.25993073945814,8
0.05,9818,93,896083,91.2601079539668,8
0.05,9819,93,896176,91.26028513238289,8
0.05,9820,93,896269,91.26046227471744,8
0.05,9821,92,896361,91.26053756872328,9
0.05,9822,92,896453,91.26061284739896,9
0.05,9823,95,896548,91.26099348534201,6
0.05,9824,96,896644,91.26147582697202,6
0.05,9825,27,896671,91.25493588438836,6
0.05,9826,96,896767,91.25541874427597,6
0.05,9827,92,896859,91.25549450549451,9
0.05,9828,95,896954,91.25587547054634,7
0.05,9829,94,897048,91.2561546286877,7
0.05,9830,96,897144,91.2566371681416,6
0.05,9831,94,897238,91.25691619202604,7
0.05,9832,96,897334,91.25739855588326,6
0.05,9833,94,897428,91.25767744559691,7
0.05,9834,92,897520,91.25775292323335,9
0.05,9835,96,897616,91.25823505490037,6
0.05,9836,96,897712,91.25871708854325,6
0.05,9837,94,897806,91.2589957308396,7
0.05,9838,89,897895,91.2587661347698,12
0.05,9839,96,897991,91.25924796747968,6
0.05,9840,94,898085,91.25952647088711,8
0.05,9841,96,898181,91.26000812842918,6
0.05,9842,94,898275,91.2602864980189,7
0.05,9843,94,898369,91.26056481105242,7
0.05,9844,92,898461,91.26063991874048,9
0.05,9845,94,898555,91.26091813934593,7
0.05,9846,95,898650,91.2612978572154,6
0.05,9847,93,898743,91.26147441104793,8
0.05,9848,94,898837,91.2617524621789,7
0.05,9849,95,898932,91.26213197969543,6
0.05,9850,94,899026,91.26240990762359,7
0.05,9851,92,899118,91.26248477466504,9
0.05,9852,96,899214,91.26296559423525,6
0.05,9853,93,899307,91.2631418713213,8
0.05,9854,91,899398,91.26311516996448,10
0.05,9855,95,899493,91.26349431818181,6
0.05,9856,94,899587,91.26377193872375,7
0.05,9857,95,899682,91.26415094339623,6
0.05,9858,93,899775,91.26432701085302,8
0.05,9859,94,899869,91.26460446247465,7
0.05,9860,94,899963,91.26488185782375,7
0.05,9861,88,900051,91.26455080105455,13
0.05,9862,93,900144,91.26472675656494,9
0.05,9863,93,900237,91.26490267639903,8
0.05,9864,94,900331,91.26517992904206,7
0.05,9865,95,900426,91.26555848368133,6
0.05,9866,96,900522,91.26603830951657,6
0.05,9867,95,900617,91.26641670044589,6
0.05,9868,-45,900572,91.25260918026143,8
0.05,9869,91,900663,91.25258358662614,10
0.05,9870,88,900751,91.25225407760105,13
0.05,9871,96,900847,91.25273500810373,6
0.05,9872,94,900941,91.25301326851007,7
0.05,9873,94,901035,91.25329147255418,7
0.05,9874,96,901131,91.25377215189873,6
0.05,9875,94,901225,91.25405022276225,7
0.05,9876,94,901319,91.25432823731903,7
0.05,9877,94,901413,91.25460619558615,7
0.05,9878,92,901505,91.25468164794007,9
0.05,9879,96,901601,91.25516194331983,6
0.05,9880,96,901697,91.25564214148366,6
0.05,9881,94,901791,91.2559198542805,7
0.05,9882,94,901885,91.25619751087726,7
0.05,9883,88,901973,91.25586806960744,13
0.05,9884,94,902067,91.25614567526556,7
0.05,9885,94,902161,91.25642322476229,8
0.05,9886,94,902255,91.2567007181147,7
0.05,9887,96,902351,91.25718042071198,6
0.05,9888,94,902445,91.25745778137325,8
0.05,9889,93,902538,91.25763397371082,8
0.05,9890,91,902629,91.25760792639774,12
0.05,9891,92,902721,91.25768297614233,9
0.05,9892,91,902812,91.25765692914182,10
0.05,9893,94,902906,91.25793410147564,7
0.05,9894,23,902929,91.2510358767054,9
0.05,9895,93,903022,91.25121261115602,8
0.05,9896,95,903117,91.2515913913307,6
0.05,9897,95,903212,91.25197009496868,6
0.05,9898,93,903305,91.25214668148298,8
0.05,9899,95,903400,91.25252525252525,6
0.05,9900,27,903427,91.24603575396425,6
0.05,9901,95,903522,91.2464148656837,6
0.05,9902,92,903614,91.24649096233465,10
0.05,9903,95,903709,91.24686995153473,6
0.05,9904,94,903803,91.24714790509843,8
0.05,9905,93,903896,91.24732485362406,8
0.05,9906,95,903991,91.24770364388816,6
0.05,9907,96,904087,91.24818328623334,6
0.05,9908,92,904179,91.2482591583409,10
0.05,9909,94,904273,91.24853683148335,7
0.05,9910,90,904363,91.24841085662395,11
0.05,9911,92,904455,91.24848668280872,9
0.05,9912,94,904549,91.248764248966,7
0.05,9913,94,904643,91.2490417591285,7
0.05,9914,96,904739,91.24952092788703,6
0.05,9915,95,904834,91.24989915288423,6
0.05,9916,93,904927,91.25007562770999,8
0.05,9917,94,905021,91.25035289372858,8
0.05,9918,92,905113,91.25042847061195,9
0.05,9919,95,905208,91.2508064516129,6
0.05,9920,93,905301,91.25098276383429,8
0.05,9921,91,905392,91.25095746825237,11
0.05,9922,95,905487,91.25133528166884,8
0.05,9923,95,905582,91.25171301894397,6
0.05,9924,94,905676,91.25198992443325,8
0.05,9925,95,905771,91.25236751964538,6
0.05,9926,96,905867,91.25284577415131,6
0.05,9927,93,905960,91.25302175664787,8
0.05,9928,91,906051,91.25299627354215,10
0.05,9929,92,906143,91.25307150050352,9
0.05,9930,94,906237,91.25334810190313,7
0.05,9931,95,906332,91.25372533225936,6
0.05,9932,93,906425,91.25390113762207,8
0.05,9933,94,906519,91.25417757197503,7
0.05,9934,92,906611,91.25425264217414,9
0.05,9935,95,906706,91.25462962962963,6
0.05,9936,92,906798,91.25470463922713,9
0.05,9937,92,906890,91.25477963372911,10
0.05,9938,94,906984,91.25505584062783,7
0.05,9939,94,907078,91.2553319919517,7
0.05,9940,94,907172,91.25560808771753,8
0.05,9941,94,907266,91.25588412794207,7
0.05,9942,94,907360,91.25616011264206,7
0.05,9943,89,907449,91.25593322606596,12
0.05,9944,91,907540,91.25590749120161,10
0.05,9945,96,907636,91.25638447617132,6
0.05,9946,94,907730,91.25666029958782,7
0.05,9947,95,907825,91.25703659026941,8
0.05,9948,96,907921,91.2575133179214,6
0.05,9949,27,907948,91.2510552763819,6
0.05,9950,96,908044,91.25153250929554,6
0.05,9951,94,908138,91.25180868167203,8
0.05,9952,89,908227,91.25158243745604,12
0.05,9953,96,908323,91.25205947357846,6
0.05,9954,95,908418,91.25243596182823,6
0.05,9955,95,908513,91.25281237444757,6
0.05,9956,92,908605,91.25288741588832,9
0.05,9957,95,908700,91.2532637075718,6
0.05,9958,94,908794,91.2535395119992,9
0.05,9959,93,908887,91.25371485943775,8
0.05,9960,90,908977,91.25358899708864,11
0.05,9961,93,909070,91.25376430435655,10
0.05,9962,92,909162,91.25383920505871,9
0.05,9963,95,909257,91.25421517462867,6
0.05,9964,90,909347,91.25408931259408,11
0.05,9965,90,909437,91.25396347581778,11
0.05,9966,95,909532,91.25433931975519,6
0.05,9967,96,909628,91.25481540930978,6
0.05,9968,94,909722,91.25509078142241,7
0.05,9969,96,909818,91.2555667001003,6
0.05,9970,95,909913,91.25594223247417,6
0.05,9971,92,910005,91.25601684717208,9
0.05,9972,94,910099,91.2562919883686,7
0.05,9973,92,910191,91.25636655303789,9
0.05,9974,94,910285,91.25664160401003,7
0.05,9975,92,910377,91.25671611868485,9
0.05,9976,95,910472,91.25709131001302,6
0.05,9977,93,910565,91.25726598516736,8
0.05,9978,90,910655,91.25713999398738,13
0.05,9979,92,910747,91.25721442885772,9
0.05,9980,92,910839,91.25728884881275,9
0.05,9981,94,910933,91.25756361450611,7
0.05,9982,95,911028,91.25793849544225,6
0.05,9983,93,911121,91.25811298076923,8
0.05,9984,94,911215,91.25838758137206,7
0.05,9985,92,911307,91.25846184658522,9
0.05,9986,95,911402,91.25883648743367,6
0.05,9987,93,911495,91.25901081297557,8
0.05,9988,91,911586,91.25898488337171,10
0.05,9989,96,911682,91.25945945945946,6
0.05,9990,96,911778,91.25993394054649,6
0.05,9991,95,911873,91.26030824659728,7
0.05,9992,92,911965,91.26038226758732,9
0.05,9993,92,912057,91.26045627376426,10
0.05,9994,93,912150,91.26063031515758,8
0.05,9995,90,912240,91.26050420168067,11
0.05,9996,94,912334,91.26077823347003,9
0.05,9997,94,912428,91.26105221044209,8
0.05,9998,94,912522,91.26132613261326,7
0.05,9999,91,912613,91.2613,10
